Class_Location,Class_Length,CheckStyle_Amount,PMD_Amount,SCAX_Amount,SpotBugs_Amount,Total_Amount
druid-master\druid-master\extensions-core\histogram\src\test\java\org\apache\druid\query\aggregation\histogram\CustomBucketsPostAggregatorTest.java,0,13,0,5,0,18
 druid-master\druid-master\processing\src\main\java\org\apache\druid\query\aggregation\any\NumericAnyBufferAggregator.java,0,43,1,9,0,53
 druid-master\druid-master\processing\src\main\java\org\apache\druid\query\aggregation\LongMaxBufferAggregator.java,0,11,0,1,0,12
 druid-master\druid-master\processing\src\main\java\org\apache\druid\segment\join\filter\JoinFilterPreAnalysisKey.java,0,32,0,2,0,34
 druid-master\druid-master\extensions-core\stats\src\main\java\org\apache\druid\query\aggregation\variance\VarianceAggregatorFactory.java,0,133,0,28,0,161
 druid-master\druid-master\processing\src\main\java\org\apache\druid\query\context\ResponseContextDeserializer.java,0,18,0,6,0,24
 druid-master\druid-master\processing\src\main\java\org\apache\druid\query\lookup\LookupExtractionFn.java,0,47,1,5,0,53
 druid-master\druid-master\processing\src\main\java\org\apache\druid\collections\bitmap\BitSetBitmapFactory.java,0,25,0,4,0,29
 druid-master\druid-master\processing\src\test\java\org\apache\druid\query\aggregation\DoubleMinAggregationTest.java,0,77,0,25,0,102
 druid-master\druid-master\indexing-service\src\main\java\org\apache\druid\indexing\worker\WorkerTaskManager.java,0,212,19,67,0,298
 druid-master\druid-master\extensions-core\lookups-cached-single\src\main\java\org\apache\druid\server\lookup\cache\polling\PollingCacheFactory.java,0,5,0,5,0,10
 druid-master\druid-master\integration-tests\src\test\java\org\apache\druid\tests\indexer\ITSystemTableBatchIndexTaskTest.java,0,12,1,4,0,17
 druid-master\druid-master\processing\src\main\java\org\apache\druid\segment\data\ColumnarMultiInts.java,0,7,0,5,0,12
 druid-master\druid-master\processing\src\main\java\org\apache\druid\query\dimension\ColumnSelectorStrategyFactory.java,0,4,1,3,0,8
 druid-master\druid-master\processing\src\test\java\org\apache\druid\query\topn\TopNQueryTest.java,0,31,0,12,0,43
 druid-master\druid-master\core\src\main\java\org\apache\druid\data\input\impl\FileEntity.java,0,18,0,2,0,20
 druid-master\druid-master\server\src\test\java\org\apache\druid\server\coordinator\duty\EmitClusterStatsAndMetricsTest.java,0,34,2,21,0,57
 druid-master\druid-master\processing\src\main\java\org\apache\druid\query\groupby\epinephelinae\IntGrouper.java,0,10,0,1,0,11
 druid-master\druid-master\extensions-core\lookups-cached-global\src\main\java\org\apache\druid\server\lookup\namespace\NamespaceExtractionModule.java,0,14,0,7,0,21
 druid-master\druid-master\processing\src\test\java\org\apache\druid\query\expression\TimestampCeilExprMacroTest.java,0,6,0,2,0,8
 druid-master\druid-master\server\src\main\java\org\apache\druid\segment\realtime\appenderator\AppenderatorPlumberSchool.java,0,21,0,2,0,23
 druid-master\druid-master\services\src\test\java\org\apache\druid\server\AsyncQueryForwardingServletTest.java,0,179,3,67,0,249
 druid-master\druid-master\extensions-core\testing-tools\src\main\java\org\apache\druid\query\sql\SleepOperatorConversion.java,0,14,0,5,0,19
 druid-master\druid-master\server\src\main\java\org\apache\druid\query\lookup\LookupModule.java,0,21,0,9,0,30
 druid-master\druid-master\extensions-contrib\aliyun-oss-extensions\src\main\java\org\apache\druid\storage\aliyun\OssTaskLogs.java,0,60,3,14,0,77
 druid-master\druid-master\sql\src\main\java\org\apache\druid\sql\calcite\external\ExternalDataSource.java,0,46,0,4,0,50
 druid-master\druid-master\core\src\main\java\org\apache\druid\math\expr\vector\ExprEvalLongVector.java,0,9,0,1,0,10
 druid-master\druid-master\server\src\main\java\org\apache\druid\guice\ServerViewModule.java,0,8,0,5,0,13
 druid-master\druid-master\extensions-core\druid-basic-security\src\test\java\org\apache\druid\security\basic\authentication\endpoint\BasicAuthenticatorResourceTest.java,0,54,0,15,0,69
 druid-master\druid-master\processing\src\main\java\org\apache\druid\query\topn\Generic2AggPooledTopNScanner.java,0,11,0,5,0,16
 druid-master\druid-master\server\src\test\java\org\apache\druid\server\metrics\TaskCountStatsMonitorTest.java,0,24,0,8,0,32
 druid-master\druid-master\processing\src\main\java\org\apache\druid\query\extraction\SubstringDimExtractionFn.java,0,34,0,2,0,36
 druid-master\druid-master\integration-tests\src\main\java\org\apache\druid\testing\clients\SqlResourceTestClient.java,0,7,0,3,0,10
 druid-master\druid-master\processing\src\main\java\org\apache\druid\query\filter\TrueDimFilter.java,0,19,1,3,0,23
 druid-master\druid-master\processing\src\main\java\org\apache\druid\segment\virtual\package-info.java,0,1,0,1,0,2
 druid-master\druid-master\indexing-service\src\main\java\org\apache\druid\indexing\common\task\Tasks.java,0,28,3,11,0,42
 druid-master\druid-master\extensions-core\hdfs-storage\src\main\java\org\apache\druid\storage\hdfs\HdfsDataSegmentPusher.java,0,60,5,22,0,87
 druid-master\druid-master\processing\src\main\java\org\apache\druid\segment\data\ReadableOffset.java,0,6,0,5,0,11
 druid-master\druid-master\processing\src\main\java\org\apache\druid\query\aggregation\post\ExpressionPostAggregator.java,0,87,1,12,0,100
 druid-master\druid-master\extensions-contrib\redis-cache\src\test\java\org\apache\druid\client\cache\RedisCacheConfigTest.java,0,50,3,3,0,56
 druid-master\druid-master\processing\src\main\java\org\apache\druid\query\metadata\metadata\ColumnAnalysis.java,0,103,1,5,0,109
 druid-master\druid-master\sql\src\main\java\org\apache\druid\sql\calcite\aggregation\builtin\BuiltinApproxCountDistinctSqlAggregator.java,0,22,0,16,0,38
 druid-master\druid-master\processing\src\test\java\org\apache\druid\query\DefaultQueryMetricsTest.java,0,40,0,12,0,52
 druid-master\druid-master\extensions-contrib\materialized-view-maintenance\src\main\java\org\apache\druid\indexing\materializedview\MaterializedViewTaskConfig.java,0,7,0,1,0,8
 druid-master\druid-master\server\src\test\java\org\apache\druid\server\lookup\cache\LookupCoordinatorManagerTest.java,0,285,9,114,0,408
 druid-master\druid-master\server\src\main\java\org\apache\druid\server\security\PreResponseAuthorizationCheckFilter.java,0,49,4,14,0,67
 druid-master\druid-master\processing\src\main\java\org\apache\druid\query\topn\AggregateTopNMetricFirstAlgorithm.java,0,50,1,21,0,72
 druid-master\druid-master\extensions-core\druid-basic-security\src\main\java\org\apache\druid\security\basic\authorization\LDAPRoleProvider.java,0,52,5,20,0,77
 druid-master\druid-master\sql\src\main\java\org\apache\druid\sql\calcite\expression\builtin\MultiValueStringToArrayOperatorConversion.java,0,6,0,3,0,9
 druid-master\druid-master\extensions-core\hdfs-storage\src\main\java\org\apache\hadoop\fs\HadoopFsWrapper.java,0,29,3,12,0,44
 druid-master\druid-master\indexing-service\src\main\java\org\apache\druid\indexing\overlord\TaskRunnerFactory.java,0,2,0,1,0,3
 druid-master\druid-master\processing\src\main\java\org\apache\druid\segment\BaseDoubleColumnValueSelector.java,0,7,0,6,0,13
 druid-master\druid-master\extensions-core\druid-basic-security\src\main\java\org\apache\druid\security\basic\authorization\db\updater\BasicAuthorizerMetadataStorageUpdater.java,0,28,0,10,0,38
 druid-master\druid-master\core\src\main\java\org\apache\druid\metadata\TaskLookup.java,0,49,0,5,0,54
 druid-master\druid-master\processing\src\test\java\org\apache\druid\segment\virtual\ExpressionSelectorsTest.java,0,172,19,76,0,267
 druid-master\druid-master\sql\src\main\java\org\apache\druid\sql\calcite\expression\builtin\ArrayOffsetOfOperatorConversion.java,0,4,0,1,0,5
 druid-master\druid-master\extendedset\src\main\java\org\apache\druid\extendedset\intset\AbstractIntSet.java,0,9,3,1,0,13
 druid-master\druid-master\server\src\main\java\org\apache\druid\server\metrics\HistoricalMetricsMonitor.java,0,28,0,14,0,42
 druid-master\druid-master\processing\src\main\java\org\apache\druid\query\DataSource.java,0,28,0,20,0,48
 druid-master\druid-master\processing\src\main\java\org\apache\druid\query\monomorphicprocessing\HotLoopCallee.java,0,9,0,8,0,17
 druid-master\druid-master\server\src\main\java\org\apache\druid\server\security\Access.java,0,23,0,1,0,24
 druid-master\druid-master\extensions-core\stats\src\test\java\org\apache\druid\query\aggregation\teststats\ZtestPostAggregatorTest.java,0,34,0,8,0,42
 druid-master\druid-master\extensions-core\kinesis-indexing-service\src\main\java\org\apache\druid\indexing\kinesis\supervisor\KinesisSupervisorTuningConfig.java,0,137,5,23,0,165
 druid-master\druid-master\indexing-service\src\test\java\org\apache\druid\indexing\overlord\helpers\TaskLogAutoCleanerConfigTest.java,0,16,0,2,0,18
 druid-master\druid-master\indexing-service\src\main\java\org\apache\druid\indexing\overlord\sampler\InputSourceSampler.java,0,55,3,36,0,94
 druid-master\druid-master\processing\src\test\java\org\apache\druid\query\groupby\epinephelinae\BufferHashGrouperTest.java,0,56,0,19,0,75
 druid-master\druid-master\extensions-core\datasketches\src\main\java\org\apache\druid\query\aggregation\datasketches\tuple\ArrayOfDoublesSketchMergeComplexMetricSerde.java,0,21,0,9,0,30
 druid-master\druid-master\server\src\test\java\org\apache\druid\guice\JavaScriptModuleTest.java,0,9,0,4,0,13
 druid-master\druid-master\server\src\main\java\org\apache\druid\discovery\WorkerNodeService.java,0,45,0,1,0,46
 druid-master\druid-master\indexing-service\src\main\java\org\apache\druid\indexing\common\actions\LockReleaseAction.java,0,23,0,1,0,24
 druid-master\druid-master\integration-tests\src\test\java\org\apache\druid\tests\indexer\AbstractOssInputSourceParallelIndexTest.java,0,26,1,10,0,37
 druid-master\druid-master\core\src\main\java\org\apache\druid\java\util\metrics\CgroupCpuSetMonitor.java,0,25,0,3,1,29
 druid-master\druid-master\core\src\main\java\org\apache\druid\java\util\emitter\core\ContentEncoding.java,0,2,0,1,0,3
 druid-master\druid-master\extensions-core\hdfs-storage\src\test\java\org\apache\druid\segment\loading\HdfsFileTimestampVersionFinderTest.java,0,66,16,18,0,100
 druid-master\druid-master\extensions-core\datasketches\src\main\java\org\apache\druid\query\aggregation\datasketches\hll\HllSketchMergeBufferAggregator.java,0,24,0,5,0,29
 druid-master\druid-master\sql\src\test\java\org\apache\druid\sql\avatica\DruidAvaticaHandlerTest.java,0,240,50,91,0,381
 druid-master\druid-master\server\src\main\java\org\apache\druid\segment\realtime\plumber\Plumbers.java,0,12,2,3,0,17
 druid-master\druid-master\indexing-service\src\main\java\org\apache\druid\indexing\overlord\ForkingTaskRunner.java,0,216,13,73,0,302
 druid-master\druid-master\extensions-core\kafka-indexing-service\src\main\java\org\apache\druid\indexing\kafka\KafkaIndexTaskClientFactory.java,0,13,0,3,0,16
 druid-master\druid-master\server\src\main\java\org\apache\druid\metadata\SQLMetadataConnector.java,0,165,4,34,0,203
 druid-master\druid-master\extensions-contrib\momentsketch\src\test\java\org\apache\druid\query\aggregation\momentsketch\aggregator\MomentSketchAggregatorFactoryTest.java,0,14,0,9,0,23
 druid-master\druid-master\processing\src\main\java\org\apache\druid\collections\spatial\search\Bound.java,0,8,0,1,0,9
 druid-master\druid-master\server\src\main\java\org\apache\druid\segment\realtime\appenderator\SegmentsAndCommitMetadata.java,0,30,0,2,0,32
 druid-master\druid-master\core\src\test\java\org\apache\druid\java\util\emitter\core\IntEvent.java,0,6,3,1,0,10
 druid-master\druid-master\server\src\test\java\org\apache\druid\segment\realtime\firehose\SqlFirehoseTest.java,0,39,3,13,0,55
 druid-master\druid-master\extensions-core\histogram\src\test\java\org\apache\druid\query\aggregation\histogram\ApproximateHistogramVectorAggregatorTest.java,0,71,2,26,0,99
 druid-master\druid-master\integration-tests\src\main\java\org\apache\druid\testing\utils\KinesisAdminClient.java,0,66,0,24,0,90
 druid-master\druid-master\processing\src\main\java\org\apache\druid\segment\incremental\IncrementalIndexAdapter.java,0,74,0,15,0,89
 druid-master\druid-master\indexing-service\src\main\java\org\apache\druid\indexing\common\task\TaskResourceCleaner.java,0,15,2,2,0,19
 druid-master\druid-master\server\src\main\java\org\apache\druid\server\coordinator\duty\NewestSegmentFirstPolicy.java,0,13,0,3,0,16
 druid-master\druid-master\extensions-contrib\tdigestsketch\src\main\java\org\apache\druid\query\aggregation\tdigestsketch\TDigestSketchObjectStrategy.java,0,16,0,2,0,18
 druid-master\druid-master\server\src\main\java\org\apache\druid\segment\realtime\firehose\NoopChatHandlerProvider.java,0,13,0,1,0,14
 druid-master\druid-master\server\src\test\java\org\apache\druid\segment\realtime\FireDepartmentTest.java,0,14,0,9,0,23
 druid-master\druid-master\sql\src\main\java\org\apache\druid\sql\calcite\filtration\BoundValue.java,0,26,0,1,0,27
 druid-master\druid-master\server\src\main\java\org\apache\druid\client\FilteredHttpServerInventoryViewProvider.java,0,11,0,2,0,13
 druid-master\druid-master\processing\src\main\java\org\apache\druid\segment\filter\FalseValueMatcher.java,0,7,0,1,0,8
 druid-master\druid-master\core\src\test\java\org\apache\druid\common\config\ConfigManagerTest.java,0,58,3,19,3,83
 druid-master\druid-master\extensions-contrib\influx-extensions\target\generated-sources\antlr4\org\apache\druid\data\input\influx\InfluxLineProtocolLexer.java,120,161,3,3,4,171
 druid-master\druid-master\server\src\main\java\org\apache\druid\query\lookup\LookupUtils.java,0,23,2,10,0,35
 druid-master\druid-master\server\src\main\java\org\apache\druid\server\initialization\ExternalStorageAccessSecurityModule.java,0,7,0,2,0,9
 druid-master\druid-master\sql\src\main\java\org\apache\druid\sql\calcite\aggregation\builtin\SimpleSqlAggregator.java,0,9,0,6,0,15
 druid-master\druid-master\processing\src\main\java\org\apache\druid\segment\virtual\ExpressionMultiValueDimensionSelector.java,0,80,0,9,0,89
 druid-master\druid-master\server\src\main\java\org\apache\druid\segment\loading\LocalDataSegmentPusher.java,0,41,2,13,0,56
 druid-master\druid-master\core\src\main\java\org\apache\druid\java\util\common\concurrent\ExecutorServiceConfig.java,0,12,2,5,0,19
 druid-master\druid-master\processing\src\main\java\org\apache\druid\segment\serde\DictionaryEncodedColumnSupplier.java,0,21,0,2,0,23
 druid-master\druid-master\extensions-core\avro-extensions\src\main\java\org\apache\druid\data\input\avro\AvroExtensionsModule.java,0,19,7,8,0,34
 druid-master\druid-master\core\src\main\java\org\apache\druid\guice\ListProvider.java,0,17,1,1,0,19
 druid-master\druid-master\processing\src\main\java\org\apache\druid\query\filter\NotDimFilter.java,0,36,1,11,0,48
 druid-master\druid-master\processing\src\main\java\org\apache\druid\query\groupby\orderby\OrderByColumnSpec.java,0,97,3,10,0,110
 druid-master\druid-master\processing\src\test\java\org\apache\druid\collections\spatial\RTreeTest.java,0,38,0,3,0,41
 druid-master\druid-master\server\src\main\java\org\apache\druid\server\coordination\ZkCoordinator.java,0,54,6,13,0,73
 druid-master\druid-master\processing\src\test\java\org\apache\druid\segment\DimensionHandlerUtilsTest.java,0,47,0,21,0,68
 druid-master\druid-master\indexing-service\src\main\java\org\apache\druid\indexing\overlord\http\TotalWorkerCapacityResponse.java,0,19,0,6,0,25
 druid-master\druid-master\sql\src\main\java\org\apache\druid\sql\calcite\expression\builtin\ReinterpretOperatorConversion.java,0,3,0,1,0,4
 druid-master\druid-master\core\src\main\java\org\apache\druid\java\util\common\CloseableIterators.java,0,25,1,5,0,31
 druid-master\druid-master\extensions-contrib\moving-average-query\src\test\java\org\apache\druid\query\movingaverage\averagers\DoubleMaxAveragerTest.java,0,12,0,3,0,15
 druid-master\druid-master\indexing-service\src\main\java\org\apache\druid\indexing\common\actions\RemoteTaskActionClientFactory.java,0,15,0,2,0,17
 druid-master\druid-master\core\src\test\java\org\apache\druid\math\expr\VectorExprSanityTest.java,0,170,1,36,1,208
 druid-master\druid-master\extensions-contrib\aliyun-oss-extensions\src\test\java\org\apache\druid\storage\aliyun\OssObjectSummaryIteratorTest.java,0,46,0,13,0,59
 druid-master\druid-master\extensions-core\mysql-metadata-storage\src\main\java\org\apache\druid\metadata\storage\mysql\MySQLConnectorSslConfig.java,0,58,0,7,0,65
 druid-master\druid-master\processing\src\main\java\org\apache\druid\segment\column\ColumnHolder.java,0,12,0,2,0,14
 druid-master\druid-master\extensions-core\azure-extensions\src\main\java\org\apache\druid\storage\azure\blob\ListBlobItemHolder.java,0,22,0,3,0,25
 druid-master\druid-master\sql\src\main\java\org\apache\druid\sql\calcite\planner\Calcites.java,0,142,3,60,0,205
 druid-master\druid-master\sql\src\test\java\org\apache\druid\sql\calcite\CalciteInsertDmlTest.java,0,222,0,97,0,319
 druid-master\druid-master\processing\src\main\java\org\apache\druid\segment\data\ColumnarInts.java,0,4,0,4,0,8
 druid-master\druid-master\processing\src\main\java\org\apache\druid\query\extraction\ExtractionCacheHelper.java,0,17,0,1,0,18
 druid-master\druid-master\processing\src\main\java\org\apache\druid\query\groupby\epinephelinae\ByteBufferMinMaxOffsetHeap.java,0,119,1,12,0,132
 druid-master\druid-master\processing\src\main\java\org\apache\druid\query\search\AutoStrategy.java,0,33,5,20,0,58
 druid-master\druid-master\server\src\main\java\org\apache\druid\server\coordinator\duty\UnloadUnusedSegments.java,0,27,1,13,0,41
 druid-master\druid-master\indexing-service\src\test\java\org\apache\druid\indexing\overlord\http\OverlordRedirectInfoTest.java,0,20,0,3,0,23
 druid-master\druid-master\sql\src\main\java\org\apache\druid\sql\calcite\schema\InformationSchema.java,0,99,1,43,0,143
 druid-master\druid-master\extensions-core\s3-extensions\src\main\java\org\apache\druid\storage\s3\CustomServerSideEncryption.java,0,15,0,3,0,18
 druid-master\druid-master\indexing-service\src\main\java\org\apache\druid\indexing\common\task\batch\parallel\PushedSegmentsReport.java,0,34,0,3,0,37
 druid-master\druid-master\benchmarks\src\test\java\org\apache\druid\benchmark\BoundFilterBenchmark.java,0,54,1,13,0,68
 druid-master\druid-master\sql\src\main\java\org\apache\druid\sql\calcite\expression\builtin\CeilOperatorConversion.java,0,7,0,3,0,10
 druid-master\druid-master\extensions-contrib\distinctcount\src\main\java\org\apache\druid\query\aggregation\distinctcount\DistinctCountAggregator.java,0,21,0,1,0,22
 druid-master\druid-master\processing\src\main\java\org\apache\druid\segment\serde\FloatNumericColumnSupplier.java,0,11,0,1,0,12
 druid-master\druid-master\core\src\main\java\org\apache\druid\java\util\common\granularity\GranularityType.java,0,78,0,5,0,83
 druid-master\druid-master\extensions-core\histogram\src\main\java\org\apache\druid\query\aggregation\histogram\ApproximateHistogramDruidModule.java,0,11,0,5,0,16
 druid-master\druid-master\integration-tests\src\test\java\org\apache\druid\tests\coordinator\duty\ITAutoCompactionTest.java,0,456,22,217,0,695
 druid-master\druid-master\server\src\test\java\org\apache\druid\metadata\TestDerbyConnector.java,0,50,0,5,0,55
 druid-master\druid-master\processing\src\main\java\org\apache\druid\segment\transform\Transform.java,0,13,0,10,0,23
 druid-master\druid-master\processing\src\test\java\org\apache\druid\segment\column\RowSignatureTest.java,0,25,5,8,0,38
 druid-master\druid-master\benchmarks\src\test\java\org\apache\druid\benchmark\indexing\IncrementalIndexReadBenchmark.java,0,47,2,13,0,62
 druid-master\druid-master\extensions-contrib\statsd-emitter\src\main\java\org\apache\druid\emitter\statsd\StatsDEmitterModule.java,0,13,0,2,0,15
 druid-master\druid-master\processing\src\main\java\org\apache\druid\query\aggregation\SerializablePairLongString.java,0,6,0,2,0,8
 druid-master\druid-master\extensions-core\stats\src\main\java\org\apache\druid\query\aggregation\variance\VarianceAggregator.java,0,47,1,5,0,53
 druid-master\druid-master\processing\src\main\java\org\apache\druid\query\aggregation\HistogramAggregator.java,0,31,0,5,0,36
 druid-master\druid-master\processing\src\main\java\org\apache\druid\segment\data\ColumnarIntsSerializer.java,0,3,0,2,0,5
 druid-master\druid-master\core\src\main\java\org\apache\druid\java\util\common\guava\FunctionalIterable.java,0,46,0,8,0,54
 druid-master\druid-master\core\src\main\java\org\apache\druid\collections\Releaser.java,0,1,0,1,0,2
 druid-master\druid-master\core\src\main\java\org\apache\druid\indexer\partitions\SingleDimensionPartitionsSpec.java,0,56,1,11,0,68
 druid-master\druid-master\core\src\test\java\org\apache\druid\java\util\metrics\MonitorsTest.java,0,11,0,4,0,15
 druid-master\druid-master\extensions-core\datasketches\src\main\java\org\apache\druid\query\aggregation\datasketches\hll\HllSketchUnionPostAggregator.java,0,52,0,3,0,55
 druid-master\druid-master\integration-tests\src\test\java\org\apache\druid\tests\parallelized\ITKafkaIndexingServiceNonTransactionalParallelizedTest.java,0,18,0,6,0,24
 druid-master\druid-master\indexing-service\src\main\java\org\apache\druid\indexing\common\task\batch\partition\LinearPartitionAnalysis.java,0,24,0,5,0,29
 druid-master\druid-master\indexing-service\src\main\java\org\apache\druid\indexing\overlord\autoscaling\PendingTaskBasedWorkerProvisioningStrategy.java,0,134,16,61,0,211
 druid-master\druid-master\core\src\main\java\org\apache\druid\java\util\http\client\response\InputStreamFullResponseHolder.java,0,19,0,2,1,22
 druid-master\druid-master\server\src\test\java\org\apache\druid\server\coordination\SegmentChangeRequestDropTest.java,0,8,0,5,0,13
 druid-master\druid-master\server\src\main\java\org\apache\druid\indexing\overlord\supervisor\SupervisorReport.java,0,32,0,1,0,33
 druid-master\druid-master\sql\src\main\java\org\apache\druid\sql\calcite\schema\SystemSchema.java,0,318,3,100,0,421
 druid-master\druid-master\extensions-contrib\moving-average-query\src\main\java\org\apache\druid\query\movingaverage\averagers\DoubleMinAveragerFactory.java,0,10,0,2,0,12
 druid-master\druid-master\processing\src\main\java\org\apache\druid\query\aggregation\post\LongLeastPostAggregator.java,0,45,3,5,0,53
 druid-master\druid-master\server\src\test\java\org\apache\druid\segment\realtime\appenderator\SegmentPublisherHelperTest.java,0,47,0,23,0,70
 druid-master\druid-master\sql\src\main\java\org\apache\druid\sql\calcite\expression\builtin\ArrayOrdinalOperatorConversion.java,0,9,0,2,0,11
 druid-master\druid-master\server\src\test\java\org\apache\druid\segment\realtime\appenderator\ClosedSegmentsSinksBatchAppenderatorTest.java,0,342,20,214,0,576
 druid-master\druid-master\processing\src\main\java\org\apache\druid\segment\writeout\OnHeapMemorySegmentWriteOutMediumFactory.java,0,9,1,2,0,12
 druid-master\druid-master\processing\src\main\java\org\apache\druid\query\topn\types\NullableNumericTopNColumnAggregatesProcessor.java,0,54,2,16,0,72
 druid-master\druid-master\core\src\test\java\org\apache\druid\data\input\impl\prefetch\PrefetchableTextFilesFirehoseFactoryTest.java,0,186,7,36,4,233
 druid-master\druid-master\sql\src\main\java\org\apache\druid\sql\calcite\expression\PostAggregatorVisitor.java,0,23,0,3,0,26
 druid-master\druid-master\server\src\main\java\org\apache\druid\segment\realtime\firehose\PredicateFirehose.java,0,22,0,3,0,25
 druid-master\druid-master\server\src\main\java\org\apache\druid\server\http\DataSourcesResource.java,0,267,2,92,0,361
 druid-master\druid-master\extensions-contrib\aliyun-oss-extensions\src\test\java\org\apache\druid\storage\aliyun\OssTestUtils.java,0,47,0,15,0,62
 druid-master\druid-master\processing\src\test\java\org\apache\druid\segment\generator\SegmentGenerator.java,0,61,1,32,0,94
 druid-master\druid-master\server\src\main\java\org\apache\druid\client\InventoryView.java,0,5,0,1,0,6
 druid-master\druid-master\extensions-core\druid-ranger-security\src\main\java\org\apache\druid\security\ranger\authorizer\RangerSecurityDruidModule.java,0,19,0,6,0,25
 druid-master\druid-master\core\src\main\java\org\apache\druid\timeline\Partitions.java,0,4,0,4,0,8
 druid-master\druid-master\extensions-core\avro-extensions\src\main\java\org\apache\druid\data\input\avro\AvroBytesDecoder.java,0,8,0,6,0,14
 druid-master\druid-master\indexing-hadoop\src\test\java\org\apache\druid\indexer\UtilsCompressionTest.java,0,36,6,11,0,53
 druid-master\druid-master\processing\src\test\java\org\apache\druid\segment\virtual\VirtualizedColumnSelectorFactoryTest.java,0,44,3,24,0,71
 druid-master\druid-master\indexing-service\src\test\java\org\apache\druid\indexing\worker\shuffle\ShuffleDataSegmentPusherTest.java,0,49,0,19,0,68
 druid-master\druid-master\processing\src\main\java\org\apache\druid\query\metadata\metadata\SegmentMetadataQuery.java,0,123,3,14,0,140
 druid-master\druid-master\server\src\main\java\org\apache\druid\segment\realtime\firehose\package-info.java,0,1,0,1,0,2
 druid-master\druid-master\sql\src\main\java\org\apache\druid\sql\calcite\rule\DruidUnionDataSourceRule.java,0,39,0,21,0,60
 druid-master\druid-master\extensions-core\kafka-indexing-service\src\test\java\org\apache\druid\indexing\kafka\supervisor\KafkaSupervisorTest.java,0,1276,3,738,0,2017
 druid-master\druid-master\core\src\test\java\org\apache\druid\data\input\impl\ColumnsFilterTest.java,0,22,0,6,0,28
 druid-master\druid-master\indexing-service\src\main\java\org\apache\druid\guice\IndexingServiceInputSourceModule.java,0,5,1,1,0,7
 druid-master\druid-master\core\src\main\java\org\apache\druid\collections\DummyBlockingPool.java,0,14,0,3,0,17
 druid-master\druid-master\processing\src\main\java\org\apache\druid\query\extraction\StringFormatExtractionFn.java,0,52,0,5,0,57
 druid-master\druid-master\processing\src\main\java\org\apache\druid\segment\data\BlockLayoutColumnarFloatsSerializer.java,0,35,0,7,0,42
 druid-master\druid-master\processing\src\main\java\org\apache\druid\query\search\AllSearchQuerySpec.java,0,15,0,1,0,16
 druid-master\druid-master\extensions-contrib\moving-average-query\src\main\java\org\apache\druid\query\movingaverage\averagers\LongMeanNoNullAverager.java,0,10,1,2,0,13
 druid-master\druid-master\processing\src\main\java\org\apache\druid\segment\SortedDimensionDictionary.java,0,26,0,4,0,30
 druid-master\druid-master\processing\src\main\java\org\apache\druid\query\aggregation\last\NumericLastBufferAggregator.java,0,52,1,7,0,60
 druid-master\druid-master\server\src\main\java\org\apache\druid\segment\realtime\appenderator\AppenderatorFactory.java,0,4,0,3,0,7
 druid-master\druid-master\server\src\test\java\org\apache\druid\server\http\RulesResourceTest.java,0,38,8,20,0,66
 druid-master\druid-master\server\src\main\java\org\apache\druid\discovery\DataNodeService.java,0,86,0,13,0,99
 druid-master\druid-master\extensions-core\google-extensions\src\main\java\org\apache\druid\storage\google\GoogleUtils.java,0,44,2,14,0,60
 druid-master\druid-master\core\src\main\java\org\apache\druid\data\input\impl\FileIteratingFirehose.java,0,32,0,3,1,36
 druid-master\druid-master\processing\src\main\java\org\apache\druid\query\topn\TopNQueryMetrics.java,0,26,0,13,0,39
 druid-master\druid-master\processing\src\test\java\org\apache\druid\query\scan\ScanQueryTest.java,0,50,3,17,0,70
 druid-master\druid-master\server\src\main\java\org\apache\druid\discovery\DruidService.java,0,10,0,8,0,18
 druid-master\druid-master\extensions-core\testing-tools\src\main\java\org\apache\druid\guice\SleepModule.java,0,7,0,1,0,8
 druid-master\druid-master\processing\src\main\java\org\apache\druid\query\aggregation\cardinality\vector\FloatCardinalityVectorProcessor.java,0,32,0,14,0,46
 druid-master\druid-master\core\src\main\java\org\apache\druid\common\guava\GuavaUtils.java,0,34,2,8,0,44
 druid-master\druid-master\sql\src\main\java\org\apache\druid\sql\calcite\view\DruidViewMacroFactory.java,0,6,0,2,0,8
 druid-master\druid-master\processing\src\main\java\org\apache\druid\query\timeboundary\TimeBoundaryQuery.java,0,79,3,13,0,95
 druid-master\druid-master\extensions-core\datasketches\src\main\java\org\apache\druid\query\aggregation\datasketches\tuple\ArrayOfDoublesSketchToMeansPostAggregator.java,0,17,0,7,0,24
 druid-master\druid-master\extensions-contrib\distinctcount\src\main\java\org\apache\druid\query\aggregation\distinctcount\JavaBitMapFactory.java,0,13,2,1,0,16
 druid-master\druid-master\extensions-core\kafka-indexing-service\src\main\java\org\apache\druid\indexing\kafka\KafkaIndexTask.java,0,38,0,4,0,42
 druid-master\druid-master\server\src\main\java\org\apache\druid\server\security\TLSCertificateCheckerModule.java,0,35,0,6,0,41
 druid-master\druid-master\processing\src\test\java\org\apache\druid\segment\IndexMergerRollupTest.java,0,23,2,8,0,33
 druid-master\druid-master\server\src\main\java\org\apache\druid\server\QueryLaningStrategy.java,0,16,0,6,0,22
 druid-master\druid-master\core\src\main\java\org\apache\druid\java\util\metrics\Monitors.java,0,23,1,11,0,35
 druid-master\druid-master\extensions-core\s3-extensions\src\main\java\org\apache\druid\storage\s3\S3DataSegmentMover.java,0,67,1,30,0,98
 druid-master\druid-master\server\src\test\java\org\apache\druid\discovery\WorkerNodeServiceTest.java,0,4,1,1,0,6
 druid-master\druid-master\processing\src\main\java\org\apache\druid\query\filter\LikeDimFilter.java,0,129,1,21,0,151
 druid-master\druid-master\processing\src\main\java\org\apache\druid\segment\vector\VectorSelectorUtils.java,0,8,4,2,0,14
 druid-master\druid-master\server\src\test\java\org\apache\druid\server\initialization\jetty\JettyServerModuleTest.java,0,23,0,4,0,27
 druid-master\druid-master\core\src\main\java\org\apache\druid\java\util\metrics\AbstractMonitor.java,0,12,1,1,0,14
 druid-master\druid-master\core\src\main\java\org\apache\druid\java\util\common\guava\SequenceWrapper.java,0,21,0,12,0,33
 druid-master\druid-master\processing\src\main\java\org\apache\druid\query\aggregation\cardinality\types\CardinalityAggregatorColumnSelectorStrategy.java,0,6,1,5,0,12
 druid-master\druid-master\core\src\main\java\org\apache\druid\data\input\InputRowSchema.java,0,22,0,6,0,28
 druid-master\druid-master\processing\src\main\java\org\apache\druid\segment\LongWrappingDimensionSelector.java,0,16,0,3,0,19
 druid-master\druid-master\sql\src\main\java\org\apache\druid\sql\calcite\run\QueryFeature.java,0,4,0,3,0,7
 druid-master\druid-master\core\src\test\java\org\apache\druid\java\util\metrics\AllocationMetricCollectorTest.java,0,20,1,6,1,28
 druid-master\druid-master\indexing-service\src\main\java\org\apache\druid\indexing\overlord\hrtr\HttpRemoteTaskRunner.java,0,460,40,186,0,686
 druid-master\druid-master\extensions-core\histogram\src\main\java\org\apache\druid\query\aggregation\histogram\sql\FixedBucketsHistogramQuantileSqlAggregator.java,0,38,0,13,0,51
 druid-master\druid-master\processing\src\main\java\org\apache\druid\query\aggregation\any\StringAnyAggregatorFactory.java,0,84,0,13,0,97
 druid-master\druid-master\indexing-service\src\test\java\org\apache\druid\indexing\common\TaskToolboxTest.java,0,80,0,30,0,110
 druid-master\druid-master\server\src\test\java\org\apache\druid\curator\CuratorModuleTest.java,0,50,1,25,0,76
 druid-master\druid-master\processing\src\test\java\org\apache\druid\segment\data\CompressedVSizeColumnarMultiIntsSupplierTest.java,0,52,0,7,0,59
 druid-master\druid-master\processing\src\main\java\org\apache\druid\collections\spatial\search\RadiusBound.java,0,41,1,2,0,44
 druid-master\druid-master\core\src\test\java\org\apache\druid\math\expr\ExpressionTypeTest.java,0,83,0,66,0,149
 druid-master\druid-master\server\src\main\java\org\apache\druid\segment\handoff\CoordinatorBasedSegmentHandoffNotifier.java,0,56,3,21,0,80
 druid-master\druid-master\extensions-core\histogram\src\main\java\org\apache\druid\query\aggregation\histogram\BucketsPostAggregator.java,0,43,0,1,0,44
 druid-master\druid-master\processing\src\main\java\org\apache\druid\query\QuerySegmentWalker.java,0,6,0,6,0,12
 druid-master\druid-master\extensions-core\datasketches\src\main\java\org\apache\druid\query\aggregation\datasketches\tuple\NoopArrayOfDoublesSketchAggregator.java,0,13,2,3,0,18
 druid-master\druid-master\indexing-hadoop\src\test\java\org\apache\druid\indexer\path\GranularUnprocessedPathSpecTest.java,0,6,0,3,0,9
 druid-master\druid-master\extensions-contrib\moving-average-query\src\test\java\org\apache\druid\query\movingaverage\averagers\LongMeanNoNullAveragerFactoryTest.java,0,6,0,3,0,9
 druid-master\druid-master\extensions-core\druid-basic-security\src\main\java\org\apache\druid\security\basic\authorization\endpoint\BasicAuthorizerResourceHandler.java,0,38,0,15,0,53
 druid-master\druid-master\core\src\test\java\org\apache\druid\java\util\emitter\core\HttpEmitterTest.java,0,21,0,5,0,26
 druid-master\druid-master\server\src\test\java\org\apache\druid\server\coordinator\rules\LoadRuleTest.java,0,216,0,118,0,334
 druid-master\druid-master\core\src\main\java\org\apache\druid\indexer\IngestionState.java,0,6,0,1,0,7
 druid-master\druid-master\extensions-core\druid-bloom-filter\src\main\java\org\apache\druid\query\aggregation\bloom\BloomFilterMergeAggregator.java,0,10,0,4,0,14
 druid-master\druid-master\indexing-service\src\test\java\org\apache\druid\indexing\common\task\batch\parallel\PartialSegmentMergeIOConfigTest.java,0,19,1,4,0,24
 druid-master\druid-master\core\src\test\java\org\apache\druid\java\util\emitter\core\CustomEmitterFactoryTest.java,0,35,4,5,1,45
 druid-master\druid-master\sql\src\test\java\org\apache\druid\sql\calcite\planner\CalcitePlannerModuleTest.java,0,39,1,9,0,49
 druid-master\druid-master\extensions-core\lookups-cached-single\src\main\java\org\apache\druid\server\lookup\cache\loading\LoadingCache.java,0,31,0,16,0,47
 druid-master\druid-master\server\src\main\java\org\apache\druid\indexing\overlord\ObjectMetadata.java,0,23,2,2,0,27
 druid-master\druid-master\server\src\main\java\org\apache\druid\server\coordinator\rules\PeriodDropRule.java,0,27,0,2,0,29
 druid-master\druid-master\extensions-contrib\aliyun-oss-extensions\src\test\java\org\apache\druid\data\input\aliyun\OssInputSourceTest.java,0,131,1,48,0,180
 druid-master\druid-master\sql\src\main\java\org\apache\druid\sql\calcite\rel\DruidOuterQueryRel.java,0,37,1,7,0,45
 druid-master\druid-master\processing\src\main\java\org\apache\druid\segment\RowPointer.java,0,34,0,8,0,42
 druid-master\druid-master\indexing-service\src\main\java\org\apache\druid\indexing\common\task\batch\parallel\ParallelIndexTaskClientFactory.java,0,17,0,2,0,19
 druid-master\druid-master\processing\src\main\java\org\apache\druid\segment\data\CompressedColumnarIntsSupplier.java,0,97,1,19,0,117
 druid-master\druid-master\server\src\main\java\org\apache\druid\server\initialization\jetty\ResponseHeaderFilterHolder.java,0,30,3,3,0,36
 druid-master\druid-master\processing\src\main\java\org\apache\druid\query\topn\BySegmentTopNResultValue.java,0,27,0,2,0,29
 druid-master\druid-master\extensions-core\druid-basic-security\src\main\java\org\apache\druid\security\basic\authorization\db\cache\BasicAuthorizerCacheManager.java,0,15,0,15,0,30
 druid-master\druid-master\core\src\main\java\org\apache\druid\java\util\common\parsers\Parser.java,0,13,1,6,0,20
 druid-master\druid-master\server\src\main\java\org\apache\druid\curator\discovery\CuratorServiceUtils.java,0,10,1,6,0,17
 druid-master\druid-master\processing\src\test\java\org\apache\druid\query\groupby\having\HavingSpecTest.java,0,125,1,10,0,136
 druid-master\druid-master\processing\src\test\java\org\apache\druid\segment\serde\HyperUniquesSerdeForTest.java,0,44,0,9,0,53
 druid-master\druid-master\core\src\test\java\org\apache\druid\timeline\partition\OvershadowableInteger.java,0,68,0,2,0,70
 druid-master\druid-master\core\src\test\java\org\apache\druid\java\util\common\StreamUtilsTest.java,0,16,0,3,2,21
 druid-master\druid-master\server\src\main\java\org\apache\druid\server\coordinator\DruidCoordinator.java,0,362,14,125,0,501
 druid-master\druid-master\processing\src\main\java\org\apache\druid\query\aggregation\NullableNumericVectorAggregator.java,0,72,0,23,0,95
 druid-master\druid-master\indexing-service\src\main\java\org\apache\druid\indexing\common\LockGranularity.java,0,3,0,1,0,4
 druid-master\druid-master\core\src\main\java\org\apache\druid\java\util\common\granularity\Granularities.java,0,36,1,17,0,54
 druid-master\druid-master\extensions-core\druid-kerberos\src\main\java\org\apache\druid\security\kerberos\KerberosHttpClient.java,0,44,4,13,0,61
 druid-master\druid-master\processing\src\test\java\org\apache\druid\query\aggregation\hyperloglog\HyperUniqueFinalizingPostAggregatorTest.java,0,19,0,8,0,27
 druid-master\druid-master\extensions-core\druid-basic-security\src\test\java\org\apache\druid\security\authorization\BasicRoleBasedAuthorizerTest.java,0,66,1,45,0,112
 druid-master\druid-master\processing\src\main\java\org\apache\druid\query\dimension\DefaultDimensionSpec.java,0,65,1,5,0,71
 druid-master\druid-master\extensions-core\datasketches\src\test\java\org\apache\druid\query\aggregation\datasketches\tuple\GenerateTestData.java,0,26,1,11,0,38
 druid-master\druid-master\server\src\main\java\org\apache\druid\server\coordinator\duty\EmitClusterStatsAndMetrics.java,0,61,5,26,0,92
 druid-master\druid-master\server\src\main\java\org\apache\druid\guice\annotations\CoordinatorMetadataStoreManagementDuty.java,0,1,0,1,0,2
 druid-master\druid-master\processing\src\main\java\org\apache\druid\collections\spatial\Point.java,0,34,0,2,0,36
 druid-master\druid-master\extensions-core\s3-extensions\src\main\java\org\apache\druid\storage\s3\S3SSEKmsConfig.java,0,5,0,1,0,6
 druid-master\druid-master\core\src\main\java\org\apache\druid\metadata\EnvironmentVariableDynamicConfigProvider.java,0,25,0,4,0,29
 druid-master\druid-master\processing\src\main\java\org\apache\druid\collections\spatial\split\SplitStrategy.java,0,3,0,1,0,4
 druid-master\druid-master\server\src\test\java\org\apache\druid\discovery\DruidServiceTestUtils.java,0,4,0,1,0,5
 druid-master\druid-master\sql\src\main\java\org\apache\druid\sql\SqlLifecycleManager.java,0,32,0,11,0,43
 druid-master\druid-master\indexing-service\src\main\java\org\apache\druid\indexing\seekablestream\SeekableStreamDataSourceMetadata.java,0,45,2,16,0,63
 druid-master\druid-master\indexing-service\src\main\java\org\apache\druid\indexing\common\task\OverlordCoordinatingSegmentAllocator.java,0,28,0,14,0,42
 druid-master\druid-master\server\src\test\java\org\apache\druid\server\coordinator\duty\NewestSegmentFirstPolicyTest.java,0,418,0,247,0,665
 druid-master\druid-master\processing\src\test\java\org\apache\druid\collections\bitmap\BitmapOperationAgainstUniformDistributionTest.java,0,8,0,4,0,12
 druid-master\druid-master\core\src\main\java\org\apache\druid\java\util\http\client\response\StatusResponseHandler.java,0,25,1,8,0,34
 druid-master\druid-master\processing\src\test\java\org\apache\druid\query\UnionQueryRunnerTest.java,0,18,0,4,0,22
 druid-master\druid-master\server\src\main\java\org\apache\druid\indexing\overlord\supervisor\SupervisorStateManagerConfig.java,0,40,1,6,0,47
 druid-master\druid-master\processing\src\main\java\org\apache\druid\query\groupby\epinephelinae\column\StringGroupByColumnSelectorStrategy.java,0,72,0,18,0,90
 druid-master\druid-master\server\src\test\java\org\apache\druid\segment\realtime\appenderator\SegmentWithStateTest.java,0,8,0,4,0,12
 druid-master\druid-master\extensions-contrib\time-min-max\src\main\java\org\apache\druid\query\aggregation\TimestampAggregator.java,0,37,1,5,0,43
 druid-master\druid-master\extensions-contrib\sqlserver-metadata-storage\src\main\java\org\apache\druid\metadata\storage\sqlserver\SQLServerConnector.java,0,72,1,28,0,101
 druid-master\druid-master\processing\src\test\java\org\apache\druid\query\aggregation\HistogramTest.java,0,42,0,7,0,49
 druid-master\druid-master\indexing-service\src\test\java\org\apache\druid\indexing\common\task\batch\parallel\TaskMonitorTest.java,0,107,0,36,0,143
 druid-master\druid-master\core\src\main\java\org\apache\druid\metadata\MetadataCASUpdate.java,0,41,0,2,4,47
 druid-master\druid-master\processing\src\main\java\org\apache\druid\query\Result.java,0,36,0,4,0,40
 druid-master\druid-master\extensions-core\s3-extensions\src\test\java\org\apache\druid\storage\s3\TestAWSCredentialsProvider.java,0,24,0,17,0,41
 druid-master\druid-master\processing\src\test\java\org\apache\druid\query\groupby\ResultRowTest.java,0,9,0,5,0,14
 druid-master\druid-master\extensions-core\ec2-extensions\src\main\java\org\apache\druid\indexing\overlord\autoscaling\ec2\GalaxyEC2UserData.java,0,46,1,3,0,50
 druid-master\druid-master\indexing-service\src\test\java\org\apache\druid\indexing\overlord\http\OverlordTest.java,0,130,12,23,0,165
 druid-master\druid-master\benchmarks\src\test\java\org\apache\druid\benchmark\bitmap\UniformBitmapBenchmark.java,0,26,0,5,0,31
 druid-master\druid-master\extensions-core\histogram\src\main\java\org\apache\druid\query\aggregation\histogram\QuantilesPostAggregator.java,0,41,0,3,0,44
 druid-master\druid-master\indexing-service\src\test\java\org\apache\druid\indexing\test\TestDataSegmentPusher.java,0,14,0,1,0,15
 druid-master\druid-master\server\src\main\java\org\apache\druid\client\DruidServer.java,0,135,3,29,0,167
 druid-master\druid-master\processing\src\main\java\org\apache\druid\query\search\SearchQueryExecutor.java,0,18,0,2,0,20
 druid-master\druid-master\processing\src\test\java\org\apache\druid\segment\QueryableIndexStorageAdapterTest.java,0,139,13,44,0,196
 druid-master\druid-master\core\src\main\java\org\apache\druid\data\input\Row.java,0,12,0,10,0,22
 druid-master\druid-master\processing\src\main\java\org\apache\druid\query\groupby\epinephelinae\ConcurrentGrouper.java,0,126,8,33,0,167
 druid-master\druid-master\extensions-core\avro-extensions\target\generated-test-sources\avro\org\apache\druid\data\input\UnionSubFixed.java,0,19,3,4,0,26
 druid-master\druid-master\sql\src\main\java\org\apache\druid\sql\calcite\expression\builtin\StringFormatOperatorConversion.java,0,20,0,4,0,24
 druid-master\druid-master\server\src\test\java\org\apache\druid\jackson\ToStringObjectPairListDeserializerTest.java,0,8,0,3,0,11
 druid-master\druid-master\processing\src\test\java\org\apache\druid\segment\join\table\LookupJoinMatcherTest.java,0,49,0,22,0,71
 druid-master\druid-master\processing\src\main\java\org\apache\druid\query\JoinDataSource.java,0,99,1,15,0,115
 druid-master\druid-master\indexing-service\src\main\java\org\apache\druid\indexing\overlord\setup\FillCapacityWithAffinityWorkerSelectStrategy.java,0,6,0,3,0,9
 druid-master\druid-master\core\src\test\java\org\apache\druid\java\util\common\FileUtilsTest.java,0,42,1,12,0,55
 druid-master\druid-master\extensions-contrib\moving-average-query\src\main\java\org\apache\druid\query\movingaverage\averagers\ComparableAveragerFactory.java,0,11,0,4,0,15
 druid-master\druid-master\integration-tests\src\test\java\org\apache\druid\tests\hadoop\AbstractGcsInputHadoopIndexTest.java,0,14,1,7,0,22
 druid-master\druid-master\server\src\main\java\org\apache\druid\offheap\OffheapBufferGenerator.java,0,15,1,1,0,17
 druid-master\druid-master\server\src\main\java\org\apache\druid\segment\realtime\appenderator\DummyForInjectionAppenderatorsManager.java,0,86,0,5,0,91
 druid-master\druid-master\server\src\main\java\org\apache\druid\indexing\overlord\Segments.java,0,10,0,10,0,20
 druid-master\druid-master\core\src\main\java\org\apache\druid\java\util\common\guava\SkippingSequence.java,0,33,0,6,0,39
 druid-master\druid-master\processing\src\main\java\org\apache\druid\query\timeboundary\TimeBoundaryQueryRunnerFactory.java,0,51,2,18,0,71
 druid-master\druid-master\processing\src\main\java\org\apache\druid\query\aggregation\NoopAggregator.java,0,11,2,1,0,14
 druid-master\druid-master\indexing-hadoop\src\test\java\org\apache\druid\indexer\hadoop\DatasourceInputSplitTest.java,0,6,0,1,0,7
 druid-master\druid-master\indexing-hadoop\src\main\java\org\apache\druid\indexer\HadoopIngestionSpec.java,0,64,0,16,0,80
 druid-master\druid-master\sql\src\test\java\org\apache\druid\sql\http\SqlResourceTest.java,0,436,6,190,0,632
 druid-master\druid-master\extensions-core\datasketches\src\main\java\org\apache\druid\query\aggregation\datasketches\hll\HllSketchMergeAggregator.java,0,16,0,1,0,17
 druid-master\druid-master\extensions-contrib\sqlserver-metadata-storage\src\test\java\org\apache\druid\metadata\storage\sqlserver\CustomStatementRewriterTest.java,0,39,1,14,0,54
 druid-master\druid-master\extensions-core\histogram\src\main\java\org\apache\druid\query\aggregation\histogram\ApproximateHistogramFoldingAggregatorFactory.java,0,64,0,18,0,82
 druid-master\druid-master\server\src\main\java\org\apache\druid\server\http\security\ConfigResourceFilter.java,0,9,0,3,0,12
 druid-master\druid-master\extensions-core\stats\src\main\java\org\apache\druid\query\aggregation\stats\DruidStatsModule.java,0,13,0,11,0,24
 druid-master\druid-master\server\src\test\java\org\apache\druid\server\coordinator\CoordinatorRuntimeParamsTestHelpers.java,0,10,1,3,0,14
 druid-master\druid-master\integration-tests\src\main\java\org\apache\druid\testing\utils\DruidClusterAdminClient.java,0,155,6,35,0,196
 druid-master\druid-master\server\src\test\java\org\apache\druid\server\lookup\cache\LookupCoordinatorManagerConfigTest.java,0,14,0,5,0,19
 druid-master\druid-master\server\src\test\java\org\apache\druid\server\metrics\NoopServiceEmitter.java,0,5,1,1,0,7
 druid-master\druid-master\extensions-core\s3-extensions\src\main\java\org\apache\druid\storage\s3\S3InputDataConfig.java,0,16,0,5,0,21
 druid-master\druid-master\extensions-core\datasketches\src\test\java\org\apache\druid\query\aggregation\datasketches\quantiles\DoublesSketchToCDFPostAggregatorTest.java,0,22,1,4,0,27
 druid-master\druid-master\integration-tests\src\test\java\org\apache\druid\tests\indexer\AbstractIndexerTest.java,0,57,6,13,0,76
 druid-master\druid-master\processing\src\main\java\org\apache\druid\query\topn\LexicographicTopNMetricSpec.java,0,55,2,7,0,64
 druid-master\druid-master\processing\src\main\java\org\apache\druid\query\dimension\RegexFilteredDimensionSpec.java,0,32,0,4,0,36
 druid-master\druid-master\processing\src\test\java\org\apache\druid\segment\data\BenchmarkIndexibleWrites.java,0,84,2,24,0,110
 druid-master\druid-master\sql\src\main\java\org\apache\druid\sql\calcite\planner\DruidRexExecutor.java,0,39,0,32,0,71
 druid-master\druid-master\extensions-contrib\moving-average-query\src\main\java\org\apache\druid\query\movingaverage\averagers\DoubleMeanAverager.java,0,10,1,2,0,13
 druid-master\druid-master\core\src\test\java\org\apache\druid\data\input\impl\CombiningInputSourceTest.java,0,83,0,23,2,108
 druid-master\druid-master\extensions-core\histogram\src\main\java\org\apache\druid\query\aggregation\histogram\ApproximateHistogramPostAggregator.java,0,28,0,4,0,32
 druid-master\druid-master\server\src\test\java\org\apache\druid\server\http\CoordinatorCompactionConfigsResourceTest.java,0,66,0,36,0,102
 druid-master\druid-master\processing\src\test\java\org\apache\druid\query\lookup\LookupExtractorTest.java,0,28,0,8,0,36
 druid-master\druid-master\core\src\test\java\org\apache\druid\java\util\common\guava\MergeIteratorTest.java,0,39,0,3,0,42
 druid-master\druid-master\core\src\main\java\org\apache\druid\query\cache\CacheKeyBuilder.java,0,126,1,13,0,140
 druid-master\druid-master\server\src\test\java\org\apache\druid\server\security\ForbiddenExceptionTest.java,0,15,0,8,0,23
 druid-master\druid-master\processing\src\main\java\org\apache\druid\segment\data\EntireLayoutColumnarLongsSerializer.java,0,33,0,7,0,40
 druid-master\druid-master\processing\src\main\java\org\apache\druid\query\groupby\strategy\GroupByStrategy.java,0,54,0,40,0,94
 druid-master\druid-master\processing\src\main\java\org\apache\druid\query\groupby\having\HavingSpecMetricComparator.java,0,19,1,11,0,31
 druid-master\druid-master\core\src\main\java\org\apache\druid\java\util\emitter\core\BaseHttpEmittingConfig.java,0,87,0,5,1,93
 druid-master\druid-master\sql\src\main\java\org\apache\druid\sql\calcite\expression\builtin\TimeCeilOperatorConversion.java,0,9,0,4,0,13
 druid-master\druid-master\server\src\main\java\org\apache\druid\segment\loading\SegmentLocalCacheLoader.java,0,27,1,6,0,34
 druid-master\druid-master\core\src\main\java\org\apache\druid\data\input\impl\MapInputRowParser.java,0,45,0,12,0,57
 druid-master\druid-master\sql\src\main\java\org\apache\druid\sql\calcite\filtration\Filtration.java,0,44,1,7,0,52
 druid-master\druid-master\extensions-core\s3-extensions\src\main\java\org\apache\druid\storage\s3\S3StorageDruidModule.java,0,65,3,26,0,94
 druid-master\druid-master\extensions-core\orc-extensions\src\main\java\org\apache\druid\data\input\orc\OrcHadoopInputRowParser.java,0,21,1,2,0,24
 druid-master\druid-master\processing\src\main\java\org\apache\druid\query\BySegmentQueryRunner.java,0,23,0,8,0,31
 druid-master\druid-master\services\src\main\java\org\apache\druid\cli\ServerRunnable.java,0,45,1,11,0,57
 druid-master\druid-master\processing\src\main\java\org\apache\druid\query\aggregation\any\FloatAnyVectorAggregator.java,0,20,0,2,0,22
 druid-master\druid-master\indexing-service\src\main\java\org\apache\druid\indexing\worker\WorkerHistoryItem.java,0,43,0,4,0,47
 druid-master\druid-master\sql\src\test\java\org\apache\druid\sql\calcite\schema\RootSchemaProviderTest.java,0,21,0,5,0,26
 druid-master\druid-master\core\src\main\java\org\apache\druid\data\input\impl\RegexReader.java,0,36,0,7,0,43
 druid-master\druid-master\sql\src\main\java\org\apache\druid\sql\calcite\rule\DruidRelToDruidRule.java,0,8,1,1,0,10
 druid-master\druid-master\processing\src\test\java\org\apache\druid\query\aggregation\any\FloatAnyAggregatorFactoryTest.java,0,26,0,7,0,33
 druid-master\druid-master\extensions-contrib\opentsdb-emitter\src\test\java\org\apache\druid\emitter\opentsdb\OpentsdbSenderTest.java,0,11,0,3,0,14
 druid-master\druid-master\processing\src\main\java\org\apache\druid\query\filter\vector\LongVectorValueMatcher.java,0,19,0,4,0,23
 druid-master\druid-master\extensions-core\lookups-cached-global\src\main\java\org\apache\druid\query\lookup\namespace\CacheGenerator.java,0,9,0,7,0,16
 druid-master\druid-master\core\src\test\java\org\apache\druid\java\util\emitter\service\ServiceMetricEventTest.java,0,34,0,3,0,37
 druid-master\druid-master\processing\src\main\java\org\apache\druid\collections\spatial\split\LinearGutmanSplitStrategy.java,0,22,0,11,0,33
 druid-master\druid-master\server\src\main\java\org\apache\druid\segment\realtime\FireDepartmentMetrics.java,0,154,0,7,0,161
 druid-master\druid-master\server\src\main\java\org\apache\druid\segment\realtime\firehose\SqlFirehoseFactory.java,0,34,3,5,0,42
 druid-master\druid-master\extensions-core\lookups-cached-global\src\main\java\org\apache\druid\server\lookup\namespace\cache\NamespaceExtractionCacheManager.java,0,26,0,9,0,35
 druid-master\druid-master\processing\src\test\java\org\apache\druid\query\expression\IPv4AddressParseExprMacroTest.java,0,41,3,2,0,46
 druid-master\druid-master\indexing-service\src\main\java\org\apache\druid\indexing\common\RetryPolicyConfig.java,0,29,0,1,0,30
 druid-master\druid-master\server\src\main\java\org\apache\druid\server\coordination\ServerManager.java,0,80,0,33,0,113
 druid-master\druid-master\server\src\test\java\org\apache\druid\segment\realtime\firehose\ServiceAnnouncingChatHandlerProviderTest.java,0,27,0,10,0,37
 druid-master\druid-master\server\src\main\java\org\apache\druid\client\selector\QueryableDruidServer.java,0,21,0,1,0,22
 druid-master\druid-master\extensions-contrib\moving-average-query\src\main\java\org\apache\druid\query\movingaverage\averagers\LongMinAveragerFactory.java,0,10,0,2,0,12
 druid-master\druid-master\extensions-contrib\momentsketch\src\main\java\org\apache\druid\query\aggregation\momentsketch\aggregator\MomentSketchMaxPostAggregator.java,0,38,1,3,0,42
 druid-master\druid-master\processing\src\test\java\org\apache\druid\query\groupby\GroupByQueryRunnerFactoryTest.java,0,32,0,11,0,43
 druid-master\druid-master\processing\src\main\java\org\apache\druid\query\scan\ScanQuery.java,0,228,5,46,0,279
 druid-master\druid-master\processing\src\main\java\org\apache\druid\segment\generator\EnumeratedTreeDistribution.java,0,10,1,3,0,14
 druid-master\druid-master\processing\src\main\java\org\apache\druid\segment\IndexSpec.java,0,103,0,30,0,133
 druid-master\druid-master\processing\src\test\java\org\apache\druid\segment\incremental\IncrementalIndexRowCompTest.java,0,22,0,8,0,30
 druid-master\druid-master\extensions-core\datasketches\src\test\java\org\apache\druid\query\aggregation\datasketches\tuple\ArrayOfDoublesSketchToQuantilesSketchPostAggregatorTest.java,0,32,0,19,0,51
 druid-master\druid-master\extensions-core\azure-extensions\src\test\java\org\apache\druid\data\input\azure\AzureEntityTest.java,0,42,8,9,0,59
 druid-master\druid-master\core\src\test\java\org\apache\druid\data\input\impl\HttpInputSourceConfigTest.java,0,13,0,5,0,18
 druid-master\druid-master\services\src\main\java\org\apache\druid\cli\GuiceRunnable.java,0,50,3,10,0,63
 druid-master\druid-master\processing\src\test\java\org\apache\druid\segment\join\lookup\LookupJoinableTest.java,0,86,0,31,0,117
 druid-master\druid-master\core\src\main\java\org\apache\druid\collections\StupidPool.java,0,113,2,33,2,150
 druid-master\druid-master\integration-tests\src\main\java\org\apache\druid\testing\ConfigFileConfigProvider.java,0,132,0,26,0,158
 druid-master\druid-master\core\src\main\java\org\apache\druid\timeline\partition\SingleDimensionShardSpec.java,0,77,0,8,0,85
 druid-master\druid-master\server\src\main\java\org\apache\druid\segment\realtime\appenderator\TransactionalSegmentPublisher.java,0,15,0,8,0,23
 druid-master\druid-master\sql\src\main\java\org\apache\druid\sql\calcite\aggregation\builtin\EarliestLatestBySqlAggregator.java,0,31,0,17,0,48
 druid-master\druid-master\extensions-core\kinesis-indexing-service\src\test\java\org\apache\druid\indexing\kinesis\supervisor\KinesisSupervisorIOConfigTest.java,0,34,0,11,0,45
 druid-master\druid-master\core\src\main\java\org\apache\druid\audit\AuditInfo.java,0,34,1,1,0,36
 druid-master\druid-master\extensions-core\hdfs-storage\src\main\java\org\apache\druid\storage\hdfs\HdfsFileTimestampVersionFinder.java,0,15,0,6,0,21
 druid-master\druid-master\core\src\main\java\org\apache\druid\java\util\common\JodaUtils.java,0,45,1,20,0,66
 druid-master\druid-master\extensions-contrib\moving-average-query\src\test\java\org\apache\druid\query\movingaverage\averagers\LongMinAveragerFactoryTest.java,0,6,0,3,0,9
 druid-master\druid-master\core\src\test\java\org\apache\druid\common\utils\LogTest.java,0,10,1,2,0,13
 druid-master\druid-master\indexing-service\src\main\java\org\apache\druid\indexing\overlord\sampler\SamplerExceptionMapper.java,0,7,0,3,0,10
 druid-master\druid-master\core\src\main\java\org\apache\druid\indexer\TaskLocation.java,0,45,0,3,0,48
 druid-master\druid-master\extensions-contrib\moving-average-query\src\test\java\org\apache\druid\query\movingaverage\averagers\DoubleMaxAveragerFactoryTest.java,0,6,0,3,0,9
 druid-master\druid-master\extensions-contrib\aliyun-oss-extensions\src\main\java\org\apache\druid\storage\aliyun\OssDataSegmentMover.java,0,62,3,26,0,91
 druid-master\druid-master\core\src\test\java\org\apache\druid\timeline\SegmentIdTest.java,0,69,0,48,0,117
 druid-master\druid-master\processing\src\test\java\org\apache\druid\segment\filter\FilterPartitionTest.java,0,159,0,98,0,257
 druid-master\druid-master\processing\src\main\java\org\apache\druid\query\aggregation\cardinality\CardinalityVectorAggregator.java,0,28,0,4,0,32
 druid-master\druid-master\processing\src\main\java\org\apache\druid\query\aggregation\hyperloglog\HyperUniquesVectorAggregator.java,0,24,0,9,0,33
 druid-master\druid-master\processing\src\main\java\org\apache\druid\segment\vector\QueryableIndexVectorColumnSelectorFactory.java,0,64,0,35,0,99
 druid-master\druid-master\processing\src\test\java\org\apache\druid\segment\join\JoinTestHelper.java,0,80,5,31,0,116
 druid-master\druid-master\indexing-service\src\main\java\org\apache\druid\indexing\worker\Worker.java,0,59,0,2,0,61
 druid-master\druid-master\processing\src\main\java\org\apache\druid\query\aggregation\LongMinAggregateCombiner.java,0,7,0,1,0,8
 druid-master\druid-master\services\src\main\java\org\apache\druid\guice\QueryablePeonModule.java,0,6,0,1,0,7
 druid-master\druid-master\sql\src\test\java\org\apache\druid\sql\calcite\SqlVectorizedExpressionSanityTest.java,0,65,4,30,0,99
 druid-master\druid-master\core\src\main\java\org\apache\druid\math\expr\vector\LongOutLongsInFunctionVectorValueProcessor.java,0,16,0,2,0,18
 druid-master\druid-master\processing\src\main\java\org\apache\druid\segment\column\DictionaryEncodedColumn.java,0,17,1,5,0,23
 druid-master\druid-master\indexing-service\src\test\java\org\apache\druid\indexing\overlord\setup\FillCapacityWithAffinityWorkerSelectStrategyTest.java,0,20,0,12,0,32
 druid-master\druid-master\processing\src\test\java\org\apache\druid\segment\selector\TestColumnValueSelector.java,0,64,1,6,0,71
 druid-master\druid-master\core\src\test\java\org\apache\druid\collections\CombiningIteratorTest.java,0,25,0,6,0,31
 druid-master\druid-master\extensions-contrib\gce-extensions\src\test\java\org\apache\druid\indexing\overlord\autoscaling\gce\GceUtilsTest.java,0,13,6,6,0,25
 druid-master\druid-master\server\src\main\java\org\apache\druid\segment\realtime\firehose\SqlFirehose.java,0,23,0,4,0,27
 druid-master\druid-master\server\src\main\java\org\apache\druid\guice\ServerTypeConfig.java,0,9,0,1,0,10
 druid-master\druid-master\processing\src\main\java\org\apache\druid\query\groupby\epinephelinae\vector\NullableDoubleGroupByVectorColumnSelector.java,0,13,0,3,0,16
 druid-master\druid-master\server\src\test\java\org\apache\druid\server\coordinator\CostBalancerStrategyBenchmark.java,0,35,2,5,0,42
 druid-master\druid-master\server\src\main\java\org\apache\druid\server\initialization\CuratorDiscoveryConfig.java,0,8,0,1,0,9
 druid-master\druid-master\server\src\test\java\org\apache\druid\segment\realtime\firehose\InlineFirehoseFactoryTest.java,0,30,0,6,0,36
 druid-master\druid-master\core\src\main\java\org\apache\druid\java\util\common\parsers\ParserUtils.java,0,29,3,6,0,38
 druid-master\druid-master\extensions-core\hdfs-storage\src\test\java\org\apache\druid\storage\hdfs\HdfsDataSegmentPusherTest.java,0,91,0,32,0,123
 druid-master\druid-master\indexing-service\src\test\java\org\apache\druid\indexing\seekablestream\supervisor\SeekableStreamSupervisorStateManagerTest.java,0,93,0,63,0,156
 druid-master\druid-master\processing\src\main\java\org\apache\druid\segment\RowBasedStorageAdapter.java,0,61,1,13,0,75
 druid-master\druid-master\processing\src\main\java\org\apache\druid\segment\incremental\IncrementalIndexRow.java,0,70,0,13,0,83
 druid-master\druid-master\server\src\test\java\org\apache\druid\query\lookup\LookupListeningAnnouncerConfigTest.java,0,32,0,14,0,46
 druid-master\druid-master\extensions-core\datasketches\src\main\java\org\apache\druid\query\aggregation\datasketches\theta\SketchModule.java,0,35,0,26,0,61
 druid-master\druid-master\core\src\main\java\org\apache\druid\java\util\common\guava\nary\TrinaryFn.java,0,7,4,1,0,12
 druid-master\druid-master\server\src\main\java\org\apache\druid\curator\discovery\CuratorDruidNodeDiscoveryProvider.java,0,113,10,25,0,148
 druid-master\druid-master\indexing-service\src\main\java\org\apache\druid\indexing\common\task\batch\parallel\GeneratedPartitionsMetadataReport.java,0,8,0,3,0,11
 druid-master\druid-master\core\src\main\java\org\apache\druid\tasklogs\NoopTaskLogs.java,0,20,0,1,0,21
 druid-master\druid-master\server\src\main\java\org\apache\druid\metadata\DerbyMetadataStorageActionHandlerFactory.java,0,10,0,2,0,12
 druid-master\druid-master\core\src\test\java\org\apache\druid\timeline\partition\BuildingSingleDimensionShardSpecTest.java,0,42,1,7,0,50
 druid-master\druid-master\processing\src\main\java\org\apache\druid\segment\transform\Transformer.java,0,55,0,11,0,66
 druid-master\druid-master\core\src\test\java\org\apache\druid\timeline\partition\TombstoneShardSpecTest.java,0,22,2,4,1,29
 druid-master\druid-master\processing\src\main\java\org\apache\druid\segment\writeout\ByteBufferWriteOutBytes.java,0,73,1,9,0,83
 druid-master\druid-master\server\src\test\java\org\apache\druid\client\SimpleQueryRunner.java,0,15,0,3,0,18
 druid-master\druid-master\processing\src\main\java\org\apache\druid\segment\IdMapping.java,0,65,0,16,0,81
 druid-master\druid-master\indexing-service\src\test\java\org\apache\druid\indexing\worker\shuffle\ShuffleResourceTest.java,0,52,0,20,0,72
 druid-master\druid-master\processing\src\test\java\org\apache\druid\query\scan\MultiSegmentScanQueryTest.java,0,104,2,41,0,147
 druid-master\druid-master\processing\src\test\java\org\apache\druid\query\aggregation\LongSumAggregatorTest.java,0,17,0,4,0,21
 druid-master\druid-master\processing\src\test\java\org\apache\druid\query\timeseries\TimeseriesQueryRunnerTest.java,0,773,30,346,0,1149
 druid-master\druid-master\server\src\main\java\org\apache\druid\server\coordinator\duty\LogUsedSegments.java,0,10,3,3,0,16
 druid-master\druid-master\core\src\test\java\org\apache\druid\java\util\common\StringUtilsTest.java,0,91,0,20,0,111
 druid-master\druid-master\sql\src\main\java\org\apache\druid\sql\calcite\expression\builtin\ArrayOverlapOperatorConversion.java,0,19,0,11,0,30
 druid-master\druid-master\indexing-hadoop\src\main\java\org\apache\druid\indexer\HadoopKerberosConfig.java,0,24,0,4,0,28
 druid-master\druid-master\sql\src\main\java\org\apache\druid\sql\calcite\expression\SqlOperatorConversion.java,0,10,0,7,0,17
 druid-master\druid-master\extensions-core\kafka-indexing-service\src\test\java\org\apache\druid\indexing\kafka\KafkaIOConfigTest.java,0,160,0,85,0,245
 druid-master\druid-master\indexing-service\src\main\java\org\apache\druid\indexing\common\actions\RemoteTaskActionClient.java,0,33,4,8,0,45
 druid-master\druid-master\processing\src\main\java\org\apache\druid\segment\Metadata.java,0,76,1,9,0,86
 druid-master\druid-master\processing\src\main\java\org\apache\druid\segment\DimensionIndexer.java,0,81,3,78,0,162
 druid-master\druid-master\core\src\main\java\org\apache\druid\timeline\partition\NumberedPartialShardSpec.java,0,13,1,3,0,17
 druid-master\druid-master\processing\src\test\java\org\apache\druid\query\aggregation\any\LongAnyAggregatorFactoryTest.java,0,26,0,7,0,33
 druid-master\druid-master\core\src\main\java\org\apache\druid\timeline\partition\DimensionRangeShardSpec.java,0,99,0,23,2,124
 druid-master\druid-master\extensions-core\datasketches\src\main\java\org\apache\druid\query\aggregation\datasketches\theta\sql\ThetaSketchSetIntersectOperatorConversion.java,0,4,0,2,0,6
 druid-master\druid-master\extensions-core\google-extensions\src\test\java\org\apache\druid\storage\google\GoogleDataSegmentPullerTest.java,0,8,0,4,0,12
 druid-master\druid-master\server\src\main\java\org\apache\druid\query\lookup\LookupListeningAnnouncerConfig.java,0,13,0,3,0,16
 druid-master\druid-master\services\src\test\java\org\apache\druid\cli\DumpSegmentTest.java,0,11,0,8,0,19
 druid-master\druid-master\processing\src\main\java\org\apache\druid\query\dimension\ForwardingFilteredDimensionSelector.java,0,39,0,7,0,46
 druid-master\druid-master\processing\src\main\java\org\apache\druid\segment\virtual\ExpressionPlanner.java,0,40,2,28,0,70
 druid-master\druid-master\extensions-core\google-extensions\src\test\java\org\apache\druid\storage\google\GoogleTestUtils.java,0,37,0,12,0,49
 druid-master\druid-master\processing\src\main\java\org\apache\druid\collections\spatial\RTree.java,0,60,0,17,0,77
 druid-master\druid-master\server\src\main\java\org\apache\druid\server\coordination\ServerType.java,0,32,0,10,0,42
 druid-master\druid-master\extensions-core\datasketches\src\main\java\org\apache\druid\query\aggregation\datasketches\quantiles\sql\DoublesSketchSingleArgBaseOperatorConversion.java,0,21,0,3,0,24
 druid-master\druid-master\extensions-contrib\moving-average-query\src\main\java\org\apache\druid\query\movingaverage\averagers\DoubleSumAveragerFactory.java,0,10,0,2,0,12
 druid-master\druid-master\processing\src\test\java\org\apache\druid\segment\CloserRuleTest.java,0,47,3,4,0,54
 druid-master\druid-master\extensions-core\s3-extensions\src\main\java\org\apache\druid\storage\s3\S3DataSegmentKiller.java,0,30,2,12,0,44
 druid-master\druid-master\processing\src\test\java\org\apache\druid\query\scan\ScanQuerySpecTest.java,0,29,0,16,0,45
 druid-master\druid-master\indexing-service\src\main\java\org\apache\druid\indexing\overlord\http\OverlordRedirectInfo.java,0,17,1,2,0,20
 druid-master\druid-master\benchmarks\src\test\java\org\apache\druid\benchmark\query\SqlExpressionBenchmark.java,0,71,4,38,0,113
 druid-master\druid-master\extensions-core\kafka-indexing-service\src\main\java\org\apache\druid\indexing\kafka\KafkaSequenceNumber.java,0,9,1,1,0,11
 druid-master\druid-master\indexing-service\src\main\java\org\apache\druid\guice\IndexingServiceTaskLogsModule.java,0,9,0,6,0,15
 druid-master\druid-master\core\src\main\java\org\apache\druid\java\util\metrics\cgroups\Cpu.java,0,38,0,5,0,43
 druid-master\druid-master\core\src\main\java\org\apache\druid\guice\annotations\Self.java,0,2,0,2,0,4
 druid-master\druid-master\server\src\test\java\org\apache\druid\server\metrics\QueryCountStatsMonitorTest.java,0,21,0,5,0,26
 druid-master\druid-master\server\src\main\java\org\apache\druid\server\http\ClusterResource.java,0,48,0,11,0,59
 druid-master\druid-master\extensions-core\stats\src\test\java\org\apache\druid\query\aggregation\teststats\PvaluefromZscorePostAggregatorTest.java,0,26,0,6,0,32
 druid-master\druid-master\sql\src\main\java\org\apache\druid\sql\SqlRowTransformer.java,0,26,0,5,0,31
 druid-master\druid-master\sql\src\main\java\org\apache\druid\sql\calcite\aggregation\builtin\MaxSqlAggregator.java,0,10,0,5,0,15
 druid-master\druid-master\core\src\main\java\org\apache\druid\data\input\InputSourceReader.java,0,6,0,3,0,9
 druid-master\druid-master\processing\src\main\java\org\apache\druid\segment\writeout\SegmentWriteOutMedium.java,0,15,0,12,0,27
 druid-master\druid-master\server\src\test\java\org\apache\druid\metadata\BasicDataSourceExtTest.java,0,16,0,8,0,24
 druid-master\druid-master\indexing-service\src\main\java\org\apache\druid\indexing\common\actions\TimeChunkLockAcquireAction.java,0,43,0,7,0,50
 druid-master\druid-master\server\src\main\java\org\apache\druid\server\coordinator\duty\KillUnusedSegments.java,0,38,2,13,0,53
 druid-master\druid-master\extensions-core\druid-bloom-filter\src\main\java\org\apache\druid\query\aggregation\bloom\BloomFilterMergeAggregatorFactory.java,0,24,0,9,0,33
 druid-master\druid-master\processing\src\test\java\org\apache\druid\query\aggregation\hyperloglog\HyperUniquesAggregationTest.java,0,39,2,15,0,56
 druid-master\druid-master\processing\src\main\java\org\apache\druid\segment\selector\settable\SettableValueDoubleColumnValueSelector.java,0,17,1,3,0,21
 druid-master\druid-master\server\src\test\java\org\apache\druid\segment\join\LookupJoinableFactoryTest.java,0,33,0,11,0,44
 druid-master\druid-master\extensions-core\datasketches\src\test\java\org\apache\druid\query\aggregation\datasketches\hll\HllSketchToStringPostAggregatorTest.java,0,8,0,2,0,10
 druid-master\druid-master\processing\src\test\java\org\apache\druid\query\filter\JavaScriptDimFilterTest.java,0,48,0,31,0,79
 druid-master\druid-master\extensions-core\s3-extensions\src\main\java\org\apache\druid\storage\s3\NoopServerSideEncryption.java,0,1,0,1,0,2
 druid-master\druid-master\server\src\main\java\org\apache\druid\segment\realtime\firehose\WindowedStorageAdapter.java,0,20,0,1,0,21
 druid-master\druid-master\indexing-service\src\main\java\org\apache\druid\indexing\overlord\autoscaling\ProvisioningService.java,0,5,0,3,0,8
 druid-master\druid-master\benchmarks\src\test\java\org\apache\druid\server\coordinator\NewestSegmentFirstPolicyBenchmark.java,0,24,0,7,0,31
 druid-master\druid-master\extensions-core\azure-extensions\src\main\java\org\apache\druid\data\input\azure\AzureEntityFactory.java,0,3,0,1,0,4
 druid-master\druid-master\server\src\main\java\org\apache\druid\server\coordinator\rules\LoadRule.java,0,121,9,57,0,187
 druid-master\druid-master\server\src\main\java\org\apache\druid\metadata\MySQLMetadataStorageActionHandler.java,0,16,4,5,0,25
 druid-master\druid-master\server\src\test\java\org\apache\druid\indexing\overlord\SegmentPublishResultTest.java,0,14,0,4,0,18
 druid-master\druid-master\processing\src\main\java\org\apache\druid\query\spec\LegacySegmentSpec.java,0,8,1,2,0,11
 druid-master\druid-master\processing\src\main\java\org\apache\druid\query\filter\JavaScriptDimFilter.java,0,140,2,20,0,162
 druid-master\druid-master\extensions-core\s3-extensions\src\test\java\org\apache\druid\storage\s3\TestFileSessionCredentialsProvider.java,0,10,0,7,0,17
 druid-master\druid-master\server\src\test\java\org\apache\druid\client\selector\TierSelectorStrategyTest.java,0,64,0,32,0,96
 druid-master\druid-master\extensions-contrib\kafka-emitter\src\main\java\org\apache\druid\emitter\kafka\KafkaEmitterModule.java,0,14,0,3,0,17
 druid-master\druid-master\extensions-contrib\materialized-view-selection\src\main\java\org\apache\druid\query\materializedview\DataSourceOptimizerStats.java,0,45,0,1,0,46
 druid-master\druid-master\server\src\main\java\org\apache\druid\server\GuiceServletConfig.java,0,9,0,1,0,10
 druid-master\druid-master\processing\src\main\java\org\apache\druid\segment\column\BitmapIndex.java,0,46,0,12,0,58
 druid-master\druid-master\processing\src\test\java\org\apache\druid\segment\data\V3CompressedVSizeColumnarMultiIntsSerializerTest.java,0,90,3,38,0,131
 druid-master\druid-master\processing\src\main\java\org\apache\druid\segment\serde\LongNumericColumnSupplier.java,0,12,0,2,0,14
 druid-master\druid-master\core\src\main\java\org\apache\druid\java\util\metrics\AllocationMetricCollectors.java,0,15,3,7,2,27
 druid-master\druid-master\extensions-core\stats\src\main\java\org\apache\druid\query\aggregation\variance\VarianceDoubleVectorAggregator.java,0,33,1,4,0,38
 druid-master\druid-master\core\src\test\java\org\apache\druid\data\input\HandlingInputRowIteratorTest.java,0,45,0,11,2,58
 druid-master\druid-master\processing\src\test\java\org\apache\druid\query\groupby\GroupByQueryRunnerTest.java,0,3748,8,1365,0,5121
 druid-master\druid-master\processing\src\main\java\org\apache\druid\query\topn\BaseTopNAlgorithm.java,0,121,8,32,0,161
 druid-master\druid-master\extensions-core\s3-extensions\src\test\java\org\apache\druid\storage\s3\ObjectSummaryIteratorTest.java,0,51,0,17,0,68
 druid-master\druid-master\extensions-core\datasketches\src\test\java\org\apache\druid\query\aggregation\datasketches\quantiles\sql\DoublesSketchSqlAggregatorTest.java,0,224,0,104,0,328
 druid-master\druid-master\processing\src\main\java\org\apache\druid\segment\serde\ComplexMetricSerde.java,0,39,0,16,0,55
 druid-master\druid-master\processing\src\test\java\org\apache\druid\query\groupby\orderby\DefaultLimitSpecTest.java,0,72,0,33,0,105
 druid-master\druid-master\server\src\test\java\org\apache\druid\metadata\input\InputSourceModuleTest.java,0,17,1,6,0,24
 druid-master\druid-master\core\src\test\java\org\apache\druid\query\QueryTimeoutExceptionTest.java,0,6,0,2,0,8
 druid-master\druid-master\processing\src\main\java\org\apache\druid\segment\join\MapJoinableFactory.java,0,39,0,16,0,55
 druid-master\druid-master\processing\src\test\java\org\apache\druid\segment\join\table\RowBasedIndexedTableTest.java,0,76,12,12,0,100
 druid-master\druid-master\core\src\main\java\org\apache\druid\java\util\common\concurrent\ExecutorServices.java,0,10,2,2,0,14
 druid-master\druid-master\core\src\main\java\org\apache\druid\timeline\partition\PartitionChunk.java,0,12,0,11,0,23
 druid-master\druid-master\server\src\main\java\org\apache\druid\jackson\DruidServiceSerializer.java,0,26,0,9,0,35
 druid-master\druid-master\processing\src\main\java\org\apache\druid\segment\column\FloatsColumn.java,0,31,0,5,0,36
 druid-master\druid-master\sql\src\main\java\org\apache\druid\sql\calcite\expression\builtin\ArrayOffsetOperatorConversion.java,0,5,0,2,0,7
 druid-master\druid-master\indexing-service\src\main\java\org\apache\druid\indexing\firehose\WindowedSegmentId.java,0,31,0,2,0,33
 druid-master\druid-master\sql\src\test\java\org\apache\druid\sql\calcite\util\CalciteTestBase.java,0,38,0,15,0,53
 druid-master\druid-master\extensions-core\orc-extensions\src\main\java\org\apache\druid\data\input\orc\OrcInputFormat.java,0,25,1,3,0,29
 druid-master\druid-master\extensions-contrib\moving-average-query\src\main\java\org\apache\druid\query\movingaverage\RowBucketIterable.java,0,44,0,12,0,56
 druid-master\druid-master\core\src\main\java\org\apache\druid\java\util\common\guava\ExplodingSequence.java,0,29,0,4,0,33
 druid-master\druid-master\processing\src\test\java\org\apache\druid\query\aggregation\CountAggregatorTest.java,0,5,0,1,0,6
 druid-master\druid-master\server\src\main\java\org\apache\druid\server\QueryPrioritizationStrategy.java,0,6,0,6,0,12
 druid-master\druid-master\processing\src\main\java\org\apache\druid\segment\filter\DimensionPredicateFilter.java,0,98,0,12,0,110
 druid-master\druid-master\server\src\test\java\org\apache\druid\segment\loading\OmniDataSegmentArchiverTest.java,0,13,0,7,0,20
 druid-master\druid-master\extensions-core\hdfs-storage\src\main\java\org\apache\druid\firehose\hdfs\HdfsFirehoseFactory.java,0,49,0,9,0,58
 druid-master\druid-master\indexing-service\src\main\java\org\apache\druid\indexing\overlord\autoscaling\SimpleWorkerProvisioningConfig.java,0,58,2,5,0,65
 druid-master\druid-master\server\src\main\java\org\apache\druid\server\http\SelfDiscoveryResource.java,0,24,0,9,0,33
 druid-master\druid-master\processing\src\main\java\org\apache\druid\segment\serde\LargeColumnSupportedComplexColumnSerializer.java,0,46,2,6,0,54
 druid-master\druid-master\integration-tests\src\test\java\org\apache\druid\tests\indexer\ITTransformTest.java,0,38,5,17,0,60
 druid-master\druid-master\indexing-service\src\test\java\org\apache\druid\indexing\common\task\batch\parallel\RangePartitionAdjustingCorePartitionSizeTest.java,0,42,3,17,0,62
 druid-master\druid-master\processing\src\test\java\org\apache\druid\query\aggregation\any\NumericAnyVectorAggregatorTest.java,0,74,1,13,0,88
 druid-master\druid-master\extensions-core\kafka-indexing-service\src\main\java\org\apache\druid\data\input\kafka\KafkaRecordEntity.java,0,17,0,6,0,23
 druid-master\druid-master\core\src\test\java\org\apache\druid\java\util\common\logger\LoggerTest.java,0,34,0,13,1,48
 druid-master\druid-master\extensions-contrib\aliyun-oss-extensions\src\main\java\org\apache\druid\data\input\aliyun\OssEntity.java,0,19,0,3,0,22
 druid-master\druid-master\extensions-core\datasketches\src\main\java\org\apache\druid\query\aggregation\datasketches\quantiles\sql\DoublesSketchSummaryOperatorConversion.java,0,18,0,4,0,22
 druid-master\druid-master\processing\src\main\java\org\apache\druid\query\QueryMetrics.java,0,158,1,91,0,250
 druid-master\druid-master\cloud\gcp-common\src\test\java\org\apache\druid\common\gcp\GcpMockModule.java,0,18,1,3,0,22
 druid-master\druid-master\processing\src\main\java\org\apache\druid\query\aggregation\Aggregator.java,0,25,0,17,0,42
 druid-master\druid-master\extensions-core\druid-basic-security\src\main\java\org\apache\druid\security\basic\authorization\MetadataStoreRoleProvider.java,0,17,1,5,0,23
 druid-master\druid-master\extensions-core\druid-pac4j\src\test\java\org\apache\druid\security\pac4j\Pac4jSessionStoreTest.java,0,6,0,3,0,9
 druid-master\druid-master\extensions-core\protobuf-extensions\src\test\java\org\apache\druid\data\input\protobuf\SchemaRegistryBasedProtobufBytesDecoderTest.java,0,74,3,31,0,108
 druid-master\druid-master\indexing-service\src\test\java\org\apache\druid\indexing\common\task\IndexTaskSerdeTest.java,0,26,2,9,0,37
 druid-master\druid-master\indexing-service\src\test\java\org\apache\druid\indexing\common\actions\SegmentInsertActionTest.java,0,30,0,10,0,40
 druid-master\druid-master\core\src\test\java\org\apache\druid\data\input\impl\DelimitedReaderTest.java,0,52,0,21,0,73
 druid-master\druid-master\sql\src\main\java\org\apache\druid\sql\calcite\expression\builtin\MultiValueStringOperatorConversions.java,0,81,0,15,0,96
 druid-master\druid-master\processing\src\main\java\org\apache\druid\segment\vector\ReadableVectorInspector.java,0,5,0,3,0,8
 druid-master\druid-master\extensions-core\hdfs-storage\src\main\java\org\apache\druid\storage\hdfs\tasklog\HdfsTaskLogs.java,0,58,4,10,0,72
 druid-master\druid-master\extensions-core\azure-extensions\src\main\java\org\apache\druid\storage\azure\AzureUtils.java,0,39,1,12,0,52
 druid-master\druid-master\server\src\test\java\org\apache\druid\server\TestClusterQuerySegmentWalker.java,0,69,0,38,0,107
 druid-master\druid-master\core\src\main\java\org\apache\druid\collections\NonBlockingPool.java,0,2,0,1,0,3
 druid-master\druid-master\sql\src\test\java\org\apache\druid\sql\calcite\expression\OperatorConversionsTest.java,0,76,0,22,0,98
 druid-master\druid-master\processing\src\main\java\org\apache\druid\segment\data\EntireLayoutColumnarFloatsSerializer.java,0,32,0,7,0,39
 druid-master\druid-master\processing\src\main\java\org\apache\druid\segment\StringDimensionDictionary.java,0,15,0,4,0,19
 druid-master\druid-master\benchmarks\src\test\java\org\apache\druid\benchmark\indexing\IndexMergeBenchmark.java,0,41,5,8,0,54
 druid-master\druid-master\processing\src\main\java\org\apache\druid\query\search\FragmentSearchQuerySpec.java,0,41,0,3,0,44
 druid-master\druid-master\processing\src\main\java\org\apache\druid\query\aggregation\last\StringLastBufferAggregator.java,0,51,0,8,0,59
 druid-master\druid-master\extensions-contrib\moving-average-query\src\main\java\org\apache\druid\query\movingaverage\averagers\DoubleMeanNoNullAverager.java,0,10,1,2,0,13
 druid-master\druid-master\sql\src\main\java\org\apache\druid\sql\calcite\expression\builtin\TimestampToMillisOperatorConversion.java,0,9,0,4,0,13
 druid-master\druid-master\indexing-service\src\test\java\org\apache\druid\indexing\common\task\TaskReportSerdeTest.java,0,10,0,2,0,12
 druid-master\druid-master\core\src\test\java\org\apache\druid\java\util\metrics\MonitorUtilsTest.java,0,5,0,3,0,8
 druid-master\druid-master\extensions-contrib\graphite-emitter\src\main\java\org\apache\druid\emitter\graphite\GraphiteEmitter.java,0,57,13,14,0,84
 druid-master\druid-master\services\src\main\java\org\apache\druid\cli\validate\DruidJsonValidator.java,0,51,1,17,0,69
 druid-master\druid-master\processing\src\main\java\org\apache\druid\query\timeboundary\TimeBoundaryResultValue.java,0,26,0,1,0,27
 druid-master\druid-master\server\src\main\java\org\apache\druid\guice\security\EscalatorModule.java,0,4,0,1,0,5
 druid-master\druid-master\extensions-contrib\moving-average-query\src\main\java\org\apache\druid\query\movingaverage\PostAveragerAggregatorCalculator.java,0,10,0,3,0,13
 druid-master\druid-master\server\src\test\java\org\apache\druid\server\StatusResourceTest.java,0,13,0,9,0,22
 druid-master\druid-master\extensions-core\google-extensions\src\main\java\org\apache\druid\storage\google\GoogleDataSegmentKiller.java,0,33,3,7,0,43
 druid-master\druid-master\extensions-core\avro-extensions\src\test\java\org\apache\druid\data\input\avro\InlineSchemaAvroBytesDecoderTest.java,0,9,0,5,0,14
 druid-master\druid-master\processing\src\test\java\org\apache\druid\query\dimension\ListFilteredDimensionSpecDimensionSelectorTest.java,0,56,0,11,0,67
 druid-master\druid-master\server\src\test\java\org\apache\druid\segment\realtime\appenderator\SegmentIdWithShardSpecTest.java,0,20,0,9,0,29
 druid-master\druid-master\extensions-core\lookups-cached-single\src\test\java\org\apache\druid\server\lookup\LoadingLookupFactoryTest.java,0,41,3,6,0,50
 druid-master\druid-master\processing\src\test\java\org\apache\druid\segment\join\filter\rewrite\RhsRewriteCandidatesTest.java,0,4,0,2,0,6
 druid-master\druid-master\indexing-hadoop\src\main\java\org\apache\druid\indexer\IndexGeneratorJob.java,0,225,14,89,0,328
 druid-master\druid-master\server\src\test\java\org\apache\druid\segment\loading\CacheTestSegmentCacheManager.java,0,21,0,1,0,22
 druid-master\druid-master\core\src\main\java\org\apache\druid\java\util\emitter\service\ServiceMetricEvent.java,0,73,0,3,1,77
 druid-master\druid-master\processing\src\main\java\org\apache\druid\query\aggregation\LongSumBufferAggregator.java,0,11,0,1,0,12
 druid-master\druid-master\extensions-contrib\cassandra-storage\src\main\java\org\apache\druid\storage\cassandra\CassandraStorage.java,0,28,1,7,0,36
 druid-master\druid-master\extensions-contrib\moving-average-query\src\main\java\org\apache\druid\query\movingaverage\averagers\AveragerFactory.java,0,15,0,13,0,28
 druid-master\druid-master\indexing-service\src\main\java\org\apache\druid\indexing\overlord\autoscaling\Provisioner.java,0,4,0,1,0,5
 druid-master\druid-master\extensions-core\druid-basic-security\src\main\java\org\apache\druid\security\basic\authentication\LdapUserPrincipal.java,0,57,0,5,0,62
 druid-master\druid-master\processing\src\main\java\org\apache\druid\segment\IntListUtils.java,0,17,0,1,0,18
 druid-master\druid-master\processing\src\main\java\org\apache\druid\segment\SimpleDescendingOffset.java,0,33,3,1,0,37
 druid-master\druid-master\server\src\main\java\org\apache\druid\server\log\RequestLogEvent.java,0,1,0,1,0,2
 druid-master\druid-master\cloud\aws-common\src\main\java\org\apache\druid\common\aws\ConfigDrivenAwsCredentialsConfigProvider.java,0,14,1,3,0,18
 druid-master\druid-master\processing\src\test\java\org\apache\druid\query\lookup\LookupSegmentTest.java,0,69,12,22,0,103
 druid-master\druid-master\integration-tests\src\test\java\org\apache\druid\tests\hadoop\ITGcsInputToGcsHadoopIndexTest.java,0,16,0,13,0,29
 druid-master\druid-master\extensions-core\druid-basic-security\src\main\java\org\apache\druid\security\basic\authorization\BasicRoleBasedAuthorizer.java,0,36,1,9,0,46
 druid-master\druid-master\hll\src\main\java\org\apache\druid\hll\HyperLogLogCollector.java,0,216,5,52,4,277
 druid-master\druid-master\processing\src\main\java\org\apache\druid\segment\vector\VectorObjectSelector.java,0,3,0,2,0,5
 druid-master\druid-master\core\src\test\java\org\apache\druid\data\input\impl\InputEntityIteratingReaderTest.java,0,17,0,12,0,29
 druid-master\druid-master\indexing-service\src\main\java\org\apache\druid\indexing\overlord\MetadataTaskStorage.java,0,86,5,16,0,107
 druid-master\druid-master\server\src\test\java\org\apache\druid\guice\DruidProcessingModuleTest.java,0,11,0,1,0,12
 druid-master\druid-master\processing\src\main\java\org\apache\druid\segment\AbstractIndex.java,0,7,0,3,0,10
 druid-master\druid-master\extensions-core\kubernetes-extensions\src\main\java\org\apache\druid\k8s\discovery\K8sDruidNodeDiscoveryProvider.java,0,115,4,23,0,142
 druid-master\druid-master\extensions-core\druid-basic-security\src\main\java\org\apache\druid\security\basic\authentication\db\cache\NoopBasicAuthenticatorCacheNotifier.java,0,9,0,5,0,14
 druid-master\druid-master\sql\src\main\java\org\apache\druid\sql\calcite\aggregation\DimensionExpression.java,0,48,1,6,0,55
 druid-master\druid-master\extensions-core\druid-basic-security\src\main\java\org\apache\druid\security\basic\authentication\db\cache\MetadataStoragePollingBasicAuthenticatorCacheManager.java,0,19,1,8,0,28
 druid-master\druid-master\core\src\test\java\org\apache\druid\java\util\emitter\core\MockHttpClient.java,0,15,3,1,2,21
 druid-master\druid-master\processing\src\main\java\org\apache\druid\segment\loading\MMappedQueryableSegmentizerFactory.java,0,15,0,3,0,18
 druid-master\druid-master\extensions-contrib\distinctcount\src\test\java\org\apache\druid\query\aggregation\distinctcount\DistinctCountTimeseriesQueryTest.java,0,13,2,6,0,21
 druid-master\druid-master\indexing-service\src\main\java\org\apache\druid\indexing\input\InputRowSchemas.java,0,18,1,7,0,26
 druid-master\druid-master\processing\src\main\java\org\apache\druid\query\QueryDataSource.java,0,31,1,2,0,34
 druid-master\druid-master\indexing-service\src\test\java\org\apache\druid\indexing\worker\shuffle\ShuffleModuleTest.java,0,18,0,5,0,23
 druid-master\druid-master\core\src\main\java\org\apache\druid\java\util\emitter\service\ServiceEmitter.java,0,34,0,1,0,35
 druid-master\druid-master\processing\src\main\java\org\apache\druid\query\aggregation\last\FloatLastAggregatorFactory.java,0,103,0,16,0,119
 druid-master\druid-master\indexing-service\src\main\java\org\apache\druid\indexing\common\TaskLock.java,0,14,0,2,0,16
 druid-master\druid-master\core\src\main\java\org\apache\druid\indexer\partitions\PartitionsSpec.java,0,32,0,15,0,47
 druid-master\druid-master\benchmarks\src\test\java\org\apache\druid\benchmark\package-info.java,0,1,0,1,0,2
 druid-master\druid-master\core\src\main\java\org\apache\druid\java\util\common\IAE.java,0,10,0,1,0,11
 druid-master\druid-master\indexing-service\src\main\java\org\apache\druid\indexing\seekablestream\supervisor\SeekableStreamSupervisorSpec.java,0,94,1,14,0,109
 druid-master\druid-master\core\src\main\java\org\apache\druid\query\QueryTimeoutException.java,0,24,0,5,0,29
 druid-master\druid-master\extensions-contrib\tdigestsketch\src\main\java\org\apache\druid\query\aggregation\tdigestsketch\TDigestSketchAggregator.java,0,25,0,7,0,32
 druid-master\druid-master\core\src\test\java\org\apache\druid\data\input\impl\NoopFirehoseFactory.java,0,12,0,1,0,13
 druid-master\druid-master\processing\src\main\java\org\apache\druid\segment\Cursor.java,0,13,0,6,0,19
 druid-master\druid-master\indexing-service\src\main\java\org\apache\druid\indexing\overlord\http\OverlordResource.java,0,270,4,88,0,362
 druid-master\druid-master\processing\src\test\java\org\apache\druid\segment\data\GenericIndexedTest.java,0,31,2,10,0,43
 druid-master\druid-master\extensions-contrib\materialized-view-maintenance\src\test\java\org\apache\druid\indexing\materializedview\MaterializedViewSupervisorTest.java,0,73,0,33,0,106
 druid-master\druid-master\processing\src\main\java\org\apache\druid\query\aggregation\CountAggregator.java,0,19,2,1,0,22
 druid-master\druid-master\extensions-core\druid-bloom-filter\src\test\java\org\apache\druid\query\filter\BloomDimFilterTest.java,0,204,0,65,0,269
 druid-master\druid-master\processing\src\main\java\org\apache\druid\segment\data\BitmapValues.java,0,8,0,2,0,10
 druid-master\druid-master\sql\src\main\java\org\apache\druid\sql\calcite\rule\DruidTableScanRule.java,0,7,0,1,0,8
 druid-master\druid-master\server\src\main\java\org\apache\druid\curator\discovery\ServerDiscoverySelector.java,0,36,1,5,0,42
 druid-master\druid-master\processing\src\main\java\org\apache\druid\query\dimension\ListFilteredDimensionSpec.java,0,64,2,11,0,77
 druid-master\druid-master\indexing-service\src\main\java\org\apache\druid\indexing\common\task\batch\parallel\PartitionLocation.java,0,9,0,5,0,14
 druid-master\druid-master\indexing-hadoop\src\test\java\org\apache\druid\indexer\HadoopIngestionSpecUpdateDatasourcePathSpecSegmentsTest.java,0,51,0,26,0,77
 druid-master\druid-master\processing\src\main\java\org\apache\druid\query\filter\DimFilter.java,0,52,1,20,0,73
 druid-master\druid-master\processing\src\main\java\org\apache\druid\segment\join\PossiblyNullDimensionSelector.java,0,58,1,9,0,68
 druid-master\druid-master\server\src\main\java\org\apache\druid\server\log\LoggingRequestLoggerProvider.java,0,13,0,3,0,16
 druid-master\druid-master\processing\src\test\java\org\apache\druid\query\groupby\epinephelinae\GrouperTestUtil.java,0,7,1,1,0,9
 druid-master\druid-master\processing\src\main\java\org\apache\druid\query\filter\InDimFilter.java,0,197,1,57,0,255
 druid-master\druid-master\server\src\test\java\org\apache\druid\initialization\ZkPathsConfigTest.java,0,15,0,13,0,28
 druid-master\druid-master\sql\src\main\java\org\apache\druid\sql\calcite\expression\builtin\TrimOperatorConversion.java,0,10,0,4,0,14
 druid-master\druid-master\server\src\main\java\org\apache\druid\segment\realtime\appenderator\Committed.java,0,44,0,3,0,47
 druid-master\druid-master\core\src\main\java\org\apache\druid\java\util\common\guava\LazySequence.java,0,17,0,3,0,20
 druid-master\druid-master\hll\src\main\java\org\apache\druid\hll\VersionZeroHyperLogLogCollector.java,0,56,5,6,0,67
 druid-master\druid-master\indexing-hadoop\src\test\java\org\apache\druid\indexer\path\HadoopGlobPathSplitterTest.java,0,5,0,1,0,6
 druid-master\druid-master\extensions-contrib\cassandra-storage\src\main\java\org\apache\druid\storage\cassandra\CassandraDruidModule.java,0,13,0,2,1,16
 druid-master\druid-master\processing\src\test\java\org\apache\druid\query\scan\ScanQueryRunnerFactoryTest.java,0,76,0,32,0,108
 druid-master\druid-master\server\src\main\java\org\apache\druid\server\security\TLSUtils.java,0,132,4,24,0,160
 druid-master\druid-master\server\src\main\java\org\apache\druid\client\cache\CaffeineCache.java,0,60,2,21,0,83
 druid-master\druid-master\server\src\main\java\org\apache\druid\server\coordinator\cost\package-info.java,0,1,0,1,0,2
 druid-master\druid-master\extensions-core\lookups-cached-global\src\main\java\org\apache\druid\server\lookup\namespace\StaticMapCacheGenerator.java,0,10,1,5,0,16
 druid-master\druid-master\core\src\main\java\org\apache\druid\data\input\impl\LongDimensionSchema.java,0,8,0,1,0,9
 druid-master\druid-master\extensions-core\stats\src\main\java\org\apache\druid\query\aggregation\variance\sql\BaseVarianceSqlAggregator.java,0,39,0,8,0,47
 druid-master\druid-master\server\src\main\java\org\apache\druid\indexing\worker\config\WorkerConfig.java,0,43,0,3,0,46
 druid-master\druid-master\extensions-core\datasketches\src\main\java\org\apache\druid\query\aggregation\datasketches\quantiles\DoublesSketchMergeAggregator.java,0,20,0,2,0,22
 druid-master\druid-master\integration-tests\src\test\java\org\apache\druid\tests\indexer\ITIndexerTest.java,0,103,13,45,0,161
 druid-master\druid-master\benchmarks\src\test\java\org\apache\druid\benchmark\MemoryBenchmark.java,0,67,10,7,0,84
 druid-master\druid-master\extensions-core\kubernetes-extensions\src\test\java\org\apache\druid\k8s\discovery\NoopServiceEmitter.java,0,5,1,1,0,7
 druid-master\druid-master\processing\src\main\java\org\apache\druid\segment\data\ColumnarDoublesSerializer.java,0,4,0,1,0,5
 druid-master\druid-master\server\src\test\java\org\apache\druid\server\coordinator\BalanceSegmentsProfiler.java,0,52,5,16,0,73
 druid-master\druid-master\extensions-core\histogram\src\test\java\org\apache\druid\query\aggregation\histogram\FixedBucketsHistogramAggregationTest.java,0,35,0,13,0,48
 druid-master\druid-master\extensions-core\avro-extensions\src\main\java\org\apache\druid\data\input\avro\InlineSchemaAvroBytesDecoder.java,0,24,0,4,0,28
 druid-master\druid-master\extensions-contrib\aliyun-oss-extensions\src\main\java\org\apache\druid\firehose\aliyun\OssFirehoseDruidModule.java,0,7,1,2,0,10
 druid-master\druid-master\core\src\main\java\org\apache\druid\io\Channels.java,0,7,0,2,0,9
 druid-master\druid-master\processing\src\main\java\org\apache\druid\query\groupby\epinephelinae\vector\FloatGroupByVectorColumnSelector.java,0,12,0,2,0,14
 druid-master\druid-master\indexing-service\src\main\java\org\apache\druid\indexing\common\task\batch\parallel\ShuffleClient.java,0,9,0,4,0,13
 druid-master\druid-master\extensions-core\avro-extensions\target\generated-test-sources\avro\org\apache\druid\data\input\MyFixed.java,0,19,3,4,0,26
 druid-master\druid-master\processing\src\test\java\org\apache\druid\query\groupby\epinephelinae\GroupByQueryEngineV2Test.java,0,60,0,43,0,103
 druid-master\druid-master\core\src\main\java\org\apache\druid\java\util\common\guava\MappingYieldingAccumulator.java,0,23,3,2,0,28
 druid-master\druid-master\server\src\test\java\org\apache\druid\server\http\ServersResourceTest.java,0,42,0,21,0,63
 druid-master\druid-master\core\src\test\java\org\apache\druid\common\utils\UUIDUtilsTest.java,0,31,0,4,1,36
 druid-master\druid-master\indexing-service\src\main\java\org\apache\druid\indexing\worker\shuffle\DeepStorageIntermediaryDataManager.java,0,37,0,10,0,47
 druid-master\druid-master\server\src\test\java\org\apache\druid\client\cache\CacheDistributionTest.java,0,36,0,6,0,42
 druid-master\druid-master\core\src\test\java\org\apache\druid\java\util\common\guava\TopNSequenceTest.java,0,47,0,9,2,58
 druid-master\druid-master\services\src\main\java\org\apache\druid\cli\convert\PropertyConverter.java,0,3,0,1,0,4
 druid-master\druid-master\server\src\test\java\org\apache\druid\client\JsonParserIteratorTest.java,0,72,1,19,0,92
 druid-master\druid-master\core\src\main\java\org\apache\druid\data\input\InputSource.java,0,13,0,10,0,23
 druid-master\druid-master\processing\src\main\java\org\apache\druid\query\aggregation\cardinality\vector\SingleValueStringCardinalityVectorProcessor.java,0,32,0,14,0,46
 druid-master\druid-master\processing\src\main\java\org\apache\druid\query\extraction\LowerExtractionFn.java,0,25,0,4,0,29
 druid-master\druid-master\extensions-core\azure-extensions\src\test\java\org\apache\druid\storage\azure\AzureUtilsTest.java,0,65,11,19,0,95
 druid-master\druid-master\indexing-service\src\test\java\org\apache\druid\indexing\common\actions\SegmentTransactionalInsertActionTest.java,0,50,0,21,0,71
 druid-master\druid-master\indexing-service\src\test\java\org\apache\druid\indexing\overlord\ImmutableWorkerInfoTest.java,0,60,19,21,0,100
 druid-master\druid-master\sql\src\main\java\org\apache\druid\sql\calcite\parser\DruidSqlInsert.java,0,41,0,10,0,51
 druid-master\druid-master\processing\src\test\java\org\apache\druid\query\search\SearchQueryTest.java,0,12,0,5,0,17
 druid-master\druid-master\processing\src\main\java\org\apache\druid\query\aggregation\NullableNumericAggregateCombiner.java,0,21,0,4,0,25
 druid-master\druid-master\processing\src\main\java\org\apache\druid\query\topn\TopNMapFn.java,0,16,0,4,0,20
 druid-master\druid-master\processing\src\test\java\org\apache\druid\query\aggregation\any\StringAnyVectorAggregatorTest.java,0,59,0,10,0,69
 druid-master\druid-master\processing\src\test\java\org\apache\druid\segment\filter\SpatialFilterTest.java,0,111,1,22,0,134
 druid-master\druid-master\indexing-service\src\test\java\org\apache\druid\indexing\common\task\IndexTaskTest.java,0,487,7,263,0,757
 druid-master\druid-master\sql\src\test\java\org\apache\druid\sql\calcite\schema\DruidSchemaTestCommon.java,0,44,0,9,0,53
 druid-master\druid-master\indexing-service\src\main\java\org\apache\druid\indexing\common\task\TaskLockHelper.java,0,111,0,40,0,151
 druid-master\druid-master\processing\src\main\java\org\apache\druid\segment\RowCombiningTimeAndDimsIterator.java,0,106,0,69,0,175
 druid-master\druid-master\benchmarks\src\test\java\org\apache\druid\benchmark\DataSketchesHllBenchmark.java,0,33,0,6,0,39
 druid-master\druid-master\processing\src\main\java\org\apache\druid\segment\incremental\package-info.java,0,1,0,1,0,2
 druid-master\druid-master\server\src\test\java\org\apache\druid\segment\realtime\firehose\SqlFirehoseFactoryTest.java,0,50,3,11,0,64
 druid-master\druid-master\server\src\main\java\org\apache\druid\server\coordinator\BalancerStrategy.java,0,50,0,36,0,86
 druid-master\druid-master\core\src\test\java\org\apache\druid\java\util\metrics\CgroupCpuSetMonitorTest.java,0,23,2,9,1,35
 druid-master\druid-master\core\src\main\java\org\apache\druid\java\util\common\HumanReadableBytesRange.java,0,21,0,5,0,26
 druid-master\druid-master\processing\src\main\java\org\apache\druid\segment\vector\ReadableVectorOffset.java,0,10,0,7,0,17
 druid-master\druid-master\server\src\main\java\org\apache\druid\client\cache\CacheExecutorFactory.java,0,12,0,2,0,14
 druid-master\druid-master\extensions-core\datasketches\src\test\java\org\apache\druid\query\aggregation\datasketches\hll\HllSketchBuildAggregatorTest.java,0,47,0,4,0,51
 druid-master\druid-master\extensions-core\stats\src\test\java\org\apache\druid\query\aggregation\variance\VarianceDoubleVectorAggregatorTest.java,0,58,0,11,0,69
 druid-master\druid-master\sql\src\main\java\org\apache\druid\sql\calcite\expression\builtin\TimeArithmeticOperatorConversion.java,0,39,0,18,0,57
 druid-master\druid-master\indexing-hadoop\src\test\java\org\apache\druid\indexer\InputRowSerdeTest.java,0,80,0,32,0,112
 druid-master\druid-master\processing\src\main\java\org\apache\druid\segment\incremental\RowIngestionMetersTotals.java,0,39,0,1,0,40
 druid-master\druid-master\sql\src\main\java\org\apache\druid\sql\calcite\rel\CostEstimates.java,0,14,1,10,0,25
 druid-master\druid-master\processing\src\main\java\org\apache\druid\query\groupby\epinephelinae\column\FloatGroupByColumnSelectorStrategy.java,0,48,0,9,0,57
 druid-master\druid-master\sql\src\main\java\org\apache\druid\sql\avatica\DruidAvaticaProtobufHandler.java,0,10,0,4,0,14
 druid-master\druid-master\processing\src\main\java\org\apache\druid\segment\incremental\AppendableIndexSpec.java,0,4,0,2,0,6
 druid-master\druid-master\sql\src\main\java\org\apache\druid\sql\calcite\rule\DruidLogicalValuesRule.java,0,24,0,10,0,34
 druid-master\druid-master\processing\src\main\java\org\apache\druid\segment\data\BlockLayoutColumnarLongsSerializer.java,0,42,0,9,0,51
 druid-master\druid-master\integration-tests\src\test\java\org\apache\druid\tests\indexer\ITHdfsToHdfsParallelIndexTest.java,0,16,0,7,0,23
 druid-master\druid-master\core\src\test\java\org\apache\druid\query\QueryExceptionTest.java,0,18,0,7,0,25
 druid-master\druid-master\indexing-service\src\test\java\org\apache\druid\indexing\common\task\batch\parallel\ParallelIndexPhaseRunnerTest.java,0,80,3,13,0,96
 druid-master\druid-master\extensions-core\datasketches\src\test\java\org\apache\druid\query\aggregation\datasketches\tuple\ArrayOfDoublesSketchTTestPostAggregatorTest.java,0,35,0,17,0,52
 druid-master\druid-master\core\src\test\java\org\apache\druid\utils\CloseableUtilsTest.java,0,134,24,35,0,193
 druid-master\druid-master\extensions-core\parquet-extensions\src\main\java\org\apache\druid\data\input\parquet\ParquetInputFormat.java,0,26,1,2,0,29
 druid-master\druid-master\server\src\test\java\org\apache\druid\client\indexing\ClientCompactionTaskTransformSpecTest.java,0,12,0,5,0,17
 druid-master\druid-master\server\src\main\java\org\apache\druid\client\cache\LocalCacheProvider.java,0,9,0,2,0,11
 druid-master\druid-master\server\src\main\java\org\apache\druid\guice\annotations\LoadScope.java,0,5,0,4,0,9
 druid-master\druid-master\processing\src\main\java\org\apache\druid\query\ForwardingQueryProcessingPool.java,0,14,0,4,0,18
 druid-master\druid-master\processing\src\main\java\org\apache\druid\query\ordering\StringComparators.java,0,138,23,16,0,177
 druid-master\druid-master\processing\src\main\java\org\apache\druid\query\DirectQueryProcessingPool.java,0,13,1,4,0,18
 druid-master\druid-master\core\src\test\java\org\apache\druid\java\util\common\IntervalsByGranularityTest.java,0,48,0,16,1,65
 druid-master\druid-master\benchmarks\src\test\java\org\apache\druid\benchmark\sequences\ParallelMergeCombiningSequenceBenchmark.java,0,75,1,40,0,116
 druid-master\druid-master\server\src\test\java\org\apache\druid\guice\JsonConfigTesterBase.java,0,37,3,7,0,47
 druid-master\druid-master\server\src\main\java\org\apache\druid\segment\loading\StorageLocationSelectorStrategy.java,0,15,0,14,0,29
 druid-master\druid-master\extensions-core\parquet-extensions\src\test\java\org\apache\druid\data\input\parquet\TimestampsParquetReaderTest.java,0,25,0,18,0,43
 druid-master\druid-master\indexing-service\src\test\java\org\apache\druid\indexing\worker\shuffle\ShuffleMetricsTest.java,0,54,0,16,0,70
 druid-master\druid-master\processing\src\main\java\org\apache\druid\query\groupby\epinephelinae\SpillingGrouper.java,0,96,7,34,0,137
 druid-master\druid-master\server\src\main\java\org\apache\druid\discovery\DruidNodeDiscovery.java,0,14,0,6,0,20
 druid-master\druid-master\server\src\main\java\org\apache\druid\segment\realtime\firehose\LocalFirehoseFactory.java,0,39,0,4,0,43
 druid-master\druid-master\server\src\test\java\org\apache\druid\server\SegmentManagerBroadcastJoinIndexedTableTest.java,0,87,2,42,0,131
 druid-master\druid-master\indexing-service\src\test\java\org\apache\druid\indexing\common\actions\TimeChunkLockTryAcquireActionTest.java,0,22,0,10,0,32
 druid-master\druid-master\server\src\main\java\org\apache\druid\server\security\Escalator.java,0,9,0,9,0,18
 druid-master\druid-master\server\src\main\java\org\apache\druid\client\FilteringSegmentCallback.java,0,23,0,5,0,28
 druid-master\druid-master\core\src\main\java\org\apache\druid\java\util\emitter\core\LoggingEmitter.java,0,46,10,2,1,59
 druid-master\druid-master\core\src\main\java\org\apache\druid\common\utils\IntArrayUtils.java,0,9,1,1,0,11
 druid-master\druid-master\indexing-service\src\test\java\org\apache\druid\indexing\common\task\batch\parallel\DimensionCardinalityReportTest.java,0,29,0,11,0,40
 druid-master\druid-master\indexing-service\src\main\java\org\apache\druid\indexing\overlord\autoscaling\ProvisioningSchedulerConfig.java,0,17,0,1,0,18
 druid-master\druid-master\core\src\test\java\org\apache\druid\data\input\impl\CloudObjectLocationTest.java,0,34,0,15,1,50
 druid-master\druid-master\extensions-core\lookups-cached-single\src\main\java\org\apache\druid\server\lookup\LookupExtractionModule.java,0,10,1,1,0,12
 druid-master\druid-master\server\src\main\java\org\apache\druid\metadata\IndexerSQLMetadataStorageCoordinator.java,0,320,11,174,0,505
 druid-master\druid-master\processing\src\test\java\org\apache\druid\collections\spatial\ImmutableRTreeTest.java,0,373,4,40,0,417
 druid-master\druid-master\extensions-core\datasketches\src\main\java\org\apache\druid\query\aggregation\datasketches\hll\HllSketchBuildAggregator.java,0,18,0,2,0,20
 druid-master\druid-master\sql\src\test\java\org\apache\druid\sql\calcite\rule\DruidJoinRuleTest.java,0,51,9,13,0,73
 druid-master\druid-master\sql\src\main\java\org\apache\druid\sql\calcite\rel\DruidRels.java,0,21,2,13,0,36
 druid-master\druid-master\core\src\main\java\org\apache\druid\query\SegmentDescriptor.java,0,42,1,9,0,52
 druid-master\druid-master\core\src\main\java\org\apache\druid\annotations\UsedByJUnitParamsRunner.java,0,3,0,3,0,6
 druid-master\druid-master\server\src\test\java\org\apache\druid\server\log\LoggingRequestLoggerTest.java,0,101,2,20,0,123
 druid-master\druid-master\extensions-core\ec2-extensions\src\main\java\org\apache\druid\indexing\overlord\autoscaling\ec2\StringEC2UserData.java,0,39,1,3,0,43
 druid-master\druid-master\processing\src\main\java\org\apache\druid\query\extraction\MatchingDimExtractionFn.java,0,26,1,1,0,28
 druid-master\druid-master\extensions-core\postgresql-metadata-storage\src\main\java\org\apache\druid\firehose\PostgresqlFirehoseDatabaseConnector.java,0,33,0,7,0,40
 druid-master\druid-master\server\src\test\java\org\apache\druid\client\cache\CacheMonitorTest.java,0,13,0,5,0,18
 druid-master\druid-master\server\src\test\java\org\apache\druid\server\coordinator\DruidCoordinatorTest.java,0,316,4,175,0,495
 druid-master\druid-master\processing\src\main\java\org\apache\druid\query\aggregation\last\LongLastBufferAggregator.java,0,32,0,4,0,36
 druid-master\druid-master\processing\src\main\java\org\apache\druid\query\metadata\metadata\SegmentAnalysis.java,0,92,0,10,0,102
 druid-master\druid-master\server\src\test\java\org\apache\druid\client\SimpleServerView.java,0,70,0,15,0,85
 druid-master\druid-master\extensions-core\kafka-indexing-service\src\main\java\org\apache\druid\indexing\kafka\supervisor\KafkaSupervisorIngestionSpec.java,0,20,0,4,0,24
 druid-master\druid-master\sql\src\main\java\org\apache\druid\sql\calcite\schema\DruidSchema.java,0,229,20,123,0,372
 druid-master\druid-master\server\src\main\java\org\apache\druid\segment\realtime\firehose\EventReceiverFirehoseFactory.java,0,209,7,110,0,326
 druid-master\druid-master\processing\src\test\java\org\apache\druid\segment\DebugRow.java,0,17,0,1,0,18
 druid-master\druid-master\services\src\test\java\org\apache\druid\cli\PullDependenciesTest.java,0,96,6,43,0,145
 druid-master\druid-master\indexing-service\src\main\java\org\apache\druid\indexing\common\actions\SegmentLockAcquireAction.java,0,54,0,4,0,58
 druid-master\druid-master\indexing-service\src\main\java\org\apache\druid\indexing\common\task\IndexTask.java,0,590,9,185,0,784
 druid-master\druid-master\processing\src\main\java\org\apache\druid\query\search\SearchQueryMetrics.java,0,3,0,2,0,5
 druid-master\druid-master\server\src\main\java\org\apache\druid\server\lookup\cache\LookupCoordinatorManagerConfig.java,0,53,0,3,0,56
 druid-master\druid-master\extensions-core\datasketches\src\main\java\org\apache\druid\query\aggregation\datasketches\tuple\ArrayOfDoublesSketchOperations.java,0,31,1,13,0,45
 druid-master\druid-master\processing\src\main\java\org\apache\druid\query\aggregation\NoopVectorAggregator.java,0,17,1,3,0,21
 druid-master\druid-master\benchmarks\src\test\java\org\apache\druid\benchmark\compression\LongCompressionBenchmark.java,0,31,1,3,0,35
 druid-master\druid-master\indexing-hadoop\src\main\java\org\apache\druid\indexer\HadoopDruidDetermineConfigurationJob.java,0,27,1,5,0,33
 druid-master\druid-master\processing\src\main\java\org\apache\druid\query\aggregation\DoubleMinVectorAggregator.java,0,16,0,3,0,19
 druid-master\druid-master\extensions-core\datasketches\src\main\java\org\apache\druid\query\aggregation\datasketches\hll\HllSketchBuildBufferAggregator.java,0,29,0,8,0,37
 druid-master\druid-master\processing\src\test\java\org\apache\druid\segment\generator\GeneratorColumnSchemaTest.java,0,9,0,2,0,11
 druid-master\druid-master\processing\src\main\java\org\apache\druid\query\timeseries\TimeseriesBinaryFn.java,0,17,1,4,0,22
 druid-master\druid-master\processing\src\main\java\org\apache\druid\segment\VectorColumnProcessorFactory.java,0,51,0,29,0,80
 druid-master\druid-master\processing\src\main\java\org\apache\druid\guice\ModulesConfig.java,0,10,0,3,0,13
 druid-master\druid-master\indexing-service\src\main\java\org\apache\druid\server\initialization\IndexerZkConfig.java,0,49,1,6,0,56
 druid-master\druid-master\core\src\main\java\org\apache\druid\data\input\impl\DimensionsSpec.java,0,125,0,15,8,148
 druid-master\druid-master\extensions-core\druid-basic-security\src\main\java\org\apache\druid\security\basic\authorization\RoleProvider.java,0,6,0,4,0,10
 druid-master\druid-master\server\src\test\java\org\apache\druid\segment\realtime\FireHydrantTest.java,0,50,2,19,0,71
 druid-master\druid-master\processing\src\main\java\org\apache\druid\query\extraction\StrlenExtractionFn.java,0,14,1,1,0,16
 druid-master\druid-master\sql\src\main\java\org\apache\druid\sql\calcite\rel\PartialDruidQuery.java,0,114,2,16,0,132
 druid-master\druid-master\processing\src\main\java\org\apache\druid\segment\filter\ColumnComparisonFilter.java,0,73,0,15,0,88
 druid-master\druid-master\processing\src\main\java\org\apache\druid\segment\EncodedKeyComponent.java,0,17,0,6,0,23
 druid-master\druid-master\benchmarks\src\test\java\org\apache\druid\benchmark\GenericIndexedBenchmark.java,0,47,3,8,0,58
 druid-master\druid-master\processing\src\main\java\org\apache\druid\segment\selector\settable\SettableFloatColumnValueSelector.java,0,11,0,2,0,13
 druid-master\druid-master\processing\src\main\java\org\apache\druid\segment\IntIteratorUtils.java,0,62,0,16,0,78
 druid-master\druid-master\processing\src\main\java\org\apache\druid\segment\serde\Serializer.java,0,7,0,4,0,11
 druid-master\druid-master\server\src\main\java\org\apache\druid\client\indexing\ClientCompactionTaskDimensionsSpec.java,0,24,0,7,0,31
 druid-master\druid-master\services\src\main\java\org\apache\druid\cli\QueryJettyServerInitializer.java,0,33,0,14,0,47
 druid-master\druid-master\processing\src\main\java\org\apache\druid\query\aggregation\any\LongAnyVectorAggregator.java,0,20,0,2,0,22
 druid-master\druid-master\extensions-core\datasketches\src\test\java\org\apache\druid\query\aggregation\datasketches\quantiles\DoublesSketchAggregatorTest.java,0,195,0,87,0,282
 druid-master\druid-master\core\src\main\java\org\apache\druid\io\ByteBufferInputStream.java,0,16,0,3,1,20
 druid-master\druid-master\core\src\main\java\org\apache\druid\math\expr\InputBindings.java,0,59,1,10,0,70
 druid-master\druid-master\extensions-core\stats\src\main\java\org\apache\druid\query\aggregation\variance\VarianceFoldingAggregatorFactory.java,0,6,0,1,0,7
 druid-master\druid-master\extensions-core\ec2-extensions\src\main\java\org\apache\druid\indexing\overlord\autoscaling\ec2\EC2AutoScaler.java,0,92,1,9,0,102
 druid-master\druid-master\extensions-contrib\momentsketch\src\test\java\org\apache\druid\query\aggregation\momentsketch\aggregator\MomentSketchQuantilePostAggregatorTest.java,0,25,0,7,0,32
 druid-master\druid-master\core\src\main\java\org\apache\druid\java\util\http\client\pool\ResourceFactory.java,0,6,0,1,0,7
 druid-master\druid-master\core\src\main\java\org\apache\druid\java\util\metrics\PidDiscoverer.java,0,2,0,1,0,3
 druid-master\druid-master\server\src\main\java\org\apache\druid\server\coordination\DataSegmentAnnouncer.java,0,5,0,1,0,6
 druid-master\druid-master\server\src\test\java\org\apache\druid\segment\loading\SegmentLocalCacheLoaderTest.java,0,19,2,10,0,31
 druid-master\druid-master\indexing-hadoop\src\main\java\org\apache\druid\indexer\HadoopDruidIndexerJob.java,0,35,2,7,0,44
 druid-master\druid-master\extensions-core\histogram\src\main\java\org\apache\druid\query\aggregation\histogram\ApproximateHistogramFoldingSerde.java,0,39,1,11,0,51
 druid-master\druid-master\core\src\main\java\org\apache\druid\data\input\impl\LocalInputSource.java,0,70,0,11,1,82
 druid-master\druid-master\processing\src\main\java\org\apache\druid\segment\SegmentWrangler.java,0,11,0,9,0,20
 druid-master\druid-master\server\src\main\java\org\apache\druid\server\security\Authorizer.java,0,12,0,11,0,23
 druid-master\druid-master\core\src\main\java\org\apache\druid\java\util\http\client\response\InputStreamFullResponseHandler.java,0,24,0,6,0,30
 druid-master\druid-master\core\src\main\java\org\apache\druid\java\util\http\client\pool\ResourceContainer.java,0,4,1,1,0,6
 druid-master\druid-master\processing\src\main\java\org\apache\druid\segment\data\ColumnarMultiIntsSerializer.java,0,3,0,2,0,5
 druid-master\druid-master\core\src\main\java\org\apache\druid\cli\CliCommandCreator.java,0,6,0,4,0,10
 druid-master\druid-master\indexing-service\src\test\java\org\apache\druid\indexing\common\actions\TimeChunkLockAcquireActionTest.java,0,18,0,6,0,24
 druid-master\druid-master\processing\src\main\java\org\apache\druid\segment\vector\ConstantVectorSelectors.java,0,36,2,3,0,41
 druid-master\druid-master\sql\src\main\java\org\apache\druid\sql\calcite\schema\MetadataSegmentView.java,0,56,1,21,0,78
 druid-master\druid-master\extensions-core\datasketches\src\test\java\org\apache\druid\query\aggregation\datasketches\tuple\ArrayOfDoublesSketchToMeansPostAggregatorTest.java,0,15,0,4,0,19
 druid-master\druid-master\services\src\main\java\org\apache\druid\cli\CliOverlord.java,0,83,0,53,0,136
 druid-master\druid-master\server\src\main\java\org\apache\druid\server\coordinator\UserCompactionTaskQueryTuningConfig.java,0,30,0,8,0,38
 druid-master\druid-master\processing\src\main\java\org\apache\druid\segment\join\filter\AllNullColumnSelectorFactory.java,0,11,0,1,0,12
 druid-master\druid-master\indexing-service\src\main\java\org\apache\druid\indexing\hadoop\OverlordActionBasedUsedSegmentsRetriever.java,0,14,0,3,0,17
 druid-master\druid-master\extensions-contrib\ambari-metrics-emitter\src\main\java\org\apache\druid\emitter\ambari\metrics\AmbariMetricsEmitterModule.java,0,14,0,4,0,18
 druid-master\druid-master\cloud\gcp-common\src\test\java\org\apache\druid\common\gcp\GcpModuleTest.java,0,9,0,5,3,17
 druid-master\druid-master\processing\src\main\java\org\apache\druid\query\QueryRunner.java,0,7,0,1,0,8
 druid-master\druid-master\processing\src\main\java\org\apache\druid\segment\incremental\OnheapIncrementalIndex.java,0,185,2,52,0,239
 druid-master\druid-master\extensions-contrib\virtual-columns\src\main\java\org\apache\druid\segment\MapVirtualColumnDimensionSelector.java,0,15,0,1,0,16
 druid-master\druid-master\processing\src\main\java\org\apache\druid\query\metadata\metadata\NoneColumnIncluderator.java,0,7,0,1,0,8
 druid-master\druid-master\processing\src\main\java\org\apache\druid\collections\spatial\Node.java,0,96,1,9,0,106
 druid-master\druid-master\indexing-service\src\main\java\org\apache\druid\indexing\common\task\AppenderatorDriverRealtimeIndexTask.java,0,176,10,71,0,257
 druid-master\druid-master\integration-tests\src\test\java\org\apache\druid\tests\parallelized\ITCustomCoordinatorDuties.java,0,8,0,2,0,10
 druid-master\druid-master\extensions-core\azure-extensions\src\main\java\org\apache\druid\storage\azure\AzureCloudBlobIterableFactory.java,0,2,0,1,0,3
 druid-master\druid-master\processing\src\main\java\org\apache\druid\segment\loading\BroadcastJoinableMMappedQueryableSegmentizerFactory.java,0,32,0,6,0,38
 druid-master\druid-master\sql\src\main\java\org\apache\druid\sql\calcite\planner\RelParameterizerShuttle.java,0,82,0,14,0,96
 druid-master\druid-master\extensions-core\azure-extensions\src\main\java\org\apache\druid\storage\azure\blob\ListBlobItemHolderFactory.java,0,3,0,1,0,4
 druid-master\druid-master\extensions-core\druid-bloom-filter\src\main\java\org\apache\druid\query\aggregation\bloom\ObjectBloomFilterAggregator.java,0,10,0,3,0,13
 druid-master\druid-master\extensions-core\avro-extensions\src\main\java\org\apache\druid\data\input\avro\AvroParsers.java,0,11,1,2,0,14
 druid-master\druid-master\indexing-service\src\main\java\org\apache\druid\indexing\common\actions\TaskActionClientFactory.java,0,2,0,1,0,3
 druid-master\druid-master\indexing-service\src\test\java\org\apache\druid\indexing\overlord\RealtimeishTask.java,0,17,1,5,0,23
 druid-master\druid-master\indexing-service\src\test\java\org\apache\druid\indexing\common\IndexingServiceCondition.java,0,3,0,1,0,4
 druid-master\druid-master\extensions-core\histogram\src\main\java\org\apache\druid\query\aggregation\histogram\ApproximateHistogramFoldingBufferAggregatorHelper.java,0,37,0,7,0,44
 druid-master\druid-master\core\src\main\java\org\apache\druid\initialization\DruidModule.java,0,3,0,1,0,4
 druid-master\druid-master\integration-tests\src\test\java\org\apache\druid\tests\api\ITOverlordResourceNotFoundTest.java,0,39,0,5,0,44
 druid-master\druid-master\core\src\main\java\org\apache\druid\java\util\metrics\ParametrizedUriEmitterMonitor.java,0,15,0,2,0,17
 druid-master\druid-master\extensions-core\lookups-cached-single\src\test\java\org\apache\druid\server\lookup\cache\loading\LoadingCacheTest.java,0,49,0,8,0,57
 druid-master\druid-master\extensions-core\datasketches\src\test\java\org\apache\druid\query\aggregation\datasketches\quantiles\DoublesSketchToRankPostAggregatorTest.java,0,19,1,4,0,24
 druid-master\druid-master\processing\src\main\java\org\apache\druid\query\aggregation\DoubleMinAggregator.java,0,21,0,1,0,22
 druid-master\druid-master\extensions-core\hdfs-storage\src\main\java\org\apache\druid\storage\hdfs\HdfsKerberosConfig.java,0,24,0,4,0,28
 druid-master\druid-master\services\src\test\java\org\apache\druid\cli\validate\DruidJsonValidatorTest.java,0,30,0,5,0,35
 druid-master\druid-master\server\src\main\java\org\apache\druid\server\metrics\EventReceiverFirehoseMetric.java,0,9,0,6,0,15
 druid-master\druid-master\indexing-service\src\test\java\org\apache\druid\indexing\common\task\batch\parallel\HashPartitionCachingLocalSegmentAllocatorTest.java,0,36,0,13,0,49
 druid-master\druid-master\processing\src\test\java\org\apache\druid\query\aggregation\JavaScriptAggregatorTest.java,0,80,0,23,0,103
 druid-master\druid-master\processing\src\main\java\org\apache\druid\query\filter\SelectorDimFilter.java,0,68,0,11,0,79
 druid-master\druid-master\indexing-service\src\test\java\org\apache\druid\indexing\common\actions\RetrieveUsedSegmentsActionSerdeTest.java,0,15,0,8,0,23
 druid-master\druid-master\server\src\test\java\org\apache\druid\segment\realtime\appenderator\TestUsedSegmentChecker.java,0,13,0,5,0,18
 druid-master\druid-master\extensions-core\lookups-cached-single\src\test\java\org\apache\druid\server\lookup\CacheRefKeeperTest.java,0,14,0,7,0,21
 druid-master\druid-master\processing\src\main\java\org\apache\druid\query\aggregation\ObjectAggregateCombiner.java,0,3,1,2,0,6
 druid-master\druid-master\processing\src\test\java\org\apache\druid\query\topn\TopNBinaryFnBenchmark.java,0,27,0,4,0,31
 druid-master\druid-master\server\src\main\java\org\apache\druid\server\coordinator\CachingCostBalancerStrategy.java,0,22,0,9,0,31
 druid-master\druid-master\indexing-service\src\main\java\org\apache\druid\indexing\seekablestream\supervisor\SeekableStreamSupervisorTuningConfig.java,0,17,0,3,0,20
 druid-master\druid-master\sql\src\test\java\org\apache\druid\sql\calcite\CalciteSelectQueryTest.java,0,383,0,191,0,574
 druid-master\druid-master\indexing-service\src\main\java\org\apache\druid\indexing\common\task\SequenceNameFunction.java,0,7,0,3,0,10
 druid-master\druid-master\server\src\test\java\org\apache\druid\metadata\SQLMetadataConnectorTest.java,0,59,2,5,0,66
 druid-master\druid-master\processing\src\test\java\org\apache\druid\segment\filter\FalseFilterTest.java,0,3,0,1,0,4
 druid-master\druid-master\extensions-core\kafka-indexing-service\src\main\java\org\apache\druid\indexing\kafka\KafkaSamplerSpec.java,0,13,0,4,0,17
 druid-master\druid-master\extensions-contrib\tdigestsketch\src\main\java\org\apache\druid\query\aggregation\tdigestsketch\TDigestSketchBufferAggregator.java,0,39,0,9,0,48
 druid-master\druid-master\processing\src\main\java\org\apache\druid\query\lookup\LookupIntrospectHandler.java,0,3,0,3,0,6
 druid-master\druid-master\indexing-hadoop\src\main\java\org\apache\druid\indexer\path\PathSpec.java,0,5,0,4,0,9
 druid-master\druid-master\indexing-service\src\main\java\org\apache\druid\indexing\common\task\batch\parallel\ParallelIndexSupervisorTaskClient.java,0,39,0,8,0,47
 druid-master\druid-master\processing\src\main\java\org\apache\druid\segment\DoubleDimensionIndexer.java,0,73,1,14,0,88
 druid-master\druid-master\core\src\main\java\org\apache\druid\data\input\impl\HttpInputSourceConfig.java,0,22,0,4,1,27
 druid-master\druid-master\indexing-service\src\main\java\org\apache\druid\indexing\common\actions\CheckPointDataSourceMetadataAction.java,0,57,4,13,0,74
 druid-master\druid-master\server\src\main\java\org\apache\druid\server\QuerySchedulerProvider.java,0,18,0,6,0,24
 druid-master\druid-master\extensions-contrib\cloudfiles-extensions\src\main\java\org\apache\druid\storage\cloudfiles\CloudFilesDataSegmentPusherConfig.java,0,38,0,1,0,39
 druid-master\druid-master\extensions-core\lookups-cached-single\src\main\java\org\apache\druid\server\lookup\cache\loading\OffHeapLoadingCache.java,0,70,0,10,0,80
 druid-master\druid-master\indexing-service\src\test\java\org\apache\druid\indexing\common\task\batch\parallel\DeepStoragePartitionLocationTest.java,0,14,0,4,0,18
 druid-master\druid-master\core\src\main\java\org\apache\druid\annotations\SubclassesMustBePublicAnnotationProcessor.java,0,7,0,3,0,10
 druid-master\druid-master\indexing-service\src\test\java\org\apache\druid\indexing\seekablestream\SeekableStreamIndexTaskRunnerAuthTest.java,0,99,6,25,0,130
 druid-master\druid-master\server\src\test\java\org\apache\druid\segment\realtime\firehose\EventReceiverFirehoseTest.java,0,88,11,42,0,141
 druid-master\druid-master\core\src\main\java\org\apache\druid\timeline\partition\IntegerPartitionChunk.java,0,52,0,4,0,56
 druid-master\druid-master\server\src\test\java\org\apache\druid\segment\realtime\appenderator\AppenderatorPlumberTest.java,0,24,0,7,0,31
 druid-master\druid-master\sql\src\main\java\org\apache\druid\sql\calcite\expression\builtin\BTrimOperatorConversion.java,0,6,0,1,0,7
 druid-master\druid-master\server\src\main\java\org\apache\druid\server\lookup\cache\LookupNodeDiscovery.java,0,21,0,5,0,26
 druid-master\druid-master\extensions-core\datasketches\src\main\java\org\apache\druid\query\aggregation\datasketches\quantiles\sql\DoublesSketchToHistogramOperatorConversion.java,0,11,0,4,0,15
 druid-master\druid-master\indexing-service\src\test\java\org\apache\druid\indexing\common\task\batch\parallel\PushedSegmentsReportTest.java,0,4,0,2,0,6
 druid-master\druid-master\processing\src\test\java\org\apache\druid\query\aggregation\any\DoubleAnyAggregatorFactoryTest.java,0,26,0,7,0,33
 druid-master\druid-master\processing\src\main\java\org\apache\druid\segment\serde\ComplexMetrics.java,0,17,1,6,0,24
 druid-master\druid-master\extensions-contrib\materialized-view-selection\src\main\java\org\apache\druid\query\materializedview\MaterializedViewQuery.java,0,108,0,12,0,120
 druid-master\druid-master\extensions-core\lookups-cached-single\src\test\java\org\apache\druid\server\lookup\cache\loading\OffHeapLoadingCacheTest.java,0,5,0,1,0,6
 druid-master\druid-master\core\src\test\java\org\apache\druid\metadata\EnvironmentVariablePasswordProviderTest.java,0,8,0,5,1,14
 druid-master\druid-master\sql\src\test\java\org\apache\druid\sql\calcite\schema\DruidSchemaTest.java,0,267,7,131,0,405
 druid-master\druid-master\extensions-contrib\aliyun-oss-extensions\src\main\java\org\apache\druid\firehose\aliyun\StaticOssFirehoseFactory.java,0,69,2,14,0,85
 druid-master\druid-master\server\src\main\java\org\apache\druid\metadata\SegmentsMetadataManagerConfig.java,0,10,0,1,0,11
 druid-master\druid-master\core\src\test\java\org\apache\druid\java\util\metrics\StubServiceEmitter.java,0,15,3,1,1,20
 druid-master\druid-master\core\src\test\java\org\apache\druid\java\util\common\CompressionUtilsTest.java,0,241,30,78,15,364
 druid-master\druid-master\processing\src\main\java\org\apache\druid\query\PrioritizedCallable.java,0,2,0,1,0,3
 druid-master\druid-master\core\src\main\java\org\apache\druid\java\util\common\parsers\ObjectFlatteners.java,0,66,0,13,0,79
 druid-master\druid-master\processing\src\test\java\org\apache\druid\query\SchemaEvolutionTest.java,0,101,0,36,0,137
 druid-master\druid-master\core\src\main\java\org\apache\druid\guice\annotations\Json.java,0,1,0,1,0,2
 druid-master\druid-master\extensions-contrib\opentelemetry-emitter\src\main\java\org\apache\druid\emitter\opentelemetry\OpenTelemetryEmitterConfig.java,0,2,0,1,0,3
 druid-master\druid-master\benchmarks\src\test\java\org\apache\druid\benchmark\bitmap\RangeBitmapBenchmark.java,0,27,0,6,0,33
 druid-master\druid-master\extensions-core\histogram\src\test\java\org\apache\druid\query\aggregation\histogram\ApproximateHistogramErrorBenchmark.java,0,65,0,8,0,73
 druid-master\druid-master\sql\src\main\java\org\apache\druid\sql\calcite\expression\UnarySuffixOperatorConversion.java,0,12,0,2,0,14
 druid-master\druid-master\extensions-core\s3-extensions\src\main\java\org\apache\druid\data\input\s3\S3Entity.java,0,29,0,3,0,32
 druid-master\druid-master\sql\src\main\java\org\apache\druid\sql\calcite\filtration\RangeSets.java,0,29,1,6,0,36
 druid-master\druid-master\sql\src\main\java\org\apache\druid\sql\calcite\aggregation\SqlAggregator.java,0,9,0,8,0,17
 druid-master\druid-master\core\src\main\java\org\apache\druid\annotations\SuppressFBWarnings.java,0,4,0,1,0,5
 druid-master\druid-master\sql\src\main\java\org\apache\druid\sql\calcite\filtration\ConvertBoundsToSelectors.java,0,10,1,2,0,13
 druid-master\druid-master\processing\src\main\java\org\apache\druid\query\aggregation\cardinality\vector\StringObjectCardinalityVectorProcessor.java,0,39,0,18,0,57
 druid-master\druid-master\core\src\main\java\org\apache\druid\java\util\common\NonnullPair.java,0,22,0,1,0,23
 druid-master\druid-master\core\src\main\java\org\apache\druid\math\expr\vector\DoubleOutDoubleLongInFunctionVectorValueProcessor.java,0,16,0,2,0,18
 druid-master\druid-master\indexing-service\src\main\java\org\apache\druid\indexing\overlord\setup\WorkerBehaviorConfig.java,0,14,0,11,0,25
 druid-master\druid-master\extensions-core\stats\src\test\java\org\apache\druid\query\aggregation\variance\VarianceAggregatorFactoryTest.java,0,15,0,10,0,25
 druid-master\druid-master\core\target\generated-sources\antlr4\org\apache\druid\math\expr\antlr\ExprListener.java,0,3,0,1,0,4
 druid-master\druid-master\server\src\main\java\org\apache\druid\server\coordination\ChangeRequestHistory.java,0,110,5,24,0,139
 druid-master\druid-master\processing\src\main\java\org\apache\druid\segment\loading\SegmentizerFactory.java,0,6,0,4,0,10
 druid-master\druid-master\processing\src\main\java\org\apache\druid\query\InlineDataSource.java,0,71,4,20,0,95
 druid-master\druid-master\processing\src\main\java\org\apache\druid\query\groupby\strategy\GroupByStrategyV2.java,0,193,5,104,0,302
 druid-master\druid-master\server\src\main\java\org\apache\druid\server\coordinator\rules\Rules.java,0,14,1,2,0,17
 druid-master\druid-master\core\src\main\java\org\apache\druid\common\config\NullValueHandlingConfig.java,0,21,0,5,0,26
 druid-master\druid-master\extensions-core\lookups-cached-global\src\main\java\org\apache\druid\query\lookup\namespace\ExtractionNamespace.java,0,8,0,4,0,12
 druid-master\druid-master\extensions-core\avro-extensions\src\main\java\org\apache\druid\data\input\avro\AvroOCFInputFormat.java,0,51,0,8,0,59
 druid-master\druid-master\processing\src\main\java\org\apache\druid\query\groupby\epinephelinae\ByteBufferIntList.java,0,27,0,2,0,29
 druid-master\druid-master\sql\src\main\java\org\apache\druid\sql\calcite\expression\builtin\ArrayPrependOperatorConversion.java,0,4,0,1,0,5
 druid-master\druid-master\processing\src\main\java\org\apache\druid\query\groupby\epinephelinae\UnexpectedMultiValueDimensionException.java,0,10,0,2,0,12
 druid-master\druid-master\core\src\test\java\org\apache\druid\collections\CombiningIterableTest.java,0,12,0,2,0,14
 druid-master\druid-master\server\src\main\java\org\apache\druid\indexing\overlord\supervisor\autoscaler\LagStats.java,0,22,0,1,0,23
 druid-master\druid-master\sql\src\test\java\org\apache\druid\sql\calcite\CalciteSimpleQueryTest.java,0,70,0,48,0,118
 druid-master\druid-master\processing\src\main\java\org\apache\druid\query\aggregation\first\StringFirstAggregateCombiner.java,0,15,0,4,0,19
 druid-master\druid-master\processing\src\main\java\org\apache\druid\segment\NumericDimensionMergerV9.java,0,32,0,5,0,37
 druid-master\druid-master\extensions-core\azure-extensions\src\main\java\org\apache\druid\firehose\azure\StaticAzureBlobStoreFirehoseFactory.java,0,60,0,13,0,73
 druid-master\druid-master\core\src\main\java\org\apache\druid\collections\ReferenceCountingResourceHolder.java,0,55,3,14,2,74
 druid-master\druid-master\extensions-core\druid-basic-security\src\main\java\org\apache\druid\security\basic\BasicSecurityDruidModule.java,0,58,1,40,0,99
 druid-master\druid-master\processing\src\main\java\org\apache\druid\segment\virtual\VirtualizedColumnInspector.java,0,18,0,5,0,23
 druid-master\druid-master\server\src\main\java\org\apache\druid\discovery\NodeRole.java,0,80,0,30,0,110
 druid-master\druid-master\processing\src\main\java\org\apache\druid\query\search\RegexSearchQuerySpec.java,0,25,0,2,0,27
 druid-master\druid-master\indexing-service\src\test\java\org\apache\druid\indexing\input\InputRowSchemasTest.java,0,8,2,2,0,12
 druid-master\druid-master\indexing-service\src\main\java\org\apache\druid\indexing\common\task\CurrentSubTaskHolder.java,0,25,0,11,0,36
 druid-master\druid-master\processing\src\test\java\org\apache\druid\segment\data\GenericIndexedStringWriterTest.java,0,6,0,2,0,8
 druid-master\druid-master\extensions-contrib\materialized-view-selection\src\main\java\org\apache\druid\query\materializedview\MaterializedViewQueryQueryToolChest.java,0,58,0,10,0,68
 druid-master\druid-master\processing\src\main\java\org\apache\druid\query\MetricsEmittingQueryRunner.java,0,54,1,9,0,64
 druid-master\druid-master\processing\src\test\java\org\apache\druid\query\groupby\epinephelinae\collection\HashTableUtilsTest.java,0,52,3,19,0,74
 druid-master\druid-master\sql\src\main\java\org\apache\druid\sql\calcite\schema\DruidSchemaName.java,0,1,0,1,0,2
 druid-master\druid-master\processing\src\main\java\org\apache\druid\query\aggregation\SerializablePairLongStringSerde.java,0,40,0,11,0,51
 druid-master\druid-master\extensions-core\s3-extensions\src\main\java\org\apache\druid\storage\s3\S3TaskLogs.java,0,60,3,13,0,76
 druid-master\druid-master\integration-tests\src\main\java\org\apache\druid\testing\utils\AbstractTestQueryHelper.java,0,78,4,11,0,93
 druid-master\druid-master\processing\src\main\java\org\apache\druid\query\QueryContexts.java,0,337,1,61,0,399
 druid-master\druid-master\core\src\test\java\org\apache\druid\indexer\partitions\DimensionRangePartitionsSpecTest.java,0,67,0,9,0,76
 druid-master\druid-master\processing\src\main\java\org\apache\druid\query\aggregation\first\DoubleFirstAggregatorFactory.java,0,106,0,18,0,124
 druid-master\druid-master\indexing-service\src\main\java\org\apache\druid\indexing\common\task\batch\parallel\distribution\ArrayOfStringTuplesSerDe.java,0,13,0,4,0,17
 druid-master\druid-master\benchmarks\src\test\java\org\apache\druid\benchmark\indexing\IndexIngestionBenchmark.java,0,32,2,3,0,37
 druid-master\druid-master\core\src\test\java\org\apache\druid\java\util\common\parsers\CloseableIteratorTest.java,0,44,0,12,0,56
 druid-master\druid-master\core\src\test\java\org\apache\druid\java\util\common\guava\TestSequence.java,0,27,0,3,0,30
 druid-master\druid-master\core\src\test\java\org\apache\druid\java\util\common\parsers\TimestampParserTest.java,0,122,0,53,0,175
 druid-master\druid-master\processing\src\main\java\org\apache\druid\query\QueryUnsupportedException.java,0,18,0,6,0,24
 druid-master\druid-master\indexing-service\src\main\java\org\apache\druid\indexing\common\task\LinearlyPartitionedSequenceNameFunction.java,0,11,0,3,0,14
 druid-master\druid-master\processing\src\main\java\org\apache\druid\segment\join\filter\JoinFilterSplit.java,0,42,0,6,0,48
 druid-master\druid-master\processing\src\main\java\org\apache\druid\query\groupby\epinephelinae\column\GroupByColumnSelectorStrategy.java,0,39,0,38,0,77
 druid-master\druid-master\core\src\test\java\org\apache\druid\java\util\emitter\service\UnitEvent.java,0,22,0,1,1,24
 druid-master\druid-master\server\src\main\java\org\apache\druid\client\selector\RandomServerSelectorStrategy.java,0,13,0,4,0,17
 druid-master\druid-master\processing\src\main\java\org\apache\druid\query\datasourcemetadata\DataSourceMetadataQuery.java,0,51,0,14,0,65
 druid-master\druid-master\core\src\test\java\org\apache\druid\timeline\partition\PartitionHolderCompletenessTest.java,0,39,1,11,1,52
 druid-master\druid-master\extensions-core\parquet-extensions\src\main\java\org\apache\druid\data\input\parquet\simple\ParquetGroupFlattenerMaker.java,0,34,0,7,0,41
 druid-master\druid-master\processing\src\main\java\org\apache\druid\query\monomorphicprocessing\SpecializationState.java,0,12,0,6,0,18
 druid-master\druid-master\indexing-service\src\main\java\org\apache\druid\indexing\seekablestream\SeekableStreamStartSequenceNumbers.java,0,80,2,32,0,114
 druid-master\druid-master\extensions-core\lookups-cached-global\src\test\java\org\apache\druid\query\lookup\namespace\UriExtractionNamespaceTest.java,0,96,3,43,0,142
 druid-master\druid-master\indexing-service\src\main\java\org\apache\druid\indexing\common\TaskLockType.java,0,4,0,2,0,6
 druid-master\druid-master\integration-tests\src\test\java\org\apache\druid\tests\hadoop\ITAzureInputToAzureHadoopIndexTest.java,0,13,0,10,0,23
 druid-master\druid-master\extensions-contrib\aliyun-oss-extensions\src\main\java\org\apache\druid\storage\aliyun\OssUtils.java,0,91,5,27,0,123
 druid-master\druid-master\processing\src\main\java\org\apache\druid\query\groupby\epinephelinae\column\NullableNumericGroupByColumnSelectorStrategy.java,0,56,0,14,0,70
 druid-master\druid-master\sql\src\main\java\org\apache\druid\sql\calcite\expression\builtin\LikeOperatorConversion.java,0,12,0,1,0,13
 druid-master\druid-master\processing\src\test\java\org\apache\druid\segment\IndexIOTest.java,0,82,0,19,0,101
 druid-master\druid-master\sql\src\main\java\org\apache\druid\sql\calcite\planner\PrepareResult.java,0,16,0,4,0,20
 druid-master\druid-master\server\src\test\java\org\apache\druid\server\lookup\cache\LookupExtractorFactoryMapContainerTest.java,0,18,0,5,0,23
 druid-master\druid-master\core\src\main\java\org\apache\druid\guice\ManageLifecycleAnnouncements.java,0,3,0,3,0,6
 druid-master\druid-master\core\src\main\java\org\apache\druid\data\input\impl\InlineInputSource.java,0,27,0,1,0,28
 druid-master\druid-master\core\src\test\java\org\apache\druid\java\util\emitter\core\LoggingEmitterConfigTest.java,0,13,0,5,0,18
 druid-master\druid-master\core\src\main\java\org\apache\druid\timeline\partition\PartitionIds.java,0,3,0,1,0,4
 druid-master\druid-master\services\src\main\java\org\apache\druid\cli\Log4JShutdownPropertyChecker.java,0,5,0,2,0,7
 druid-master\druid-master\server\src\main\java\org\apache\druid\segment\handoff\CoordinatorBasedSegmentHandoffNotifierFactory.java,0,13,0,2,0,15
 druid-master\druid-master\processing\src\main\java\org\apache\druid\query\aggregation\JavaScriptAggregatorFactory.java,0,146,0,35,0,181
 druid-master\druid-master\extensions-core\histogram\src\main\java\org\apache\druid\query\aggregation\histogram\FixedBucketsHistogramVectorAggregator.java,0,39,1,3,0,43
 druid-master\druid-master\sql\src\main\java\org\apache\druid\sql\calcite\expression\DirectOperatorConversion.java,0,21,0,2,0,23
 druid-master\druid-master\core\src\main\java\org\apache\druid\java\util\common\guava\Sequences.java,0,72,1,18,0,91
 druid-master\druid-master\extensions-contrib\moving-average-query\src\main\java\org\apache\druid\query\movingaverage\MovingAverageIterable.java,0,90,2,29,0,121
 druid-master\druid-master\processing\src\test\java\org\apache\druid\collections\IntSetTestUtility.java,0,40,1,4,0,45
 druid-master\druid-master\core\src\main\java\org\apache\druid\timeline\partition\NumberedOverwritePartialShardSpec.java,0,40,0,3,0,43
 druid-master\druid-master\processing\src\main\java\org\apache\druid\query\aggregation\DelegatingAggregator.java,0,19,0,3,0,22
 druid-master\druid-master\processing\src\main\java\org\apache\druid\query\expression\IPv4AddressExprUtils.java,0,22,1,4,0,27
 druid-master\druid-master\processing\src\test\java\org\apache\druid\query\groupby\epinephelinae\vector\VectorGroupByEngineIteratorTest.java,0,11,0,6,0,17
 druid-master\druid-master\core\src\test\java\org\apache\druid\timeline\partition\OvershadowableManagerTest.java,0,321,1,53,0,375
 druid-master\druid-master\server\src\main\java\org\apache\druid\client\cache\CacheMonitor.java,0,36,3,18,0,57
 druid-master\druid-master\server\src\main\java\org\apache\druid\server\security\AllowOptionsResourceFilter.java,0,20,2,7,0,29
 druid-master\druid-master\processing\src\main\java\org\apache\druid\query\aggregation\LongMinAggregator.java,0,21,0,1,0,22
 druid-master\druid-master\extensions-contrib\moving-average-query\src\test\java\org\apache\druid\query\movingaverage\averagers\DoubleMeanNoNullAveragerFactoryTest.java,0,6,0,3,0,9
 druid-master\druid-master\indexing-hadoop\src\test\java\org\apache\druid\indexer\hadoop\DatasourceInputFormatTest.java,0,110,8,38,0,156
 druid-master\druid-master\extensions-contrib\cloudfiles-extensions\src\test\java\org\apache\druid\storage\cloudfiles\CloudFilesObjectApiProxyTest.java,0,5,0,3,0,8
 druid-master\druid-master\processing\src\main\java\org\apache\druid\query\aggregation\FilteredBufferAggregator.java,0,43,0,2,0,45
 druid-master\druid-master\extensions-core\datasketches\src\test\java\org\apache\druid\query\aggregation\datasketches\theta\SketchToStringPostAggregatorTest.java,0,23,0,9,0,32
 druid-master\druid-master\indexing-service\src\main\java\org\apache\druid\indexing\overlord\TaskRunnerUtils.java,0,30,2,9,0,41
 druid-master\druid-master\processing\src\test\java\org\apache\druid\segment\filter\LikeFilterTest.java,0,79,1,16,0,96
 druid-master\druid-master\processing\src\main\java\org\apache\druid\query\filter\DruidFloatPredicate.java,0,13,0,4,0,17
 druid-master\druid-master\extensions-contrib\cloudfiles-extensions\src\test\java\org\apache\druid\storage\cloudfiles\CloudFilesByteSourceTest.java,0,10,2,4,0,16
 druid-master\druid-master\processing\src\main\java\org\apache\druid\query\aggregation\post\ConstantPostAggregator.java,0,42,1,3,0,46
 druid-master\druid-master\processing\src\main\java\org\apache\druid\query\dimension\ColumnSelectorStrategy.java,0,3,0,2,0,5
 druid-master\druid-master\core\src\main\java\org\apache\druid\segment\column\Types.java,0,60,3,15,0,78
 druid-master\druid-master\indexing-service\src\main\java\org\apache\druid\guice\IndexingServiceFirehoseModule.java,0,7,1,2,0,10
 druid-master\druid-master\processing\src\main\java\org\apache\druid\query\groupby\epinephelinae\AggregateResult.java,0,27,1,2,0,30
 druid-master\druid-master\server\src\main\java\org\apache\druid\client\DruidServerConfig.java,0,24,0,3,0,27
 druid-master\druid-master\processing\src\main\java\org\apache\druid\segment\data\BlockLayoutColumnarDoublesSerializer.java,0,35,0,7,0,42
 druid-master\druid-master\extensions-core\druid-bloom-filter\src\test\java\org\apache\druid\query\aggregation\bloom\sql\BloomFilterSqlAggregatorTest.java,0,58,1,31,0,90
 druid-master\druid-master\server\src\test\java\org\apache\druid\initialization\InitializationTest.java,0,183,22,75,0,280
 druid-master\druid-master\server\src\main\java\org\apache\druid\server\security\AuthorizerMapper.java,0,13,0,1,0,14
 druid-master\druid-master\extensions-contrib\moving-average-query\src\main\java\org\apache\druid\query\movingaverage\AveragerFactoryWrapper.java,0,46,0,13,0,59
 druid-master\druid-master\indexing-service\src\test\java\org\apache\druid\indexing\common\task\batch\parallel\PartialDimensionDistributionTaskTest.java,0,141,0,71,0,212
 druid-master\druid-master\extensions-contrib\dropwizard-emitter\src\main\java\org\apache\druid\emitter\dropwizard\reporters\DropwizardJMXReporter.java,0,21,0,1,0,22
 druid-master\druid-master\server\src\main\java\org\apache\druid\client\HttpServerInventoryViewConfig.java,0,27,0,5,0,32
 druid-master\druid-master\processing\src\main\java\org\apache\druid\query\search\SearchQueryDecisionHelper.java,0,7,0,1,0,8
 druid-master\druid-master\sql\src\main\java\org\apache\druid\sql\calcite\filtration\CombineAndSimplifyBounds.java,0,36,2,20,0,58
 druid-master\druid-master\core\src\main\java\org\apache\druid\timeline\partition\PartialShardSpec.java,0,17,0,13,0,30
 druid-master\druid-master\core\src\main\java\org\apache\druid\segment\loading\SegmentLoadingException.java,0,10,0,1,0,11
 druid-master\druid-master\processing\src\main\java\org\apache\druid\query\aggregation\NullableNumericAggregator.java,0,26,0,9,0,35
 druid-master\druid-master\extensions-core\parquet-extensions\src\main\java\org\apache\druid\data\input\parquet\simple\ParquetGroupConverter.java,0,172,7,45,0,224
 druid-master\druid-master\extensions-contrib\time-min-max\src\test\java\org\apache\druid\query\aggregation\TimestampMinMaxAggregatorTest.java,0,59,2,13,0,74
 druid-master\druid-master\indexing-hadoop\src\main\java\org\apache\druid\indexer\HadoopyStringInputRowParser.java,0,16,0,4,0,20
 druid-master\druid-master\server\src\main\java\org\apache\druid\server\coordinator\CoordinatorDynamicConfig.java,0,436,2,126,0,564
 druid-master\druid-master\server\src\main\java\org\apache\druid\metadata\SQLMetadataSegmentPublisherProvider.java,0,7,0,2,0,9
 druid-master\druid-master\processing\src\test\java\org\apache\druid\collections\bitmap\BitmapOperationAgainstConsecutiveRunsTest.java,0,11,0,6,0,17
 druid-master\druid-master\processing\src\main\java\org\apache\druid\query\groupby\epinephelinae\column\ArrayNumericGroupByColumnSelectorStrategy.java,0,76,2,13,0,91
 druid-master\druid-master\extensions-core\druid-basic-security\src\main\java\org\apache\druid\security\basic\authorization\entity\BasicAuthorizerUserMapBundle.java,0,15,0,1,0,16
 druid-master\druid-master\processing\src\test\java\org\apache\druid\query\filter\LikeDimFilterTest.java,0,25,1,12,0,38
 druid-master\druid-master\core\src\main\java\org\apache\druid\math\expr\vector\VectorStringProcessors.java,0,33,2,11,0,46
 druid-master\druid-master\server\src\main\java\org\apache\druid\indexing\overlord\SegmentPublishResult.java,0,39,1,6,0,46
 druid-master\druid-master\core\src\test\java\org\apache\druid\java\util\common\io\smoosh\SmooshedFileMapperTest.java,0,71,1,17,5,94
 druid-master\druid-master\integration-tests\src\main\java\org\apache\druid\testing\IntegrationTestingConfig.java,0,74,0,1,0,75
 druid-master\druid-master\extensions-contrib\tdigestsketch\src\main\java\org\apache\druid\query\aggregation\tdigestsketch\TDigestSketchToQuantilePostAggregator.java,0,47,0,4,0,51
 druid-master\druid-master\core\src\main\java\org\apache\druid\java\util\common\guava\LimitedSequence.java,0,50,1,12,0,63
 druid-master\druid-master\extensions-core\datasketches\src\main\java\org\apache\druid\query\aggregation\datasketches\quantiles\DoublesSketchBuildAggregator.java,0,17,0,2,0,19
 druid-master\druid-master\core\src\main\java\org\apache\druid\data\input\impl\HttpEntity.java,0,39,0,12,0,51
 druid-master\druid-master\indexing-service\src\main\java\org\apache\druid\indexing\common\config\TaskConfig.java,0,139,0,27,0,166
 druid-master\druid-master\server\src\test\java\org\apache\druid\curator\ExhibitorConfigTest.java,0,9,0,1,0,10
 druid-master\druid-master\server\src\test\java\org\apache\druid\server\coordinator\BalancerStrategyTest.java,0,32,0,9,0,41
 druid-master\druid-master\sql\src\main\java\org\apache\druid\sql\calcite\aggregation\builtin\ArrayConcatSqlAggregator.java,0,27,0,8,0,35
 druid-master\druid-master\indexing-service\src\main\java\org\apache\druid\indexing\common\task\batch\parallel\SinglePhaseSubTaskSpec.java,0,15,0,2,0,17
 druid-master\druid-master\core\src\test\java\org\apache\druid\timeline\DataSegmentTest.java,0,114,0,63,0,177
 druid-master\druid-master\processing\src\test\java\org\apache\druid\query\topn\PooledTopNAlgorithmTest.java,0,11,0,7,0,18
 druid-master\druid-master\processing\src\test\java\org\apache\druid\query\scan\ScanQueryTestHelper.java,0,18,1,6,0,25
 druid-master\druid-master\server\src\main\java\org\apache\druid\guice\AnnouncerModule.java,0,19,0,6,0,25
 druid-master\druid-master\processing\src\test\java\org\apache\druid\segment\ConstantMultiValueDimensionSelectorTest.java,0,51,0,28,0,79
 druid-master\druid-master\core\src\main\java\org\apache\druid\annotations\SubclassesMustBePublic.java,0,1,0,1,0,2
 druid-master\druid-master\server\src\test\java\org\apache\druid\server\coordinator\duty\UnloadUnusedSegmentsTest.java,0,73,8,17,0,98
 druid-master\druid-master\processing\src\main\java\org\apache\druid\query\groupby\having\EqualToHavingSpec.java,0,39,3,6,0,48
 druid-master\druid-master\processing\src\main\java\org\apache\druid\query\groupby\epinephelinae\Groupers.java,0,44,2,13,0,59
 druid-master\druid-master\server\src\main\java\org\apache\druid\guice\http\AbstractHttpClientProvider.java,0,25,1,2,0,28
 druid-master\druid-master\processing\src\main\java\org\apache\druid\query\aggregation\cardinality\CardinalityAggregator.java,0,45,0,15,0,60
 druid-master\druid-master\integration-tests\src\test\java\org\apache\druid\tests\indexer\ITOverwriteBatchIndexTest.java,0,47,2,27,0,76
 druid-master\druid-master\extensions-contrib\redis-cache\src\test\java\org\apache\druid\client\cache\RedisClusterCacheTest.java,0,47,0,8,0,55
 druid-master\druid-master\processing\src\main\java\org\apache\druid\segment\filter\OrFilter.java,0,67,4,17,0,88
 druid-master\druid-master\core\src\main\java\org\apache\druid\math\expr\IdentifierExpr.java,0,76,0,16,0,92
 druid-master\druid-master\sql\src\test\java\org\apache\druid\sql\calcite\rule\FilterJoinExcludePushToChildRuleTest.java,0,17,0,12,0,29
 druid-master\druid-master\processing\src\test\java\org\apache\druid\query\groupby\epinephelinae\HashVectorGrouperTest.java,0,56,2,18,0,76
 druid-master\druid-master\extensions-contrib\moving-average-query\src\main\java\org\apache\druid\query\movingaverage\RowBucket.java,0,25,0,2,0,27
 druid-master\druid-master\extensions-contrib\tdigestsketch\src\test\java\org\apache\druid\query\aggregation\tdigestsketch\TDigestSketchToQuantilesPostAggregatorTest.java,0,23,0,5,0,28
 druid-master\druid-master\core\src\main\java\org\apache\druid\collections\CombiningIterable.java,0,27,0,5,0,32
 druid-master\druid-master\indexing-service\src\test\java\org\apache\druid\indexing\overlord\TaskLockConfigTest.java,0,21,0,8,0,29
 druid-master\druid-master\server\src\main\java\org\apache\druid\server\security\AuthConfig.java,0,58,0,11,0,69
 druid-master\druid-master\indexing-service\src\main\java\org\apache\druid\indexing\common\task\InputSourceProcessor.java,0,48,3,21,0,72
 druid-master\druid-master\indexing-service\src\test\java\org\apache\druid\indexing\common\task\batch\parallel\PartialRangeSegmentGenerateTaskTest.java,0,41,0,16,0,57
 druid-master\druid-master\processing\src\test\java\org\apache\druid\segment\filter\SpatialFilterBonusTest.java,0,99,1,23,0,123
 druid-master\druid-master\processing\src\main\java\org\apache\druid\query\datasourcemetadata\DataSourceMetadataQueryRunnerFactory.java,0,39,1,11,0,51
 druid-master\druid-master\indexing-service\src\main\java\org\apache\druid\indexing\seekablestream\supervisor\SeekableStreamSupervisorIOConfig.java,0,96,1,11,0,108
 druid-master\druid-master\integration-tests\src\main\java\org\apache\druid\testing\guice\DruidTestModule.java,0,24,0,8,0,32
 druid-master\druid-master\benchmarks\src\test\java\org\apache\druid\server\coordinator\BalancerStrategyBenchmark.java,0,37,1,6,0,44
 druid-master\druid-master\indexing-service\src\main\java\org\apache\druid\indexing\common\tasklogs\FileTaskLogs.java,0,34,2,5,0,41
 druid-master\druid-master\core\src\main\java\org\apache\druid\math\expr\vector\BivariateFunctionVectorProcessor.java,0,28,3,7,0,38
 druid-master\druid-master\server\src\main\java\org\apache\druid\server\coordinator\BalancerStrategyFactory.java,0,7,0,6,0,13
 druid-master\druid-master\indexing-service\src\test\java\org\apache\druid\indexing\overlord\TaskRunnerUtilsTest.java,0,9,2,5,0,16
 druid-master\druid-master\server\src\test\java\org\apache\druid\server\log\TestRequestLoggerProvider.java,0,3,0,1,0,4
 druid-master\druid-master\extensions-core\histogram\src\test\java\org\apache\druid\query\aggregation\histogram\ApproximateHistogramGroupByQueryTest.java,0,63,1,13,0,77
 druid-master\druid-master\extensions-core\druid-bloom-filter\src\main\java\org\apache\druid\query\aggregation\bloom\BloomFilterAggregatorFactory.java,0,83,0,12,0,95
 druid-master\druid-master\processing\src\test\java\org\apache\druid\segment\data\CompressedLongsSerdeTest.java,0,90,0,20,0,110
 druid-master\druid-master\indexing-service\src\test\java\org\apache\druid\indexing\common\TestTasks.java,0,42,3,2,0,47
 druid-master\druid-master\processing\src\test\java\org\apache\druid\query\scan\ScanQueryQueryToolChestTest.java,0,47,8,18,0,73
 druid-master\druid-master\processing\src\test\java\org\apache\druid\query\groupby\GroupByQueryTest.java,0,34,1,21,0,56
 druid-master\druid-master\processing\src\main\java\org\apache\druid\collections\IntegerSet.java,0,46,0,4,0,50
 druid-master\druid-master\extensions-core\kafka-indexing-service\src\test\java\org\apache\druid\indexing\kafka\test\TestBroker.java,0,50,1,5,0,56
 druid-master\druid-master\extensions-core\histogram\src\test\java\org\apache\druid\query\aggregation\histogram\ApproximateHistogramFoldingSerdeTest.java,0,9,0,3,0,12
 druid-master\druid-master\core\src\main\java\org\apache\druid\timeline\partition\OverwriteShardSpec.java,0,12,0,7,0,19
 druid-master\druid-master\extensions-contrib\aliyun-oss-extensions\src\test\java\org\apache\druid\storage\aliyun\OssTaskLogsTest.java,0,73,6,31,0,110
 druid-master\druid-master\core\src\main\java\org\apache\druid\common\utils\SerializerUtils.java,0,90,0,5,0,95
 druid-master\druid-master\extensions-core\lookups-cached-single\src\test\java\org\apache\druid\server\lookup\PollingLookupTest.java,0,58,2,6,0,66
 druid-master\druid-master\processing\src\main\java\org\apache\druid\query\topn\TimeExtractionTopNAlgorithm.java,0,52,1,11,0,64
 druid-master\druid-master\core\src\main\java\org\apache\druid\audit\AuditManager.java,0,15,0,5,0,20
 druid-master\druid-master\server\src\test\java\org\apache\druid\metadata\SqlSegmentsMetadataManagerTest.java,0,175,0,92,0,267
 druid-master\druid-master\core\src\main\java\org\apache\druid\data\input\Rows.java,0,27,1,15,0,43
 druid-master\druid-master\sql\src\main\java\org\apache\druid\sql\calcite\parser\DruidSqlParserUtils.java,0,37,4,26,0,67
 druid-master\druid-master\processing\src\main\java\org\apache\druid\segment\ObjectColumnSelector.java,0,17,0,12,0,29
 druid-master\druid-master\processing\src\main\java\org\apache\druid\query\filter\RowOffsetMatcherFactory.java,0,2,0,1,0,3
 druid-master\druid-master\extensions-core\parquet-extensions\src\main\java\org\apache\druid\data\input\parquet\DruidParquetInputFormat.java,0,3,0,1,0,4
 druid-master\druid-master\processing\src\main\java\org\apache\druid\query\metadata\SegmentMetadataQueryQueryToolChest.java,0,104,1,34,0,139
 druid-master\druid-master\extensions-core\histogram\src\test\java\org\apache\druid\query\aggregation\histogram\QuantilePostAggregatorTest.java,0,17,0,4,0,21
 druid-master\druid-master\indexing-hadoop\src\test\java\org\apache\druid\indexer\HadoopDruidIndexerConfigTest.java,0,42,0,17,0,59
 druid-master\druid-master\core\src\test\java\org\apache\druid\java\util\common\RetryUtilsTest.java,0,25,2,3,0,30
 druid-master\druid-master\services\src\test\java\org\apache\druid\cli\CliMainTest.java,0,4,0,1,0,5
 druid-master\druid-master\sql\src\main\java\org\apache\druid\sql\http\ObjectLinesWriter.java,0,24,0,6,0,30
 druid-master\druid-master\benchmarks\src\test\java\org\apache\druid\server\coordinator\CostBalancerStrategyBenchmark.java,0,27,0,1,0,28
 druid-master\druid-master\extensions-core\parquet-extensions\src\test\java\org\apache\druid\data\input\parquet\DecimalParquetInputTest.java,0,27,0,12,0,39
 druid-master\druid-master\processing\src\main\java\org\apache\druid\segment\serde\DoubleNumericColumnPartSerdeV2.java,0,62,0,10,0,72
 druid-master\druid-master\server\src\main\java\org\apache\druid\server\log\DefaultRequestLogEventBuilderFactory.java,0,18,0,7,0,25
 druid-master\druid-master\processing\src\main\java\org\apache\druid\query\aggregation\LongMinVectorAggregator.java,0,16,0,3,0,19
 druid-master\druid-master\server\src\main\java\org\apache\druid\server\http\HistoricalResource.java,0,13,0,2,0,15
 druid-master\druid-master\processing\src\main\java\org\apache\druid\query\lookup\LookupBean.java,0,30,0,5,0,35
 druid-master\druid-master\core\src\main\java\org\apache\druid\java\util\common\guava\FilteredSequence.java,0,30,0,6,0,36
 druid-master\druid-master\indexing-service\src\main\java\org\apache\druid\indexing\common\task\ClientBasedTaskInfoProvider.java,0,16,0,3,0,19
 druid-master\druid-master\processing\src\main\java\org\apache\druid\collections\bitmap\WrappedImmutableBitSetBitmap.java,0,41,3,4,0,48
 druid-master\druid-master\extensions-contrib\thrift-extensions\src\test\java\org\apache\druid\data\input\thrift\ThriftInputRowParserTest.java,0,27,0,11,0,38
 druid-master\druid-master\core\src\main\java\org\apache\druid\java\util\common\concurrent\ScheduledExecutors.java,0,60,4,9,0,73
 druid-master\druid-master\indexing-service\src\test\java\org\apache\druid\indexing\seekablestream\SeekableStreamStartSequenceNumbersTest.java,0,16,0,7,0,23
 druid-master\druid-master\server\src\main\java\org\apache\druid\server\log\RequestLogEventBuilderFactory.java,0,7,0,6,0,13
 druid-master\druid-master\processing\src\main\java\org\apache\druid\segment\FloatColumnSerializerV2.java,0,44,1,6,0,51
 druid-master\druid-master\extensions-contrib\moving-average-query\src\main\java\org\apache\druid\query\movingaverage\averagers\LongMinAverager.java,0,11,1,3,0,15
 druid-master\druid-master\sql\src\main\java\org\apache\druid\sql\calcite\planner\Rules.java,0,62,0,31,0,93
 druid-master\druid-master\processing\src\main\java\org\apache\druid\segment\NilColumnValueSelector.java,0,28,0,11,0,39
 druid-master\druid-master\processing\src\main\java\org\apache\druid\query\aggregation\LongMaxAggregateCombiner.java,0,7,0,1,0,8
 druid-master\druid-master\core\src\main\java\org\apache\druid\java\util\metrics\cgroups\ProcSelfCgroupDiscoverer.java,0,7,0,1,0,8
 druid-master\druid-master\extensions-contrib\dropwizard-emitter\src\main\java\org\apache\druid\emitter\dropwizard\GaugesCache.java,0,8,0,1,0,9
 druid-master\druid-master\extensions-core\avro-extensions\src\test\java\org\apache\druid\data\input\avro\AvroOCFInputFormatTest.java,0,16,0,7,0,23
 druid-master\druid-master\indexing-service\src\main\java\org\apache\druid\indexing\common\task\batch\parallel\distribution\ArrayOfStringsNullSafeSerde.java,0,10,0,2,0,12
 druid-master\druid-master\processing\src\test\java\org\apache\druid\query\filter\RegexDimFilterTest.java,0,11,0,5,0,16
 druid-master\druid-master\server\src\test\java\org\apache\druid\metadata\SQLMetadataStorageActionHandlerTest.java,0,89,0,35,0,124
 druid-master\druid-master\processing\src\main\java\org\apache\druid\query\timeboundary\TimeBoundaryQueryQueryToolChest.java,0,78,2,18,0,98
 druid-master\druid-master\sql\src\main\java\org\apache\druid\sql\calcite\expression\builtin\ArrayAppendOperatorConversion.java,0,5,0,1,0,6
 druid-master\druid-master\server\src\test\java\org\apache\druid\server\SegmentManagerTest.java,0,115,2,58,0,175
 druid-master\druid-master\services\src\main\java\org\apache\druid\cli\ExportMetadata.java,0,140,10,53,0,203
 druid-master\druid-master\processing\src\test\java\org\apache\druid\query\aggregation\constant\LongConstantBufferAggregatorTest.java,0,16,0,2,0,18
 druid-master\druid-master\processing\src\test\java\org\apache\druid\query\groupby\GroupByQueryRunnerFailureTest.java,0,74,0,25,0,99
 druid-master\druid-master\server\src\main\java\org\apache\druid\server\coordinator\duty\CoordinatorDuty.java,0,7,0,6,0,13
 druid-master\druid-master\processing\src\main\java\org\apache\druid\query\aggregation\first\FloatFirstBufferAggregator.java,0,31,0,3,0,34
 druid-master\druid-master\processing\src\test\java\org\apache\druid\query\MultiValuedDimensionTest.java,0,294,2,193,0,489
 druid-master\druid-master\extensions-core\histogram\src\main\java\org\apache\druid\query\aggregation\histogram\QuantilePostAggregator.java,0,42,1,4,0,47
 druid-master\druid-master\processing\src\test\java\org\apache\druid\query\monomorphicprocessing\StringRuntimeShapeTest.java,0,20,0,8,0,28
 druid-master\druid-master\processing\src\test\java\org\apache\druid\query\expression\TimestampExtractExprMacroTest.java,0,29,0,11,0,40
 druid-master\druid-master\core\src\main\java\org\apache\druid\metadata\MetadataStorageConnectorConfig.java,0,57,1,9,3,70
 druid-master\druid-master\sql\src\main\java\org\apache\druid\sql\calcite\rel\DruidConvention.java,0,21,2,2,0,25
 druid-master\druid-master\server\src\main\java\org\apache\druid\server\coordination\SegmentChangeRequestLoad.java,0,31,0,4,0,35
 druid-master\druid-master\extensions-core\datasketches\src\test\java\org\apache\druid\query\aggregation\datasketches\quantiles\DoublesSketchMergeAggregatorFactoryTest.java,0,8,0,4,0,12
 druid-master\druid-master\extensions-core\druid-pac4j\src\main\java\org\apache\druid\security\pac4j\Pac4jFilter.java,0,38,2,13,0,53
 druid-master\druid-master\integration-tests\src\test\java\org\apache\druid\tests\indexer\ITGcsToGcsParallelIndexTest.java,0,12,0,9,0,21
 druid-master\druid-master\server\src\main\java\org\apache\druid\client\BrokerSegmentWatcherConfig.java,0,21,0,1,0,22
 druid-master\druid-master\core\src\test\java\org\apache\druid\java\util\emitter\core\HttpEmitterConfigTest.java,0,71,0,32,0,103
 druid-master\druid-master\sql\src\main\java\org\apache\druid\sql\calcite\expression\builtin\ContainsOperatorConversion.java,0,20,1,6,0,27
 druid-master\druid-master\processing\src\test\java\org\apache\druid\query\QueryInterruptedExceptionTest.java,0,41,0,28,0,69
 druid-master\druid-master\indexing-service\src\main\java\org\apache\druid\indexing\overlord\setup\WorkerCategorySpec.java,0,52,0,3,0,55
 druid-master\druid-master\processing\src\main\java\org\apache\druid\query\aggregation\post\ArithmeticPostAggregator.java,0,117,3,13,0,133
 druid-master\druid-master\extendedset\src\main\java\org\apache\druid\extendedset\intset\ConciseSetUtils.java,0,122,4,12,0,138
 druid-master\druid-master\server\src\main\java\org\apache\druid\indexing\overlord\IndexerMetadataStorageCoordinator.java,0,95,0,88,0,183
 druid-master\druid-master\processing\src\main\java\org\apache\druid\segment\generator\SequentialDistribution.java,0,16,0,2,0,18
 druid-master\druid-master\integration-tests\src\test\java\org\apache\druid\tests\indexer\ITS3AssumeRoleWithOverrideCredentialsIndexTest.java,0,28,0,20,0,48
 druid-master\druid-master\processing\src\main\java\org\apache\druid\query\topn\TopNQuery.java,0,122,0,10,0,132
 druid-master\druid-master\core\src\main\java\org\apache\druid\math\expr\package-info.java,0,1,0,1,0,2
 druid-master\druid-master\core\src\main\java\org\apache\druid\java\util\common\Intervals.java,0,30,0,6,0,36
 druid-master\druid-master\extensions-core\lookups-cached-global\src\main\java\org\apache\druid\query\lookup\namespace\UriExtractionNamespace.java,0,272,2,37,0,311
 druid-master\druid-master\indexing-hadoop\src\main\java\org\apache\druid\indexer\HadoopDruidIndexerMapper.java,0,43,2,16,0,61
 druid-master\druid-master\processing\src\test\java\org\apache\druid\query\expression\IPv4AddressStringifyExprMacroTest.java,0,42,6,2,0,50
 druid-master\druid-master\processing\src\main\java\org\apache\druid\query\aggregation\any\StringAnyVectorAggregator.java,0,43,0,3,0,46
 druid-master\druid-master\extensions-core\datasketches\src\test\java\org\apache\druid\query\aggregation\datasketches\theta\BufferHashGrouperUsingSketchMergeAggregatorFactoryTest.java,0,18,0,8,0,26
 druid-master\druid-master\core\src\main\java\org\apache\druid\data\input\FirehoseFactoryToInputSourceAdaptor.java,0,41,0,8,0,49
 druid-master\druid-master\server\src\main\java\org\apache\druid\server\NoopQuerySegmentWalker.java,0,13,0,5,0,18
 druid-master\druid-master\server\src\test\java\org\apache\druid\client\cache\ByteCountingLRUMapTest.java,0,27,0,5,0,32
 druid-master\druid-master\benchmarks\src\test\java\org\apache\druid\benchmark\query\SerializingQueryRunner.java,0,16,0,2,0,18
 druid-master\druid-master\server\src\main\java\org\apache\druid\metadata\SQLServerMetadataStorageActionHandler.java,0,17,4,5,0,26
 druid-master\druid-master\processing\src\main\java\org\apache\druid\segment\data\VSizeColumnarMultiIntsSerializer.java,0,61,1,8,0,70
 druid-master\druid-master\processing\src\main\java\org\apache\druid\segment\data\SliceIndexedInts.java,0,20,0,2,0,22
 druid-master\druid-master\extensions-core\postgresql-metadata-storage\src\main\java\org\apache\druid\metadata\storage\postgresql\PostgreSQLConnector.java,0,77,2,22,0,101
 druid-master\druid-master\sql\src\main\java\org\apache\druid\sql\calcite\expression\builtin\GreatestOperatorConversion.java,0,6,0,1,0,7
 druid-master\druid-master\processing\src\main\java\org\apache\druid\collections\bitmap\WrappedConciseBitmap.java,0,41,0,2,0,43
 druid-master\druid-master\core\src\test\java\org\apache\druid\indexer\TaskStatusPlusTest.java,0,14,0,4,0,18
 druid-master\druid-master\indexing-service\src\main\java\org\apache\druid\indexing\seekablestream\common\OrderedPartitionableRecord.java,0,44,3,7,0,54
 druid-master\druid-master\core\src\main\java\org\apache\druid\timeline\partition\BuildingShardSpec.java,0,26,0,19,0,45
 druid-master\druid-master\processing\src\main\java\org\apache\druid\query\aggregation\hyperloglog\HyperUniqueFinalizingPostAggregator.java,0,59,0,11,0,70
 druid-master\druid-master\server\src\test\java\org\apache\druid\curator\CuratorTestBase.java,0,63,3,13,0,79
 druid-master\druid-master\server\src\main\java\org\apache\druid\server\http\CoordinatorResource.java,0,38,0,9,0,47
 druid-master\druid-master\server\src\main\java\org\apache\druid\client\cache\CacheProvider.java,0,3,0,3,0,6
 druid-master\druid-master\server\src\test\java\org\apache\druid\guice\QueryableModuleTest.java,0,14,0,8,0,22
 druid-master\druid-master\processing\src\test\java\org\apache\druid\query\TestQuery.java,0,23,0,2,0,25
 druid-master\druid-master\extensions-contrib\ambari-metrics-emitter\src\test\java\org\apache\druid\emitter\ambari\metrics\WhiteListBasedDruidToTimelineEventConverterTest.java,0,52,5,28,0,85
 druid-master\druid-master\processing\src\main\java\org\apache\druid\segment\data\BitmapSerde.java,0,9,1,2,0,12
 druid-master\druid-master\processing\src\test\java\org\apache\druid\query\aggregation\any\LongAnyVectorAggregatorTest.java,0,27,0,1,0,28
 druid-master\druid-master\core\src\main\java\org\apache\druid\data\input\InputEntityReader.java,0,4,0,2,0,6
 druid-master\druid-master\processing\src\main\java\org\apache\druid\segment\serde\package-info.java,0,1,0,1,0,2
 druid-master\druid-master\indexing-service\src\main\java\org\apache\druid\indexing\overlord\setup\FillCapacityWithCategorySpecWorkerSelectStrategy.java,0,21,0,3,0,24
 druid-master\druid-master\server\src\main\java\org\apache\druid\metadata\SQLMetadataRuleManager.java,0,114,2,38,0,154
 druid-master\druid-master\indexing-service\src\test\java\org\apache\druid\indexing\appenderator\ActionBasedUsedSegmentCheckerTest.java,0,11,0,8,0,19
 druid-master\druid-master\processing\src\main\java\org\apache\druid\query\select\SelectQuery.java,0,63,0,4,0,67
 druid-master\druid-master\processing\src\main\java\org\apache\druid\segment\join\table\IndexedTable.java,0,53,0,22,0,75
 druid-master\druid-master\processing\src\main\java\org\apache\druid\query\aggregation\FloatMinVectorAggregator.java,0,16,0,3,0,19
 druid-master\druid-master\extensions-contrib\tdigestsketch\src\main\java\org\apache\druid\query\aggregation\tdigestsketch\sql\TDigestGenerateSketchSqlAggregator.java,0,21,0,11,0,32
 druid-master\druid-master\processing\src\test\java\org\apache\druid\segment\filter\BoundFilterTest.java,0,189,2,106,0,297
 druid-master\druid-master\core\src\main\java\org\apache\druid\java\util\emitter\core\NoopEmitter.java,0,8,0,1,0,9
 druid-master\druid-master\processing\src\test\java\org\apache\druid\segment\filter\JavaScriptFilterTest.java,0,71,3,37,0,111
 druid-master\druid-master\processing\src\main\java\org\apache\druid\query\search\RoaringBitmapDecisionHelper.java,0,9,1,3,0,13
 druid-master\druid-master\indexing-hadoop\src\main\java\org\apache\druid\indexer\package-info.java,0,1,0,1,0,2
 druid-master\druid-master\core\src\test\java\org\apache\druid\data\input\impl\JSONParseSpecTest.java,0,28,0,17,0,45
 druid-master\druid-master\indexing-service\src\test\java\org\apache\druid\indexing\worker\WorkerTaskManagerTest.java,0,76,2,40,0,118
 druid-master\druid-master\core\src\main\java\org\apache\druid\java\util\common\guava\YieldingSequenceBase.java,0,11,2,3,0,16
 druid-master\druid-master\extensions-core\hdfs-storage\src\test\java\org\apache\druid\storage\hdfs\HdfsDataSegmentKillerTest.java,0,53,0,15,0,68
 druid-master\druid-master\extensions-contrib\graphite-emitter\src\test\java\org\apache\druid\emitter\graphite\DruidToWhiteListBasedConverterTest.java,0,8,0,3,0,11
 druid-master\druid-master\server\src\test\java\org\apache\druid\server\coordinator\rules\PeriodDropRuleTest.java,0,12,0,4,0,16
 druid-master\druid-master\processing\src\test\java\org\apache\druid\segment\TestFloatColumnSelector.java,0,3,0,1,0,4
 druid-master\druid-master\indexing-service\src\test\java\org\apache\druid\indexing\overlord\sampler\CsvInputSourceSamplerTest.java,0,11,0,4,0,15
 druid-master\druid-master\core\src\main\java\org\apache\druid\utils\ConnectionUriUtils.java,0,86,11,38,0,135
 druid-master\druid-master\core\src\main\java\org\apache\druid\timeline\VersionedIntervalTimeline.java,0,275,6,101,2,384
 druid-master\druid-master\extensions-core\google-extensions\src\test\java\org\apache\druid\storage\google\GoogleByteSourceTest.java,0,6,1,1,0,8
 druid-master\druid-master\server\src\main\java\org\apache\druid\server\emitter\NoopEmitterModule.java,0,7,1,1,0,9
 druid-master\druid-master\server\src\test\java\org\apache\druid\server\http\CoordinatorDynamicConfigTest.java,0,140,0,42,0,182
 druid-master\druid-master\processing\src\main\java\org\apache\druid\segment\data\CloseableIndexed.java,0,1,0,1,0,2
 druid-master\druid-master\server\src\main\java\org\apache\druid\client\FilteredServerInventoryView.java,0,4,0,2,0,6
 druid-master\druid-master\core\src\main\java\org\apache\druid\timeline\PruneLastCompactionState.java,0,6,0,6,0,12
 druid-master\druid-master\core\src\main\java\org\apache\druid\math\expr\FunctionalExpr.java,0,124,0,22,0,146
 druid-master\druid-master\processing\src\main\java\org\apache\druid\segment\data\CachingIndexed.java,0,45,0,6,0,51
 druid-master\druid-master\core\src\test\java\org\apache\druid\java\util\common\concurrent\ScheduledExecutorsTest.java,0,9,0,2,0,11
 druid-master\druid-master\integration-tests\src\test\java\org\apache\druid\tests\indexer\ITAzureToHdfsParallelIndexTest.java,0,12,0,9,0,21
 druid-master\druid-master\processing\src\main\java\org\apache\druid\query\aggregation\JavaScriptAggregator.java,0,26,0,4,0,30
 druid-master\druid-master\indexing-service\src\main\java\org\apache\druid\indexing\input\GeneratorInputSource.java,0,116,0,17,0,133
 druid-master\druid-master\processing\src\main\java\org\apache\druid\query\BitmapResultFactory.java,0,41,0,21,0,62
 druid-master\druid-master\processing\src\test\java\org\apache\druid\query\aggregation\any\FloatAnyVectorAggregatorTest.java,0,28,0,1,0,29
 druid-master\druid-master\core\src\main\java\org\apache\druid\math\expr\vector\VectorComparisonProcessors.java,0,321,1,27,0,349
 druid-master\druid-master\core\src\main\java\org\apache\druid\data\input\impl\InputRowParser.java,0,13,0,5,0,18
 druid-master\druid-master\server\src\main\java\org\apache\druid\server\log\LoggingRequestLogger.java,0,39,0,8,0,47
 druid-master\druid-master\extensions-contrib\influx-extensions\src\test\java\org\apache\druid\data\input\influx\InfluxParserTest.java,0,71,4,9,0,84
 druid-master\druid-master\services\src\main\java\org\apache\druid\guice\MiddleManagerServiceModule.java,0,6,0,1,0,7
 druid-master\druid-master\processing\src\main\java\org\apache\druid\segment\filter\ValueMatchers.java,0,69,1,15,0,85
 druid-master\druid-master\extensions-core\datasketches\src\main\java\org\apache\druid\query\aggregation\datasketches\theta\sql\ThetaSketchSetNotOperatorConversion.java,0,4,0,2,0,6
 druid-master\druid-master\extensions-core\s3-extensions\src\main\java\org\apache\druid\storage\s3\KmsServerSideEncryption.java,0,10,0,3,0,13
 druid-master\druid-master\core\src\main\java\org\apache\druid\java\util\metrics\HttpPostEmitterMonitor.java,0,46,0,14,2,62
 druid-master\druid-master\server\src\main\java\org\apache\druid\server\initialization\jetty\JettyServerInitializer.java,0,2,0,1,0,3
 druid-master\druid-master\processing\src\main\java\org\apache\druid\segment\incremental\ParseExceptionReport.java,0,39,0,1,0,40
 druid-master\druid-master\extensions-contrib\tdigestsketch\src\main\java\org\apache\druid\query\aggregation\tdigestsketch\TDigestSketchModule.java,0,11,0,5,0,16
 druid-master\druid-master\indexing-service\src\main\java\org\apache\druid\indexing\common\task\KillUnusedSegmentsTask.java,0,29,0,8,0,37
 druid-master\druid-master\core\src\test\java\org\apache\druid\java\util\common\io\NativeIOTest.java,0,17,0,1,0,18
 druid-master\druid-master\indexing-service\src\main\java\org\apache\druid\indexing\common\task\batch\parallel\PartialDimensionDistributionParallelIndexTaskRunner.java,0,89,3,33,0,125
 druid-master\druid-master\extensions-core\druid-basic-security\src\test\java\org\apache\druid\security\basic\authentication\LdapUserPrincipalTest.java,0,32,0,5,0,37
 druid-master\druid-master\indexing-service\src\main\java\org\apache\druid\indexing\common\task\batch\partition\RangePartitionAnalysis.java,0,39,0,9,0,48
 druid-master\druid-master\indexing-service\src\test\java\org\apache\druid\indexing\overlord\setup\EqualDistributionWorkerSelectStrategyTest.java,0,58,0,23,0,81
 druid-master\druid-master\processing\src\main\java\org\apache\druid\query\groupby\orderby\NoopLimitSpec.java,0,18,1,2,0,21
 druid-master\druid-master\processing\src\main\java\org\apache\druid\segment\selector\settable\SettableLongColumnValueSelector.java,0,17,0,3,0,20
 druid-master\druid-master\indexing-hadoop\src\main\java\org\apache\druid\indexer\HadoopTuningConfig.java,0,171,4,34,0,209
 druid-master\druid-master\processing\src\main\java\org\apache\druid\query\metadata\SegmentAnalyzer.java,0,65,3,28,0,96
 druid-master\druid-master\extensions-contrib\statsd-emitter\src\test\java\org\apache\druid\emitter\statsd\StatsDEmitterTest.java,0,55,3,14,0,72
 druid-master\druid-master\server\src\main\java\org\apache\druid\server\log\RequestLoggerProvider.java,0,2,0,2,0,4
 druid-master\druid-master\processing\src\main\java\org\apache\druid\query\aggregation\cardinality\HyperLogLogCollectorAggregateCombiner.java,0,9,0,2,0,11
 druid-master\druid-master\processing\src\main\java\org\apache\druid\segment\data\ColumnarFloatsSerializer.java,0,4,0,1,0,5
 druid-master\druid-master\processing\src\main\java\org\apache\druid\query\aggregation\first\LongFirstBufferAggregator.java,0,32,0,4,0,36
 druid-master\druid-master\extensions-core\s3-extensions\src\main\java\org\apache\druid\storage\s3\S3TimestampVersionedDataFinder.java,0,17,0,11,0,28
 druid-master\druid-master\benchmarks\src\test\java\org\apache\druid\benchmark\IndexedTableLoadingBenchmark.java,0,32,1,3,0,36
 druid-master\druid-master\indexing-service\src\test\java\org\apache\druid\indexing\overlord\ZkWorkerTest.java,0,36,0,9,0,45
 druid-master\druid-master\processing\src\main\java\org\apache\druid\query\topn\TopNMetricSpecBuilder.java,0,7,0,1,0,8
 druid-master\druid-master\server\src\main\java\org\apache\druid\segment\join\InlineJoinableFactory.java,0,11,0,5,0,16
 druid-master\druid-master\server\src\test\java\org\apache\druid\server\SetAndVerifyContextQueryRunnerTest.java,0,42,0,28,0,70
 druid-master\druid-master\processing\src\main\java\org\apache\druid\segment\column\SpatialIndex.java,0,2,0,1,0,3
 druid-master\druid-master\processing\src\main\java\org\apache\druid\segment\data\CompressionStrategy.java,0,144,7,30,0,181
 druid-master\druid-master\processing\src\test\java\org\apache\druid\query\topn\TopNQueryRunnerBenchmark.java,0,38,0,6,0,44
 druid-master\druid-master\server\src\test\java\org\apache\druid\server\http\security\SecuritySanityCheckFilterTest.java,0,20,0,15,0,35
 druid-master\druid-master\core\src\main\java\org\apache\druid\utils\Streams.java,0,9,0,2,0,11
 druid-master\druid-master\processing\src\main\java\org\apache\druid\query\aggregation\mean\DoubleMeanAggregatorFactory.java,0,59,0,9,0,68
 druid-master\druid-master\core\src\main\java\org\apache\druid\timeline\partition\NumberedOverwritingPartitionChunk.java,0,38,0,4,0,42
 druid-master\druid-master\sql\src\main\java\org\apache\druid\sql\avatica\AvaticaServerConfig.java,0,36,0,2,0,38
 druid-master\druid-master\indexing-hadoop\src\main\java\org\apache\druid\indexer\hadoop\SegmentInputRow.java,0,33,0,3,0,36
 druid-master\druid-master\core\src\main\java\org\apache\druid\java\util\metrics\cgroups\CpuAcct.java,0,51,1,6,2,60
 druid-master\druid-master\extensions-contrib\moving-average-query\src\main\java\org\apache\druid\query\movingaverage\averagers\LongMaxAveragerFactory.java,0,10,0,2,0,12
 druid-master\druid-master\extensions-contrib\dropwizard-emitter\src\main\java\org\apache\druid\emitter\dropwizard\DropwizardEmitterConfig.java,0,64,1,4,0,69
 druid-master\druid-master\server\src\main\java\org\apache\druid\guice\ServerModule.java,0,14,0,4,0,18
 druid-master\druid-master\server\src\main\java\org\apache\druid\metadata\MySQLMetadataStorageActionHandlerFactory.java,0,13,0,4,0,17
 druid-master\druid-master\core\src\test\java\org\apache\druid\java\util\common\guava\SkippingSequenceTest.java,0,39,0,8,2,49
 druid-master\druid-master\server\src\main\java\org\apache\druid\server\scheduling\ManualQueryPrioritizationStrategy.java,0,10,0,5,0,15
 druid-master\druid-master\core\src\main\java\org\apache\druid\math\expr\ConstantExpr.java,0,121,0,20,0,141
 druid-master\druid-master\processing\src\main\java\org\apache\druid\segment\data\ObjectStrategy.java,0,13,0,6,0,19
 druid-master\druid-master\extensions-core\datasketches\src\main\java\org\apache\druid\query\aggregation\datasketches\hll\sql\HllSketchEstimateOperatorConversion.java,0,18,0,5,0,23
 druid-master\druid-master\processing\src\test\java\org\apache\druid\segment\generator\DataGeneratorTest.java,0,145,0,17,0,162
 druid-master\druid-master\extensions-core\postgresql-metadata-storage\src\test\java\org\apache\druid\metadata\storage\postgresql\PostgreSQLConnectorTest.java,0,10,0,7,0,17
 druid-master\druid-master\extensions-core\kinesis-indexing-service\src\test\java\org\apache\druid\indexing\kinesis\KinesisIndexTaskSerdeTest.java,0,29,0,20,0,49
 druid-master\druid-master\extensions-core\datasketches\src\main\java\org\apache\druid\query\aggregation\datasketches\quantiles\DoublesSketchBuildBufferAggregator.java,0,34,0,6,0,40
 druid-master\druid-master\core\src\main\java\org\apache\druid\data\input\MapBasedRow.java,0,46,1,2,1,50
 druid-master\druid-master\core\src\main\java\org\apache\druid\common\config\ConfigSerde.java,0,7,0,3,0,10
 druid-master\druid-master\processing\src\main\java\org\apache\druid\segment\data\Indexed.java,0,9,0,5,0,14
 druid-master\druid-master\extensions-core\avro-extensions\src\test\java\org\apache\druid\data\input\AvroStreamInputFormatTest.java,0,56,0,33,0,89
 druid-master\druid-master\server\src\main\java\org\apache\druid\server\coordinator\CachingCostBalancerStrategyFactory.java,0,50,0,18,0,68
 druid-master\druid-master\core\src\main\java\org\apache\druid\java\util\emitter\core\Event.java,0,3,0,1,0,4
 druid-master\druid-master\processing\src\main\java\org\apache\druid\segment\DimensionSelector.java,0,89,1,41,0,131
 druid-master\druid-master\processing\src\main\java\org\apache\druid\query\groupby\epinephelinae\BufferArrayGrouper.java,0,96,0,32,0,128
 druid-master\druid-master\core\src\main\java\org\apache\druid\metadata\MetadataStorageConnector.java,0,25,0,5,0,30
 druid-master\druid-master\extensions-core\kinesis-indexing-service\src\main\java\org\apache\druid\indexing\kinesis\KinesisIndexTaskClient.java,0,14,0,2,0,16
 druid-master\druid-master\core\src\main\java\org\apache\druid\guice\ConditionalMultibind.java,0,97,0,34,1,132
 druid-master\druid-master\extensions-core\hdfs-storage\src\main\java\org\apache\druid\storage\hdfs\HdfsDataSegmentPuller.java,0,76,5,15,0,96
 druid-master\druid-master\core\src\main\java\org\apache\druid\timeline\partition\LinearPartitionChunk.java,0,29,0,2,0,31
 druid-master\druid-master\core\src\main\java\org\apache\druid\data\input\impl\JsonInputFormat.java,0,54,1,12,1,68
 druid-master\druid-master\core\src\main\java\org\apache\druid\java\util\common\parsers\JSONPathSpec.java,0,27,1,2,1,31
 druid-master\druid-master\processing\src\main\java\org\apache\druid\query\aggregation\first\NumericFirstAggregator.java,0,24,1,4,0,29
 druid-master\druid-master\processing\src\main\java\org\apache\druid\segment\generator\ColumnValueGenerator.java,0,40,0,15,0,55
 druid-master\druid-master\processing\src\main\java\org\apache\druid\query\topn\types\TopNColumnAggregatesProcessorFactory.java,0,22,1,13,0,36
 druid-master\druid-master\processing\src\main\java\org\apache\druid\query\filter\vector\VectorValueMatcherColumnProcessorFactory.java,0,14,1,3,0,18
 druid-master\druid-master\core\src\test\java\org\apache\druid\timeline\partition\SingleDimensionPartialShardSpecTest.java,0,13,0,7,0,20
 druid-master\druid-master\sql\src\main\java\org\apache\druid\sql\calcite\filtration\BoundRefKey.java,0,43,0,3,0,46
 druid-master\druid-master\sql\src\main\java\org\apache\druid\sql\http\ArrayWriter.java,0,28,0,8,0,36
 druid-master\druid-master\processing\src\main\java\org\apache\druid\query\aggregation\cardinality\vector\CardinalityVectorProcessorFactory.java,0,32,0,7,0,39
 druid-master\druid-master\indexing-service\src\test\java\org\apache\druid\indexing\seekablestream\SeekableStreamEndSequenceNumbersTest.java,0,21,0,9,0,30
 druid-master\druid-master\extensions-core\druid-basic-security\src\main\java\org\apache\druid\security\basic\authorization\db\cache\CoordinatorBasicAuthorizerCacheNotifier.java,0,36,0,10,0,46
 druid-master\druid-master\integration-tests\src\main\java\org\apache\druid\cli\CustomNodeRoleCommandCreator.java,0,4,0,1,0,5
 druid-master\druid-master\server\src\main\java\org\apache\druid\segment\realtime\SegmentPublisher.java,0,2,0,1,0,3
 druid-master\druid-master\processing\src\test\java\org\apache\druid\segment\filter\PredicateValueMatcherFactoryTest.java,0,128,0,66,0,194
 druid-master\druid-master\server\src\main\java\org\apache\druid\client\BrokerInternalQueryConfig.java,0,5,0,1,0,6
 druid-master\druid-master\server\src\main\java\org\apache\druid\server\log\EmittingRequestLogger.java,0,25,0,3,0,28
 druid-master\druid-master\core\src\test\java\org\apache\druid\math\expr\ExprsTest.java,0,22,4,9,0,35
 druid-master\druid-master\core\src\main\java\org\apache\druid\math\expr\Parser.java,0,199,6,114,1,320
 druid-master\druid-master\indexing-hadoop\src\test\java\org\apache\druid\indexer\DetermineHashedPartitionsJobTest.java,0,51,0,17,0,68
 druid-master\druid-master\server\src\test\java\org\apache\druid\segment\realtime\appenderator\ClosedSegmentsSinksBatchAppenderatorDriverTest.java,0,50,1,17,0,68
 druid-master\druid-master\processing\src\test\java\org\apache\druid\segment\filter\AndFilterTest.java,0,23,1,3,0,27
 druid-master\druid-master\processing\src\test\java\org\apache\druid\query\aggregation\first\StringFirstLastUtilsTest.java,0,15,0,7,0,22
 druid-master\druid-master\sql\src\test\java\org\apache\druid\sql\calcite\aggregation\SqlAggregationModuleTest.java,0,15,1,6,0,22
 druid-master\druid-master\server\src\main\java\org\apache\druid\segment\realtime\appenderator\SegmentWithState.java,0,69,0,18,0,87
 druid-master\druid-master\server\src\test\java\org\apache\druid\server\coordination\coordination\BatchDataSegmentAnnouncerTest.java,0,117,1,29,0,147
 druid-master\druid-master\core\src\test\java\org\apache\druid\java\util\http\client\response\InputStreamFullResponseHandlerTest.java,0,16,0,11,0,27
 druid-master\druid-master\processing\src\main\java\org\apache\druid\segment\package-info.java,0,1,0,1,0,2
 druid-master\druid-master\core\src\main\java\org\apache\druid\timeline\partition\NumberedShardSpec.java,0,45,0,6,0,51
 druid-master\druid-master\processing\src\main\java\org\apache\druid\segment\data\CompressionFactory.java,0,169,0,47,0,216
 druid-master\druid-master\extensions-core\druid-basic-security\src\main\java\org\apache\druid\security\basic\authentication\db\updater\BasicAuthenticatorMetadataStorageUpdater.java,0,13,0,7,0,20
 druid-master\druid-master\core\src\main\java\org\apache\druid\math\expr\vector\CastToTypeVectorProcessor.java,0,12,1,3,0,16
 druid-master\druid-master\sql\src\test\java\org\apache\druid\sql\calcite\CalciteJoinQueryTest.java,0,932,6,591,0,1529
 druid-master\druid-master\server\src\main\java\org\apache\druid\server\coordinator\duty\BalanceSegments.java,0,79,11,43,0,133
 druid-master\druid-master\extensions-contrib\time-min-max\src\test\java\org\apache\druid\query\aggregation\TimestampGroupByAggregationTest.java,0,86,3,7,0,96
 druid-master\druid-master\processing\src\test\java\org\apache\druid\segment\join\table\IndexedTableJoinMatcherTest.java,0,210,4,71,0,285
 druid-master\druid-master\core\src\main\java\org\apache\druid\java\util\common\HumanReadableBytes.java,0,111,4,15,0,130
 druid-master\druid-master\core\src\main\java\org\apache\druid\common\config\ConfigManager.java,0,99,4,17,2,122
 druid-master\druid-master\core\src\main\java\org\apache\druid\segment\loading\LoadSpec.java,0,12,0,1,0,13
 druid-master\druid-master\processing\src\main\java\org\apache\druid\query\search\SearchSortSpec.java,0,28,0,2,0,30
 druid-master\druid-master\extensions-contrib\materialized-view-maintenance\src\main\java\org\apache\druid\indexing\materializedview\MaterializedViewSupervisorSpec.java,0,140,2,9,0,151
 druid-master\druid-master\core\src\main\java\org\apache\druid\math\expr\vector\VectorMathProcessors.java,0,900,3,68,1,972
 druid-master\druid-master\extensions-core\kinesis-indexing-service\src\test\java\org\apache\druid\indexing\kinesis\KinesisSamplerSpecTest.java,0,57,0,19,0,76
 druid-master\druid-master\server\src\test\java\org\apache\druid\indexing\overlord\supervisor\SupervisorStatusTest.java,0,9,0,4,0,13
 druid-master\druid-master\indexing-service\src\main\java\org\apache\druid\indexing\common\task\HadoopTask.java,0,80,3,48,0,131
 druid-master\druid-master\indexing-service\src\main\java\org\apache\druid\indexing\common\actions\TaskActionToolbox.java,0,35,0,3,0,38
 druid-master\druid-master\processing\src\test\java\org\apache\druid\segment\join\table\RowBasedIndexBuilderTest.java,0,43,5,2,0,50
 druid-master\druid-master\core\src\test\java\org\apache\druid\java\util\http\client\response\ObjectOrErrorResponseHandlerTest.java,0,26,1,20,0,47
 druid-master\druid-master\processing\src\test\java\org\apache\druid\query\JoinDataSourceTest.java,0,66,15,11,0,92
 druid-master\druid-master\integration-tests\src\test\java\org\apache\druid\tests\hadoop\ITS3InputToHdfsHadoopIndexTest.java,0,12,0,10,0,22
 druid-master\druid-master\extensions-core\datasketches\src\main\java\org\apache\druid\query\aggregation\datasketches\tuple\ArrayOfDoublesSketchToVariancesPostAggregator.java,0,17,0,7,0,24
 druid-master\druid-master\extensions-core\histogram\src\main\java\org\apache\druid\query\aggregation\histogram\sql\QuantileSqlAggregator.java,0,26,0,16,0,42
 druid-master\druid-master\extensions-core\kafka-indexing-service\src\main\java\org\apache\druid\indexing\kafka\KafkaIndexTaskIOConfig.java,0,76,0,22,0,98
 druid-master\druid-master\indexing-service\src\main\java\org\apache\druid\indexing\overlord\TaskRunnerWorkItem.java,0,54,0,3,0,57
 druid-master\druid-master\integration-tests\src\test\java\org\apache\druid\tests\hadoop\AbstractS3InputHadoopIndexTest.java,0,16,1,7,0,24
 druid-master\druid-master\sql\src\test\java\org\apache\druid\sql\SqlRowTransformerTest.java,0,14,0,5,0,19
 druid-master\druid-master\processing\src\main\java\org\apache\druid\query\BaseQuery.java,0,111,1,12,0,124
 druid-master\druid-master\sql\src\main\java\org\apache\druid\sql\calcite\expression\Expressions.java,0,123,4,83,0,210
 druid-master\druid-master\sql\src\test\java\org\apache\druid\sql\calcite\expression\ExpressionsTest.java,0,308,0,136,0,444
 druid-master\druid-master\sql\src\test\java\org\apache\druid\sql\calcite\expression\GreatestExpressionTest.java,0,67,0,6,0,73
 druid-master\druid-master\server\src\main\java\org\apache\druid\server\security\ResourceAction.java,0,23,0,1,0,24
 druid-master\druid-master\processing\src\test\java\org\apache\druid\segment\virtual\ExpressionVirtualColumnTest.java,0,166,1,62,0,229
 druid-master\druid-master\extensions-core\parquet-extensions\src\test\java\org\apache\druid\data\input\parquet\CompatParquetInputTest.java,0,54,0,33,0,87
 druid-master\druid-master\processing\src\test\java\org\apache\druid\segment\SchemalessIndexTest.java,0,121,3,32,0,156
 druid-master\druid-master\core\src\test\java\org\apache\druid\java\util\metrics\CgroupMemoryMonitorTest.java,0,14,2,4,1,21
 druid-master\druid-master\indexing-service\src\main\java\org\apache\druid\indexing\common\task\batch\parallel\PartialDimensionCardinalityParallelIndexTaskRunner.java,0,22,0,3,0,25
 druid-master\druid-master\extensions-contrib\materialized-view-selection\src\test\java\org\apache\druid\query\materializedview\DatasourceOptimizerTest.java,0,62,0,18,0,80
 druid-master\druid-master\extensions-core\druid-bloom-filter\src\test\java\org\apache\druid\query\filter\BloomKFilterTest.java,0,72,0,10,0,82
 druid-master\druid-master\processing\src\main\java\org\apache\druid\segment\serde\SpatialIndexColumnPartSupplier.java,0,10,0,1,0,11
 druid-master\druid-master\indexing-service\src\main\java\org\apache\druid\indexing\worker\shuffle\ShuffleMonitor.java,0,18,0,8,0,26
 druid-master\druid-master\sql\src\test\java\org\apache\druid\sql\calcite\util\QueryLogHook.java,0,25,2,2,0,29
 druid-master\druid-master\indexing-service\src\main\java\org\apache\druid\indexing\common\task\batch\parallel\PartialRangeSegmentGenerateParallelIndexTaskRunner.java,0,26,0,4,0,30
 druid-master\druid-master\server\src\main\java\org\apache\druid\server\security\AuthorizationUtils.java,0,84,3,67,0,154
 druid-master\druid-master\server\src\main\java\org\apache\druid\server\router\ManagementProxyConfig.java,0,5,0,1,0,6
 druid-master\druid-master\processing\src\test\java\org\apache\druid\segment\data\CompressionStrategyTest.java,0,44,0,13,0,57
 druid-master\druid-master\core\src\test\java\org\apache\druid\timeline\partition\NumberedShardSpecTest.java,0,60,0,12,1,73
 druid-master\druid-master\indexing-hadoop\src\main\java\org\apache\druid\indexer\DataSegmentAndIndexZipFilePath.java,0,34,0,2,0,36
 druid-master\druid-master\processing\src\test\java\org\apache\druid\segment\filter\ValueMatchersTest.java,0,26,0,10,0,36
 druid-master\druid-master\processing\src\test\java\org\apache\druid\query\aggregation\FloatMaxAggregationTest.java,0,36,0,14,0,50
 druid-master\druid-master\extensions-core\druid-bloom-filter\src\main\java\org\apache\druid\query\expressions\BloomFilterExpressions.java,0,87,3,14,0,104
 druid-master\druid-master\processing\src\test\java\org\apache\druid\query\extraction\TimeDimExtractionFnTest.java,0,27,0,9,0,36
 druid-master\druid-master\extensions-core\s3-extensions\src\test\java\org\apache\druid\storage\s3\S3InputDataConfigTest.java,0,52,9,14,0,75
 druid-master\druid-master\processing\src\test\java\org\apache\druid\segment\column\ColumnCapabilitiesImplTest.java,0,10,0,4,0,14
 druid-master\druid-master\integration-tests\src\test\java\org\apache\druid\tests\indexer\AbstractKinesisIndexingServiceTest.java,0,34,0,12,0,46
 druid-master\druid-master\server\src\main\java\org\apache\druid\metadata\SQLMetadataStorageActionHandler.java,0,201,6,45,0,252
 druid-master\druid-master\cloud\aws-common\src\main\java\org\apache\druid\common\aws\AWSCredentialsConfig.java,0,13,0,1,0,14
 druid-master\druid-master\server\src\test\java\org\apache\druid\server\scheduling\ManualQueryLaningStrategyTest.java,0,57,0,15,0,72
 druid-master\druid-master\processing\src\main\java\org\apache\druid\query\scan\ScanQueryOffsetSequence.java,0,34,0,10,0,44
 druid-master\druid-master\core\src\main\java\org\apache\druid\java\util\common\granularity\Granularity.java,0,95,4,20,1,120
 druid-master\druid-master\server\src\main\java\org\apache\druid\segment\realtime\appenderator\Appenderator.java,0,86,0,58,0,144
 druid-master\druid-master\core\src\test\java\org\apache\druid\data\input\impl\StringInputRowParserTest.java,0,10,0,5,0,15
 druid-master\druid-master\processing\src\main\java\org\apache\druid\query\aggregation\AggregatorFactoryNotMergeableException.java,0,12,0,4,0,16
 druid-master\druid-master\indexing-service\src\main\java\org\apache\druid\indexing\common\task\batch\parallel\InputSourceSplitParallelIndexTaskRunner.java,0,28,0,6,0,34
 druid-master\druid-master\server\src\test\java\org\apache\druid\jackson\StringObjectPairListTest.java,0,5,0,2,0,7
 druid-master\druid-master\services\src\main\java\org\apache\druid\cli\convert\IndexCacheConverter.java,0,9,0,2,0,11
 druid-master\druid-master\processing\src\main\java\org\apache\druid\segment\selector\settable\SettableColumnValueSelector.java,0,5,0,2,0,7
 druid-master\druid-master\extensions-core\protobuf-extensions\src\main\java\org\apache\druid\data\input\protobuf\ProtobufInputRowSchema.java,0,20,0,8,0,28
 druid-master\druid-master\server\src\main\java\org\apache\druid\server\coordinator\BalancerSegmentHolder.java,0,23,0,1,0,24
 druid-master\druid-master\sql\src\main\java\org\apache\druid\sql\calcite\expression\builtin\ReductionOperatorConversionHelper.java,0,6,1,2,0,9
 druid-master\druid-master\server\src\test\java\org\apache\druid\server\security\AuthValidatorTest.java,0,26,0,5,0,31
 druid-master\druid-master\processing\src\main\java\org\apache\druid\query\search\ConciseBitmapDecisionHelper.java,0,9,1,3,0,13
 druid-master\druid-master\server\src\main\java\org\apache\druid\client\ImmutableDruidServer.java,0,80,0,10,0,90
 druid-master\druid-master\server\src\test\java\org\apache\druid\server\SegmentManagerThreadSafetyTest.java,0,66,3,14,0,83
 druid-master\druid-master\core\src\main\java\org\apache\druid\timeline\TimelineLookup.java,0,14,2,10,0,26
 druid-master\druid-master\server\src\test\java\org\apache\druid\metadata\input\SqlInputSourceTest.java,0,83,3,25,0,111
 druid-master\druid-master\indexing-service\src\main\java\org\apache\druid\indexing\seekablestream\SeekableStreamSequenceNumbers.java,0,10,2,3,0,15
 druid-master\druid-master\core\src\test\java\org\apache\druid\java\util\common\guava\LimitedSequenceTest.java,0,37,0,8,2,47
 druid-master\druid-master\core\src\test\java\org\apache\druid\data\input\impl\CsvReaderTest.java,0,53,0,25,0,78
 druid-master\druid-master\extensions-core\druid-basic-security\src\test\java\org\apache\druid\security\authentication\validator\DBCredentialsValidatorTest.java,0,41,1,21,0,63
 druid-master\druid-master\benchmarks\src\test\java\org\apache\druid\benchmark\bitmap\BitmapBenchmarkWithVaryingOrder.java,0,35,0,6,0,41
 druid-master\druid-master\extensions-core\parquet-extensions\src\main\java\org\apache\druid\data\input\parquet\simple\ParquetHadoopInputRowParser.java,0,21,2,2,0,25
 druid-master\druid-master\extensions-core\druid-basic-security\src\main\java\org\apache\druid\security\basic\authentication\validator\MetadataStoreCredentialsValidator.java,0,18,0,9,0,27
 druid-master\druid-master\server\src\main\java\org\apache\druid\server\security\AuthenticationResult.java,0,33,0,4,0,37
 druid-master\druid-master\processing\src\main\java\org\apache\druid\query\scan\ScanResultValue.java,0,61,0,18,0,79
 druid-master\druid-master\integration-tests\src\test\java\org\apache\druid\tests\indexer\ITAppenderatorDriverRealtimeIndexTaskTest.java,0,38,0,15,0,53
 druid-master\druid-master\core\src\main\java\org\apache\druid\indexer\TaskInfo.java,0,37,2,2,0,41
 druid-master\druid-master\integration-tests\src\test\java\org\apache\druid\tests\hadoop\ITAzureInputToHdfsHadoopIndexTest.java,0,13,0,10,0,23
 druid-master\druid-master\extensions-core\datasketches\src\test\java\org\apache\druid\query\aggregation\datasketches\hll\HllSketchMergeAggregatorFactoryTest.java,0,40,0,12,0,52
 druid-master\druid-master\extensions-core\datasketches\src\main\java\org\apache\druid\query\aggregation\datasketches\quantiles\DoublesSketchBuildBufferAggregatorHelper.java,0,47,0,16,0,63
 druid-master\druid-master\indexing-hadoop\src\main\java\org\apache\druid\indexer\HadoopIOConfig.java,0,24,0,3,0,27
 druid-master\druid-master\processing\src\main\java\org\apache\druid\segment\data\ColumnarDoubles.java,0,51,0,13,0,64
 druid-master\druid-master\core\src\main\java\org\apache\druid\segment\SegmentUtils.java,0,26,1,9,0,36
 druid-master\druid-master\core\src\main\java\org\apache\druid\data\input\impl\ParseSpec.java,0,38,0,8,0,46
 druid-master\druid-master\extensions-contrib\gce-extensions\src\main\java\org\apache\druid\indexing\overlord\autoscaling\gce\GceEnvironmentConfig.java,0,47,1,5,0,53
 druid-master\druid-master\processing\src\main\java\org\apache\druid\query\timeseries\TimeseriesQueryMetricsFactory.java,0,4,0,2,0,6
 druid-master\druid-master\extensions-core\druid-basic-security\src\main\java\org\apache\druid\security\basic\authentication\validator\CredentialsValidator.java,0,5,0,3,0,8
 druid-master\druid-master\processing\src\main\java\org\apache\druid\segment\vector\BaseDoubleVectorValueSelector.java,0,20,0,2,0,22
 druid-master\druid-master\processing\src\main\java\org\apache\druid\segment\column\LongsColumn.java,0,31,0,5,0,36
 druid-master\druid-master\processing\src\main\java\org\apache\druid\query\groupby\epinephelinae\AbstractBufferHashGrouper.java,0,79,1,25,0,105
 druid-master\druid-master\extensions-contrib\tdigestsketch\src\test\java\org\apache\druid\query\aggregation\tdigestsketch\GenerateTestData.java,0,18,3,7,0,28
 druid-master\druid-master\processing\src\test\java\org\apache\druid\query\extraction\CascadeExtractionFnTest.java,0,57,4,25,0,86
 druid-master\druid-master\extensions-core\kafka-indexing-service\src\test\java\org\apache\druid\indexing\kafka\supervisor\KafkaSupervisorTuningConfigTest.java,0,40,0,17,0,57
 druid-master\druid-master\extensions-core\druid-bloom-filter\src\main\java\org\apache\druid\query\filter\BloomKFilter.java,0,341,4,67,0,412
 druid-master\druid-master\integration-tests\src\test\java\org\apache\druid\tests\indexer\ITBestEffortRollupParallelIndexTest.java,0,62,5,32,0,99
 druid-master\druid-master\server\src\main\java\org\apache\druid\server\initialization\jetty\ServiceUnavailableExceptionMapper.java,0,5,0,2,0,7
 druid-master\druid-master\server\src\main\java\org\apache\druid\client\selector\Server.java,0,5,0,1,0,6
 druid-master\druid-master\server\src\test\java\org\apache\druid\discovery\DruidLeaderClientTest.java,0,69,0,30,0,99
 druid-master\druid-master\extensions-contrib\prometheus-emitter\src\main\java\org\apache\druid\emitter\prometheus\PrometheusEmitter.java,0,53,2,10,0,65
 druid-master\druid-master\processing\src\test\java\org\apache\druid\query\filter\SearchQueryDimFilterTest.java,0,47,0,5,0,52
 druid-master\druid-master\server\src\test\java\org\apache\druid\segment\realtime\firehose\EventReceiverFirehoseIdleTest.java,0,27,1,7,0,35
 druid-master\druid-master\indexing-hadoop\src\test\java\org\apache\druid\indexer\partitions\HashedPartitionsSpecTest.java,0,45,0,17,0,62
 druid-master\druid-master\integration-tests\src\test\java\org\apache\druid\tests\indexer\ITS3AssumeRoleIndexTest.java,0,25,0,17,0,42
 druid-master\druid-master\sql\src\test\java\org\apache\druid\sql\calcite\BaseCalciteQueryTest.java,0,426,2,117,0,545
 druid-master\druid-master\core\src\main\java\org\apache\druid\metadata\MetadataStorageActionHandler.java,0,20,4,10,0,34
 druid-master\druid-master\processing\src\main\java\org\apache\druid\query\aggregation\VectorAggregator.java,0,28,1,18,0,47
 druid-master\druid-master\processing\src\main\java\org\apache\druid\segment\StorageAdapter.java,0,33,0,17,0,50
 druid-master\druid-master\server\src\main\java\org\apache\druid\curator\discovery\CuratorServiceAnnouncer.java,0,26,0,7,0,33
 druid-master\druid-master\hll\src\test\java\org\apache\druid\hll\HyperLogLogCollectorBenchmark.java,0,71,6,18,2,97
 druid-master\druid-master\core\src\test\java\org\apache\druid\common\guava\CombiningSequenceTest.java,0,94,1,6,1,102
 druid-master\druid-master\extensions-core\datasketches\src\main\java\org\apache\druid\query\aggregation\datasketches\hll\sql\HllSketchToStringOperatorConversion.java,0,18,0,4,0,22
 druid-master\druid-master\sql\src\main\java\org\apache\druid\sql\calcite\rel\DruidQueryRel.java,0,42,1,6,0,49
 druid-master\druid-master\processing\src\main\java\org\apache\druid\query\aggregation\first\FloatFirstAggregatorFactory.java,0,104,0,17,0,121
 druid-master\druid-master\indexing-service\src\main\java\org\apache\druid\indexing\common\task\batch\parallel\GenericPartitionLocation.java,0,56,0,3,0,59
 druid-master\druid-master\processing\src\main\java\org\apache\druid\segment\virtual\ExpressionSelectors.java,0,136,4,61,0,201
 druid-master\druid-master\extensions-core\datasketches\src\main\java\org\apache\druid\query\aggregation\datasketches\quantiles\sql\DoublesSketchRankOperatorConversion.java,0,14,0,4,0,18
 druid-master\druid-master\core\src\main\java\org\apache\druid\data\SearchableVersionedDataFinder.java,0,12,1,10,0,23
 druid-master\druid-master\core\src\main\java\org\apache\druid\java\util\common\RetryUtils.java,0,48,3,20,0,71
 druid-master\druid-master\integration-tests\src\main\java\org\apache\druid\testing\DockerConfigProvider.java,0,89,0,8,0,97
 druid-master\druid-master\integration-tests\src\main\java\org\apache\druid\testing\guice\DruidTestModuleFactory.java,0,11,0,2,0,13
 druid-master\druid-master\extensions-core\orc-extensions\src\test\java\org\apache\druid\data\input\orc\OrcReaderTest.java,0,104,0,76,0,180
 druid-master\druid-master\core\src\main\java\org\apache\druid\java\util\common\StringUtils.java,0,168,2,41,1,212
 druid-master\druid-master\indexing-service\src\main\java\org\apache\druid\indexing\common\task\CompactionInputSpec.java,0,7,0,4,0,11
 druid-master\druid-master\core\src\main\java\org\apache\druid\java\util\metrics\CpuAcctDeltaMonitor.java,0,40,1,9,0,50
 druid-master\druid-master\server\src\main\java\org\apache\druid\jackson\DruidServiceSerializerModifier.java,0,6,0,1,0,7
 druid-master\druid-master\processing\src\test\java\org\apache\druid\query\expression\TrimExprMacroTest.java,0,5,0,1,0,6
 druid-master\druid-master\indexing-service\src\main\java\org\apache\druid\indexing\overlord\SingleTaskBackgroundRunner.java,0,143,10,39,0,192
 druid-master\druid-master\indexing-service\src\main\java\org\apache\druid\indexing\common\actions\SegmentAllocateAction.java,0,144,1,42,0,187
 druid-master\druid-master\processing\src\main\java\org\apache\druid\query\aggregation\MetricManipulationFn.java,0,2,0,1,0,3
 druid-master\druid-master\indexing-service\src\test\java\org\apache\druid\indexing\common\task\AppenderatorDriverRealtimeIndexTaskTest.java,0,263,3,74,0,340
 druid-master\druid-master\processing\src\main\java\org\apache\druid\segment\join\JoinConditionAnalysis.java,0,66,1,26,0,93
 druid-master\druid-master\extensions-core\datasketches\src\main\java\org\apache\druid\query\aggregation\datasketches\theta\sql\ThetaSketchSetBaseOperatorConversion.java,0,25,2,5,0,32
 druid-master\druid-master\processing\src\main\java\org\apache\druid\query\topn\TopNAlgorithm.java,0,10,2,2,0,14
 druid-master\druid-master\processing\src\test\java\org\apache\druid\segment\join\PossiblyNullDimensionSelectorTest.java,0,48,12,4,0,64
 druid-master\druid-master\core\src\main\java\org\apache\druid\guice\ManageLifecycle.java,0,3,0,3,0,6
 druid-master\druid-master\services\src\test\java\org\apache\druid\cli\MainTest.java,0,12,0,3,0,15
 druid-master\druid-master\core\src\test\java\org\apache\druid\common\exception\NoErrorResponseTransformStrategyTest.java,0,3,0,1,0,4
 druid-master\druid-master\indexing-service\src\main\java\org\apache\druid\indexing\seekablestream\SeekableStreamIndexTaskTuningConfig.java,0,162,0,26,0,188
 druid-master\druid-master\extensions-core\histogram\src\main\java\org\apache\druid\query\aggregation\histogram\ApproximateHistogram.java,0,398,21,97,0,516
 druid-master\druid-master\processing\src\test\java\org\apache\druid\query\lookup\LookupConfigTest.java,0,15,0,3,0,18
 druid-master\druid-master\processing\src\test\java\org\apache\druid\query\topn\AlphaNumericTopNMetricSpecTest.java,0,13,0,8,0,21
 druid-master\druid-master\extensions-core\datasketches\src\main\java\org\apache\druid\query\aggregation\datasketches\theta\SketchHolderObjectStrategy.java,0,15,0,2,0,17
 druid-master\druid-master\processing\src\main\java\org\apache\druid\query\filter\ValueMatcher.java,0,5,0,4,0,9
 druid-master\druid-master\indexing-service\src\main\java\org\apache\druid\indexing\seekablestream\supervisor\SeekableStreamSupervisorIngestionSpec.java,0,22,0,2,0,24
 druid-master\druid-master\core\src\test\java\org\apache\druid\timeline\partition\TombstonePartitionedChunkTest.java,0,28,1,6,0,35
 druid-master\druid-master\extensions-core\datasketches\src\main\java\org\apache\druid\query\aggregation\datasketches\tuple\ArrayOfDoublesSketchTTestPostAggregator.java,0,22,0,10,0,32
 druid-master\druid-master\extensions-core\datasketches\src\main\java\org\apache\druid\query\aggregation\datasketches\hll\sql\HllSketchObjectSqlAggregator.java,0,18,0,6,0,24
 druid-master\druid-master\processing\src\main\java\org\apache\druid\segment\join\filter\rewrite\RhsRewriteCandidate.java,0,38,0,5,0,43
 druid-master\druid-master\server\src\main\java\org\apache\druid\guice\SegmentWranglerModule.java,0,7,0,4,0,11
 druid-master\druid-master\processing\src\main\java\org\apache\druid\query\topn\NumericTopNMetricSpec.java,0,59,3,6,0,68
 druid-master\druid-master\extensions-contrib\moving-average-query\src\main\java\org\apache\druid\query\movingaverage\averagers\DoubleMaxAveragerFactory.java,0,10,0,2,0,12
 druid-master\druid-master\server\src\test\java\org\apache\druid\client\indexing\ClientCompactionIntervalSpecTest.java,0,31,0,17,0,48
 druid-master\druid-master\server\src\test\java\org\apache\druid\server\metrics\HistoricalMetricsMonitorTest.java,0,24,0,10,0,34
 druid-master\druid-master\processing\src\main\java\org\apache\druid\segment\vector\NoFilterVectorOffset.java,0,29,0,2,0,31
 druid-master\druid-master\extensions-contrib\cloudfiles-extensions\src\main\java\org\apache\druid\storage\cloudfiles\CloudFilesAccountConfig.java,0,18,0,1,0,19
 druid-master\druid-master\core\src\main\java\org\apache\druid\data\input\impl\CloudObjectLocation.java,0,51,0,15,0,66
 druid-master\druid-master\processing\src\main\java\org\apache\druid\segment\RowAdapters.java,0,12,1,2,0,15
 druid-master\druid-master\processing\src\main\java\org\apache\druid\segment\vector\BitmapVectorOffset.java,0,32,0,1,0,33
 druid-master\druid-master\indexing-service\src\test\java\org\apache\druid\indexing\common\task\TestAppenderatorsManager.java,0,80,1,1,0,82
 druid-master\druid-master\extensions-contrib\gce-extensions\src\main\java\org\apache\druid\indexing\overlord\autoscaling\gce\GceAutoScaler.java,0,104,13,36,0,153
 druid-master\druid-master\extensions-core\datasketches\src\main\java\org\apache\druid\query\aggregation\datasketches\quantiles\DoublesSketchToStringPostAggregator.java,0,39,0,4,0,43
 druid-master\druid-master\extensions-core\datasketches\src\main\java\org\apache\druid\query\aggregation\datasketches\tuple\ArrayOfDoublesSketchPostAggregator.java,0,19,0,3,0,22
 druid-master\druid-master\extensions-core\histogram\src\test\java\org\apache\druid\query\aggregation\histogram\ArrayUtilsTest.java,0,19,0,1,0,20
 druid-master\druid-master\server\src\main\java\org\apache\druid\client\indexing\ClientKillUnusedSegmentsTaskQuery.java,0,36,0,4,0,40
 druid-master\druid-master\processing\src\main\java\org\apache\druid\segment\join\lookup\LookupJoinMatcher.java,0,77,1,30,0,108
 druid-master\druid-master\processing\src\main\java\org\apache\druid\segment\QueryableIndexIndexableAdapter.java,0,104,0,31,0,135
 druid-master\druid-master\server\src\main\java\org\apache\druid\client\CachingClusteredClient.java,0,289,6,132,0,427
 druid-master\druid-master\processing\src\main\java\org\apache\druid\query\vector\VectorCursorGranularizer.java,0,39,1,11,0,51
 druid-master\druid-master\extensions-core\druid-pac4j\src\test\java\org\apache\druid\security\pac4j\Pac4jCommonConfigTest.java,0,5,0,2,0,7
 druid-master\druid-master\processing\src\main\java\org\apache\druid\segment\join\filter\JoinFilterAnalysis.java,0,32,0,5,0,37
 druid-master\druid-master\sql\src\main\java\org\apache\druid\sql\calcite\expression\UnaryPrefixOperatorConversion.java,0,12,0,2,0,14
 druid-master\druid-master\processing\src\test\java\org\apache\druid\query\aggregation\first\LongFirstAggregationTest.java,0,88,0,15,0,103
 druid-master\druid-master\indexing-service\src\test\java\org\apache\druid\indexing\overlord\setup\EqualDistributionWithAffinityWorkerSelectStrategyTest.java,0,27,0,16,0,43
 druid-master\druid-master\indexing-service\src\main\java\org\apache\druid\indexing\common\task\RealtimeIndexTask.java,0,161,12,60,0,233
 druid-master\druid-master\core\src\test\java\org\apache\druid\metadata\DefaultPasswordProviderTest.java,0,16,0,2,0,18
 druid-master\druid-master\processing\src\test\java\org\apache\druid\collections\CombiningIterableTest.java,0,6,0,2,0,8
 druid-master\druid-master\extensions-contrib\moving-average-query\src\main\java\org\apache\druid\query\movingaverage\averagers\DoubleMaxAverager.java,0,11,1,3,0,15
 druid-master\druid-master\extensions-core\datasketches\src\main\java\org\apache\druid\query\aggregation\datasketches\theta\SketchVectorAggregator.java,0,24,0,4,0,28
 druid-master\druid-master\processing\src\main\java\org\apache\druid\segment\RowBasedSegment.java,0,23,1,9,0,33
 druid-master\druid-master\indexing-service\src\main\java\org\apache\druid\indexing\common\task\batch\parallel\PartialRangeSegmentGenerateTask.java,0,74,0,21,0,95
 druid-master\druid-master\server\src\test\java\org\apache\druid\segment\realtime\plumber\CustomVersioningPolicyTest.java,0,5,0,2,0,7
 druid-master\druid-master\extendedset\src\main\java\org\apache\druid\extendedset\intset\IntSet.java,0,9,0,1,0,10
 druid-master\druid-master\indexing-service\src\test\java\org\apache\druid\indexing\common\tasklogs\FileTaskLogsTest.java,0,26,0,9,0,35
 druid-master\druid-master\services\src\main\java\org\apache\druid\cli\CoordinatorJettyServerInitializer.java,0,29,2,15,0,46
 druid-master\druid-master\indexing-service\src\main\java\org\apache\druid\indexing\common\task\CachingLocalSegmentAllocator.java,0,48,0,21,0,69
 druid-master\druid-master\processing\src\main\java\org\apache\druid\query\aggregation\DoubleSumAggregatorFactory.java,0,43,0,3,0,46
 druid-master\druid-master\processing\src\main\java\org\apache\druid\segment\join\table\IndexedTableDimensionSelector.java,0,46,0,5,0,51
 druid-master\druid-master\core\src\main\java\org\apache\druid\timeline\partition\LinearShardSpec.java,0,23,0,3,0,26
 druid-master\druid-master\integration-tests\src\main\java\org\apache\druid\testing\utils\CsvEventSerializer.java,0,10,0,2,0,12
 druid-master\druid-master\indexing-service\src\test\java\org\apache\druid\indexing\test\TestIndexerMetadataStorageCoordinator.java,0,102,0,12,0,114
 druid-master\druid-master\extensions-core\kinesis-indexing-service\src\test\java\org\apache\druid\indexing\kinesis\KinesisIOConfigTest.java,0,148,0,67,0,215
 druid-master\druid-master\extensions-core\kafka-indexing-service\src\test\java\org\apache\druid\indexing\kafka\supervisor\KafkaSupervisorIOConfigTest.java,0,82,1,36,0,119
 druid-master\druid-master\extensions-core\stats\src\test\java\org\apache\druid\query\aggregation\variance\VarianceGroupByQueryTest.java,0,124,4,32,0,160
 druid-master\druid-master\processing\src\test\java\org\apache\druid\query\filter\TrueDimFilterTest.java,0,6,0,2,0,8
 druid-master\druid-master\processing\src\test\java\org\apache\druid\segment\join\JoinableFactoryWrapperTest.java,0,229,26,123,0,378
 druid-master\druid-master\extensions-core\hdfs-storage\src\test\java\org\apache\druid\storage\hdfs\HdfsStorageDruidModuleTest.java,0,13,0,6,0,19
 druid-master\druid-master\core\src\main\java\org\apache\druid\timeline\partition\HashBucketShardSpec.java,0,57,0,6,1,64
 druid-master\druid-master\server\src\main\java\org\apache\druid\segment\realtime\appenderator\AppenderatorPlumber.java,0,124,15,31,0,170
 druid-master\druid-master\server\src\main\java\org\apache\druid\segment\loading\LocalDataSegmentPuller.java,0,53,5,14,0,72
 druid-master\druid-master\extensions-core\google-extensions\src\test\java\org\apache\druid\firehose\google\StaticGoogleBlobStoreFirehoseFactoryTest.java,0,7,0,3,0,10
 druid-master\druid-master\server\src\main\java\org\apache\druid\client\DataSourcesSnapshot.java,0,71,0,30,0,101
 druid-master\druid-master\processing\src\test\java\org\apache\druid\query\aggregation\FloatMinAggregationTest.java,0,36,0,14,0,50
 druid-master\druid-master\cloud\aws-common\src\test\java\org\apache\druid\common\aws\AWSClientUtilTest.java,0,31,8,3,0,42
 druid-master\druid-master\processing\src\test\java\org\apache\druid\query\spec\QuerySegmentSpecTest.java,0,23,0,11,0,34
 druid-master\druid-master\processing\src\test\java\org\apache\druid\query\groupby\epinephelinae\column\ArrayDoubleGroupByColumnSelectorStrategyTest.java,0,59,2,21,0,82
 druid-master\druid-master\server\src\main\java\org\apache\druid\metadata\SQLServerMetadataStorageActionHandlerFactory.java,0,13,0,4,0,17
 druid-master\druid-master\indexing-service\src\main\java\org\apache\druid\indexing\common\actions\TaskLocks.java,0,31,1,19,0,51
 druid-master\druid-master\processing\src\test\java\org\apache\druid\collections\bitmap\ConciseBitmapFactoryTest.java,0,16,0,3,0,19
 druid-master\druid-master\processing\src\test\java\org\apache\druid\segment\SchemalessTestFullTest.java,0,421,8,117,0,546
 druid-master\druid-master\extensions-core\lookups-cached-global\src\test\java\org\apache\druid\query\lookup\LookupUtilsTest.java,0,51,3,25,0,79
 druid-master\druid-master\server\src\main\java\org\apache\druid\metadata\SQLFirehoseDatabaseConnector.java,0,34,2,10,0,46
 druid-master\druid-master\processing\src\test\java\org\apache\druid\segment\QueryableIndexCursorSequenceBuilderTest.java,0,28,0,11,0,39
 druid-master\druid-master\indexing-service\src\test\java\org\apache\druid\indexing\common\task\batch\parallel\PartialCompactionTest.java,0,54,1,28,0,83
 druid-master\druid-master\processing\src\test\java\org\apache\druid\segment\join\HashJoinSegmentStorageAdapterTest.java,0,484,70,162,0,716
 druid-master\druid-master\processing\src\main\java\org\apache\druid\query\filter\FilterTuning.java,0,60,1,23,0,84
 druid-master\druid-master\extensions-contrib\momentsketch\src\test\java\org\apache\druid\query\aggregation\momentsketch\aggregator\MomentSketchMinPostAggregatorTest.java,0,13,0,5,0,18
 druid-master\druid-master\server\src\main\java\org\apache\druid\server\security\CustomCheckX509TrustManager.java,0,56,1,16,0,73
 druid-master\druid-master\server\src\main\java\org\apache\druid\server\coordination\BatchDataSegmentAnnouncerProvider.java,0,5,1,2,0,8
 druid-master\druid-master\indexing-service\src\test\java\org\apache\druid\indexing\common\RetryPolicyFactoryTest.java,0,4,0,2,0,6
 druid-master\druid-master\processing\src\test\java\org\apache\druid\query\search\RegexSearchQueryTest.java,0,8,0,3,0,11
 druid-master\druid-master\processing\src\test\java\org\apache\druid\query\extraction\StrlenExtractionFnTest.java,0,14,0,6,0,20
 druid-master\druid-master\processing\src\main\java\org\apache\druid\segment\ForwardingRowIterator.java,0,19,0,2,0,21
 druid-master\druid-master\extensions-core\datasketches\src\main\java\org\apache\druid\query\aggregation\datasketches\tuple\ArrayOfDoublesSketchJsonSerializer.java,0,4,0,2,0,6
 druid-master\druid-master\extensions-core\azure-extensions\src\main\java\org\apache\druid\storage\azure\AzureLoadSpec.java,0,17,0,2,0,19
 druid-master\druid-master\core\src\test\java\org\apache\druid\java\util\emitter\core\GoHandlers.java,0,32,4,2,0,38
 druid-master\druid-master\extensions-core\datasketches\src\main\java\org\apache\druid\query\aggregation\datasketches\theta\SketchEstimateWithErrorBounds.java,0,50,1,1,0,52
 druid-master\druid-master\indexing-service\src\main\java\org\apache\druid\indexing\common\task\batch\partition\PartitionAnalysis.java,0,12,0,4,0,16
 druid-master\druid-master\extensions-contrib\cassandra-storage\src\main\java\org\apache\druid\storage\cassandra\CassandraDataSegmentConfig.java,0,13,0,1,0,14
 druid-master\druid-master\processing\src\main\java\org\apache\druid\query\search\SearchQueryMetricsFactory.java,0,3,0,1,0,4
 druid-master\druid-master\extensions-core\mysql-metadata-storage\src\test\java\org\apache\druid\metadata\storage\mysql\MySQLMetadataStorageModuleTest.java,0,30,0,19,0,49
 druid-master\druid-master\extensions-core\s3-extensions\src\test\java\org\apache\druid\storage\s3\S3TaskLogsTest.java,0,76,6,32,0,114
 druid-master\druid-master\cloud\aws-common\src\main\java\org\apache\druid\common\aws\AWSCredentialsUtils.java,0,6,1,2,0,9
 druid-master\druid-master\indexing-service\src\main\java\org\apache\druid\indexing\common\task\AbstractTask.java,0,81,0,8,0,89
 druid-master\druid-master\server\src\main\java\org\apache\druid\server\router\Router.java,0,1,0,1,0,2
 druid-master\druid-master\extensions-contrib\moving-average-query\src\test\java\org\apache\druid\query\movingaverage\averagers\LongMinAveragerTest.java,0,12,0,1,0,13
 druid-master\druid-master\indexing-service\src\test\java\org\apache\druid\indexing\input\GeneratorInputSourceTest.java,0,29,1,5,0,35
 druid-master\druid-master\indexing-service\src\main\java\org\apache\druid\indexing\common\actions\TaskActionClient.java,0,2,0,1,0,3
 druid-master\druid-master\server\src\main\java\org\apache\druid\metadata\PostgreSQLMetadataStorageActionHandler.java,0,21,4,7,0,32
 druid-master\druid-master\extensions-contrib\moving-average-query\src\test\java\org\apache\druid\query\movingaverage\averagers\DoubleMeanNoNullAveragerTest.java,0,42,0,18,0,60
 druid-master\druid-master\server\src\main\java\org\apache\druid\segment\loading\OmniDataSegmentMover.java,0,18,0,4,0,22
 druid-master\druid-master\indexing-service\src\main\java\org\apache\druid\indexing\common\actions\ResetDataSourceMetadataAction.java,0,30,0,2,0,32
 druid-master\druid-master\indexing-service\src\main\java\org\apache\druid\indexing\common\RetryPolicy.java,0,15,0,2,0,17
 druid-master\druid-master\processing\src\main\java\org\apache\druid\query\search\SearchQueryConfig.java,0,18,0,2,0,20
 druid-master\druid-master\processing\src\test\java\org\apache\druid\segment\loading\TombstoneSegmentizerFactoryTest.java,0,11,0,9,0,20
 druid-master\druid-master\extensions-core\druid-basic-security\src\main\java\org\apache\druid\security\basic\BasicSecurityResourceFilter.java,0,9,0,2,0,11
 druid-master\druid-master\benchmarks\src\test\java\org\apache\druid\benchmark\ConsistentHasherBenchmark.java,0,18,1,1,0,20
 druid-master\druid-master\core\src\main\java\org\apache\druid\java\util\http\client\HttpClientConfig.java,0,127,0,11,0,138
 druid-master\druid-master\core\src\main\java\org\apache\druid\segment\column\ColumnType.java,0,32,0,10,0,42
 druid-master\druid-master\server\src\test\java\org\apache\druid\server\http\CompactionResourceTest.java,0,35,0,12,0,47
 druid-master\druid-master\integration-tests\src\main\java\org\apache\druid\cli\CliHistoricalForQueryErrorTest.java,0,14,1,4,0,19
 druid-master\druid-master\core\src\main\java\org\apache\druid\data\input\impl\HttpInputSource.java,0,66,0,13,2,81
 druid-master\druid-master\processing\src\test\java\org\apache\druid\query\aggregation\any\StringAnyBufferAggregatorTest.java,0,26,10,6,0,42
 druid-master\druid-master\server\src\main\java\org\apache\druid\segment\realtime\firehose\InlineFirehoseFactory.java,0,34,0,5,0,39
 druid-master\druid-master\server\src\test\java\org\apache\druid\segment\realtime\appenderator\StreamAppenderatorDriverFailTest.java,0,123,2,38,0,163
 druid-master\druid-master\processing\src\main\java\org\apache\druid\segment\virtual\ExpressionPlan.java,0,141,0,44,0,185
 druid-master\druid-master\processing\src\main\java\org\apache\druid\segment\selector\settable\SettableValueLongColumnValueSelector.java,0,16,1,2,0,19
 druid-master\druid-master\integration-tests\src\test\java\org\apache\druid\tests\indexer\ITKafkaIndexingServiceTransactionalSerializedTest.java,0,15,0,5,0,20
 druid-master\druid-master\processing\src\main\java\org\apache\druid\segment\incremental\IncrementalIndexColumnSelectorFactory.java,0,32,0,10,0,42
 druid-master\druid-master\server\src\main\java\org\apache\druid\metadata\input\SqlReader.java,0,31,2,6,0,39
 druid-master\druid-master\extensions-core\druid-pac4j\src\main\java\org\apache\druid\security\pac4j\Pac4jCommonConfig.java,0,24,0,3,0,27
 druid-master\druid-master\processing\src\main\java\org\apache\druid\query\lookup\LookupExtractorFactory.java,0,16,0,13,0,29
 druid-master\druid-master\processing\src\test\java\org\apache\druid\segment\filter\FilterTestUtils.java,0,14,1,2,0,17
 druid-master\druid-master\indexing-service\src\main\java\org\apache\druid\indexing\worker\WorkerTaskMonitor.java,0,54,2,15,0,71
 druid-master\druid-master\extensions-core\druid-basic-security\src\main\java\org\apache\druid\security\basic\authorization\entity\BasicAuthorizerGroupMappingFull.java,0,28,0,4,0,32
 druid-master\druid-master\integration-tests\src\test\java\org\apache\druid\tests\security\AbstractAuthConfigurationTest.java,0,255,25,61,0,341
 druid-master\druid-master\processing\src\test\java\org\apache\druid\segment\incremental\IncrementalIndexTest.java,0,38,0,12,0,50
 druid-master\druid-master\sql\src\main\java\org\apache\druid\sql\calcite\planner\CalcitePlannerModule.java,0,7,0,2,0,9
 druid-master\druid-master\processing\src\test\java\org\apache\druid\segment\filter\TimeFilteringTest.java,0,66,0,40,0,106
 druid-master\druid-master\extensions-core\histogram\src\main\java\org\apache\druid\query\aggregation\histogram\ApproximateHistogramAggregatorFactory.java,0,145,1,27,0,173
 druid-master\druid-master\core\src\main\java\org\apache\druid\segment\column\BaseTypeSignature.java,0,40,1,5,0,46
 druid-master\druid-master\processing\src\main\java\org\apache\druid\query\DruidMetrics.java,0,20,1,1,0,22
 druid-master\druid-master\extensions-contrib\time-min-max\src\main\java\org\apache\druid\query\aggregation\TimestampMinAggregatorFactory.java,0,18,0,3,0,21
 druid-master\druid-master\processing\src\main\java\org\apache\druid\query\groupby\epinephelinae\column\ArrayLongGroupByColumnSelectorStrategy.java,0,11,1,3,0,15
 druid-master\druid-master\processing\src\main\java\org\apache\druid\query\lookup\LookupExtractorFactoryContainer.java,0,34,0,5,0,39
 druid-master\druid-master\indexing-service\src\main\java\org\apache\druid\indexing\common\task\batch\parallel\distribution\StringSketchMerger.java,0,11,0,3,0,14
 druid-master\druid-master\processing\src\main\java\org\apache\druid\query\groupby\having\GreaterThanHavingSpec.java,0,38,3,5,0,46
 druid-master\druid-master\extensions-core\datasketches\src\main\java\org\apache\druid\query\aggregation\datasketches\theta\SketchAggregatorFactory.java,0,98,0,17,0,115
 druid-master\druid-master\extensions-core\stats\src\main\java\org\apache\druid\query\aggregation\variance\VarianceAggregatorCollector.java,0,81,2,6,0,89
 druid-master\druid-master\processing\src\main\java\org\apache\druid\query\scan\ScanResultValueTimestampComparator.java,0,16,0,7,0,23
 druid-master\druid-master\processing\src\main\java\org\apache\druid\query\filter\vector\VectorValueMatcher.java,0,6,0,5,0,11
 druid-master\druid-master\extensions-contrib\virtual-columns\src\main\java\org\apache\druid\segment\MapVirtualColumnValueSelector.java,0,16,0,3,0,19
 druid-master\druid-master\processing\src\main\java\org\apache\druid\segment\ConstantMultiValueDimensionSelector.java,0,36,0,3,0,39
 druid-master\druid-master\processing\src\main\java\org\apache\druid\segment\data\LongsLongEncodingReader.java,0,32,0,5,0,37
 druid-master\druid-master\extensions-core\kubernetes-extensions\src\main\java\org\apache\druid\k8s\discovery\LeaderElectorAsyncWrapper.java,0,32,3,6,0,41
 druid-master\druid-master\processing\src\test\java\org\apache\druid\segment\IntListUtilsTest.java,0,11,0,1,0,12
 druid-master\druid-master\indexing-hadoop\src\main\java\org\apache\druid\indexer\path\GranularUnprocessedPathSpec.java,0,23,0,10,0,33
 druid-master\druid-master\server\src\test\java\org\apache\druid\server\coordination\ZkCoordinatorTest.java,0,44,1,6,0,51
 druid-master\druid-master\extensions-contrib\moving-average-query\src\test\java\org\apache\druid\query\movingaverage\averagers\DoubleMeanAveragerTest.java,0,9,0,2,0,11
 druid-master\druid-master\processing\src\test\java\org\apache\druid\segment\column\ColumnBuilderTest.java,0,5,0,2,0,7
 druid-master\druid-master\server\src\main\java\org\apache\druid\server\metrics\EventReceiverFirehoseMonitor.java,0,19,0,7,0,26
 druid-master\druid-master\processing\src\test\java\org\apache\druid\segment\NoBitmapIndexMergerV9Test.java,0,7,0,1,0,8
 druid-master\druid-master\indexing-service\src\test\java\org\apache\druid\indexing\common\task\batch\parallel\PartialGenericSegmentMergeTaskTest.java,0,28,1,7,0,36
 druid-master\druid-master\core\src\main\java\org\apache\druid\annotations\SubclassesMustOverrideEqualsAndHashCode.java,0,3,0,3,0,6
 druid-master\druid-master\integration-tests\src\test\java\org\apache\druid\tests\security\ITTLSTest.java,0,202,3,100,0,305
 druid-master\druid-master\server\src\main\java\org\apache\druid\client\indexing\ClientCompactionIntervalSpec.java,0,60,2,25,0,87
 druid-master\druid-master\core\src\main\java\org\apache\druid\java\util\common\io\smoosh\Metadata.java,0,14,0,1,0,15
 druid-master\druid-master\core\src\test\java\org\apache\druid\data\input\MaxSizeSplitHintSpecTest.java,0,59,0,17,0,76
 druid-master\druid-master\core\src\main\java\org\apache\druid\math\expr\vector\UnivariateFunctionVectorValueProcessor.java,0,26,2,5,1,34
 druid-master\druid-master\server\src\main\java\org\apache\druid\server\JettyUtils.java,0,26,2,13,0,41
 druid-master\druid-master\server\src\test\java\org\apache\druid\curator\discovery\CuratorDruidNodeAnnouncerAndDiscoveryTest.java,0,52,0,16,0,68
 druid-master\druid-master\processing\src\main\java\org\apache\druid\segment\vector\SingleValueDimensionVectorSelector.java,0,6,0,5,0,11
 druid-master\druid-master\core\src\test\java\org\apache\druid\data\input\impl\JavaScriptParseSpecTest.java,0,15,0,7,0,22
 druid-master\druid-master\core\src\main\java\org\apache\druid\java\util\common\guava\FilteringAccumulator.java,0,16,1,2,0,19
 druid-master\druid-master\server\src\main\java\org\apache\druid\curator\inventory\InventoryManagerConfig.java,0,9,0,9,0,18
 druid-master\druid-master\core\src\test\java\org\apache\druid\metadata\EnvironmentVariableDynamicConfigProviderTest.java,0,15,0,8,1,24
 druid-master\druid-master\sql\src\test\java\org\apache\druid\sql\calcite\expression\IPv4AddressMatchExpressionTest.java,0,75,5,9,0,89
 druid-master\druid-master\extensions-core\datasketches\src\test\java\org\apache\druid\query\aggregation\datasketches\theta\SketchAggregationWithSimpleDataTest.java,0,153,2,51,0,206
 druid-master\druid-master\processing\src\test\java\org\apache\druid\segment\BitmapOffsetTest.java,0,23,0,5,0,28
 druid-master\druid-master\processing\src\main\java\org\apache\druid\query\filter\ColumnComparisonDimFilter.java,0,33,0,4,0,37
 druid-master\druid-master\processing\src\main\java\org\apache\druid\query\ColumnSelectorPlus.java,0,27,1,5,0,33
 druid-master\druid-master\indexing-service\src\test\java\org\apache\druid\indexing\test\TestDataSegmentKiller.java,0,5,0,1,0,6
 druid-master\druid-master\extensions-contrib\opentsdb-emitter\src\main\java\org\apache\druid\emitter\opentsdb\OpentsdbSender.java,0,52,2,5,0,59
 druid-master\druid-master\core\src\test\java\org\apache\druid\guice\JsonConfiguratorTest.java,0,69,0,14,1,84
 druid-master\druid-master\processing\src\test\java\org\apache\druid\query\scan\ScanResultValueTest.java,0,41,0,15,0,56
 druid-master\druid-master\processing\src\main\java\org\apache\druid\segment\incremental\MutableRowIngestionMeters.java,0,33,0,3,0,36
 druid-master\druid-master\extensions-core\druid-basic-security\src\main\java\org\apache\druid\security\basic\authorization\entity\BasicAuthorizerPermission.java,0,37,0,5,0,42
 druid-master\druid-master\integration-tests\src\test\java\org\apache\druid\tests\query\ITUnionQueryTest.java,0,59,4,19,0,82
 druid-master\druid-master\extensions-core\parquet-extensions\src\test\java\org\apache\druid\data\input\parquet\DecimalParquetReaderTest.java,0,27,0,18,0,45
 druid-master\druid-master\processing\src\main\java\org\apache\druid\segment\generator\RealRoundingDistribution.java,0,28,1,2,0,31
 druid-master\druid-master\processing\src\main\java\org\apache\druid\query\expression\TimestampFormatExprMacro.java,0,22,1,6,0,29
 druid-master\druid-master\processing\src\main\java\org\apache\druid\query\aggregation\DoubleMaxBufferAggregator.java,0,17,0,1,0,18
 druid-master\druid-master\server\src\main\java\org\apache\druid\server\metrics\TaskSlotCountStatsProvider.java,0,8,0,3,0,11
 druid-master\druid-master\extensions-core\avro-extensions\src\test\java\org\apache\druid\data\input\AvroHadoopInputRowParserTest.java,0,28,0,7,0,35
 druid-master\druid-master\processing\src\main\java\org\apache\druid\query\lookup\LookupsState.java,0,35,0,1,0,36
 druid-master\druid-master\core\src\main\java\org\apache\druid\java\util\http\client\netty\HttpClientPipelineFactory.java,0,4,0,1,0,5
 druid-master\druid-master\processing\src\main\java\org\apache\druid\query\search\SearchResultValue.java,0,20,1,1,0,22
 druid-master\druid-master\core\src\main\java\org\apache\druid\data\input\MapBasedInputRow.java,0,27,0,1,3,31
 druid-master\druid-master\indexing-service\src\main\java\org\apache\druid\indexing\seekablestream\common\OrderedSequenceNumber.java,0,26,1,2,0,29
 druid-master\druid-master\core\src\main\java\org\apache\druid\segment\column\TypeStrategy.java,0,64,0,44,0,108
 druid-master\druid-master\server\src\test\java\org\apache\druid\discovery\LookupNodeServiceTest.java,0,3,0,1,0,4
 druid-master\druid-master\processing\src\test\java\org\apache\druid\query\ReportTimelineMissingSegmentQueryRunnerTest.java,0,22,0,6,0,28
 druid-master\druid-master\processing\src\test\java\org\apache\druid\query\expression\IPv4AddressExprUtilsTest.java,0,62,10,9,0,81
 druid-master\druid-master\processing\src\test\java\org\apache\druid\query\aggregation\post\LongLeastPostAggregatorTest.java,0,14,0,4,0,18
 druid-master\druid-master\core\src\main\java\org\apache\druid\concurrent\ConcurrentAwaitableCounter.java,0,63,0,24,0,87
 druid-master\druid-master\processing\src\main\java\org\apache\druid\guice\GuiceInjectors.java,0,12,1,4,0,17
 druid-master\druid-master\core\src\main\java\org\apache\druid\java\util\common\guava\TopNSequence.java,0,10,0,3,0,13
 druid-master\druid-master\core\src\main\java\org\apache\druid\data\input\impl\DoubleDimensionSchema.java,0,8,0,1,0,9
 druid-master\druid-master\server\src\main\java\org\apache\druid\client\cache\MemcachedCustomConnectionFactoryBuilder.java,0,43,0,10,0,53
 druid-master\druid-master\server\src\main\java\org\apache\druid\segment\realtime\plumber\VersioningPolicy.java,0,3,0,2,0,5
 druid-master\druid-master\server\src\main\java\org\apache\druid\server\lookup\cache\LookupCoordinatorManager.java,0,289,8,121,0,418
 druid-master\druid-master\core\src\main\java\org\apache\druid\collections\ResourceHolder.java,0,3,0,1,0,4
 druid-master\druid-master\core\src\main\java\org\apache\druid\math\expr\Expr.java,0,270,0,105,0,375
 druid-master\druid-master\processing\src\test\java\org\apache\druid\segment\incremental\IncrementalIndexRowSizeTest.java,0,36,0,10,0,46
 druid-master\druid-master\extensions-contrib\graphite-emitter\src\main\java\org\apache\druid\emitter\graphite\GraphiteEmitterModule.java,0,17,0,6,0,23
 druid-master\druid-master\indexing-hadoop\src\main\java\org\apache\druid\indexer\DetermineHashedPartitionsJob.java,0,123,13,50,0,186
 druid-master\druid-master\server\src\test\java\org\apache\druid\server\scheduling\NoQueryLaningStrategyTest.java,0,12,0,3,0,15
 druid-master\druid-master\extensions-core\druid-basic-security\src\main\java\org\apache\druid\security\basic\authorization\endpoint\BasicAuthorizerResource.java,0,156,0,26,0,182
 druid-master\druid-master\core\src\test\java\org\apache\druid\common\utils\StringUtilsTest.java,0,11,0,2,1,14
 druid-master\druid-master\server\src\test\java\org\apache\druid\client\cache\MemcachedCacheBenchmark.java,0,47,0,7,0,54
 druid-master\druid-master\integration-tests\src\main\java\org\apache\druid\testing\utils\KafkaEventWriter.java,0,32,1,7,0,40
 druid-master\druid-master\core\src\main\java\org\apache\druid\math\expr\BinaryOperatorExpr.java,0,68,0,18,0,86
 druid-master\druid-master\extensions-contrib\opentsdb-emitter\src\main\java\org\apache\druid\emitter\opentsdb\OpentsdbEmitter.java,0,21,1,3,0,25
 druid-master\druid-master\processing\src\test\java\org\apache\druid\query\DefaultQueryConfigTest.java,0,11,1,6,0,18
 druid-master\druid-master\benchmarks\src\test\java\org\apache\druid\benchmark\RegexMatchBenchmark.java,0,51,1,6,0,58
 druid-master\druid-master\extensions-contrib\opentelemetry-emitter\src\main\java\org\apache\druid\emitter\opentelemetry\DruidContextTextMapGetter.java,0,15,0,5,0,20
 druid-master\druid-master\processing\src\test\java\org\apache\druid\segment\QueryableIndexColumnCapabilitiesTest.java,0,80,0,43,0,123
 druid-master\druid-master\processing\src\main\java\org\apache\druid\segment\DimensionMerger.java,0,36,0,34,0,70
 druid-master\druid-master\core\src\test\java\org\apache\druid\java\util\metrics\cgroups\TestUtils.java,0,18,1,5,0,24
 druid-master\druid-master\processing\src\main\java\org\apache\druid\segment\LongDimensionMergerV9.java,0,12,0,4,0,16
 druid-master\druid-master\extensions-core\histogram\src\main\java\org\apache\druid\query\aggregation\histogram\EqualBucketsPostAggregator.java,0,37,0,3,0,40
 druid-master\druid-master\extensions-core\kubernetes-extensions\src\main\java\org\apache\druid\k8s\discovery\DefaultK8sLeaderElectorFactory.java,0,30,0,6,0,36
 druid-master\druid-master\processing\src\main\java\org\apache\druid\segment\data\ConciseBitmapSerdeFactory.java,0,29,0,6,0,35
 druid-master\druid-master\integration-tests\src\main\java\org\apache\druid\testing\utils\DataLoaderHelper.java,0,7,0,2,0,9
 druid-master\druid-master\core\src\test\java\org\apache\druid\java\util\http\client\io\AppendableByteArrayInputStreamTest.java,0,143,2,9,9,163
 druid-master\druid-master\extensions-contrib\moving-average-query\src\test\java\org\apache\druid\query\movingaverage\averagers\LongMeanNoNullAveragerTest.java,0,9,0,2,0,11
 druid-master\druid-master\extensions-contrib\opentsdb-emitter\src\main\java\org\apache\druid\emitter\opentsdb\OpentsdbEvent.java,0,36,0,2,0,38
 druid-master\druid-master\indexing-service\src\main\java\org\apache\druid\indexing\common\stats\TaskRealtimeMetricsMonitor.java,0,44,0,26,0,70
 druid-master\druid-master\processing\src\test\java\org\apache\druid\query\ResultTest.java,0,4,0,2,0,6
 druid-master\druid-master\core\src\main\java\org\apache\druid\annotations\EverythingIsNonnullByDefault.java,0,5,0,4,0,9
 druid-master\druid-master\server\src\main\java\org\apache\druid\discovery\DruidLeaderSelector.java,0,19,0,14,0,33
 druid-master\druid-master\processing\src\main\java\org\apache\druid\segment\data\SingleIndexedInt.java,0,13,2,1,0,16
 druid-master\druid-master\services\src\main\java\org\apache\druid\cli\WebConsoleJettyServerInitializer.java,0,20,1,9,0,30
 druid-master\druid-master\server\src\test\java\org\apache\druid\curator\announcement\AnnouncerTest.java,0,67,3,26,0,96
 druid-master\druid-master\processing\src\main\java\org\apache\druid\segment\column\ColumnCapabilities.java,0,73,0,23,0,96
 druid-master\druid-master\processing\src\test\java\org\apache\druid\segment\TestNullableLongColumnSelector.java,0,15,0,2,0,17
 druid-master\druid-master\extensions-core\stats\src\main\java\org\apache\druid\query\aggregation\variance\VarianceBufferAggregator.java,0,117,1,17,0,135
 druid-master\druid-master\processing\src\main\java\org\apache\druid\segment\serde\StringBitmapIndexColumnPartSupplier.java,0,74,3,11,0,88
 druid-master\druid-master\processing\src\main\java\org\apache\druid\query\search\ContainsSearchQuerySpec.java,0,31,0,2,0,33
 druid-master\druid-master\extensions-core\druid-basic-security\src\main\java\org\apache\druid\security\basic\authorization\entity\BasicAuthorizerUserFull.java,0,24,0,4,0,28
 druid-master\druid-master\core\src\test\java\org\apache\druid\java\util\common\guava\WithEffectSequenceTest.java,0,14,0,4,0,18
 druid-master\druid-master\processing\src\main\java\org\apache\druid\query\aggregation\constant\LongConstantBufferAggregator.java,0,27,2,2,0,31
 druid-master\druid-master\processing\src\test\java\org\apache\druid\segment\virtual\AlwaysTwoCounterAggregatorFactory.java,0,76,0,24,0,100
 druid-master\druid-master\server\src\test\java\org\apache\druid\client\DirectDruidClientTest.java,0,54,4,26,0,84
 druid-master\druid-master\extensions-core\avro-extensions\src\main\java\org\apache\druid\data\input\avro\AvroStreamInputFormat.java,0,39,0,4,0,43
 druid-master\druid-master\extensions-core\parquet-extensions\src\main\java\org\apache\parquet\avro\DruidParquetAvroReadSupport.java,0,27,2,14,0,43
 druid-master\druid-master\processing\src\main\java\org\apache\druid\query\aggregation\CountBufferAggregator.java,0,28,0,1,0,29
 druid-master\druid-master\integration-tests\src\main\java\org\apache\druid\testing\clients\EventReceiverFirehoseTestClient.java,0,42,0,7,0,49
 druid-master\druid-master\processing\src\main\java\org\apache\druid\query\groupby\package-info.java,0,1,0,1,0,2
 druid-master\druid-master\core\src\main\java\org\apache\druid\common\utils\CurrentTimeMillisSupplier.java,0,3,0,1,0,4
 druid-master\druid-master\sql\src\main\java\org\apache\druid\sql\calcite\planner\DruidOperatorTable.java,0,136,0,136,0,272
 druid-master\druid-master\server\src\main\java\org\apache\druid\server\http\LookupCoordinatorResource.java,0,232,0,104,0,336
 druid-master\druid-master\core\src\main\java\org\apache\druid\timeline\partition\DimensionRangeBucketShardSpec.java,0,54,0,4,2,60
 druid-master\druid-master\extensions-core\druid-basic-security\src\test\java\org\apache\druid\security\BasicAuthUtilsTest.java,0,18,0,12,0,30
 druid-master\druid-master\core\src\main\java\org\apache\druid\data\input\impl\FirehoseToInputSourceReaderAdaptor.java,0,33,0,4,0,37
 druid-master\druid-master\processing\src\main\java\org\apache\druid\query\groupby\epinephelinae\LimitedTemporaryStorage.java,0,56,2,9,0,67
 druid-master\druid-master\extensions-core\protobuf-extensions\src\test\java\org\apache\druid\data\input\protobuf\ProtobufInputRowParserTest.java,0,116,0,32,0,148
 druid-master\druid-master\server\src\main\java\org\apache\druid\server\coordinator\ServerHolder.java,0,79,1,7,0,87
 druid-master\druid-master\core\src\main\java\org\apache\druid\guice\annotations\Parent.java,0,2,0,2,0,4
 druid-master\druid-master\indexing-service\src\main\java\org\apache\druid\indexing\common\task\batch\parallel\LegacySinglePhaseSubTask.java,0,5,0,1,0,6
 druid-master\druid-master\processing\src\main\java\org\apache\druid\query\extraction\ExtractionFn.java,0,26,0,23,0,49
 druid-master\druid-master\processing\src\main\java\org\apache\druid\query\UnionDataSource.java,0,40,1,9,0,50
 druid-master\druid-master\core\src\test\java\org\apache\druid\data\input\impl\DelimitedInputFormatTest.java,0,32,0,11,0,43
 druid-master\druid-master\indexing-hadoop\src\main\java\org\apache\druid\indexer\hadoop\DatasourceRecordReader.java,0,35,1,9,0,45
 druid-master\druid-master\indexing-service\src\test\java\org\apache\druid\indexing\common\task\BatchAppenderatorsTest.java,0,153,3,19,0,175
 druid-master\druid-master\processing\src\test\java\org\apache\druid\segment\virtual\AlwaysTwoVectorizedVirtualColumn.java,0,97,1,13,0,111
 druid-master\druid-master\processing\src\main\java\org\apache\druid\segment\AbstractSegment.java,0,1,1,1,0,3
 druid-master\druid-master\sql\src\main\java\org\apache\druid\sql\calcite\filtration\MoveTimeFiltersToIntervals.java,0,27,2,17,0,46
 druid-master\druid-master\core\src\main\java\org\apache\druid\common\utils\UUIDUtils.java,0,8,2,4,0,14
 druid-master\druid-master\core\src\main\java\org\apache\druid\common\config\NullHandling.java,0,56,1,15,0,72
 druid-master\druid-master\server\src\test\java\org\apache\druid\server\coordination\ChangeRequestHistoryTest.java,0,38,3,15,0,56
 druid-master\druid-master\extensions-core\s3-extensions\src\main\java\org\apache\druid\data\input\s3\S3InputSourceConfig.java,0,52,0,7,0,59
 druid-master\druid-master\core\src\main\java\org\apache\druid\math\expr\vector\LongOutLongInFunctionVectorValueProcessor.java,0,17,0,5,0,22
 druid-master\druid-master\processing\src\main\java\org\apache\druid\segment\RowBasedCursor.java,0,34,1,5,0,40
 druid-master\druid-master\indexing-hadoop\src\main\java\org\apache\druid\indexer\HadoopDruidIndexerConfig.java,0,219,3,50,0,272
 druid-master\druid-master\extensions-core\lookups-cached-global\src\main\java\org\apache\druid\server\lookup\namespace\cache\OnHeapNamespaceExtractionCacheManager.java,0,42,0,19,0,61
 druid-master\druid-master\extensions-core\datasketches\src\main\java\org\apache\druid\query\aggregation\datasketches\tuple\ArrayOfDoublesSketchModule.java,0,21,0,11,0,32
 druid-master\druid-master\processing\src\main\java\org\apache\druid\segment\data\DeltaLongEncodingWriter.java,0,34,0,3,0,37
 druid-master\druid-master\extensions-core\s3-extensions\src\main\java\org\apache\druid\storage\s3\S3ServerSideEncryption.java,0,13,0,5,0,18
 druid-master\druid-master\processing\src\test\java\org\apache\druid\query\timeseries\TimeseriesQueryRunnerBonusTest.java,0,27,0,12,0,39
 druid-master\druid-master\server\src\test\java\org\apache\druid\server\initialization\BaseJettyTest.java,0,112,2,9,0,123
 druid-master\druid-master\indexing-service\src\main\java\org\apache\druid\indexing\overlord\sampler\SamplerException.java,0,9,0,3,0,12
 druid-master\druid-master\server\src\test\java\org\apache\druid\client\cache\MemcacheClientPoolTest.java,0,17,1,7,0,25
 druid-master\druid-master\processing\src\test\java\org\apache\druid\query\groupby\DefaultGroupByQueryMetricsTest.java,0,16,0,11,0,27
 druid-master\druid-master\server\src\main\java\org\apache\druid\server\coordinator\duty\KillSupervisors.java,0,25,0,10,0,35
 druid-master\druid-master\processing\src\main\java\org\apache\druid\segment\data\TableLongEncodingReader.java,0,45,0,8,0,53
 druid-master\druid-master\indexing-service\src\main\java\org\apache\druid\indexing\common\actions\TaskActionHolder.java,0,15,0,1,0,16
 druid-master\druid-master\integration-tests\src\test\java\org\apache\druid\tests\indexer\ITS3ToHdfsParallelIndexTest.java,0,11,0,8,0,19
 druid-master\druid-master\indexing-service\src\test\java\org\apache\druid\indexing\common\task\AppenderatorsTest.java,0,149,3,21,0,173
 druid-master\druid-master\processing\src\test\java\org\apache\druid\query\select\SelectQueryTest.java,0,9,0,3,0,12
 druid-master\druid-master\core\src\test\java\org\apache\druid\java\util\http\client\AsyncHttpClientTest.java,0,25,5,7,6,43
 druid-master\druid-master\sql\src\main\java\org\apache\druid\sql\calcite\expression\builtin\RightOperatorConversion.java,0,6,0,1,0,7
 druid-master\druid-master\core\src\main\java\org\apache\druid\guice\JsonConfigProvider.java,0,102,0,24,2,128
 druid-master\druid-master\indexing-service\src\main\java\org\apache\druid\indexing\appenderator\SegmentAllocateActionGenerator.java,0,5,0,4,0,9
 druid-master\druid-master\server\src\main\java\org\apache\druid\initialization\Log4jShutterDownerModule.java,0,32,2,10,0,44
 druid-master\druid-master\server\src\test\java\org\apache\druid\segment\loading\StorageLocationTest.java,0,87,0,16,0,103
 druid-master\druid-master\server\src\main\java\org\apache\druid\server\http\MetadataResource.java,0,73,1,30,0,104
 druid-master\druid-master\processing\src\main\java\org\apache\druid\segment\join\filter\JoinFilterColumnCorrelationAnalysis.java,0,43,0,8,0,51
 druid-master\druid-master\processing\src\main\java\org\apache\druid\query\aggregation\DoubleSumAggregator.java,0,27,0,2,0,29
 druid-master\druid-master\server\src\main\java\org\apache\druid\segment\realtime\FireDepartment.java,0,30,0,7,0,37
 druid-master\druid-master\extensions-contrib\gce-extensions\src\test\java\org\apache\druid\indexing\overlord\autoscaling\gce\GceAutoScalerTest.java,0,169,8,94,0,271
 druid-master\druid-master\processing\src\main\java\org\apache\druid\jackson\SegmentizerModule.java,0,6,0,5,0,11
 druid-master\druid-master\sql\src\main\java\org\apache\druid\sql\calcite\expression\builtin\ParseLongOperatorConversion.java,0,8,0,2,0,10
 druid-master\druid-master\processing\src\main\java\org\apache\druid\segment\DimensionMergerV9.java,0,3,0,3,0,6
 druid-master\druid-master\processing\src\main\java\org\apache\druid\query\scan\ScanQueryConfig.java,0,31,0,3,0,34
 druid-master\druid-master\processing\src\main\java\org\apache\druid\query\expression\RegexpExtractExprMacro.java,0,25,0,9,0,34
 druid-master\druid-master\extensions-core\histogram\src\test\java\org\apache\druid\query\aggregation\histogram\ApproximateHistogramTopNQueryTest.java,0,78,0,10,0,88
 druid-master\druid-master\server\src\test\java\org\apache\druid\server\audit\SQLAuditManagerTest.java,0,104,15,30,0,149
 druid-master\druid-master\server\src\main\java\org\apache\druid\server\security\AuthenticationWrappingFilter.java,0,20,0,5,0,25
 druid-master\druid-master\processing\src\test\java\org\apache\druid\query\extraction\MatchingDimExtractionFnTest.java,0,12,0,4,0,16
 druid-master\druid-master\server\src\test\java\org\apache\druid\guice\JoinableFactoryModuleTest.java,0,40,0,19,0,59
 druid-master\druid-master\indexing-service\src\test\java\org\apache\druid\indexing\common\task\TasksTest.java,0,27,0,6,0,33
 druid-master\druid-master\processing\src\main\java\org\apache\druid\segment\QueryableIndexSegment.java,0,19,0,1,0,20
 druid-master\druid-master\core\src\main\java\org\apache\druid\math\expr\ExprListenerImpl.java,0,134,0,37,2,173
 druid-master\druid-master\extensions-contrib\graphite-emitter\src\main\java\org\apache\druid\emitter\graphite\GraphiteEmitterConfig.java,0,102,0,13,0,115
 druid-master\druid-master\extensions-core\datasketches\src\main\java\org\apache\druid\query\aggregation\datasketches\hll\HllSketchJsonSerializer.java,0,4,0,2,0,6
 druid-master\druid-master\processing\src\main\java\org\apache\druid\query\groupby\epinephelinae\CloseableGrouperIterator.java,0,18,1,2,0,21
 druid-master\druid-master\extensions-contrib\moving-average-query\src\main\java\org\apache\druid\query\movingaverage\MovingAverageQueryMetricsFactory.java,0,4,0,2,0,6
 druid-master\druid-master\indexing-service\src\test\java\org\apache\druid\indexing\common\task\batch\parallel\ParallelIndexSupervisorTaskSerdeTest.java,0,58,0,17,0,75
 druid-master\druid-master\extensions-core\druid-bloom-filter\src\main\java\org\apache\druid\query\filter\BloomKFilterHolder.java,0,25,0,2,0,27
 druid-master\druid-master\server\src\test\java\org\apache\druid\segment\realtime\appenderator\OpenAndClosedSegmentsBatchAppenderatorDriverTest.java,0,40,1,18,0,59
 druid-master\druid-master\server\src\main\java\org\apache\druid\server\coordinator\rules\PeriodDropBeforeRule.java,0,19,0,1,0,20
 druid-master\druid-master\core\src\main\java\org\apache\druid\data\input\impl\prefetch\FileFetcher.java,0,26,0,5,0,31
 druid-master\druid-master\processing\src\main\java\org\apache\druid\query\timeseries\DefaultTimeseriesQueryMetrics.java,0,19,0,4,0,23
 druid-master\druid-master\processing\src\main\java\org\apache\druid\query\MetricsEmittingQueryProcessingPool.java,0,12,0,4,0,16
 druid-master\druid-master\core\src\test\java\org\apache\druid\timeline\partition\StringPartitionChunkTest.java,0,60,0,41,0,101
 druid-master\druid-master\processing\src\main\java\org\apache\druid\segment\historical\HistoricalCursor.java,0,2,0,1,0,3
 druid-master\druid-master\indexing-service\src\test\java\org\apache\druid\indexing\firehose\WindowedSegmentIdTest.java,0,3,0,1,0,4
 druid-master\druid-master\core\src\test\java\org\apache\druid\java\util\emitter\service\AlertEventTest.java,0,32,0,14,1,47
 druid-master\druid-master\indexing-service\src\main\java\org\apache\druid\indexing\seekablestream\SeekableStreamIndexTaskIOConfig.java,0,59,3,14,0,76
 druid-master\druid-master\server\src\test\java\org\apache\druid\server\coordinator\ServerHolderTest.java,0,24,0,16,0,40
 druid-master\druid-master\server\src\test\java\org\apache\druid\server\ClientQuerySegmentWalkerTest.java,0,379,4,142,0,525
 druid-master\druid-master\indexing-service\src\test\java\org\apache\druid\indexing\overlord\OverlordBlinkLeadershipTest.java,0,23,0,12,0,35
 druid-master\druid-master\core\src\main\java\org\apache\druid\math\expr\vector\DoubleOutLongInFunctionVectorValueProcessor.java,0,16,0,4,0,20
 druid-master\druid-master\extensions-contrib\virtual-columns\src\main\java\org\apache\druid\segment\MapVirtualColumn.java,0,77,1,18,0,96
 druid-master\druid-master\processing\src\main\java\org\apache\druid\segment\IndexMergerV9Factory.java,0,20,0,5,0,25
 druid-master\druid-master\indexing-service\src\main\java\org\apache\druid\indexing\common\task\SegmentAllocators.java,0,24,0,5,0,29
 druid-master\druid-master\server\src\main\java\org\apache\druid\server\coordination\SegmentChangeRequestNoop.java,0,8,0,2,0,10
 druid-master\druid-master\processing\src\main\java\org\apache\druid\query\aggregation\cardinality\vector\DoubleCardinalityVectorProcessor.java,0,32,0,14,0,46
 druid-master\druid-master\server\src\main\java\org\apache\druid\server\SegmentManager.java,0,115,6,52,0,173
 druid-master\druid-master\core\src\main\java\org\apache\druid\math\expr\ApplyFunction.java,0,470,2,96,1,569
 druid-master\druid-master\sql\src\main\java\org\apache\druid\sql\calcite\run\NativeQueryMaker.java,0,84,4,44,0,132
 druid-master\druid-master\core\src\test\java\org\apache\druid\segment\loading\NoopDataSegmentKiller.java,0,4,2,1,0,7
 druid-master\druid-master\processing\src\main\java\org\apache\druid\segment\column\ColumnConfig.java,0,2,0,1,0,3
 druid-master\druid-master\processing\src\main\java\org\apache\druid\query\topn\LegacyTopNMetricSpec.java,0,7,0,2,0,9
 druid-master\druid-master\server\src\main\java\org\apache\druid\metadata\SQLMetadataSegmentPublisher.java,0,32,1,5,0,38
 druid-master\druid-master\processing\src\test\java\org\apache\druid\query\extraction\SubstringDimExtractionFnTest.java,0,30,1,6,0,37
 druid-master\druid-master\processing\src\main\java\org\apache\druid\segment\data\LongsLongEncodingWriter.java,0,33,1,3,0,37
 druid-master\druid-master\indexing-service\src\main\java\org\apache\druid\indexing\common\task\batch\parallel\distribution\StringDistributionMerger.java,0,2,0,1,0,3
 druid-master\druid-master\server\src\main\java\org\apache\druid\server\coordinator\rules\ForeverBroadcastDistributionRule.java,0,19,3,1,0,23
 druid-master\druid-master\core\src\main\java\org\apache\druid\java\util\common\parsers\TimestampParser.java,0,30,1,17,0,48
 druid-master\druid-master\extensions-core\druid-kerberos\src\main\java\org\apache\druid\security\kerberos\ResponseCookieHandler.java,0,40,3,6,0,49
 druid-master\druid-master\server\src\main\java\org\apache\druid\metadata\SqlSegmentsMetadataQuery.java,0,95,2,40,0,137
 druid-master\druid-master\processing\src\test\java\org\apache\druid\query\expression\TimestampFloorExprMacroTest.java,0,6,0,2,0,8
 druid-master\druid-master\benchmarks\src\test\java\org\apache\druid\benchmark\compression\FloatCompressionBenchmark.java,0,26,1,3,0,30
 druid-master\druid-master\extensions-core\kafka-indexing-service\src\test\java\org\apache\druid\indexing\kafka\KafkaDataSourceMetadataTest.java,0,47,0,13,0,60
 druid-master\druid-master\indexing-hadoop\src\test\java\org\apache\druid\indexer\JobHelperTest.java,0,56,3,15,0,74
 druid-master\druid-master\processing\src\main\java\org\apache\druid\query\dimension\PredicateFilteredDimensionSelector.java,0,33,0,6,0,39
 druid-master\druid-master\server\src\main\java\org\apache\druid\server\coordinator\CostBalancerStrategy.java,0,94,0,48,0,142
 druid-master\druid-master\server\src\main\java\org\apache\druid\segment\realtime\appenderator\AppenderatorsManager.java,0,64,0,15,0,79
 druid-master\druid-master\extensions-core\lookups-cached-global\src\main\java\org\apache\druid\query\lookup\NamespaceLookupExtractorFactory.java,0,83,1,15,0,99
 druid-master\druid-master\extensions-contrib\virtual-columns\src\main\java\org\apache\druid\segment\DruidVirtualColumnsModule.java,0,6,1,1,0,8
 druid-master\druid-master\integration-tests\src\main\java\org\testng\DruidTestRunnerFactory.java,0,32,1,8,0,41
 druid-master\druid-master\processing\src\main\java\org\apache\druid\segment\BaseSingleValueDimensionSelector.java,0,29,0,2,0,31
 druid-master\druid-master\processing\src\main\java\org\apache\druid\query\Query.java,0,79,1,27,0,107
 druid-master\druid-master\extensions-core\parquet-extensions\src\test\java\org\apache\druid\data\input\parquet\FlattenSpecParquetReaderTest.java,0,64,0,45,0,109
 druid-master\druid-master\extensions-contrib\moving-average-query\src\main\java\org\apache\druid\query\movingaverage\averagers\BaseAveragerFactory.java,0,41,1,9,0,51
 druid-master\druid-master\core\src\test\java\org\apache\druid\java\util\common\guava\SimpleSequenceTest.java,0,10,0,2,0,12
 druid-master\druid-master\processing\src\test\java\org\apache\druid\query\aggregation\StringColumnAggregationTest.java,0,111,3,63,0,177
 druid-master\druid-master\integration-tests\src\main\java\org\apache\druid\testing\utils\CompactionUtil.java,0,8,1,1,0,10
 druid-master\druid-master\processing\src\test\java\org\apache\druid\query\filter\FalseDimFilterTest.java,0,6,0,2,0,8
 druid-master\druid-master\core\src\main\java\org\apache\druid\guice\LazySingleton.java,0,1,0,1,0,2
 druid-master\druid-master\server\src\test\java\org\apache\druid\metadata\SQLMetadataSupervisorManagerTest.java,0,133,0,86,0,219
 druid-master\druid-master\server\src\main\java\org\apache\druid\server\coordinator\BytesAccumulatingResponseHandler.java,0,16,0,4,0,20
 druid-master\druid-master\core\src\main\java\org\apache\druid\guice\JacksonConfigProvider.java,0,37,0,4,3,44
 druid-master\druid-master\core\src\main\java\org\apache\druid\math\expr\vector\StringOutStringsInFunctionVectorProcessor.java,0,18,0,2,0,20
 druid-master\druid-master\processing\src\test\java\org\apache\druid\segment\serde\DictionaryEncodedColumnPartSerdeTest.java,0,6,0,4,0,10
 druid-master\druid-master\indexing-service\src\main\java\org\apache\druid\indexing\common\RetryPolicyFactory.java,0,9,0,1,0,10
 druid-master\druid-master\server\src\main\java\org\apache\druid\segment\indexing\BatchIOConfig.java,0,6,0,1,0,7
 druid-master\druid-master\extensions-core\kubernetes-extensions\src\test\java\org\apache\druid\k8s\discovery\K8sDruidNodeAnnouncerTest.java,0,18,0,8,0,26
 druid-master\druid-master\processing\src\main\java\org\apache\druid\guice\ConfigModule.java,0,10,0,2,0,12
 druid-master\druid-master\processing\src\main\java\org\apache\druid\segment\serde\FloatNumericColumnPartSerde.java,0,41,0,5,0,46
 druid-master\druid-master\core\src\main\java\org\apache\druid\io\ZeroCopyByteArrayOutputStream.java,0,7,2,1,0,10
 druid-master\druid-master\services\src\main\java\org\apache\druid\guice\HistoricalServiceModule.java,0,9,0,1,0,10
 druid-master\druid-master\processing\src\main\java\org\apache\druid\guice\RuntimeInfoModule.java,0,4,0,1,0,5
 druid-master\druid-master\processing\src\main\java\org\apache\druid\query\aggregation\StringColumnLongBufferAggregatorWrapper.java,0,17,0,4,0,21
 druid-master\druid-master\core\src\main\java\org\apache\druid\java\util\common\guava\Yielder.java,0,17,0,16,0,33
 druid-master\druid-master\server\src\main\java\org\apache\druid\server\metrics\TaskCountStatsMonitor.java,0,14,0,2,0,16
 druid-master\druid-master\processing\src\test\java\org\apache\druid\query\topn\TopNQueryBuilderTest.java,0,24,0,10,0,34
 druid-master\druid-master\indexing-service\src\test\java\org\apache\druid\indexing\overlord\RemoteTaskRunnerTestUtils.java,0,88,0,19,0,107
 druid-master\druid-master\server\src\test\java\org\apache\druid\server\ObservableQueryScheduler.java,0,64,0,12,0,76
 druid-master\druid-master\extensions-core\datasketches\src\main\java\org\apache\druid\query\aggregation\datasketches\theta\sql\ThetaSketchObjectSqlAggregator.java,0,16,0,4,0,20
 druid-master\druid-master\extensions-core\lookups-cached-global\src\test\java\org\apache\druid\server\lookup\namespace\cache\CacheSchedulerTest.java,0,96,4,20,0,120
 druid-master\druid-master\extensions-core\google-extensions\src\main\java\org\apache\druid\firehose\google\StaticGoogleBlobStoreFirehoseFactory.java,0,53,0,8,0,61
 druid-master\druid-master\extensions-core\stats\src\test\java\org\apache\druid\query\aggregation\variance\VarianceLongVectorAggregatorTest.java,0,58,0,11,0,69
 druid-master\druid-master\sql\src\main\java\org\apache\druid\sql\calcite\expression\builtin\TextcatOperatorConversion.java,0,4,0,1,0,5
 druid-master\druid-master\extensions-contrib\momentsketch\src\main\java\org\apache\druid\query\aggregation\momentsketch\aggregator\MomentSketchBuildAggregator.java,0,22,3,1,0,26
 druid-master\druid-master\integration-tests\src\test\java\org\apache\druid\tests\indexer\ITGcsToHdfsParallelIndexTest.java,0,13,0,10,0,23
 druid-master\druid-master\processing\src\test\java\org\apache\druid\query\filter\DimFilterTestUtils.java,0,14,1,2,0,17
 druid-master\druid-master\cloud\aws-common\src\main\java\org\apache\druid\common\aws\AWSModule.java,0,15,0,3,0,18
 druid-master\druid-master\server\src\main\java\org\apache\druid\query\RetryQueryRunner.java,0,102,1,38,0,141
 druid-master\druid-master\processing\src\main\java\org\apache\druid\query\GroupByMergedQueryRunner.java,0,54,4,19,0,77
 druid-master\druid-master\core\src\main\java\org\apache\druid\timeline\partition\HashBasedNumberedPartialShardSpec.java,0,48,0,6,2,56
 druid-master\druid-master\extensions-contrib\ambari-metrics-emitter\src\test\java\org\apache\druid\emitter\ambari\metrics\AmbariMetricsEmitterTest.java,0,15,0,4,0,19
 druid-master\druid-master\core\src\main\java\org\apache\druid\segment\loading\NoopDataSegmentPusher.java,0,21,0,3,0,24
 druid-master\druid-master\core\src\test\java\org\apache\druid\java\util\common\guava\BaseSequenceTest.java,0,21,1,1,0,23
 druid-master\druid-master\processing\src\main\java\org\apache\druid\segment\serde\DoubleNumericColumnSupplier.java,0,11,0,2,0,13
 druid-master\druid-master\processing\src\main\java\org\apache\druid\query\aggregation\DoubleSumVectorAggregator.java,0,16,0,3,0,19
 druid-master\druid-master\server\src\main\java\org\apache\druid\segment\realtime\plumber\RealtimePlumberSchool.java,0,57,0,9,0,66
 druid-master\druid-master\integration-tests\src\test\java\org\apache\druid\tests\indexer\ITS3ToS3ParallelIndexTest.java,0,11,0,8,0,19
 druid-master\druid-master\processing\src\main\java\org\apache\druid\query\groupby\epinephelinae\column\ArrayDoubleGroupByColumnSelectorStrategy.java,0,12,1,3,0,16
 druid-master\druid-master\extensions-core\hdfs-storage\src\main\java\org\apache\druid\storage\hdfs\tasklog\HdfsTaskLogsConfig.java,0,9,0,1,0,10
 druid-master\druid-master\services\src\test\java\org\apache\druid\server\router\TieredBrokerHostSelectorTest.java,0,73,1,19,0,93
 druid-master\druid-master\processing\src\main\java\org\apache\druid\segment\join\filter\JoinFilterPreAnalysis.java,0,80,0,9,0,89
 druid-master\druid-master\server\src\test\java\org\apache\druid\client\CachingClusteredClientTestUtils.java,0,11,0,4,0,15
 druid-master\druid-master\server\src\main\java\org\apache\druid\server\emitter\ParametrizedUriEmitterModule.java,0,19,1,6,0,26
 druid-master\druid-master\server\src\test\java\org\apache\druid\client\TestHttpClient.java,0,69,0,17,0,86
 druid-master\druid-master\processing\src\test\java\org\apache\druid\segment\IndexSpecTest.java,0,23,0,13,0,36
 druid-master\druid-master\indexing-service\src\test\java\org\apache\druid\indexing\common\TestRealtimeTask.java,0,16,0,2,0,18
 druid-master\druid-master\extensions-core\druid-bloom-filter\src\main\java\org\apache\druid\query\aggregation\bloom\BaseBloomFilterAggregator.java,0,71,1,20,0,92
 druid-master\druid-master\core\src\test\java\org\apache\druid\timeline\partition\BuildingHashBasedNumberedShardSpecTest.java,0,27,0,6,0,33
 druid-master\druid-master\server\src\main\java\org\apache\druid\server\scheduling\ManualQueryLaningStrategy.java,0,23,2,7,0,32
 druid-master\druid-master\core\src\test\java\org\apache\druid\java\util\common\guava\ParallelMergeCombiningSequenceTest.java,0,340,2,76,8,426
 druid-master\druid-master\integration-tests\src\test\java\org\apache\druid\tests\indexer\ITCombiningFirehoseFactoryIndexTest.java,0,20,2,8,0,30
 druid-master\druid-master\server\src\main\java\org\apache\druid\server\router\RendezvousHasher.java,0,8,0,1,0,9
 druid-master\druid-master\indexing-hadoop\src\test\java\org\apache\druid\indexer\HadoopKerberosConfigTest.java,0,6,0,3,0,9
 druid-master\druid-master\server\src\test\java\org\apache\druid\server\security\AuthorizationUtilsTest.java,0,18,0,11,0,29
 druid-master\druid-master\server\src\main\java\org\apache\druid\segment\loading\SegmentCacheManager.java,0,27,0,21,0,48
 druid-master\druid-master\server\src\main\java\org\apache\druid\server\security\Resource.java,0,27,0,2,0,29
 druid-master\druid-master\core\src\test\java\org\apache\druid\guice\DruidSecondaryModuleTest.java,0,150,0,42,0,192
 druid-master\druid-master\processing\src\main\java\org\apache\druid\query\TruncatedResponseContextException.java,0,7,0,3,0,10
 druid-master\druid-master\processing\src\main\java\org\apache\druid\query\QueryToolChestWarehouse.java,0,3,0,2,0,5
 druid-master\druid-master\processing\src\main\java\org\apache\druid\query\topn\types\FloatTopNColumnAggregatesProcessor.java,0,20,0,5,0,25
 druid-master\druid-master\processing\src\main\java\org\apache\druid\query\ResourceLimitExceededException.java,0,26,0,8,0,34
 druid-master\druid-master\processing\src\main\java\org\apache\druid\segment\FilteredOffset.java,0,54,2,15,0,71
 druid-master\druid-master\extensions-contrib\moving-average-query\src\test\java\org\apache\druid\query\movingaverage\averagers\LongMeanAveragerTest.java,0,11,0,2,0,13
 druid-master\druid-master\processing\src\main\java\org\apache\druid\segment\DimensionHandlerProvider.java,0,4,3,3,0,10
 druid-master\druid-master\indexing-service\src\test\java\org\apache\druid\indexing\common\task\IngestionTestBase.java,0,141,0,12,0,153
 druid-master\druid-master\indexing-service\src\main\java\org\apache\druid\indexing\worker\shuffle\ShuffleDataSegmentPusher.java,0,28,0,4,0,32
 druid-master\druid-master\extensions-core\druid-basic-security\src\test\java\org\apache\druid\security\authentication\CoordinatorBasicAuthenticatorMetadataStorageUpdaterTest.java,0,35,0,24,0,59
 druid-master\druid-master\core\src\test\java\org\apache\druid\timeline\partition\HashBucketShardSpecTest.java,0,30,0,10,0,40
 druid-master\druid-master\indexing-service\src\test\java\org\apache\druid\indexing\seekablestream\RecordSupplierInputSourceTest.java,0,50,1,12,0,63
 druid-master\druid-master\processing\src\main\java\org\apache\druid\query\BySegmentResultValue.java,0,5,0,1,0,6
 druid-master\druid-master\sql\src\test\java\org\apache\druid\sql\calcite\rule\DruidLogicalValuesRuleTest.java,0,73,1,23,0,97
 druid-master\druid-master\server\src\main\java\org\apache\druid\guice\JavaScriptModule.java,0,4,0,1,0,5
 druid-master\druid-master\core\src\main\java\org\apache\druid\java\util\http\client\NettyHttpClient.java,0,85,2,31,1,119
 druid-master\druid-master\indexing-service\src\main\java\org\apache\druid\indexing\common\task\batch\parallel\TaskMonitor.java,0,193,7,58,0,258
 druid-master\druid-master\server\src\main\java\org\apache\druid\segment\realtime\appenderator\PeonAppenderatorsManager.java,0,96,0,16,0,112
 druid-master\druid-master\server\src\main\java\org\apache\druid\segment\indexing\granularity\BaseGranularitySpec.java,0,52,2,13,0,67
 druid-master\druid-master\extensions-core\kinesis-indexing-service\src\main\java\org\apache\druid\indexing\kinesis\supervisor\KinesisSupervisorReportPayload.java,0,36,0,5,0,41
 druid-master\druid-master\processing\src\test\java\org\apache\druid\segment\virtual\VectorizedVirtualColumnTest.java,0,148,1,43,0,192
 druid-master\druid-master\processing\src\main\java\org\apache\druid\query\groupby\DefaultGroupByQueryMetricsFactory.java,0,7,0,2,0,9
 druid-master\druid-master\core\src\main\java\org\apache\druid\indexer\TaskMetricsGetter.java,0,3,0,1,0,4
 druid-master\druid-master\server\src\main\java\org\apache\druid\server\http\SegmentToDrop.java,0,15,0,1,0,16
 druid-master\druid-master\indexing-service\src\main\java\org\apache\druid\indexing\common\task\NonLinearlyPartitionedSequenceNameFunction.java,0,27,0,9,0,36
 druid-master\druid-master\extensions-contrib\thrift-extensions\src\main\java\org\apache\druid\data\input\thrift\ThriftInputRowParser.java,0,37,3,6,0,46
 druid-master\druid-master\core\src\test\java\org\apache\druid\java\util\metrics\cgroups\CpuSetTest.java,0,41,0,9,0,50
 druid-master\druid-master\server\src\main\java\org\apache\druid\segment\realtime\plumber\Sink.java,0,153,4,15,0,172
 druid-master\druid-master\indexing-hadoop\src\test\java\org\apache\druid\indexer\IndexGeneratorJobTest.java,0,114,3,42,0,159
 druid-master\druid-master\core\target\generated-sources\antlr4\org\apache\druid\math\expr\antlr\ExprLexer.java,0,422,3,3,4,432
 druid-master\druid-master\processing\src\test\java\org\apache\druid\query\extraction\MapLookupExtractionFnSerDeTest.java,0,9,0,3,0,12
 druid-master\druid-master\services\src\main\java\org\apache\druid\cli\CliCoordinator.java,0,104,0,52,0,156
 druid-master\druid-master\core\src\main\java\org\apache\druid\indexer\TaskStatus.java,0,93,1,9,0,103
 druid-master\druid-master\core\src\main\java\org\apache\druid\data\input\InputRowListPlusRawValues.java,0,72,1,20,3,96
 druid-master\druid-master\core\src\main\java\org\apache\druid\annotations\UsedInGeneratedCode.java,0,2,0,2,0,4
 druid-master\druid-master\extensions-core\s3-extensions\src\test\java\org\apache\druid\storage\s3\S3TimestampVersionedDataFinderTest.java,0,34,1,21,0,56
 druid-master\druid-master\core\src\main\java\org\apache\druid\math\expr\vector\ExprEvalVector.java,0,29,0,4,2,35
 druid-master\druid-master\cloud\aws-common\src\main\java\org\apache\druid\common\aws\AWSClientConfig.java,0,22,0,4,0,26
 druid-master\druid-master\extensions-core\histogram\src\test\java\org\apache\druid\query\aggregation\histogram\ApproximateHistogramAggregatorTest.java,0,53,2,33,0,88
 druid-master\druid-master\indexing-service\src\main\java\org\apache\druid\indexing\common\actions\TaskAuditLogConfig.java,0,10,0,2,0,12
 druid-master\druid-master\processing\src\test\java\org\apache\druid\query\groupby\GroupByQueryBuilderTest.java,0,24,0,11,0,35
 druid-master\druid-master\services\src\test\java\org\apache\druid\server\router\JavaScriptTieredBrokerSelectorStrategyTest.java,0,25,0,11,0,36
 druid-master\druid-master\server\src\main\java\org\apache\druid\segment\loading\OmniDataSegmentKiller.java,0,18,0,3,0,21
 druid-master\druid-master\processing\src\main\java\org\apache\druid\segment\serde\ComplexColumnSerializer.java,0,34,2,8,0,44
 druid-master\druid-master\processing\src\main\java\org\apache\druid\query\aggregation\DelegatingBufferAggregator.java,0,45,0,4,0,49
 druid-master\druid-master\sql\src\test\java\org\apache\druid\sql\calcite\planner\OffsetLimitTest.java,0,12,0,6,0,18
 druid-master\druid-master\server\src\main\java\org\apache\druid\segment\loading\RoundRobinStorageLocationSelectorStrategy.java,0,19,0,8,0,27
 druid-master\druid-master\processing\src\test\java\org\apache\druid\segment\filter\SelectorFilterTest.java,0,150,1,112,0,263
 druid-master\druid-master\indexing-service\src\main\java\org\apache\druid\indexing\common\task\BatchAppenderators.java,0,34,0,6,0,40
 druid-master\druid-master\integration-tests\src\main\java\org\apache\druid\testing\clients\QueryResourceTestClient.java,0,23,0,7,0,30
 druid-master\druid-master\processing\src\main\java\org\apache\druid\query\aggregation\cardinality\types\FloatCardinalityAggregatorColumnSelectorStrategy.java,0,16,0,5,0,21
 druid-master\druid-master\core\src\main\java\org\apache\druid\java\util\common\granularity\PeriodGranularity.java,0,103,0,20,0,123
 druid-master\druid-master\server\src\main\java\org\apache\druid\guice\http\DruidHttpClientConfig.java,0,52,1,6,0,59
 druid-master\druid-master\server\src\main\java\org\apache\druid\segment\loading\StorageLocation.java,0,97,2,26,0,125
 druid-master\druid-master\extensions-core\google-extensions\src\main\java\org\apache\druid\storage\google\GoogleAccountConfig.java,0,20,0,1,0,21
 druid-master\druid-master\integration-tests\src\test\java\org\apache\druid\tests\hadoop\AbstractAzureInputHadoopIndexTest.java,0,14,1,6,0,21
 druid-master\druid-master\extensions-contrib\redis-cache\src\main\java\org\apache\druid\client\cache\RedisCacheFactory.java,0,18,2,13,0,33
 druid-master\druid-master\server\src\test\java\org\apache\druid\server\initialization\JettyBindOnHostTest.java,0,13,0,6,0,19
 druid-master\druid-master\server\src\main\java\org\apache\druid\client\SegmentServerSelector.java,0,21,0,7,0,28
 druid-master\druid-master\server\src\main\java\org\apache\druid\server\coordinator\HttpLoadQueuePeon.java,0,165,17,37,0,219
 druid-master\druid-master\processing\src\main\java\org\apache\druid\query\aggregation\first\DoubleFirstBufferAggregator.java,0,31,0,3,0,34
 druid-master\druid-master\extensions-core\stats\src\main\java\org\apache\druid\query\aggregation\variance\package-info.java,0,1,0,1,0,2
 druid-master\druid-master\core\src\main\java\org\apache\druid\java\util\emitter\core\UriExtractor.java,0,2,0,1,0,3
 druid-master\druid-master\indexing-service\src\test\java\org\apache\druid\indexing\common\task\batch\parallel\DeepStoragePartitionStatTest.java,0,13,0,3,0,16
 druid-master\druid-master\processing\src\test\java\org\apache\druid\segment\data\CompressedVSizeColumnarIntsSupplierTest.java,0,110,0,18,0,128
 druid-master\druid-master\extensions-core\simple-client-sslcontext\src\main\java\org\apache\druid\https\SSLContextModule.java,0,12,0,7,0,19
 druid-master\druid-master\benchmarks\src\test\java\org\apache\druid\benchmark\DimensionPredicateFilterBenchmark.java,0,35,1,6,0,42
 druid-master\druid-master\indexing-service\src\main\java\org\apache\druid\indexing\overlord\autoscaling\AutoScalingData.java,0,13,0,1,0,14
 druid-master\druid-master\processing\src\main\java\org\apache\druid\query\expression\ExprUtils.java,0,23,3,9,0,35
 druid-master\druid-master\extensions-core\protobuf-extensions\src\test\java\org\apache\druid\data\input\protobuf\FileBasedProtobufBytesDecoderTest.java,0,19,0,7,0,26
 druid-master\druid-master\indexing-service\src\main\java\org\apache\druid\indexing\common\task\batch\parallel\DeepStorageShuffleClient.java,0,17,0,5,0,22
 druid-master\druid-master\sql\src\main\java\org\apache\druid\sql\calcite\filtration\Bounds.java,0,39,1,16,0,56
 druid-master\druid-master\indexing-service\src\main\java\org\apache\druid\indexing\common\task\batch\parallel\PartialHashSegmentGenerateTask.java,0,78,0,26,0,104
 druid-master\druid-master\server\src\main\java\org\apache\druid\server\listener\resource\ListenerHandler.java,0,10,1,2,0,13
 druid-master\druid-master\extensions-contrib\materialized-view-selection\src\main\java\org\apache\druid\query\materializedview\MaterializedViewQueryRunner.java,0,18,0,3,0,21
 druid-master\druid-master\server\src\main\java\org\apache\druid\server\log\RequestLogger.java,0,7,2,1,0,10
 druid-master\druid-master\extensions-core\datasketches\src\test\java\org\apache\druid\query\aggregation\datasketches\theta\oldapi\OldApiSketchAggregationTest.java,0,63,0,19,0,82
 druid-master\druid-master\sql\src\main\java\org\apache\druid\sql\calcite\expression\builtin\TimeFormatOperatorConversion.java,0,11,1,4,0,16
 druid-master\druid-master\core\src\main\java\org\apache\druid\data\input\impl\TimestampSpec.java,0,67,1,10,0,78
 druid-master\druid-master\server\src\main\java\org\apache\druid\segment\realtime\appenderator\AppenderatorImpl.java,0,367,24,160,0,551
 druid-master\druid-master\core\src\main\java\org\apache\druid\java\util\http\client\response\ObjectOrErrorResponseHandler.java,0,34,2,17,0,53
 druid-master\druid-master\processing\src\main\java\org\apache\druid\segment\data\VSizeColumnarIntsSerializer.java,0,29,0,6,0,35
 druid-master\druid-master\sql\src\main\java\org\apache\druid\sql\calcite\expression\builtin\RegexpLikeOperatorConversion.java,0,8,0,1,0,9
 druid-master\druid-master\processing\src\test\java\org\apache\druid\segment\vector\VectorSelectorUtilsTest.java,0,32,0,8,0,40
 druid-master\druid-master\indexing-service\src\test\java\org\apache\druid\indexing\overlord\TaskLifecycleTest.java,0,345,12,96,0,453
 druid-master\druid-master\extensions-contrib\redis-cache\src\main\java\org\apache\druid\client\cache\RedisClusterCache.java,0,36,0,9,0,45
 druid-master\druid-master\sql\src\main\java\org\apache\druid\sql\calcite\rel\DruidUnionRel.java,0,39,2,10,0,51
 druid-master\druid-master\sql\src\test\java\org\apache\druid\sql\calcite\schema\DruidCalciteSchemaModuleTest.java,0,69,1,23,0,93
 druid-master\druid-master\processing\src\main\java\org\apache\druid\query\aggregation\first\StringFirstLastUtils.java,0,21,1,9,0,31
 druid-master\druid-master\processing\src\main\java\org\apache\druid\segment\serde\NullColumnPartSerde.java,0,64,2,12,0,78
 druid-master\druid-master\processing\src\main\java\org\apache\druid\segment\StringDimensionIndexer.java,0,125,2,48,0,175
 druid-master\druid-master\server\src\test\java\org\apache\druid\server\QueryLifecycleTest.java,0,49,0,10,0,59
 druid-master\druid-master\extensions-contrib\cloudfiles-extensions\src\main\java\org\apache\druid\storage\cloudfiles\CloudFilesByteSource.java,0,21,0,2,0,23
 druid-master\druid-master\server\src\main\java\org\apache\druid\segment\realtime\firehose\HttpFirehoseFactory.java,0,69,1,15,0,85
 druid-master\druid-master\server\src\test\java\org\apache\druid\server\RequestLogLineTest.java,0,14,2,5,0,21
 druid-master\druid-master\processing\src\main\java\org\apache\druid\query\search\SearchQueryQueryToolChest.java,0,117,2,32,0,151
 druid-master\druid-master\core\src\main\java\org\apache\druid\java\util\common\parsers\JSONPathParser.java,0,21,2,5,0,28
 druid-master\druid-master\core\src\main\java\org\apache\druid\common\config\ConfigManagerConfig.java,0,9,0,1,0,10
 druid-master\druid-master\extensions-core\protobuf-extensions\src\main\java\org\apache\druid\data\input\protobuf\SchemaRegistryBasedProtobufBytesDecoder.java,0,72,4,10,0,86
 druid-master\druid-master\processing\src\main\java\org\apache\druid\segment\ColumnProcessors.java,0,96,1,74,0,171
 druid-master\druid-master\processing\src\test\java\org\apache\druid\segment\incremental\ParseExceptionHandlerTest.java,0,41,0,20,0,61
 druid-master\druid-master\extensions-core\druid-basic-security\src\main\java\org\apache\druid\security\basic\authorization\db\updater\NoopBasicAuthorizerMetadataStorageUpdater.java,0,65,12,9,0,86
 druid-master\druid-master\server\src\main\java\org\apache\druid\server\coordination\package-info.java,0,1,0,1,0,2
 druid-master\druid-master\core\src\main\java\org\apache\druid\java\util\common\parsers\RegexParser.java,0,29,0,4,1,34
 druid-master\druid-master\core\src\test\java\org\apache\druid\timeline\partition\NoneShardSpecTest.java,0,9,0,3,0,12
 druid-master\druid-master\server\src\test\java\org\apache\druid\client\client\ImmutableSegmentLoadInfoTest.java,0,6,0,2,0,8
 druid-master\druid-master\processing\src\test\java\org\apache\druid\query\groupby\GroupByQueryConfigTest.java,0,29,0,4,0,33
 druid-master\druid-master\core\src\main\java\org\apache\druid\java\util\http\client\auth\BasicCredentials.java,0,13,0,1,0,14
 druid-master\druid-master\server\src\main\java\org\apache\druid\metadata\RetryTransactionException.java,0,5,0,2,0,7
 druid-master\druid-master\indexing-service\src\test\java\org\apache\druid\indexing\common\task\ClientKillUnusedSegmentsTaskQuerySerdeTest.java,0,14,0,7,0,21
 druid-master\druid-master\extensions-core\datasketches\src\main\java\org\apache\druid\query\aggregation\datasketches\tuple\ArrayOfDoublesSketchToEstimatePostAggregator.java,0,15,0,4,0,19
 druid-master\druid-master\server\src\main\java\org\apache\druid\segment\realtime\firehose\CombiningFirehoseFactory.java,0,47,2,6,0,55
 druid-master\druid-master\processing\src\main\java\org\apache\druid\collections\bitmap\RoaringBitmapFactory.java,0,47,0,8,0,55
 druid-master\druid-master\core\src\main\java\org\apache\druid\java\util\emitter\core\Batch.java,0,97,0,25,0,122
 druid-master\druid-master\processing\src\test\java\org\apache\druid\query\aggregation\hyperloglog\HyperUniquesAggregatorFactoryTest.java,0,70,0,37,0,107
 druid-master\druid-master\core\src\main\java\org\apache\druid\common\config\Log4jShutdown.java,0,51,1,12,0,64
 druid-master\druid-master\core\src\main\java\org\apache\druid\java\util\metrics\BasicMonitorScheduler.java,0,14,0,3,0,17
 druid-master\druid-master\extensions-core\datasketches\src\main\java\org\apache\druid\query\aggregation\datasketches\quantiles\DoublesSketchToCDFPostAggregator.java,0,46,0,5,0,51
 druid-master\druid-master\indexing-service\src\main\java\org\apache\druid\indexing\common\actions\SegmentLockReleaseAction.java,0,30,0,2,0,32
 druid-master\druid-master\processing\src\main\java\org\apache\druid\query\aggregation\hyperloglog\PreComputedHyperUniquesSerde.java,0,14,1,5,0,20
 druid-master\druid-master\extensions-core\azure-extensions\src\test\java\org\apache\druid\data\input\azure\AzureInputSourceSerdeTest.java,0,48,3,22,0,73
 druid-master\druid-master\server\src\main\java\org\apache\druid\segment\loading\RandomStorageLocationSelectorStrategy.java,0,10,0,4,0,14
 druid-master\druid-master\processing\src\test\java\org\apache\druid\query\aggregation\JavaScriptAggregatorBenchmark.java,0,39,0,7,0,46
 druid-master\druid-master\extensions-core\histogram\src\test\java\org\apache\druid\query\aggregation\histogram\FixedBucketsHistogramBufferAggregatorTest.java,0,52,2,26,0,80
 druid-master\druid-master\server\src\main\java\org\apache\druid\segment\realtime\appenderator\UnifiedIndexerAppenderatorsManager.java,0,252,0,39,0,291
 druid-master\druid-master\indexing-service\src\main\java\org\apache\druid\indexing\common\task\batch\parallel\SubTaskSpec.java,0,43,0,5,0,48
 druid-master\druid-master\core\src\main\java\org\apache\druid\data\input\impl\SpatialDimensionSchema.java,0,22,0,2,2,26
 druid-master\druid-master\server\src\main\java\org\apache\druid\server\initialization\jetty\JettyMonitoringConnectionFactory.java,0,25,0,4,0,29
 druid-master\druid-master\processing\src\test\java\org\apache\druid\query\groupby\GroupByQueryMergeBufferTest.java,0,120,0,57,0,177
 druid-master\druid-master\extensions-core\datasketches\src\main\java\org\apache\druid\query\aggregation\datasketches\tuple\ArrayOfDoublesSketchToStringPostAggregator.java,0,15,0,4,0,19
 druid-master\druid-master\sql\src\main\java\org\apache\druid\sql\calcite\run\QueryFeatureInspector.java,0,4,0,2,0,6
 druid-master\druid-master\processing\src\main\java\org\apache\druid\segment\join\JoinPrefixUtils.java,0,19,1,10,0,30
 druid-master\druid-master\server\src\main\java\org\apache\druid\client\selector\TierSelectorStrategy.java,0,15,0,6,0,21
 druid-master\druid-master\server\src\main\java\org\apache\druid\server\security\DefaultTLSCertificateChecker.java,0,16,1,2,0,19
 druid-master\druid-master\indexing-service\src\main\java\org\apache\druid\indexing\seekablestream\supervisor\autoscaler\LagBasedAutoScaler.java,0,67,1,32,0,100
 druid-master\druid-master\indexing-service\src\main\java\org\apache\druid\indexing\common\ReingestionTimelineUtils.java,0,28,1,16,0,45
 druid-master\druid-master\indexing-service\src\main\java\org\apache\druid\indexing\common\actions\TaskAction.java,0,19,1,16,0,36
 druid-master\druid-master\processing\src\main\java\org\apache\druid\segment\filter\TrueValueMatcher.java,0,7,0,1,0,8
 druid-master\druid-master\processing\src\test\java\org\apache\druid\query\topn\DimValHolderTest.java,0,3,0,1,0,4
 druid-master\druid-master\extensions-core\datasketches\src\main\java\org\apache\druid\query\aggregation\datasketches\tuple\ArrayOfDoublesSketchSetOpPostAggregator.java,0,47,0,11,0,58
 druid-master\druid-master\extensions-core\kafka-indexing-service\src\test\java\org\apache\druid\indexing\kafka\KafkaIndexTaskTest.java,0,744,25,390,0,1159
 druid-master\druid-master\processing\src\main\java\org\apache\druid\query\aggregation\FloatMaxBufferAggregator.java,0,12,0,1,0,13
 druid-master\druid-master\core\src\main\java\org\apache\druid\common\guava\ThreadRenamingCallable.java,0,9,0,1,0,10
 druid-master\druid-master\server\src\main\java\org\apache\druid\server\coordinator\rules\IntervalDropRule.java,0,24,0,1,0,25
 druid-master\druid-master\core\src\main\java\org\apache\druid\java\util\emitter\core\LoggingEmitterConfig.java,0,14,0,1,0,15
 druid-master\druid-master\server\src\main\java\org\apache\druid\query\lookup\LookupIntrospectionResource.java,0,17,1,7,0,25
 druid-master\druid-master\core\src\main\java\org\apache\druid\timeline\partition\PartitionBoundaries.java,0,29,0,7,1,37
 druid-master\druid-master\processing\src\main\java\org\apache\druid\query\aggregation\mean\DoubleMeanVectorAggregator.java,0,15,0,2,0,17
 druid-master\druid-master\extensions-core\azure-extensions\src\main\java\org\apache\druid\storage\azure\AzureDataSegmentKiller.java,0,35,2,8,0,45
 druid-master\druid-master\extensions-contrib\distinctcount\src\main\java\org\apache\druid\query\aggregation\distinctcount\DistinctCountBufferAggregator.java,0,39,0,2,0,41
 druid-master\druid-master\core\src\main\java\org\apache\druid\timeline\partition\ShardSpec.java,0,62,16,26,0,104
 druid-master\druid-master\processing\src\main\java\org\apache\druid\segment\serde\ComplexMetricExtractor.java,0,7,0,2,0,9
 druid-master\druid-master\processing\src\test\java\org\apache\druid\query\scan\ScanQueryOffsetSequenceTest.java,0,10,0,3,0,13
 druid-master\druid-master\processing\src\main\java\org\apache\druid\segment\SingleScanTimeDimensionSelector.java,0,59,0,12,0,71
 druid-master\druid-master\core\src\main\java\org\apache\druid\timeline\partition\BucketNumberedShardSpec.java,0,34,0,26,0,60
 druid-master\druid-master\server\src\main\java\org\apache\druid\segment\realtime\appenderator\Appenderators.java,0,70,1,5,0,76
 druid-master\druid-master\extensions-core\druid-pac4j\src\main\java\org\apache\druid\security\pac4j\Pac4jAuthenticator.java,0,38,2,6,0,46
 druid-master\druid-master\processing\src\test\java\org\apache\druid\segment\join\filter\JoinFilterColumnCorrelationAnalysisTest.java,0,5,0,2,0,7
 druid-master\druid-master\indexing-service\src\main\java\org\apache\druid\indexing\common\config\TaskStorageConfig.java,0,10,0,2,0,12
 druid-master\druid-master\server\src\test\java\org\apache\druid\segment\join\InlineJoinableFactoryTest.java,0,24,0,8,0,32
 druid-master\druid-master\indexing-service\src\test\java\org\apache\druid\indexing\overlord\http\security\SupervisorResourceFilterTest.java,0,43,0,10,0,53
 druid-master\druid-master\indexing-service\src\main\java\org\apache\druid\indexing\common\actions\SegmentMetadataUpdateAction.java,0,30,0,7,0,37
 druid-master\druid-master\indexing-service\src\test\java\org\apache\druid\indexing\common\task\batch\parallel\ParallelIndexSupervisorTaskTest.java,0,124,5,51,0,180
 druid-master\druid-master\processing\src\main\java\org\apache\druid\segment\MergingRowIterator.java,0,62,2,37,0,101
 druid-master\druid-master\sql\src\main\java\org\apache\druid\sql\calcite\rel\CannotBuildQueryException.java,0,18,0,3,0,21
 druid-master\druid-master\server\src\main\java\org\apache\druid\client\selector\CustomTierSelectorStrategy.java,0,10,0,3,0,13
 druid-master\druid-master\extensions-contrib\moving-average-query\src\test\java\org\apache\druid\query\movingaverage\averagers\LongSumAveragerFactoryTest.java,0,6,0,3,0,9
 druid-master\druid-master\processing\src\main\java\org\apache\druid\query\aggregation\StringColumnFloatBufferAggregatorWrapper.java,0,17,0,4,0,21
 druid-master\druid-master\sql\src\test\java\org\apache\druid\sql\calcite\util\SpecificSegmentsQuerySegmentWalker.java,0,46,1,18,0,65
 druid-master\druid-master\processing\src\main\java\org\apache\druid\segment\join\PostJoinCursor.java,0,24,1,5,0,30
 druid-master\druid-master\benchmarks\src\test\java\org\apache\druid\benchmark\indexing\IndexPersistBenchmark.java,0,49,3,6,0,58
 druid-master\druid-master\processing\src\test\java\org\apache\druid\query\aggregation\GroupingAggregatorFactoryTest.java,0,53,5,11,0,69
 druid-master\druid-master\server\src\main\java\org\apache\druid\server\coordinator\duty\CompactSegments.java,0,186,2,114,0,302
 druid-master\druid-master\processing\src\main\java\org\apache\druid\segment\DimensionHandler.java,0,40,3,31,0,74
 druid-master\druid-master\integration-tests\src\main\java\org\apache\druid\testing\utils\AvroEventSerializer.java,0,30,1,2,0,33
 druid-master\druid-master\server\src\main\java\org\apache\druid\server\coordination\SegmentChangeRequestDrop.java,0,25,0,2,0,27
 druid-master\druid-master\extensions-core\kubernetes-extensions\src\test\java\org\apache\druid\k8s\discovery\K8sAnnouncerAndDiscoveryIntTest.java,0,25,0,11,0,36
 druid-master\druid-master\processing\src\test\java\org\apache\druid\collections\test\annotation\Dummy.java,0,1,0,1,0,2
 druid-master\druid-master\processing\src\main\java\org\apache\druid\segment\filter\BoundFilter.java,0,93,9,21,0,123
 druid-master\druid-master\extensions-contrib\moving-average-query\src\test\java\org\apache\druid\query\movingaverage\averagers\DoubleSumAveragerTest.java,0,14,1,3,0,18
 druid-master\druid-master\processing\src\main\java\org\apache\druid\query\aggregation\hyperloglog\HyperUniquesSerde.java,0,48,0,12,0,60
 druid-master\druid-master\processing\src\main\java\org\apache\druid\query\groupby\GroupByQueryConfig.java,0,161,0,27,0,188
 druid-master\druid-master\core\src\test\java\org\apache\druid\common\utils\SocketUtilTest.java,0,12,1,3,1,17
 druid-master\druid-master\extensions-contrib\moving-average-query\src\test\java\org\apache\druid\query\movingaverage\averagers\BaseAveragerFactoryTest.java,0,14,0,1,0,15
 druid-master\druid-master\processing\src\main\java\org\apache\druid\query\QueryRunnerFactory.java,0,33,1,29,0,63
 druid-master\druid-master\server\src\main\java\org\apache\druid\guice\QueryRunnerFactoryModule.java,0,18,0,11,0,29
 druid-master\druid-master\indexing-service\src\test\java\org\apache\druid\indexing\common\task\batch\parallel\HashPartitionMultiPhaseParallelIndexingWithNullColumnTest.java,0,27,1,13,0,41
 druid-master\druid-master\processing\src\test\java\org\apache\druid\segment\incremental\IncrementalIndexAdapterTest.java,0,39,0,19,0,58
 druid-master\druid-master\processing\src\main\java\org\apache\druid\segment\DictionaryEncodedColumnIndexer.java,0,94,3,16,0,113
 druid-master\druid-master\processing\src\main\java\org\apache\druid\segment\writeout\WriteOutBytes.java,0,20,0,13,0,33
 druid-master\druid-master\extensions-contrib\graphite-emitter\src\main\java\org\apache\druid\emitter\graphite\DruidToGraphiteEventConverter.java,0,7,0,6,0,13
 druid-master\druid-master\processing\src\test\java\org\apache\druid\segment\data\CompressedColumnarIntsSerializerTest.java,0,60,0,19,0,79
 druid-master\druid-master\indexing-hadoop\src\main\java\org\apache\druid\indexer\Utils.java,0,86,3,29,0,118
 druid-master\druid-master\extensions-core\druid-basic-security\src\test\java\org\apache\druid\security\authorization\CoordinatorBasicAuthorizerMetadataStorageUpdaterTest.java,0,120,0,68,0,188
 druid-master\druid-master\extensions-core\hdfs-storage\src\main\java\org\apache\druid\storage\hdfs\HdfsStorageAuthentication.java,0,22,0,7,0,29
 druid-master\druid-master\extensions-core\datasketches\src\main\java\org\apache\druid\query\aggregation\datasketches\tuple\ArrayOfDoublesSketchMergeBufferAggregator.java,0,37,1,15,0,53
 druid-master\druid-master\server\src\test\java\org\apache\druid\server\log\LoggingRequestLoggerProviderTest.java,0,24,0,11,0,35
 druid-master\druid-master\processing\src\main\java\org\apache\druid\segment\ProgressIndicator.java,0,6,0,1,0,7
 druid-master\druid-master\processing\src\main\java\org\apache\druid\query\aggregation\BufferAggregator.java,0,74,1,68,0,143
 druid-master\druid-master\server\src\main\java\org\apache\druid\server\coordinator\UserCompactionTaskIOConfig.java,0,22,0,5,0,27
 druid-master\druid-master\sql\src\main\java\org\apache\druid\sql\calcite\aggregation\Aggregation.java,0,46,1,16,0,63
 druid-master\druid-master\sql\src\main\java\org\apache\druid\sql\calcite\expression\builtin\ArrayConstructorOperatorConversion.java,0,3,0,1,0,4
 druid-master\druid-master\server\src\main\java\org\apache\druid\metadata\MetadataRuleManagerProvider.java,0,2,0,2,0,4
 druid-master\druid-master\sql\src\main\java\org\apache\druid\sql\calcite\aggregation\SqlAggregationModule.java,0,12,0,6,0,18
 druid-master\druid-master\processing\src\test\java\org\apache\druid\segment\data\ComparableIntArrayTest.java,0,22,1,9,0,32
 druid-master\druid-master\core\src\main\java\org\apache\druid\java\util\http\client\Request.java,0,96,0,9,1,106
 druid-master\druid-master\extensions-core\avro-extensions\target\generated-test-sources\avro\org\apache\druid\data\input\MyEnum.java,0,11,1,3,0,15
 druid-master\druid-master\processing\src\main\java\org\apache\druid\segment\data\ComparableStringArray.java,0,28,4,4,0,36
 druid-master\druid-master\core\src\test\java\org\apache\druid\segment\loading\NoopDataSegmentMover.java,0,6,0,2,0,8
 druid-master\druid-master\core\src\test\java\org\apache\druid\common\utils\IntArrayUtilsTest.java,0,4,0,2,0,6
 druid-master\druid-master\processing\src\main\java\org\apache\druid\jackson\AppendableIndexModule.java,0,7,0,4,0,11
 druid-master\druid-master\processing\src\main\java\org\apache\druid\query\spec\MultipleIntervalSegmentSpec.java,0,23,1,3,0,27
 druid-master\druid-master\processing\src\main\java\org\apache\druid\query\CPUTimeMetricQueryRunner.java,0,40,1,8,0,49
 druid-master\druid-master\indexing-service\src\test\java\org\apache\druid\indexing\common\task\batch\parallel\distribution\StringSketchMergerTest.java,0,11,0,2,0,13
 druid-master\druid-master\indexing-service\src\test\java\org\apache\druid\indexing\common\task\batch\parallel\AbstractMultiPhaseParallelIndexingTest.java,0,80,0,10,0,90
 druid-master\druid-master\extensions-core\orc-extensions\src\test\java\org\apache\druid\data\input\orc\OrcHadoopInputRowParserTest.java,0,71,0,42,0,113
 druid-master\druid-master\processing\src\main\java\org\apache\druid\query\expression\IPv4AddressStringifyExprMacro.java,0,22,0,4,0,26
 druid-master\druid-master\server\src\main\java\org\apache\druid\metadata\SegmentsMetadataManager.java,0,68,0,36,0,104
 druid-master\druid-master\processing\src\main\java\org\apache\druid\query\groupby\epinephelinae\column\ArrayStringGroupByColumnSelectorStrategy.java,0,83,2,25,0,110
 druid-master\druid-master\processing\src\main\java\org\apache\druid\segment\data\VSizeColumnarMultiInts.java,0,52,0,10,0,62
 druid-master\druid-master\core\src\main\java\org\apache\druid\math\expr\BinaryLogicalOperatorExpr.java,0,173,0,12,0,185
 druid-master\druid-master\extensions-contrib\aliyun-oss-extensions\src\test\java\org\apache\druid\storage\aliyun\OssStorageDruidModuleTest.java,0,14,0,7,0,21
 druid-master\druid-master\extensions-contrib\aliyun-oss-extensions\src\test\java\org\apache\druid\storage\aliyun\OssDataSegmentArchiverTest.java,0,51,0,9,0,60
 druid-master\druid-master\processing\src\test\java\org\apache\druid\query\topn\TopNQueryRunnerTest.java,0,1591,9,239,0,1839
 druid-master\druid-master\core\src\main\java\org\apache\druid\java\util\common\parsers\UnparseableColumnsParseException.java,0,15,0,4,2,21
 druid-master\druid-master\processing\src\main\java\org\apache\druid\query\search\SearchBinaryFn.java,0,17,0,2,0,19
 druid-master\druid-master\processing\src\test\java\org\apache\druid\query\planning\DataSourceAnalysisTest.java,0,121,0,67,0,188
 druid-master\druid-master\extensions-core\ec2-extensions\src\main\java\org\apache\druid\indexing\overlord\autoscaling\ec2\EC2EnvironmentConfig.java,0,37,1,4,0,42
 druid-master\druid-master\core\src\main\java\org\apache\druid\java\util\emitter\service\AlertEvent.java,0,87,0,4,1,92
 druid-master\druid-master\processing\src\main\java\org\apache\druid\query\aggregation\cardinality\vector\CardinalityVectorProcessor.java,0,15,0,5,0,20
 druid-master\druid-master\core\src\test\java\org\apache\druid\java\util\common\guava\SequenceTestHelper.java,0,51,2,6,0,59
 druid-master\druid-master\processing\src\main\java\org\apache\druid\query\expression\IPv4AddressParseExprMacro.java,0,22,0,4,0,26
 druid-master\druid-master\core\src\main\java\org\apache\druid\concurrent\TaskThreadPriority.java,0,19,1,15,0,35
 druid-master\druid-master\indexing-hadoop\src\test\java\org\apache\druid\indexer\HadoopTuningConfigTest.java,0,17,0,7,0,24
 druid-master\druid-master\indexing-service\src\main\java\org\apache\druid\indexing\overlord\BaseRestorableTaskRunner.java,0,60,4,19,0,83
 druid-master\druid-master\extensions-contrib\cloudfiles-extensions\src\test\java\org\apache\druid\firehose\cloudfiles\StaticCloudFilesFirehoseFactoryTest.java,0,14,1,3,0,18
 druid-master\druid-master\processing\src\main\java\org\apache\druid\segment\join\filter\rewrite\JoinFilterRewriteConfig.java,0,55,0,12,0,67
 druid-master\druid-master\indexing-service\src\test\java\org\apache\druid\indexing\overlord\IndexerMetadataStorageAdapterTest.java,0,25,0,12,0,37
 druid-master\druid-master\sql\src\main\java\org\apache\druid\sql\calcite\rule\DruidSortUnionRule.java,0,10,1,3,0,14
 druid-master\druid-master\benchmarks\src\test\java\org\apache\druid\benchmark\query\QueryBenchmarkUtil.java,0,11,1,2,0,14
 druid-master\druid-master\processing\src\main\java\org\apache\druid\query\planning\DataSourceAnalysis.java,0,111,2,52,0,165
 druid-master\druid-master\extensions-core\s3-extensions\src\test\java\org\apache\druid\storage\s3\S3DataSegmentArchiverTest.java,0,55,0,14,0,69
 druid-master\druid-master\core\src\main\java\org\apache\druid\java\util\common\parsers\DelimitedParser.java,0,14,0,3,1,18
 druid-master\druid-master\core\src\test\java\org\apache\druid\timeline\VersionedIntervalTimelineSpecificDataTest.java,0,155,0,40,0,195
 druid-master\druid-master\server\src\main\java\org\apache\druid\segment\realtime\appenderator\SinkQuerySegmentWalker.java,0,99,2,43,0,144
 druid-master\druid-master\server\src\test\java\org\apache\druid\curator\discovery\CuratorDruidLeaderSelectorTest.java,0,28,3,3,0,34
 druid-master\druid-master\core\src\main\java\org\apache\druid\java\util\http\client\AbstractHttpClient.java,0,4,0,1,0,5
 druid-master\druid-master\processing\src\test\java\org\apache\druid\segment\virtual\ExpressionVectorSelectorsTest.java,0,53,1,21,0,75
 druid-master\druid-master\extensions-core\protobuf-extensions\src\main\java\org\apache\druid\data\input\protobuf\ProtobufInputFormat.java,0,24,0,3,0,27
 druid-master\druid-master\core\src\main\java\org\apache\druid\math\expr\SettableObjectBinding.java,0,29,0,2,1,32
 druid-master\druid-master\core\src\main\java\org\apache\druid\utils\DynamicConfigProviderUtils.java,0,21,1,7,0,29
 druid-master\druid-master\processing\src\main\java\org\apache\druid\segment\join\Joinable.java,0,28,0,23,0,51
 druid-master\druid-master\processing\src\test\java\org\apache\druid\query\aggregation\mean\DoubleMeanAggregationTest.java,0,95,1,50,0,146
 druid-master\druid-master\processing\src\main\java\org\apache\druid\query\aggregation\DoubleMaxAggregateCombiner.java,0,7,0,1,0,8
 druid-master\druid-master\processing\src\test\java\org\apache\druid\query\expression\VectorExpressionsSanityTest.java,0,34,0,16,0,50
 druid-master\druid-master\extensions-contrib\dropwizard-emitter\src\main\java\org\apache\druid\emitter\dropwizard\DropwizardReporter.java,0,5,0,3,0,8
 druid-master\druid-master\core\src\test\java\org\apache\druid\java\util\common\GranularityTest.java,0,549,1,162,0,712
 druid-master\druid-master\integration-tests\src\test\java\org\apache\druid\tests\hadoop\ITHadoopIndexTest.java,0,70,6,28,0,104
 druid-master\druid-master\indexing-service\src\main\java\org\apache\druid\indexing\common\actions\SurrogateAction.java,0,33,2,4,0,39
 druid-master\druid-master\processing\src\test\java\org\apache\druid\segment\join\JoinableClauseTest.java,0,41,10,5,0,56
 druid-master\druid-master\core\src\main\java\org\apache\druid\timeline\Overshadowable.java,0,25,0,12,0,37
 druid-master\druid-master\core\src\test\java\org\apache\druid\java\util\emitter\core\ParametrizedUriEmitterTest.java,0,44,0,15,0,59
 druid-master\druid-master\processing\src\main\java\org\apache\druid\query\aggregation\last\StringLastAggregateCombiner.java,0,15,0,4,0,19
 druid-master\druid-master\indexing-service\src\test\java\org\apache\druid\indexing\common\actions\RetrieveSegmentsActionsTest.java,0,29,0,15,0,44
 druid-master\druid-master\core\src\main\java\org\apache\druid\common\exception\AllowedRegexErrorResponseTransformStrategy.java,0,19,0,5,1,25
 druid-master\druid-master\processing\src\main\java\org\apache\druid\query\FluentQueryRunnerBuilder.java,0,56,0,8,0,64
 druid-master\druid-master\indexing-hadoop\src\test\java\org\apache\druid\indexer\hadoop\DatasourceRecordReaderTest.java,0,16,0,7,0,23
 druid-master\druid-master\processing\src\test\java\org\apache\druid\query\planning\PreJoinableClauseTest.java,0,20,5,4,0,29
 druid-master\druid-master\server\src\main\java\org\apache\druid\client\selector\ServerSelectorStrategy.java,0,16,0,8,0,24
 druid-master\druid-master\processing\src\main\java\org\apache\druid\query\MapQueryToolChestWarehouse.java,0,12,0,4,0,16
 druid-master\druid-master\server\src\test\java\org\apache\druid\server\metrics\MetricsModuleTest.java,0,39,0,18,0,57
 druid-master\druid-master\processing\src\main\java\org\apache\druid\query\filter\vector\VectorValueMatcherFactory.java,0,9,0,2,0,11
 druid-master\druid-master\processing\src\main\java\org\apache\druid\segment\SimpleQueryableIndex.java,0,76,0,6,0,82
 druid-master\druid-master\extensions-core\druid-basic-security\src\main\java\org\apache\druid\security\basic\BasicAuthClassCompositionConfig.java,0,65,0,13,0,78
 druid-master\druid-master\server\src\test\java\org\apache\druid\client\BrokerInternalQueryConfigTest.java,0,18,0,5,0,23
 druid-master\druid-master\indexing-service\src\test\java\org\apache\druid\indexing\overlord\RemoteTaskRunnerRunPendingTasksConcurrencyTest.java,0,63,2,18,0,83
 druid-master\druid-master\indexing-service\src\main\java\org\apache\druid\indexing\overlord\setup\JavaScriptWorkerSelectStrategy.java,0,32,1,5,0,38
 druid-master\druid-master\processing\src\test\java\org\apache\druid\segment\filter\FilterCnfConversionTest.java,0,93,0,35,0,128
 druid-master\druid-master\extensions-core\druid-bloom-filter\src\test\java\org\apache\druid\query\filter\sql\BloomDimFilterSqlTest.java,0,61,0,28,0,89
 druid-master\druid-master\sql\src\main\java\org\apache\druid\sql\calcite\expression\builtin\CastOperatorConversion.java,0,21,0,13,0,34
 druid-master\druid-master\processing\src\test\java\org\apache\druid\query\aggregation\first\FloatFirstAggregationTest.java,0,90,0,16,0,106
 druid-master\druid-master\indexing-hadoop\src\main\java\org\apache\druid\indexer\path\GranularityPathSpec.java,0,59,0,5,0,64
 druid-master\druid-master\integration-tests\src\test\java\org\apache\druid\tests\indexer\ITCompactionSparseColumnTest.java,0,98,4,23,0,125
 druid-master\druid-master\benchmarks\src\test\java\org\apache\druid\benchmark\ConciseComplementBenchmark.java,0,8,1,2,0,11
 druid-master\druid-master\core\src\test\java\org\apache\druid\data\input\impl\MapInputRowParserTest.java,0,45,2,20,2,69
 druid-master\druid-master\server\src\test\java\org\apache\druid\client\cache\BackgroundCachePopulatorTest.java,0,59,4,10,0,73
 druid-master\druid-master\core\src\main\java\org\apache\druid\java\util\common\guava\Accumulators.java,0,8,1,1,0,10
 druid-master\druid-master\extensions-contrib\cassandra-storage\src\main\java\org\apache\druid\storage\cassandra\CassandraDataSegmentPuller.java,0,25,4,9,0,38
 druid-master\druid-master\indexing-service\src\test\java\org\apache\druid\indexing\common\task\SpecificSegmentsSpecTest.java,0,10,0,3,0,13
 druid-master\druid-master\server\src\test\java\org\apache\druid\segment\loading\LocalFileTimestampVersionFinderTest.java,0,24,0,5,0,29
 druid-master\druid-master\indexing-service\src\main\java\org\apache\druid\indexing\common\actions\LocalTaskActionClientFactory.java,0,16,0,2,0,18
 druid-master\druid-master\processing\src\test\java\org\apache\druid\segment\data\VSizeLongSerdeTest.java,0,78,1,21,0,100
 druid-master\druid-master\extensions-core\kafka-extraction-namespace\src\main\java\org\apache\druid\query\lookup\KafkaLookupExtractorIntrospectionHandler.java,0,11,0,3,0,14
 druid-master\druid-master\extensions-core\azure-extensions\src\main\java\org\apache\druid\storage\azure\AzureCloudBlobIterable.java,0,12,0,1,0,13
 druid-master\druid-master\server\src\main\java\org\apache\druid\indexing\overlord\supervisor\SupervisorSpec.java,0,15,0,3,0,18
 druid-master\druid-master\sql\src\main\java\org\apache\druid\sql\calcite\expression\builtin\RoundOperatorConversion.java,0,7,0,2,0,9
 druid-master\druid-master\benchmarks\src\test\java\org\apache\druid\benchmark\ExpressionAggregationBenchmark.java,0,59,1,14,0,74
 druid-master\druid-master\processing\src\test\java\org\apache\druid\segment\DictionaryMergingIteratorTest.java,0,22,0,8,0,30
 druid-master\druid-master\processing\src\test\java\org\apache\druid\collections\spatial\search\RadiusBoundTest.java,0,19,0,1,0,20
 druid-master\druid-master\core\src\main\java\org\apache\druid\java\util\http\client\response\InputStreamResponseHandler.java,0,22,0,4,0,26
 druid-master\druid-master\server\src\main\java\org\apache\druid\guice\annotations\Client.java,0,2,0,1,0,3
 druid-master\druid-master\benchmarks\src\test\java\org\apache\druid\benchmark\FlattenJSONBenchmarkUtil.java,0,182,1,23,0,206
 druid-master\druid-master\server\src\main\java\org\apache\druid\segment\realtime\plumber\FlushingPlumber.java,0,50,6,10,0,66
 druid-master\druid-master\core\src\test\java\org\apache\druid\timeline\partition\NumberedOverwritePartialShardSpecTest.java,0,8,0,4,0,12
 druid-master\druid-master\indexing-service\src\main\java\org\apache\druid\indexing\common\stats\DropwizardRowIngestionMetersFactory.java,0,4,0,2,0,6
 druid-master\druid-master\server\src\test\java\org\apache\druid\server\RendezvousHasherTest.java,0,46,3,14,0,63
 druid-master\druid-master\extensions-contrib\aliyun-oss-extensions\src\main\java\org\apache\druid\data\input\aliyun\OssClientConfig.java,0,44,0,3,0,47
 druid-master\druid-master\extensions-core\kinesis-indexing-service\src\main\java\org\apache\druid\indexing\kinesis\KinesisIndexTaskRunner.java,0,62,2,19,0,83
 druid-master\druid-master\indexing-service\src\test\java\org\apache\druid\indexing\common\task\CompactionTuningConfigTest.java,0,24,1,12,0,37
 druid-master\druid-master\processing\src\test\java\org\apache\druid\query\aggregation\post\DoubleGreatestPostAggregatorTest.java,0,13,0,3,0,16
 druid-master\druid-master\sql\src\main\java\org\apache\druid\sql\calcite\schema\AvailableSegmentMetadata.java,0,69,0,4,0,73
 druid-master\druid-master\extensions-core\datasketches\src\main\java\org\apache\druid\query\aggregation\datasketches\quantiles\DoublesSketchModule.java,0,42,0,34,0,76
 druid-master\druid-master\core\src\main\java\org\apache\druid\data\input\impl\NoopInputRowParser.java,0,21,0,2,0,23
 druid-master\druid-master\extensions-core\parquet-extensions\src\test\java\org\apache\druid\data\input\parquet\CompatParquetReaderTest.java,0,69,0,52,0,121
 druid-master\druid-master\server\src\main\java\org\apache\druid\client\ServerInventoryViewProvider.java,0,5,0,5,0,10
 druid-master\druid-master\extensions-core\hdfs-storage\src\main\java\org\apache\druid\inputsource\hdfs\HdfsInputSourceConfig.java,0,12,0,3,0,15
 druid-master\druid-master\core\src\test\java\org\apache\druid\collections\StableLimitingSorterTest.java,0,4,0,2,0,6
 druid-master\druid-master\integration-tests\src\test\java\org\apache\druid\tests\query\ITQueryErrorTest.java,0,75,0,34,0,109
 druid-master\druid-master\core\src\test\java\org\apache\druid\timeline\partition\AtomicUpdateGroupTest.java,0,11,0,1,0,12
 druid-master\druid-master\processing\src\test\java\org\apache\druid\segment\QueryableIndexIndexableAdapterTest.java,0,16,0,5,0,21
 druid-master\druid-master\extensions-contrib\moving-average-query\src\main\java\org\apache\druid\query\movingaverage\averagers\LongMeanNoNullAveragerFactory.java,0,10,0,2,0,12
 druid-master\druid-master\extensions-core\azure-extensions\src\test\java\org\apache\druid\storage\azure\AzureDataSegmentPusherTest.java,0,97,11,45,0,153
 druid-master\druid-master\indexing-service\src\main\java\org\apache\druid\indexing\common\task\batch\partition\HashPartitionAnalysis.java,0,30,0,5,0,35
 druid-master\druid-master\processing\src\main\java\org\apache\druid\jackson\DruidDefaultSerializersModule.java,0,34,0,5,0,39
 druid-master\druid-master\server\src\test\java\org\apache\druid\client\CachingClusteredClientCacheKeyManagerTest.java,0,99,13,34,0,146
 druid-master\druid-master\sql\src\main\java\org\apache\druid\sql\calcite\schema\DruidCalciteSchemaModule.java,0,12,1,3,0,16
 druid-master\druid-master\core\src\test\java\org\apache\druid\java\util\metrics\SigarLoadTest.java,0,3,0,1,0,4
 druid-master\druid-master\sql\src\main\java\org\apache\druid\sql\calcite\planner\PlannerContext.java,0,149,0,28,0,177
 druid-master\druid-master\server\src\main\java\org\apache\druid\client\cache\CaffeineCacheProvider.java,0,4,0,2,0,6
 druid-master\druid-master\sql\src\main\java\org\apache\druid\sql\http\SqlHttpModule.java,0,5,0,1,0,6
 druid-master\druid-master\server\src\main\java\org\apache\druid\indexing\overlord\supervisor\SupervisorStateManager.java,0,137,3,33,0,173
 druid-master\druid-master\extensions-core\druid-basic-security\src\main\java\org\apache\druid\security\basic\authorization\db\cache\BasicAuthorizerCacheNotifier.java,0,7,0,5,0,12
 druid-master\druid-master\sql\src\main\java\org\apache\druid\sql\calcite\expression\builtin\ArrayOrdinalOfOperatorConversion.java,0,4,0,1,0,5
 druid-master\druid-master\server\src\main\java\org\apache\druid\segment\realtime\appenderator\BatchAppenderatorDriver.java,0,46,0,24,0,70
 druid-master\druid-master\extensions-core\lookups-cached-global\src\test\java\org\apache\druid\query\lookup\namespace\JSONFlatDataParserTest.java,0,48,2,14,0,64
 druid-master\druid-master\processing\src\main\java\org\apache\druid\query\topn\TopNNumericResultBuilder.java,0,88,3,23,0,114
 druid-master\druid-master\core\src\main\java\org\apache\druid\java\util\common\parsers\AbstractFlatTextFormatParser.java,0,49,2,9,1,61
 druid-master\druid-master\processing\src\main\java\org\apache\druid\query\groupby\epinephelinae\collection\HashTableUtils.java,0,68,2,20,0,90
 druid-master\druid-master\extensions-core\stats\src\test\java\org\apache\druid\query\aggregation\variance\VarianceTimeseriesQueryTest.java,0,54,1,19,0,74
 druid-master\druid-master\core\src\main\java\org\apache\druid\java\util\common\DefineClassUtils.java,0,57,2,30,0,89
 druid-master\druid-master\processing\src\main\java\org\apache\druid\segment\FloatDimensionHandler.java,0,36,0,6,0,42
 druid-master\druid-master\core\src\main\java\org\apache\druid\java\util\common\lifecycle\LifecycleStop.java,0,1,0,1,0,2
 druid-master\druid-master\services\src\main\java\org\apache\druid\cli\CoordinatorOverlordRedirectInfo.java,0,22,0,3,0,25
 druid-master\druid-master\extensions-core\druid-basic-security\src\main\java\org\apache\druid\security\basic\BasicAuthDBConfig.java,0,45,0,1,0,46
 druid-master\druid-master\indexing-hadoop\src\main\java\org\apache\druid\indexer\JobHelper.java,0,225,12,84,0,321
 druid-master\druid-master\server\src\main\java\org\apache\druid\server\http\IntervalsResource.java,0,38,2,15,0,55
 druid-master\druid-master\sql\src\main\java\org\apache\druid\sql\calcite\expression\builtin\StringToArrayOperatorConversion.java,0,4,0,1,0,5
 druid-master\druid-master\extensions-core\parquet-extensions\src\test\java\org\apache\druid\data\input\parquet\BaseParquetReaderTest.java,0,22,0,6,0,28
 druid-master\druid-master\core\src\main\java\org\apache\druid\java\util\metrics\CgroupUtil.java,0,4,0,1,0,5
 druid-master\druid-master\processing\src\main\java\org\apache\druid\query\groupby\epinephelinae\RowBasedKeySerdeHelper.java,0,13,0,13,0,26
 druid-master\druid-master\core\src\main\java\org\apache\druid\timeline\partition\HashPartitionFunction.java,0,16,0,5,0,21
 druid-master\druid-master\server\src\main\java\org\apache\druid\server\emitter\ComposingEmitterConfig.java,0,6,0,1,0,7
 druid-master\druid-master\extensions-core\druid-basic-security\src\main\java\org\apache\druid\security\basic\authentication\validator\LDAPCredentialsValidator.java,0,128,3,31,0,162
 druid-master\druid-master\server\src\main\java\org\apache\druid\metadata\MetadataStorage.java,0,5,0,1,0,6
 druid-master\druid-master\server\src\main\java\org\apache\druid\server\initialization\jetty\JettyRequestLog.java,0,8,0,2,0,10
 druid-master\druid-master\core\src\test\java\org\apache\druid\data\input\impl\prefetch\JsonIteratorTest.java,0,8,0,4,2,14
 druid-master\druid-master\server\src\main\java\org\apache\druid\server\initialization\ServerConfig.java,0,187,1,11,0,199
 druid-master\druid-master\processing\src\test\java\org\apache\druid\segment\filter\LongFilteringTest.java,0,100,0,49,0,149
 druid-master\druid-master\processing\src\test\java\org\apache\druid\segment\data\CompressedDoublesSerdeTest.java,0,69,0,17,0,86
 druid-master\druid-master\server\src\main\java\org\apache\druid\server\router\AvaticaConnectionBalancer.java,0,8,0,7,0,15
 druid-master\druid-master\indexing-service\src\main\java\org\apache\druid\indexing\common\task\batch\parallel\GenericPartitionStat.java,0,67,0,7,0,74
 druid-master\druid-master\core\src\main\java\org\apache\druid\math\expr\Evals.java,0,25,2,1,0,28
 druid-master\druid-master\extensions-core\s3-extensions\src\test\java\org\apache\druid\data\input\s3\S3InputSourceTest.java,0,179,2,77,0,258
 druid-master\druid-master\integration-tests\src\main\java\org\apache\druid\testing\utils\ProtobufEventSerializer.java,0,24,1,2,0,27
 druid-master\druid-master\sql\src\test\java\org\apache\druid\sql\calcite\rule\DruidUnionDataSourceRuleTest.java,0,34,9,6,0,49
 druid-master\druid-master\sql\src\test\java\org\apache\druid\sql\calcite\expression\LeastExpressionTest.java,0,67,0,5,0,72
 druid-master\druid-master\processing\src\test\java\org\apache\druid\query\GlobalTableDataSourceTest.java,0,13,0,4,0,17
 druid-master\druid-master\indexing-service\src\test\java\org\apache\druid\indexing\worker\WorkerTaskMonitorTest.java,0,85,1,32,0,118
 druid-master\druid-master\integration-tests\src\test\java\org\apache\druid\tests\api\ITOverlordResourceTest.java,0,8,0,3,0,11
 druid-master\druid-master\server\src\main\java\org\apache\druid\server\coordination\BatchDataSegmentAnnouncer.java,0,112,10,26,0,148
 druid-master\druid-master\extensions-core\azure-extensions\src\main\java\org\apache\druid\storage\azure\AzureTaskLogsConfig.java,0,24,1,1,0,26
 druid-master\druid-master\processing\src\main\java\org\apache\druid\query\aggregation\JavaScriptBufferAggregator.java,0,40,0,3,0,43
 druid-master\druid-master\extensions-contrib\aliyun-oss-extensions\src\main\java\org\apache\druid\storage\aliyun\OssObjectSummaryIterator.java,0,33,0,11,0,44
 druid-master\druid-master\processing\src\main\java\org\apache\druid\query\PrioritizedRunnable.java,0,2,0,1,0,3
 druid-master\druid-master\processing\src\main\java\org\apache\druid\query\aggregation\any\FloatAnyAggregator.java,0,16,0,2,0,18
 druid-master\druid-master\processing\src\main\java\org\apache\druid\query\aggregation\AggregateCombiner.java,0,21,0,16,0,37
 druid-master\druid-master\processing\src\main\java\org\apache\druid\query\groupby\epinephelinae\RowBasedGrouperHelper.java,0,504,1,178,0,683
 druid-master\druid-master\processing\src\main\java\org\apache\druid\segment\filter\PredicateValueMatcherFactory.java,0,56,1,18,0,75
 druid-master\druid-master\processing\src\main\java\org\apache\druid\query\aggregation\HistogramAggregatorFactory.java,0,87,1,11,0,99
 druid-master\druid-master\processing\src\test\java\org\apache\druid\query\scan\ScanQueryLimitRowIteratorTest.java,0,38,3,17,0,58
 druid-master\druid-master\core\src\test\java\org\apache\druid\utils\DynamicConfigProviderUtilsTest.java,0,17,1,8,2,28
 druid-master\druid-master\core\src\test\java\org\apache\druid\guice\PolyBindTest.java,0,43,3,15,7,68
 druid-master\druid-master\processing\src\main\java\org\apache\druid\query\aggregation\FloatMinAggregator.java,0,21,0,1,0,22
 druid-master\druid-master\integration-tests\src\main\java\org\apache\druid\testing\clients\CompactionResourceTestClient.java,0,74,1,25,0,100
 druid-master\druid-master\processing\src\main\java\org\apache\druid\segment\data\ZeroIndexedInts.java,0,12,1,2,0,15
 druid-master\druid-master\processing\src\main\java\org\apache\druid\query\expression\IPv4AddressMatchExprMacro.java,0,35,1,10,0,46
 druid-master\druid-master\processing\src\test\java\org\apache\druid\segment\SchemalessTestSimpleTest.java,0,109,6,32,0,147
 druid-master\druid-master\processing\src\main\java\org\apache\druid\query\topn\TopNQueryEngine.java,0,63,0,39,0,102
 druid-master\druid-master\processing\src\main\java\org\apache\druid\segment\data\CompressedColumnarFloatsSupplier.java,0,36,0,5,0,41
 druid-master\druid-master\core\src\main\java\org\apache\druid\metadata\EntryExistsException.java,0,8,0,1,0,9
 druid-master\druid-master\server\src\main\java\org\apache\druid\client\indexing\ClientCompactionIOConfig.java,0,32,0,3,0,35
 druid-master\druid-master\extensions-core\druid-basic-security\src\test\java\org\apache\druid\security\authentication\validator\LDAPCredentialsValidatorTest.java,0,32,2,12,0,46
 druid-master\druid-master\processing\src\main\java\org\apache\druid\query\groupby\epinephelinae\HashVectorGrouper.java,0,137,0,61,0,198
 druid-master\druid-master\processing\src\main\java\org\apache\druid\segment\virtual\ExpressionSingleValueDimensionSelector.java,0,29,0,8,0,37
 druid-master\druid-master\core\src\test\java\org\apache\druid\common\EitherTest.java,0,24,0,13,0,37
 druid-master\druid-master\extensions-core\datasketches\src\main\java\org\apache\druid\query\aggregation\datasketches\tuple\ArrayOfDoublesSketchToEstimateAndBoundsPostAggregator.java,0,37,1,11,0,49
 druid-master\druid-master\sql\src\main\java\org\apache\druid\sql\calcite\parser\DruidSqlParserImplFactory.java,0,4,0,1,0,5
 druid-master\druid-master\core\src\main\java\org\apache\druid\java\util\emitter\factory\ParametrizedUriEmitterFactory.java,0,9,0,4,0,13
 druid-master\druid-master\extensions-core\avro-extensions\src\main\java\org\apache\druid\data\input\avro\AvroFlattenerMaker.java,0,50,2,12,0,64
 druid-master\druid-master\server\src\main\java\org\apache\druid\server\coordinator\UserCompactionTaskDimensionsConfig.java,0,24,0,7,0,31
 druid-master\druid-master\indexing-service\src\main\java\org\apache\druid\indexing\overlord\hrtr\HttpRemoteTaskRunnerResource.java,0,42,0,15,0,57
 druid-master\druid-master\processing\src\main\java\org\apache\druid\query\groupby\having\NotHavingSpec.java,0,27,1,2,0,30
 druid-master\druid-master\processing\src\main\java\org\apache\druid\query\extraction\TimeDimExtractionFn.java,0,52,0,6,0,58
 druid-master\druid-master\integration-tests\src\test\java\org\apache\druid\tests\indexer\ITSqlInputSourceTest.java,0,21,1,12,0,34
 druid-master\druid-master\indexing-service\src\main\java\org\apache\druid\indexing\common\TaskReport.java,0,9,0,4,0,13
 druid-master\druid-master\server\src\main\java\org\apache\druid\guice\QueryToolChestModule.java,0,29,0,19,0,48
 druid-master\druid-master\server\src\main\java\org\apache\druid\client\JsonParserIterator.java,0,64,3,18,0,85
 druid-master\druid-master\processing\src\main\java\org\apache\druid\segment\writeout\SegmentWriteOutMediumFactory.java,0,12,0,8,0,20
 druid-master\druid-master\processing\src\test\java\org\apache\druid\query\filter\GetDimensionRangeSetTest.java,0,71,0,38,0,109
 druid-master\druid-master\extensions-core\kafka-extraction-namespace\src\main\java\org\apache\druid\query\lookup\KafkaLookupExtractorFactory.java,0,106,1,21,0,128
 druid-master\druid-master\indexing-service\src\main\java\org\apache\druid\indexing\overlord\http\security\TaskResourceFilter.java,0,14,0,5,0,19
 druid-master\druid-master\sql\src\main\java\org\apache\druid\sql\calcite\rel\DruidRel.java,0,33,0,10,0,43
 druid-master\druid-master\extensions-core\s3-extensions\src\main\java\org\apache\druid\storage\s3\S3SSECustomConfig.java,0,5,0,1,0,6
 druid-master\druid-master\server\src\main\java\org\apache\druid\guice\NoopSegmentPublisherProvider.java,0,3,0,1,0,4
 druid-master\druid-master\integration-tests\src\main\java\org\apache\druid\testing\utils\StreamEventWriter.java,0,13,0,9,0,22
 druid-master\druid-master\server\src\main\java\org\apache\druid\client\FilteredBatchServerInventoryViewProvider.java,0,7,0,2,0,9
 druid-master\druid-master\server\src\test\java\org\apache\druid\segment\realtime\firehose\CombiningFirehoseFactoryTest.java,0,50,0,8,0,58
 druid-master\druid-master\sql\src\main\java\org\apache\druid\sql\calcite\planner\PlannerConfig.java,0,114,0,9,0,123
 druid-master\druid-master\services\src\main\java\org\apache\druid\server\router\TieredBrokerSelectorStrategiesProvider.java,0,8,0,2,0,10
 druid-master\druid-master\processing\src\main\java\org\apache\druid\query\aggregation\FilteredAggregatorFactory.java,0,94,1,12,0,107
 druid-master\druid-master\extensions-contrib\moving-average-query\src\main\java\org\apache\druid\query\movingaverage\averagers\Averager.java,0,7,0,2,0,9
 druid-master\druid-master\extensions-core\datasketches\src\main\java\org\apache\druid\query\aggregation\datasketches\theta\sql\ThetaSketchBaseSqlAggregator.java,0,21,0,11,0,32
 druid-master\druid-master\extensions-core\histogram\src\main\java\org\apache\druid\query\aggregation\histogram\ApproximateHistogramVectorAggregator.java,0,28,0,5,0,33
 druid-master\druid-master\processing\src\main\java\org\apache\druid\collections\spatial\search\SearchStrategy.java,0,2,0,1,0,3
 druid-master\druid-master\core\src\main\java\org\apache\druid\segment\loading\DataSegmentPusher.java,0,48,0,27,0,75
 druid-master\druid-master\processing\src\main\java\org\apache\druid\query\topn\TopNAlgorithmSelector.java,0,39,3,2,0,44
 druid-master\druid-master\extensions-core\lookups-cached-global\src\main\java\org\apache\druid\server\lookup\namespace\UriCacheGenerator.java,0,29,3,13,0,45
 druid-master\druid-master\processing\src\main\java\org\apache\druid\segment\serde\ComplexColumnPartSupplier.java,0,10,0,2,0,12
 druid-master\druid-master\integration-tests\src\test\java\org\apache\druid\tests\indexer\AbstractAzureInputSourceParallelIndexTest.java,0,27,1,10,0,38
 druid-master\druid-master\core\src\main\java\org\apache\druid\timeline\partition\TombstonePartitionedChunk.java,0,34,0,2,0,36
 druid-master\druid-master\processing\src\test\java\org\apache\druid\query\lookup\LookupExtractorFactoryContainerTest.java,0,19,1,5,0,25
 druid-master\druid-master\processing\src\main\java\org\apache\druid\query\aggregation\post\DoubleGreatestPostAggregator.java,0,46,3,6,0,55
 druid-master\druid-master\indexing-service\src\main\java\org\apache\druid\indexing\overlord\setup\EqualDistributionWithAffinityWorkerSelectStrategy.java,0,6,0,3,0,9
 druid-master\druid-master\extensions-contrib\statsd-emitter\src\main\java\org\apache\druid\emitter\statsd\StatsDEmitter.java,0,64,4,12,0,80
 druid-master\druid-master\indexing-service\src\test\java\org\apache\druid\indexing\overlord\supervisor\SupervisorResourceTest.java,0,396,4,240,0,640
 druid-master\druid-master\server\src\main\java\org\apache\druid\segment\realtime\firehose\ChatHandlerResource.java,0,20,0,9,0,29
 druid-master\druid-master\processing\src\test\java\org\apache\druid\query\aggregation\last\FloatLastAggregationTest.java,0,90,0,16,0,106
 druid-master\druid-master\core\src\main\java\org\apache\druid\math\expr\vector\LongOutLongDoubleInFunctionVectorValueProcessor.java,0,16,0,2,0,18
 druid-master\druid-master\extensions-contrib\tdigestsketch\src\main\java\org\apache\druid\query\aggregation\tdigestsketch\TDigestSketchToQuantilesPostAggregator.java,0,49,0,7,0,56
 druid-master\druid-master\server\src\test\java\org\apache\druid\query\expression\LookupEnabledTestExprMacroTable.java,0,27,1,7,0,35
 druid-master\druid-master\processing\src\main\java\org\apache\druid\segment\data\IndexedInts.java,0,15,0,3,0,18
 druid-master\druid-master\processing\src\main\java\org\apache\druid\query\aggregation\FloatSumVectorAggregator.java,0,16,0,3,0,19
 druid-master\druid-master\extensions-contrib\moving-average-query\src\main\java\org\apache\druid\query\movingaverage\averagers\DoubleMeanAveragerFactory.java,0,10,0,2,0,12
 druid-master\druid-master\core\src\main\java\org\apache\druid\data\input\impl\RetryingInputStream.java,0,63,5,11,0,79
 druid-master\druid-master\indexing-service\src\test\java\org\apache\druid\indexing\common\task\RealtimeIndexTaskTest.java,0,179,1,72,0,252
 druid-master\druid-master\extensions-core\simple-client-sslcontext\src\main\java\org\apache\druid\https\SSLContextProvider.java,0,15,0,3,0,18
 druid-master\druid-master\extensions-core\azure-extensions\src\test\java\org\apache\druid\storage\azure\AzureDataSegmentKillerTest.java,0,98,10,44,0,152
 druid-master\druid-master\extensions-core\lookups-cached-single\src\main\java\org\apache\druid\server\lookup\cache\polling\OffHeapPollingCache.java,0,31,0,5,0,36
 druid-master\druid-master\server\src\main\java\org\apache\druid\client\indexing\TaskStatusResponse.java,0,26,0,3,0,29
 druid-master\druid-master\extensions-core\stats\src\test\java\org\apache\druid\query\aggregation\variance\VarianceFloatVectorAggregatorTest.java,0,58,0,11,0,69
 druid-master\druid-master\extensions-core\lookups-cached-single\src\main\java\org\apache\druid\server\lookup\LoadingLookup.java,0,66,0,11,0,77
 druid-master\druid-master\processing\src\main\java\org\apache\druid\query\extraction\MapLookupExtractor.java,0,39,0,3,0,42
 druid-master\druid-master\integration-tests\src\test\java\org\apache\druid\tests\indexer\ITS3OverrideCredentialsIndexTest.java,0,62,2,38,0,102
 druid-master\druid-master\processing\src\test\java\org\apache\druid\query\aggregation\TestDoubleColumnSelectorImpl.java,0,14,0,1,0,15
 druid-master\druid-master\processing\src\test\java\org\apache\druid\query\aggregation\post\JavaScriptPostAggregatorTest.java,0,13,0,2,0,15
 druid-master\druid-master\server\src\main\java\org\apache\druid\segment\indexing\IOConfig.java,0,3,1,1,0,5
 druid-master\druid-master\processing\src\main\java\org\apache\druid\query\topn\PooledTopNAlgorithm.java,0,346,5,95,0,446
 druid-master\druid-master\processing\src\test\java\org\apache\druid\query\spec\SpecificSegmentQueryRunnerTest.java,0,42,0,12,0,54
 druid-master\druid-master\server\src\main\java\org\apache\druid\server\http\security\AbstractResourceFilter.java,0,32,1,2,0,35
 druid-master\druid-master\benchmarks\src\test\java\org\apache\druid\benchmark\compression\LongCompressionBenchmarkFileGenerator.java,0,37,1,13,0,51
 druid-master\druid-master\processing\src\test\java\org\apache\druid\query\QueryRunnerTestHelper.java,0,213,2,84,0,299
 druid-master\druid-master\server\src\main\java\org\apache\druid\server\initialization\TLSServerConfig.java,0,92,0,2,0,94
 druid-master\druid-master\benchmarks\src\test\java\org\apache\druid\server\coordinator\CachingCostBalancerStrategyBenchmark.java,0,29,0,6,0,35
 druid-master\druid-master\extensions-contrib\cloudfiles-extensions\src\main\java\org\apache\druid\firehose\cloudfiles\CloudFilesBlob.java,0,31,0,1,0,32
 druid-master\druid-master\processing\src\test\java\org\apache\druid\query\aggregation\AggregationTestHelper.java,0,259,3,34,0,296
 druid-master\druid-master\processing\src\main\java\org\apache\druid\query\groupby\epinephelinae\GroupByMergingQueryRunnerV2.java,0,124,5,59,0,188
 druid-master\druid-master\extensions-core\datasketches\src\main\java\org\apache\druid\query\aggregation\datasketches\hll\HllSketchMergeAggregatorFactory.java,0,33,0,12,0,45
 druid-master\druid-master\extensions-core\kafka-indexing-service\src\main\java\org\apache\druid\indexing\kafka\supervisor\KafkaSupervisorTuningConfig.java,0,100,1,17,0,118
 druid-master\druid-master\core\src\main\java\org\apache\druid\timeline\CompactionState.java,0,69,0,11,8,88
 druid-master\druid-master\extensions-core\parquet-extensions\src\test\java\org\apache\druid\data\input\parquet\FlattenSpecParquetInputTest.java,0,45,0,20,0,65
 druid-master\druid-master\sql\src\main\java\org\apache\druid\sql\calcite\schema\NamedDruidSchema.java,0,17,0,2,0,19
 druid-master\druid-master\processing\src\main\java\org\apache\druid\segment\QueryableIndex.java,0,12,0,4,0,16
 druid-master\druid-master\processing\src\test\java\org\apache\druid\segment\transform\TransformerTest.java,0,39,0,15,0,54
 druid-master\druid-master\processing\src\main\java\org\apache\druid\query\extraction\TimeFormatExtractionFn.java,0,73,0,12,0,85
 druid-master\druid-master\extensions-core\datasketches\src\test\java\org\apache\druid\query\aggregation\datasketches\hll\HllSketchToEstimateWithBoundsPostAggregatorTest.java,0,10,0,4,0,14
 druid-master\druid-master\core\src\main\java\org\apache\druid\java\util\common\guava\Sequence.java,0,35,0,16,0,51
 druid-master\druid-master\services\src\main\java\org\apache\druid\server\router\TieredBrokerSelectorStrategy.java,0,8,0,7,0,15
 druid-master\druid-master\extensions-core\azure-extensions\src\test\java\org\apache\druid\storage\azure\AzureDataSegmentPullerTest.java,0,51,6,24,0,81
 druid-master\druid-master\processing\src\test\java\org\apache\druid\query\timeboundary\TimeBoundaryQueryRunnerTest.java,0,79,2,38,0,119
 druid-master\druid-master\core\src\main\java\org\apache\druid\data\input\impl\prefetch\CacheManager.java,0,35,1,9,0,45
 druid-master\druid-master\processing\src\main\java\org\apache\druid\query\topn\Generic1AggPooledTopNScannerPrototype.java,0,16,0,9,0,25
 druid-master\druid-master\core\src\test\java\org\apache\druid\data\input\FirehoseFactoryToInputSourceAdaptorTest.java,0,38,0,8,0,46
 druid-master\druid-master\extensions-core\google-extensions\src\main\java\org\apache\druid\data\input\google\GoogleCloudStorageEntity.java,0,18,0,2,0,20
 druid-master\druid-master\processing\src\main\java\org\apache\druid\segment\LongColumnSelector.java,0,16,0,12,0,28
 druid-master\druid-master\cloud\aws-common\src\main\java\org\apache\druid\common\aws\AWSClientUtil.java,0,9,1,4,0,14
 druid-master\druid-master\indexing-hadoop\src\test\java\org\apache\druid\indexer\HadoopDruidDetermineConfigurationJobTest.java,0,20,0,14,0,34
 druid-master\druid-master\server\src\main\java\org\apache\druid\curator\ExhibitorConfig.java,0,24,0,1,0,25
 druid-master\druid-master\processing\src\main\java\org\apache\druid\segment\virtual\SingleStringInputDeferredEvaluationExpressionDimensionSelector.java,0,37,0,10,0,47
 druid-master\druid-master\benchmarks\src\test\java\org\apache\druid\benchmark\compression\ColumnarLongsEncodeDataFromSegmentBenchmark.java,0,26,3,11,0,40
 druid-master\druid-master\processing\src\main\java\org\apache\druid\query\filter\vector\BooleanVectorValueMatcher.java,0,10,1,3,0,14
 druid-master\druid-master\processing\src\test\java\org\apache\druid\query\search\SearchQueryRunnerTest.java,0,268,2,126,0,396
 druid-master\druid-master\processing\src\main\java\org\apache\druid\segment\data\CompressedVSizeColumnarIntsSerializer.java,0,46,0,8,0,54
 druid-master\druid-master\sql\src\test\java\org\apache\druid\sql\calcite\rel\GroupingTest.java,0,5,0,3,0,8
 druid-master\druid-master\indexing-service\src\main\java\org\apache\druid\indexing\common\task\batch\parallel\TombstoneHelper.java,0,37,0,12,0,49
 druid-master\druid-master\server\src\main\java\org\apache\druid\server\coordinator\AutoCompactionSnapshot.java,0,152,0,7,0,159
 druid-master\druid-master\sql\src\main\java\org\apache\druid\sql\calcite\rule\DruidRules.java,0,47,0,13,0,60
 druid-master\druid-master\sql\src\main\java\org\apache\druid\sql\calcite\expression\builtin\RTrimOperatorConversion.java,0,6,0,1,0,7
 druid-master\druid-master\core\src\test\java\org\apache\druid\data\input\impl\HttpEntityTest.java,0,30,4,8,5,47
 druid-master\druid-master\processing\src\main\java\org\apache\druid\jackson\JacksonModule.java,0,14,0,2,0,16
 druid-master\druid-master\extensions-core\lookups-cached-global\src\main\java\org\apache\druid\server\lookup\namespace\cache\CacheHandler.java,0,20,2,3,0,25
 druid-master\druid-master\processing\src\main\java\org\apache\druid\query\expression\ContainsExpr.java,0,31,0,9,0,40
 druid-master\druid-master\server\src\main\java\org\apache\druid\indexing\overlord\supervisor\autoscaler\SupervisorTaskAutoScaler.java,0,4,0,1,0,5
 druid-master\druid-master\processing\src\main\java\org\apache\druid\query\ReflectionQueryToolChestWarehouse.java,0,17,0,7,0,24
 druid-master\druid-master\processing\src\test\java\org\apache\druid\segment\virtual\DummyStringVirtualColumnTest.java,0,87,8,19,0,114
 druid-master\druid-master\extensions-core\stats\src\main\java\org\apache\druid\query\aggregation\variance\VarianceFloatVectorAggregator.java,0,33,1,4,0,38
 druid-master\druid-master\processing\src\main\java\org\apache\druid\segment\transform\TransformSpec.java,0,48,0,11,0,59
 druid-master\druid-master\processing\src\main\java\org\apache\druid\segment\data\VSizeLongSerde.java,0,857,5,85,0,947
 druid-master\druid-master\sql\src\main\java\org\apache\druid\sql\calcite\expression\OperatorConversions.java,0,214,3,91,0,308
 druid-master\druid-master\core\src\main\java\org\apache\druid\data\input\impl\JSONLowercaseParseSpec.java,0,15,0,1,0,16
 druid-master\druid-master\processing\src\test\java\org\apache\druid\query\expression\RegexpLikeExprMacroTest.java,0,37,0,15,0,52
 druid-master\druid-master\core\src\test\java\org\apache\druid\timeline\partition\DimensionRangeBucketShardSpecTest.java,0,33,1,10,0,44
 druid-master\druid-master\processing\src\main\java\org\apache\druid\query\aggregation\any\DoubleAnyAggregatorFactory.java,0,84,0,12,0,96
 druid-master\druid-master\extensions-core\datasketches\src\test\java\org\apache\druid\query\aggregation\datasketches\tuple\ArrayOfDoublesSketchAggregatorFactoryTest.java,0,15,0,11,0,26
 druid-master\druid-master\core\src\main\java\org\apache\druid\data\input\impl\DelimitedValueReader.java,0,41,0,8,0,49
 druid-master\druid-master\server\src\test\java\org\apache\druid\server\coordinator\DruidClusterBuilder.java,0,26,0,5,0,31
 druid-master\druid-master\processing\src\main\java\org\apache\druid\query\aggregation\FloatMaxAggregator.java,0,21,0,1,0,22
 druid-master\druid-master\extensions-core\ec2-extensions\src\main\java\org\apache\druid\indexing\overlord\autoscaling\ec2\EC2NodeData.java,0,87,1,7,0,95
 druid-master\druid-master\server\src\test\java\org\apache\druid\segment\indexing\RealtimeTuningConfigTest.java,0,35,0,16,0,51
 druid-master\druid-master\extensions-core\azure-extensions\src\main\java\org\apache\druid\storage\azure\AzureCloudBlobIterator.java,0,37,0,8,0,45
 druid-master\druid-master\core\src\test\java\org\apache\druid\java\util\common\guava\ConcatSequenceTest.java,0,119,0,7,4,130
 druid-master\druid-master\extensions-contrib\moving-average-query\src\test\java\org\apache\druid\query\movingaverage\averagers\DoubleMeanAveragerWithPeriodTest.java,0,57,0,33,0,90
 druid-master\druid-master\core\src\test\java\org\apache\druid\java\util\common\NumbersTest.java,0,42,0,1,3,46
 druid-master\druid-master\processing\src\main\java\org\apache\druid\segment\MetricHolder.java,0,39,2,4,0,45
 druid-master\druid-master\indexing-service\src\test\java\org\apache\druid\indexing\common\actions\SegmentAllocateActionSerdeTest.java,0,22,0,13,0,35
 druid-master\druid-master\sql\src\main\java\org\apache\druid\sql\calcite\expression\builtin\TimeFloorOperatorConversion.java,0,41,1,23,0,65
 druid-master\druid-master\core\src\main\java\org\apache\druid\java\util\common\concurrent\DirectExecutorService.java,0,46,0,24,0,70
 druid-master\druid-master\sql\src\test\java\org\apache\druid\sql\calcite\external\ExternalTableScanRuleTest.java,0,10,0,7,0,17
 druid-master\druid-master\services\src\main\java\org\apache\druid\cli\convert\DataSegmentPusherDefaultConverter.java,0,18,0,10,0,28
 druid-master\druid-master\indexing-service\src\test\java\org\apache\druid\indexing\seekablestream\StreamChunkParserTest.java,0,62,1,22,0,85
 druid-master\druid-master\indexing-service\src\main\java\org\apache\druid\indexing\overlord\RemoteTaskRunner.java,0,387,42,164,0,593
 druid-master\druid-master\processing\src\main\java\org\apache\druid\query\filter\vector\ReadableVectorMatch.java,0,14,0,9,0,23
 druid-master\druid-master\sql\src\main\java\org\apache\druid\sql\guice\SqlBindings.java,0,23,1,9,0,33
 druid-master\druid-master\sql\src\main\java\org\apache\druid\sql\http\ObjectWriter.java,0,29,0,7,0,36
 druid-master\druid-master\extensions-core\druid-basic-security\src\main\java\org\apache\druid\security\basic\authorization\entity\UserAndRoleMap.java,0,15,0,1,0,16
 druid-master\druid-master\server\src\test\java\org\apache\druid\segment\loading\OmniDataSegmentKillerTest.java,0,16,0,8,0,24
 druid-master\druid-master\server\src\main\java\org\apache\druid\segment\loading\SegmentLoaderConfig.java,0,72,0,9,0,81
 druid-master\druid-master\processing\src\test\java\org\apache\druid\query\aggregation\FilteredAggregatorFactoryTest.java,0,5,0,1,0,6
 druid-master\druid-master\indexing-hadoop\src\main\java\org\apache\druid\indexer\hadoop\FSSpideringIterator.java,0,34,0,5,0,39
 druid-master\druid-master\processing\src\test\java\org\apache\druid\query\timeboundary\TimeBoundaryQueryQueryToolChestTest.java,0,70,0,40,0,110
 druid-master\druid-master\processing\src\test\java\org\apache\druid\query\aggregation\first\StringFirstAggregationTest.java,0,79,1,19,0,99
 druid-master\druid-master\server\src\test\java\org\apache\druid\segment\realtime\plumber\SinkTest.java,0,37,0,5,0,42
 druid-master\druid-master\processing\src\main\java\org\apache\druid\segment\DoubleDimensionHandler.java,0,36,0,6,0,42
 druid-master\druid-master\processing\src\main\java\org\apache\druid\query\aggregation\last\StringLastFoldingAggregatorFactory.java,0,9,0,4,0,13
 druid-master\druid-master\processing\src\main\java\org\apache\druid\segment\LongDimensionIndexer.java,0,71,1,12,0,84
 druid-master\druid-master\processing\src\test\java\org\apache\druid\segment\TestNullableFloatColumnSelector.java,0,15,0,2,0,17
 druid-master\druid-master\server\src\main\java\org\apache\druid\server\metrics\MetricsModule.java,0,49,1,15,0,65
 druid-master\druid-master\core\src\test\java\org\apache\druid\java\util\metrics\SigarPidDiscovererTest.java,0,3,0,1,1,5
 druid-master\druid-master\processing\src\test\java\org\apache\druid\query\QueryContextsTest.java,0,57,1,16,0,74
 druid-master\druid-master\sql\src\test\java\org\apache\druid\sql\avatica\DruidAvaticaJsonHandlerTest.java,0,5,0,1,0,6
 druid-master\druid-master\server\src\main\java\org\apache\druid\segment\realtime\firehose\PrefetchSqlFirehoseFactory.java,0,83,3,29,0,115
 druid-master\druid-master\extensions-core\stats\src\test\java\org\apache\druid\query\aggregation\variance\VarianceObjectVectorAggregatorTest.java,0,44,1,9,0,54
 druid-master\druid-master\server\src\test\java\org\apache\druid\client\cache\CachePopulatorTest.java,0,37,2,14,0,53
 druid-master\druid-master\processing\src\test\java\org\apache\druid\query\expression\RegexpExtractExprMacroTest.java,0,50,1,20,0,71
 druid-master\druid-master\extensions-core\hdfs-storage\src\main\java\org\apache\druid\storage\hdfs\HdfsDataSegmentPusherConfig.java,0,10,0,1,0,11
 druid-master\druid-master\core\src\main\java\org\apache\druid\indexer\partitions\DimensionRangePartitionsSpec.java,0,67,2,13,2,84
 druid-master\druid-master\core\src\test\java\org\apache\druid\math\expr\ApplyFunctionTest.java,0,135,0,55,1,191
 druid-master\druid-master\core\src\test\java\org\apache\druid\data\input\impl\JSONPathSpecTest.java,0,10,0,2,0,12
 druid-master\druid-master\processing\src\main\java\org\apache\druid\segment\data\WritableSupplier.java,0,1,0,1,0,2
 druid-master\druid-master\processing\src\main\java\org\apache\druid\segment\DoubleColumnSerializer.java,0,34,1,3,0,38
 druid-master\druid-master\server\src\test\java\org\apache\druid\discovery\DruidNodeDiscoveryProviderTest.java,0,65,1,22,0,88
 druid-master\druid-master\processing\src\main\java\org\apache\druid\query\aggregation\FloatMinAggregatorFactory.java,0,43,0,3,0,46
 druid-master\druid-master\indexing-service\src\main\java\org\apache\druid\indexing\overlord\setup\WorkerSelectUtils.java,0,41,1,30,0,72
 druid-master\druid-master\core\src\test\java\org\apache\druid\data\input\impl\NoopInputRowParserTest.java,0,8,0,3,0,11
 druid-master\druid-master\integration-tests\src\test\java\org\apache\druid\tests\hadoop\ITGcsInputToHdfsHadoopIndexTest.java,0,16,0,13,0,29
 druid-master\druid-master\core\src\main\java\org\apache\druid\indexer\Checks.java,0,29,0,8,0,37
 druid-master\druid-master\extensions-core\orc-extensions\src\main\java\org\apache\druid\data\input\orc\OrcExtensionsModule.java,0,18,0,4,0,22
 druid-master\druid-master\processing\src\test\java\org\apache\druid\query\groupby\epinephelinae\column\ArrayStringGroupByColumnSelectorStrategyTest.java,0,62,2,26,0,90
 druid-master\druid-master\indexing-service\src\test\java\org\apache\druid\indexing\common\task\batch\parallel\distribution\ArrayOfStringsNullSafeSerdeTest.java,0,20,0,4,0,24
 druid-master\druid-master\server\src\test\java\org\apache\druid\server\initialization\jetty\LimitRequestsFilterTest.java,0,23,0,2,0,25
 druid-master\druid-master\extensions-core\lookups-cached-single\src\test\java\org\apache\druid\server\lookup\jdbc\JdbcDataFetcherTest.java,0,64,0,13,0,77
 druid-master\druid-master\core\src\main\java\org\apache\druid\timeline\PruneLoadSpec.java,0,4,0,4,0,8
 druid-master\druid-master\benchmarks\src\test\java\org\apache\druid\benchmark\NullHandlingBitmapGetVsIteratorBenchmark.java,0,35,2,8,0,45
 druid-master\druid-master\processing\src\main\java\org\apache\druid\segment\filter\LikeFilter.java,0,72,0,18,0,90
 druid-master\druid-master\sql\src\main\java\org\apache\druid\sql\calcite\external\ExternalTableScanRule.java,0,14,0,5,0,19
 druid-master\druid-master\server\src\main\java\org\apache\druid\indexer\SQLMetadataStorageUpdaterJobHandler.java,0,22,2,7,0,31
 druid-master\druid-master\processing\src\main\java\org\apache\druid\segment\join\HashJoinEngine.java,0,53,0,27,0,80
 druid-master\druid-master\extensions-contrib\opentsdb-emitter\src\test\java\org\apache\druid\emitter\opentsdb\OpentsdbEventTest.java,0,9,0,2,0,11
 druid-master\druid-master\processing\src\main\java\org\apache\druid\segment\virtual\RowBasedExpressionColumnValueSelector.java,0,27,2,12,0,41
 druid-master\druid-master\extensions-core\hdfs-storage\src\main\java\org\apache\druid\guice\Hdfs.java,0,5,0,4,0,9
 druid-master\druid-master\extensions-core\kinesis-indexing-service\src\main\java\org\apache\druid\indexing\kinesis\supervisor\KinesisSupervisor.java,0,170,4,61,0,235
 druid-master\druid-master\indexing-service\src\main\java\org\apache\druid\indexing\seekablestream\supervisor\SeekableStreamSupervisor.java,0,1257,75,672,0,2004
 druid-master\druid-master\server\src\test\java\org\apache\druid\server\http\OverlordProxyServletTest.java,0,9,0,7,0,16
 druid-master\druid-master\processing\src\test\java\org\apache\druid\query\QueriesTest.java,0,36,0,9,0,45
 druid-master\druid-master\extensions-core\datasketches\src\main\java\org\apache\druid\query\aggregation\datasketches\quantiles\DoublesSketchToQuantilePostAggregator.java,0,46,0,4,0,50
 druid-master\druid-master\processing\src\test\java\org\apache\druid\query\aggregation\constant\LongConstantVectorAggregatorTest.java,0,14,0,1,0,15
 druid-master\druid-master\indexing-service\src\main\java\org\apache\druid\indexing\overlord\setup\EqualDistributionWithCategorySpecWorkerSelectStrategy.java,0,21,0,3,0,24
 druid-master\druid-master\sql\src\test\java\org\apache\druid\sql\calcite\rel\DruidRelsTest.java,0,86,17,17,0,120
 druid-master\druid-master\processing\src\main\java\org\apache\druid\segment\DimensionDictionarySelector.java,0,39,0,33,0,72
 druid-master\druid-master\sql\src\main\java\org\apache\druid\sql\SqlLifecycleFactory.java,0,18,0,1,0,19
 druid-master\druid-master\server\src\main\java\org\apache\druid\segment\indexing\RealtimeIOConfig.java,0,15,0,1,0,16
 druid-master\druid-master\indexing-service\src\main\java\org\apache\druid\indexing\seekablestream\SequenceMetadata.java,0,164,2,55,0,221
 druid-master\druid-master\processing\src\main\java\org\apache\druid\segment\selector\settable\SettableDoubleColumnValueSelector.java,0,11,0,2,0,13
 druid-master\druid-master\extensions-core\azure-extensions\src\test\java\org\apache\druid\storage\azure\AzureCloudBlobHolderToCloudObjectLocationConverterTest.java,0,14,2,5,0,21
 druid-master\druid-master\processing\src\main\java\org\apache\druid\segment\RowWalker.java,0,30,0,4,0,34
 druid-master\druid-master\extensions-contrib\aliyun-oss-extensions\src\main\java\org\apache\druid\storage\aliyun\OssDataSegmentArchiverConfig.java,0,9,0,1,0,10
 druid-master\druid-master\processing\src\test\java\org\apache\druid\query\aggregation\MetricManipulatorFnsTest.java,0,45,0,8,0,53
 druid-master\druid-master\processing\src\main\java\org\apache\druid\query\aggregation\constant\LongConstantAggregator.java,0,17,1,3,0,21
 druid-master\druid-master\extensions-core\kubernetes-extensions\src\test\java\org\apache\druid\k8s\discovery\K8sDiscoveryConfigTest.java,0,15,0,4,0,19
 druid-master\druid-master\extensions-core\datasketches\src\main\java\org\apache\druid\query\aggregation\datasketches\tuple\ArrayOfDoublesSketchBuildComplexMetricSerde.java,0,4,0,2,0,6
 druid-master\druid-master\server\src\test\java\org\apache\druid\server\coordinator\UserCompactionTaskDimensionsConfigTest.java,0,12,1,6,0,19
 druid-master\druid-master\benchmarks\src\test\java\org\apache\druid\benchmark\MockBitmapIndexSelector.java,0,34,0,1,0,35
 druid-master\druid-master\extensions-core\kafka-indexing-service\src\main\java\org\apache\druid\indexing\kafka\supervisor\KafkaSupervisorSpec.java,0,46,0,6,0,52
 druid-master\druid-master\core\src\main\java\org\apache\druid\java\util\common\io\smoosh\Smoosh.java,0,5,1,1,0,7
 druid-master\druid-master\core\src\test\java\org\apache\druid\data\input\impl\FileIteratingFirehoseTest.java,0,31,2,6,2,41
 druid-master\druid-master\core\src\test\java\org\apache\druid\data\input\impl\LocalInputSourceTest.java,0,60,0,28,0,88
 druid-master\druid-master\extensions-core\azure-extensions\src\main\java\org\apache\druid\storage\azure\AzureStorageDruidModule.java,0,34,2,13,0,49
 druid-master\druid-master\indexing-service\src\test\java\org\apache\druid\indexing\common\TestFirehose.java,0,29,0,6,0,35
 druid-master\druid-master\core\src\main\java\org\apache\druid\java\util\common\parsers\JSONToLowerParser.java,0,39,2,13,1,55
 druid-master\druid-master\extensions-contrib\prometheus-emitter\src\main\java\org\apache\druid\emitter\prometheus\PrometheusEmitterModule.java,0,12,0,2,0,14
 druid-master\druid-master\server\src\main\java\org\apache\druid\server\security\AuthenticationOnlyResourceFilter.java,0,12,2,4,0,18
 druid-master\druid-master\server\src\main\java\org\apache\druid\client\FilteredServerInventoryViewProvider.java,0,5,0,5,0,10
 druid-master\druid-master\processing\src\main\java\org\apache\druid\segment\IdLookup.java,0,3,0,1,0,4
 druid-master\druid-master\core\src\main\java\org\apache\druid\concurrent\Threads.java,0,14,0,8,0,22
 druid-master\druid-master\hll\src\test\java\org\apache\druid\hll\HyperLogLogCollectorTest.java,0,275,6,101,13,395
 druid-master\druid-master\processing\src\main\java\org\apache\druid\query\aggregation\last\LongLastAggregator.java,0,19,0,3,0,22
 druid-master\druid-master\processing\src\test\java\org\apache\druid\query\groupby\epinephelinae\BufferArrayGrouperTest.java,0,30,0,7,0,37
 druid-master\druid-master\extensions-core\datasketches\src\test\java\org\apache\druid\query\aggregation\datasketches\theta\SketchAggregationTest.java,0,165,0,57,0,222
 druid-master\druid-master\server\src\main\java\org\apache\druid\segment\realtime\appenderator\BatchAppenderator.java,0,290,19,115,0,424
 druid-master\druid-master\core\src\main\java\org\apache\druid\collections\CombiningIterator.java,0,24,0,1,0,25
 druid-master\druid-master\indexing-service\src\main\java\org\apache\druid\indexing\common\task\batch\parallel\SinglePhaseSubTask.java,0,146,4,63,0,213
 druid-master\druid-master\server\src\main\java\org\apache\druid\metadata\MetadataSegmentPublisherProvider.java,0,2,0,2,0,4
 druid-master\druid-master\sql\src\main\java\org\apache\druid\sql\calcite\table\DruidTable.java,0,51,0,5,0,56
 druid-master\druid-master\processing\src\main\java\org\apache\druid\query\aggregation\NullableNumericBufferAggregator.java,0,51,0,13,0,64
 druid-master\druid-master\core\src\test\java\org\apache\druid\java\util\emitter\core\GoHandler.java,0,21,2,2,0,25
 druid-master\druid-master\processing\src\test\java\org\apache\druid\query\groupby\epinephelinae\column\StringGroupByColumnSelectorStrategyTest.java,0,33,0,15,0,48
 druid-master\druid-master\indexing-service\src\main\java\org\apache\druid\indexing\common\MultipleFileTaskReportFileWriter.java,0,24,0,2,0,26
 druid-master\druid-master\processing\src\test\java\org\apache\druid\segment\IndexMergerTestBase.java,0,839,6,439,0,1284
 druid-master\druid-master\server\src\main\java\org\apache\druid\server\http\HttpMediaType.java,0,4,0,2,0,6
 druid-master\druid-master\core\src\main\java\org\apache\druid\guice\ManageLifecycleInit.java,0,3,0,3,0,6
 druid-master\druid-master\processing\src\test\java\org\apache\druid\query\UnionDataSourceTest.java,0,47,12,8,0,67
 druid-master\druid-master\integration-tests\src\test\java\org\apache\druid\tests\indexer\ITNestedQueryPushDownTest.java,0,25,2,7,0,34
 druid-master\druid-master\benchmarks\src\test\java\org\apache\druid\benchmark\sequences\MergeSequenceBenchmark.java,0,21,0,4,0,25
 druid-master\druid-master\processing\src\main\java\org\apache\druid\segment\virtual\SingleInputBindings.java,0,16,0,1,0,17
 druid-master\druid-master\indexing-service\src\main\java\org\apache\druid\indexing\overlord\CriticalAction.java,0,39,0,8,0,47
 druid-master\druid-master\extensions-core\avro-extensions\src\test\java\org\apache\druid\data\input\avro\InlineSchemasAvroBytesDecoderTest.java,0,11,0,4,0,15
 druid-master\druid-master\processing\src\test\java\org\apache\druid\query\timeseries\DefaultTimeseriesQueryMetricsTest.java,0,18,0,13,0,31
 druid-master\druid-master\processing\src\main\java\org\apache\druid\collections\bitmap\WrappedImmutableRoaringBitmap.java,0,33,0,4,0,37
 druid-master\druid-master\core\src\main\java\org\apache\druid\indexer\MetadataStorageUpdaterJobHandler.java,0,3,0,2,0,5
 druid-master\druid-master\processing\src\test\java\org\apache\druid\query\filter\SelectorDimFilterTest.java,0,25,0,15,0,40
 druid-master\druid-master\indexing-service\src\main\java\org\apache\druid\indexing\seekablestream\SeekableStreamIndexTaskClientFactory.java,0,14,0,2,0,16
 druid-master\druid-master\core\src\main\java\org\apache\druid\guice\ConfigProvider.java,0,41,0,5,1,47
 druid-master\druid-master\extensions-contrib\prometheus-emitter\src\main\java\org\apache\druid\emitter\prometheus\PrometheusEmitterConfig.java,0,39,0,3,0,42
 druid-master\druid-master\server\src\main\java\org\apache\druid\segment\realtime\plumber\NoopSegmentHandoffNotifierFactory.java,0,19,2,6,0,27
 druid-master\druid-master\core\src\main\java\org\apache\druid\data\input\impl\RegexParseSpec.java,0,34,0,4,2,40
 druid-master\druid-master\processing\src\test\java\org\apache\druid\query\expression\TestExprMacroTable.java,0,4,1,1,0,6
 druid-master\druid-master\extensions-contrib\redis-cache\src\main\java\org\apache\druid\client\cache\RedisStandaloneCache.java,0,21,0,3,0,24
 druid-master\druid-master\core\src\main\java\org\apache\druid\java\util\emitter\service\AlertBuilder.java,0,47,0,4,0,51
 druid-master\druid-master\server\src\test\java\org\apache\druid\client\BrokerSegmentWatcherConfigTest.java,0,8,0,5,0,13
 druid-master\druid-master\core\src\test\java\org\apache\druid\testing\junit\LoggerCaptureRule.java,0,32,0,4,3,39
 druid-master\druid-master\server\src\main\java\org\apache\druid\segment\realtime\appenderator\SegmentNotWritableException.java,0,5,0,1,0,6
 druid-master\druid-master\server\src\test\java\org\apache\druid\segment\realtime\appenderator\DefaultOfflineAppenderatorFactoryTest.java,0,33,0,13,0,46
 druid-master\druid-master\processing\src\main\java\org\apache\druid\segment\column\ObjectStrategyComplexTypeStrategy.java,0,30,0,7,0,37
 druid-master\druid-master\extensions-contrib\sqlserver-metadata-storage\src\main\java\org\apache\druid\metadata\storage\sqlserver\SQLServerMetadataStorageModule.java,0,11,0,3,0,14
 druid-master\druid-master\processing\src\main\java\org\apache\druid\query\QueryWatcher.java,0,6,0,6,0,12
 druid-master\druid-master\extensions-core\lookups-cached-single\src\test\java\org\apache\druid\server\lookup\jdbc\JdbcDataFetcherUrlCheckTest.java,0,108,0,17,0,125
 druid-master\druid-master\processing\src\test\java\org\apache\druid\query\aggregation\cardinality\CardinalityVectorAggregatorTest.java,0,74,0,27,0,101
 druid-master\druid-master\server\src\test\java\org\apache\druid\server\coordinator\TestDruidCoordinatorConfig.java,0,147,0,10,0,157
 druid-master\druid-master\core\src\test\java\org\apache\druid\java\util\common\parsers\RegexParserTest.java,0,22,2,12,0,36
 druid-master\druid-master\processing\src\test\java\org\apache\druid\segment\filter\FloatAndDoubleFilteringTest.java,0,84,0,34,0,118
 druid-master\druid-master\processing\src\test\java\org\apache\druid\segment\WrappingDimensionSelectorTest.java,0,31,0,7,0,38
 druid-master\druid-master\extensions-core\druid-pac4j\src\main\java\org\apache\druid\security\pac4j\Pac4jSessionStore.java,0,50,1,6,0,57
 druid-master\druid-master\extensions-contrib\ambari-metrics-emitter\src\main\java\org\apache\druid\emitter\ambari\metrics\DruidToTimelineMetricConverter.java,0,7,0,7,0,14
 druid-master\druid-master\server\src\main\java\org\apache\druid\indexing\overlord\supervisor\NoopSupervisorSpec.java,0,65,7,6,0,78
 druid-master\druid-master\extensions-core\lookups-cached-single\src\main\java\org\apache\druid\server\lookup\cache\loading\OnHeapLoadingCache.java,0,73,1,15,0,89
 druid-master\druid-master\services\src\main\java\org\apache\druid\cli\CliBroker.java,0,35,0,18,0,53
 druid-master\druid-master\sql\src\main\java\org\apache\druid\sql\calcite\view\NoopViewManager.java,0,15,0,6,0,21
 druid-master\druid-master\server\src\test\java\org\apache\druid\segment\loading\CacheTestSegmentLoader.java,0,16,3,3,0,22
 druid-master\druid-master\integration-tests\src\test\java\org\apache\druid\tests\indexer\ITCompactionTaskTest.java,0,110,5,51,0,166
 druid-master\druid-master\processing\src\main\java\org\apache\druid\query\topn\types\TopNColumnAggregatesProcessor.java,0,31,1,23,0,55
 druid-master\druid-master\core\src\main\java\org\apache\druid\indexer\partitions\SecondaryPartitionType.java,0,6,0,6,0,12
 druid-master\druid-master\extensions-core\datasketches\src\main\java\org\apache\druid\query\aggregation\datasketches\tuple\ArrayOfDoublesSketchToNumEntriesPostAggregator.java,0,16,0,5,0,21
 druid-master\druid-master\sql\src\main\java\org\apache\druid\sql\calcite\filtration\ValidateNoMarkerFiltersRemain.java,0,11,1,4,3,19
 druid-master\druid-master\extensions-core\google-extensions\src\main\java\org\apache\druid\storage\google\GoogleStorage.java,0,44,1,12,0,57
 druid-master\druid-master\server\src\main\java\org\apache\druid\segment\realtime\firehose\IngestSegmentFirehose.java,0,47,0,24,0,71
 druid-master\druid-master\processing\src\test\java\org\apache\druid\collections\bitmap\BitmapIterationTest.java,0,42,1,10,0,53
 druid-master\druid-master\processing\src\test\java\org\apache\druid\segment\data\BitmapCreationBenchmark.java,0,54,1,5,0,60
 druid-master\druid-master\server\src\main\java\org\apache\druid\segment\realtime\appenderator\SegmentAllocator.java,0,10,0,10,0,20
 druid-master\druid-master\processing\src\main\java\org\apache\druid\query\aggregation\StringColumnFloatAggregatorWrapper.java,0,14,0,3,0,17
 druid-master\druid-master\extensions-contrib\distinctcount\src\main\java\org\apache\druid\query\aggregation\distinctcount\ConciseBitMapFactory.java,0,14,2,2,0,18
 druid-master\druid-master\extensions-core\parquet-extensions\src\main\java\org\apache\druid\data\input\parquet\avro\ParquetAvroHadoopInputRowParser.java,0,38,0,10,0,48
 druid-master\druid-master\server\src\main\java\org\apache\druid\curator\ZkEnablementConfig.java,0,15,2,2,0,19
 druid-master\druid-master\processing\src\test\java\org\apache\druid\segment\filter\ExpressionFilterStrictBooleansTest.java,0,9,0,1,0,10
 druid-master\druid-master\server\src\main\java\org\apache\druid\server\http\BrokerResource.java,0,14,0,2,0,16
 druid-master\druid-master\integration-tests\src\test\java\org\apache\druid\tests\query\ITBroadcastJoinQueryTest.java,0,41,0,14,0,55
 druid-master\druid-master\core\src\main\java\org\apache\druid\java\util\common\guava\DelegatingYieldingAccumulator.java,0,19,1,2,0,22
 druid-master\druid-master\indexing-service\src\main\java\org\apache\druid\indexing\overlord\sampler\SamplerConfig.java,0,22,0,7,0,29
 druid-master\druid-master\services\src\main\java\org\apache\druid\server\AsyncQueryForwardingServlet.java,0,226,6,63,0,295
 druid-master\druid-master\indexing-service\src\test\java\org\apache\druid\indexing\firehose\IngestSegmentFirehoseFactoryTest.java,0,131,8,37,0,176
 druid-master\druid-master\core\src\main\java\org\apache\druid\math\expr\ExpressionProcessing.java,0,35,1,13,0,49
 druid-master\druid-master\extensions-core\hdfs-storage\src\main\java\org\apache\druid\storage\hdfs\HdfsDataSegmentKiller.java,0,39,2,16,0,57
 druid-master\druid-master\core\src\main\java\org\apache\druid\java\util\emitter\core\BatchingStrategy.java,0,43,0,1,0,44
 druid-master\druid-master\server\src\main\java\org\apache\druid\metadata\MetadataStorageProvider.java,0,1,0,1,0,2
 druid-master\druid-master\server\src\main\java\org\apache\druid\segment\indexing\granularity\UniformGranularitySpec.java,0,54,1,8,0,63
 druid-master\druid-master\processing\src\main\java\org\apache\druid\segment\historical\HistoricalColumnSelector.java,0,3,0,1,0,4
 druid-master\druid-master\extensions-contrib\moving-average-query\src\main\java\org\apache\druid\query\movingaverage\averagers\ConstantAverager.java,0,19,2,3,0,24
 druid-master\druid-master\core\src\main\java\org\apache\druid\math\expr\vector\LongOutStringsInFunctionVectorProcessor.java,0,20,0,3,0,23
 druid-master\druid-master\server\src\main\java\org\apache\druid\metadata\MetadataRuleManager.java,0,10,0,3,0,13
 druid-master\druid-master\processing\src\test\java\org\apache\druid\query\timeboundary\TimeBoundaryQueryTest.java,0,10,1,3,0,14
 druid-master\druid-master\processing\src\main\java\org\apache\druid\segment\selector\settable\SettableDimensionValueSelector.java,0,28,0,2,0,30
 druid-master\druid-master\extensions-core\datasketches\src\main\java\org\apache\druid\query\aggregation\datasketches\theta\oldapi\OldSketchMergeAggregatorFactory.java,0,8,0,3,0,11
 druid-master\druid-master\processing\src\main\java\org\apache\druid\query\lookup\LookupConfig.java,0,58,0,6,0,64
 druid-master\druid-master\server\src\main\java\org\apache\druid\server\metrics\DruidMonitorSchedulerConfig.java,0,11,0,1,0,12
 druid-master\druid-master\processing\src\main\java\org\apache\druid\query\search\DefaultSearchQueryMetrics.java,0,144,0,14,0,158
 druid-master\druid-master\processing\src\main\java\org\apache\druid\query\topn\HeapBasedTopNAlgorithm.java,0,49,1,12,0,62
 druid-master\druid-master\sql\src\test\java\org\apache\druid\sql\calcite\TestQueryMakerFactory.java,0,19,0,5,0,24
 druid-master\druid-master\processing\src\test\java\org\apache\druid\segment\join\JoinPrefixUtilsTest.java,0,19,5,3,0,27
 druid-master\druid-master\core\src\main\java\org\apache\druid\data\input\impl\StringInputRowParser.java,0,54,0,6,0,60
 druid-master\druid-master\processing\src\main\java\org\apache\druid\query\spec\SpecificSegmentQueryRunner.java,0,41,0,7,0,48
 druid-master\druid-master\indexing-service\src\test\java\org\apache\druid\indexing\overlord\http\security\TaskResourceFilterTest.java,0,18,1,4,0,23
 druid-master\druid-master\processing\src\test\java\org\apache\druid\segment\join\table\SortedIntIntersectionIteratorTest.java,0,26,3,3,0,32
 druid-master\druid-master\indexing-service\src\test\java\org\apache\druid\indexing\common\task\TaskSerdeTest.java,0,108,2,61,0,171
 druid-master\druid-master\processing\src\main\java\org\apache\druid\segment\AbstractDimensionSelector.java,0,4,0,2,0,6
 druid-master\druid-master\indexing-service\src\main\java\org\apache\druid\indexing\overlord\hrtr\WorkerHolder.java,0,152,9,42,0,203
 druid-master\druid-master\sql\src\main\java\org\apache\druid\sql\calcite\expression\AuthorizableOperator.java,0,4,0,3,0,7
 druid-master\druid-master\core\src\test\java\org\apache\druid\java\util\metrics\ProcFsReaderTest.java,0,13,0,2,2,17
 druid-master\druid-master\core\src\main\java\org\apache\druid\data\input\impl\CombiningInputSource.java,0,40,0,12,2,54
 druid-master\druid-master\extensions-core\druid-aws-rds-extensions\src\test\java\org\apache\druid\aws\rds\AWSRDSTokenPasswordProviderTest.java,0,10,1,3,1,15
 druid-master\druid-master\server\src\test\java\org\apache\druid\server\coordinator\duty\KillAuditLogTest.java,0,27,0,10,0,37
 druid-master\druid-master\processing\src\main\java\org\apache\druid\query\filter\vector\SingleValueStringVectorValueMatcher.java,0,28,0,10,0,38
 druid-master\druid-master\server\src\test\java\org\apache\druid\client\indexing\ClientKillUnusedSegmentsTaskQueryTest.java,0,24,0,4,0,28
 druid-master\druid-master\server\src\main\java\org\apache\druid\server\metrics\QueryCountStatsMonitor.java,0,11,0,2,0,13
 druid-master\druid-master\processing\src\main\java\org\apache\druid\segment\data\CompressedColumnarDoublesSuppliers.java,0,9,1,1,0,11
 druid-master\druid-master\processing\src\test\java\org\apache\druid\query\timeseries\TimeseriesBinaryFnTest.java,0,27,0,2,0,29
 druid-master\druid-master\processing\src\main\java\org\apache\druid\segment\data\CompressedColumnarLongsSupplier.java,0,40,0,6,0,46
 druid-master\druid-master\indexing-service\src\main\java\org\apache\druid\indexing\overlord\setup\AffinityConfig.java,0,31,0,2,0,33
 druid-master\druid-master\integration-tests\src\test\java\org\apache\druid\tests\indexer\ITHdfsToS3ParallelIndexTest.java,0,9,0,6,0,15
 druid-master\druid-master\core\src\test\java\org\apache\druid\segment\column\TypeStrategiesTest.java,0,284,1,74,4,363
 druid-master\druid-master\core\src\main\java\org\apache\druid\concurrent\LifecycleLock.java,0,72,0,29,0,101
 druid-master\druid-master\extensions-core\avro-extensions\src\main\java\org\apache\druid\data\input\schemarepo\Avro1124RESTRepositoryClientWrapper.java,0,19,0,3,0,22
 druid-master\druid-master\processing\src\main\java\org\apache\druid\segment\incremental\IncrementalIndexRowHolder.java,0,20,0,5,0,25
 druid-master\druid-master\server\src\main\java\org\apache\druid\guice\ExpressionModule.java,0,13,0,5,0,18
 druid-master\druid-master\processing\src\main\java\org\apache\druid\query\aggregation\LongSumVectorAggregator.java,0,16,0,3,0,19
 druid-master\druid-master\core\src\main\java\org\apache\druid\data\input\impl\prefetch\Fetcher.java,0,78,2,27,2,109
 druid-master\druid-master\extensions-core\druid-basic-security\src\main\java\org\apache\druid\security\basic\authorization\endpoint\CoordinatorBasicAuthorizerResourceHandler.java,0,247,2,92,0,341
 druid-master\druid-master\server\src\test\java\org\apache\druid\metadata\input\SqlEntityTest.java,0,28,2,5,0,35
 druid-master\druid-master\processing\src\main\java\org\apache\druid\segment\virtual\ExpressionColumnValueSelector.java,0,32,0,7,0,39
 druid-master\druid-master\processing\src\main\java\org\apache\druid\query\aggregation\any\DoubleAnyVectorAggregator.java,0,20,0,2,0,22
 druid-master\druid-master\server\src\main\java\org\apache\druid\segment\realtime\FireDepartmentConfig.java,0,18,0,4,0,22
 druid-master\druid-master\extensions-core\testing-tools\src\main\java\org\apache\druid\query\expressions\SleepExprMacro.java,0,26,0,6,0,32
 druid-master\druid-master\processing\src\main\java\org\apache\druid\collections\bitmap\ImmutableBitmap.java,0,7,0,2,0,9
 druid-master\druid-master\processing\src\main\java\org\apache\druid\query\groupby\GroupByQueryHelper.java,0,48,2,16,0,66
 druid-master\druid-master\indexing-service\src\main\java\org\apache\druid\indexing\seekablestream\SeekableStreamIndexTaskRunner.java,0,537,35,269,0,841
 druid-master\druid-master\server\src\main\java\org\apache\druid\guice\CacheModule.java,0,25,0,4,0,29
 druid-master\druid-master\server\src\test\java\org\apache\druid\segment\realtime\plumber\RealtimePlumberSchoolTest.java,0,119,1,31,0,151
 druid-master\druid-master\processing\src\main\java\org\apache\druid\segment\RowBasedColumnSelectorFactory.java,0,116,2,38,0,156
 druid-master\druid-master\server\src\main\java\org\apache\druid\segment\realtime\DbSegmentPublisherConfig.java,0,3,0,1,0,4
 druid-master\druid-master\processing\src\test\java\org\apache\druid\segment\TestIndex.java,0,98,1,29,0,128
 druid-master\druid-master\processing\src\main\java\org\apache\druid\segment\TimeAndDimsIterator.java,0,13,0,11,0,24
 druid-master\druid-master\extensions-core\datasketches\src\test\java\org\apache\druid\query\aggregation\datasketches\theta\SketchSetPostAggregatorTest.java,0,29,0,10,0,39
 druid-master\druid-master\extensions-core\avro-extensions\src\test\java\org\apache\druid\data\input\avro\AvroOCFReaderTest.java,0,43,0,21,0,64
 druid-master\druid-master\processing\src\test\java\org\apache\druid\query\ChainedExecutionQueryRunnerTest.java,0,74,3,21,0,98
 druid-master\druid-master\extensions-contrib\moving-average-query\src\test\java\org\apache\druid\query\movingaverage\PostAveragerAggregatorCalculatorTest.java,0,19,0,4,0,23
 druid-master\druid-master\extensions-core\druid-kerberos\src\main\java\org\apache\druid\security\kerberos\DruidKerberosModule.java,0,5,1,1,0,7
 druid-master\druid-master\indexing-service\src\main\java\org\apache\druid\indexing\overlord\helpers\OverlordHelperManager.java,0,19,2,1,0,22
 druid-master\druid-master\processing\src\main\java\org\apache\druid\query\aggregation\PostAggregator.java,0,19,0,9,0,28
 druid-master\druid-master\core\src\main\java\org\apache\druid\metadata\MetadataStorageTablesConfig.java,0,95,0,3,0,98
 druid-master\druid-master\processing\src\test\java\org\apache\druid\query\CachingEmitter.java,0,12,3,1,0,16
 druid-master\druid-master\processing\src\test\java\org\apache\druid\segment\filter\TrueFilterTest.java,0,3,0,1,0,4
 druid-master\druid-master\processing\src\main\java\org\apache\druid\query\groupby\epinephelinae\vector\SingleValueStringGroupByVectorColumnSelector.java,0,13,0,3,0,16
 druid-master\druid-master\processing\src\test\java\org\apache\druid\query\aggregation\mean\SimpleTestIndex.java,0,20,1,4,0,25
 druid-master\druid-master\extensions-core\azure-extensions\src\test\java\org\apache\druid\storage\azure\AzureStorageDruidModuleTest.java,0,109,0,37,0,146
 druid-master\druid-master\sql\src\main\java\org\apache\druid\sql\calcite\expression\builtin\TimeExtractOperatorConversion.java,0,12,0,5,0,17
 druid-master\druid-master\processing\src\main\java\org\apache\druid\segment\MMappedIndex.java,0,82,0,1,0,83
 druid-master\druid-master\server\src\main\java\org\apache\druid\curator\inventory\CuratorInventoryManager.java,0,134,20,47,0,201
 druid-master\druid-master\integration-tests\src\main\java\org\apache\druid\testing\utils\TestQueryHelper.java,0,24,0,5,0,29
 druid-master\druid-master\server\src\main\java\org\apache\druid\segment\realtime\firehose\SqlFetcher.java,0,24,0,6,0,30
 druid-master\druid-master\processing\src\main\java\org\apache\druid\segment\join\JoinableFactory.java,0,15,0,11,0,26
 druid-master\druid-master\sql\src\main\java\org\apache\druid\sql\calcite\planner\DruidConvertletTable.java,0,33,0,15,0,48
 druid-master\druid-master\benchmarks\src\test\java\org\apache\druid\benchmark\query\SqlVsNativeBenchmark.java,0,41,3,16,0,60
 druid-master\druid-master\core\src\main\java\org\apache\druid\metadata\PasswordProvider.java,0,6,0,5,0,11
 druid-master\druid-master\extensions-core\avro-extensions\src\test\java\org\apache\druid\data\input\avro\AvroFlattenerMakerTest.java,0,70,9,37,0,116
 druid-master\druid-master\core\src\main\java\org\apache\druid\java\util\emitter\service\ServiceEventBuilder.java,0,7,0,1,0,8
 druid-master\druid-master\server\src\main\java\org\apache\druid\metadata\storage\derby\DerbyConnector.java,0,53,1,5,0,59
 druid-master\druid-master\server\src\main\java\org\apache\druid\client\indexing\ClientCompactionTaskTransformSpec.java,0,28,0,6,0,34
 druid-master\druid-master\processing\src\main\java\org\apache\druid\query\groupby\epinephelinae\BufferHashGrouper.java,0,76,1,19,0,96
 druid-master\druid-master\indexing-service\src\test\java\org\apache\druid\indexing\overlord\http\OverlordResourceTest.java,0,282,4,126,0,412
 druid-master\druid-master\server\src\test\java\org\apache\druid\server\initialization\ExternalStorageAccessSecurityModuleTest.java,0,12,0,7,0,19
 druid-master\druid-master\indexing-hadoop\src\main\java\org\apache\druid\indexer\path\MultiplePathSpec.java,0,20,1,3,0,24
 druid-master\druid-master\processing\src\main\java\org\apache\druid\query\filter\DimFilters.java,0,28,1,2,0,31
 druid-master\druid-master\processing\src\main\java\org\apache\druid\segment\filter\SelectorFilter.java,0,74,0,11,0,85
 druid-master\druid-master\server\src\main\java\org\apache\druid\server\ZkPathsModule.java,0,3,1,1,0,5
 druid-master\druid-master\extensions-contrib\kafka-emitter\src\main\java\org\apache\druid\emitter\kafka\MemoryBoundLinkedBlockingQueue.java,0,31,0,2,0,33
 druid-master\druid-master\processing\src\test\java\org\apache\druid\segment\virtual\VirtualColumnsTest.java,0,131,0,53,0,184
 druid-master\druid-master\processing\src\main\java\org\apache\druid\query\TableDataSource.java,0,32,0,1,0,33
 druid-master\druid-master\processing\src\main\java\org\apache\druid\segment\LongColumnSerializerV2.java,0,48,1,6,0,55
 druid-master\druid-master\extensions-core\datasketches\src\main\java\org\apache\druid\query\aggregation\datasketches\theta\sql\ThetaSketchApproxCountDistinctSqlAggregator.java,0,17,0,5,0,22
 druid-master\druid-master\integration-tests\src\test\java\org\apache\druid\tests\indexer\ITTestCoordinatorPausedTest.java,0,18,2,5,0,25
 druid-master\druid-master\server\src\main\java\org\apache\druid\segment\realtime\appenderator\SegmentPublisherHelper.java,0,32,0,22,0,54
 druid-master\druid-master\indexing-hadoop\src\test\java\org\apache\druid\indexer\HadoopIngestionSpecTest.java,0,48,0,18,0,66
 druid-master\druid-master\indexing-service\src\main\java\org\apache\druid\indexing\common\task\CompactionIOConfig.java,0,28,0,3,0,31
 druid-master\druid-master\server\src\main\java\org\apache\druid\segment\handoff\SegmentHandoffNotifier.java,0,5,0,4,0,9
 druid-master\druid-master\core\src\test\java\org\apache\druid\segment\SegmentUtilsTest.java,0,22,0,3,0,25
 druid-master\druid-master\server\src\test\java\org\apache\druid\segment\realtime\firehose\InlineFirehoseTest.java,0,48,0,3,0,51
 druid-master\druid-master\extensions-contrib\ambari-metrics-emitter\src\test\java\org\apache\druid\emitter\ambari\metrics\AmbariMetricsEmitterConfigTest.java,0,20,0,6,0,26
 druid-master\druid-master\processing\src\main\java\org\apache\druid\segment\data\EntireLayoutColumnarDoublesSupplier.java,0,22,1,4,0,27
 druid-master\druid-master\sql\src\main\java\org\apache\druid\sql\calcite\expression\builtin\IPv4AddressMatchOperatorConversion.java,0,12,0,5,0,17
 druid-master\druid-master\server\src\main\java\org\apache\druid\segment\realtime\plumber\RejectionPolicy.java,0,3,0,1,0,4
 druid-master\druid-master\extensions-contrib\influxdb-emitter\src\main\java\org\apache\druid\emitter\influxdb\InfluxdbEmitterConfig.java,0,105,1,14,0,120
 druid-master\druid-master\core\src\test\java\org\apache\druid\collections\CloseableStupidPool.java,0,14,0,2,0,16
 druid-master\druid-master\processing\src\test\java\org\apache\druid\query\extraction\SearchQuerySpecDimExtractionFnTest.java,0,12,0,3,0,15
 druid-master\druid-master\services\src\main\java\org\apache\druid\cli\MiddleManagerJettyServerInitializer.java,0,27,3,12,0,42
 druid-master\druid-master\extensions-core\lookups-cached-single\src\main\java\org\apache\druid\server\lookup\DataFetcher.java,0,10,0,6,0,16
 druid-master\druid-master\server\src\test\java\org\apache\druid\curator\inventory\CuratorInventoryManagerTest.java,0,86,6,14,0,106
 druid-master\druid-master\core\src\main\java\org\apache\druid\timeline\partition\TombstoneShardSpec.java,0,33,1,2,2,38
 druid-master\druid-master\core\src\main\java\org\apache\druid\data\input\impl\JSONParseSpec.java,0,48,1,6,1,56
 druid-master\druid-master\extensions-contrib\distinctcount\src\main\java\org\apache\druid\query\aggregation\distinctcount\DistinctCountAggregatorFactory.java,0,80,1,11,0,92
 druid-master\druid-master\sql\src\main\java\org\apache\druid\sql\calcite\schema\DruidSchemaCatalog.java,0,55,0,13,0,68
 druid-master\druid-master\core\target\generated-sources\antlr4\org\apache\druid\math\expr\antlr\ExprParser.java,0,1437,3,86,6,1532
 druid-master\druid-master\processing\src\main\java\org\apache\druid\segment\data\ListIndexed.java,0,23,0,1,0,24
 druid-master\druid-master\processing\src\main\java\org\apache\druid\segment\virtual\VirtualColumnCacheHelper.java,0,7,1,1,0,9
 druid-master\druid-master\processing\src\main\java\org\apache\druid\segment\data\EntireLayoutColumnarFloatsSupplier.java,0,21,1,3,0,25
 druid-master\druid-master\processing\src\test\java\org\apache\druid\segment\join\BaseHashJoinSegmentStorageAdapterTest.java,0,80,0,19,0,99
 druid-master\druid-master\processing\src\test\java\org\apache\druid\segment\serde\ComplexMetricsTest.java,0,11,0,3,0,14
 druid-master\druid-master\processing\src\main\java\org\apache\druid\query\aggregation\any\LongAnyBufferAggregator.java,0,29,0,2,0,31
 druid-master\druid-master\extensions-contrib\materialized-view-selection\src\test\java\org\apache\druid\query\materializedview\MaterializedViewQueryTest.java,0,13,0,6,0,19
 druid-master\druid-master\processing\src\test\java\org\apache\druid\query\dimension\LegacyDimensionSpecTest.java,0,7,0,3,0,10
 druid-master\druid-master\extensions-core\druid-pac4j\src\main\java\org\apache\druid\security\pac4j\OIDCConfig.java,0,23,0,3,0,26
 druid-master\druid-master\server\src\main\java\org\apache\druid\server\metrics\DruidSysMonitor.java,0,4,0,1,0,5
 druid-master\druid-master\processing\src\main\java\org\apache\druid\query\aggregation\post\FieldAccessPostAggregator.java,0,54,1,6,0,61
 druid-master\druid-master\processing\src\test\java\org\apache\druid\query\timeseries\TimeseriesQueryQueryToolChestTest.java,0,77,0,43,0,120
 druid-master\druid-master\core\src\test\java\org\apache\druid\data\input\impl\RegexParseSpecTest.java,0,6,0,3,0,9
 druid-master\druid-master\core\src\main\java\org\apache\druid\data\input\impl\NestedDataParseSpec.java,0,15,1,1,0,17
 druid-master\druid-master\processing\src\test\java\org\apache\druid\segment\virtual\ListFilteredVirtualColumnSelectorTest.java,0,60,1,32,0,93
 druid-master\druid-master\server\src\test\java\org\apache\druid\client\cache\CaffeineCacheTest.java,0,145,10,30,0,185
 druid-master\druid-master\server\src\test\java\org\apache\druid\server\coordinator\DataSourceCompactionConfigTest.java,0,118,0,72,0,190
 druid-master\druid-master\extensions-core\stats\src\main\java\org\apache\druid\query\aggregation\variance\VarianceLongVectorAggregator.java,0,33,1,4,0,38
 druid-master\druid-master\processing\src\test\java\org\apache\druid\query\context\ResponseContextTest.java,0,88,0,10,0,98
 druid-master\druid-master\processing\src\main\java\org\apache\druid\query\QueryProcessingPool.java,0,9,0,9,0,18
 druid-master\druid-master\server\src\test\java\org\apache\druid\server\http\CoordinatorResourceTest.java,0,14,0,2,0,16
 druid-master\druid-master\extensions-core\histogram\src\main\java\org\apache\druid\query\aggregation\histogram\Quantiles.java,0,42,0,1,0,43
 druid-master\druid-master\extensions-contrib\kafka-emitter\src\test\java\org\apache\druid\emitter\kafka\KafkaEmitterConfigTest.java,0,23,0,10,0,33
 druid-master\druid-master\server\src\test\java\org\apache\druid\metadata\TestSupervisorSpec.java,0,37,1,3,0,41
 druid-master\druid-master\extensions-contrib\dropwizard-emitter\src\main\java\org\apache\druid\emitter\dropwizard\DropwizardMetricSpec.java,0,26,0,1,0,27
 druid-master\druid-master\server\src\test\java\org\apache\druid\server\QueryStackTests.java,0,72,2,18,0,92
 druid-master\druid-master\core\src\main\java\org\apache\druid\data\input\impl\FloatDimensionSchema.java,0,8,0,1,0,9
 druid-master\druid-master\processing\src\main\java\org\apache\druid\query\aggregation\LongMaxAggregator.java,0,21,0,1,0,22
 druid-master\druid-master\server\src\test\java\org\apache\druid\segment\loading\LoadSpecTest.java,0,24,0,6,0,30
 druid-master\druid-master\server\src\main\java\org\apache\druid\server\security\ResourceType.java,0,19,1,5,0,25
 druid-master\druid-master\indexing-hadoop\src\main\java\org\apache\druid\indexer\hadoop\DatasourceInputFormat.java,0,71,4,22,0,97
 druid-master\druid-master\indexing-hadoop\src\test\java\org\apache\druid\indexer\path\MultiplePathSpecTest.java,0,7,0,3,0,10
 druid-master\druid-master\processing\src\test\java\org\apache\druid\query\groupby\epinephelinae\StreamingMergeSortedGrouperTest.java,0,62,0,22,0,84
 druid-master\druid-master\server\src\main\java\org\apache\druid\segment\loading\MostAvailableSizeStorageLocationSelectorStrategy.java,0,16,0,5,0,21
 druid-master\druid-master\server\src\test\java\org\apache\druid\query\QueryRunnerBasedOnClusteredClientTestBase.java,0,74,0,16,0,90
 druid-master\druid-master\extensions-contrib\redis-cache\src\test\java\org\apache\druid\client\cache\RedisStandaloneCacheTest.java,0,63,0,12,0,75
 druid-master\druid-master\indexing-service\src\test\java\org\apache\druid\indexing\overlord\setup\JavaScriptWorkerSelectStrategyTest.java,0,41,11,15,0,67
 druid-master\druid-master\services\src\main\java\org\apache\druid\cli\convert\DatabasePropertiesConverter.java,0,22,0,8,0,30
 druid-master\druid-master\server\src\main\java\org\apache\druid\server\BrokerQueryResource.java,0,26,0,5,0,31
 druid-master\druid-master\processing\src\main\java\org\apache\druid\guice\PropertiesModule.java,0,21,1,7,0,29
 druid-master\druid-master\server\src\main\java\org\apache\druid\server\http\ServersResource.java,0,54,0,16,0,70
 druid-master\druid-master\processing\src\main\java\org\apache\druid\query\aggregation\NullableNumericAggregatorFactory.java,0,53,0,29,0,82
 druid-master\druid-master\extensions-core\stats\src\main\java\org\apache\druid\query\aggregation\variance\VarianceObjectVectorAggregator.java,0,35,0,8,0,43
 druid-master\druid-master\server\src\main\java\org\apache\druid\server\initialization\jetty\ServiceUnavailableException.java,0,5,0,2,0,7
 druid-master\druid-master\integration-tests\src\test\java\org\apache\druid\tests\indexer\AbstractITBatchIndexTest.java,0,156,2,51,0,209
 druid-master\druid-master\server\src\main\java\org\apache\druid\guice\annotations\CoordinatorIndexingServiceDuty.java,0,1,0,1,0,2
 druid-master\druid-master\core\src\test\java\org\apache\druid\data\input\impl\JSONLowercaseParseSpecTest.java,0,5,0,3,0,8
 druid-master\druid-master\extensions-core\datasketches\src\main\java\org\apache\druid\query\aggregation\datasketches\hll\sql\HllSketchApproxCountDistinctSqlAggregator.java,0,20,0,8,0,28
 druid-master\druid-master\processing\src\main\java\org\apache\druid\query\topn\DefaultTopNQueryMetrics.java,0,37,0,4,0,41
 druid-master\druid-master\core\src\main\java\org\apache\druid\java\util\common\HumanReadableBytesSerializer.java,0,11,0,3,0,14
 druid-master\druid-master\server\src\main\java\org\apache\druid\client\cache\CaffeineCacheConfig.java,0,18,0,2,0,20
 druid-master\druid-master\core\src\test\java\org\apache\druid\math\expr\SettableObjectBindingTest.java,0,5,0,2,0,7
 druid-master\druid-master\processing\src\main\java\org\apache\druid\query\PerSegmentOptimizingQueryRunner.java,0,15,0,5,0,20
 druid-master\druid-master\indexing-service\src\test\java\org\apache\druid\indexing\common\actions\RemoteTaskActionClientTest.java,0,22,0,12,0,34
 druid-master\druid-master\core\src\main\java\org\apache\druid\java\util\metrics\FeedDefiningMonitor.java,0,10,0,1,0,11
 druid-master\druid-master\extensions-core\kinesis-indexing-service\src\main\java\org\apache\druid\indexing\kinesis\KinesisRegion.java,0,31,0,4,0,35
 druid-master\druid-master\processing\src\test\java\org\apache\druid\segment\TestLongColumnSelector.java,0,3,0,1,0,4
 druid-master\druid-master\core\src\main\java\org\apache\druid\math\expr\ExprEval.java,0,317,12,70,3,402
 druid-master\druid-master\extensions-core\histogram\src\test\java\org\apache\druid\query\aggregation\histogram\FixedBucketsHistogramVectorAggregatorTest.java,0,100,2,29,0,131
 druid-master\druid-master\server\src\main\java\org\apache\druid\server\coordinator\CoordinatorStats.java,0,96,0,19,0,115
 druid-master\druid-master\processing\src\main\java\org\apache\druid\query\scan\ScanQueryLimitRowIterator.java,0,43,0,21,0,64
 druid-master\druid-master\processing\src\main\java\org\apache\druid\query\timeseries\TimeseriesQueryEngine.java,0,38,2,23,0,63
 druid-master\druid-master\extensions-core\google-extensions\src\main\java\org\apache\druid\storage\google\GoogleStorageDruidModule.java,0,29,0,7,0,36
 druid-master\druid-master\extensions-contrib\dropwizard-emitter\src\main\java\org\apache\druid\emitter\dropwizard\DropwizardConverter.java,0,31,1,7,0,39
 druid-master\druid-master\extensions-contrib\cloudfiles-extensions\src\main\java\org\apache\druid\storage\cloudfiles\CloudFilesLoadSpec.java,0,21,0,4,0,25
 druid-master\druid-master\processing\src\main\java\org\apache\druid\query\groupby\epinephelinae\column\GroupByColumnSelectorPlus.java,0,15,0,2,0,17
 druid-master\druid-master\extensions-core\hdfs-storage\src\main\java\org\apache\druid\inputsource\hdfs\HdfsInputSource.java,0,104,0,27,0,131
 druid-master\druid-master\server\src\test\java\org\apache\druid\client\CachingQueryRunnerTest.java,0,105,4,22,0,131
 druid-master\druid-master\processing\src\test\java\org\apache\druid\query\aggregation\first\StringFirstBufferAggregatorTest.java,0,41,11,22,0,74
 druid-master\druid-master\core\src\test\java\org\apache\druid\java\util\emitter\core\EmitterTest.java,0,143,0,39,3,185
 druid-master\druid-master\server\src\main\java\org\apache\druid\client\cache\ByteCountingLRUMap.java,0,28,1,2,0,31
 druid-master\druid-master\extensions-core\datasketches\src\test\java\org\apache\druid\query\aggregation\datasketches\hll\HllSketchAggregatorFactoryTest.java,0,85,0,20,0,105
 druid-master\druid-master\integration-tests\src\test\java\org\apache\druid\tests\indexer\AbstractITRealtimeIndexTaskTest.java,0,64,5,25,0,94
 druid-master\druid-master\indexing-service\src\main\java\org\apache\druid\indexing\overlord\sampler\SamplerModule.java,0,6,0,1,0,7
 druid-master\druid-master\sql\src\test\java\org\apache\druid\sql\calcite\rel\DruidQueryTest.java,0,65,8,15,0,88
 druid-master\druid-master\benchmarks\src\test\java\org\apache\druid\benchmark\IncrementalIndexRowTypeBenchmark.java,0,43,3,2,0,48
 druid-master\druid-master\core\src\main\java\org\apache\druid\java\util\http\client\response\BytesFullResponseHolder.java,0,11,0,1,0,12
 druid-master\druid-master\processing\src\test\java\org\apache\druid\query\lookup\LookupExtractionFnTest.java,0,32,0,10,0,42
 druid-master\druid-master\server\src\main\java\org\apache\druid\server\coordinator\CompactionStatistics.java,0,35,0,1,0,36
 druid-master\druid-master\extensions-contrib\virtual-columns\src\test\java\org\apache\druid\segment\MapVirtualColumnGroupByTest.java,0,30,0,11,0,41
 druid-master\druid-master\extensions-core\orc-extensions\src\main\java\org\apache\druid\data\input\orc\OrcReader.java,0,47,0,13,0,60
 druid-master\druid-master\processing\src\main\java\org\apache\druid\segment\BitmapOffset.java,0,84,4,34,0,122
 druid-master\druid-master\indexing-service\src\test\java\org\apache\druid\indexing\common\task\batch\parallel\RangePartitionTaskKillTest.java,0,82,0,19,0,101
 druid-master\druid-master\core\src\main\java\org\apache\druid\data\input\SegmentsSplitHintSpec.java,0,45,0,14,0,59
 druid-master\druid-master\extensions-contrib\tdigestsketch\src\test\java\org\apache\druid\query\aggregation\tdigestsketch\TDigestSketchAggregatorTest.java,0,64,0,28,0,92
 druid-master\druid-master\extensions-core\datasketches\src\main\java\org\apache\druid\query\aggregation\datasketches\quantiles\DoublesSketchMergeBufferAggregatorHelper.java,0,45,0,14,0,59
 druid-master\druid-master\indexing-service\src\main\java\org\apache\druid\guice\IndexingServiceTuningConfigModule.java,0,8,1,5,0,14
 druid-master\druid-master\processing\src\test\java\org\apache\druid\segment\join\HashJoinSegmentTest.java,0,62,6,11,0,79
 druid-master\druid-master\integration-tests\src\main\java\org\apache\druid\testing\clients\OverlordResourceTestClient.java,0,198,5,23,0,226
 druid-master\druid-master\indexing-service\src\main\java\org\apache\druid\indexing\overlord\hrtr\HttpRemoteTaskRunnerFactory.java,0,29,0,5,0,34
 druid-master\druid-master\core\src\main\java\org\apache\druid\java\util\http\client\pool\ChannelResourceFactory.java,0,74,0,22,0,96
 druid-master\druid-master\services\src\test\java\org\apache\druid\server\router\QueryHostFinderTest.java,0,17,1,3,0,21
 druid-master\druid-master\processing\src\main\java\org\apache\druid\jackson\GranularityModule.java,0,5,0,2,0,7
 druid-master\druid-master\server\src\main\java\org\apache\druid\server\coordination\DataSegmentServerAnnouncer.java,0,10,2,5,0,17
 druid-master\druid-master\core\src\main\java\org\apache\druid\data\input\InputRow.java,0,4,0,4,0,8
 druid-master\druid-master\extensions-core\mysql-metadata-storage\src\test\java\org\apache\druid\metadata\storage\mysql\MySQLConnectorTest.java,0,30,0,16,0,46
 druid-master\druid-master\server\src\test\java\org\apache\druid\query\lookup\MapLookupExtractorFactoryTest.java,0,17,0,8,0,25
 druid-master\druid-master\indexing-service\src\test\java\org\apache\druid\indexing\common\task\batch\parallel\distribution\StringSketchTest.java,0,110,0,30,0,140
 druid-master\druid-master\core\src\main\java\org\apache\druid\data\input\ColumnsFilter.java,0,53,0,4,1,58
 druid-master\druid-master\server\src\main\java\org\apache\druid\client\indexing\IndexingServiceClient.java,0,24,0,9,0,33
 druid-master\druid-master\extensions-core\orc-extensions\src\main\java\org\apache\druid\data\input\orc\OrcStructJsonProvider.java,0,43,0,5,0,48
 druid-master\druid-master\core\src\test\java\org\apache\druid\common\guava\ComplexSequenceTest.java,0,28,0,3,1,32
 druid-master\druid-master\processing\src\main\java\org\apache\druid\query\aggregation\LongAggregateCombiner.java,0,2,1,2,0,5
 druid-master\druid-master\processing\src\main\java\org\apache\druid\segment\column\UnknownTypeComplexColumn.java,0,22,1,3,0,26
 druid-master\druid-master\processing\src\test\java\org\apache\druid\query\aggregation\post\DoubleLeastPostAggregatorTest.java,0,13,0,3,0,16
 druid-master\druid-master\indexing-service\src\main\java\org\apache\druid\indexing\common\task\batch\parallel\PartialSegmentMergeTask.java,0,80,0,32,0,112
 druid-master\druid-master\server\src\main\java\org\apache\druid\client\coordinator\CoordinatorSelectorConfig.java,0,6,0,1,0,7
 druid-master\druid-master\processing\src\main\java\org\apache\druid\segment\serde\FloatNumericColumnPartSerdeV2.java,0,58,0,10,0,68
 druid-master\druid-master\extensions-core\lookups-cached-global\src\main\java\org\apache\druid\query\lookup\namespace\JdbcExtractionNamespace.java,0,91,4,16,0,111
 druid-master\druid-master\server\src\main\java\org\apache\druid\server\coordinator\DruidCoordinatorRuntimeParams.java,0,231,6,23,0,260
 druid-master\druid-master\processing\src\main\java\org\apache\druid\query\UnionQueryRunner.java,0,27,0,15,0,42
 druid-master\druid-master\indexing-service\src\test\java\org\apache\druid\indexing\common\task\RangePartitionCachingLocalSegmentAllocatorTest.java,0,87,1,22,0,110
 druid-master\druid-master\extensions-core\mysql-metadata-storage\src\main\java\org\apache\druid\firehose\sql\MySQLFirehoseDatabaseConnector.java,0,35,0,6,0,41
 druid-master\druid-master\indexing-service\src\main\java\org\apache\druid\indexing\common\task\batch\parallel\DeepStoragePartitionLocation.java,0,39,0,2,0,41
 druid-master\druid-master\core\src\main\java\org\apache\druid\java\util\common\guava\Comparators.java,0,35,1,8,0,44
 druid-master\druid-master\indexing-service\src\main\java\org\apache\druid\indexing\common\task\batch\parallel\DimensionDistributionReport.java,0,28,0,3,0,31
 druid-master\druid-master\server\src\main\java\org\apache\druid\client\cache\HybridCacheProvider.java,0,17,0,5,0,22
 druid-master\druid-master\extensions-core\protobuf-extensions\src\main\java\org\apache\druid\data\input\protobuf\ProtobufReader.java,0,39,0,12,0,51
 druid-master\druid-master\processing\src\test\java\org\apache\druid\collections\spatial\search\RectangularBoundTest.java,0,14,0,9,0,23
 druid-master\druid-master\extensions-contrib\prometheus-emitter\src\main\java\org\apache\druid\emitter\prometheus\Metrics.java,0,62,1,6,0,69
 druid-master\druid-master\sql\src\test\java\org\apache\druid\sql\calcite\CalciteArraysQueryTest.java,0,379,0,207,0,586
 druid-master\druid-master\processing\src\test\java\org\apache\druid\segment\MetadataTest.java,0,7,0,3,0,10
 druid-master\druid-master\core\src\test\java\org\apache\druid\math\expr\EvalTest.java,0,221,18,81,0,320
 druid-master\druid-master\integration-tests\src\test\java\org\apache\druid\tests\security\ITBasicAuthConfigurationTest.java,0,53,2,15,0,70
 druid-master\druid-master\extensions-contrib\dropwizard-emitter\src\test\java\org\apache\druid\emitter\dropwizard\DropwizardEmitterConfigTest.java,0,19,0,10,0,29
 druid-master\druid-master\extensions-contrib\cloudfiles-extensions\src\main\java\org\apache\druid\storage\cloudfiles\CloudFilesStorageDruidModule.java,0,26,0,10,0,36
 druid-master\druid-master\processing\src\test\java\org\apache\druid\query\aggregation\TestObjectColumnSelector.java,0,16,0,2,0,18
 druid-master\druid-master\indexing-service\src\main\java\org\apache\druid\indexing\overlord\TaskLockbox.java,0,308,14,140,0,462
 druid-master\druid-master\extensions-core\kinesis-indexing-service\src\main\java\org\apache\druid\indexing\kinesis\KinesisIndexTaskIOConfig.java,0,122,0,23,0,145
 druid-master\druid-master\processing\src\main\java\org\apache\druid\query\aggregation\hyperloglog\package-info.java,0,1,0,1,0,2
 druid-master\druid-master\processing\src\main\java\org\apache\druid\segment\vector\VectorColumnSelectorFactory.java,0,46,0,35,0,81
 druid-master\druid-master\extensions-contrib\moving-average-query\src\test\java\org\apache\druid\query\movingaverage\test\TestConfig.java,0,8,0,1,0,9
 druid-master\druid-master\extensions-contrib\materialized-view-selection\src\test\java\org\apache\druid\query\materializedview\MaterializedViewUtilsTest.java,0,162,0,22,0,184
 druid-master\druid-master\core\src\main\java\org\apache\druid\data\input\impl\InputEntityIteratingReader.java,0,40,0,9,0,49
 druid-master\druid-master\processing\src\main\java\org\apache\druid\segment\filter\SearchQueryFilter.java,0,32,0,2,0,34
 druid-master\druid-master\processing\src\main\java\org\apache\druid\query\aggregation\last\FloatLastBufferAggregator.java,0,31,0,3,0,34
 druid-master\druid-master\server\src\test\java\org\apache\druid\guice\BrokerProcessingModuleTest.java,0,34,2,7,0,43
 druid-master\druid-master\core\src\main\java\org\apache\druid\java\util\http\client\response\HttpResponseHandler.java,0,26,2,22,0,50
 druid-master\druid-master\server\src\main\java\org\apache\druid\server\http\InventoryViewUtils.java,0,12,0,6,0,18
 druid-master\druid-master\processing\src\main\java\org\apache\druid\segment\virtual\ExpressionVectorSelectors.java,0,35,3,18,0,56
 druid-master\druid-master\server\src\main\java\org\apache\druid\server\coordinator\cost\ClusterCostCache.java,0,41,0,8,0,49
 druid-master\druid-master\core\src\test\java\org\apache\druid\timeline\partition\NumberedPartialShardSpecTest.java,0,10,0,5,0,15
 druid-master\druid-master\server\src\main\java\org\apache\druid\server\emitter\HttpEmittingMonitor.java,0,11,0,3,0,14
 druid-master\druid-master\processing\src\main\java\org\apache\druid\query\filter\vector\ObjectVectorValueMatcher.java,0,22,0,8,0,30
 druid-master\druid-master\processing\src\main\java\org\apache\druid\query\BySegmentResultValueClass.java,0,46,1,12,0,59
 druid-master\druid-master\server\src\main\java\org\apache\druid\segment\loading\SegmentLocalCacheManager.java,0,146,6,54,0,206
 druid-master\druid-master\sql\src\test\java\org\apache\druid\sql\calcite\schema\SystemSchemaTest.java,0,377,5,150,0,532
 druid-master\druid-master\core\src\main\java\org\apache\druid\java\util\common\URIs.java,0,6,0,1,0,7
 druid-master\druid-master\processing\src\main\java\org\apache\druid\query\topn\AlphaNumericTopNMetricSpec.java,0,23,0,5,0,28
 druid-master\druid-master\processing\src\test\java\org\apache\druid\query\aggregation\any\StringAnyAggregatorFactoryTest.java,0,35,0,14,0,49
 druid-master\druid-master\server\src\main\java\org\apache\druid\server\log\SwitchingRequestLoggerProvider.java,0,34,0,4,0,38
 druid-master\druid-master\server\src\main\java\org\apache\druid\metadata\SQLMetadataSupervisorManager.java,0,102,1,21,0,124
 druid-master\druid-master\indexing-hadoop\src\main\java\org\apache\druid\indexer\updater\MetadataStorageUpdaterJobSpec.java,0,28,0,3,0,31
 druid-master\druid-master\processing\src\test\java\org\apache\druid\segment\TestObjectColumnSelector.java,0,4,0,2,0,6
 druid-master\druid-master\server\src\main\java\org\apache\druid\metadata\SqlSegmentsMetadataManager.java,0,343,8,193,0,544
 druid-master\druid-master\extensions-contrib\influxdb-emitter\src\main\java\org\apache\druid\emitter\influxdb\InfluxdbEmitterModule.java,0,16,1,3,0,20
 druid-master\druid-master\indexing-hadoop\src\test\java\org\apache\druid\indexer\SortableBytesTest.java,0,25,0,11,0,36
 druid-master\druid-master\server\src\main\java\org\apache\druid\client\selector\ConnectionCountServerSelectorStrategy.java,0,15,0,5,0,20
 druid-master\druid-master\indexing-service\src\test\java\org\apache\druid\indexing\overlord\TestRemoteTaskRunnerConfig.java,0,25,0,2,0,27
 druid-master\druid-master\processing\src\main\java\org\apache\druid\collections\bitmap\PeekableIteratorAdapter.java,0,21,3,3,0,27
 druid-master\druid-master\indexing-service\src\main\java\org\apache\druid\indexing\common\actions\SegmentNukeAction.java,0,29,0,7,0,36
 druid-master\druid-master\sql\src\main\java\org\apache\druid\sql\calcite\external\ExternalTableScan.java,0,19,0,4,0,23
 druid-master\druid-master\core\src\main\java\org\apache\druid\data\input\impl\FastJacksonJsonNodeJsonProvider.java,0,13,0,3,0,16
 druid-master\druid-master\core\src\main\java\org\apache\druid\segment\column\TypeStrategies.java,0,196,5,53,1,255
 druid-master\druid-master\extensions-contrib\moving-average-query\src\test\java\org\apache\druid\query\movingaverage\MovingAverageIterableTest.java,0,125,76,40,0,241
 druid-master\druid-master\server\src\test\java\org\apache\druid\server\http\security\ResourceFilterTestHelper.java,0,73,0,23,0,96
 druid-master\druid-master\cloud\aws-common\src\main\java\org\apache\druid\common\aws\LazyFileSessionCredentialsProvider.java,0,16,1,5,0,22
 druid-master\druid-master\sql\src\main\java\org\apache\druid\sql\calcite\expression\builtin\SubstringOperatorConversion.java,0,9,0,4,0,13
 druid-master\druid-master\server\src\main\java\org\apache\druid\metadata\PostgreSQLMetadataStorageActionHandlerFactory.java,0,13,0,4,0,17
 druid-master\druid-master\processing\src\main\java\org\apache\druid\segment\FloatColumnSerializer.java,0,34,1,3,0,38
 druid-master\druid-master\processing\src\main\java\org\apache\druid\collections\spatial\RTreeUtils.java,0,15,4,3,0,22
 druid-master\druid-master\services\src\main\java\org\apache\druid\server\router\CoordinatorRuleManager.java,0,43,1,6,0,50
 druid-master\druid-master\core\src\main\java\org\apache\druid\java\util\common\guava\MergeSequence.java,0,43,6,7,0,56
 druid-master\druid-master\extensions-core\histogram\src\main\java\org\apache\druid\query\aggregation\histogram\CustomBucketsPostAggregator.java,0,37,0,2,0,39
 druid-master\druid-master\indexing-service\src\test\java\org\apache\druid\indexing\common\task\CompactionInputSpecTest.java,0,32,0,9,0,41
 druid-master\druid-master\processing\src\main\java\org\apache\druid\segment\data\GenericIndexedWriter.java,0,149,3,41,0,193
 druid-master\druid-master\core\src\main\java\org\apache\druid\java\util\emitter\core\ParametrizedUriExtractor.java,0,20,0,3,1,24
 druid-master\druid-master\processing\src\main\java\org\apache\druid\segment\IncrementalIndexSegment.java,0,19,0,1,0,20
 druid-master\druid-master\processing\src\main\java\org\apache\druid\query\aggregation\AggregatorFactory.java,0,147,2,100,0,249
 druid-master\druid-master\extensions-core\parquet-extensions\src\test\java\org\apache\druid\data\input\parquet\TimestampsParquetInputTest.java,0,23,0,9,0,32
 druid-master\druid-master\server\src\main\java\org\apache\druid\client\SegmentLoadInfo.java,0,45,0,1,0,46
 druid-master\druid-master\extendedset\src\main\java\org\apache\druid\extendedset\intset\ImmutableConciseSet.java,0,195,5,58,0,258
 druid-master\druid-master\processing\src\main\java\org\apache\druid\query\ReferenceCountingSegmentQueryRunner.java,0,20,1,4,0,25
 druid-master\druid-master\processing\src\main\java\org\apache\druid\query\QueryRunnerFactoryConglomerate.java,0,3,0,2,0,5
 druid-master\druid-master\processing\src\main\java\org\apache\druid\segment\filter\cnf\CalciteCnfHelper.java,0,32,2,8,0,42
 druid-master\druid-master\processing\src\main\java\org\apache\druid\query\groupby\having\AndHavingSpec.java,0,28,1,3,0,32
 druid-master\druid-master\processing\src\test\java\org\apache\druid\query\aggregation\constant\LongConstantAggregatorTest.java,0,15,0,1,0,16
 druid-master\druid-master\core\src\main\java\org\apache\druid\java\util\common\io\smoosh\FileSmoosher.java,0,152,2,24,0,178
 druid-master\druid-master\extensions-core\testing-tools\src\test\java\org\apache\druid\query\expressions\SleepExprTest.java,0,19,0,9,0,28
 druid-master\druid-master\integration-tests\src\test\java\org\apache\druid\tests\indexer\AbstractHdfsInputSourceParallelIndexTest.java,0,22,1,10,0,33
 druid-master\druid-master\extensions-contrib\distinctcount\src\main\java\org\apache\druid\query\aggregation\distinctcount\DistinctCountDruidModule.java,0,6,1,1,0,8
 druid-master\druid-master\core\src\test\java\org\apache\druid\metadata\MapStringDynamicConfigProviderTest.java,0,5,0,3,0,8
 druid-master\druid-master\extensions-core\druid-aws-rds-extensions\src\main\java\org\apache\druid\aws\rds\AWSRDSModule.java,0,6,1,1,0,8
 druid-master\druid-master\core\src\main\java\org\apache\druid\timeline\partition\NumberedPartitionChunk.java,0,42,2,2,0,46
 druid-master\druid-master\extensions-core\hdfs-storage\src\test\java\org\apache\druid\storage\hdfs\HdfsKerberosConfigTest.java,0,6,0,3,0,9
 druid-master\druid-master\indexing-service\src\test\java\org\apache\druid\indexing\common\task\CountingLocalTaskActionClientForTest.java,0,18,0,4,0,22
 druid-master\druid-master\processing\src\main\java\org\apache\druid\query\expression\HyperUniqueExpressions.java,0,96,1,22,0,119
 druid-master\druid-master\processing\src\test\java\org\apache\druid\segment\ReferenceCountingSegmentTest.java,0,28,1,2,0,31
 druid-master\druid-master\processing\src\main\java\org\apache\druid\query\search\SearchQueryRunner.java,0,73,0,18,0,91
 druid-master\druid-master\extensions-core\s3-extensions\src\main\java\org\apache\druid\firehose\s3\StaticS3FirehoseFactory.java,0,69,1,13,0,83
 druid-master\druid-master\extensions-core\datasketches\src\main\java\org\apache\druid\query\aggregation\datasketches\theta\oldapi\OldSketchEstimatePostAggregator.java,0,6,0,3,0,9
 druid-master\druid-master\indexing-service\src\main\java\org\apache\druid\indexing\common\task\batch\parallel\PartialSegmentGenerateTask.java,0,56,1,24,0,81
 druid-master\druid-master\processing\src\main\java\org\apache\druid\segment\vector\FilteredVectorOffset.java,0,29,1,8,0,38
 druid-master\druid-master\extensions-contrib\influx-extensions\src\main\java\org\apache\druid\data\input\influx\InfluxExtensionsModule.java,0,8,3,1,0,12
 druid-master\druid-master\processing\src\main\java\org\apache\druid\segment\join\table\MapIndex.java,0,22,0,4,0,26
 druid-master\druid-master\core\src\main\java\org\apache\druid\java\util\metrics\CgroupCpuMonitor.java,0,29,0,4,1,34
 druid-master\druid-master\processing\src\test\java\org\apache\druid\query\aggregation\HistogramAggregatorTest.java,0,81,0,50,0,131
 druid-master\druid-master\core\src\main\java\org\apache\druid\java\util\emitter\core\ZeroCopyByteArrayOutputStream.java,0,4,0,1,0,5
 druid-master\druid-master\extensions-core\histogram\src\main\java\org\apache\druid\query\aggregation\histogram\FixedBucketsHistogramBufferAggregator.java,0,42,0,4,0,46
 druid-master\druid-master\processing\src\main\java\org\apache\druid\query\aggregation\DoubleMinAggregatorFactory.java,0,43,0,3,0,46
 druid-master\druid-master\core\src\test\java\org\apache\druid\timeline\VersionedIntervalTimelineTestBase.java,0,108,0,30,0,138
 druid-master\druid-master\indexing-service\src\test\java\org\apache\druid\indexing\common\task\batch\parallel\ParallelIndexSupervisorTaskKillTest.java,0,111,0,25,0,136
 druid-master\druid-master\indexing-service\src\test\java\org\apache\druid\indexing\overlord\config\ForkingTaskRunnerConfigTest.java,0,51,0,19,0,70
 druid-master\druid-master\core\src\main\java\org\apache\druid\data\input\impl\CsvInputFormat.java,0,24,0,5,0,29
 druid-master\druid-master\server\src\main\java\org\apache\druid\client\indexing\SamplerResponse.java,0,75,0,1,0,76
 druid-master\druid-master\processing\src\main\java\org\apache\druid\query\aggregation\last\FloatLastAggregator.java,0,19,0,3,0,22
 druid-master\druid-master\benchmarks\src\test\java\org\apache\druid\benchmark\compression\CompressedColumnarIntsBenchmark.java,0,31,2,5,0,38
 druid-master\druid-master\extensions-core\datasketches\src\main\java\org\apache\druid\query\aggregation\datasketches\hll\HllSketchToStringPostAggregator.java,0,38,0,3,0,41
 druid-master\druid-master\server\src\main\java\org\apache\druid\indexing\overlord\DataSourceMetadata.java,0,17,0,13,0,30
 druid-master\druid-master\core\src\main\java\org\apache\druid\math\expr\vector\CastToDoubleVectorProcessor.java,0,9,0,3,0,12
 druid-master\druid-master\processing\src\test\java\org\apache\druid\query\aggregation\last\LongLastAggregationTest.java,0,75,0,14,0,89
 druid-master\druid-master\server\src\main\java\org\apache\druid\client\indexing\ClientTaskQuery.java,0,11,0,8,0,19
 druid-master\druid-master\server\src\main\java\org\apache\druid\server\coordinator\duty\KillDatasourceMetadata.java,0,39,0,21,0,60
 druid-master\druid-master\core\src\main\java\org\apache\druid\data\input\Firehose.java,0,24,0,21,1,46
 druid-master\druid-master\server\src\main\java\org\apache\druid\client\indexing\SamplerSpec.java,0,2,0,1,0,3
 druid-master\druid-master\core\src\main\java\org\apache\druid\utils\CircularBuffer.java,0,28,0,4,1,33
 druid-master\druid-master\server\src\main\java\org\apache\druid\server\security\TrustedDomainAuthenticator.java,0,52,6,9,0,67
 druid-master\druid-master\indexing-service\src\main\java\org\apache\druid\indexing\common\task\TaskResource.java,0,19,0,4,0,23
 druid-master\druid-master\processing\src\main\java\org\apache\druid\segment\data\ImmutableRTreeObjectStrategy.java,0,30,0,3,0,33
 druid-master\druid-master\services\src\main\java\org\apache\druid\cli\CliMiddleManager.java,0,50,0,22,0,72
 druid-master\druid-master\processing\src\main\java\org\apache\druid\query\aggregation\StringColumnLongAggregatorWrapper.java,0,14,0,3,0,17
 druid-master\druid-master\core\src\main\java\org\apache\druid\timeline\partition\AtomicUpdateGroup.java,0,52,0,19,0,71
 druid-master\druid-master\extensions-contrib\materialized-view-selection\src\main\java\org\apache\druid\query\materializedview\MaterializedViewSelectionDruidModule.java,0,12,0,3,0,15
 druid-master\druid-master\server\src\test\java\org\apache\druid\client\selector\ServerSelectorTest.java,0,25,1,10,0,36
 druid-master\druid-master\core\src\main\java\org\apache\druid\data\input\FiniteFirehoseFactory.java,0,16,0,9,0,25
 druid-master\druid-master\server\src\main\java\org\apache\druid\server\coordinator\CostBalancerStrategyFactory.java,0,5,0,2,0,7
 druid-master\druid-master\server\src\main\java\org\apache\druid\segment\loading\SegmentLoader.java,0,15,0,12,0,27
 druid-master\druid-master\extensions-contrib\gce-extensions\src\main\java\org\apache\druid\indexing\overlord\autoscaling\gce\GceModule.java,0,6,1,2,0,9
 druid-master\druid-master\indexing-service\src\main\java\org\apache\druid\guice\IndexingServiceModuleHelper.java,0,11,1,6,0,18
 druid-master\druid-master\extensions-core\druid-basic-security\src\main\java\org\apache\druid\security\basic\authentication\entity\BasicAuthenticatorCredentialUpdate.java,0,16,0,2,0,18
 druid-master\druid-master\processing\src\main\java\org\apache\druid\query\topn\InvertedTopNMetricSpec.java,0,50,1,5,0,56
 druid-master\druid-master\extensions-core\druid-bloom-filter\src\main\java\org\apache\druid\query\filter\sql\BloomFilterOperatorConversion.java,0,15,0,4,0,19
 druid-master\druid-master\processing\src\test\java\org\apache\druid\query\filter\IntervalDimFilterTest.java,0,22,0,9,0,31
 druid-master\druid-master\indexing-service\src\main\java\org\apache\druid\indexing\common\IngestionStatsAndErrorsTaskReport.java,0,30,1,3,0,34
 druid-master\druid-master\extensions-core\azure-extensions\src\test\java\org\apache\druid\firehose\azure\StaticAzureBlobStoreFirehoseFactoryTest.java,0,13,1,2,0,16
 druid-master\druid-master\server\src\main\java\org\apache\druid\metadata\SQLMetadataRuleManagerProvider.java,0,30,1,3,0,34
 druid-master\druid-master\core\src\main\java\org\apache\druid\data\input\SplitHintSpec.java,0,11,0,8,0,19
 druid-master\druid-master\processing\src\main\java\org\apache\druid\segment\join\filter\Equiconditions.java,0,13,0,2,0,15
 druid-master\druid-master\extensions-core\kafka-indexing-service\src\test\java\org\apache\druid\indexing\kafka\KafkaRecordSupplierTest.java,0,163,10,74,0,247
 druid-master\druid-master\processing\src\test\java\org\apache\druid\segment\ColumnSelectorBitmapIndexSelectorTest.java,0,31,0,15,0,46
 druid-master\druid-master\extensions-contrib\statsd-emitter\src\main\java\org\apache\druid\emitter\statsd\StatsDEmitterConfig.java,0,82,4,8,0,94
 druid-master\druid-master\core\src\main\java\org\apache\druid\math\expr\vector\BivariateFunctionVectorObjectProcessor.java,0,34,3,7,1,45
 druid-master\druid-master\benchmarks\src\test\java\org\apache\druid\benchmark\query\GroupByBenchmark.java,0,177,2,66,0,245
 druid-master\druid-master\core\src\main\java\org\apache\druid\math\expr\ExprMacroTable.java,0,84,0,13,2,99
 druid-master\druid-master\server\src\main\java\org\apache\druid\server\coordination\DataSegmentChangeCallback.java,0,5,0,1,0,6
 druid-master\druid-master\indexing-service\src\main\java\org\apache\druid\indexing\common\task\batch\parallel\iterator\RangePartitionIndexTaskInputRowIteratorBuilder.java,0,43,0,15,0,58
 druid-master\druid-master\benchmarks\src\test\java\org\apache\druid\benchmark\TopNTypeInterfaceBenchmark.java,0,130,7,46,0,183
 druid-master\druid-master\core\src\main\java\org\apache\druid\java\util\common\guava\Yielders.java,0,18,1,2,0,21
 druid-master\druid-master\benchmarks\src\test\java\org\apache\druid\benchmark\ExpressionFilterBenchmark.java,0,32,1,10,0,43
 druid-master\druid-master\processing\src\main\java\org\apache\druid\query\dimension\DimensionSpec.java,0,40,0,22,0,62
 druid-master\druid-master\indexing-service\src\test\java\org\apache\druid\indexing\worker\http\WorkerResourceTest.java,0,29,1,8,0,38
 druid-master\druid-master\server\src\main\java\org\apache\druid\metadata\MetadataSupervisorManager.java,0,8,0,1,0,9
 druid-master\druid-master\extensions-core\stats\src\main\java\org\apache\druid\query\aggregation\variance\VarianceSerde.java,0,40,1,11,0,52
 druid-master\druid-master\processing\src\main\java\org\apache\druid\query\filter\DruidPredicateFactory.java,0,11,0,5,0,16
 druid-master\druid-master\processing\src\main\java\org\apache\druid\query\filter\Filter.java,0,53,0,43,0,96
 druid-master\druid-master\server\src\main\java\org\apache\druid\client\HttpServerInventoryViewResource.java,0,11,0,4,0,15
 druid-master\druid-master\server\src\test\java\org\apache\druid\metadata\SQLMetadataRuleManagerTest.java,0,57,6,22,0,85
 druid-master\druid-master\extensions-contrib\cloudfiles-extensions\src\main\java\org\apache\druid\storage\cloudfiles\CloudFilesObject.java,0,37,0,4,0,41
 druid-master\druid-master\core\src\test\java\org\apache\druid\utils\ConnectionUriUtilsTest.java,0,94,0,36,0,130
 druid-master\druid-master\processing\src\test\java\org\apache\druid\segment\filter\ExpressionFilterTest.java,0,101,0,44,0,145
 druid-master\druid-master\extensions-core\druid-kerberos\src\main\java\org\apache\druid\security\kerberos\RetryIfUnauthorizedResponseHandler.java,0,39,3,12,0,54
 druid-master\druid-master\extensions-core\kafka-extraction-namespace\src\main\java\org\apache\druid\query\lookup\KafkaExtractionNamespaceModule.java,0,6,0,1,0,7
 druid-master\druid-master\processing\src\main\java\org\apache\druid\query\AbstractPrioritizedQueryRunnerCallable.java,0,16,0,4,0,20
 druid-master\druid-master\extensions-core\datasketches\src\test\java\org\apache\druid\query\aggregation\datasketches\theta\SketchAggregatorFactoryTest.java,0,49,0,23,0,72
 druid-master\druid-master\sql\src\test\java\org\apache\druid\sql\SqlLifecycleTest.java,0,79,0,65,0,144
 druid-master\druid-master\extensions-core\datasketches\src\main\java\org\apache\druid\query\aggregation\datasketches\hll\HllSketchMergeBufferAggregatorHelper.java,0,40,0,12,0,52
 druid-master\druid-master\core\src\main\java\org\apache\druid\utils\package-info.java,0,1,0,1,0,2
 druid-master\druid-master\server\src\main\java\org\apache\druid\client\cache\MemcachedCache.java,0,126,4,17,0,147
 druid-master\druid-master\processing\src\main\java\org\apache\druid\segment\filter\cnf\HiveCnfHelper.java,0,47,2,22,0,71
 druid-master\druid-master\processing\src\main\java\org\apache\druid\guice\LifecycleForkJoinPoolProvider.java,0,20,0,2,0,22
 druid-master\druid-master\core\src\main\java\org\apache\druid\java\util\metrics\AllocationMetricCollector.java,0,22,0,10,0,32
 druid-master\druid-master\core\src\main\java\org\apache\druid\segment\column\NullableTypeStrategy.java,0,41,1,8,1,51
 druid-master\druid-master\core\src\main\java\org\apache\druid\java\util\common\parsers\ObjectFlattener.java,0,3,0,1,0,4
 druid-master\druid-master\indexing-hadoop\src\test\java\org\apache\druid\indexer\UtilsTest.java,0,28,3,3,0,34
 druid-master\druid-master\processing\src\main\java\org\apache\druid\collections\bitmap\BatchIteratorAdapter.java,0,12,2,2,0,16
 druid-master\druid-master\core\src\main\java\org\apache\druid\utils\Throwables.java,0,9,0,5,0,14
 druid-master\druid-master\processing\src\main\java\org\apache\druid\query\timeseries\TimeseriesResultValue.java,0,8,0,1,0,9
 druid-master\druid-master\indexing-service\src\main\java\org\apache\druid\indexing\common\task\batch\parallel\ParallelIndexIngestionSpec.java,0,29,0,7,0,36
 druid-master\druid-master\server\src\main\java\org\apache\druid\segment\handoff\CoordinatorBasedSegmentHandoffNotifierConfig.java,0,6,0,1,0,7
 druid-master\druid-master\extensions-core\mysql-metadata-storage\src\test\java\org\apache\druid\firehose\sql\MySQLFirehoseDatabaseConnectorTest.java,0,101,0,41,0,142
 druid-master\druid-master\indexing-service\src\test\java\org\apache\druid\indexing\common\task\batch\parallel\ParallelIndexSupervisorTaskResourceTest.java,0,167,1,60,0,228
 druid-master\druid-master\processing\src\test\java\org\apache\druid\query\groupby\epinephelinae\LimitedBufferHashGrouperTest.java,0,149,1,64,0,214
 druid-master\druid-master\indexing-service\src\test\java\org\apache\druid\indexing\common\task\NoopIndexTaskClientFactory.java,0,9,0,2,0,11
 druid-master\druid-master\extensions-contrib\ambari-metrics-emitter\src\main\java\org\apache\druid\emitter\ambari\metrics\SendAllTimelineEventConverter.java,0,32,0,11,0,43
 druid-master\druid-master\processing\src\main\java\org\apache\druid\query\groupby\epinephelinae\TemporaryStorageFullException.java,0,4,0,2,0,6
 druid-master\druid-master\core\src\main\java\org\apache\druid\utils\CompressionUtils.java,0,145,8,54,0,207
 druid-master\druid-master\indexing-service\src\main\java\org\apache\druid\indexing\common\task\batch\parallel\GeneratedPartitionsReport.java,0,34,0,3,0,37
 druid-master\druid-master\processing\src\main\java\org\apache\druid\query\aggregation\DoubleMaxAggregatorFactory.java,0,43,0,3,0,46
 druid-master\druid-master\benchmarks\src\test\java\org\apache\druid\benchmark\IndexedTableJoinCursorBenchmark.java,0,97,4,43,0,144
 druid-master\druid-master\indexing-service\src\main\java\org\apache\druid\indexing\common\task\batch\parallel\PartialHashSegmentGenerateParallelIndexTaskRunner.java,0,26,0,4,0,30
 druid-master\druid-master\server\src\main\java\org\apache\druid\guice\DruidProcessingConfigModule.java,0,5,0,2,0,7
 druid-master\druid-master\server\src\main\java\org\apache\druid\jackson\ToStringObjectPairListDeserializer.java,0,13,0,6,0,19
 druid-master\druid-master\processing\src\test\java\org\apache\druid\query\groupby\having\HavingSpecMetricComparatorTest.java,0,62,0,47,0,109
 druid-master\druid-master\integration-tests\src\test\java\org\apache\druid\tests\indexer\ITHttpInputSourceTest.java,0,11,1,5,0,17
 druid-master\druid-master\extendedset\src\main\java\org\apache\druid\extendedset\intset\EmptyIntIterator.java,0,10,2,1,0,13
 druid-master\druid-master\extensions-core\datasketches\src\main\java\org\apache\druid\query\aggregation\datasketches\theta\SketchBufferAggregatorHelper.java,0,57,0,16,0,73
 druid-master\druid-master\extensions-core\datasketches\src\main\java\org\apache\druid\query\aggregation\datasketches\hll\HllSketchBuildBufferAggregatorHelper.java,0,56,0,18,0,74
 druid-master\druid-master\processing\src\main\java\org\apache\druid\segment\column\StringDictionaryEncodedColumn.java,0,144,0,25,0,169
 druid-master\druid-master\processing\src\main\java\org\apache\druid\query\extraction\FunctionalExtraction.java,0,44,1,13,0,58
 druid-master\druid-master\server\src\main\java\org\apache\druid\server\lookup\cache\LookupExtractorFactoryMapContainer.java,0,36,0,7,0,43
 druid-master\druid-master\extensions-core\kinesis-indexing-service\src\main\java\org\apache\druid\indexing\kinesis\KinesisIndexingServiceModule.java,0,11,0,5,0,16
 druid-master\druid-master\core\src\main\java\org\apache\druid\java\util\metrics\MonitorUtils.java,0,7,1,2,0,10
 druid-master\druid-master\processing\src\test\java\org\apache\druid\segment\loading\SegmentizerFactoryTest.java,0,7,1,2,0,10
 druid-master\druid-master\extensions-contrib\momentsketch\src\test\java\org\apache\druid\query\aggregation\momentsketch\MomentSketchWrapperTest.java,0,14,0,1,0,15
 druid-master\druid-master\server\src\main\java\org\apache\druid\client\indexing\IndexingWorker.java,0,34,0,1,0,35
 druid-master\druid-master\processing\src\main\java\org\apache\druid\query\aggregation\cardinality\CardinalityBufferAggregator.java,0,46,0,12,0,58
 druid-master\druid-master\processing\src\test\java\org\apache\druid\query\filter\InDimFilterTest.java,0,87,1,51,0,139
 druid-master\druid-master\core\src\main\java\org\apache\druid\metadata\EnvironmentVariablePasswordProvider.java,0,22,0,3,0,25
 druid-master\druid-master\core\src\test\java\org\apache\druid\segment\column\TypesTest.java,0,17,0,10,1,28
 druid-master\druid-master\extensions-core\histogram\src\test\java\org\apache\druid\query\aggregation\histogram\ApproximateHistogramPostAggregatorTest.java,0,30,1,9,0,40
 druid-master\druid-master\processing\src\main\java\org\apache\druid\segment\data\BlockLayoutColumnarLongsSupplier.java,0,59,1,8,0,68
 druid-master\druid-master\processing\src\main\java\org\apache\druid\segment\IndexMerger.java,0,121,6,47,0,174
 druid-master\druid-master\server\src\main\java\org\apache\druid\server\security\AuthValidator.java,0,7,0,1,0,8
 druid-master\druid-master\integration-tests\src\main\java\org\apache\druid\testing\utils\SqlTestQueryHelper.java,0,16,0,2,0,18
 druid-master\druid-master\server\src\main\java\org\apache\druid\metadata\input\InputSourceModule.java,0,10,0,3,0,13
 druid-master\druid-master\server\src\main\java\org\apache\druid\client\indexing\TaskPayloadResponse.java,0,18,0,1,0,19
 druid-master\druid-master\processing\src\test\java\org\apache\druid\query\groupby\epinephelinae\ConcurrentGrouperTest.java,0,92,4,12,0,108
 druid-master\druid-master\server\src\main\java\org\apache\druid\server\audit\SQLAuditManagerConfig.java,0,24,0,3,0,27
 druid-master\druid-master\extensions-contrib\moving-average-query\src\main\java\org\apache\druid\query\movingaverage\DefaultMovingAverageQueryMetrics.java,0,16,0,4,0,20
 druid-master\druid-master\indexing-service\src\main\java\org\apache\druid\indexing\common\task\batch\parallel\AbstractBatchSubtask.java,0,15,0,3,0,18
 druid-master\druid-master\extensions-core\azure-extensions\src\test\java\org\apache\druid\data\input\azure\AzureInputSourceTest.java,0,72,5,27,0,104
 druid-master\druid-master\indexing-service\src\test\java\org\apache\druid\indexing\common\task\batch\parallel\HashPartitionMultiPhaseParallelIndexingTest.java,0,119,3,51,0,173
 druid-master\druid-master\indexing-service\src\main\java\org\apache\druid\indexing\overlord\PortFinder.java,0,31,0,1,0,32
 druid-master\druid-master\core\src\main\java\org\apache\druid\guice\annotations\Smile.java,0,1,0,1,0,2
 druid-master\druid-master\core\src\main\java\org\apache\druid\java\util\common\Triple.java,0,32,3,2,0,37
 druid-master\druid-master\extensions-core\google-extensions\src\main\java\org\apache\druid\storage\google\ObjectStorageIterator.java,0,32,2,6,0,40
 druid-master\druid-master\server\src\test\java\org\apache\druid\discovery\DiscoveryDruidNodeTest.java,0,56,2,15,0,73
 druid-master\druid-master\extensions-core\druid-basic-security\src\test\java\org\apache\druid\security\authentication\NoopBasicAuthenticatorCacheNotifier.java,0,6,0,4,0,10
 druid-master\druid-master\extensions-core\datasketches\src\main\java\org\apache\druid\query\aggregation\datasketches\theta\package-info.java,0,1,0,1,0,2
 druid-master\druid-master\extensions-core\postgresql-metadata-storage\src\test\java\org\apache\druid\firehose\PostgresqlFirehoseDatabaseConnectorTest.java,0,71,0,26,0,97
 druid-master\druid-master\extensions-contrib\influxdb-emitter\src\main\java\org\apache\druid\emitter\influxdb\InfluxdbEmitter.java,0,66,2,17,0,85
 druid-master\druid-master\server\src\main\java\org\apache\druid\server\security\AuthTestUtils.java,0,6,0,1,0,7
 druid-master\druid-master\indexing-service\src\test\java\org\apache\druid\indexing\overlord\ThreadingTaskRunnerTest.java,0,16,1,4,0,21
 druid-master\druid-master\sql\src\test\java\org\apache\druid\sql\calcite\schema\DruidSchemaConcurrencyTest.java,0,155,1,48,0,204
 druid-master\druid-master\extensions-core\kubernetes-extensions\src\main\java\org\apache\druid\k8s\discovery\WatchResult.java,0,6,0,1,0,7
 druid-master\druid-master\processing\src\main\java\org\apache\druid\query\groupby\epinephelinae\LimitedBufferHashGrouper.java,0,154,4,37,0,195
 druid-master\druid-master\processing\src\main\java\org\apache\druid\query\filter\AndDimFilter.java,0,36,2,5,0,43
 druid-master\druid-master\server\src\main\java\org\apache\druid\segment\realtime\NoopSegmentPublisher.java,0,3,0,1,0,4
 druid-master\druid-master\indexing-service\src\test\java\org\apache\druid\indexing\overlord\hrtr\WorkerHolderTest.java,0,13,1,3,0,17
 druid-master\druid-master\server\src\main\java\org\apache\druid\server\initialization\ZkPathsConfig.java,0,75,1,15,0,91
 druid-master\druid-master\indexing-service\src\main\java\org\apache\druid\indexing\overlord\config\WorkerTaskRunnerConfig.java,0,12,0,6,0,18
 druid-master\druid-master\processing\src\test\java\org\apache\druid\segment\ConstantDimensionSelectorTest.java,0,27,0,11,0,38
 druid-master\druid-master\processing\src\main\java\org\apache\druid\segment\historical\SingleValueHistoricalDimensionSelector.java,0,3,0,2,0,5
 druid-master\druid-master\server\src\main\java\org\apache\druid\discovery\DruidNodeAnnouncer.java,0,3,0,1,0,4
 druid-master\druid-master\extensions-contrib\moving-average-query\src\main\java\org\apache\druid\query\movingaverage\averagers\LongMaxAverager.java,0,11,1,3,0,15
 druid-master\druid-master\server\src\main\java\org\apache\druid\guice\IndexingServiceDiscoveryModule.java,0,10,0,2,0,12
 druid-master\druid-master\server\src\test\java\org\apache\druid\server\initialization\JettyTest.java,0,107,5,41,0,153
 druid-master\druid-master\indexing-service\src\main\java\org\apache\druid\indexing\common\task\NoopTask.java,0,73,2,6,0,81
 druid-master\druid-master\core\src\main\java\org\apache\druid\java\util\http\client\HttpClientInit.java,0,30,2,9,1,42
 druid-master\druid-master\extensions-core\datasketches\src\main\java\org\apache\druid\query\aggregation\datasketches\tuple\NoopArrayOfDoublesSketchBufferAggregator.java,0,16,4,4,0,24
 druid-master\druid-master\processing\src\test\java\org\apache\druid\query\dimension\ExtractionDimensionSpecTest.java,0,21,0,13,0,34
 druid-master\druid-master\core\src\main\java\org\apache\druid\java\util\http\client\auth\Credentials.java,0,2,0,1,0,3
 druid-master\druid-master\extensions-core\azure-extensions\src\main\java\org\apache\druid\storage\azure\AzureAccountConfig.java,0,48,0,1,0,49
 druid-master\druid-master\processing\src\main\java\org\apache\druid\query\lookup\LookupExtractorFactoryContainerProvider.java,0,7,0,4,0,11
 druid-master\druid-master\server\src\main\java\org\apache\druid\segment\realtime\firehose\ClippedFirehoseFactory.java,0,24,0,3,0,27
 druid-master\druid-master\sql\src\main\java\org\apache\druid\sql\calcite\expression\builtin\StrposOperatorConversion.java,0,6,0,1,0,7
 druid-master\druid-master\core\src\main\java\org\apache\druid\java\util\emitter\factory\HttpEmitterFactory.java,0,8,0,3,0,11
 druid-master\druid-master\core\src\main\java\org\apache\druid\java\util\common\guava\BaseSequence.java,0,30,4,3,0,37
 druid-master\druid-master\processing\src\main\java\org\apache\druid\query\filter\BoundDimFilter.java,0,155,12,18,0,185
 druid-master\druid-master\server\src\main\java\org\apache\druid\server\DruidNode.java,0,160,2,24,0,186
 druid-master\druid-master\extensions-core\datasketches\src\main\java\org\apache\druid\query\aggregation\datasketches\quantiles\sql\DoublesSketchListArgBaseOperatorConversion.java,0,21,0,4,0,25
 druid-master\druid-master\processing\src\test\java\org\apache\druid\query\aggregation\LongMinAggregationTest.java,0,68,0,25,0,93
 druid-master\druid-master\benchmarks\src\test\java\org\apache\druid\benchmark\compression\VSizeSerdeBenchmark.java,0,94,1,4,0,99
 druid-master\druid-master\indexing-service\src\main\java\org\apache\druid\indexing\common\actions\LockListAction.java,0,13,0,1,0,14
 druid-master\druid-master\extensions-core\ec2-extensions\src\test\java\org\apache\druid\indexing\overlord\autoscaling\ec2\EC2AutoScalerTest.java,0,44,0,25,0,69
 druid-master\druid-master\extensions-contrib\statsd-emitter\src\main\java\org\apache\druid\emitter\statsd\StatsDMetric.java,0,19,0,1,0,20
 druid-master\druid-master\services\src\main\java\org\apache\druid\cli\convert\Rename.java,0,16,0,1,0,17
 druid-master\druid-master\extensions-contrib\moving-average-query\src\test\java\org\apache\druid\query\movingaverage\averagers\LongMaxAveragerFactoryTest.java,0,6,0,3,0,9
 druid-master\druid-master\indexing-service\src\test\java\org\apache\druid\indexing\common\task\batch\parallel\MultiPhaseParallelIndexingRowStatsTest.java,0,45,3,14,0,62
 druid-master\druid-master\indexing-service\src\test\java\org\apache\druid\indexing\firehose\IngestSegmentFirehoseFactoryTimelineTest.java,0,132,3,21,0,156
 druid-master\druid-master\extensions-core\hdfs-storage\src\test\java\org\apache\druid\inputsource\hdfs\HdfsInputSourceConfigTest.java,0,11,0,4,0,15
 druid-master\druid-master\extensions-core\druid-basic-security\src\main\java\org\apache\druid\security\basic\CommonCacheNotifier.java,0,83,6,26,0,115
 druid-master\druid-master\core\src\main\java\org\apache\druid\java\util\common\ISE.java,0,15,0,3,0,18
 druid-master\druid-master\extensions-core\kubernetes-extensions\src\main\java\org\apache\druid\k8s\discovery\K8sLeaderElectorFactory.java,0,5,0,2,0,7
 druid-master\druid-master\indexing-service\src\test\java\org\apache\druid\indexing\common\task\batch\parallel\PartialHashSegmentGenerateTaskTest.java,0,28,0,13,0,41
 druid-master\druid-master\extensions-contrib\cloudfiles-extensions\src\main\java\org\apache\druid\firehose\cloudfiles\StaticCloudFilesFirehoseFactory.java,0,58,0,11,0,69
 druid-master\druid-master\indexing-service\src\test\java\org\apache\druid\indexing\common\task\batch\parallel\ParallelIndexTestingFactory.java,0,110,1,14,0,125
 druid-master\druid-master\indexing-service\src\main\java\org\apache\druid\indexing\overlord\autoscaling\NoopAutoScaler.java,0,25,1,2,0,28
 druid-master\druid-master\core\src\main\java\org\apache\druid\js\JavaScriptConfig.java,0,25,1,3,0,29
 druid-master\druid-master\core\src\main\java\org\apache\druid\java\util\common\parsers\JSONFlattenerMaker.java,0,38,3,9,0,50
 druid-master\druid-master\core\src\main\java\org\apache\druid\guice\annotations\JsonNonNull.java,0,2,0,2,0,4
 druid-master\druid-master\server\src\test\java\org\apache\druid\segment\realtime\firehose\IngestSegmentFirehoseTest.java,0,42,3,17,0,62
 druid-master\druid-master\extensions-core\lookups-cached-global\src\main\java\org\apache\druid\data\input\MapPopulator.java,0,89,5,34,0,128
 druid-master\druid-master\extensions-contrib\momentsketch\src\main\java\org\apache\druid\query\aggregation\momentsketch\MomentSketchComplexMetricSerde.java,0,24,0,7,0,31
 druid-master\druid-master\core\src\main\java\org\apache\druid\java\util\http\client\pool\ResourcePoolConfig.java,0,23,0,2,0,25
 druid-master\druid-master\core\src\test\java\org\apache\druid\java\util\common\URIsTest.java,0,12,3,3,0,18
 druid-master\druid-master\extensions-core\s3-extensions\src\test\java\org\apache\druid\storage\s3\S3DataSegmentPusherConfigTest.java,0,19,0,12,0,31
 druid-master\druid-master\server\src\test\java\org\apache\druid\segment\indexing\granularity\UniformGranularityTest.java,0,41,0,8,0,49
 druid-master\druid-master\core\src\main\java\org\apache\druid\guice\DruidGuiceExtensions.java,0,4,0,1,0,5
 druid-master\druid-master\extensions-core\kubernetes-extensions\src\test\java\org\apache\druid\k8s\discovery\K8sDruidLeaderElectionIntTest.java,0,34,4,8,0,46
 druid-master\druid-master\server\src\main\java\org\apache\druid\segment\join\BroadcastTableJoinableFactory.java,0,28,1,8,0,37
 druid-master\druid-master\indexing-service\src\test\java\org\apache\druid\indexing\common\task\FilteringCloseableInputRowIteratorTest.java,0,65,3,17,0,85
 druid-master\druid-master\extensions-contrib\thrift-extensions\src\main\java\org\apache\druid\data\input\thrift\ThriftDeserialization.java,0,30,3,8,0,41
 druid-master\druid-master\extensions-contrib\moving-average-query\src\main\java\org\apache\druid\query\movingaverage\MovingAverageQueryModule.java,0,23,0,8,0,31
 druid-master\druid-master\integration-tests\src\test\java\org\apache\druid\tests\indexer\AbstractGcsInputSourceParallelIndexTest.java,0,26,1,10,0,37
 druid-master\druid-master\server\src\main\java\org\apache\druid\server\initialization\jetty\BadRequestException.java,0,6,0,2,0,8
 druid-master\druid-master\extensions-core\histogram\src\test\java\org\apache\druid\query\aggregation\histogram\QuantilesPostAggregatorTest.java,0,21,0,6,0,27
 druid-master\druid-master\extensions-contrib\tdigestsketch\src\main\java\org\apache\druid\query\aggregation\tdigestsketch\sql\TDigestSketchQuantileSqlAggregator.java,0,24,0,15,0,39
 druid-master\druid-master\extensions-core\stats\src\test\java\org\apache\druid\query\aggregation\variance\VarianceAggregatorFactoryUnitTest.java,0,40,0,6,0,46
 druid-master\druid-master\processing\src\main\java\org\apache\druid\segment\join\table\IndexedTableJoinable.java,0,48,2,17,0,67
 druid-master\druid-master\server\src\main\java\org\apache\druid\client\InputStreamHolder.java,0,26,0,5,0,31
 druid-master\druid-master\processing\src\test\java\org\apache\druid\segment\data\IncrementalIndexTest.java,0,141,0,64,0,205
 druid-master\druid-master\core\src\main\java\org\apache\druid\java\util\metrics\ProcFsReader.java,0,16,0,4,0,20
 druid-master\druid-master\server\src\main\java\org\apache\druid\metadata\UnknownSegmentIdsException.java,0,8,0,2,0,10
 druid-master\druid-master\sql\src\main\java\org\apache\druid\sql\calcite\expression\builtin\LeftOperatorConversion.java,0,6,0,1,0,7
 druid-master\druid-master\server\src\main\java\org\apache\druid\segment\realtime\firehose\ChatHandlerProvider.java,0,7,0,6,0,13
 druid-master\druid-master\benchmarks\src\test\java\org\apache\druid\benchmark\FilterPartitionBenchmark.java,0,148,6,27,0,181
 druid-master\druid-master\sql\src\main\java\org\apache\druid\sql\calcite\schema\DruidSchemaManager.java,0,5,0,4,0,9
 druid-master\druid-master\indexing-hadoop\src\test\java\org\apache\druid\indexer\DeterminePartitionsJobTest.java,0,46,0,11,0,57
 druid-master\druid-master\extensions-core\datasketches\src\main\java\org\apache\druid\query\aggregation\datasketches\quantiles\sql\DoublesSketchQuantileOperatorConversion.java,0,14,0,4,0,18
 druid-master\druid-master\server\src\test\java\org\apache\druid\query\dimension\LookupDimensionSpecTest.java,0,66,1,29,0,96
 druid-master\druid-master\core\src\main\java\org\apache\druid\collections\SerializablePair.java,0,17,2,3,0,22
 druid-master\druid-master\extensions-core\protobuf-extensions\src\test\java\org\apache\druid\data\input\protobuf\ProtobufInputFormatTest.java,0,45,0,18,0,63
 druid-master\druid-master\core\src\test\java\org\apache\druid\common\utils\IdUtilsTest.java,0,46,0,14,1,61
 druid-master\druid-master\indexing-service\src\test\java\org\apache\druid\indexing\common\task\batch\parallel\PartialSegmentMergeIngestionSpecTest.java,0,20,2,6,0,28
 druid-master\druid-master\core\src\main\java\org\apache\druid\tasklogs\TaskLogStreamer.java,0,8,0,5,0,13
 druid-master\druid-master\extensions-core\s3-extensions\src\main\java\org\apache\druid\storage\s3\S3TaskLogsConfig.java,0,25,0,1,0,26
 druid-master\druid-master\server\src\main\java\org\apache\druid\metadata\MetadataRuleManagerConfig.java,0,13,0,1,0,14
 druid-master\druid-master\core\src\test\java\org\apache\druid\java\util\common\parsers\JSONPathParserTest.java,0,125,0,57,0,182
 druid-master\druid-master\server\src\test\java\org\apache\druid\server\ClientInfoResourceTest.java,0,107,1,54,0,162
 druid-master\druid-master\processing\src\main\java\org\apache\druid\query\aggregation\ExpressionLambdaAggregator.java,0,25,0,3,0,28
 druid-master\druid-master\processing\src\main\java\org\apache\druid\segment\filter\cnf\CNFFilterExplosionException.java,0,5,0,1,0,6
 druid-master\druid-master\indexing-service\src\main\java\org\apache\druid\indexing\common\task\LocalSegmentAllocator.java,0,21,0,8,0,29
 druid-master\druid-master\server\src\main\java\org\apache\druid\client\indexing\IndexingService.java,0,1,0,1,0,2
 druid-master\druid-master\benchmarks\src\test\java\org\apache\druid\benchmark\BasicAuthUserMapSerdeBenchmark.java,0,50,1,3,0,54
 druid-master\druid-master\server\src\main\java\org\apache\druid\metadata\BasicDataSourceExt.java,0,40,0,11,0,51
 druid-master\druid-master\extensions-core\druid-bloom-filter\src\main\java\org\apache\druid\guice\BloomFilterExtensionModule.java,0,11,0,5,0,16
 druid-master\druid-master\extensions-core\s3-extensions\src\test\java\org\apache\druid\storage\s3\S3TestUtils.java,0,50,0,18,0,68
 druid-master\druid-master\processing\src\main\java\org\apache\druid\query\NoopQueryRunner.java,0,7,0,2,0,9
 druid-master\druid-master\extensions-core\google-extensions\src\main\java\org\apache\druid\data\input\google\GoogleCloudStorageInputSource.java,0,38,1,8,0,47
 druid-master\druid-master\processing\src\main\java\org\apache\druid\segment\FloatColumnSelector.java,0,16,0,12,0,28
 druid-master\druid-master\indexing-service\src\main\java\org\apache\druid\indexing\common\task\batch\partition\CompletePartitionAnalysis.java,0,9,0,5,0,14
 druid-master\druid-master\indexing-service\src\test\java\org\apache\druid\indexing\worker\shuffle\LocalIntermediaryDataManagerAutoCleanupTest.java,0,40,0,9,0,49
 druid-master\druid-master\extensions-contrib\thrift-extensions\src\main\java\org\apache\druid\data\input\thrift\ThriftExtensionsModule.java,0,5,1,1,0,7
 druid-master\druid-master\extensions-core\histogram\src\main\java\org\apache\druid\query\aggregation\histogram\MaxPostAggregator.java,0,27,0,3,0,30
 druid-master\druid-master\indexing-hadoop\src\test\java\org\apache\druid\indexer\path\StaticPathSpecTest.java,0,20,0,6,0,26
 druid-master\druid-master\indexing-service\src\main\java\org\apache\druid\indexing\overlord\TimeChunkLockRequest.java,0,66,0,3,0,69
 druid-master\druid-master\processing\src\main\java\org\apache\druid\guice\NullHandlingModule.java,0,5,0,2,0,7
 druid-master\druid-master\extensions-core\druid-basic-security\src\main\java\org\apache\druid\security\basic\BasicAuthCommonCacheConfig.java,0,34,0,5,0,39
 druid-master\druid-master\server\src\main\java\org\apache\druid\server\log\FileRequestLogger.java,0,45,0,6,0,51
 druid-master\druid-master\core\src\main\java\org\apache\druid\java\util\metrics\SigarPidDiscoverer.java,0,8,1,1,0,10
 druid-master\druid-master\processing\src\main\java\org\apache\druid\segment\SegmentReference.java,0,4,0,3,0,7
 druid-master\druid-master\processing\src\main\java\org\apache\druid\query\aggregation\NoopBufferAggregator.java,0,27,3,2,0,32
 druid-master\druid-master\indexing-hadoop\src\test\java\org\apache\druid\indexer\hadoop\WindowedDataSegmentTest.java,0,9,0,3,0,12
 druid-master\druid-master\server\src\main\java\org\apache\druid\server\security\AuthenticatorMapper.java,0,12,0,1,0,13
 druid-master\druid-master\processing\src\main\java\org\apache\druid\segment\join\table\BroadcastSegmentIndexedTable.java,0,69,2,24,0,95
 druid-master\druid-master\integration-tests\src\test\java\org\apache\druid\tests\query\ITJdbcQueryTest.java,0,56,8,21,0,85
 druid-master\druid-master\indexing-service\src\test\java\org\apache\druid\indexing\common\task\batch\parallel\SinglePhaseParallelIndexingTest.java,0,249,5,126,0,380
 druid-master\druid-master\processing\src\main\java\org\apache\druid\query\context\ConcurrentResponseContext.java,0,10,0,3,0,13
 druid-master\druid-master\indexing-hadoop\src\main\java\org\apache\druid\indexer\path\StaticPathSpec.java,0,50,0,8,0,58
 druid-master\druid-master\server\src\main\java\org\apache\druid\indexing\overlord\supervisor\VersionedSupervisorSpec.java,0,23,0,3,0,26
 druid-master\druid-master\core\src\main\java\org\apache\druid\java\util\common\granularity\IntervalsByGranularity.java,0,19,0,11,0,30
 druid-master\druid-master\extensions-contrib\graphite-emitter\src\test\java\org\apache\druid\emitter\graphite\GraphiteEmitterConfigTest.java,0,26,0,13,0,39
 druid-master\druid-master\sql\src\main\java\org\apache\druid\sql\calcite\view\DruidViewModule.java,0,3,0,1,0,4
 druid-master\druid-master\benchmarks\src\test\java\org\apache\druid\benchmark\FlattenJSONBenchmark.java,0,52,1,6,0,59
 druid-master\druid-master\processing\src\main\java\org\apache\druid\query\groupby\epinephelinae\vector\GroupByVectorColumnProcessorFactory.java,0,27,1,14,0,42
 druid-master\druid-master\extensions-core\lookups-cached-single\src\main\java\org\apache\druid\server\lookup\jdbc\QueryKeys.java,0,16,0,5,0,21
 druid-master\druid-master\processing\src\main\java\org\apache\druid\query\aggregation\DoubleSumAggregateCombiner.java,0,7,0,1,0,8
 druid-master\druid-master\core\src\main\java\org\apache\druid\timeline\partition\BuildingHashBasedNumberedShardSpec.java,0,68,0,10,1,79
 druid-master\druid-master\server\src\test\java\org\apache\druid\client\CachingClusteredClientPerfTest.java,0,53,1,15,0,69
 druid-master\druid-master\server\src\main\java\org\apache\druid\server\coordinator\duty\KillAuditLog.java,0,23,0,8,0,31
 druid-master\druid-master\core\src\main\java\org\apache\druid\data\input\impl\CloudObjectInputSource.java,0,66,0,17,6,89
 druid-master\druid-master\sql\src\test\java\org\apache\druid\sql\avatica\DruidAvaticaProtobufHandlerTest.java,0,6,0,2,0,8
 druid-master\druid-master\extensions-core\druid-basic-security\src\main\java\org\apache\druid\security\basic\authentication\endpoint\BasicAuthenticatorResource.java,0,52,0,5,0,57
 druid-master\druid-master\processing\src\test\java\org\apache\druid\segment\IndexBuilder.java,0,82,3,15,0,100
 druid-master\druid-master\server\src\main\java\org\apache\druid\client\indexing\ClientCompactionTaskQuery.java,0,90,0,7,0,97
 druid-master\druid-master\core\src\test\java\org\apache\druid\data\input\impl\CSVParseSpecTest.java,0,4,0,2,1,7
 druid-master\druid-master\processing\src\main\java\org\apache\druid\segment\IndexMergerV9.java,0,319,12,135,0,466
 druid-master\druid-master\sql\src\test\java\org\apache\druid\sql\http\ResultFormatTest.java,0,15,1,5,0,21
 druid-master\druid-master\core\src\test\java\org\apache\druid\data\input\impl\JsonLineReaderTest.java,0,46,0,36,0,82
 druid-master\druid-master\processing\src\main\java\org\apache\druid\query\BadQueryException.java,0,14,0,4,0,18
 druid-master\druid-master\extensions-core\druid-pac4j\src\main\java\org\apache\druid\security\pac4j\CustomSSLResourceRetriever.java,0,13,0,4,0,17
 druid-master\druid-master\processing\src\main\java\org\apache\druid\segment\FloatWrappingDimensionSelector.java,0,16,0,3,0,19
 druid-master\druid-master\processing\src\test\java\org\apache\druid\segment\serde\LargeColumnSupportedComplexColumnSerializerTest.java,0,26,1,9,0,36
 druid-master\druid-master\core\src\main\java\org\apache\druid\java\util\common\MapUtils.java,0,26,1,4,0,31
 druid-master\druid-master\core\src\main\java\org\apache\druid\java\util\emitter\core\FeedUriExtractor.java,0,13,0,1,0,14
 druid-master\druid-master\server\src\main\java\org\apache\druid\server\coordinator\duty\CompactionSegmentSearchPolicy.java,0,6,0,2,0,8
 druid-master\druid-master\extensions-core\datasketches\src\test\java\org\apache\druid\query\aggregation\datasketches\quantiles\DoublesSketchToQuantilesPostAggregatorTest.java,0,26,1,5,0,32
 druid-master\druid-master\processing\src\main\java\org\apache\druid\query\DefaultGenericQueryMetricsFactory.java,0,9,0,3,0,12
 druid-master\druid-master\indexing-service\src\test\java\org\apache\druid\indexing\overlord\TestTaskRunner.java,0,132,7,30,0,169
 druid-master\druid-master\server\src\main\java\org\apache\druid\curator\announcement\Announcer.java,0,124,4,43,0,171
 druid-master\druid-master\server\src\main\java\org\apache\druid\segment\realtime\FireHydrant.java,0,76,1,16,0,93
 druid-master\druid-master\indexing-service\src\test\java\org\apache\druid\indexing\common\task\ShardSpecsTest.java,0,14,2,8,0,24
 druid-master\druid-master\services\src\main\java\org\apache\druid\guice\AbstractDruidServiceModule.java,0,24,0,5,0,29
 druid-master\druid-master\core\src\main\java\org\apache\druid\tasklogs\TaskLogKiller.java,0,3,0,1,0,4
 druid-master\druid-master\processing\src\main\java\org\apache\druid\query\aggregation\FilteredVectorAggregator.java,0,25,1,4,0,30
 druid-master\druid-master\processing\src\main\java\org\apache\druid\segment\incremental\IncrementalIndexSchema.java,0,98,0,2,0,100
 druid-master\druid-master\server\src\main\java\org\apache\druid\client\indexing\ClientCompactionTaskGranularitySpec.java,0,49,0,10,0,59
 druid-master\druid-master\server\src\main\java\org\apache\druid\guice\CoordinatorDiscoveryModule.java,0,10,0,2,0,12
 druid-master\druid-master\core\src\main\java\org\apache\druid\data\input\Committer.java,0,4,0,3,0,7
 druid-master\druid-master\indexing-service\src\main\java\org\apache\druid\indexing\common\Counters.java,0,15,0,5,0,20
 druid-master\druid-master\extensions-core\datasketches\src\main\java\org\apache\druid\query\aggregation\datasketches\quantiles\DoublesSketchToQuantilesPostAggregator.java,0,47,0,6,0,53
 druid-master\druid-master\processing\src\main\java\org\apache\druid\query\aggregation\LongMinBufferAggregator.java,0,11,0,1,0,12
 druid-master\druid-master\extensions-core\stats\src\main\java\org\apache\druid\query\aggregation\teststats\ZtestPostAggregator.java,0,93,2,19,0,114
 druid-master\druid-master\core\src\test\java\org\apache\druid\timeline\LogicalSegmentTest.java,0,14,0,3,2,19
 druid-master\druid-master\processing\src\test\java\org\apache\druid\query\aggregation\last\DoubleLastAggregationTest.java,0,90,0,15,0,105
 druid-master\druid-master\extensions-core\lookups-cached-global\src\test\java\org\apache\druid\query\lookup\namespace\JdbcExtractionNamespaceUrlCheckTest.java,0,111,0,17,0,128
 druid-master\druid-master\sql\src\test\java\org\apache\druid\sql\avatica\AvaticaModuleTest.java,0,66,1,24,0,91
 druid-master\druid-master\core\src\main\java\org\apache\druid\java\util\metrics\SigarUtil.java,0,16,1,6,0,23
 druid-master\druid-master\processing\src\main\java\org\apache\druid\segment\vector\BaseFloatVectorValueSelector.java,0,19,0,2,0,21
 druid-master\druid-master\extensions-core\hdfs-storage\src\test\java\org\apache\druid\storage\hdfs\HdfsDataSegmentPullerTest.java,0,41,7,8,0,56
 druid-master\druid-master\extensions-core\parquet-extensions\src\test\java\org\apache\druid\data\input\parquet\ParquetReaderResourceLeakTest.java,0,20,1,6,0,27
 druid-master\druid-master\indexing-service\src\main\java\org\apache\druid\indexing\common\task\batch\parallel\HttpShuffleClient.java,0,22,0,8,0,30
 druid-master\druid-master\core\src\main\java\org\apache\druid\java\util\common\guava\YieldingAccumulators.java,0,9,1,2,0,12
 druid-master\druid-master\sql\src\main\java\org\apache\druid\sql\SqlPlanningException.java,0,32,0,3,0,35
 druid-master\druid-master\services\src\test\java\org\apache\druid\cli\Log4JShutdownPropertyCheckerTest.java,0,4,1,1,0,6
 druid-master\druid-master\processing\src\test\java\org\apache\druid\query\aggregation\first\StringFirstTimeseriesQueryTest.java,0,36,0,19,0,55
 druid-master\druid-master\core\src\main\java\org\apache\druid\java\util\http\client\response\SequenceInputStreamResponseHandler.java,0,52,3,18,3,76
 druid-master\druid-master\processing\src\test\java\org\apache\druid\query\aggregation\post\ConstantPostAggregatorTest.java,0,16,0,4,0,20
 druid-master\druid-master\extensions-contrib\prometheus-emitter\src\test\java\org\apache\druid\emitter\prometheus\MetricsTest.java,0,9,0,5,0,14
 druid-master\druid-master\core\src\test\java\org\apache\druid\java\util\metrics\JvmMonitorTest.java,0,28,4,6,2,40
 druid-master\druid-master\processing\src\main\java\org\apache\druid\collections\bitmap\ConciseBitmapFactory.java,0,36,0,7,0,43
 druid-master\druid-master\indexing-service\src\main\java\org\apache\druid\indexing\common\task\batch\parallel\ParallelIndexTaskRunner.java,0,55,2,15,0,72
 druid-master\druid-master\core\src\main\java\org\apache\druid\data\input\StringTuple.java,0,36,0,1,2,39
 druid-master\druid-master\sql\src\test\java\org\apache\druid\sql\calcite\expression\ExpressionTestBase.java,0,6,0,1,0,7
 druid-master\druid-master\processing\src\main\java\org\apache\druid\collections\bitmap\MutableBitmap.java,0,2,0,2,0,4
 druid-master\druid-master\indexing-service\src\test\java\org\apache\druid\indexing\common\TestUtils.java,0,51,0,15,0,66
 druid-master\druid-master\server\src\main\java\org\apache\druid\server\http\SegmentListerResource.java,0,115,6,44,0,165
 druid-master\druid-master\core\src\main\java\org\apache\druid\indexer\partitions\DynamicPartitionsSpec.java,0,39,0,3,0,42
 druid-master\druid-master\server\src\main\java\org\apache\druid\metadata\DerbyMetadataStorageActionHandler.java,0,20,4,7,0,31
 druid-master\druid-master\sql\src\main\java\org\apache\druid\sql\calcite\planner\PlannerResult.java,0,15,0,2,0,17
 druid-master\druid-master\core\src\main\java\org\apache\druid\java\util\common\UnsafeUtils.java,0,17,2,5,1,25
 druid-master\druid-master\extensions-contrib\influx-extensions\target\generated-sources\antlr4\org\apache\druid\data\input\influx\InfluxLineProtocolBaseListener.java,148,51,24,19,0,94
 druid-master\druid-master\indexing-service\src\test\java\org\apache\druid\indexing\common\task\batch\parallel\SinglePhaseSubTaskSpecTest.java,0,10,0,2,0,12
 druid-master\druid-master\processing\src\main\java\org\apache\druid\segment\data\package-info.java,0,1,0,1,0,2
 druid-master\druid-master\extensions-core\lookups-cached-single\src\main\java\org\apache\druid\server\lookup\cache\loading\LookupCacheStats.java,0,69,0,20,0,89
 druid-master\druid-master\processing\src\main\java\org\apache\druid\query\spec\SpecificSegmentSpec.java,0,22,1,3,0,26
 druid-master\druid-master\processing\src\main\java\org\apache\druid\query\groupby\GroupByQueryMetrics.java,0,9,0,5,0,14
 druid-master\druid-master\indexing-service\src\main\java\org\apache\druid\indexing\worker\executor\ExecutorLifecycleConfig.java,0,26,0,1,0,27
 druid-master\druid-master\extensions-contrib\prometheus-emitter\src\test\java\org\apache\druid\emitter\prometheus\PrometheusEmitterTest.java,0,38,0,19,0,57
 druid-master\druid-master\processing\src\main\java\org\apache\druid\query\aggregation\cardinality\types\LongCardinalityAggregatorColumnSelectorStrategy.java,0,15,0,4,0,19
 druid-master\druid-master\indexing-service\src\main\java\org\apache\druid\indexing\overlord\IndexerMetadataStorageAdapter.java,0,19,0,6,0,25
 druid-master\druid-master\processing\src\main\java\org\apache\druid\query\aggregation\first\FloatFirstAggregator.java,0,18,0,2,0,20
 druid-master\druid-master\core\src\main\java\org\apache\druid\data\input\impl\NewSpatialDimensionSchema.java,0,25,0,4,2,31
 druid-master\druid-master\processing\src\main\java\org\apache\druid\segment\ConstantDimensionSelector.java,0,41,0,5,0,46
 druid-master\druid-master\processing\src\test\java\org\apache\druid\query\groupby\GroupByTimeseriesQueryRunnerTest.java,0,81,0,40,0,121
 druid-master\druid-master\extensions-core\lookups-cached-global\src\main\java\org\apache\druid\server\lookup\namespace\NamespaceExtractionConfig.java,0,21,0,3,0,24
 druid-master\druid-master\processing\src\test\java\org\apache\druid\query\aggregation\last\StringLastAggregationTest.java,0,68,1,16,0,85
 druid-master\druid-master\sql\src\main\java\org\apache\druid\sql\calcite\rule\ProjectAggregatePruneUnusedCallRule.java,0,14,1,8,0,23
 druid-master\druid-master\extensions-contrib\aliyun-oss-extensions\src\main\java\org\apache\druid\storage\aliyun\OssDataSegmentArchiver.java,0,28,0,5,0,33
 druid-master\druid-master\server\src\main\java\org\apache\druid\server\http\RulesResource.java,0,36,0,8,0,44
 druid-master\druid-master\processing\src\main\java\org\apache\druid\query\groupby\epinephelinae\column\DoubleGroupByColumnSelectorStrategy.java,0,49,0,10,0,59
 druid-master\druid-master\core\src\main\java\org\apache\druid\java\util\common\Numbers.java,0,46,0,11,0,57
 druid-master\druid-master\server\src\main\java\org\apache\druid\guice\security\AuthorizerModule.java,0,9,0,3,0,12
 druid-master\druid-master\server\src\main\java\org\apache\druid\server\coordinator\duty\CoordinatorCustomDutyGroups.java,0,13,0,1,0,14
 druid-master\druid-master\extensions-contrib\cloudfiles-extensions\src\main\java\org\apache\druid\storage\cloudfiles\CloudFilesUtils.java,0,18,1,4,0,23
 druid-master\druid-master\server\src\main\java\org\apache\druid\server\QueryLifecycleFactory.java,0,20,1,1,0,22
 druid-master\druid-master\processing\src\test\java\org\apache\druid\collections\bitmap\BitmapPeekableIteratorTest.java,0,16,0,2,0,18
 druid-master\druid-master\server\src\main\java\org\apache\druid\server\SetAndVerifyContextQueryRunner.java,0,28,0,8,0,36
 druid-master\druid-master\server\src\main\java\org\apache\druid\guice\DruidProcessingModule.java,0,55,1,18,0,74
 druid-master\druid-master\core\src\main\java\org\apache\druid\common\exception\SanitizableException.java,0,9,0,7,0,16
 druid-master\druid-master\extensions-core\google-extensions\src\test\java\org\apache\druid\storage\google\GoogleDataSegmentPusherTest.java,0,15,0,4,0,19
 druid-master\druid-master\server\src\main\java\org\apache\druid\client\DirectDruidClient.java,0,147,6,47,0,200
 druid-master\druid-master\extensions-contrib\moving-average-query\src\test\java\org\apache\druid\query\movingaverage\averagers\LongMeanAveragerFactoryTest.java,0,6,0,3,0,9
 druid-master\druid-master\extensions-contrib\aliyun-oss-extensions\src\main\java\org\apache\druid\data\input\aliyun\OssInputSource.java,0,47,0,9,0,56
 druid-master\druid-master\indexing-service\src\main\java\org\apache\druid\indexing\common\task\batch\parallel\distribution\StringSketch.java,0,85,0,20,0,105
 druid-master\druid-master\processing\src\test\java\org\apache\druid\segment\RowBasedColumnSelectorFactoryTest.java,0,52,0,22,0,74
 druid-master\druid-master\processing\src\main\java\org\apache\druid\segment\writeout\TmpFileSegmentWriteOutMediumFactory.java,0,10,0,4,0,14
 druid-master\druid-master\extensions-core\druid-kerberos\src\main\java\org\apache\druid\security\kerberos\KerberosAuthenticator.java,0,156,8,50,0,214
 druid-master\druid-master\integration-tests\src\main\java\org\apache\druid\testing\clients\ClientInfoResourceTestClient.java,0,19,0,1,0,20
 druid-master\druid-master\processing\src\main\java\org\apache\druid\segment\virtual\SingleStringInputCachingExpressionColumnValueSelector.java,0,46,0,10,0,56
 druid-master\druid-master\processing\src\test\java\org\apache\druid\segment\filter\OrFilterTest.java,0,43,0,5,0,48
 druid-master\druid-master\processing\src\main\java\org\apache\druid\guice\annotations\Merging.java,0,2,0,1,0,3
 druid-master\druid-master\integration-tests\src\main\java\org\apache\druid\testing\utils\SyntheticStreamGenerator.java,0,57,3,24,0,84
 druid-master\druid-master\core\src\main\java\org\apache\druid\indexer\partitions\HashedPartitionsSpec.java,0,90,1,17,1,109
 druid-master\druid-master\processing\src\main\java\org\apache\druid\query\MetricValueExtractor.java,0,34,1,1,0,36
 druid-master\druid-master\server\src\main\java\org\apache\druid\metadata\input\SqlInputFormat.java,0,14,0,2,0,16
 druid-master\druid-master\processing\src\test\java\org\apache\druid\query\expression\ContainsExprMacroTest.java,0,37,0,15,0,52
 druid-master\druid-master\server\src\main\java\org\apache\druid\client\BatchServerInventoryView.java,0,135,7,33,0,175
 druid-master\druid-master\core\src\test\java\org\apache\druid\collections\StupidResourceHolderTest.java,0,4,1,1,0,6
 druid-master\druid-master\core\src\main\java\org\apache\druid\math\expr\CartesianList.java,0,33,1,9,0,43
 druid-master\druid-master\sql\src\main\java\org\apache\druid\sql\calcite\expression\builtin\DateTruncOperatorConversion.java,0,16,0,6,0,22
 druid-master\druid-master\core\src\main\java\org\apache\druid\guice\annotations\Global.java,0,1,0,1,0,2
 druid-master\druid-master\sql\src\main\java\org\apache\druid\sql\calcite\expression\BinaryOperatorConversion.java,0,21,0,4,0,25
 druid-master\druid-master\extensions-core\histogram\src\main\java\org\apache\druid\query\aggregation\histogram\Histogram.java,0,29,2,2,0,33
 druid-master\druid-master\sql\src\main\java\org\apache\druid\sql\http\SqlResource.java,0,76,3,25,0,104
 druid-master\druid-master\core\src\test\java\org\apache\druid\data\input\impl\HttpInputSourceTest.java,0,12,0,5,0,17
 druid-master\druid-master\indexing-hadoop\src\main\java\org\apache\druid\indexer\InputRowSerde.java,0,131,3,24,0,158
 druid-master\druid-master\indexing-service\src\test\java\org\apache\druid\indexing\common\RetryPolicyTest.java,0,10,0,7,0,17
 druid-master\druid-master\processing\src\main\java\org\apache\druid\query\groupby\ResultRow.java,0,44,0,8,0,52
 druid-master\druid-master\extensions-core\druid-kerberos\src\main\java\org\apache\druid\security\kerberos\DruidKerberosUtil.java,0,43,1,16,0,60
 druid-master\druid-master\server\src\main\java\org\apache\druid\server\http\RedirectInfo.java,0,3,0,1,0,4
 druid-master\druid-master\extensions-core\datasketches\src\main\java\org\apache\druid\query\aggregation\datasketches\hll\sql\HllSketchEstimateWithErrorBoundsOperatorConversion.java,0,19,0,5,0,24
 druid-master\druid-master\server\src\main\java\org\apache\druid\server\security\NoopEscalator.java,0,15,0,1,0,16
 druid-master\druid-master\processing\src\main\java\org\apache\druid\query\aggregation\first\StringFirstAggregatorFactory.java,0,100,1,15,0,116
 druid-master\druid-master\sql\src\main\java\org\apache\druid\sql\calcite\run\NativeQueryMakerFactory.java,0,13,0,2,0,15
 druid-master\druid-master\integration-tests\src\test\java\org\apache\druid\tests\indexer\ITHdfsToAzureParallelIndexTest.java,0,9,0,6,0,15
 druid-master\druid-master\processing\src\main\java\org\apache\druid\query\expression\TimestampShiftExprMacro.java,0,47,0,12,0,59
 druid-master\druid-master\processing\src\test\java\org\apache\druid\segment\incremental\OnheapIncrementalIndexBenchmark.java,0,88,1,31,0,120
 druid-master\druid-master\sql\src\main\java\org\apache\druid\sql\calcite\aggregation\builtin\StringSqlAggregator.java,0,36,0,14,0,50
 druid-master\druid-master\processing\src\test\java\org\apache\druid\query\filter\ColumnComparisonDimFilterTest.java,0,15,0,9,0,24
 druid-master\druid-master\processing\src\main\java\org\apache\druid\segment\transform\TransformingStringInputRowParser.java,0,17,0,3,0,20
 druid-master\druid-master\processing\src\test\java\org\apache\druid\query\PrioritizedExecutorServiceTest.java,0,88,2,17,0,107
 druid-master\druid-master\core\src\main\java\org\apache\druid\timeline\SegmentWithOvershadowedStatus.java,0,39,2,8,0,49
 druid-master\druid-master\server\src\main\java\org\apache\druid\segment\realtime\firehose\EventReceiver.java,0,2,0,1,0,3
 druid-master\druid-master\extensions-core\postgresql-metadata-storage\src\main\java\org\apache\druid\metadata\storage\postgresql\PostgreSQLTablesConfig.java,0,9,0,1,0,10
 druid-master\druid-master\extensions-contrib\moving-average-query\src\main\java\org\apache\druid\query\movingaverage\averagers\BaseAverager.java,0,54,0,19,0,73
 druid-master\druid-master\server\src\main\java\org\apache\druid\server\log\FileRequestLoggerProvider.java,0,9,0,1,0,10
 druid-master\druid-master\extensions-core\lookups-cached-single\src\test\java\org\apache\druid\server\lookup\cache\loading\OnHeapLoadingCacheTest.java,0,9,0,2,0,11
 druid-master\druid-master\extensions-core\s3-extensions\src\main\java\org\apache\druid\storage\s3\S3DataSegmentPuller.java,0,71,4,21,0,96
 druid-master\druid-master\core\src\test\java\org\apache\druid\java\util\metrics\BasicMonitorSchedulerTest.java,0,27,3,6,1,37
 druid-master\druid-master\indexing-service\src\main\java\org\apache\druid\indexing\overlord\RemoteTaskRunnerWorkItem.java,0,86,0,4,0,90
 druid-master\druid-master\processing\src\test\java\org\apache\druid\query\ResultGranularTimestampComparatorTest.java,0,28,0,9,0,37
 druid-master\druid-master\extensions-core\kubernetes-extensions\src\main\java\org\apache\druid\k8s\discovery\DefaultK8sApiClient.java,0,58,1,16,0,75
 druid-master\druid-master\server\src\main\java\org\apache\druid\client\cache\MemcacheClientPool.java,0,45,0,11,0,56
 druid-master\druid-master\server\src\main\java\org\apache\druid\server\coordinator\KillStalePendingSegments.java,0,21,1,10,0,32
 druid-master\druid-master\sql\src\test\java\org\apache\druid\sql\calcite\http\SqlQueryTest.java,0,9,0,4,0,13
 druid-master\druid-master\core\src\test\java\org\apache\druid\collections\SerializablePairTest.java,0,12,0,3,0,15
 druid-master\druid-master\extensions-contrib\momentsketch\src\main\java\org\apache\druid\query\aggregation\momentsketch\aggregator\MomentSketchMinPostAggregator.java,0,38,1,3,0,42
 druid-master\druid-master\server\src\test\java\org\apache\druid\server\coordinator\CoordinatorStatsTest.java,0,41,0,1,0,42
 druid-master\druid-master\server\src\main\java\org\apache\druid\server\http\OverlordProxyServlet.java,0,26,0,4,0,30
 druid-master\druid-master\server\src\test\java\org\apache\druid\server\coordinator\rules\BroadcastDistributionRuleSerdeTest.java,0,19,0,4,0,23
 druid-master\druid-master\extensions-core\datasketches\src\main\java\org\apache\druid\query\aggregation\datasketches\quantiles\DoublesSketchBuildVectorAggregator.java,0,21,0,5,0,26
 druid-master\druid-master\processing\src\main\java\org\apache\druid\segment\join\JoinableFactoryWrapper.java,0,60,1,40,0,101
 druid-master\druid-master\extensions-contrib\virtual-columns\src\test\java\org\apache\druid\segment\MapVirtualColumnTestBase.java,0,8,0,2,0,10
 druid-master\druid-master\core\src\main\java\org\apache\druid\math\expr\Exprs.java,0,22,1,5,0,28
 druid-master\druid-master\core\src\test\java\org\apache\druid\math\expr\ParserTest.java,0,256,0,101,2,359
 druid-master\druid-master\extensions-core\datasketches\src\test\java\org\apache\druid\query\aggregation\datasketches\hll\HllSketchToEstimatePostAggregatorTest.java,0,10,0,2,0,12
 druid-master\druid-master\integration-tests\src\main\java\org\apache\druid\testing\utils\KafkaUtil.java,0,18,1,7,0,26
 druid-master\druid-master\core\src\main\java\org\apache\druid\math\expr\ExpressionTypeConversion.java,0,67,3,25,0,95
 druid-master\druid-master\services\src\main\java\org\apache\druid\server\router\PriorityTieredBrokerSelectorStrategy.java,0,15,0,3,0,18
 druid-master\druid-master\server\src\main\java\org\apache\druid\server\router\RendezvousHashAvaticaConnectionBalancer.java,0,8,0,3,0,11
 druid-master\druid-master\services\src\main\java\org\apache\druid\server\router\TieredBrokerHostSelector.java,0,93,4,20,0,117
 druid-master\druid-master\extensions-core\druid-bloom-filter\src\test\java\org\apache\druid\query\expressions\BloomFilterExpressionsTest.java,0,68,0,26,0,94
 druid-master\druid-master\extensions-core\google-extensions\src\main\java\org\apache\druid\storage\google\GoogleByteSource.java,0,28,0,2,0,30
 druid-master\druid-master\server\src\main\java\org\apache\druid\indexing\overlord\supervisor\SupervisorStatus.java,0,104,0,4,0,108
 druid-master\druid-master\core\src\main\java\org\apache\druid\guice\annotations\PublicApi.java,0,13,0,13,0,26
 druid-master\druid-master\extensions-core\kafka-indexing-service\src\test\java\org\apache\druid\indexing\kafka\KafkaSamplerSpecTest.java,0,53,2,11,0,66
 druid-master\druid-master\extensions-core\lookups-cached-global\src\test\java\org\apache\druid\server\lookup\namespace\NamespacedExtractorModuleTest.java,0,27,0,9,0,36
 druid-master\druid-master\processing\src\main\java\org\apache\druid\query\search\SearchHit.java,0,44,1,3,0,48
 druid-master\druid-master\extensions-core\lookups-cached-global\src\test\java\org\apache\druid\server\lookup\namespace\cache\NamespaceExtractionCacheManagersTest.java,0,26,2,5,0,33
 druid-master\druid-master\processing\src\main\java\org\apache\druid\segment\transform\ExpressionTransform.java,0,40,0,4,0,44
 druid-master\druid-master\benchmarks\src\test\java\org\apache\druid\benchmark\query\timecompare\TimeCompareBenchmark.java,0,62,11,16,0,89
 druid-master\druid-master\sql\src\main\java\org\apache\druid\sql\calcite\expression\TimeUnits.java,0,7,1,3,0,11
 druid-master\druid-master\server\src\main\java\org\apache\druid\segment\realtime\plumber\NoopRejectionPolicyFactory.java,0,8,0,1,0,9
 druid-master\druid-master\processing\src\main\java\org\apache\druid\query\scan\ScanQueryRunnerFactory.java,0,105,2,55,0,162
 druid-master\druid-master\server\src\test\java\org\apache\druid\curator\CuratorConfigTest.java,0,4,0,1,0,5
 druid-master\druid-master\processing\src\main\java\org\apache\druid\query\aggregation\post\JavaScriptPostAggregator.java,0,64,2,12,0,78
 druid-master\druid-master\benchmarks\src\test\java\org\apache\druid\benchmark\query\ScanBenchmark.java,0,110,4,37,0,151
 druid-master\druid-master\server\src\test\java\org\apache\druid\segment\realtime\firehose\HttpFirehoseFactoryTest.java,0,12,0,5,0,17
 druid-master\druid-master\extensions-contrib\moving-average-query\src\main\java\org\apache\druid\query\movingaverage\averagers\ConstantAveragerFactory.java,0,31,0,1,0,32
 druid-master\druid-master\extensions-core\datasketches\src\main\java\org\apache\druid\query\aggregation\datasketches\quantiles\NoopDoublesSketchAggregator.java,0,9,2,1,0,12
 druid-master\druid-master\processing\src\main\java\org\apache\druid\collections\spatial\ImmutableRTree.java,0,47,0,6,0,53
 druid-master\druid-master\processing\src\main\java\org\apache\druid\collections\spatial\search\GutmanSearchStrategy.java,0,55,0,5,0,60
 druid-master\druid-master\processing\src\main\java\org\apache\druid\query\topn\TopNLexicographicResultBuilder.java,0,77,2,19,0,98
 druid-master\druid-master\processing\src\main\java\org\apache\druid\segment\BaseObjectColumnValueSelector.java,0,8,0,5,0,13
 druid-master\druid-master\sql\src\main\java\org\apache\druid\sql\calcite\expression\builtin\RepeatOperatorConversion.java,0,6,0,1,0,7
 druid-master\druid-master\processing\src\test\java\org\apache\druid\query\extraction\FunctionalExtractionTest.java,0,71,1,13,0,85
 druid-master\druid-master\extensions-contrib\time-min-max\src\main\java\org\apache\druid\query\aggregation\TimestampBufferAggregator.java,0,45,1,3,0,49
 druid-master\druid-master\extensions-contrib\materialized-view-maintenance\src\test\java\org\apache\druid\indexing\materializedview\MaterializedViewSupervisorSpecTest.java,0,91,4,19,0,114
 druid-master\druid-master\server\src\test\java\org\apache\druid\server\coordinator\duty\NewestSegmentFirstIteratorTest.java,0,48,0,19,0,67
 druid-master\druid-master\extensions-contrib\tdigestsketch\src\main\java\org\apache\druid\query\aggregation\tdigestsketch\TDigestSketchJsonSerializer.java,0,6,0,1,0,7
 druid-master\druid-master\processing\src\main\java\org\apache\druid\segment\virtual\ListFilteredVirtualColumn.java,0,118,3,10,0,131
 druid-master\druid-master\server\src\main\java\org\apache\druid\initialization\ExtensionFirstClassLoader.java,0,20,0,6,0,26
 druid-master\druid-master\extensions-core\kafka-indexing-service\src\test\java\org\apache\druid\indexing\kafka\KafkaIndexTaskClientTest.java,0,218,1,101,0,320
 druid-master\druid-master\processing\src\test\java\org\apache\druid\segment\data\CompressedFloatsSerdeTest.java,0,71,0,16,0,87
 druid-master\druid-master\core\src\main\java\org\apache\druid\segment\loading\URIDataPuller.java,0,5,0,3,0,8
 druid-master\druid-master\processing\src\test\java\org\apache\druid\query\TestBigDecimalSumAggregatorFactory.java,0,18,0,2,0,20
 druid-master\druid-master\extensions-core\lookups-cached-single\src\test\java\org\apache\druid\server\lookup\PollingLookupSerDeserTest.java,0,27,3,4,0,34
 druid-master\druid-master\indexing-service\src\test\java\org\apache\druid\indexing\common\task\batch\parallel\iterator\DefaultIndexTaskInputRowIteratorBuilderTest.java,0,37,0,18,0,55
 druid-master\druid-master\server\src\test\java\org\apache\druid\server\coordinator\rules\PeriodLoadRuleTest.java,0,37,0,24,0,61
 druid-master\druid-master\processing\src\main\java\org\apache\druid\query\dimension\LookupDimensionSpec.java,0,79,1,13,0,93
 druid-master\druid-master\server\src\test\java\org\apache\druid\server\coordinator\rules\PeriodDropBeforeRuleTest.java,0,11,0,5,0,16
 druid-master\druid-master\indexing-service\src\main\java\org\apache\druid\indexing\common\SegmentCacheManagerFactory.java,0,10,0,2,0,12
 druid-master\druid-master\server\src\main\java\org\apache\druid\segment\realtime\plumber\IntervalStartVersioningPolicy.java,0,4,0,1,0,5
 druid-master\druid-master\core\src\main\java\org\apache\druid\data\input\impl\JsonReader.java,0,45,0,19,0,64
 druid-master\druid-master\server\src\test\java\org\apache\druid\server\initialization\JettyQosTest.java,0,31,2,10,0,43
 druid-master\druid-master\server\src\main\java\org\apache\druid\server\initialization\jetty\JettyServerModule.java,0,154,8,55,0,217
 druid-master\druid-master\extensions-core\datasketches\src\main\java\org\apache\druid\query\aggregation\datasketches\hll\HllSketchBuildAggregatorFactory.java,0,31,0,11,0,42
 druid-master\druid-master\server\src\main\java\org\apache\druid\server\initialization\jetty\BadRequestExceptionMapper.java,0,5,0,2,0,7
 druid-master\druid-master\processing\src\main\java\org\apache\druid\segment\transform\TransformingInputEntityReader.java,0,15,0,3,0,18
 druid-master\druid-master\indexing-service\src\test\java\org\apache\druid\indexing\worker\shuffle\ShuffleMonitorTest.java,0,13,0,7,0,20
 druid-master\druid-master\core\src\test\java\org\apache\druid\java\util\common\BufferUtils.java,0,6,0,2,0,8
 druid-master\druid-master\processing\src\main\java\org\apache\druid\query\GlobalTableDataSource.java,0,19,0,7,0,26
 druid-master\druid-master\indexing-service\src\main\java\org\apache\druid\indexing\overlord\autoscaling\ProvisioningUtil.java,0,16,1,5,0,22
 druid-master\druid-master\extensions-core\druid-pac4j\src\test\java\org\apache\druid\security\pac4j\OIDCConfigTest.java,0,5,0,2,0,7
 druid-master\druid-master\extensions-core\stats\src\test\java\org\apache\druid\query\aggregation\variance\VarianceSerdeTest.java,0,5,0,2,0,7
 druid-master\druid-master\sql\src\test\java\org\apache\druid\sql\calcite\CalciteParameterQueryTest.java,0,118,0,40,0,158
 druid-master\druid-master\extensions-core\datasketches\src\test\java\org\apache\druid\query\aggregation\datasketches\quantiles\DoublesSketchToHistogramPostAggregatorTest.java,0,28,2,5,0,35
 druid-master\druid-master\server\src\test\java\org\apache\druid\segment\loading\SegmentLocalCacheManagerTest.java,0,264,3,188,0,455
 druid-master\druid-master\server\src\main\java\org\apache\druid\segment\handoff\SegmentHandoffNotifierFactory.java,0,2,0,1,0,3
 druid-master\druid-master\processing\src\main\java\org\apache\druid\query\aggregation\StringColumnDoubleAggregatorWrapper.java,0,14,0,3,0,17
 druid-master\druid-master\extensions-core\google-extensions\src\test\java\org\apache\druid\storage\google\GoogleDataSegmentKillerTest.java,0,66,4,27,0,97
 druid-master\druid-master\processing\src\main\java\org\apache\druid\segment\generator\GeneratorBasicSchemas.java,0,447,0,151,0,598
 druid-master\druid-master\benchmarks\src\test\java\org\apache\druid\benchmark\compression\ColumnarLongsSelectRowsFromGeneratorBenchmark.java,0,29,1,6,0,36
 druid-master\druid-master\indexing-service\src\test\java\org\apache\druid\indexing\overlord\sampler\IndexTaskSamplerSpecTest.java,0,18,0,9,0,27
 druid-master\druid-master\server\src\main\java\org\apache\druid\guice\annotations\RemoteChatHandler.java,0,1,0,1,0,2
 druid-master\druid-master\processing\src\main\java\org\apache\druid\query\aggregation\first\StringFirstAggregator.java,0,37,0,8,0,45
 druid-master\druid-master\server\src\test\java\org\apache\druid\server\http\LookupCoordinatorResourceTest.java,0,307,13,170,0,490
 druid-master\druid-master\server\src\main\java\org\apache\druid\server\security\Action.java,0,6,0,1,0,7
 druid-master\druid-master\server\src\test\java\org\apache\druid\server\coordinator\rules\ForeverLoadRuleTest.java,0,18,2,10,0,30
 druid-master\druid-master\server\src\test\java\org\apache\druid\segment\realtime\appenderator\StreamAppenderatorTester.java,0,69,2,8,0,79
 druid-master\druid-master\core\src\main\java\org\apache\druid\java\util\common\guava\MergeIterator.java,0,17,0,1,0,18
 druid-master\druid-master\extensions-core\datasketches\src\main\java\org\apache\druid\query\aggregation\datasketches\theta\SketchEstimatePostAggregator.java,0,60,0,5,0,65
 druid-master\druid-master\processing\src\main\java\org\apache\druid\query\aggregation\LongSumAggregator.java,0,26,0,1,0,27
 druid-master\druid-master\core\src\main\java\org\apache\druid\guice\ManageLifecycleServer.java,0,3,0,3,0,6
 druid-master\druid-master\core\src\test\java\org\apache\druid\java\util\common\lifecycle\LifecycleTest.java,0,88,2,19,0,109
 druid-master\druid-master\server\src\main\java\org\apache\druid\guice\http\HttpClientModule.java,0,41,0,9,0,50
 druid-master\druid-master\extensions-core\google-extensions\src\main\java\org\apache\druid\storage\google\GoogleTaskLogsConfig.java,0,16,0,2,0,18
 druid-master\druid-master\extensions-core\druid-bloom-filter\src\main\java\org\apache\druid\query\aggregation\bloom\LongBloomFilterAggregator.java,0,9,0,3,0,12
 druid-master\druid-master\core\src\main\java\org\apache\druid\java\util\http\client\response\StringFullResponseHandler.java,0,28,0,8,0,36
 druid-master\druid-master\core\src\main\java\org\apache\druid\segment\column\ColumnTypeFactory.java,0,31,2,8,0,41
 druid-master\druid-master\processing\src\main\java\org\apache\druid\query\scan\ScanQueryEngine.java,0,64,3,40,0,107
 druid-master\druid-master\processing\src\main\java\org\apache\druid\segment\data\BlockLayoutColumnarDoublesSupplier.java,0,47,1,6,0,54
 druid-master\druid-master\processing\src\main\java\org\apache\druid\query\metadata\SegmentMetadataQueryRunnerFactory.java,0,54,3,21,0,78
 druid-master\druid-master\indexing-service\src\test\java\org\apache\druid\indexing\common\task\batch\parallel\HashPartitionTaskKillTest.java,0,120,8,35,0,163
 druid-master\druid-master\extensions-contrib\moving-average-query\src\test\java\org\apache\druid\query\movingaverage\averagers\LongMaxAveragerTest.java,0,11,0,2,0,13
 druid-master\druid-master\server\src\test\java\org\apache\druid\indexing\NoopSupervisorSpecTest.java,0,7,1,4,0,12
 druid-master\druid-master\benchmarks\src\test\java\org\apache\druid\benchmark\sequences\BaseParallelMergeCombiningSequenceBenchmark.java,0,65,0,16,0,81
 druid-master\druid-master\processing\src\main\java\org\apache\druid\segment\incremental\AppendableIndexBuilder.java,0,67,0,14,0,81
 druid-master\druid-master\extensions-core\datasketches\src\test\java\org\apache\druid\query\aggregation\datasketches\tuple\ArrayOfDoublesSketchToVariancesPostAggregatorTest.java,0,18,0,7,0,25
 druid-master\druid-master\processing\src\main\java\org\apache\druid\segment\serde\DoubleNumericColumnPartSerde.java,0,35,0,4,0,39
 druid-master\druid-master\extensions-core\datasketches\src\test\java\org\apache\druid\query\aggregation\datasketches\util\ToObjectVectorColumnProcessorFactoryTest.java,0,71,8,13,0,92
 druid-master\druid-master\extensions-core\azure-extensions\src\main\java\org\apache\druid\storage\azure\AzureCloudBlobIteratorFactory.java,0,3,0,1,0,4
 druid-master\druid-master\core\src\main\java\org\apache\druid\java\util\common\io\NativeIO.java,0,65,11,14,1,91
 druid-master\druid-master\server\src\main\java\org\apache\druid\client\indexing\QueryStatus.java,0,30,0,1,0,31
 druid-master\druid-master\processing\src\main\java\org\apache\druid\segment\column\package-info.java,0,1,0,1,0,2
 druid-master\druid-master\sql\src\main\java\org\apache\druid\sql\calcite\schema\RootSchemaProvider.java,0,12,0,6,0,18
 druid-master\druid-master\processing\src\main\java\org\apache\druid\segment\serde\ComplexColumnPartSerde.java,0,38,0,4,0,42
 druid-master\druid-master\processing\src\main\java\org\apache\druid\query\aggregation\cardinality\vector\LongCardinalityVectorProcessor.java,0,32,0,14,0,46
 druid-master\druid-master\sql\src\main\java\org\apache\druid\sql\calcite\expression\builtin\MillisToTimestampOperatorConversion.java,0,9,0,4,0,13
 druid-master\druid-master\core\src\main\java\org\apache\druid\math\expr\UnaryOperatorExpr.java,0,52,2,6,0,60
 druid-master\druid-master\processing\src\test\java\org\apache\druid\query\aggregation\last\StringLastBufferAggregatorTest.java,0,43,11,22,0,76
 druid-master\druid-master\sql\src\main\java\org\apache\druid\sql\calcite\aggregation\builtin\ArraySqlAggregator.java,0,32,0,10,0,42
 druid-master\druid-master\sql\src\test\java\org\apache\druid\sql\calcite\expression\IPv4AddressStringifyExpressionTest.java,0,54,5,8,0,67
 druid-master\druid-master\indexing-service\src\test\java\org\apache\druid\indexing\overlord\PortFinderTest.java,0,18,0,3,0,21
 druid-master\druid-master\processing\src\test\java\org\apache\druid\segment\filter\NotFilterEvaluateTest.java,0,16,0,2,0,18
 druid-master\druid-master\processing\src\test\java\org\apache\druid\segment\transform\TransformSpecTest.java,0,44,0,24,0,68
 druid-master\druid-master\server\src\test\java\org\apache\druid\segment\loading\StorageLocationSelectorStrategyTest.java,0,126,0,79,0,205
 druid-master\druid-master\server\src\test\java\org\apache\druid\segment\realtime\appenderator\ClosedSegmensSinksBatchAppenderatorTester.java,0,156,0,13,0,169
 druid-master\druid-master\integration-tests\src\main\java\org\apache\druid\testing\guice\TestClient.java,0,1,0,1,0,2
 druid-master\druid-master\server\src\main\java\org\apache\druid\query\lookup\MapLookupExtractorFactory.java,0,45,0,3,0,48
 druid-master\druid-master\extensions-contrib\materialized-view-maintenance\src\test\java\org\apache\druid\indexing\materializedview\DerivativeDataSourceMetadataTest.java,0,13,2,7,0,22
 druid-master\druid-master\processing\src\main\java\org\apache\druid\segment\serde\LongNumericColumnPartSerdeV2.java,0,58,0,10,0,68
 druid-master\druid-master\extensions-core\kafka-indexing-service\src\test\java\org\apache\druid\indexing\kafka\test\TestModifiedKafkaIndexTaskTuningConfig.java,0,40,0,12,0,52
 druid-master\druid-master\core\src\test\java\org\apache\druid\math\expr\ExprTest.java,0,70,0,16,0,86
 druid-master\druid-master\extensions-core\datasketches\src\main\java\org\apache\druid\query\aggregation\datasketches\tuple\ArrayOfDoublesSketchUnaryPostAggregator.java,0,24,0,3,0,27
 druid-master\druid-master\extensions-core\kafka-indexing-service\src\main\java\org\apache\druid\indexing\kafka\KafkaConsumerConfigs.java,0,5,1,1,0,7
 druid-master\druid-master\processing\src\test\java\org\apache\druid\collections\spatial\split\LinearGutmanSplitStrategyTest.java,0,42,0,3,0,45
 druid-master\druid-master\server\src\main\java\org\apache\druid\server\security\AnonymousAuthenticator.java,0,34,4,4,0,42
 druid-master\druid-master\extensions-contrib\graphite-emitter\src\test\java\org\apache\druid\emitter\graphite\WhiteListBasedConverterTest.java,0,51,5,27,0,83
 druid-master\druid-master\server\src\test\java\org\apache\druid\client\CoordinatorServerViewTest.java,0,103,0,39,0,142
 druid-master\druid-master\core\src\main\java\org\apache\druid\math\expr\vector\DoubleOutDoubleInFunctionVectorValueProcessor.java,0,16,0,4,0,20
 druid-master\druid-master\integration-tests\src\test\java\org\apache\druid\tests\indexer\ITRealtimeIndexTaskTest.java,0,37,0,14,0,51
 druid-master\druid-master\extensions-core\datasketches\src\main\java\org\apache\druid\query\aggregation\datasketches\quantiles\DoublesSketchJsonSerializer.java,0,4,0,2,0,6
 druid-master\druid-master\processing\src\main\java\org\apache\druid\query\aggregation\any\NumericAnyVectorAggregator.java,0,59,0,11,0,70
 druid-master\druid-master\extensions-contrib\momentsketch\src\main\java\org\apache\druid\query\aggregation\momentsketch\aggregator\MomentSketchMergeAggregatorFactory.java,0,14,0,7,0,21
 druid-master\druid-master\processing\src\main\java\org\apache\druid\query\filter\SelectorPredicateFactory.java,0,28,3,3,0,34
 druid-master\druid-master\extensions-contrib\momentsketch\src\main\java\org\apache\druid\query\aggregation\momentsketch\aggregator\MomentSketchAggregatorFactory.java,0,98,0,19,0,117
 druid-master\druid-master\processing\src\main\java\org\apache\druid\segment\StringDimensionHandler.java,0,56,0,14,0,70
 druid-master\druid-master\server\src\main\java\org\apache\druid\guice\SQLMetadataStorageDruidModule.java,0,37,0,22,0,59
 druid-master\druid-master\extensions-core\histogram\src\main\java\org\apache\druid\query\aggregation\histogram\ApproximateHistogramFoldingVectorAggregator.java,0,33,0,6,0,39
 druid-master\druid-master\processing\src\test\java\org\apache\druid\query\aggregation\mean\DoubleMeanAggregatorFactoryTest.java,0,29,0,15,0,44
 druid-master\druid-master\core\src\main\java\org\apache\druid\data\input\impl\StringDimensionSchema.java,0,18,0,2,0,20
 druid-master\druid-master\server\src\main\java\org\apache\druid\server\ClientInfoResource.java,0,73,3,17,0,93
 druid-master\druid-master\core\src\test\java\org\apache\druid\data\input\MapBasedRowTest.java,0,15,0,1,0,16
 druid-master\druid-master\extensions-contrib\ambari-metrics-emitter\src\main\java\org\apache\druid\emitter\ambari\metrics\AmbariMetricsEmitterConfig.java,0,120,0,15,0,135
 druid-master\druid-master\extensions-contrib\aliyun-oss-extensions\src\main\java\org\apache\druid\storage\aliyun\OssInputDataConfig.java,0,10,0,1,0,11
 druid-master\druid-master\processing\src\main\java\org\apache\druid\query\ConcatQueryRunner.java,0,12,0,2,0,14
 druid-master\druid-master\processing\src\main\java\org\apache\druid\query\metadata\metadata\ListColumnIncluderator.java,0,18,0,2,0,20
 druid-master\druid-master\processing\src\main\java\org\apache\druid\collections\bitmap\WrappedImmutableConciseBitmap.java,0,30,0,3,0,33
 druid-master\druid-master\processing\src\main\java\org\apache\druid\segment\ColumnInspector.java,0,5,0,2,0,7
 druid-master\druid-master\indexing-service\src\main\java\org\apache\druid\indexing\common\task\AbstractBatchIndexTask.java,0,312,4,158,0,474
 druid-master\druid-master\server\src\main\java\org\apache\druid\server\initialization\jetty\ChatHandlerServerModule.java,0,32,1,10,0,43
 druid-master\druid-master\services\src\main\java\org\apache\druid\cli\convert\ChatHandlerConverter.java,0,10,0,2,0,12
 druid-master\druid-master\processing\src\main\java\org\apache\druid\query\expression\CaseInsensitiveContainsExprMacro.java,0,10,0,4,0,14
 druid-master\druid-master\indexing-service\src\test\java\org\apache\druid\indexing\overlord\setup\EqualDistributionWithCategorySpecWorkerSelectStrategyTest.java,0,17,1,4,0,22
 druid-master\druid-master\core\src\test\java\org\apache\druid\collections\IteratorShell.java,0,12,0,1,0,13
 druid-master\druid-master\extensions-core\google-extensions\src\main\java\org\apache\druid\firehose\google\GoogleBlob.java,0,25,0,2,0,27
 druid-master\druid-master\extensions-core\kinesis-indexing-service\src\test\java\org\apache\druid\indexing\kinesis\supervisor\KinesisSupervisorTest.java,0,1242,0,826,0,2068
 druid-master\druid-master\indexing-service\src\main\java\org\apache\druid\indexing\seekablestream\supervisor\SeekableStreamSupervisorReportPayload.java,0,113,2,2,0,117
 druid-master\druid-master\extensions-core\azure-extensions\src\main\java\org\apache\druid\storage\azure\AzureCloudBlobHolderToCloudObjectLocationConverter.java,0,10,0,5,0,15
 druid-master\druid-master\extensions-core\histogram\src\test\java\org\apache\druid\query\aggregation\histogram\sql\QuantileSqlAggregatorTest.java,0,111,0,50,0,161
 druid-master\druid-master\indexing-service\src\test\java\org\apache\druid\indexing\common\IndexTaskClientTest.java,0,83,1,36,0,120
 druid-master\druid-master\extensions-contrib\influx-extensions\target\generated-sources\antlr4\org\apache\druid\data\input\influx\InfluxLineProtocolParser.java,634,603,3,38,3,647
 druid-master\druid-master\extensions-core\datasketches\src\test\java\org\apache\druid\query\aggregation\datasketches\tuple\ArrayOfDoublesSketchSetOpPostAggregatorTest.java,0,47,1,26,0,74
 druid-master\druid-master\processing\src\main\java\org\apache\druid\query\dimension\LegacyDimensionSpec.java,0,9,0,3,0,12
 druid-master\druid-master\server\src\test\java\org\apache\druid\client\HttpServerInventoryViewTest.java,0,55,2,16,0,73
 druid-master\druid-master\processing\src\main\java\org\apache\druid\query\topn\Generic1AggPooledTopNScanner.java,0,8,0,4,0,12
 druid-master\druid-master\processing\src\main\java\org\apache\druid\query\aggregation\any\StringAnyBufferAggregator.java,0,41,0,5,0,46
 druid-master\druid-master\core\src\main\java\org\apache\druid\math\expr\BinaryMathOperatorExpr.java,0,124,0,14,0,138
 druid-master\druid-master\benchmarks\src\test\java\org\apache\druid\benchmark\compression\BaseColumnarLongsBenchmark.java,0,76,1,16,0,93
 druid-master\druid-master\extensions-core\datasketches\src\main\java\org\apache\druid\query\aggregation\datasketches\quantiles\DoublesSketchMergeAggregatorFactory.java,0,14,0,7,0,21
 druid-master\druid-master\services\src\main\java\org\apache\druid\server\router\QueryHostFinder.java,0,47,3,7,0,57
 druid-master\druid-master\indexing-service\src\main\java\org\apache\druid\indexing\common\task\batch\parallel\TaskHistory.java,0,16,0,5,0,21
 druid-master\druid-master\processing\src\test\java\org\apache\druid\query\extraction\LowerExtractionFnTest.java,0,12,0,4,0,16
 druid-master\druid-master\core\src\test\java\org\apache\druid\java\util\common\guava\WrappingSequenceTest.java,0,12,1,4,0,17
 druid-master\druid-master\core\src\test\java\org\apache\druid\timeline\partition\BuildingDimensionRangeShardSpecTest.java,0,26,1,5,0,32
 druid-master\druid-master\extensions-core\azure-extensions\src\test\java\org\apache\druid\storage\azure\AzureTestUtils.java,0,35,1,16,0,52
 druid-master\druid-master\server\src\main\java\org\apache\druid\server\security\AllowHttpMethodsResourceFilter.java,0,19,0,7,0,26
 druid-master\druid-master\core\src\test\java\org\apache\druid\java\util\common\guava\ComparatorsTest.java,0,15,0,11,0,26
 druid-master\druid-master\extensions-core\lookups-cached-single\src\main\java\org\apache\druid\server\lookup\jdbc\JdbcDataFetcher.java,0,71,0,15,0,86
 druid-master\druid-master\extensions-core\datasketches\src\main\java\org\apache\druid\query\aggregation\datasketches\tuple\ArrayOfDoublesSketchAggregatorFactory.java,0,98,1,26,0,125
 druid-master\druid-master\server\src\main\java\org\apache\druid\server\initialization\JdbcAccessSecurityConfig.java,0,25,0,9,0,34
 druid-master\druid-master\processing\src\main\java\org\apache\druid\segment\VirtualColumn.java,0,128,0,72,0,200
 druid-master\druid-master\processing\src\test\java\org\apache\druid\query\CPUTimeMetricQueryRunnerTest.java,0,5,0,3,0,8
 druid-master\druid-master\extensions-core\protobuf-extensions\src\main\java\org\apache\druid\data\input\protobuf\FileBasedProtobufBytesDecoder.java,0,46,3,11,0,60
 druid-master\druid-master\extensions-contrib\materialized-view-maintenance\src\main\java\org\apache\druid\indexing\materializedview\MaterializedViewSupervisor.java,0,157,1,66,0,224
 druid-master\druid-master\processing\src\main\java\org\apache\druid\query\ResultMergeQueryRunner.java,0,17,0,2,0,19
 druid-master\druid-master\processing\src\main\java\org\apache\druid\segment\serde\LongNumericColumnPartSerde.java,0,34,0,3,0,37
 druid-master\druid-master\processing\src\test\java\org\apache\druid\segment\data\CompressedColumnarIntsSupplierTest.java,0,86,0,10,0,96
 druid-master\druid-master\core\src\main\java\org\apache\druid\java\util\common\logger\Logger.java,0,150,6,21,0,177
 druid-master\druid-master\core\src\main\java\org\apache\druid\guice\GuiceInjectableValues.java,0,14,0,3,0,17
 druid-master\druid-master\processing\src\main\java\org\apache\druid\segment\vector\VectorCursor.java,0,12,0,10,0,22
 druid-master\druid-master\extensions-core\kinesis-indexing-service\src\main\java\org\apache\druid\indexing\kinesis\KinesisSamplerSpec.java,0,13,3,6,0,22
 druid-master\druid-master\extensions-core\kafka-indexing-service\src\main\java\org\apache\druid\indexing\kafka\KafkaIndexTaskModule.java,0,11,0,6,0,17
 druid-master\druid-master\extendedset\src\test\java\org\apache\druid\extendedset\intset\ImmutableConciseSetIntersectionTest.java,0,193,0,9,0,202
 druid-master\druid-master\server\src\main\java\org\apache\druid\curator\discovery\NoopServiceAnnouncer.java,0,5,2,1,0,8
 druid-master\druid-master\processing\src\main\java\org\apache\druid\query\aggregation\last\DoubleLastAggregatorFactory.java,0,103,0,16,0,119
 druid-master\druid-master\core\src\main\java\org\apache\druid\java\util\metrics\JvmCpuMonitor.java,0,22,0,1,0,23
 druid-master\druid-master\processing\src\main\java\org\apache\druid\segment\BaseFloatColumnValueSelector.java,0,7,0,6,0,13
 druid-master\druid-master\extensions-contrib\moving-average-query\src\test\java\org\apache\druid\query\movingaverage\averagers\DoubleMeanAveragerFactoryTest.java,0,6,0,3,0,9
 druid-master\druid-master\processing\src\main\java\org\apache\druid\query\aggregation\FloatSumAggregatorFactory.java,0,43,0,3,0,46
 druid-master\druid-master\extensions-core\google-extensions\src\test\java\org\apache\druid\storage\google\GoogleStorageTest.java,0,16,2,7,0,25
 druid-master\druid-master\sql\src\main\java\org\apache\druid\sql\calcite\external\ExternalOperatorConversion.java,0,25,0,8,0,33
 druid-master\druid-master\server\src\main\java\org\apache\druid\server\QuerySchedulerConfig.java,0,14,0,2,0,16
 druid-master\druid-master\server\src\test\java\org\apache\druid\server\scheduling\HiLoQueryLaningStrategyTest.java,0,78,6,21,0,105
 druid-master\druid-master\server\src\test\java\org\apache\druid\server\coordinator\duty\MarkAsUnusedOvershadowedSegmentsTest.java,0,26,1,8,0,35
 druid-master\druid-master\processing\src\test\java\org\apache\druid\query\extraction\BucketExtractionFnTest.java,0,21,0,4,0,25
 druid-master\druid-master\extensions-core\histogram\src\test\java\org\apache\druid\query\aggregation\histogram\QuantilesTest.java,0,18,1,3,0,22
 druid-master\druid-master\processing\src\main\java\org\apache\druid\segment\BaseProgressIndicator.java,0,8,0,1,0,9
 druid-master\druid-master\extensions-core\parquet-extensions\src\test\java\org\apache\druid\data\input\parquet\BaseParquetInputTest.java,0,26,1,10,0,37
 druid-master\druid-master\indexing-service\src\main\java\org\apache\druid\indexing\common\task\batch\parallel\PartialGenericSegmentMergeTask.java,0,29,1,11,0,41
 druid-master\druid-master\benchmarks\src\test\java\org\apache\druid\benchmark\compression\BaseColumnarLongsFromGeneratorBenchmark.java,0,59,2,5,0,66
 druid-master\druid-master\processing\src\main\java\org\apache\druid\query\groupby\having\OrHavingSpec.java,0,27,1,2,0,30
 druid-master\druid-master\extensions-core\azure-extensions\src\main\java\org\apache\druid\storage\azure\ICloudSpecificObjectToCloudObjectLocationConverter.java,0,4,0,2,0,6
 druid-master\druid-master\core\src\test\java\org\apache\druid\metadata\MetadataStorageConnectorConfigTest.java,0,75,0,9,0,84
 druid-master\druid-master\processing\src\main\java\org\apache\druid\query\search\InsensitiveContainsSearchQuerySpec.java,0,8,0,1,0,9
 druid-master\druid-master\processing\src\main\java\org\apache\druid\segment\VirtualColumns.java,0,223,1,75,0,299
 druid-master\druid-master\processing\src\main\java\org\apache\druid\segment\incremental\IndexSizeExceededException.java,0,5,0,1,0,6
 druid-master\druid-master\processing\src\main\java\org\apache\druid\query\timeseries\TimeseriesQueryRunnerFactory.java,0,39,0,8,0,47
 druid-master\druid-master\indexing-service\src\test\java\org\apache\druid\indexing\common\task\batch\parallel\HttpShuffleClientTest.java,0,50,0,20,0,70
 druid-master\druid-master\server\src\main\java\org\apache\druid\metadata\input\SqlInputSource.java,0,55,1,8,0,64
 druid-master\druid-master\server\src\main\java\org\apache\druid\server\QueryScheduler.java,0,142,2,54,0,198
 druid-master\druid-master\indexing-service\src\test\java\org\apache\druid\indexing\overlord\setup\WorkerCategorySpecTest.java,0,8,0,3,0,11
 druid-master\druid-master\processing\src\main\java\org\apache\druid\segment\data\RangeIndexedInts.java,0,16,2,1,0,19
 druid-master\druid-master\processing\src\main\java\org\apache\druid\segment\QueryableIndexCursorSequenceBuilder.java,0,186,8,44,0,238
 druid-master\druid-master\extensions-core\kubernetes-extensions\src\main\java\org\apache\druid\k8s\discovery\DiscoveryDruidNodeList.java,0,16,0,2,0,18
 druid-master\druid-master\processing\src\main\java\org\apache\druid\segment\SegmentLazyLoadFailCallback.java,0,5,0,1,0,6
 druid-master\druid-master\processing\src\main\java\org\apache\druid\query\DruidProcessingConfig.java,0,93,11,24,0,128
 druid-master\druid-master\processing\src\main\java\org\apache\druid\query\aggregation\first\NumericFirstBufferAggregator.java,0,52,1,6,0,59
 druid-master\druid-master\server\src\test\java\org\apache\druid\segment\LookupSegmentWranglerTest.java,0,17,3,3,0,23
 druid-master\druid-master\extensions-core\parquet-extensions\src\main\java\org\apache\druid\data\input\parquet\simple\ParquetGroupJsonProvider.java,0,45,0,5,0,50
 druid-master\druid-master\processing\src\main\java\org\apache\druid\jackson\AggregatorsModule.java,0,50,0,52,0,102
 druid-master\druid-master\indexing-service\src\main\java\org\apache\druid\indexing\overlord\sampler\IndexTaskSamplerSpec.java,0,18,0,6,0,24
 druid-master\druid-master\processing\src\test\java\org\apache\druid\query\aggregation\AggregatorFactoryTest.java,0,56,0,48,0,104
 druid-master\druid-master\core\src\main\java\org\apache\druid\java\util\http\client\CredentialedHttpClient.java,0,15,0,2,1,18
 druid-master\druid-master\processing\src\test\java\org\apache\druid\segment\IndexIONullColumnsCompatibilityTest.java,0,49,1,20,0,70
 druid-master\druid-master\extensions-core\druid-pac4j\src\main\java\org\apache\druid\security\pac4j\Pac4jDruidModule.java,0,7,0,2,0,9
 druid-master\druid-master\processing\src\main\java\org\apache\druid\query\groupby\having\HavingSpecUtil.java,0,18,1,3,0,22
 druid-master\druid-master\server\src\main\java\org\apache\druid\server\metrics\TaskSlotCountStatsMonitor.java,0,16,0,4,0,20
 druid-master\druid-master\indexing-service\src\main\java\org\apache\druid\indexing\overlord\RemoteTaskRunnerFactory.java,0,25,0,4,0,29
 druid-master\druid-master\processing\src\main\java\org\apache\druid\query\topn\types\LongTopNColumnAggregatesProcessor.java,0,22,0,6,0,28
 druid-master\druid-master\processing\src\test\java\org\apache\druid\annotations\SubclassesMustOverrideEqualsAndHashCodeTest.java,0,8,0,4,0,12
 druid-master\druid-master\processing\src\main\java\org\apache\druid\query\aggregation\SimpleLongBufferAggregator.java,0,26,0,1,0,27
 druid-master\druid-master\processing\src\main\java\org\apache\druid\segment\filter\TrueFilter.java,0,36,1,5,0,42
 druid-master\druid-master\processing\src\main\java\org\apache\druid\query\aggregation\post\package-info.java,0,1,0,1,0,2
 druid-master\druid-master\indexing-service\src\main\java\org\apache\druid\indexing\common\task\batch\parallel\DimensionCardinalityReport.java,0,34,0,6,0,40
 druid-master\druid-master\processing\src\main\java\org\apache\druid\query\aggregation\LongSumAggregatorFactory.java,0,43,0,3,0,46
 druid-master\druid-master\server\src\main\java\org\apache\druid\segment\realtime\appenderator\AppenderatorDriverMetadata.java,0,48,1,13,0,62
 druid-master\druid-master\indexing-service\src\main\java\org\apache\druid\indexing\overlord\WorkerTaskRunnerQueryAdapter.java,0,29,1,7,0,37
 druid-master\druid-master\sql\src\main\java\org\apache\druid\sql\calcite\expression\AliasedOperatorConversion.java,0,39,2,9,0,50
 druid-master\druid-master\extensions-core\google-extensions\src\test\java\org\apache\druid\storage\google\GoogleUtilsTest.java,0,17,0,8,0,25
 druid-master\druid-master\extensions-core\lookups-cached-single\src\test\java\org\apache\druid\server\lookup\LoadingLookupTest.java,0,41,0,12,0,53
 druid-master\druid-master\server\src\main\java\org\apache\druid\server\metrics\QueryCountStatsProvider.java,0,7,0,3,0,10
 druid-master\druid-master\sql\src\test\java\org\apache\druid\sql\SqlLifecycleManagerTest.java,0,34,0,12,0,46
 druid-master\druid-master\server\src\main\java\org\apache\druid\discovery\DruidNodeDiscoveryProvider.java,0,65,0,28,0,93
 druid-master\druid-master\core\src\test\java\org\apache\druid\data\input\impl\JsonReaderTest.java,0,85,0,67,0,152
 druid-master\druid-master\core\src\main\java\org\apache\druid\java\util\metrics\cgroups\CpuSet.java,0,46,0,2,4,52
 druid-master\druid-master\indexing-hadoop\src\test\java\org\apache\druid\indexer\hadoop\FSSpideringIteratorTest.java,0,17,0,1,0,18
 druid-master\druid-master\hll\src\main\java\org\apache\druid\hll\HyperLogLogHash.java,0,22,0,6,0,28
 druid-master\druid-master\processing\src\main\java\org\apache\druid\collections\spatial\split\GutmanSplitStrategy.java,0,26,1,9,0,36
 druid-master\druid-master\processing\src\main\java\org\apache\druid\query\search\BySegmentSearchResultValue.java,0,26,0,1,0,27
 druid-master\druid-master\server\src\test\java\org\apache\druid\segment\indexing\TestModifiedDataSchema.java,0,18,0,1,0,19
 druid-master\druid-master\extensions-contrib\materialized-view-selection\src\test\java\org\apache\druid\query\materializedview\MaterializedViewQueryQueryToolChestTest.java,0,42,0,18,0,60
 druid-master\druid-master\extendedset\src\main\java\org\apache\druid\extendedset\utilities\IntList.java,0,27,2,1,0,30
 druid-master\druid-master\extensions-contrib\opentelemetry-emitter\src\test\java\org\apache\druid\emitter\opentelemetry\OpenTelemetryEmitterTest.java,0,52,1,15,1,69
 druid-master\druid-master\indexing-service\src\test\java\org\apache\druid\indexing\common\task\CompactionTaskRunTest.java,0,280,1,144,0,425
 druid-master\druid-master\extensions-core\kubernetes-extensions\src\test\java\org\apache\druid\k8s\discovery\K8sDruidNodeDiscoveryProviderTest.java,0,113,3,36,0,152
 druid-master\druid-master\server\src\main\java\org\apache\druid\segment\realtime\firehose\InlineFirehose.java,0,19,0,2,0,21
 druid-master\druid-master\processing\src\main\java\org\apache\druid\query\search\SearchQuerySpec.java,0,6,0,4,0,10
 druid-master\druid-master\extensions-core\google-extensions\src\main\java\org\apache\druid\storage\google\GoogleDataSegmentPuller.java,0,29,3,7,0,39
 druid-master\druid-master\indexing-service\src\main\java\org\apache\druid\indexing\common\task\batch\parallel\PartitionStat.java,0,13,0,9,0,22
 druid-master\druid-master\extensions-core\druid-basic-security\src\main\java\org\apache\druid\security\basic\authentication\entity\BasicAuthenticatorCredentials.java,0,35,0,4,0,39
 druid-master\druid-master\indexing-service\src\main\java\org\apache\druid\indexing\common\task\batch\parallel\iterator\IndexTaskInputRowIteratorBuilder.java,0,8,0,4,0,12
 druid-master\druid-master\integration-tests\src\test\java\org\apache\druid\tests\parallelized\ITKinesisIndexingServiceParallelizedTest.java,0,9,0,3,0,12
 druid-master\druid-master\extensions-contrib\momentsketch\src\main\java\org\apache\druid\query\aggregation\momentsketch\aggregator\MomentSketchBuildBufferAggregator.java,0,20,1,2,0,23
 druid-master\druid-master\server\src\main\java\org\apache\druid\server\emitter\ComposingEmitterModule.java,0,16,1,3,0,20
 druid-master\druid-master\sql\src\main\java\org\apache\druid\sql\calcite\aggregation\builtin\AvgSqlAggregator.java,0,10,0,5,0,15
 druid-master\druid-master\indexing-service\src\main\java\org\apache\druid\indexing\common\TaskReportFileWriter.java,0,3,0,1,0,4
 druid-master\druid-master\extensions-core\datasketches\src\main\java\org\apache\druid\query\aggregation\datasketches\quantiles\sql\DoublesSketchQuantilesOperatorConversion.java,0,11,0,4,0,15
 druid-master\druid-master\processing\src\test\java\org\apache\druid\segment\TestDoubleColumnSelector.java,0,3,0,1,0,4
 druid-master\druid-master\server\src\main\java\org\apache\druid\guice\RouterProcessingModule.java,0,26,2,10,0,38
 druid-master\druid-master\core\src\main\java\org\apache\druid\java\util\metrics\MonitorSchedulerConfig.java,0,3,0,2,0,5
 druid-master\druid-master\sql\src\main\java\org\apache\druid\sql\calcite\expression\builtin\FloorOperatorConversion.java,0,7,0,3,0,10
 druid-master\druid-master\core\src\main\java\org\apache\druid\java\util\common\io\smoosh\SmooshedWriter.java,0,1,0,1,0,2
 druid-master\druid-master\indexing-service\src\main\java\org\apache\druid\indexing\common\config\FileTaskLogsConfig.java,0,12,1,1,0,14
 druid-master\druid-master\extensions-contrib\aliyun-oss-extensions\src\test\java\org\apache\druid\storage\aliyun\OssDataSegmentMoverTest.java,0,54,1,16,0,71
 druid-master\druid-master\core\src\main\java\org\apache\druid\java\util\common\guava\YieldingAccumulator.java,0,18,2,5,0,25
 druid-master\druid-master\server\src\main\java\org\apache\druid\server\coordinator\duty\CoordinatorCustomDutyGroup.java,0,27,0,1,0,28
 druid-master\druid-master\cloud\aws-common\src\main\java\org\apache\druid\common\aws\FileSessionCredentialsProvider.java,0,31,0,5,2,38
 druid-master\druid-master\processing\src\main\java\org\apache\druid\query\timeseries\TimeseriesQueryMetrics.java,0,8,0,4,0,12
 druid-master\druid-master\extensions-core\lookups-cached-global\src\main\java\org\apache\druid\query\lookup\namespace\StaticMapExtractionNamespace.java,0,20,0,4,0,24
 druid-master\druid-master\server\src\test\java\org\apache\druid\client\cache\BytesBoundedLinkedQueueTest.java,0,55,3,3,0,61
 druid-master\druid-master\core\src\main\java\org\apache\druid\java\util\common\parsers\ParseException.java,0,42,0,11,0,53
 druid-master\druid-master\indexing-service\src\main\java\org\apache\druid\indexing\overlord\WorkerTaskRunner.java,0,15,0,2,0,17
 druid-master\druid-master\processing\src\test\java\org\apache\druid\segment\filter\BaseFilterTest.java,0,205,6,86,0,297
 druid-master\druid-master\server\src\main\java\org\apache\druid\server\security\Authenticator.java,0,32,0,30,0,62
 druid-master\druid-master\sql\src\test\java\org\apache\druid\sql\calcite\filtration\FiltrationTest.java,0,7,0,4,0,11
 druid-master\druid-master\integration-tests\src\main\java\org\apache\druid\testing\utils\DelimitedEventSerializer.java,0,7,1,2,0,10
 druid-master\druid-master\core\src\test\java\org\apache\druid\common\utils\PropUtilsTest.java,0,13,0,1,0,14
 druid-master\druid-master\sql\src\main\java\org\apache\druid\sql\http\SqlParameter.java,0,35,3,5,0,43
 druid-master\druid-master\processing\src\main\java\org\apache\druid\query\groupby\epinephelinae\vector\LongGroupByVectorColumnSelector.java,0,12,0,2,0,14
 druid-master\druid-master\extensions-contrib\statsd-emitter\src\test\java\org\apache\druid\emitter\statsd\DimensionConverterTest.java,0,8,1,4,0,13
 druid-master\druid-master\extensions-contrib\virtual-columns\src\main\java\org\apache\druid\segment\MapTypeMapVirtualColumnDimensionSelector.java,0,29,2,6,0,37
 druid-master\druid-master\indexing-service\src\main\java\org\apache\druid\indexing\overlord\LockRequestForNewSegment.java,0,97,0,2,0,99
 druid-master\druid-master\services\src\main\java\org\apache\druid\cli\CliIndexer.java,0,43,0,15,0,58
 druid-master\druid-master\extensions-core\avro-extensions\src\main\java\org\apache\druid\data\input\schemarepo\Avro1124SubjectAndIdConverter.java,0,31,0,6,0,37
 druid-master\druid-master\processing\src\main\java\org\apache\druid\segment\ReferenceCountingSegment.java,0,62,1,10,0,73
 druid-master\druid-master\processing\src\main\java\org\apache\druid\segment\join\table\RowBasedIndexedTable.java,0,57,2,10,0,69
 druid-master\druid-master\core\target\generated-sources\antlr4\org\apache\druid\math\expr\antlr\ExprBaseListener.java,352,104,58,24,0,186
 druid-master\druid-master\processing\src\main\java\org\apache\druid\query\DefaultQueryMetrics.java,0,154,2,16,0,172
 druid-master\druid-master\processing\src\main\java\org\apache\druid\segment\serde\ColumnPartSerde.java,0,12,0,8,0,20
 druid-master\druid-master\processing\src\main\java\org\apache\druid\query\datasourcemetadata\DataSourceQueryQueryToolChest.java,0,41,0,10,0,51
 druid-master\druid-master\extensions-contrib\moving-average-query\src\test\java\org\apache\druid\query\movingaverage\averagers\LongSumAveragerTest.java,0,12,0,1,0,13
 druid-master\druid-master\extensions-core\s3-extensions\src\main\java\org\apache\druid\storage\s3\S3StorageConfig.java,0,10,0,3,0,13
 druid-master\druid-master\indexing-service\src\main\java\org\apache\druid\indexing\overlord\helpers\TaskLogAutoCleanerConfig.java,0,46,0,6,0,52
 druid-master\druid-master\processing\src\test\java\org\apache\druid\query\expression\MacroTestBase.java,0,23,0,6,0,29
 druid-master\druid-master\indexing-service\src\main\java\org\apache\druid\indexing\common\task\SegmentAllocatorForBatch.java,0,2,0,1,0,3
 druid-master\druid-master\core\src\main\java\org\apache\druid\indexer\Jobby.java,0,8,0,5,0,13
 druid-master\druid-master\server\src\test\java\org\apache\druid\server\log\FileRequestLoggerTest.java,0,14,0,9,0,23
 druid-master\druid-master\processing\src\main\java\org\apache\druid\segment\TransformableRowIterator.java,0,16,0,15,0,31
 druid-master\druid-master\server\src\main\java\org\apache\druid\server\coordinator\duty\KillCompactionConfig.java,0,46,1,18,0,65
 druid-master\druid-master\processing\src\test\java\org\apache\druid\query\DataSourceTest.java,0,18,0,7,0,25
 druid-master\druid-master\extensions-contrib\distinctcount\src\main\java\org\apache\druid\query\aggregation\distinctcount\NoopDistinctCountAggregator.java,0,13,4,1,0,18
 druid-master\druid-master\processing\src\main\java\org\apache\druid\query\dimension\ExtractionDimensionSpec.java,0,78,1,9,0,88
 druid-master\druid-master\extensions-contrib\moving-average-query\src\test\java\org\apache\druid\query\movingaverage\MovingAverageQueryTest.java,0,82,8,19,0,109
 druid-master\druid-master\extensions-contrib\influxdb-emitter\src\test\java\org\apache\druid\emitter\influxdb\InfluxdbEmitterTest.java,0,90,4,14,0,108
 druid-master\druid-master\processing\src\main\java\org\apache\druid\query\topn\TopNQueryQueryToolChest.java,0,172,0,68,0,240
 druid-master\druid-master\sql\src\test\java\org\apache\druid\sql\calcite\planner\DruidRexExecutorTest.java,0,34,0,14,0,48
 druid-master\druid-master\processing\src\main\java\org\apache\druid\query\groupby\having\HavingSpec.java,0,7,0,6,0,13
 druid-master\druid-master\extensions-core\ec2-extensions\src\main\java\org\apache\druid\indexing\overlord\autoscaling\ec2\EC2UserData.java,0,6,0,4,0,10
 druid-master\druid-master\extensions-core\kafka-indexing-service\src\test\java\org\apache\druid\indexing\kafka\KafkaCheckpointDataSourceMetadataSerdeTest.java,0,13,0,6,0,19
 druid-master\druid-master\extensions-core\lookups-cached-global\src\main\java\org\apache\druid\query\lookup\NamespaceLookupIntrospectHandler.java,0,27,0,6,0,33
 druid-master\druid-master\indexing-service\src\main\java\org\apache\druid\indexing\worker\http\WorkerResource.java,0,53,0,5,0,58
 druid-master\druid-master\sql\src\main\java\org\apache\druid\sql\calcite\expression\SimpleExtraction.java,0,38,0,6,0,44
 druid-master\druid-master\processing\src\main\java\org\apache\druid\segment\data\ColumnCapacityExceededException.java,0,8,0,2,0,10
 druid-master\druid-master\indexing-service\src\main\java\org\apache\druid\indexing\common\TaskInfoProvider.java,0,3,0,3,0,6
 druid-master\druid-master\processing\src\test\java\org\apache\druid\segment\filter\NotFilterTest.java,0,10,0,4,0,14
 druid-master\druid-master\core\src\main\java\org\apache\druid\metadata\MetadataStorageActionHandlerTypes.java,0,6,4,2,0,12
 druid-master\druid-master\core\src\main\java\org\apache\druid\guice\LifecycleModule.java,0,74,0,43,1,118
 druid-master\druid-master\indexing-service\src\main\java\org\apache\druid\indexing\common\actions\LocalTaskActionClient.java,0,27,1,6,0,34
 druid-master\druid-master\processing\src\test\java\org\apache\druid\query\QueryToolChestTestHelper.java,0,7,1,4,0,12
 druid-master\druid-master\processing\src\main\java\org\apache\druid\query\groupby\strategy\GroupByStrategySelector.java,0,19,0,3,0,22
 druid-master\druid-master\processing\src\main\java\org\apache\druid\segment\column\NumericColumn.java,0,5,0,3,0,8
 druid-master\druid-master\server\src\main\java\org\apache\druid\query\RetryQueryRunnerConfig.java,0,8,0,1,0,9
 druid-master\druid-master\processing\src\test\java\org\apache\druid\segment\data\BitmapSerdeFactoryTest.java,0,18,0,14,0,32
 druid-master\druid-master\extensions-core\histogram\src\test\java\org\apache\druid\query\aggregation\histogram\FixedBucketsHistogramTest.java,0,1068,1,59,0,1128
 druid-master\druid-master\benchmarks\src\test\java\org\apache\druid\benchmark\ProtobufParserBenchmark.java,0,35,6,8,0,49
 druid-master\druid-master\extensions-core\azure-extensions\src\main\java\org\apache\druid\storage\azure\AzureDataSegmentPuller.java,0,18,2,6,0,26
 druid-master\druid-master\extensions-core\kafka-indexing-service\src\test\java\org\apache\druid\indexing\kafka\supervisor\KafkaSupervisorSpecTest.java,0,34,0,17,0,51
 druid-master\druid-master\extensions-contrib\moving-average-query\src\main\java\org\apache\druid\query\movingaverage\MovingAverageHelper.java,0,6,1,2,0,9
 druid-master\druid-master\extensions-core\parquet-extensions\src\main\java\org\apache\druid\data\input\parquet\simple\ParquetParseSpec.java,0,18,0,1,0,19
 druid-master\druid-master\extensions-core\datasketches\src\test\java\org\apache\druid\query\aggregation\datasketches\quantiles\DoublesSketchAggregatorFactoryTest.java,0,41,0,14,0,55
 druid-master\druid-master\server\src\test\java\org\apache\druid\client\RangeIterable.java,0,27,0,1,0,28
 druid-master\druid-master\processing\src\main\java\org\apache\druid\query\filter\vector\MultiValueStringVectorValueMatcher.java,0,25,0,8,0,33
 druid-master\druid-master\processing\src\main\java\org\apache\druid\guice\ExtensionsConfig.java,0,41,2,3,0,46
 druid-master\druid-master\server\src\main\java\org\apache\druid\server\http\security\StateResourceFilter.java,0,9,0,3,0,12
 druid-master\druid-master\core\src\main\java\org\apache\druid\common\exception\NoErrorResponseTransformStrategy.java,0,16,0,4,0,20
 druid-master\druid-master\processing\src\test\java\org\apache\druid\query\extraction\StringFormatExtractionFnTest.java,0,25,0,5,0,30
 druid-master\druid-master\processing\src\test\java\org\apache\druid\query\search\SearchSortSpecTest.java,0,13,0,3,0,16
 druid-master\druid-master\processing\src\main\java\org\apache\druid\query\groupby\epinephelinae\vector\NullableFloatGroupByVectorColumnSelector.java,0,13,0,3,0,16
 druid-master\druid-master\sql\src\main\java\org\apache\druid\sql\calcite\expression\builtin\ArrayToStringOperatorConversion.java,0,4,0,1,0,5
 druid-master\druid-master\server\src\main\java\org\apache\druid\server\initialization\jetty\ForbiddenExceptionMapper.java,0,5,0,2,0,7
 druid-master\druid-master\server\src\main\java\org\apache\druid\segment\realtime\firehose\ChatHandlers.java,0,12,1,2,0,15
 druid-master\druid-master\core\src\main\java\org\apache\druid\timeline\partition\BuildingDimensionRangeShardSpec.java,0,56,0,2,2,60
 druid-master\druid-master\processing\src\test\java\org\apache\druid\segment\data\VSizeColumnarIntsSerializerTest.java,0,21,0,5,0,26
 druid-master\druid-master\core\src\test\java\org\apache\druid\java\util\common\parsers\JavaScriptParserTest.java,0,9,0,3,0,12
 druid-master\druid-master\core\src\main\java\org\apache\druid\query\QueryException.java,0,43,0,6,0,49
 druid-master\druid-master\processing\src\main\java\org\apache\druid\segment\serde\DictionaryEncodedColumnPartSerde.java,0,131,1,25,0,157
 druid-master\druid-master\sql\src\main\java\org\apache\druid\sql\calcite\rule\FilterJoinExcludePushToChildRule.java,0,78,3,39,0,120
 druid-master\druid-master\server\src\main\java\org\apache\druid\indexing\overlord\supervisor\Supervisor.java,0,22,0,10,0,32
 druid-master\druid-master\processing\src\main\java\org\apache\druid\segment\TimeAndDimsPointer.java,0,85,0,22,0,107
 druid-master\druid-master\extensions-contrib\statsd-emitter\src\main\java\org\apache\druid\emitter\statsd\DimensionConverter.java,0,25,1,5,0,31
 druid-master\druid-master\processing\src\main\java\org\apache\druid\query\topn\Generic2AggPooledTopNScannerPrototype.java,0,19,0,9,0,28
 druid-master\druid-master\server\src\main\java\org\apache\druid\server\initialization\jetty\CustomExceptionMapper.java,0,6,0,3,0,9
 druid-master\druid-master\server\src\main\java\org\apache\druid\client\ImmutableDruidDataSource.java,0,64,0,18,0,82
 druid-master\druid-master\server\src\main\java\org\apache\druid\guice\QueryableModule.java,0,7,0,2,0,9
 druid-master\druid-master\integration-tests\src\main\java\org\apache\druid\testing\utils\StreamGenerator.java,0,12,0,3,0,15
 druid-master\druid-master\extensions-core\azure-extensions\src\test\java\org\apache\druid\storage\azure\AzureCloudBlobIteratorTest.java,0,136,6,73,0,215
 druid-master\druid-master\processing\src\main\java\org\apache\druid\segment\incremental\RowIngestionMeters.java,0,21,0,5,0,26
 druid-master\druid-master\sql\src\main\java\org\apache\druid\sql\calcite\aggregation\builtin\GroupingSqlAggregator.java,0,25,1,5,0,31
 druid-master\druid-master\sql\src\main\java\org\apache\druid\sql\calcite\expression\builtin\HumanReadableFormatOperatorConversion.java,0,31,0,9,0,40
 druid-master\druid-master\extensions-core\datasketches\src\test\java\org\apache\druid\query\aggregation\datasketches\tuple\ArrayOfDoublesSketchAggregationTest.java,0,399,10,217,0,626
 druid-master\druid-master\processing\src\main\java\org\apache\druid\query\aggregation\AggregatorUtil.java,0,166,1,34,0,201
 druid-master\druid-master\extensions-core\druid-kerberos\src\main\java\org\apache\druid\security\kerberos\RetryResponseHolder.java,0,17,0,1,0,18
 druid-master\druid-master\extensions-core\histogram\src\main\java\org\apache\druid\query\aggregation\histogram\FixedBucketsHistogramSerde.java,0,51,2,13,0,66
 druid-master\druid-master\extensions-core\druid-basic-security\src\main\java\org\apache\druid\security\basic\authentication\db\cache\CoordinatorPollingBasicAuthenticatorCacheManager.java,0,80,3,31,0,114
 druid-master\druid-master\benchmarks\src\test\java\org\apache\druid\benchmark\query\SearchBenchmark.java,0,130,4,43,0,177
 druid-master\druid-master\server\src\main\java\org\apache\druid\client\coordinator\Coordinator.java,0,2,0,1,0,3
 druid-master\druid-master\extensions-core\datasketches\src\test\java\org\apache\druid\query\aggregation\datasketches\quantiles\DoublesSketchComplexMetricSerdeTest.java,0,29,0,11,0,40
 druid-master\druid-master\server\src\main\java\org\apache\druid\curator\cache\PathChildrenCacheFactory.java,0,57,0,4,0,61
 druid-master\druid-master\processing\src\main\java\org\apache\druid\query\aggregation\any\FloatAnyAggregatorFactory.java,0,83,0,12,0,95
 druid-master\druid-master\server\src\main\java\org\apache\druid\server\coordinator\duty\SegmentCompactionUtil.java,0,11,1,4,0,16
 druid-master\druid-master\processing\src\main\java\org\apache\druid\query\groupby\epinephelinae\Grouper.java,0,77,1,34,0,112
 druid-master\druid-master\extensions-core\datasketches\src\test\java\org\apache\druid\query\aggregation\datasketches\hll\HllSketchAggregatorTest.java,0,94,1,20,0,115
 druid-master\druid-master\integration-tests\src\main\java\org\apache\druid\cli\QueryRetryTestCommandCreator.java,0,5,0,2,0,7
 druid-master\druid-master\processing\src\main\java\org\apache\druid\segment\GenericColumnSerializer.java,0,5,0,2,0,7
 druid-master\druid-master\server\src\test\java\org\apache\druid\client\indexing\ClientCompactionTaskDimensionsSpecTest.java,0,12,1,6,0,19
 druid-master\druid-master\extensions-core\google-extensions\src\main\java\org\apache\druid\storage\google\GoogleDataSegmentPusher.java,0,45,0,7,0,52
 druid-master\druid-master\server\src\main\java\org\apache\druid\server\log\ComposingRequestLoggerProvider.java,0,35,0,4,0,39
 druid-master\druid-master\extensions-core\druid-bloom-filter\src\main\java\org\apache\druid\query\aggregation\bloom\FloatBloomFilterAggregator.java,0,9,0,3,0,12
 druid-master\druid-master\extensions-contrib\momentsketch\src\main\java\org\apache\druid\query\aggregation\momentsketch\aggregator\MomentSketchMergeBufferAggregator.java,0,40,1,1,0,42
 druid-master\druid-master\extensions-contrib\aliyun-oss-extensions\src\test\java\org\apache\druid\storage\aliyun\OssDataSegmentKillerTest.java,0,45,4,17,0,66
 druid-master\druid-master\server\src\main\java\org\apache\druid\query\LocatedSegmentDescriptor.java,0,57,1,4,0,62
 druid-master\druid-master\server\src\main\java\org\apache\druid\server\coordination\DataSegmentChangeRequest.java,0,4,0,2,0,6
 druid-master\druid-master\processing\src\main\java\org\apache\druid\query\aggregation\HistogramVisual.java,0,31,0,3,0,34
 druid-master\druid-master\processing\src\main\java\org\apache\druid\query\dimension\PrefixFilteredDimensionSpec.java,0,30,0,3,0,33
 druid-master\druid-master\core\src\main\java\org\apache\druid\java\util\http\client\response\ClientResponse.java,0,34,0,2,0,36
 druid-master\druid-master\sql\src\main\java\org\apache\druid\sql\calcite\schema\NamedSystemSchema.java,0,18,0,2,0,20
 druid-master\druid-master\processing\src\main\java\org\apache\druid\query\groupby\orderby\DefaultLimitSpec.java,0,155,1,49,0,205
 druid-master\druid-master\extensions-core\histogram\src\test\java\org\apache\druid\query\aggregation\histogram\FixedBucketsHistogramTopNQueryTest.java,0,79,0,13,0,92
 druid-master\druid-master\processing\src\main\java\org\apache\druid\query\aggregation\ExpressionLambdaAggregatorInputBindings.java,0,31,0,5,0,36
 druid-master\druid-master\core\src\test\java\org\apache\druid\math\expr\FunctionTest.java,0,333,0,105,0,438
 druid-master\druid-master\extensions-core\druid-basic-security\src\main\java\org\apache\druid\security\basic\authentication\endpoint\CoordinatorBasicAuthenticatorResourceHandler.java,0,67,0,22,0,89
 druid-master\druid-master\extensions-contrib\tdigestsketch\src\main\java\org\apache\druid\query\aggregation\tdigestsketch\TDigestSketchComplexMetricSerde.java,0,27,3,9,0,39
 druid-master\druid-master\processing\src\main\java\org\apache\druid\query\PostProcessingOperator.java,0,2,0,1,0,3
 druid-master\druid-master\indexing-service\src\main\java\org\apache\druid\indexing\input\DruidSegmentInputFormat.java,0,16,0,1,0,17
 druid-master\druid-master\extensions-contrib\tdigestsketch\src\test\java\org\apache\druid\query\aggregation\tdigestsketch\sql\TDigestSketchSqlAggregatorTest.java,0,121,0,62,0,183
 druid-master\druid-master\extensions-contrib\time-min-max\src\main\java\org\apache\druid\query\aggregation\TimestampAggregatorFactory.java,0,88,0,10,0,98
 druid-master\druid-master\processing\src\test\java\org\apache\druid\segment\virtual\ExpressionVectorValueSelectorTest.java,0,20,0,5,0,25
 druid-master\druid-master\processing\src\main\java\org\apache\druid\query\topn\TopNQueryMetricsFactory.java,0,3,0,1,0,4
 druid-master\druid-master\core\src\main\java\org\apache\druid\audit\AuditEntry.java,0,70,1,1,0,72
 druid-master\druid-master\indexing-service\src\test\java\org\apache\druid\indexing\common\task\HadoopTaskTest.java,0,28,2,8,0,38
 druid-master\druid-master\processing\src\test\java\org\apache\druid\query\extraction\RegexDimExtractionFnTest.java,0,65,0,18,0,83
 druid-master\druid-master\processing\src\test\java\org\apache\druid\segment\filter\ExtractionDimFilterTest.java,0,79,0,22,0,101
 druid-master\druid-master\server\src\test\java\org\apache\druid\server\coordinator\duty\KillRulesTest.java,0,30,0,11,0,41
 druid-master\druid-master\processing\src\test\java\org\apache\druid\segment\IndexMergerNullHandlingTest.java,0,55,6,39,0,100
 druid-master\druid-master\processing\src\test\java\org\apache\druid\segment\TestNullableDoubleColumnSelector.java,0,15,0,2,0,17
 druid-master\druid-master\processing\src\main\java\org\apache\druid\segment\filter\JavaScriptFilter.java,0,52,0,7,0,59
 druid-master\druid-master\extensions-core\stats\src\test\java\org\apache\druid\query\aggregation\variance\VarianceAggregatorCollectorTest.java,0,100,2,62,0,164
 druid-master\druid-master\server\src\main\java\org\apache\druid\guice\DruidBinders.java,0,52,1,10,0,63
 druid-master\druid-master\server\src\main\java\org\apache\druid\metadata\SegmentsMetadataManagerProvider.java,0,2,0,2,0,4
 druid-master\druid-master\server\src\test\java\org\apache\druid\segment\loading\LocalDataSegmentKillerTest.java,0,19,0,8,0,27
 druid-master\druid-master\extensions-core\s3-extensions\src\test\java\org\apache\druid\storage\s3\S3DataSegmentMoverTest.java,0,55,1,14,0,70
 druid-master\druid-master\processing\src\test\java\org\apache\druid\query\metadata\SegmentMetadataQueryTest.java,0,253,0,81,0,334
 druid-master\druid-master\processing\src\test\java\org\apache\druid\segment\filter\ColumnComparisonFilterTest.java,0,48,0,25,0,73
 druid-master\druid-master\processing\src\test\java\org\apache\druid\query\metadata\SegmentMetadataQueryQueryToolChestTest.java,0,43,0,12,0,55
 druid-master\druid-master\extensions-core\datasketches\src\main\java\org\apache\druid\query\aggregation\datasketches\theta\SketchMergeAggregatorFactory.java,0,56,2,11,0,69
 druid-master\druid-master\processing\src\main\java\org\apache\druid\query\aggregation\last\DoubleLastBufferAggregator.java,0,31,0,3,0,34
 druid-master\druid-master\sql\src\main\java\org\apache\druid\sql\calcite\rel\Grouping.java,0,77,1,24,0,102
 druid-master\druid-master\processing\src\main\java\org\apache\druid\query\ChainedExecutionQueryRunner.java,0,53,4,23,0,80
 druid-master\druid-master\processing\src\main\java\org\apache\druid\query\aggregation\any\DoubleAnyBufferAggregator.java,0,29,0,2,0,31
 druid-master\druid-master\server\src\main\java\org\apache\druid\segment\realtime\plumber\Plumber.java,0,15,0,11,0,26
 druid-master\druid-master\server\src\main\java\org\apache\druid\metadata\input\SqlEntity.java,0,70,3,21,0,94
 druid-master\druid-master\processing\src\main\java\org\apache\druid\query\aggregation\DoubleMaxVectorAggregator.java,0,16,0,3,0,19
 druid-master\druid-master\server\src\test\java\org\apache\druid\server\coordinator\duty\KillSupervisorsCustomDutyTest.java,0,23,0,10,0,33
 druid-master\druid-master\processing\src\main\java\org\apache\druid\query\groupby\strategy\GroupByStrategyV1.java,0,88,0,38,0,126
 druid-master\druid-master\indexing-service\src\main\java\org\apache\druid\indexing\appenderator\ActionBasedSegmentAllocator.java,0,16,0,2,0,18
 druid-master\druid-master\processing\src\test\java\org\apache\druid\query\topn\TopNUnionQueryTest.java,0,43,0,11,0,54
 druid-master\druid-master\indexing-hadoop\src\test\java\org\apache\druid\indexer\HdfsClasspathSetupTest.java,0,48,0,20,0,68
 druid-master\druid-master\extensions-contrib\tdigestsketch\src\main\java\org\apache\druid\query\aggregation\tdigestsketch\TDigestSketchAggregatorFactory.java,0,90,0,15,0,105
 druid-master\druid-master\extensions-core\datasketches\src\main\java\org\apache\druid\query\aggregation\datasketches\hll\HllSketchMergeVectorAggregator.java,0,19,0,8,0,27
 druid-master\druid-master\extensions-core\kafka-indexing-service\src\main\java\org\apache\druid\indexing\kafka\IncrementalPublishingKafkaIndexTaskRunner.java,0,68,4,20,0,92
 druid-master\druid-master\extensions-core\kafka-indexing-service\src\main\java\org\apache\druid\data\input\kafkainput\KafkaHeaderFormat.java,0,4,0,2,0,6
 druid-master\druid-master\processing\src\test\java\org\apache\druid\query\groupby\epinephelinae\TestColumnSelectorFactory.java,0,25,0,1,0,26
 druid-master\druid-master\processing\src\main\java\org\apache\druid\segment\IndexableAdapter.java,0,13,0,2,0,15
 druid-master\druid-master\server\src\main\java\org\apache\druid\curator\CuratorUtils.java,0,33,1,7,0,41
 druid-master\druid-master\core\src\main\java\org\apache\druid\java\util\common\UOE.java,0,11,0,4,0,15
 druid-master\druid-master\processing\src\main\java\org\apache\druid\segment\join\lookup\LookupJoinable.java,0,40,1,12,0,53
 druid-master\druid-master\indexing-service\src\main\java\org\apache\druid\indexing\overlord\autoscaling\AbstractWorkerProvisioningStrategy.java,0,32,0,6,0,38
 druid-master\druid-master\integration-tests\src\test\java\org\apache\druid\tests\indexer\ITPerfectRollupParallelIndexTest.java,0,32,3,16,0,51
 druid-master\druid-master\processing\src\main\java\org\apache\druid\segment\column\ColumnSignature.java,0,16,0,3,0,19
 druid-master\druid-master\core\src\main\java\org\apache\druid\java\util\metrics\JvmThreadsMonitor.java,0,20,0,5,0,25
 druid-master\druid-master\services\src\main\java\org\apache\druid\cli\CreateTables.java,0,20,0,4,0,24
 druid-master\druid-master\benchmarks\src\test\java\org\apache\druid\benchmark\query\TimeseriesBenchmark.java,0,118,3,45,0,166
 druid-master\druid-master\core\src\main\java\org\apache\druid\segment\column\TypeFactory.java,0,13,1,5,0,19
 druid-master\druid-master\processing\src\test\java\org\apache\druid\segment\EmptyIndexTest.java,0,18,0,8,0,26
 druid-master\druid-master\integration-tests\src\main\java\org\apache\druid\testing\utils\ProtobufSchemaRegistryEventSerializer.java,0,21,2,4,0,27
 druid-master\druid-master\indexing-service\src\main\java\org\apache\druid\indexing\common\task\batch\parallel\PartialDimensionCardinalityTask.java,0,55,3,19,0,77
 druid-master\druid-master\processing\src\main\java\org\apache\druid\segment\join\filter\rewrite\RhsRewriteCandidates.java,0,28,1,10,0,39
 druid-master\druid-master\processing\src\main\java\org\apache\druid\segment\join\JoinableClause.java,0,63,0,16,0,79
 druid-master\druid-master\processing\src\main\java\org\apache\druid\query\ExecutorServiceMonitor.java,0,15,0,2,0,17
 druid-master\druid-master\extensions-core\datasketches\src\test\java\org\apache\druid\query\aggregation\datasketches\quantiles\GenerateTestData.java,0,15,3,7,0,25
 druid-master\druid-master\processing\src\test\java\org\apache\druid\query\aggregation\post\FieldAccessPostAggregatorTest.java,0,23,2,9,0,34
 druid-master\druid-master\core\src\main\java\org\apache\druid\java\util\common\parsers\CloseableIteratorWithMetadata.java,0,20,0,9,0,29
 druid-master\druid-master\processing\src\main\java\org\apache\druid\query\timeseries\TimeseriesResultBuilder.java,0,16,0,2,0,18
 druid-master\druid-master\integration-tests\src\main\java\org\apache\druid\testing\utils\ServerDiscoveryUtil.java,0,13,1,2,0,16
 druid-master\druid-master\processing\src\main\java\org\apache\druid\segment\ColumnSelectorBitmapIndexSelector.java,0,71,2,17,0,90
 druid-master\druid-master\extensions-core\parquet-extensions\src\main\java\org\apache\druid\data\input\parquet\guice\Parquet.java,0,5,0,4,0,9
 druid-master\druid-master\sql\src\main\java\org\apache\druid\sql\calcite\run\QueryMakerFactory.java,0,6,0,6,0,12
 druid-master\druid-master\core\src\test\java\org\apache\druid\data\input\impl\DimensionSchemaTest.java,0,6,0,3,0,9
 druid-master\druid-master\processing\src\test\java\org\apache\druid\segment\MergeIntIteratorTest.java,0,27,2,7,0,36
 druid-master\druid-master\processing\src\main\java\org\apache\druid\query\topn\types\DoubleTopNColumnAggregatesProcessor.java,0,21,0,5,0,26
 druid-master\druid-master\core\src\main\java\org\apache\druid\math\expr\vector\LongOutDoubleLongInFunctionVectorValueProcessor.java,0,16,0,2,0,18
 druid-master\druid-master\sql\src\test\java\org\apache\druid\sql\avatica\DruidStatementTest.java,0,58,0,23,0,81
 druid-master\druid-master\indexing-service\src\test\java\org\apache\druid\indexing\overlord\setup\FillCapacityWithCategorySpecWorkerSelectStrategyTest.java,0,17,1,4,0,22
 druid-master\druid-master\core\src\main\java\org\apache\druid\java\util\common\granularity\AllGranularity.java,0,41,3,3,0,47
 druid-master\druid-master\integration-tests\src\main\java\org\apache\druid\testing\IntegrationTestingCuratorConfig.java,0,10,0,3,0,13
 druid-master\druid-master\server\src\main\java\org\apache\druid\client\ImmutableSegmentLoadInfo.java,0,26,0,1,0,27
 druid-master\druid-master\core\src\test\java\org\apache\druid\utils\JvmUtilsTest.java,0,9,2,3,0,14
 druid-master\druid-master\processing\src\main\java\org\apache\druid\query\groupby\epinephelinae\vector\VectorGroupByEngine.java,0,78,2,27,0,107
 druid-master\druid-master\sql\src\main\java\org\apache\druid\sql\calcite\expression\builtin\TimeParseOperatorConversion.java,0,8,0,3,0,11
 druid-master\druid-master\server\src\test\java\org\apache\druid\server\coordinator\DruidCoordinatorConfigTest.java,0,25,0,14,0,39
 druid-master\druid-master\indexing-service\src\main\java\org\apache\druid\indexing\overlord\sampler\SamplerInputRow.java,0,40,0,4,0,44
 druid-master\druid-master\server\src\main\java\org\apache\druid\curator\inventory\CuratorInventoryManagerStrategy.java,0,18,2,7,0,27
 druid-master\druid-master\processing\src\main\java\org\apache\druid\query\groupby\epinephelinae\column\LongGroupByColumnSelectorStrategy.java,0,50,0,9,0,59
 druid-master\druid-master\extensions-contrib\aliyun-oss-extensions\src\test\java\org\apache\druid\storage\aliyun\OssTimestampVersionedDataFinderTest.java,0,30,1,17,0,48
 druid-master\druid-master\core\src\test\java\org\apache\druid\java\util\common\DateTimesTest.java,0,37,1,13,0,51
 druid-master\druid-master\server\src\test\java\org\apache\druid\server\security\EscalatorTest.java,0,3,0,1,0,4
 druid-master\druid-master\server\src\test\java\org\apache\druid\query\lookup\LookupIntrospectionResourceTest.java,0,42,0,16,0,58
 druid-master\druid-master\server\src\test\java\org\apache\druid\client\CacheUtilTest.java,0,53,8,6,0,67
 druid-master\druid-master\core\src\test\java\org\apache\druid\java\util\common\guava\YieldingSequenceBaseTest.java,0,17,0,5,0,22
 druid-master\druid-master\integration-tests\src\main\java\org\apache\druid\testing\utils\WikipediaStreamEventStreamGenerator.java,0,14,0,4,0,18
 druid-master\druid-master\indexing-service\src\test\java\org\apache\druid\indexing\common\task\CompactionTaskTest.java,0,486,9,211,0,706
 druid-master\druid-master\server\src\test\java\org\apache\druid\client\client\BatchServerInventoryViewTest.java,0,107,1,34,0,142
 druid-master\druid-master\extensions-core\histogram\src\main\java\org\apache\druid\query\aggregation\histogram\ApproximateHistogramAggregator.java,0,32,0,8,0,40
 druid-master\druid-master\extensions-core\datasketches\src\main\java\org\apache\druid\query\aggregation\datasketches\quantiles\sql\DoublesSketchApproxQuantileSqlAggregator.java,0,33,0,19,0,52
 druid-master\druid-master\processing\src\main\java\org\apache\druid\segment\FloatDimensionIndexer.java,0,72,1,13,0,86
 druid-master\druid-master\processing\src\test\java\org\apache\druid\collections\TestIntegerSet.java,0,59,1,26,0,86
 druid-master\druid-master\core\src\main\java\org\apache\druid\data\input\impl\JsonLineReader.java,0,31,0,10,0,41
 druid-master\druid-master\processing\src\main\java\org\apache\druid\query\search\SearchStrategySelector.java,0,16,3,6,0,25
 druid-master\druid-master\extensions-core\google-extensions\src\main\java\org\apache\druid\storage\google\GoogleInputDataConfig.java,0,11,0,1,0,12
 druid-master\druid-master\core\src\test\java\org\apache\druid\js\JavaScriptConfigTest.java,0,7,0,1,0,8
 druid-master\druid-master\core\src\main\java\org\apache\druid\java\util\metrics\JvmMonitor.java,0,115,0,26,0,141
 druid-master\druid-master\indexing-service\src\main\java\org\apache\druid\indexing\seekablestream\RecordSupplierInputSource.java,0,47,4,13,0,64
 druid-master\druid-master\server\src\test\java\org\apache\druid\server\log\RequestLoggerProviderTest.java,0,10,0,2,0,12
 druid-master\druid-master\services\src\test\java\org\apache\druid\server\http\security\SecurityResourceFilterTest.java,0,27,2,3,0,32
 druid-master\druid-master\processing\src\main\java\org\apache\druid\query\aggregation\LongMaxAggregatorFactory.java,0,43,0,3,0,46
 druid-master\druid-master\server\src\main\java\org\apache\druid\server\audit\SQLAuditManagerProvider.java,0,27,1,1,0,29
 druid-master\druid-master\server\src\main\java\org\apache\druid\server\initialization\jetty\LimitRequestsFilter.java,0,22,2,3,0,27
 druid-master\druid-master\core\src\main\java\org\apache\druid\timeline\partition\NoneShardSpec.java,0,19,1,1,0,21
 druid-master\druid-master\integration-tests\src\test\java\org\apache\druid\tests\security\ITCoordinatorOverlordProxyAuthTest.java,0,7,0,2,0,9
 druid-master\druid-master\processing\src\main\java\org\apache\druid\query\filter\BooleanFilter.java,0,15,1,9,0,25
 druid-master\druid-master\core\src\main\java\org\apache\druid\metadata\PasswordProviderRedactionMixIn.java,0,4,0,3,0,7
 druid-master\druid-master\indexing-service\src\main\java\org\apache\druid\indexing\common\task\ArchiveTask.java,0,17,2,4,0,23
 druid-master\druid-master\processing\src\main\java\org\apache\druid\segment\filter\BooleanValueMatcher.java,0,5,0,1,0,6
 druid-master\druid-master\processing\src\test\java\org\apache\druid\query\lookup\LookupExtractionFnExpectationsTest.java,0,10,0,1,0,11
 druid-master\druid-master\core\src\test\java\org\apache\druid\metadata\TaskLookupTest.java,0,25,0,8,0,33
 druid-master\druid-master\processing\src\main\java\org\apache\druid\segment\data\EntireLayoutColumnarDoublesSerializer.java,0,33,0,7,0,40
 druid-master\druid-master\core\src\main\java\org\apache\druid\timeline\partition\NumberedOverwriteShardSpec.java,0,89,0,17,0,106
 druid-master\druid-master\server\src\main\java\org\apache\druid\server\coordination\ChangeRequestsSnapshot.java,0,39,0,4,0,43
 druid-master\druid-master\sql\src\test\java\org\apache\druid\sql\calcite\CalciteMultiValueStringQueryTest.java,0,251,0,128,0,379
 druid-master\druid-master\indexing-service\src\main\java\org\apache\druid\indexing\common\SegmentLock.java,0,105,0,9,0,114
 druid-master\druid-master\extensions-contrib\moving-average-query\src\main\java\org\apache\druid\query\movingaverage\averagers\DoubleMeanNoNullAveragerFactory.java,0,10,0,2,0,12
 druid-master\druid-master\extensions-contrib\graphite-emitter\src\main\java\org\apache\druid\emitter\graphite\SendAllGraphiteEventConverter.java,0,54,4,17,0,75
 druid-master\druid-master\server\src\main\java\org\apache\druid\guice\StorageNodeModule.java,0,43,1,12,0,56
 druid-master\druid-master\server\src\main\java\org\apache\druid\server\coordinator\cost\SegmentsCostCache.java,0,173,8,63,0,244
 druid-master\druid-master\sql\src\test\java\org\apache\druid\sql\calcite\schema\NamedLookupSchemaTest.java,0,10,0,1,0,11
 druid-master\druid-master\processing\src\test\java\org\apache\druid\query\groupby\epinephelinae\collection\MemoryOpenHashTableTest.java,0,70,1,21,0,92
 druid-master\druid-master\processing\src\main\java\org\apache\druid\segment\filter\ExpressionFilter.java,0,88,3,36,0,127
 druid-master\druid-master\processing\src\main\java\org\apache\druid\query\SinkQueryRunners.java,0,17,0,3,0,20
 druid-master\druid-master\processing\src\main\java\org\apache\druid\segment\join\table\UniqueLongArrayIndex.java,0,19,0,2,0,21
 druid-master\druid-master\benchmarks\src\test\java\org\apache\druid\benchmark\query\TopNBenchmark.java,0,102,4,35,0,141
 druid-master\druid-master\server\src\main\java\org\apache\druid\client\cache\Cache.java,0,30,1,4,0,35
 druid-master\druid-master\server\src\main\java\org\apache\druid\client\cache\MemcachedOperationQueueFactory.java,0,12,0,1,0,13
 druid-master\druid-master\server\src\main\java\org\apache\druid\server\scheduling\NoQueryLaningStrategy.java,0,14,0,4,0,18
 druid-master\druid-master\extensions-contrib\cassandra-storage\src\main\java\org\apache\druid\storage\cassandra\CassandraDataSegmentPusher.java,0,45,3,12,2,62
 druid-master\druid-master\indexing-service\src\main\java\org\apache\druid\indexing\overlord\http\security\SupervisorResourceFilter.java,0,21,0,6,0,27
 druid-master\druid-master\server\src\main\java\org\apache\druid\server\metrics\DataSourceTaskIdHolder.java,0,14,0,1,0,15
 druid-master\druid-master\indexing-service\src\main\java\org\apache\druid\indexing\common\TaskToolbox.java,0,259,0,15,0,274
 druid-master\druid-master\indexing-service\src\test\java\org\apache\druid\indexing\common\task\batch\parallel\TombstoneHelperTest.java,0,23,0,15,0,38
 druid-master\druid-master\extensions-contrib\moving-average-query\src\main\java\org\apache\druid\query\movingaverage\averagers\LongSumAverager.java,0,10,1,2,0,13
 druid-master\druid-master\processing\src\main\java\org\apache\druid\query\filter\OrDimFilter.java,0,41,2,5,0,48
 druid-master\druid-master\server\src\main\java\org\apache\druid\server\coordination\DataSegmentChangeHandler.java,0,5,0,3,0,8
 druid-master\druid-master\integration-tests\src\test\java\org\apache\druid\tests\leadership\ITHighAvailabilityTest.java,0,80,3,28,0,111
 druid-master\druid-master\sql\src\test\java\org\apache\druid\sql\avatica\ErrorHandlerTest.java,0,21,0,12,0,33
 druid-master\druid-master\server\src\main\java\org\apache\druid\client\indexing\IndexingServiceSelectorConfig.java,0,6,0,1,0,7
 druid-master\druid-master\services\src\main\java\org\apache\druid\cli\CliHistorical.java,0,33,0,14,0,47
 druid-master\druid-master\extensions-core\orc-extensions\src\main\java\org\apache\druid\data\input\orc\guice\Orc.java,0,5,0,4,0,9
 druid-master\druid-master\processing\src\main\java\org\apache\druid\query\lookup\LookupSnapshotTaker.java,0,29,1,7,0,37
 druid-master\druid-master\server\src\main\java\org\apache\druid\segment\LookupSegmentWrangler.java,0,11,0,4,0,15
 druid-master\druid-master\processing\src\main\java\org\apache\druid\segment\SimpleSettableOffset.java,0,2,0,1,0,3
 druid-master\druid-master\sql\src\main\java\org\apache\druid\sql\avatica\AvaticaModule.java,0,6,0,2,0,8
 druid-master\druid-master\processing\src\main\java\org\apache\druid\query\groupby\epinephelinae\vector\NilGroupByVectorColumnSelector.java,0,21,1,5,0,27
 druid-master\druid-master\server\src\test\java\org\apache\druid\server\metrics\TaskSlotCountStatsMonitorTest.java,0,24,0,8,0,32
 druid-master\druid-master\extensions-core\kafka-indexing-service\src\main\java\org\apache\druid\data\input\kafkainput\KafkaHeaderReader.java,0,2,0,1,0,3
 druid-master\druid-master\extensions-core\druid-basic-security\src\main\java\org\apache\druid\security\basic\authorization\entity\BasicAuthorizerRoleFull.java,0,41,0,7,0,48
 druid-master\druid-master\extensions-core\kafka-extraction-namespace\src\test\java\org\apache\druid\query\lookup\TestKafkaExtractionCluster.java,0,70,4,26,0,100
 druid-master\druid-master\extensions-core\azure-extensions\src\main\java\org\apache\druid\storage\azure\blob\CloudBlobHolder.java,0,20,0,2,0,22
 druid-master\druid-master\sql\src\main\java\org\apache\druid\sql\calcite\aggregation\builtin\MultiColumnSqlAggregator.java,0,35,0,10,0,45
 druid-master\druid-master\server\src\main\java\org\apache\druid\curator\discovery\ServerDiscoveryFactory.java,0,18,1,2,0,21
 druid-master\druid-master\server\src\main\java\org\apache\druid\server\initialization\AuthenticatorMapperModule.java,0,34,1,11,0,46
 druid-master\druid-master\processing\src\main\java\org\apache\druid\segment\ColumnSelector.java,0,4,0,1,0,5
 druid-master\druid-master\integration-tests\src\test\java\org\apache\druid\tests\indexer\ITKinesisIndexingServiceSerializedTest.java,0,24,0,8,0,32
 druid-master\druid-master\core\src\main\java\org\apache\druid\data\input\impl\DimensionSchema.java,0,69,0,12,0,81
 druid-master\druid-master\sql\src\main\java\org\apache\druid\sql\calcite\planner\SqlParameterizerShuttle.java,0,23,0,14,0,37
 druid-master\druid-master\sql\src\main\java\org\apache\druid\sql\calcite\filtration\BottomUpTransform.java,0,9,0,4,0,13
 druid-master\druid-master\core\src\main\java\org\apache\druid\java\util\common\parsers\JSONPathFieldType.java,0,8,0,1,0,9
 druid-master\druid-master\processing\src\test\java\org\apache\druid\query\aggregation\any\DoubleAnyAggregationTest.java,0,56,0,8,0,64
 druid-master\druid-master\processing\src\test\java\org\apache\druid\query\scan\ScanQueryRunnerTest.java,0,311,20,195,0,526
 druid-master\druid-master\core\src\main\java\org\apache\druid\collections\DefaultBlockingPool.java,0,59,2,10,0,71
 druid-master\druid-master\core\src\main\java\org\apache\druid\java\util\common\guava\SimpleSequence.java,0,11,1,1,0,13
 druid-master\druid-master\extensions-core\histogram\src\test\java\org\apache\druid\query\aggregation\histogram\FixedBucketsHistogramGroupByQueryTest.java,0,64,1,12,0,77
 druid-master\druid-master\processing\src\test\java\org\apache\druid\query\QueryDataSourceTest.java,0,56,14,9,0,79
 druid-master\druid-master\server\src\main\java\org\apache\druid\client\CacheUtil.java,0,69,1,15,0,85
 druid-master\druid-master\server\src\main\java\org\apache\druid\server\initialization\jetty\JettyServerInitUtils.java,0,29,1,10,0,40
 druid-master\druid-master\indexing-service\src\main\java\org\apache\druid\indexing\seekablestream\SettableByteEntity.java,0,38,0,10,0,48
 druid-master\druid-master\extensions-contrib\dropwizard-emitter\src\main\java\org\apache\druid\emitter\dropwizard\DropwizardEmitter.java,0,49,0,9,0,58
 druid-master\druid-master\core\src\main\java\org\apache\druid\java\util\common\jackson\JacksonUtils.java,0,23,0,5,0,28
 druid-master\druid-master\processing\src\main\java\org\apache\druid\query\aggregation\any\LongAnyAggregator.java,0,16,0,2,0,18
 druid-master\druid-master\server\src\main\java\org\apache\druid\server\initialization\jetty\JettyBindings.java,0,37,2,4,0,43
 druid-master\druid-master\server\src\main\java\org\apache\druid\server\emitter\LogEmitterModule.java,0,12,0,3,0,15
 druid-master\druid-master\indexing-service\src\test\java\org\apache\druid\indexing\overlord\autoscaling\PendingTaskBasedProvisioningStrategyTest.java,0,200,1,60,0,261
 druid-master\druid-master\sql\src\main\java\org\apache\druid\sql\calcite\table\RowSignatures.java,0,47,0,18,0,65
 druid-master\druid-master\extensions-contrib\moving-average-query\src\test\java\org\apache\druid\query\movingaverage\RowBucketIterableTest.java,0,89,0,21,0,110
 druid-master\druid-master\core\src\main\java\org\apache\druid\java\util\common\guava\MappingAccumulator.java,0,17,3,3,0,23
 druid-master\druid-master\extensions-core\lookups-cached-global\src\test\java\org\apache\druid\server\lookup\namespace\cache\OnHeapNamespaceExtractionCacheManagerTest.java,0,14,1,4,0,19
 druid-master\druid-master\server\src\main\java\org\apache\druid\metadata\storage\derby\DerbyMetadataStorage.java,0,15,0,2,0,17
 druid-master\druid-master\sql\src\main\java\org\apache\druid\sql\calcite\rule\DruidJoinRule.java,0,106,1,57,0,164
 druid-master\druid-master\indexing-service\src\main\java\org\apache\druid\indexing\overlord\HeapMemoryTaskStorage.java,0,122,2,22,0,146
 druid-master\druid-master\extensions-core\kinesis-indexing-service\src\main\java\org\apache\druid\indexing\kinesis\KinesisSequenceNumber.java,0,30,1,10,0,41
 druid-master\druid-master\core\src\main\java\org\apache\druid\java\util\metrics\KeyedDiff.java,0,15,1,3,0,19
 druid-master\druid-master\processing\src\test\java\org\apache\druid\segment\ConciseBitmapIndexMergerV9Test.java,0,7,0,1,0,8
 druid-master\druid-master\server\src\test\java\org\apache\druid\server\coordinator\RunRulesTest.java,0,341,0,194,0,535
 druid-master\druid-master\extensions-core\mysql-metadata-storage\src\main\java\org\apache\druid\metadata\storage\mysql\MySQLConnectorDriverConfig.java,0,14,0,1,0,15
 druid-master\druid-master\processing\src\main\java\org\apache\druid\segment\writeout\HeapByteBufferWriteOutBytes.java,0,2,0,1,0,3
 druid-master\druid-master\server\src\test\java\org\apache\druid\server\coordinator\UserCompactionTaskQueryTuningConfigTest.java,0,9,0,4,0,13
 druid-master\druid-master\extensions-core\lookups-cached-global\src\test\java\org\apache\druid\query\lookup\NamespaceLookupExtractorFactoryTest.java,0,116,0,42,0,158
 druid-master\druid-master\extensions-core\kafka-extraction-namespace\src\test\java\org\apache\druid\query\lookup\KafkaLookupExtractorFactoryTest.java,0,72,0,19,0,91
 druid-master\druid-master\processing\src\main\java\org\apache\druid\segment\DoubleDimensionMergerV9.java,0,12,0,4,0,16
 druid-master\druid-master\core\src\main\java\org\apache\druid\indexer\Property.java,0,30,0,1,0,31
 druid-master\druid-master\server\src\test\java\org\apache\druid\query\lookup\RegisteredLookupExtractionFnTest.java,0,40,0,13,0,53
 druid-master\druid-master\core\src\main\java\org\apache\druid\java\util\common\ByteBufferUtils.java,0,37,4,14,0,55
 druid-master\druid-master\extensions-contrib\redis-cache\src\main\java\org\apache\druid\client\cache\RedisDruidModule.java,0,6,0,2,0,8
 druid-master\druid-master\processing\src\main\java\org\apache\druid\query\CacheStrategy.java,0,38,2,22,0,62
 druid-master\druid-master\extensions-contrib\momentsketch\src\main\java\org\apache\druid\query\aggregation\momentsketch\aggregator\MomentSketchMergeAggregator.java,0,17,0,1,0,18
 druid-master\druid-master\extensions-contrib\time-min-max\src\test\java\org\apache\druid\query\aggregation\TimestampMinMaxAggregatorFactoryTest.java,0,16,0,10,0,26
 druid-master\druid-master\processing\src\main\java\org\apache\druid\query\SubqueryQueryRunner.java,0,18,0,8,0,26
 druid-master\druid-master\extensions-core\kafka-extraction-namespace\src\test\java\org\apache\druid\server\lookup\namespace\cache\MockNamespaceExtractionCacheManager.java,0,8,1,4,0,13
 druid-master\druid-master\integration-tests\src\test\java\org\apache\druid\tests\indexer\ITNilColumnTest.java,0,43,3,23,0,69
 druid-master\druid-master\core\src\test\java\org\apache\druid\timeline\partition\SingleDimensionRangeBucketShardSpecTest.java,0,22,0,10,0,32
 druid-master\druid-master\processing\src\test\java\org\apache\druid\segment\RowBasedStorageAdapterTest.java,0,162,35,44,0,241
 druid-master\druid-master\server\src\test\java\org\apache\druid\client\ImmutableDruidDataSourceTest.java,0,19,0,8,0,27
 druid-master\druid-master\indexing-service\src\main\java\org\apache\druid\indexing\overlord\setup\WorkerSelectStrategy.java,0,10,0,10,0,20
 druid-master\druid-master\extensions-core\postgresql-metadata-storage\src\main\java\org\apache\druid\metadata\storage\postgresql\PostgreSQLMetadataStorageModule.java,0,14,0,6,0,20
 druid-master\druid-master\services\src\main\java\org\apache\druid\server\router\JavaScriptTieredBrokerSelectorStrategy.java,0,32,1,6,0,39
 druid-master\druid-master\indexing-service\src\main\java\org\apache\druid\indexing\seekablestream\common\StreamPartition.java,0,34,1,4,0,39
 druid-master\druid-master\extensions-core\druid-basic-security\src\main\java\org\apache\druid\security\basic\authentication\db\updater\NoopBasicAuthenticatorMetadataStorageUpdater.java,0,24,4,6,0,34
 druid-master\druid-master\services\src\main\java\org\apache\druid\server\http\RouterResource.java,0,13,0,4,0,17
 druid-master\druid-master\core\src\test\java\org\apache\druid\collections\CloseableDefaultBlockingPool.java,0,8,0,2,0,10
 druid-master\druid-master\indexing-service\src\main\java\org\apache\druid\indexing\seekablestream\supervisor\autoscaler\LagBasedAutoScalerConfig.java,0,141,1,30,0,172
 druid-master\druid-master\processing\src\main\java\org\apache\druid\segment\DoubleColumnSelector.java,0,16,0,12,0,28
 druid-master\druid-master\processing\src\main\java\org\apache\druid\segment\column\RowSignature.java,0,94,1,31,0,126
 druid-master\druid-master\core\src\test\java\org\apache\druid\testing\DeadlockDetectingFailOnTimeout.java,0,61,7,16,0,84
 druid-master\druid-master\sql\src\main\java\org\apache\druid\sql\calcite\filtration\MoveMarkerFiltersToIntervals.java,0,9,1,3,0,13
 druid-master\druid-master\server\src\test\java\org\apache\druid\client\cache\HybridCacheTest.java,0,22,0,9,0,31
 druid-master\druid-master\processing\src\main\java\org\apache\druid\segment\transform\TransformingInputRowParser.java,0,20,0,4,0,24
 druid-master\druid-master\extensions-contrib\materialized-view-selection\src\main\java\org\apache\druid\query\materializedview\DataSourceOptimizer.java,0,62,0,40,0,102
 druid-master\druid-master\indexing-service\src\test\java\org\apache\druid\indexing\common\task\batch\parallel\GenericPartitionLocationTest.java,0,14,0,4,0,18
 druid-master\druid-master\core\src\main\java\org\apache\druid\guice\annotations\JSR311Resource.java,0,1,0,1,0,2
 druid-master\druid-master\processing\src\main\java\org\apache\druid\segment\vector\VectorOffset.java,0,4,0,3,0,7
 druid-master\druid-master\indexing-service\src\main\java\org\apache\druid\indexing\seekablestream\common\StreamException.java,0,4,0,1,0,5
 druid-master\druid-master\extensions-core\parquet-extensions\src\test\java\org\apache\druid\data\input\parquet\WikiParquetReaderTest.java,0,10,0,7,0,17
 druid-master\druid-master\extensions-contrib\dropwizard-emitter\src\main\java\org\apache\druid\emitter\dropwizard\DropwizardEmitterModule.java,0,16,0,5,0,21
 druid-master\druid-master\extensions-contrib\influx-extensions\src\main\java\org\apache\druid\data\input\influx\InfluxParseSpec.java,0,12,1,1,1,15
 druid-master\druid-master\processing\src\main\java\org\apache\druid\segment\SegmentValidationException.java,0,11,0,2,0,13
 druid-master\druid-master\extensions-core\druid-bloom-filter\src\test\java\org\apache\druid\query\aggregation\bloom\BloomFilterAggregatorFactoryTest.java,0,12,0,8,0,20
 druid-master\druid-master\extensions-contrib\momentsketch\src\test\java\org\apache\druid\query\aggregation\momentsketch\aggregator\MomentSketchMaxPostAggregatorTest.java,0,13,0,5,0,18
 druid-master\druid-master\core\src\main\java\org\apache\druid\java\util\common\FileUtils.java,0,149,12,49,0,210
 druid-master\druid-master\core\src\main\java\org\apache\druid\timeline\partition\LinearPartialShardSpec.java,0,13,1,3,0,17
 druid-master\druid-master\extensions-contrib\opentelemetry-emitter\src\main\java\org\apache\druid\emitter\opentelemetry\OpenTelemetryEmitterModule.java,0,16,0,5,0,21
 druid-master\druid-master\indexing-service\src\main\java\org\apache\druid\indexing\seekablestream\SeekableStreamEndSequenceNumbers.java,0,72,2,32,0,106
 druid-master\druid-master\processing\src\main\java\org\apache\druid\query\aggregation\LongMaxVectorAggregator.java,0,16,0,3,0,19
 druid-master\druid-master\server\src\main\java\org\apache\druid\segment\realtime\firehose\ChatHandler.java,0,3,0,3,0,6
 druid-master\druid-master\core\src\main\java\org\apache\druid\common\guava\ThreadRenamingRunnable.java,0,9,0,1,0,10
 druid-master\druid-master\sql\src\main\java\org\apache\druid\sql\calcite\schema\NamedLookupSchema.java,0,11,0,1,0,12
 druid-master\druid-master\indexing-service\src\test\java\org\apache\druid\indexing\worker\shuffle\LocalIntermediaryDataManagerManualAddAndDeleteTest.java,0,70,0,25,0,95
 druid-master\druid-master\integration-tests\src\test\java\org\apache\druid\tests\indexer\AbstractS3AssumeRoleIndexTest.java,0,58,3,35,0,96
 druid-master\druid-master\processing\src\main\java\org\apache\druid\segment\transform\RowFunction.java,0,2,0,1,0,3
 druid-master\druid-master\core\src\test\java\org\apache\druid\data\input\impl\DelimitedParseSpecTest.java,0,12,0,5,2,19
 druid-master\druid-master\server\src\test\java\org\apache\druid\server\coordinator\ReservoirSegmentSamplerTest.java,0,51,5,15,0,71
 druid-master\druid-master\server\src\test\java\org\apache\druid\server\http\DataSourcesResourceTest.java,0,499,7,282,0,788
 druid-master\druid-master\processing\src\main\java\org\apache\druid\query\aggregation\post\LongGreatestPostAggregator.java,0,45,3,5,0,53
 druid-master\druid-master\server\src\main\java\org\apache\druid\server\metrics\TaskCountStatsProvider.java,0,8,0,3,0,11
 druid-master\druid-master\extensions-core\druid-ranger-security\src\test\java\org\apache\druid\security\ranger\authorizer\RangerAdminClientImpl.java,0,22,1,7,0,30
 druid-master\druid-master\extensions-contrib\kafka-emitter\src\main\java\org\apache\druid\emitter\kafka\KafkaEmitterConfig.java,0,68,0,11,0,79
 druid-master\druid-master\sql\src\main\java\org\apache\druid\sql\calcite\rel\VirtualColumnRegistry.java,0,141,0,38,0,179
 druid-master\druid-master\processing\src\main\java\org\apache\druid\query\groupby\epinephelinae\GroupByRowProcessor.java,0,53,0,25,0,78
 druid-master\druid-master\integration-tests\src\main\java\org\apache\druid\testing\utils\QueryResultVerifier.java,0,7,2,1,0,10
 druid-master\druid-master\processing\src\main\java\org\apache\druid\query\topn\TopNMetricSpec.java,0,15,0,8,0,23
 druid-master\druid-master\indexing-service\src\test\java\org\apache\druid\indexing\overlord\SingleTaskBackgroundRunnerTest.java,0,71,0,12,0,83
 druid-master\druid-master\indexing-service\src\main\java\org\apache\druid\indexing\worker\http\TaskManagementResource.java,0,76,3,24,0,103
 druid-master\druid-master\extensions-core\postgresql-metadata-storage\src\main\java\org\apache\druid\metadata\storage\postgresql\PostgreSQLConnectorConfig.java,0,54,0,2,0,56
 druid-master\druid-master\services\src\main\java\org\apache\druid\cli\DumpSegment.java,0,103,4,32,0,139
 druid-master\druid-master\core\src\main\java\org\apache\druid\data\input\TextReader.java,0,36,1,10,0,47
 druid-master\druid-master\processing\src\main\java\org\apache\druid\segment\CompressedPools.java,0,34,6,11,0,51
 druid-master\druid-master\integration-tests\src\main\java\org\apache\druid\testing\utils\LoggerListener.java,0,17,4,2,0,23
 druid-master\druid-master\extensions-core\druid-bloom-filter\src\main\java\org\apache\druid\query\filter\BloomDimFilter.java,0,79,0,6,0,85
 druid-master\druid-master\indexing-service\src\main\java\org\apache\druid\indexing\common\task\batch\parallel\PartialSegmentMergeIngestionSpec.java,0,6,0,2,0,8
 druid-master\druid-master\processing\src\main\java\org\apache\druid\query\QueryRunnerHelper.java,0,15,1,6,0,22
 druid-master\druid-master\processing\src\main\java\org\apache\druid\query\aggregation\DoubleMaxAggregator.java,0,21,0,1,0,22
 druid-master\druid-master\indexing-service\src\main\java\org\apache\druid\indexing\seekablestream\supervisor\TaskReportData.java,0,69,2,3,0,74
 druid-master\druid-master\processing\src\main\java\org\apache\druid\segment\data\IntermediateColumnarLongsSerializer.java,0,44,0,6,0,50
 druid-master\druid-master\indexing-hadoop\src\main\java\org\apache\druid\indexer\HadoopWorkingDirCleaner.java,0,7,1,1,0,9
 druid-master\druid-master\processing\src\main\java\org\apache\druid\query\filter\vector\DoubleVectorValueMatcher.java,0,20,0,5,0,25
 druid-master\druid-master\extensions-core\druid-basic-security\src\main\java\org\apache\druid\security\basic\authorization\endpoint\DefaultBasicAuthorizerResourceHandler.java,0,139,0,30,0,169
 druid-master\druid-master\extensions-core\druid-basic-security\src\main\java\org\apache\druid\security\basic\authorization\entity\BasicAuthorizerRoleSimplifiedPermissions.java,0,56,0,15,0,71
 druid-master\druid-master\extensions-core\avro-extensions\src\main\java\org\apache\druid\data\input\avro\AvroValueInputFormat.java,0,15,0,9,0,24
 druid-master\druid-master\core\src\test\java\org\apache\druid\java\util\emitter\core\HttpPostEmitterTest.java,0,23,1,5,1,30
 druid-master\druid-master\core\src\main\java\org\apache\druid\data\input\impl\prefetch\JsonIterator.java,0,28,0,6,0,34
 druid-master\druid-master\processing\src\main\java\org\apache\druid\query\aggregation\mean\DoubleMeanBufferAggregator.java,0,35,1,1,0,37
 druid-master\druid-master\processing\src\main\java\org\apache\druid\collections\spatial\search\RectangularBound.java,0,57,0,4,0,61
 druid-master\druid-master\sql\src\test\java\org\apache\druid\sql\guice\SqlModuleTest.java,0,57,4,17,0,78
 druid-master\druid-master\core\src\test\java\org\apache\druid\java\util\http\client\response\SequenceInputStreamResponseHandlerTest.java,0,64,6,26,1,97
 druid-master\druid-master\indexing-service\src\test\java\org\apache\druid\indexing\overlord\RemoteTaskRunnerTest.java,0,221,6,72,0,299
 druid-master\druid-master\core\src\main\java\org\apache\druid\data\input\InputSplit.java,0,16,0,3,0,19
 druid-master\druid-master\indexing-service\src\main\java\org\apache\druid\indexing\common\task\batch\parallel\ParallelIndexTuningConfig.java,0,146,1,29,0,176
 druid-master\druid-master\server\src\main\java\org\apache\druid\client\indexing\IndexingWorkerInfo.java,0,44,0,2,0,46
 druid-master\druid-master\extensions-core\datasketches\src\main\java\org\apache\druid\query\aggregation\datasketches\hll\HllSketchToEstimateWithBoundsPostAggregator.java,0,54,0,11,0,65
 druid-master\druid-master\core\src\main\java\org\apache\druid\math\expr\vector\CastToStringVectorProcessor.java,0,9,0,3,0,12
 druid-master\druid-master\core\src\main\java\org\apache\druid\math\expr\vector\UnivariateFunctionVectorObjectProcessor.java,0,29,2,5,1,37
 druid-master\druid-master\processing\src\test\java\org\apache\druid\query\aggregation\ExpressionLambdaAggregatorFactoryTest.java,0,127,0,57,0,184
 druid-master\druid-master\server\src\test\java\org\apache\druid\segment\realtime\appenderator\StreamAppenderatorDriverTest.java,0,123,2,49,0,174
 druid-master\druid-master\indexing-service\src\main\java\org\apache\druid\indexing\common\task\SpecificSegmentsSpec.java,0,32,0,4,0,36
 druid-master\druid-master\benchmarks\src\test\java\org\apache\druid\benchmark\FilteredAggregatorBenchmark.java,0,109,4,32,0,145
 druid-master\druid-master\server\src\main\java\org\apache\druid\indexing\overlord\supervisor\SupervisorModule.java,0,5,0,2,0,7
 druid-master\druid-master\processing\src\main\java\org\apache\druid\segment\virtual\SingleLongInputCachingExpressionColumnValueSelector.java,0,40,0,9,0,49
 druid-master\druid-master\server\src\main\java\org\apache\druid\server\log\NoopRequestLoggerProvider.java,0,5,0,1,0,6
 druid-master\druid-master\indexing-hadoop\src\main\java\org\apache\druid\indexer\path\MetadataStoreBasedUsedSegmentsRetriever.java,0,15,0,5,0,20
 druid-master\druid-master\integration-tests\src\test\java\org\apache\druid\tests\indexer\ITKafkaIndexingServiceNonTransactionalSerializedTest.java,0,15,0,5,0,20
 druid-master\druid-master\server\src\test\java\org\apache\druid\client\CachingClusteredClientTest.java,0,1826,7,484,0,2317
 druid-master\druid-master\server\src\main\java\org\apache\druid\guice\JoinableFactoryModule.java,0,8,0,5,0,13
 druid-master\druid-master\extensions-core\druid-bloom-filter\src\main\java\org\apache\druid\query\aggregation\bloom\NoopBloomFilterAggregator.java,0,11,0,2,0,13
 druid-master\druid-master\processing\src\main\java\org\apache\druid\query\groupby\epinephelinae\vector\NullableLongGroupByVectorColumnSelector.java,0,13,0,3,0,16
 druid-master\druid-master\core\src\test\java\org\apache\druid\timeline\VersionedIntervalTimelineTest.java,0,500,0,166,0,666
 druid-master\druid-master\processing\src\test\java\org\apache\druid\segment\data\VSizeColumnarIntsTest.java,0,6,0,2,0,8
 druid-master\druid-master\extensions-core\histogram\src\main\java\org\apache\druid\query\aggregation\histogram\FixedBucketsHistogramBufferAggregatorHelper.java,0,32,0,4,0,36
 druid-master\druid-master\server\src\main\java\org\apache\druid\server\coordinator\duty\MarkAsUnusedOvershadowedSegments.java,0,22,0,11,0,33
 druid-master\druid-master\processing\src\main\java\org\apache\druid\query\aggregation\FloatMaxAggregatorFactory.java,0,44,0,3,0,47
 druid-master\druid-master\sql\src\main\java\org\apache\druid\sql\calcite\aggregation\ApproxCountDistinctSqlAggregator.java,0,26,0,4,0,30
 druid-master\druid-master\core\src\main\java\org\apache\druid\java\util\emitter\core\ConcurrentTimeCounter.java,0,37,0,6,0,43
 druid-master\druid-master\core\src\main\java\org\apache\druid\java\util\common\guava\FilteringYieldingAccumulator.java,0,27,2,3,0,32
 druid-master\druid-master\processing\src\test\java\org\apache\druid\guice\GuiceInjectorsTest.java,0,21,0,1,0,22
 druid-master\druid-master\server\src\main\java\org\apache\druid\client\CachingQueryRunner.java,0,59,1,6,0,66
 druid-master\druid-master\services\src\main\java\org\apache\druid\cli\CliHadoopIndexer.java,0,23,3,12,0,38
 druid-master\druid-master\core\src\main\java\org\apache\druid\java\util\metrics\Monitor.java,0,4,0,1,0,5
 druid-master\druid-master\core\src\test\java\org\apache\druid\java\util\metrics\cgroups\CpuTest.java,0,16,0,5,0,21
 druid-master\druid-master\processing\src\main\java\org\apache\druid\query\aggregation\any\NumericNilVectorAggregator.java,0,33,1,4,0,38
 druid-master\druid-master\server\src\main\java\org\apache\druid\server\coordinator\rules\IntervalLoadRule.java,0,39,2,5,0,46
 druid-master\druid-master\extensions-core\datasketches\src\main\java\org\apache\druid\query\aggregation\datasketches\quantiles\package-info.java,0,1,0,1,0,2
 druid-master\druid-master\server\src\test\java\org\apache\druid\client\indexing\HttpIndexingServiceClientTest.java,0,96,0,59,0,155
 druid-master\druid-master\indexing-service\src\main\java\org\apache\druid\indexing\worker\TaskAnnouncement.java,0,63,1,8,0,72
 druid-master\druid-master\extensions-core\datasketches\src\main\java\org\apache\druid\query\aggregation\datasketches\quantiles\DoublesSketchComplexMetricSerde.java,0,32,1,16,0,49
 druid-master\druid-master\processing\src\main\java\org\apache\druid\segment\vector\BaseLongVectorValueSelector.java,0,18,0,1,0,19
 druid-master\druid-master\server\src\main\java\org\apache\druid\server\coordinator\duty\NewestSegmentFirstIterator.java,0,249,10,135,0,394
 druid-master\druid-master\integration-tests\src\main\java\org\apache\druid\testing\utils\JsonEventSerializer.java,0,12,1,2,0,15
 druid-master\druid-master\indexing-service\src\main\java\org\apache\druid\indexing\common\task\IndexTaskUtils.java,0,28,3,7,0,38
 druid-master\druid-master\extensions-core\s3-extensions\src\main\java\org\apache\druid\data\input\s3\S3InputSourceDruidModule.java,0,7,1,2,0,10
 druid-master\druid-master\core\src\main\java\org\apache\druid\java\util\http\client\HttpClient.java,0,16,0,16,0,32
 druid-master\druid-master\extensions-contrib\aliyun-oss-extensions\src\main\java\org\apache\druid\storage\aliyun\OssDataSegmentKiller.java,0,30,2,11,0,43
 druid-master\druid-master\core\src\test\java\org\apache\druid\query\cache\CacheKeyBuilderTest.java,0,77,0,12,0,89
 druid-master\druid-master\integration-tests\src\main\java\org\apache\druid\testing\IntegrationTestingConfigProvider.java,0,4,0,4,0,8
 druid-master\druid-master\server\src\main\java\org\apache\druid\server\security\UnsecuredResourceFilter.java,0,14,2,6,0,22
 druid-master\druid-master\processing\src\main\java\org\apache\druid\query\aggregation\FloatMaxVectorAggregator.java,0,16,0,3,0,19
 druid-master\druid-master\server\src\main\java\org\apache\druid\server\http\CoordinatorDynamicConfigsResource.java,0,25,0,5,0,30
 druid-master\druid-master\extensions-contrib\momentsketch\src\main\java\org\apache\druid\query\aggregation\momentsketch\MomentSketchObjectStrategy.java,0,16,0,3,0,19
 druid-master\druid-master\processing\src\main\java\org\apache\druid\query\topn\DimensionAndMetricValueExtractor.java,0,20,1,2,0,23
 druid-master\druid-master\core\src\test\java\org\apache\druid\collections\StupidPoolTest.java,0,21,2,2,4,29
 druid-master\druid-master\core\src\main\java\org\apache\druid\indexer\TaskMetricsUtils.java,0,13,1,2,0,16
 druid-master\druid-master\server\src\main\java\org\apache\druid\segment\realtime\appenderator\UsedSegmentChecker.java,0,3,0,3,0,6
 druid-master\druid-master\sql\src\main\java\org\apache\druid\sql\calcite\expression\builtin\ReverseOperatorConversion.java,0,4,0,1,0,5
 druid-master\druid-master\extensions-contrib\materialized-view-selection\src\main\java\org\apache\druid\query\materializedview\DataSourceOptimizerMonitor.java,0,19,0,9,0,28
 druid-master\druid-master\processing\src\test\java\org\apache\druid\segment\RowIteratorHelper.java,0,7,0,2,0,9
 druid-master\druid-master\extensions-core\kubernetes-extensions\src\main\java\org\apache\druid\k8s\discovery\DiscoveryDruidNodeAndResourceVersion.java,0,16,0,2,0,18
 druid-master\druid-master\processing\src\main\java\org\apache\druid\collections\bitmap\ConcisePeekableIteratorAdapter.java,0,7,0,2,0,9
 druid-master\druid-master\core\src\test\java\org\apache\druid\java\util\common\guava\MergeSequenceTest.java,0,100,0,15,3,118
 druid-master\druid-master\benchmarks\src\test\java\org\apache\druid\benchmark\LikeFilterBenchmark.java,0,51,1,6,0,58
 druid-master\druid-master\processing\src\main\java\org\apache\druid\query\PrioritizedQueryRunnerCallable.java,0,10,0,8,0,18
 druid-master\druid-master\sql\src\main\java\org\apache\druid\sql\calcite\expression\builtin\SafeDivideOperatorConversion.java,0,6,0,1,0,7
 druid-master\druid-master\processing\src\main\java\org\apache\druid\segment\data\V3CompressedVSizeColumnarMultiIntsSerializer.java,0,35,0,7,0,42
 druid-master\druid-master\extensions-core\kafka-indexing-service\src\main\java\org\apache\druid\indexing\kafka\KafkaIndexTaskClient.java,0,14,0,2,0,16
 druid-master\druid-master\processing\src\main\java\org\apache\druid\query\groupby\having\DimensionSelectorHavingSpec.java,0,44,1,4,0,49
 druid-master\druid-master\server\src\test\java\org\apache\druid\server\coordinator\AutoCompactionSnapshotTest.java,0,34,0,4,0,38
 druid-master\druid-master\processing\src\main\java\org\apache\druid\segment\join\table\ReferenceCountingIndexedTable.java,0,25,0,2,0,27
 druid-master\druid-master\processing\src\main\java\org\apache\druid\segment\data\V3CompressedVSizeColumnarMultiIntsSupplier.java,0,46,1,21,0,68
 druid-master\druid-master\processing\src\main\java\org\apache\druid\segment\virtual\ExpressionVirtualColumn.java,0,111,2,27,0,140
 druid-master\druid-master\processing\src\main\java\org\apache\druid\query\aggregation\last\StringLastAggregatorFactory.java,0,94,1,14,0,109
 druid-master\druid-master\extensions-core\datasketches\src\test\java\org\apache\druid\query\aggregation\datasketches\hll\HllSketchUnionPostAggregatorTest.java,0,8,0,2,0,10
 druid-master\druid-master\server\src\main\java\org\apache\druid\segment\realtime\firehose\TimedShutoffFirehoseFactory.java,0,39,1,8,0,48
 druid-master\druid-master\core\src\test\java\org\apache\druid\collections\BlockingPoolTest.java,0,97,0,32,0,129
 druid-master\druid-master\core\src\main\java\org\apache\druid\data\input\impl\SplittableInputSource.java,0,27,0,14,0,41
 druid-master\druid-master\processing\src\main\java\org\apache\druid\segment\join\Equality.java,0,22,0,4,0,26
 druid-master\druid-master\benchmarks\src\test\java\org\apache\druid\benchmark\GroupByTypeInterfaceBenchmark.java,0,153,3,44,0,200
 druid-master\druid-master\indexing-service\src\main\java\org\apache\druid\indexing\seekablestream\SeekableStreamSamplerSpec.java,0,57,3,18,0,78
 druid-master\druid-master\core\src\main\java\org\apache\druid\data\input\impl\AbstractTextFilesFirehoseFactory.java,0,37,0,15,1,53
 druid-master\druid-master\processing\src\main\java\org\apache\druid\segment\incremental\ParseExceptionHandler.java,0,28,0,8,0,36
 druid-master\druid-master\processing\src\main\java\org\apache\druid\query\groupby\epinephelinae\ParallelCombiner.java,0,158,4,62,0,224
 druid-master\druid-master\services\src\main\java\org\apache\druid\cli\CliRouter.java,0,26,0,13,0,39
 druid-master\druid-master\server\src\test\java\org\apache\druid\initialization\ServerConfigTest.java,0,18,0,10,0,28
 druid-master\druid-master\processing\src\test\java\org\apache\druid\query\filter\vector\VectorValueMatcherColumnProcessorFactoryTest.java,0,71,0,48,0,119
 druid-master\druid-master\extensions-core\druid-basic-security\src\main\java\org\apache\druid\security\basic\BasicAuthUtils.java,0,113,1,28,0,142
 druid-master\druid-master\core\src\main\java\org\apache\druid\tasklogs\TaskLogs.java,0,1,0,1,0,2
 druid-master\druid-master\extensions-core\histogram\src\main\java\org\apache\druid\query\aggregation\histogram\FixedBucketsHistogramAggregator.java,0,35,1,5,0,41
 druid-master\druid-master\indexing-service\src\main\java\org\apache\druid\indexing\common\task\HadoopIndexTask.java,0,304,9,101,0,414
 druid-master\druid-master\server\src\test\java\org\apache\druid\server\coordinator\cost\CachingCostBalancerStrategyTest.java,0,54,1,16,0,71
 druid-master\druid-master\server\src\test\java\org\apache\druid\query\ResultLevelCachingQueryRunnerTest.java,0,49,0,18,0,67
 druid-master\druid-master\core\src\main\java\org\apache\druid\java\util\common\guava\FunctionalIterator.java,0,41,0,6,1,48
 druid-master\druid-master\processing\src\test\java\org\apache\druid\query\datasourcemetadata\DataSourceMetadataQueryTest.java,0,81,0,19,0,100
 druid-master\druid-master\processing\src\main\java\org\apache\druid\query\groupby\DefaultGroupByQueryMetrics.java,0,18,0,4,0,22
 druid-master\druid-master\server\src\test\java\org\apache\druid\server\coordination\ServerManagerTest.java,0,306,5,66,0,377
 druid-master\druid-master\extensions-core\avro-extensions\src\main\java\org\apache\druid\data\input\avro\AvroStreamReader.java,0,30,0,6,0,36
 druid-master\druid-master\core\src\test\java\org\apache\druid\guice\LifecycleScopeTest.java,0,66,0,5,3,74
 druid-master\druid-master\sql\src\main\java\org\apache\druid\sql\calcite\view\InProcessViewManager.java,0,19,0,6,0,25
 druid-master\druid-master\extensions-core\kinesis-indexing-service\src\test\java\org\apache\druid\indexing\kinesis\supervisor\KinesisSupervisorTuningConfigTest.java,0,35,0,12,0,47
 druid-master\druid-master\extensions-core\kubernetes-extensions\src\main\java\org\apache\druid\k8s\discovery\K8sApiClient.java,0,11,0,5,0,16
 druid-master\druid-master\server\src\main\java\org\apache\druid\server\log\NoopRequestLogger.java,0,5,0,1,0,6
 druid-master\druid-master\server\src\main\java\org\apache\druid\server\coordinator\ReplicationThrottler.java,0,97,5,19,0,121
 druid-master\druid-master\extensions-core\lookups-cached-single\src\main\java\org\apache\druid\server\lookup\cache\polling\PollingCache.java,0,4,0,3,0,7
 druid-master\druid-master\sql\src\main\java\org\apache\druid\sql\calcite\schema\NoopDruidSchemaManager.java,0,7,0,2,0,9
 druid-master\druid-master\core\src\main\java\org\apache\druid\guice\DruidSecondaryModule.java,0,41,0,3,1,45
 druid-master\druid-master\extensions-core\s3-extensions\src\main\java\org\apache\druid\storage\s3\S3DataSegmentPusherConfig.java,0,47,0,1,0,48
 druid-master\druid-master\server\src\main\java\org\apache\druid\server\initialization\jetty\TaskIdResponseHeaderFilterHolder.java,0,6,0,2,0,8
 druid-master\druid-master\sql\src\main\java\org\apache\druid\sql\calcite\expression\builtin\LPadOperatorConversion.java,0,7,0,2,0,9
 druid-master\druid-master\processing\src\main\java\org\apache\druid\query\aggregation\cardinality\vector\MultiValueStringCardinalityVectorProcessor.java,0,31,0,13,0,44
 druid-master\druid-master\server\src\main\java\org\apache\druid\segment\loading\LeastBytesUsedStorageLocationSelectorStrategy.java,0,17,0,5,0,22
 druid-master\druid-master\processing\src\test\java\org\apache\druid\query\topn\PerSegmentQueryOptimizeTest.java,0,36,0,12,0,48
 druid-master\druid-master\extensions-contrib\tdigestsketch\src\test\java\org\apache\druid\query\aggregation\tdigestsketch\TDigestSketchToQuantilePostAggregatorTest.java,0,16,0,5,0,21
 druid-master\druid-master\processing\src\main\java\org\apache\druid\segment\RowNumCounter.java,0,11,1,2,0,14
 druid-master\druid-master\server\src\test\java\org\apache\druid\server\coordinator\CostBalancerStrategyTest.java,0,97,2,27,0,126
 druid-master\druid-master\server\src\main\java\org\apache\druid\client\cache\LZ4Transcoder.java,0,13,0,1,0,14
 druid-master\druid-master\indexing-service\src\main\java\org\apache\druid\indexing\common\task\batch\parallel\ParallelIndexingPhaseProgress.java,0,23,0,3,0,26
 druid-master\druid-master\processing\src\test\java\org\apache\druid\query\filter\FilterTuningTest.java,0,5,0,3,0,8
 druid-master\druid-master\indexing-service\src\main\java\org\apache\druid\indexing\common\actions\SegmentLockTryAcquireAction.java,0,47,0,5,0,52
 druid-master\druid-master\server\src\main\java\org\apache\druid\server\http\CompactionResource.java,0,21,0,6,0,27
 druid-master\druid-master\integration-tests\src\test\java\org\apache\druid\tests\indexer\ITHdfsToGcsParallelIndexTest.java,0,9,0,6,0,15
 druid-master\druid-master\extensions-core\avro-extensions\src\main\java\org\apache\druid\data\input\AvroStreamInputRowParser.java,0,54,0,6,0,60
 druid-master\druid-master\services\src\main\java\org\apache\druid\guice\BrokerServiceModule.java,0,9,0,1,0,10
 druid-master\druid-master\integration-tests\src\main\java\org\apache\druid\testing\utils\ITTLSCertificateChecker.java,0,19,3,5,0,27
 druid-master\druid-master\processing\src\main\java\org\apache\druid\query\extraction\RegexDimExtractionFn.java,0,58,1,4,0,63
 druid-master\druid-master\extensions-core\datasketches\src\main\java\org\apache\druid\query\aggregation\datasketches\quantiles\DoublesSketchMergeVectorAggregator.java,0,30,0,5,0,35
 druid-master\druid-master\core\src\main\java\org\apache\druid\timeline\SegmentId.java,0,177,1,68,0,246
 druid-master\druid-master\sql\src\main\java\org\apache\druid\sql\guice\ApproxCountDistinct.java,0,2,0,1,0,3
 druid-master\druid-master\processing\src\main\java\org\apache\druid\segment\data\ColumnarFloats.java,0,50,0,12,0,62
 druid-master\druid-master\sql\src\test\java\org\apache\druid\sql\calcite\TestInsertQueryMaker.java,0,18,0,5,0,23
 druid-master\druid-master\processing\src\test\java\org\apache\druid\query\expression\HyperUniqueExpressionsTest.java,0,84,0,37,0,121
 druid-master\druid-master\processing\src\main\java\org\apache\druid\query\groupby\epinephelinae\vector\DictionaryBuildingSingleValueStringGroupByVectorColumnSelector.java,0,27,0,10,0,37
 druid-master\druid-master\core\src\main\java\org\apache\druid\java\util\http\client\response\StringFullResponseHolder.java,0,12,1,1,0,14
 druid-master\druid-master\core\src\main\java\org\apache\druid\crypto\CryptoService.java,0,81,2,15,2,100
 druid-master\druid-master\core\src\main\java\org\apache\druid\data\input\impl\RegexInputFormat.java,0,32,0,4,2,38
 druid-master\druid-master\core\src\main\java\org\apache\druid\data\input\HandlingInputRowIterator.java,0,21,0,8,1,30
 druid-master\druid-master\indexing-service\src\test\java\org\apache\druid\indexing\common\task\batch\parallel\DimensionDistributionReportTest.java,0,11,0,5,0,16
 druid-master\druid-master\processing\src\main\java\org\apache\druid\query\monomorphicprocessing\CalledFromHotLoop.java,0,4,0,3,0,7
 druid-master\druid-master\server\src\test\java\org\apache\druid\server\coordination\SegmentLoadDropHandlerTest.java,0,174,3,75,0,252
 druid-master\druid-master\processing\src\main\java\org\apache\druid\segment\DimensionSelectorUtils.java,0,56,0,14,0,70
 druid-master\druid-master\core\src\test\java\org\apache\druid\java\util\emitter\core\HttpPostEmitterStressTest.java,0,64,1,11,2,78
 druid-master\druid-master\extensions-core\datasketches\src\main\java\org\apache\druid\query\aggregation\datasketches\quantiles\sql\DoublesSketchCDFOperatorConversion.java,0,11,0,4,0,15
 druid-master\druid-master\server\src\test\java\org\apache\druid\server\coordination\TestStorageLocation.java,0,38,0,2,0,40
 druid-master\druid-master\core\src\test\java\org\apache\druid\testing\DeadlockDetectingTimeout.java,0,13,0,2,0,15
 druid-master\druid-master\core\src\main\java\org\apache\druid\java\util\metrics\cgroups\CgroupDiscoverer.java,0,3,0,2,0,5
 druid-master\druid-master\sql\src\main\java\org\apache\druid\sql\calcite\schema\NamedSchema.java,0,8,0,5,0,13
 druid-master\druid-master\core\src\test\java\org\apache\druid\timeline\partition\HashBasedNumberedPartialShardSpecTest.java,0,22,0,10,0,32
 druid-master\druid-master\processing\src\main\java\org\apache\druid\segment\join\table\IndexedTableColumnValueSelector.java,0,29,0,6,0,35
 druid-master\druid-master\core\src\main\java\org\apache\druid\java\util\common\Cleaners.java,0,46,4,9,0,59
 druid-master\druid-master\sql\src\test\java\org\apache\druid\sql\calcite\expression\ExpressionTestHelper.java,0,89,0,23,0,112
 druid-master\druid-master\processing\src\main\java\org\apache\druid\query\aggregation\FilteredAggregator.java,0,21,0,1,0,22
 druid-master\druid-master\server\src\test\java\org\apache\druid\curator\discovery\ServiceAnnouncerTest.java,0,21,1,6,0,28
 druid-master\druid-master\core\src\main\java\org\apache\druid\guice\annotations\EscalatedGlobal.java,0,2,0,1,0,3
 druid-master\druid-master\processing\src\main\java\org\apache\druid\segment\join\table\RowBasedIndexBuilder.java,0,35,1,17,0,53
 druid-master\druid-master\core\src\test\java\org\apache\druid\timeline\partition\IntegerPartitionChunkTest.java,0,59,0,2,0,61
 druid-master\druid-master\indexing-service\src\test\java\org\apache\druid\indexing\seekablestream\SeekableStreamSupervisorSpecTest.java,0,296,7,111,0,414
 druid-master\druid-master\extensions-core\druid-basic-security\src\main\java\org\apache\druid\security\basic\authentication\endpoint\BasicAuthenticatorResourceHandler.java,0,14,0,6,0,20
 druid-master\druid-master\extensions-core\kafka-indexing-service\src\test\java\org\apache\druid\data\input\kafkainput\KafkaInputFormatTest.java,0,101,2,71,0,174
 druid-master\druid-master\server\src\main\java\org\apache\druid\server\coordinator\DatasourceWhitelist.java,0,14,0,1,0,15
 druid-master\druid-master\server\src\main\java\org\apache\druid\server\coordinator\RandomBalancerStrategyFactory.java,0,4,0,1,0,5
 druid-master\druid-master\processing\src\main\java\org\apache\druid\query\PerSegmentQueryOptimizationContext.java,0,10,0,2,0,12
 druid-master\druid-master\core\src\test\java\org\apache\druid\java\util\common\guava\UnsupportedSequence.java,0,11,0,3,0,14
 druid-master\druid-master\processing\src\main\java\org\apache\druid\segment\join\HashJoinSegmentStorageAdapter.java,0,111,0,44,0,155
 druid-master\druid-master\extensions-contrib\moving-average-query\src\main\java\org\apache\druid\query\movingaverage\MovingAverageQueryToolChest.java,0,42,0,13,0,55
 druid-master\druid-master\processing\src\main\java\org\apache\druid\segment\virtual\ExpressionVectorValueSelector.java,0,27,0,2,0,29
 druid-master\druid-master\processing\src\test\java\org\apache\druid\segment\data\CompressedLongsAutoEncodingSerdeTest.java,0,38,1,7,0,46
 druid-master\druid-master\processing\src\test\java\org\apache\druid\query\aggregation\cardinality\CardinalityAggregatorTest.java,0,220,16,38,0,274
 druid-master\druid-master\server\src\test\java\org\apache\druid\indexing\ClientCompactQueryTuningConfigTest.java,0,6,0,3,0,9
 druid-master\druid-master\extensions-core\avro-extensions\target\generated-test-sources\avro\org\apache\druid\data\input\MySubRecord.java,0,88,40,21,0,149
 druid-master\druid-master\indexing-service\src\main\java\org\apache\druid\indexing\overlord\config\ForkingTaskRunnerConfig.java,0,45,0,6,0,51
 druid-master\druid-master\server\src\test\java\org\apache\druid\segment\loading\SegmentLocalCacheManagerConcurrencyTest.java,0,32,2,9,0,43
 druid-master\druid-master\server\src\main\java\org\apache\druid\client\CoordinatorServerView.java,0,65,3,14,0,82
 druid-master\druid-master\processing\src\main\java\org\apache\druid\segment\column\BitmapIndexes.java,0,36,1,9,0,46
 druid-master\druid-master\sql\src\main\java\org\apache\druid\sql\calcite\planner\OffsetLimit.java,0,49,0,5,0,54
 druid-master\druid-master\sql\src\main\java\org\apache\druid\sql\calcite\expression\builtin\PositionOperatorConversion.java,0,9,1,4,0,14
 druid-master\druid-master\processing\src\main\java\org\apache\druid\query\DefaultBitmapResultFactory.java,0,27,0,3,0,30
 druid-master\druid-master\processing\src\main\java\org\apache\druid\query\lookup\LookupSegment.java,0,15,0,8,0,23
 druid-master\druid-master\extensions-contrib\aliyun-oss-extensions\src\main\java\org\apache\druid\data\input\aliyun\OssInputSourceDruidModule.java,0,7,1,2,0,10
 druid-master\druid-master\extensions-core\druid-bloom-filter\src\main\java\org\apache\druid\query\aggregation\bloom\BloomFilterSerde.java,0,38,0,10,0,48
 druid-master\druid-master\server\src\main\java\org\apache\druid\server\coordinator\rules\ForeverDropRule.java,0,11,0,1,0,12
 druid-master\druid-master\core\src\main\java\org\apache\druid\java\util\common\guava\nary\TrinaryTransformIterable.java,0,30,4,4,0,38
 druid-master\druid-master\processing\src\test\java\org\apache\druid\segment\writeout\FileWriteOutBytesTest.java,0,53,0,16,0,69
 druid-master\druid-master\extensions-core\azure-extensions\src\main\java\org\apache\druid\data\input\azure\AzureInputSource.java,0,60,0,14,0,74
 druid-master\druid-master\indexing-service\src\main\java\org\apache\druid\indexing\overlord\supervisor\SupervisorResource.java,0,108,1,34,0,143
 druid-master\druid-master\indexing-service\src\main\java\org\apache\druid\indexing\worker\shuffle\ShuffleModule.java,0,16,0,9,0,25
 druid-master\druid-master\processing\src\main\java\org\apache\druid\query\metadata\SegmentMetadataQueryConfig.java,0,27,1,6,0,34
 druid-master\druid-master\sql\src\main\java\org\apache\druid\sql\avatica\DruidConnection.java,0,47,3,11,0,61
 druid-master\druid-master\extensions-contrib\time-min-max\src\main\java\org\apache\druid\query\aggregation\TimestampMaxAggregatorFactory.java,0,17,0,2,0,19
 druid-master\druid-master\indexing-service\src\main\java\org\apache\druid\indexing\overlord\autoscaling\ScalingStats.java,0,55,0,5,0,60
 druid-master\druid-master\core\src\test\java\org\apache\druid\java\util\metrics\GcNameTest.java,0,7,1,3,0,11
 druid-master\druid-master\core\src\main\java\org\apache\druid\java\util\common\parsers\JavaScriptParser.java,0,22,0,4,0,26
 druid-master\druid-master\server\src\test\java\org\apache\druid\server\coordination\ChangeRequestHttpSyncerTest.java,0,29,0,7,0,36
 druid-master\druid-master\processing\src\main\java\org\apache\druid\segment\data\RoaringBitmapSerdeFactory.java,0,38,0,6,0,44
 druid-master\druid-master\processing\src\test\java\org\apache\druid\query\scan\ScanQueryResultOrderingTest.java,0,119,0,31,0,150
 druid-master\druid-master\processing\src\main\java\org\apache\druid\segment\data\BlockLayoutColumnarFloatsSupplier.java,0,47,1,6,0,54
 druid-master\druid-master\core\src\main\java\org\apache\druid\timeline\partition\BuildingSingleDimensionShardSpec.java,0,56,0,6,0,62
 druid-master\druid-master\processing\src\main\java\org\apache\druid\segment\join\HashJoinSegment.java,0,38,1,9,0,48
 druid-master\druid-master\core\src\test\java\org\apache\druid\common\utils\JodaUtilsTest.java,0,48,0,11,0,59
 druid-master\druid-master\processing\src\main\java\org\apache\druid\query\groupby\epinephelinae\column\DictionaryBuildingStringGroupByColumnSelectorStrategy.java,0,43,0,13,0,56
 druid-master\druid-master\processing\src\main\java\org\apache\druid\query\groupby\having\AlwaysHavingSpec.java,0,10,0,1,0,11
 druid-master\druid-master\extensions-core\s3-extensions\src\test\java\org\apache\druid\storage\s3\S3StorageDruidModuleTest.java,0,14,0,7,0,21
 druid-master\druid-master\server\src\main\java\org\apache\druid\guice\FirehoseModule.java,0,5,1,1,0,7
 druid-master\druid-master\extensions-core\mysql-metadata-storage\src\main\java\org\apache\druid\metadata\storage\mysql\MySQLMetadataStorageModule.java,0,13,0,5,0,18
 druid-master\druid-master\server\src\main\java\org\apache\druid\server\security\AuthenticationUtils.java,0,33,1,7,0,41
 druid-master\druid-master\core\src\main\java\org\apache\druid\java\util\common\guava\MappedSequence.java,0,23,1,5,0,29
 druid-master\druid-master\core\src\test\java\org\apache\druid\java\util\common\guava\FunctionalIteratorTest.java,0,27,0,3,4,34
 druid-master\druid-master\server\src\main\java\org\apache\druid\server\coordinator\CoordinatorCompactionConfig.java,0,94,0,18,0,112
 druid-master\druid-master\processing\src\main\java\org\apache\druid\query\aggregation\cardinality\types\DoubleCardinalityAggregatorColumnSelectorStrategy.java,0,16,0,5,0,21
 druid-master\druid-master\processing\src\test\java\org\apache\druid\query\aggregation\cardinality\CardinalityAggregatorBenchmark.java,0,37,1,6,0,44
 druid-master\druid-master\core\src\main\java\org\apache\druid\timeline\partition\SingleElementPartitionChunk.java,0,33,1,5,0,39
 druid-master\druid-master\processing\src\main\java\org\apache\druid\query\aggregation\any\FloatAnyBufferAggregator.java,0,29,0,2,0,31
 druid-master\druid-master\server\src\main\java\org\apache\druid\server\coordinator\UserCompactionTaskTransformConfig.java,0,22,0,6,0,28
 druid-master\druid-master\processing\src\test\java\org\apache\druid\segment\incremental\IncrementalIndexCreator.java,0,55,0,23,0,78
 druid-master\druid-master\indexing-hadoop\src\main\java\org\apache\druid\indexer\HadoopyShardSpec.java,0,22,0,3,0,25
 druid-master\druid-master\core\src\main\java\org\apache\druid\indexer\TaskStatusPlus.java,0,132,0,8,0,140
 druid-master\druid-master\processing\src\test\java\org\apache\druid\segment\filter\SearchQueryFilterTest.java,0,71,0,40,0,111
 druid-master\druid-master\extensions-core\s3-extensions\src\main\java\org\apache\druid\storage\s3\S3DataSegmentPusher.java,0,51,1,14,0,66
 druid-master\druid-master\processing\src\main\java\org\apache\druid\segment\writeout\SegmentWriteOutMediumModule.java,0,4,0,1,0,5
 druid-master\druid-master\core\src\main\java\org\apache\druid\guice\JsonConfigurator.java,0,77,1,35,0,113
 druid-master\druid-master\processing\src\main\java\org\apache\druid\segment\vector\NilVectorSelector.java,0,47,1,10,0,58
 druid-master\druid-master\core\src\main\java\org\apache\druid\common\config\JacksonConfigManager.java,0,91,0,15,2,108
 druid-master\druid-master\processing\src\test\java\org\apache\druid\query\DruidProcessingConfigTest.java,0,61,1,14,0,76
 druid-master\druid-master\extensions-core\parquet-extensions\src\main\java\org\apache\druid\data\input\parquet\ParquetExtensionsModule.java,0,26,0,9,0,35
 druid-master\druid-master\indexing-service\src\main\java\org\apache\druid\indexing\common\actions\RetrieveUnusedSegmentsAction.java,0,32,0,3,0,35
 druid-master\druid-master\server\src\main\java\org\apache\druid\client\selector\DiscoverySelector.java,0,3,0,1,0,4
 druid-master\druid-master\processing\src\main\java\org\apache\druid\query\extraction\DimExtractionFn.java,0,7,0,1,0,8
 druid-master\druid-master\extensions-core\s3-extensions\src\main\java\org\apache\druid\storage\s3\S3DataSegmentArchiverConfig.java,0,9,0,1,0,10
 druid-master\druid-master\core\src\main\java\org\apache\druid\math\expr\vector\ExprVectorProcessor.java,0,7,1,3,0,11
 druid-master\druid-master\extensions-core\druid-bloom-filter\src\main\java\org\apache\druid\query\aggregation\bloom\DoubleBloomFilterAggregator.java,0,9,0,3,0,12
 druid-master\druid-master\server\src\main\java\org\apache\druid\server\security\TLSCertificateChecker.java,0,17,0,17,0,34
 druid-master\druid-master\processing\src\test\java\org\apache\druid\query\search\SearchQueryRunnerWithCaseTest.java,0,58,0,30,0,88
 druid-master\druid-master\processing\src\main\java\org\apache\druid\segment\DimensionDictionary.java,0,67,1,7,0,75
 druid-master\druid-master\server\src\main\java\org\apache\druid\segment\realtime\appenderator\AppenderatorDriverAddResult.java,0,40,1,4,0,45
 druid-master\druid-master\core\src\main\java\org\apache\druid\timeline\partition\ShardSpecLookup.java,0,5,0,2,0,7
 druid-master\druid-master\core\src\test\java\org\apache\druid\data\input\impl\InputRowParserSerdeTest.java,0,53,1,27,0,81
 druid-master\druid-master\extensions-core\datasketches\src\main\java\org\apache\druid\query\aggregation\datasketches\hll\sql\HllSketchBaseSqlAggregator.java,0,23,0,12,0,35
 druid-master\druid-master\extensions-core\druid-ranger-security\src\main\java\org\apache\druid\security\ranger\authorizer\RangerAuthorizer.java,0,38,0,7,0,45
 druid-master\druid-master\extensions-core\druid-bloom-filter\src\test\java\org\apache\druid\query\aggregation\bloom\BloomFilterGroupByQueryTest.java,0,43,0,19,0,62
 druid-master\druid-master\core\src\main\java\org\apache\druid\data\input\impl\DelimitedParseSpec.java,0,56,0,4,2,62
 druid-master\druid-master\processing\src\test\java\org\apache\druid\query\dimension\StringDimensionSelectorForTest.java,0,44,1,2,0,47
 druid-master\druid-master\indexing-service\src\main\java\org\apache\druid\indexing\input\DruidSegmentReader.java,0,76,0,24,0,100
 druid-master\druid-master\processing\src\main\java\org\apache\druid\segment\LongColumnSerializer.java,0,38,1,3,0,42
 druid-master\druid-master\integration-tests\src\main\java\org\apache\druid\testing\utils\EventSerializer.java,0,9,1,6,0,16
 druid-master\druid-master\sql\src\main\java\org\apache\druid\sql\calcite\expression\builtin\ArrayContainsOperatorConversion.java,0,20,0,12,0,32
 druid-master\druid-master\server\src\main\java\org\apache\druid\discovery\DruidLeaderClient.java,0,82,3,24,0,109
 druid-master\druid-master\server\src\test\java\org\apache\druid\server\initialization\JettyWithResponseFilterEnabledTest.java,0,6,0,3,0,9
 druid-master\druid-master\integration-tests\src\main\java\org\apache\druid\testing\utils\SuiteListener.java,0,11,0,3,0,14
 druid-master\druid-master\extensions-core\lookups-cached-global\src\test\java\org\apache\druid\server\lookup\namespace\StaticMapCacheGeneratorTest.java,0,16,2,6,0,24
 druid-master\druid-master\server\src\test\java\org\apache\druid\server\coordinator\LoadQueuePeonTester.java,0,14,0,2,0,16
 druid-master\druid-master\extensions-core\protobuf-extensions\src\main\java\org\apache\druid\data\input\protobuf\ProtobufExtensionsModule.java,0,5,1,1,0,7
 druid-master\druid-master\processing\src\main\java\org\apache\druid\query\aggregation\HistogramBufferAggregator.java,0,43,1,5,0,49
 druid-master\druid-master\core\src\test\java\org\apache\druid\java\util\common\HumanReadableBytesTest.java,0,378,4,68,2,452
 druid-master\druid-master\processing\src\test\java\org\apache\druid\query\search\SearchQueryQueryToolChestTest.java,0,5,0,3,0,8
 druid-master\druid-master\extensions-core\druid-kerberos\src\main\java\org\apache\druid\security\kerberos\DruidKerberosAuthenticationHandler.java,0,45,2,20,0,67
 druid-master\druid-master\core\src\main\java\org\apache\druid\metadata\DefaultPasswordProvider.java,0,20,0,2,0,22
 druid-master\druid-master\benchmarks\src\test\java\org\apache\druid\benchmark\compression\CompressedVSizeColumnarMultiIntsBenchmark.java,0,36,2,6,0,44
 druid-master\druid-master\core\src\test\java\org\apache\druid\java\util\http\client\JankyServersTest.java,0,82,6,23,9,120
 druid-master\druid-master\indexing-service\src\main\java\org\apache\druid\indexing\common\task\batch\parallel\SegmentAllocationRequest.java,0,28,0,3,0,31
 druid-master\druid-master\indexing-service\src\main\java\org\apache\druid\indexing\overlord\autoscaling\PendingTaskBasedWorkerProvisioningConfig.java,0,43,0,9,0,52
 druid-master\druid-master\indexing-service\src\test\java\org\apache\druid\indexing\common\config\TaskStorageConfigTest.java,0,11,0,3,0,14
 druid-master\druid-master\indexing-service\src\main\java\org\apache\druid\indexing\overlord\RemoteTaskRunnerWorkQueue.java,0,8,0,4,0,12
 druid-master\druid-master\server\src\test\java\org\apache\druid\query\LocatedSegmentDescriptorSerdeTest.java,0,15,0,4,0,19
 druid-master\druid-master\indexing-service\src\main\java\org\apache\druid\indexing\overlord\setup\DefaultWorkerBehaviorConfig.java,0,31,1,4,0,36
 druid-master\druid-master\extensions-core\stats\src\test\java\org\apache\druid\query\aggregation\variance\VarianceTopNQueryTest.java,0,36,0,5,0,41
 druid-master\druid-master\services\src\main\java\org\apache\druid\cli\convert\Remove.java,0,12,0,1,0,13
 druid-master\druid-master\processing\src\test\java\org\apache\druid\query\aggregation\TestFloatColumnSelector.java,0,18,0,2,0,20
 druid-master\druid-master\extensions-contrib\materialized-view-maintenance\src\main\java\org\apache\druid\indexing\materializedview\DerivativeDataSourceMetadata.java,0,63,0,6,0,69
 druid-master\druid-master\server\src\test\java\org\apache\druid\server\coordinator\DruidClusterTest.java,0,31,0,15,0,46
 druid-master\druid-master\core\src\test\java\org\apache\druid\java\util\metrics\ClockDriftSafeMonitorSchedulerTest.java,0,120,18,33,18,189
 druid-master\druid-master\core\src\test\java\org\apache\druid\testing\InitializedNullHandlingTest.java,0,1,0,1,0,2
 druid-master\druid-master\extensions-core\datasketches\src\test\java\org\apache\druid\query\aggregation\datasketches\theta\sql\ThetaSketchSqlAggregatorTest.java,0,92,0,60,0,152
 druid-master\druid-master\sql\src\main\java\org\apache\druid\sql\calcite\rel\Sorting.java,0,47,1,10,0,58
 druid-master\druid-master\core\src\test\java\org\apache\druid\java\util\common\ByteBufferUtilsTest.java,0,11,1,2,0,14
 druid-master\druid-master\core\src\main\java\org\apache\druid\math\expr\vector\DoubleOutLongsInFunctionVectorValueProcessor.java,0,16,0,2,0,18
 druid-master\druid-master\indexing-service\src\test\java\org\apache\druid\indexing\seekablestream\SeekableStreamIndexTaskTestBase.java,0,148,3,26,0,177
 druid-master\druid-master\server\src\main\java\org\apache\druid\server\coordinator\duty\KillSupervisorsCustomDuty.java,0,24,0,10,0,34
 druid-master\druid-master\server\src\main\java\org\apache\druid\server\coordinator\duty\KillRules.java,0,21,0,9,0,30
 druid-master\druid-master\processing\src\main\java\org\apache\druid\segment\generator\GeneratorColumnSchema.java,0,270,0,18,0,288
 druid-master\druid-master\indexing-service\src\main\java\org\apache\druid\indexing\overlord\ThreadingTaskRunner.java,0,161,9,51,0,221
 druid-master\druid-master\sql\src\main\java\org\apache\druid\sql\calcite\planner\ValidationResult.java,0,11,0,3,0,14
 druid-master\druid-master\extensions-core\stats\src\test\java\org\apache\druid\query\aggregation\variance\VarianceTestHelper.java,0,27,0,5,0,32
 druid-master\druid-master\core\src\main\java\org\apache\druid\java\util\common\guava\WrappingYielder.java,0,19,3,1,0,23
 druid-master\druid-master\extensions-core\orc-extensions\src\main\java\org\apache\druid\data\input\orc\OrcParseSpec.java,0,18,0,1,0,19
 druid-master\druid-master\processing\src\test\java\org\apache\druid\query\aggregation\FilteredAggregatorTest.java,0,72,7,23,0,102
 druid-master\druid-master\indexing-service\src\main\java\org\apache\druid\indexing\overlord\TaskMaster.java,0,96,14,12,0,122
 druid-master\druid-master\extensions-core\google-extensions\src\main\java\org\apache\druid\storage\google\GoogleTimestampVersionedDataFinder.java,0,13,0,5,0,18
 druid-master\druid-master\extensions-contrib\moving-average-query\src\main\java\org\apache\druid\query\movingaverage\averagers\LongMeanAverager.java,0,10,1,2,0,13
 druid-master\druid-master\processing\src\main\java\org\apache\druid\segment\SimpleAscendingOffset.java,0,33,3,1,0,37
 druid-master\druid-master\cloud\aws-common\src\main\java\org\apache\druid\common\aws\AWSEndpointConfig.java,0,9,0,1,0,10
 druid-master\druid-master\benchmarks\src\test\java\org\apache\druid\benchmark\bitmap\BitmapBenchmarkUtils.java,0,21,1,9,0,31
 druid-master\druid-master\processing\src\test\java\org\apache\druid\segment\incremental\IncrementalIndexStorageAdapterTest.java,0,124,2,40,0,166
 druid-master\druid-master\sql\src\main\java\org\apache\druid\sql\calcite\expression\builtin\TruncateOperatorConversion.java,0,9,0,4,0,13
 druid-master\druid-master\extensions-contrib\momentsketch\src\main\java\org\apache\druid\query\aggregation\momentsketch\MomentSketchWrapper.java,0,71,2,11,0,84
 druid-master\druid-master\extensions-core\histogram\src\main\java\org\apache\druid\query\aggregation\histogram\package-info.java,0,1,0,1,0,2
 druid-master\druid-master\server\src\main\java\org\apache\druid\segment\loading\StorageLocationConfig.java,0,37,0,3,0,40
 druid-master\druid-master\extensions-contrib\opentsdb-emitter\src\test\java\org\apache\druid\emitter\opentsdb\EventConverterTest.java,0,42,0,16,0,58
 druid-master\druid-master\extensions-core\datasketches\src\main\java\org\apache\druid\query\aggregation\datasketches\theta\oldapi\OldSketchBuildAggregatorFactory.java,0,7,0,3,0,10
 druid-master\druid-master\extensions-core\avro-extensions\target\generated-test-sources\avro\org\apache\druid\data\input\MyNestedRecord.java,0,85,40,24,0,149
 druid-master\druid-master\indexing-service\src\main\java\org\apache\druid\indexing\overlord\setup\EqualDistributionWorkerSelectStrategy.java,0,23,0,4,0,27
 druid-master\druid-master\core\src\test\java\org\apache\druid\data\input\impl\JsonInputFormatTest.java,0,11,0,7,0,18
 druid-master\druid-master\core\src\main\java\org\apache\druid\data\input\impl\CSVParseSpec.java,0,41,0,5,2,48
 druid-master\druid-master\core\src\main\java\org\apache\druid\jackson\CommaListJoinDeserializer.java,0,9,0,3,0,12
 druid-master\druid-master\extensions-core\avro-extensions\src\test\java\org\apache\druid\data\input\avro\SchemaRegistryBasedAvroBytesDecoderTest.java,0,63,0,21,0,84
 druid-master\druid-master\integration-tests\src\test\java\org\apache\druid\tests\coordinator\duty\ITAutoCompactionLockContentionTest.java,0,97,3,28,0,128
 druid-master\druid-master\extensions-core\druid-basic-security\src\main\java\org\apache\druid\security\basic\authentication\entity\BasicAuthenticatorUser.java,0,24,0,4,0,28
 druid-master\druid-master\benchmarks\src\test\java\org\apache\druid\benchmark\FixedHistogramBenchmark.java,0,75,3,8,0,86
 druid-master\druid-master\services\src\test\java\org\apache\druid\server\router\CoordinatorRuleManagerTest.java,0,23,0,6,0,29
 druid-master\druid-master\processing\src\test\java\org\apache\druid\guice\SegmentMetadataQueryConfigTest.java,0,14,0,8,0,22
 druid-master\druid-master\core\src\main\java\org\apache\druid\java\util\common\granularity\DurationGranularity.java,0,67,1,5,0,73
 druid-master\druid-master\core\src\main\java\org\apache\druid\java\util\common\DateTimes.java,0,89,0,24,0,113
 druid-master\druid-master\processing\src\test\java\org\apache\druid\segment\join\JoinConditionAnalysisTest.java,0,66,13,20,0,99
 druid-master\druid-master\core\src\main\java\org\apache\druid\segment\loading\TombstoneLoadSpec.java,0,9,1,2,1,13
 druid-master\druid-master\extensions-core\histogram\src\main\java\org\apache\druid\query\aggregation\histogram\ArrayUtils.java,0,22,1,1,0,24
 druid-master\druid-master\core\src\main\java\org\apache\druid\guice\annotations\UnstableApi.java,0,5,0,5,0,10
 druid-master\druid-master\processing\src\test\java\org\apache\druid\jackson\DefaultObjectMapperTest.java,0,7,0,2,0,9
 druid-master\druid-master\extensions-core\kinesis-indexing-service\src\test\java\org\apache\druid\indexing\kinesis\KinesisIndexTaskClientTest.java,0,208,1,100,0,309
 druid-master\druid-master\server\src\test\java\org\apache\druid\metadata\input\SqlTestUtils.java,0,37,0,7,0,44
 druid-master\druid-master\processing\src\main\java\org\apache\druid\query\aggregation\mean\DoubleMeanHolder.java,0,78,0,4,0,82
 druid-master\druid-master\indexing-service\src\test\java\org\apache\druid\indexing\common\task\batch\parallel\iterator\RangePartitionIndexTaskInputRowIteratorBuilderTest.java,0,58,0,41,0,99
 druid-master\druid-master\server\src\main\java\org\apache\druid\client\coordinator\CoordinatorClient.java,0,50,0,12,0,62
 druid-master\druid-master\processing\src\main\java\org\apache\druid\segment\LongDimensionHandler.java,0,35,0,5,0,40
 druid-master\druid-master\extensions-core\datasketches\src\main\java\org\apache\druid\query\aggregation\datasketches\theta\SketchBuildComplexMetricSerde.java,0,3,0,1,0,4
 druid-master\druid-master\server\src\main\java\org\apache\druid\server\scheduling\HiLoQueryLaningStrategy.java,0,21,0,5,0,26
 druid-master\druid-master\integration-tests\src\test\java\org\apache\druid\tests\query\ITSqlCancelTest.java,0,30,0,14,0,44
 druid-master\druid-master\server\src\main\java\org\apache\druid\segment\realtime\plumber\FlushingPlumberSchool.java,0,50,0,7,0,57
 druid-master\druid-master\core\src\main\java\org\apache\druid\indexer\partitions\DimensionBasedPartitionsSpec.java,0,9,0,1,0,10
 druid-master\druid-master\processing\src\main\java\org\apache\druid\segment\DoubleColumnSerializerV2.java,0,44,1,6,0,51
 druid-master\druid-master\core\src\test\java\org\apache\druid\java\util\emitter\core\ComposingEmitterTest.java,0,16,0,1,0,17
 druid-master\druid-master\processing\src\main\java\org\apache\druid\segment\DoubleWrappingDimensionSelector.java,0,14,0,2,0,16
 druid-master\druid-master\core\src\test\java\org\apache\druid\data\input\impl\TimestampSpecTest.java,0,9,0,3,0,12
 druid-master\druid-master\indexing-service\src\main\java\org\apache\druid\indexing\common\task\batch\parallel\PartialDimensionDistributionTask.java,0,130,3,47,0,180
 druid-master\druid-master\indexing-service\src\main\java\org\apache\druid\indexing\appenderator\ActionBasedUsedSegmentChecker.java,0,12,0,4,0,16
 druid-master\druid-master\indexing-hadoop\src\test\java\org\apache\druid\indexer\path\GranularityPathSpecTest.java,0,68,3,27,0,98
 druid-master\druid-master\processing\src\main\java\org\apache\druid\query\extraction\SearchQuerySpecDimExtractionFn.java,0,29,1,3,0,33
 druid-master\druid-master\core\src\test\java\org\apache\druid\timeline\partition\NumberedOverwriteShardSpecTest.java,0,14,0,8,0,22
 druid-master\druid-master\extensions-core\lookups-cached-single\src\main\java\org\apache\druid\server\lookup\PollingLookupFactory.java,0,42,1,3,0,46
 druid-master\druid-master\core\src\test\java\org\apache\druid\java\util\metrics\cgroups\ProcCgroupDiscovererTest.java,0,23,0,5,2,30
 druid-master\druid-master\processing\src\main\java\org\apache\druid\query\aggregation\cardinality\types\StringCardinalityAggregatorColumnSelectorStrategy.java,0,28,1,14,0,43
 druid-master\druid-master\indexing-service\src\main\java\org\apache\druid\indexing\overlord\autoscaling\NoopProvisioningStrategy.java,0,8,0,2,0,10
 druid-master\druid-master\server\src\main\java\org\apache\druid\segment\indexing\TuningConfig.java,0,25,0,7,0,32
 druid-master\druid-master\processing\src\main\java\org\apache\druid\segment\data\ByteBufferWriter.java,0,28,0,4,0,32
 druid-master\druid-master\extensions-core\datasketches\src\main\java\org\apache\druid\query\aggregation\datasketches\hll\HllSketchModule.java,0,30,0,23,0,53
 druid-master\druid-master\processing\src\test\java\org\apache\druid\segment\data\ComparableListTest.java,0,24,3,9,0,36
 druid-master\druid-master\indexing-service\src\main\java\org\apache\druid\indexing\overlord\http\TaskStatusResponse.java,0,24,0,2,0,26
 druid-master\druid-master\core\src\main\java\org\apache\druid\java\util\common\StreamUtils.java,0,27,1,15,0,43
 druid-master\druid-master\extensions-contrib\aliyun-oss-extensions\src\test\java\org\apache\druid\storage\aliyun\OssDataSegmentPusherConfigTest.java,0,10,0,5,0,15
 druid-master\druid-master\processing\src\test\java\org\apache\druid\query\groupby\NestedQueryPushDownTest.java,0,171,1,47,0,219
 druid-master\druid-master\integration-tests\src\main\java\org\apache\druid\server\coordination\ServerManagerForQueryErrorTest.java,0,101,0,32,0,133
 druid-master\druid-master\sql\src\main\java\org\apache\druid\sql\calcite\planner\DruidConformance.java,0,14,1,3,0,18
 druid-master\druid-master\processing\src\main\java\org\apache\druid\query\QueryInterruptedException.java,0,39,0,10,0,49
 druid-master\druid-master\server\src\test\java\org\apache\druid\server\coordinator\BalanceSegmentsTester.java,0,15,2,5,0,22
 druid-master\druid-master\indexing-service\src\test\java\org\apache\druid\indexing\common\actions\SegmentAllocateActionTest.java,0,106,1,46,0,153
 druid-master\druid-master\processing\src\test\java\org\apache\druid\query\topn\TopNQueryQueryToolChestTest.java,0,103,0,44,0,147
 druid-master\druid-master\extensions-contrib\moving-average-query\src\main\java\org\apache\druid\query\movingaverage\MovingAverageQueryRunner.java,0,38,4,19,0,61
 druid-master\druid-master\server\src\main\java\org\apache\druid\client\ServerInventoryView.java,0,2,0,2,0,4
 druid-master\druid-master\sql\src\main\java\org\apache\druid\sql\calcite\expression\builtin\IPv4AddressStringifyOperatorConversion.java,0,8,0,3,0,11
 druid-master\druid-master\core\src\main\java\org\apache\druid\indexer\RunnerTaskState.java,0,8,0,3,0,11
 druid-master\druid-master\processing\src\main\java\org\apache\druid\query\ReportTimelineMissingSegmentQueryRunner.java,0,20,1,6,0,27
 druid-master\druid-master\processing\src\test\java\org\apache\druid\query\groupby\epinephelinae\IntKeySerde.java,0,33,0,4,0,37
 druid-master\druid-master\extensions-core\druid-basic-security\src\main\java\org\apache\druid\security\basic\authorization\db\cache\NoopBasicAuthorizerCacheNotifier.java,0,14,0,6,0,20
 druid-master\druid-master\server\src\main\java\org\apache\druid\client\cache\MemcachedCacheProvider.java,0,4,0,2,0,6
 druid-master\druid-master\server\src\main\java\org\apache\druid\server\coordinator\DruidCoordinatorConfig.java,0,47,0,1,0,48
 druid-master\druid-master\indexing-service\src\main\java\org\apache\druid\indexing\common\task\batch\MaxAllowedLocksExceededException.java,0,7,0,1,0,8
 druid-master\druid-master\processing\src\test\java\org\apache\druid\segment\data\GenericIndexedWriterTest.java,0,9,0,3,0,12
 druid-master\druid-master\indexing-hadoop\src\test\java\org\apache\druid\indexer\MetadataStorageUpdaterJobTest.java,0,18,6,7,0,31
 druid-master\druid-master\processing\src\main\java\org\apache\druid\segment\join\table\IndexedTableJoinMatcher.java,0,171,0,46,0,217
 druid-master\druid-master\processing\src\main\java\org\apache\druid\query\context\ResponseContext.java,0,321,0,67,0,388
 druid-master\druid-master\indexing-hadoop\src\main\java\org\apache\druid\indexer\path\DatasourcePathSpec.java,0,64,1,16,0,81
 druid-master\druid-master\integration-tests\src\test\java\org\apache\druid\tests\parallelized\ITKafkaIndexingServiceTransactionalParallelizedTest.java,0,12,0,4,0,16
 druid-master\druid-master\extensions-core\mysql-metadata-storage\src\main\java\org\apache\druid\metadata\storage\mysql\MySQLConnector.java,0,63,1,21,0,85
 druid-master\druid-master\processing\src\main\java\org\apache\druid\query\aggregation\first\StringFirstBufferAggregator.java,0,51,0,8,0,59
 druid-master\druid-master\indexing-service\src\main\java\org\apache\druid\indexing\seekablestream\common\RecordSupplier.java,0,23,3,11,0,37
 druid-master\druid-master\indexing-service\src\main\java\org\apache\druid\indexing\overlord\supervisor\SupervisorManager.java,0,128,2,30,0,160
 druid-master\druid-master\processing\src\main\java\org\apache\druid\segment\data\ComparableIntArray.java,0,23,2,4,0,29
 druid-master\druid-master\extensions-core\druid-basic-security\src\main\java\org\apache\druid\security\basic\authorization\entity\BasicAuthorizerRole.java,0,35,1,8,0,44
 druid-master\druid-master\server\src\main\java\org\apache\druid\segment\realtime\appenderator\StreamAppenderator.java,0,344,25,143,0,512
 druid-master\druid-master\extensions-core\datasketches\src\main\java\org\apache\druid\query\aggregation\datasketches\hll\HllSketchToEstimatePostAggregator.java,0,47,0,4,0,51
 druid-master\druid-master\sql\src\main\java\org\apache\druid\sql\avatica\ErrorHandler.java,0,24,0,19,0,43
 druid-master\druid-master\processing\src\test\java\org\apache\druid\query\aggregation\any\StringAnyAggregationTest.java,0,42,1,11,0,54
 druid-master\druid-master\processing\src\test\java\org\apache\druid\segment\virtual\DummyStringVirtualColumn.java,0,80,0,8,0,88
 druid-master\druid-master\server\src\test\java\org\apache\druid\test\utils\ImmutableDruidDataSourceTestUtils.java,0,28,1,10,0,39
 druid-master\druid-master\indexing-service\src\main\java\org\apache\druid\indexing\seekablestream\SettableByteEntityReader.java,0,18,1,5,0,24
 druid-master\druid-master\extensions-core\parquet-extensions\src\main\java\org\apache\druid\data\input\parquet\DruidParquetAvroInputFormat.java,0,5,0,2,0,7
 druid-master\druid-master\server\src\test\java\org\apache\druid\server\coordinator\CuratorDruidCoordinatorTest.java,0,123,5,35,0,163
 druid-master\druid-master\indexing-service\src\main\java\org\apache\druid\indexing\common\index\RealtimeAppenderatorTuningConfig.java,0,139,0,23,0,162
 druid-master\druid-master\server\src\main\java\org\apache\druid\segment\realtime\plumber\RealtimePlumber.java,0,244,27,89,0,360
 druid-master\druid-master\core\src\main\java\org\apache\druid\guice\SupplierProvider.java,0,14,0,1,1,16
 druid-master\druid-master\server\src\test\java\org\apache\druid\server\log\FilteredRequestLoggerTest.java,0,49,2,15,0,66
 druid-master\druid-master\extensions-contrib\momentsketch\src\test\java\org\apache\druid\query\aggregation\momentsketch\aggregator\MomentsSketchAggregatorTest.java,0,79,0,32,0,111
 druid-master\druid-master\processing\src\main\java\org\apache\druid\query\aggregation\SimpleFloatAggregatorFactory.java,0,81,1,13,0,95
 druid-master\druid-master\extensions-core\kinesis-indexing-service\src\main\java\org\apache\druid\indexing\kinesis\KinesisDataSourceMetadata.java,0,15,0,8,0,23
 druid-master\druid-master\core\src\main\java\org\apache\druid\java\util\common\guava\nary\TrinaryTransformIterator.java,0,33,4,3,3,43
 druid-master\druid-master\extensions-core\azure-extensions\src\main\java\org\apache\druid\storage\azure\AzureDataSegmentConfig.java,0,20,0,1,0,21
 druid-master\druid-master\extensions-contrib\moving-average-query\src\main\java\org\apache\druid\query\movingaverage\BucketingAccumulator.java,0,6,0,2,0,8
 druid-master\druid-master\core\src\main\java\org\apache\druid\java\util\common\Either.java,0,38,1,8,0,47
 druid-master\druid-master\server\src\test\java\org\apache\druid\server\coordinator\duty\KillCompactionConfigTest.java,0,78,1,38,0,117
 druid-master\druid-master\processing\src\test\java\org\apache\druid\query\aggregation\DoubleMaxAggregationTest.java,0,81,0,25,0,106
 druid-master\druid-master\server\src\main\java\org\apache\druid\segment\realtime\appenderator\SegmentIdWithShardSpec.java,0,36,0,8,0,44
 druid-master\druid-master\processing\src\main\java\org\apache\druid\query\aggregation\SimpleLongAggregatorFactory.java,0,84,1,16,0,101
 druid-master\druid-master\core\src\main\java\org\apache\druid\common\utils\ServletResourceUtils.java,0,16,2,7,0,25
 druid-master\druid-master\indexing-service\src\test\java\org\apache\druid\indexing\input\DruidInputSourceTest.java,0,45,0,23,0,68
 druid-master\druid-master\extensions-core\datasketches\src\main\java\org\apache\druid\query\aggregation\datasketches\tuple\ArrayOfDoublesSketchMergeAggregator.java,0,19,0,5,0,24
 druid-master\druid-master\server\src\test\java\org\apache\druid\server\coordinator\BalanceSegmentsTest.java,0,256,3,96,0,355
 druid-master\druid-master\processing\src\main\java\org\apache\druid\segment\ReferenceCountingCloseableObject.java,0,47,2,15,0,64
 druid-master\druid-master\server\src\main\java\org\apache\druid\segment\indexing\IngestionSpec.java,0,24,2,2,0,28
 druid-master\druid-master\extensions-core\s3-extensions\src\test\java\org\apache\druid\firehose\s3\StaticS3FirehoseFactoryTest.java,0,13,0,6,0,19
 druid-master\druid-master\indexing-service\src\main\java\org\apache\druid\indexing\seekablestream\supervisor\autoscaler\NoopTaskAutoScaler.java,0,6,2,2,0,10
 druid-master\druid-master\extensions-core\protobuf-extensions\src\main\java\org\apache\druid\data\input\protobuf\ProtobufInputRowParser.java,0,37,0,11,0,48
 druid-master\druid-master\server\src\main\java\org\apache\druid\server\coordinator\rules\IntervalBroadcastDistributionRule.java,0,27,0,2,0,29
 druid-master\druid-master\processing\src\main\java\org\apache\druid\segment\incremental\RowIngestionMetersFactory.java,0,2,0,1,0,3
 druid-master\druid-master\processing\src\test\java\org\apache\druid\granularity\QueryGranularityTest.java,0,192,2,86,0,280
 druid-master\druid-master\extensions-core\datasketches\src\main\java\org\apache\druid\query\aggregation\datasketches\package-info.java,0,1,0,1,0,2
 druid-master\druid-master\core\src\test\java\org\apache\druid\timeline\partition\ShardSpecTestUtils.java,0,5,1,1,0,7
 druid-master\druid-master\extensions-core\ec2-extensions\src\main\java\org\apache\druid\indexing\overlord\autoscaling\ec2\EC2IamProfileData.java,0,30,1,2,0,33
 druid-master\druid-master\server\src\main\java\org\apache\druid\guice\annotations\EscalatedClient.java,0,1,0,1,0,2
 druid-master\druid-master\server\src\main\java\org\apache\druid\curator\PotentiallyGzippedCompressionProvider.java,0,18,0,2,0,20
 druid-master\druid-master\extensions-contrib\materialized-view-selection\src\main\java\org\apache\druid\query\materializedview\DerivativeDataSourceManager.java,0,71,1,21,0,93
 druid-master\druid-master\indexing-service\src\main\java\org\apache\druid\indexing\overlord\config\TaskLockConfig.java,0,6,0,2,0,8
 druid-master\druid-master\processing\src\main\java\org\apache\druid\query\QueryPlus.java,0,73,0,24,0,97
 druid-master\druid-master\extensions-core\avro-extensions\src\test\java\org\apache\druid\data\input\AvroStreamInputRowParserTest.java,0,117,0,54,0,171
 druid-master\druid-master\server\src\test\java\org\apache\druid\server\JettyUtilsTest.java,0,3,0,1,0,4
 druid-master\druid-master\processing\src\main\java\org\apache\druid\query\topn\TopNQueryBuilder.java,0,133,0,6,0,139
 druid-master\druid-master\processing\src\main\java\org\apache\druid\query\metadata\metadata\AllColumnIncluderator.java,0,13,0,1,0,14
 druid-master\druid-master\server\src\main\java\org\apache\druid\server\audit\SQLAuditManager.java,0,75,0,19,0,94
 druid-master\druid-master\indexing-service\src\main\java\org\apache\druid\indexing\overlord\config\DefaultTaskConfig.java,0,9,0,4,0,13
 druid-master\druid-master\extensions-core\s3-extensions\src\main\java\org\apache\druid\firehose\s3\S3FirehoseDruidModule.java,0,7,1,2,0,10
 druid-master\druid-master\extensions-core\stats\src\test\java\org\apache\druid\query\aggregation\variance\StandardDeviationPostAggregatorTest.java,0,27,0,6,0,33
 druid-master\druid-master\server\src\main\java\org\apache\druid\server\security\SecuritySanityCheckFilter.java,0,30,3,8,0,41
 druid-master\druid-master\processing\src\test\java\org\apache\druid\segment\writeout\SegmentWriteOutMediumTest.java,0,19,0,2,0,21
 druid-master\druid-master\core\src\main\java\org\apache\druid\math\expr\vector\VectorProcessors.java,0,249,2,37,0,288
 druid-master\druid-master\processing\src\main\java\org\apache\druid\segment\CursorFactory.java,0,29,0,9,0,38
 druid-master\druid-master\extensions-contrib\cloudfiles-extensions\src\test\java\org\apache\druid\storage\cloudfiles\CloudFilesDataSegmentPusherTest.java,0,9,0,6,0,15
 druid-master\druid-master\core\src\main\java\org\apache\druid\java\util\metrics\JvmPidDiscoverer.java,0,14,0,3,0,17
 druid-master\druid-master\extensions-core\druid-basic-security\src\main\java\org\apache\druid\security\basic\authorization\entity\BasicAuthorizerRoleMapBundle.java,0,15,0,1,0,16
 druid-master\druid-master\extensions-core\stats\src\main\java\org\apache\druid\query\aggregation\teststats\PvaluefromZscorePostAggregator.java,0,43,2,1,0,46
 druid-master\druid-master\processing\src\test\java\org\apache\druid\query\groupby\having\DimFilterHavingSpecTest.java,0,22,0,11,0,33
 druid-master\druid-master\extensions-core\azure-extensions\src\main\java\org\apache\druid\firehose\azure\AzureBlob.java,0,28,0,5,0,33
 druid-master\druid-master\processing\src\main\java\org\apache\druid\query\search\SearchQueryRunnerFactory.java,0,23,0,4,0,27
 druid-master\druid-master\processing\src\test\java\org\apache\druid\query\DoubleStorageTest.java,0,71,0,26,0,97
 druid-master\druid-master\core\src\test\java\org\apache\druid\data\input\impl\DimensionsSpecSerdeTest.java,0,9,0,6,0,15
 druid-master\druid-master\extensions-core\datasketches\src\main\java\org\apache\druid\query\aggregation\datasketches\quantiles\DoublesSketchMergeBufferAggregator.java,0,31,0,6,0,37
 druid-master\druid-master\processing\src\main\java\org\apache\druid\segment\BaseNullableColumnValueSelector.java,0,7,0,6,0,13
 druid-master\druid-master\processing\src\main\java\org\apache\druid\segment\data\BitmapSerdeFactory.java,0,6,0,4,0,10
 druid-master\druid-master\processing\src\main\java\org\apache\druid\segment\data\DecompressingByteBufferObjectStrategy.java,0,30,0,8,0,38
 druid-master\druid-master\extensions-core\azure-extensions\src\main\java\org\apache\druid\storage\azure\AzureStorage.java,0,54,1,19,0,74
 druid-master\druid-master\server\src\main\java\org\apache\druid\server\log\FilteredRequestLoggerProvider.java,0,52,0,6,0,58
 druid-master\druid-master\integration-tests\src\test\java\org\apache\druid\tests\indexer\AbstractLocalInputSourceParallelIndexTest.java,0,25,1,10,0,36
 druid-master\druid-master\extensions-core\datasketches\src\main\java\org\apache\druid\query\aggregation\datasketches\hll\HllSketchObjectStrategy.java,0,11,0,2,0,13
 druid-master\druid-master\sql\src\main\java\org\apache\druid\sql\avatica\DruidMeta.java,0,182,21,70,0,273
 druid-master\druid-master\processing\src\main\java\org\apache\druid\query\groupby\orderby\LimitSpec.java,0,7,0,4,0,11
 druid-master\druid-master\core\src\main\java\org\apache\druid\data\input\RetryingInputEntity.java,0,25,0,11,0,36
 druid-master\druid-master\processing\src\test\java\org\apache\druid\query\metadata\SegmentMetadataUnionQueryTest.java,0,25,0,7,0,32
 druid-master\druid-master\processing\src\main\java\org\apache\druid\segment\column\LongsColumnWithNulls.java,0,16,0,3,0,19
 druid-master\druid-master\extensions-core\kinesis-indexing-service\src\main\java\org\apache\druid\indexing\kinesis\supervisor\KinesisSupervisorSpec.java,0,51,0,8,0,59
 druid-master\druid-master\indexing-service\src\test\java\org\apache\druid\server\initialization\IndexerZkConfigTest.java,0,58,0,30,0,88
 druid-master\druid-master\indexing-hadoop\src\main\java\org\apache\druid\indexer\path\HadoopGlobPathSplitter.java,0,19,2,3,0,24
 druid-master\druid-master\extensions-core\google-extensions\src\main\java\org\apache\druid\storage\google\GoogleLoadSpec.java,0,16,0,2,0,18
 druid-master\druid-master\server\src\test\java\org\apache\druid\server\coordinator\cost\SegmentsCostCacheTest.java,0,86,1,22,0,109
 druid-master\druid-master\indexing-service\src\test\java\org\apache\druid\indexing\common\task\batch\parallel\SegmentAllocationRequestTest.java,0,6,0,2,0,8
 druid-master\druid-master\core\src\test\java\org\apache\druid\data\input\impl\NoopInputSource.java,0,12,0,1,0,13
 druid-master\druid-master\processing\src\main\java\org\apache\druid\query\aggregation\DoubleAggregateCombiner.java,0,3,1,3,0,7
 druid-master\druid-master\server\src\main\java\org\apache\druid\client\cache\BackgroundCachePopulator.java,0,28,0,6,0,34
 druid-master\druid-master\processing\src\test\java\org\apache\druid\segment\IntIteratorUtilsTest.java,0,16,0,3,0,19
 druid-master\druid-master\sql\src\main\java\org\apache\druid\sql\calcite\run\QueryMaker.java,0,8,0,5,0,13
 druid-master\druid-master\benchmarks\src\test\java\org\apache\druid\benchmark\TimeParseBenchmark.java,0,27,0,2,0,29
 druid-master\druid-master\server\src\main\java\org\apache\druid\server\coordination\ChangeRequestHttpSyncer.java,0,126,4,34,0,164
 druid-master\druid-master\indexing-service\src\test\java\org\apache\druid\indexing\overlord\WorkerTaskRunnerQueryAdpaterTest.java,0,44,4,17,0,65
 druid-master\druid-master\indexing-service\src\main\java\org\apache\druid\indexing\common\task\AbstractFixedIntervalTask.java,0,39,1,6,0,46
 druid-master\druid-master\server\src\test\java\org\apache\druid\curator\discovery\ServerDiscoverySelectorTest.java,0,34,1,8,0,43
 druid-master\druid-master\processing\src\main\java\org\apache\druid\query\groupby\epinephelinae\DictionaryBuilding.java,0,16,1,5,0,22
 druid-master\druid-master\processing\src\main\java\org\apache\druid\query\aggregation\last\StringLastAggregator.java,0,33,0,8,0,41
 druid-master\druid-master\processing\src\main\java\org\apache\druid\collections\bitmap\WrappedBitSetBitmap.java,0,38,0,2,0,40
 druid-master\druid-master\server\src\main\java\org\apache\druid\segment\realtime\appenderator\DefaultRealtimeAppenderatorFactory.java,0,44,0,2,0,46
 druid-master\druid-master\core\src\test\java\org\apache\druid\java\util\common\guava\FilteredSequenceTest.java,0,8,0,1,1,10
 druid-master\druid-master\extensions-core\datasketches\src\main\java\org\apache\druid\query\aggregation\datasketches\tuple\ArrayOfDoublesSketchMultiPostAggregator.java,0,22,0,4,0,26
 druid-master\druid-master\core\src\main\java\org\apache\druid\math\expr\ExpressionProcessingConfig.java,0,44,0,11,0,55
 druid-master\druid-master\processing\src\main\java\org\apache\druid\query\filter\DruidLongPredicate.java,0,12,0,2,0,14
 druid-master\druid-master\processing\src\main\java\org\apache\druid\query\filter\ExtractionDimFilter.java,0,42,0,5,0,47
 druid-master\druid-master\indexing-service\src\test\java\org\apache\druid\indexing\overlord\http\security\OverlordSecurityResourceFilterTest.java,0,53,0,10,0,63
 druid-master\druid-master\processing\src\main\java\org\apache\druid\query\extraction\JavaScriptExtractionFn.java,0,58,2,8,0,68
 druid-master\druid-master\extensions-core\datasketches\src\main\java\org\apache\druid\query\aggregation\datasketches\hll\sql\HllSketchSetUnionOperatorConversion.java,0,20,0,5,0,25
 druid-master\druid-master\processing\src\main\java\org\apache\druid\query\aggregation\last\NumericLastAggregator.java,0,24,1,5,0,30
 druid-master\druid-master\extensions-contrib\redis-cache\src\main\java\org\apache\druid\client\cache\AbstractRedisCache.java,0,45,2,5,0,52
 druid-master\druid-master\server\src\main\java\org\apache\druid\segment\realtime\plumber\MessageTimeRejectionPolicyFactory.java,0,24,1,4,0,29
 druid-master\druid-master\integration-tests\src\main\java\org\apache\druid\testing\utils\QueryWithResults.java,0,7,0,2,0,9
 druid-master\druid-master\server\src\test\java\org\apache\druid\metadata\IndexerSQLMetadataStorageCoordinatorTest.java,0,421,2,197,0,620
 druid-master\druid-master\indexing-service\src\main\java\org\apache\druid\indexing\common\tasklogs\TaskRunnerTaskLogStreamer.java,0,14,0,3,0,17
 druid-master\druid-master\extensions-core\druid-basic-security\src\main\java\org\apache\druid\security\basic\authorization\entity\BasicAuthorizerGroupMappingMapBundle.java,0,17,0,3,0,20
 druid-master\druid-master\indexing-service\src\main\java\org\apache\druid\indexing\overlord\TaskStorageQueryAdapter.java,0,52,0,14,0,66
 druid-master\druid-master\core\src\main\java\org\apache\druid\math\expr\ExprType.java,0,10,0,2,0,12
 druid-master\druid-master\extensions-core\lookups-cached-global\src\test\java\org\apache\druid\server\lookup\namespace\cache\OffHeapNamespaceExtractionCacheManagerTest.java,0,9,0,4,0,13
 druid-master\druid-master\sql\src\main\java\org\apache\druid\sql\http\ResultFormat.java,0,36,0,9,0,45
 druid-master\druid-master\core\src\main\java\org\apache\druid\java\util\common\Cacheable.java,0,1,0,1,0,2
 druid-master\druid-master\processing\src\test\java\org\apache\druid\query\groupby\epinephelinae\ByteBufferMinMaxOffsetHeapTest.java,0,170,0,8,0,178
 druid-master\druid-master\sql\src\main\java\org\apache\druid\sql\calcite\view\DruidViewMacro.java,0,18,1,2,0,21
 druid-master\druid-master\processing\src\test\java\org\apache\druid\segment\MergingRowIteratorTest.java,0,58,0,13,0,71
 druid-master\druid-master\extensions-contrib\aliyun-oss-extensions\src\main\java\org\apache\druid\storage\aliyun\OssStorageConfig.java,0,19,0,1,0,20
 druid-master\druid-master\core\src\test\java\org\apache\druid\java\util\emitter\core\ParametrizedUriEmitterConfigTest.java,0,25,0,17,0,42
 druid-master\druid-master\extensions-contrib\materialized-view-maintenance\src\main\java\org\apache\druid\indexing\materializedview\MaterializedViewMaintenanceDruidModule.java,0,11,0,4,0,15
 druid-master\druid-master\processing\src\main\java\org\apache\druid\segment\filter\RegexFilter.java,0,34,1,1,0,36
 druid-master\druid-master\extensions-contrib\materialized-view-selection\src\main\java\org\apache\druid\query\materializedview\DerivativeDataSource.java,0,38,0,3,0,41
 druid-master\druid-master\server\src\test\java\org\apache\druid\server\coordinator\duty\KillUnusedSegmentsTest.java,0,48,0,22,0,70
 druid-master\druid-master\processing\src\main\java\org\apache\druid\query\aggregation\hyperloglog\HyperUniquesAggregator.java,0,22,0,5,0,27
 druid-master\druid-master\core\src\main\java\org\apache\druid\guice\LifecycleScope.java,0,22,1,3,1,27
 druid-master\druid-master\processing\src\main\java\org\apache\druid\segment\StringDimensionMergerV9.java,0,50,0,12,0,62
 druid-master\druid-master\processing\src\test\java\org\apache\druid\query\ordering\StringComparatorsTest.java,0,53,0,25,0,78
 druid-master\druid-master\services\src\main\java\org\apache\druid\cli\RouterJettyServerInitializer.java,0,54,0,23,0,77
 druid-master\druid-master\processing\src\main\java\org\apache\druid\query\filter\IntervalDimFilter.java,0,71,1,8,0,80
 druid-master\druid-master\extensions-core\druid-basic-security\src\test\java\org\apache\druid\security\basic\authorization\endpoint\BasicAuthorizerResourceTest.java,0,140,0,37,0,177
 druid-master\druid-master\indexing-service\src\main\java\org\apache\druid\indexing\common\task\IndexTaskClientFactory.java,0,3,0,2,0,5
 druid-master\druid-master\indexing-service\src\test\java\org\apache\druid\indexing\worker\TaskAnnouncementTest.java,0,18,0,12,0,30
 druid-master\druid-master\services\src\main\java\org\apache\druid\cli\CliPeon.java,0,92,5,47,0,144
 druid-master\druid-master\extensions-core\azure-extensions\src\main\java\org\apache\druid\storage\azure\AzureTaskLogs.java,0,61,5,9,0,75
 druid-master\druid-master\sql\src\main\java\org\apache\druid\sql\calcite\expression\builtin\RPadOperatorConversion.java,0,7,0,2,0,9
 druid-master\druid-master\processing\src\main\java\org\apache\druid\query\GenericQueryMetricsFactory.java,0,9,0,7,0,16
 druid-master\druid-master\sql\src\test\java\org\apache\druid\sql\calcite\CalciteQueryTest.java,0,2479,3,1222,0,3704
 druid-master\druid-master\core\src\main\java\org\apache\druid\java\util\metrics\cgroups\Memory.java,0,32,2,7,0,41
 druid-master\druid-master\processing\src\main\java\org\apache\druid\segment\virtual\ExpressionVectorInputBinding.java,0,33,0,3,0,36
 druid-master\druid-master\processing\src\main\java\org\apache\druid\segment\data\ImmutableBitmapValues.java,0,11,0,2,0,13
 druid-master\druid-master\extensions-core\lookups-cached-global\src\main\java\org\apache\druid\server\lookup\namespace\cache\CacheScheduler.java,0,155,8,50,0,213
 druid-master\druid-master\processing\src\main\java\org\apache\druid\query\search\DefaultSearchQueryMetricsFactory.java,0,16,0,5,0,21
 druid-master\druid-master\extensions-core\s3-extensions\src\main\java\org\apache\druid\storage\s3\S3Utils.java,0,119,4,39,0,162
 druid-master\druid-master\processing\src\main\java\org\apache\druid\query\aggregation\any\StringAnyAggregator.java,0,26,0,5,0,31
 druid-master\druid-master\server\src\main\java\org\apache\druid\server\emitter\ExtraServiceDimensions.java,0,4,0,4,0,8
 druid-master\druid-master\processing\src\main\java\org\apache\druid\segment\filter\Filters.java,0,149,5,65,0,219
 druid-master\druid-master\indexing-service\src\main\java\org\apache\druid\indexing\common\task\ShardSpecs.java,0,14,0,5,0,19
 druid-master\druid-master\server\src\main\java\org\apache\druid\server\emitter\ParametrizedUriEmitterSSLClientConfig.java,0,12,0,3,0,15
 druid-master\druid-master\processing\src\test\java\org\apache\druid\query\aggregation\LongMaxAggregationTest.java,0,72,0,25,0,97
 druid-master\druid-master\core\src\main\java\org\apache\druid\java\util\common\guava\MergeIterable.java,0,12,0,1,0,13
 druid-master\druid-master\core\src\main\java\org\apache\druid\collections\StableLimitingSorter.java,0,37,0,4,0,41
 druid-master\druid-master\processing\src\test\java\org\apache\druid\query\expression\TimestampShiftMacroTest.java,0,51,0,9,0,60
 druid-master\druid-master\sql\src\test\java\org\apache\druid\sql\calcite\parser\DruidSqlParserUtilsTest.java,0,78,0,31,0,109
 druid-master\druid-master\extensions-core\druid-basic-security\src\main\java\org\apache\druid\security\basic\authorization\entity\BasicAuthorizerGroupMapping.java,0,31,0,4,0,35
 druid-master\druid-master\processing\src\main\java\org\apache\druid\segment\data\ColumnarLongs.java,0,50,0,12,0,62
 druid-master\druid-master\processing\src\main\java\org\apache\druid\query\expression\TimestampParseExprMacro.java,0,31,1,9,0,41
 druid-master\druid-master\processing\src\test\java\org\apache\druid\query\aggregation\last\StringLastTimeseriesQueryTest.java,0,36,0,19,0,55
 druid-master\druid-master\indexing-service\src\test\java\org\apache\druid\indexing\common\task\batch\parallel\GenericPartitionStatTest.java,0,14,0,4,0,18
 druid-master\druid-master\server\src\test\java\org\apache\druid\server\coordinator\LoadQueuePeonTest.java,0,83,1,25,0,109
 druid-master\druid-master\processing\src\test\java\org\apache\druid\query\topn\TopNQueryRunnerTestHelper.java,0,10,1,4,0,15
 druid-master\druid-master\extensions-core\google-extensions\src\test\java\org\apache\druid\storage\google\GoogleStorageDruidModuleTest.java,0,6,0,3,0,9
 druid-master\druid-master\core\src\test\java\org\apache\druid\timeline\partition\DimensionRangeShardSpecTest.java,0,59,9,10,1,79
 druid-master\druid-master\server\src\main\java\org\apache\druid\server\initialization\jetty\CliIndexerServerModule.java,0,41,2,15,0,58
 druid-master\druid-master\extensions-contrib\virtual-columns\src\main\java\org\apache\druid\segment\StringTypeMapVirtualColumnDimensionSelector.java,0,35,0,7,0,42
 druid-master\druid-master\processing\src\main\java\org\apache\druid\query\expression\TimestampExtractExprMacro.java,0,48,0,7,0,55
 druid-master\druid-master\server\src\test\java\org\apache\druid\server\coordinator\duty\KillDatasourceMetadataTest.java,0,42,1,20,0,63
 druid-master\druid-master\processing\src\main\java\org\apache\druid\query\lookup\RegisteredLookupExtractionFn.java,0,75,2,6,0,83
 druid-master\druid-master\indexing-service\src\main\java\org\apache\druid\indexing\common\TaskRealtimeMetricsMonitorBuilder.java,0,14,1,3,0,18
 druid-master\druid-master\core\src\main\java\org\apache\druid\common\guava\DSuppliers.java,0,6,1,1,0,8
 druid-master\druid-master\processing\src\main\java\org\apache\druid\query\filter\RegexDimFilter.java,0,70,0,7,0,77
 druid-master\druid-master\extensions-contrib\moving-average-query\src\test\java\org\apache\druid\query\movingaverage\averagers\DoubleSumAveragerFactoryTest.java,0,6,0,3,0,9
 druid-master\druid-master\extensions-core\datasketches\src\main\java\org\apache\druid\query\aggregation\datasketches\tuple\ArrayOfDoublesSketchBuildBufferAggregator.java,0,56,1,24,0,81
 druid-master\druid-master\processing\src\main\java\org\apache\druid\query\groupby\epinephelinae\collection\MemoryOpenHashTable.java,0,92,0,38,0,130
 druid-master\druid-master\extensions-contrib\influx-extensions\target\generated-sources\antlr4\org\apache\druid\data\input\influx\InfluxLineProtocolListener.java,0,28,10,2,0,40
 druid-master\druid-master\server\src\main\java\org\apache\druid\server\AsyncManagementForwardingServlet.java,0,71,1,26,0,98
 druid-master\druid-master\server\src\main\java\org\apache\druid\server\log\StartupLoggingConfig.java,0,10,0,2,0,12
 druid-master\druid-master\processing\src\main\java\org\apache\druid\query\aggregation\DoubleMinBufferAggregator.java,0,17,0,1,0,18
 druid-master\druid-master\core\src\main\java\org\apache\druid\data\input\IntermediateRowParsingReader.java,0,95,0,44,0,139
 druid-master\druid-master\extensions-contrib\tdigestsketch\src\main\java\org\apache\druid\query\aggregation\tdigestsketch\TDigestSketchUtils.java,0,23,1,7,0,31
 druid-master\druid-master\sql\src\main\java\org\apache\druid\sql\calcite\aggregation\builtin\CountSqlAggregator.java,0,17,0,7,0,24
 druid-master\druid-master\extensions-core\datasketches\src\main\java\org\apache\druid\query\aggregation\datasketches\quantiles\DoublesSketchToHistogramPostAggregator.java,0,59,2,6,0,67
 druid-master\druid-master\processing\src\main\java\org\apache\druid\query\monomorphicprocessing\StringRuntimeShape.java,0,44,1,4,0,49
 druid-master\druid-master\extensions-core\google-extensions\src\test\java\org\apache\druid\storage\google\GoogleTaskLogsTest.java,0,85,8,34,0,127
 druid-master\druid-master\extensions-contrib\moving-average-query\src\test\java\org\apache\druid\query\movingaverage\averagers\DoubleMinAveragerTest.java,0,14,1,4,0,19
 druid-master\druid-master\extensions-core\avro-extensions\target\generated-test-sources\avro\org\apache\druid\data\input\UnionSubRecord.java,0,82,40,21,0,143
 druid-master\druid-master\integration-tests\src\main\java\org\apache\druid\testing\utils\StreamAdminClient.java,0,14,0,8,0,22
 druid-master\druid-master\server\src\main\java\org\apache\druid\segment\loading\LocalDataSegmentKiller.java,0,21,2,5,0,28
 druid-master\druid-master\server\src\main\java\org\apache\druid\discovery\DiscoveryDruidNode.java,0,62,2,20,0,84
 druid-master\druid-master\server\src\test\java\org\apache\druid\curator\CuratorUtilsTest.java,0,25,0,5,0,30
 druid-master\druid-master\processing\src\main\java\org\apache\druid\query\filter\DimFilterUtils.java,0,44,1,16,0,61
 druid-master\druid-master\services\src\test\java\org\apache\druid\server\router\ManualTieredBrokerSelectorStrategyTest.java,0,41,3,14,0,58
 druid-master\druid-master\server\src\main\java\org\apache\druid\server\coordinator\UserCompactionTaskGranularityConfig.java,0,41,0,7,0,48
 druid-master\druid-master\core\src\main\java\org\apache\druid\java\util\common\parsers\Parsers.java,0,3,0,1,0,4
 druid-master\druid-master\extensions-core\lookups-cached-global\src\test\java\org\apache\druid\data\input\MapPopulatorTest.java,0,106,20,26,0,152
 druid-master\druid-master\extensions-core\parquet-extensions\src\main\java\org\apache\druid\data\input\parquet\ParquetReader.java,0,42,0,8,0,50
 druid-master\druid-master\extensions-core\datasketches\src\main\java\org\apache\druid\query\aggregation\datasketches\theta\oldapi\OldApiSketchModule.java,0,19,0,13,0,32
 druid-master\druid-master\core\src\main\java\org\apache\druid\timeline\partition\SingleDimensionRangeBucketShardSpec.java,0,56,0,4,0,60
 druid-master\druid-master\extensions-core\kubernetes-extensions\src\main\java\org\apache\druid\k8s\discovery\K8sDiscoveryConfig.java,0,95,0,16,0,111
 druid-master\druid-master\server\src\main\java\org\apache\druid\server\coordination\DruidServerMetadata.java,0,73,0,2,0,75
 druid-master\druid-master\benchmarks\src\test\java\org\apache\druid\benchmark\DruidSchemaInternRowSignatureBenchmark.java,0,41,2,8,0,51
 druid-master\druid-master\indexing-service\src\test\java\org\apache\druid\indexing\common\task\ClientCompactionTaskQuerySerdeTest.java,0,57,0,34,0,91
 druid-master\druid-master\processing\src\main\java\org\apache\druid\segment\column\SimpleColumnHolder.java,0,35,1,11,0,47
 druid-master\druid-master\extensions-core\kafka-indexing-service\src\main\java\org\apache\druid\indexing\kafka\KafkaIndexTaskTuningConfig.java,0,61,0,16,0,77
 druid-master\druid-master\core\src\main\java\org\apache\druid\guice\KeyHolder.java,0,10,0,1,0,11
 druid-master\druid-master\indexing-service\src\main\java\org\apache\druid\indexing\common\task\batch\parallel\ParallelIndexIOConfig.java,0,20,0,4,0,24
 druid-master\druid-master\indexing-service\src\test\java\org\apache\druid\indexing\overlord\TaskLockboxTest.java,0,325,15,144,0,484
 druid-master\druid-master\benchmarks\src\test\java\org\apache\druid\benchmark\compression\ColumnarLongsEncodeDataFromGeneratorBenchmark.java,0,25,2,11,0,38
 druid-master\druid-master\processing\src\main\java\org\apache\druid\query\aggregation\DoubleSumBufferAggregator.java,0,17,0,1,0,18
 druid-master\druid-master\processing\src\main\java\org\apache\druid\query\scan\ScanQueryQueryToolChest.java,0,53,1,24,0,78
 druid-master\druid-master\extensions-core\azure-extensions\src\test\java\org\apache\druid\storage\azure\AzureByteSourceTest.java,0,23,4,10,0,37
 druid-master\druid-master\processing\src\main\java\org\apache\druid\query\groupby\epinephelinae\vector\DoubleGroupByVectorColumnSelector.java,0,12,0,2,0,14
 druid-master\druid-master\server\src\test\java\org\apache\druid\server\DruidNodeTest.java,0,158,9,30,0,197
 druid-master\druid-master\extensions-core\druid-basic-security\src\main\java\org\apache\druid\security\basic\authentication\entity\BasicAuthenticatorUserMapBundle.java,0,15,0,1,0,16
 druid-master\druid-master\indexing-service\src\main\java\org\apache\druid\indexing\overlord\sampler\SamplerResource.java,0,5,0,2,0,7
 druid-master\druid-master\core\src\main\java\org\apache\druid\common\exception\ErrorResponseTransformStrategy.java,0,11,0,7,0,18
 druid-master\druid-master\extensions-core\histogram\src\main\java\org\apache\druid\query\aggregation\histogram\ApproximateHistogramBufferAggregatorHelper.java,0,15,0,6,0,21
 druid-master\druid-master\processing\src\test\java\org\apache\druid\query\dimension\DefaultDimensionSpecTest.java,0,12,0,4,0,16
 druid-master\druid-master\extensions-core\parquet-extensions\src\test\java\org\apache\druid\data\input\parquet\WikiParquetInputTest.java,0,13,0,3,0,16
 druid-master\druid-master\server\src\test\java\org\apache\druid\server\coordinator\UserCompactionTaskTransformConfigTest.java,0,7,0,3,0,10
 druid-master\druid-master\indexing-service\src\main\java\org\apache\druid\indexing\overlord\LockRequest.java,0,10,0,1,0,11
 druid-master\druid-master\processing\src\main\java\org\apache\druid\query\aggregation\ExpressionLambdaAggregatorFactory.java,0,225,0,48,0,273
 druid-master\druid-master\extensions-core\druid-basic-security\src\main\java\org\apache\druid\security\basic\BasicAuthSSLConfig.java,0,93,0,6,0,99
 druid-master\druid-master\server\src\main\java\org\apache\druid\client\selector\HighestPriorityTierSelectorStrategy.java,0,8,0,3,0,11
 druid-master\druid-master\sql\src\test\java\org\apache\druid\sql\calcite\schema\NamedDruidSchemaTest.java,0,10,0,1,0,11
 druid-master\druid-master\extensions-contrib\sqlserver-metadata-storage\src\test\java\org\apache\druid\metadata\storage\sqlserver\SQLServerConnectorTest.java,0,10,0,8,0,18
 druid-master\druid-master\core\src\main\java\org\apache\druid\java\util\common\RE.java,0,13,0,1,0,14
 druid-master\druid-master\processing\src\test\java\org\apache\druid\query\filter\SelectorPredicateFactoryTest.java,0,4,0,2,0,6
 druid-master\druid-master\processing\src\main\java\org\apache\druid\query\aggregation\any\DoubleAnyAggregator.java,0,17,0,2,0,19
 druid-master\druid-master\server\src\test\java\org\apache\druid\segment\handoff\CoordinatorBasedSegmentHandoffNotifierTest.java,0,41,0,11,0,52
 druid-master\druid-master\processing\src\main\java\org\apache\druid\segment\ConstantExprEvalSelector.java,0,23,0,2,0,25
 druid-master\druid-master\processing\src\main\java\org\apache\druid\segment\data\IndexedIterable.java,0,16,0,1,0,17
 druid-master\druid-master\extensions-core\druid-basic-security\src\main\java\org\apache\druid\security\basic\BasicSecurityDBResourceException.java,0,13,0,4,0,17
 druid-master\druid-master\processing\src\test\java\org\apache\druid\segment\filter\RegexFilterTest.java,0,68,0,40,0,108
 druid-master\druid-master\extensions-contrib\aliyun-oss-extensions\src\main\java\org\apache\druid\storage\aliyun\OssStorageDruidModule.java,0,30,0,10,0,40
 druid-master\druid-master\server\src\main\java\org\apache\druid\initialization\Initialization.java,0,127,8,50,0,185
 druid-master\druid-master\processing\src\main\java\org\apache\druid\query\filter\FalseDimFilter.java,0,19,1,3,0,23
 druid-master\druid-master\server\src\main\java\org\apache\druid\segment\realtime\appenderator\DefaultOfflineAppenderatorFactory.java,0,21,0,2,0,23
 druid-master\druid-master\processing\src\main\java\org\apache\druid\segment\RowIterator.java,0,24,0,23,0,47
 druid-master\druid-master\sql\src\main\java\org\apache\druid\sql\calcite\rel\DruidJoinQueryRel.java,0,84,2,31,0,117
 druid-master\druid-master\processing\src\main\java\org\apache\druid\segment\ColumnSelectorFactory.java,0,9,0,5,0,14
 druid-master\druid-master\server\src\main\java\org\apache\druid\server\initialization\BatchDataSegmentAnnouncerConfig.java,0,27,0,1,0,28
 druid-master\druid-master\core\src\main\java\org\apache\druid\java\util\emitter\core\Emitter.java,0,7,0,5,0,12
 druid-master\druid-master\extensions-core\druid-ranger-security\src\main\java\org\apache\druid\security\ranger\authorizer\guice\Ranger.java,0,2,0,1,0,3
 druid-master\druid-master\extensions-core\kafka-indexing-service\src\test\java\org\apache\druid\data\input\kafkainput\KafkaStringHeaderFormatTest.java,0,38,0,7,0,45
 druid-master\druid-master\core\src\main\java\org\apache\druid\java\util\common\IOE.java,0,10,0,1,0,11
 druid-master\druid-master\processing\src\test\java\org\apache\druid\query\aggregation\post\FinalizingFieldAccessPostAggregatorTest.java,0,73,7,31,0,111
 druid-master\druid-master\indexing-service\src\main\java\org\apache\druid\indexing\overlord\helpers\OverlordHelper.java,0,4,0,1,0,5
 druid-master\druid-master\indexing-service\src\main\java\org\apache\druid\indexing\seekablestream\SeekableStreamIndexTaskClient.java,0,135,6,35,0,176
 druid-master\druid-master\processing\src\main\java\org\apache\druid\query\extraction\UpperExtractionFn.java,0,25,0,4,0,29
 druid-master\druid-master\processing\src\test\java\org\apache\druid\query\aggregation\post\ArithmeticPostAggregatorTest.java,0,46,0,22,0,68
 druid-master\druid-master\indexing-service\src\main\java\org\apache\druid\indexing\seekablestream\supervisor\SeekableStreamSupervisorStateManager.java,0,42,0,6,0,48
 druid-master\druid-master\processing\src\main\java\org\apache\druid\query\extraction\IdentityExtractionFn.java,0,21,2,3,0,26
 druid-master\druid-master\extensions-contrib\opentsdb-emitter\src\main\java\org\apache\druid\emitter\opentsdb\EventConverter.java,0,30,1,5,0,36
 druid-master\druid-master\core\src\main\java\org\apache\druid\jackson\CommaListJoinSerializer.java,0,9,0,2,0,11
 druid-master\druid-master\processing\src\main\java\org\apache\druid\query\timeseries\TimeseriesQueryQueryToolChest.java,0,117,0,50,0,167
 druid-master\druid-master\core\src\test\java\org\apache\druid\java\util\metrics\CgroupCpuMonitorTest.java,0,33,2,12,1,48
 druid-master\druid-master\processing\src\main\java\org\apache\druid\query\aggregation\constant\LongConstantVectorAggregator.java,0,28,3,3,0,34
 druid-master\druid-master\extensions-core\druid-basic-security\src\main\java\org\apache\druid\security\basic\authorization\entity\BasicAuthorizerUser.java,0,23,0,3,0,26
 druid-master\druid-master\processing\src\test\java\org\apache\druid\query\groupby\having\DimensionSelectorHavingSpecTest.java,0,46,0,27,0,73
 druid-master\druid-master\server\src\test\java\org\apache\druid\server\log\TestRequestLogger.java,0,27,0,1,0,28
 druid-master\druid-master\server\src\main\java\org\apache\druid\segment\realtime\plumber\Committers.java,0,13,1,2,0,16
 druid-master\druid-master\processing\src\main\java\org\apache\druid\segment\column\ValueTypes.java,0,16,1,11,0,28
 druid-master\druid-master\processing\src\main\java\org\apache\druid\query\topn\TopNResultValue.java,0,24,1,2,0,27
 druid-master\druid-master\extensions-contrib\cloudfiles-extensions\src\main\java\org\apache\druid\storage\cloudfiles\CloudFilesObjectApiProxy.java,0,28,0,3,0,31
 druid-master\druid-master\integration-tests\src\test\java\org\apache\druid\tests\parallelized\ITKafkaIndexingServiceDataFormatTest.java,0,28,1,12,0,41
 druid-master\druid-master\extensions-core\datasketches\src\test\java\org\apache\druid\query\aggregation\datasketches\quantiles\DoublesSketchToStringPostAggregatorTest.java,0,12,0,3,0,15
 druid-master\druid-master\indexing-service\src\test\java\org\apache\druid\indexing\common\task\batch\parallel\DeepStorageShuffleClientTest.java,0,19,1,9,0,29
 druid-master\druid-master\processing\src\main\java\org\apache\druid\query\timeseries\TimeseriesQuery.java,0,123,0,21,0,144
 druid-master\druid-master\core\src\test\java\org\apache\druid\timeline\OvershadowableTest.java,0,9,0,1,1,11
 druid-master\druid-master\processing\src\test\java\org\apache\druid\segment\incremental\MutableRowIngestionMetersTest.java,0,12,0,7,0,19
 druid-master\druid-master\server\src\main\java\org\apache\druid\segment\realtime\firehose\FixedCountFirehoseFactory.java,0,24,0,3,0,27
 druid-master\druid-master\core\src\test\java\org\apache\druid\math\expr\ExprEvalTest.java,0,158,1,21,0,180
 druid-master\druid-master\processing\src\main\java\org\apache\druid\query\aggregation\AggregatorAndSize.java,0,14,0,2,0,16
 druid-master\druid-master\core\src\main\java\org\apache\druid\java\util\common\parsers\JSONPathFieldSpec.java,0,49,0,3,0,52
 druid-master\druid-master\core\src\main\java\org\apache\druid\java\util\emitter\core\ParametrizedUriEmitterConfig.java,0,18,0,3,0,21
 druid-master\druid-master\core\src\main\java\org\apache\druid\data\input\impl\prefetch\FetchConfig.java,0,46,0,10,0,56
 druid-master\druid-master\processing\src\test\java\org\apache\druid\query\aggregation\TestLongColumnSelector.java,0,15,0,2,0,17
 druid-master\druid-master\server\src\main\java\org\apache\druid\segment\realtime\firehose\ServiceAnnouncingChatHandlerProvider.java,0,33,0,6,0,39
 druid-master\druid-master\processing\src\main\java\org\apache\druid\query\filter\vector\VectorMatch.java,0,51,1,17,0,69
 druid-master\druid-master\sql\src\main\java\org\apache\druid\sql\calcite\aggregation\builtin\BitwiseSqlAggregator.java,0,38,0,6,0,44
 druid-master\druid-master\processing\src\test\java\org\apache\druid\segment\writeout\WriteOutBytesTest.java,0,25,0,5,0,30
 druid-master\druid-master\core\src\main\java\org\apache\druid\math\expr\vector\LongOutDoubleInFunctionVectorValueProcessor.java,0,17,0,5,0,22
 druid-master\druid-master\processing\src\main\java\org\apache\druid\segment\vector\MultiValueDimensionVectorSelector.java,0,4,0,3,0,7
 druid-master\druid-master\core\src\main\java\org\apache\druid\math\expr\ExpressionType.java,0,60,3,18,0,81
 druid-master\druid-master\processing\src\test\java\org\apache\druid\segment\virtual\ExpressionVectorObjectSelectorTest.java,0,13,0,3,0,16
 druid-master\druid-master\server\src\main\java\org\apache\druid\client\cache\HybridCacheConfig.java,0,14,0,1,0,15
 druid-master\druid-master\sql\src\main\java\org\apache\druid\sql\calcite\rel\DruidQuery.java,0,212,3,135,0,350
 druid-master\druid-master\core\src\test\java\org\apache\druid\java\util\metrics\cgroups\CpuAcctTest.java,0,285,2,8,2,297
 druid-master\druid-master\sql\src\main\java\org\apache\druid\sql\calcite\expression\builtin\BaseExpressionDimFilterOperatorConversion.java,0,14,0,3,0,17
 druid-master\druid-master\extensions-core\kafka-indexing-service\src\main\java\org\apache\druid\indexing\kafka\KafkaRecordSupplier.java,0,95,0,34,0,129
 druid-master\druid-master\server\src\test\java\org\apache\druid\server\ServerTestHelper.java,0,3,0,1,0,4
 druid-master\druid-master\integration-tests\src\test\java\org\apache\druid\tests\indexer\ITAzureToAzureParallelIndexTest.java,0,12,0,9,0,21
 druid-master\druid-master\services\src\test\java\org\apache\druid\cli\DiscoverySideEffectsProviderTest.java,0,40,0,14,0,54
 druid-master\druid-master\sql\src\main\java\org\apache\druid\sql\calcite\expression\UnaryFunctionOperatorConversion.java,0,12,0,2,0,14
 druid-master\druid-master\core\src\main\java\org\apache\druid\java\util\http\client\pool\ResourcePool.java,0,106,9,32,0,147
 druid-master\druid-master\server\src\main\java\org\apache\druid\segment\loading\LocalFileTimestampVersionFinder.java,0,15,1,7,0,23
 druid-master\druid-master\core\src\main\java\org\apache\druid\timeline\LogicalSegment.java,0,14,0,7,0,21
 druid-master\druid-master\server\src\test\java\org\apache\druid\client\indexing\NoopIndexingServiceClient.java,0,57,2,3,0,62
 druid-master\druid-master\server\src\main\java\org\apache\druid\server\http\security\RulesResourceFilter.java,0,14,0,4,0,18
 druid-master\druid-master\extensions-core\kinesis-indexing-service\src\test\java\org\apache\druid\indexing\kinesis\KinesisIndexTaskTuningConfigTest.java,0,124,0,55,0,179
 druid-master\druid-master\extensions-core\druid-basic-security\src\test\java\org\apache\druid\security\authentication\BasicHTTPAuthenticatorTest.java,0,63,1,31,0,95
 druid-master\druid-master\processing\src\main\java\org\apache\druid\query\FinalizeResultsQueryRunner.java,0,30,0,14,0,44
 druid-master\druid-master\processing\src\main\java\org\apache\druid\query\aggregation\FloatSumAggregator.java,0,27,0,2,0,29
 druid-master\druid-master\processing\src\test\java\org\apache\druid\query\extraction\MapLookupExtractorTest.java,0,35,0,15,0,50
 druid-master\druid-master\extensions-core\datasketches\src\main\java\org\apache\druid\query\aggregation\datasketches\tuple\ArrayOfDoublesSketchToQuantilesSketchPostAggregator.java,0,44,0,11,0,55
 druid-master\druid-master\processing\src\test\java\org\apache\druid\segment\join\table\BroadcastSegmentIndexedTableTest.java,0,93,3,28,0,124
 druid-master\druid-master\server\src\main\java\org\apache\druid\client\indexing\TaskStatus.java,0,31,0,1,0,32
 druid-master\druid-master\indexing-service\src\main\java\org\apache\druid\indexing\common\task\batch\parallel\ParallelIndexPhaseRunner.java,0,152,10,49,0,211
 druid-master\druid-master\extensions-core\hdfs-storage\src\main\java\org\apache\druid\inputsource\hdfs\HdfsInputEntity.java,0,18,0,1,0,19
 druid-master\druid-master\core\src\test\java\org\apache\druid\data\input\impl\ParseSpecTest.java,0,30,0,12,7,49
 druid-master\druid-master\server\src\main\java\org\apache\druid\server\coordinator\ReservoirSegmentSampler.java,0,42,0,26,0,68
 druid-master\druid-master\core\src\test\java\org\apache\druid\common\config\NullHandlingTest.java,0,27,8,1,0,36
 druid-master\druid-master\extensions-core\kinesis-indexing-service\src\test\java\org\apache\druid\indexing\kinesis\KinesisRegionTest.java,0,14,0,5,0,19
 druid-master\druid-master\core\src\main\java\org\apache\druid\guice\PolyBind.java,0,77,1,28,4,110
 druid-master\druid-master\processing\src\main\java\org\apache\druid\query\QueryToolChest.java,0,129,2,85,0,216
 druid-master\druid-master\server\src\main\java\org\apache\druid\server\coordinator\duty\RunRules.java,0,38,1,20,0,59
 druid-master\druid-master\processing\src\test\java\org\apache\druid\query\TableDataSourceTest.java,0,43,12,4,0,59
 druid-master\druid-master\extensions-core\s3-extensions\src\test\java\org\apache\druid\storage\s3\S3DataSegmentKillerTest.java,0,45,4,17,0,66
 druid-master\druid-master\core\src\main\java\org\apache\druid\segment\column\TypeSignature.java,0,72,1,46,0,119
 druid-master\druid-master\server\src\main\java\org\apache\druid\server\coordinator\duty\CoordinatorCustomDuty.java,0,15,0,13,0,28
 druid-master\druid-master\core\src\main\java\org\apache\druid\utils\Runnables.java,0,6,1,1,0,8
 druid-master\druid-master\processing\src\test\java\org\apache\druid\segment\IndexMergerLongestSharedDimOrderTest.java,0,63,0,37,0,100
 druid-master\druid-master\extensions-contrib\prometheus-emitter\src\main\java\org\apache\druid\emitter\prometheus\DimensionsAndCollector.java,0,22,0,2,0,24
 druid-master\druid-master\services\src\main\java\org\apache\druid\cli\ValidateSegments.java,0,31,0,5,0,36
 druid-master\druid-master\server\src\main\java\org\apache\druid\client\ServerViewUtil.java,0,20,1,7,0,28
 druid-master\druid-master\sql\src\main\java\org\apache\druid\sql\calcite\expression\builtin\ConcatOperatorConversion.java,0,4,0,1,0,5
 druid-master\druid-master\core\src\main\java\org\apache\druid\java\util\metrics\CgroupMemoryMonitor.java,0,28,0,6,1,35
 druid-master\druid-master\extensions-core\kafka-indexing-service\src\main\java\org\apache\druid\indexing\kafka\KafkaDataSourceMetadata.java,0,14,0,8,0,22
 druid-master\druid-master\extensions-core\druid-basic-security\src\main\java\org\apache\druid\security\basic\authentication\db\cache\CoordinatorBasicAuthenticatorCacheNotifier.java,0,28,0,7,0,35
 druid-master\druid-master\extensions-core\avro-extensions\target\generated-test-sources\avro\org\apache\druid\data\input\UnionSubEnum.java,0,10,1,3,0,14
 druid-master\druid-master\processing\src\main\java\org\apache\druid\segment\column\DoublesColumn.java,0,31,0,5,0,36
 druid-master\druid-master\server\src\main\java\org\apache\druid\client\ServerView.java,0,43,0,24,0,67
 druid-master\druid-master\integration-tests\src\test\java\org\apache\druid\tests\query\ITSystemTableQueryTest.java,0,16,0,2,0,18
 druid-master\druid-master\processing\src\test\java\org\apache\druid\query\MetricsEmittingQueryProcessingPoolTest.java,0,16,0,7,0,23
 druid-master\druid-master\server\src\main\java\org\apache\druid\server\coordination\LoadableDataSegment.java,0,19,1,5,0,25
 druid-master\druid-master\processing\src\main\java\org\apache\druid\query\aggregation\StringColumnDoubleBufferAggregatorWrapper.java,0,17,0,4,0,21
 druid-master\druid-master\processing\src\main\java\org\apache\druid\query\aggregation\last\LongLastAggregatorFactory.java,0,102,0,16,0,118
 druid-master\druid-master\processing\src\main\java\org\apache\druid\segment\column\ColumnCapabilitiesImpl.java,0,153,2,34,0,189
 druid-master\druid-master\processing\src\test\java\org\apache\druid\query\dimension\ListFilteredDimensionSpecTest.java,0,26,0,5,0,31
 druid-master\druid-master\server\src\main\java\org\apache\druid\server\coordinator\rules\Rule.java,0,39,0,22,0,61
 druid-master\druid-master\extensions-contrib\cloudfiles-extensions\src\main\java\org\apache\druid\storage\cloudfiles\CloudFilesDataSegmentPuller.java,0,24,2,8,0,34
 druid-master\druid-master\processing\src\main\java\org\apache\druid\query\aggregation\last\DoubleLastAggregator.java,0,20,0,3,0,23
 druid-master\druid-master\processing\src\main\java\org\apache\druid\query\aggregation\any\NumericAnyAggregator.java,0,19,1,2,0,22
 druid-master\druid-master\processing\src\main\java\org\apache\druid\query\aggregation\post\FinalizingFieldAccessPostAggregator.java,0,53,1,5,0,59
 druid-master\druid-master\indexing-service\src\main\java\org\apache\druid\indexing\seekablestream\SeekableStreamIndexTask.java,0,92,5,22,0,119
 druid-master\druid-master\extensions-core\parquet-extensions\src\main\java\org\apache\druid\data\input\parquet\simple\DruidParquetReadSupport.java,0,14,2,7,0,23
 druid-master\druid-master\indexing-hadoop\src\main\java\org\apache\druid\indexer\Bucket.java,0,41,1,5,0,47
 druid-master\druid-master\processing\src\main\java\org\apache\druid\segment\filter\SpatialFilter.java,0,56,0,4,0,60
 druid-master\druid-master\processing\src\main\java\org\apache\druid\query\groupby\having\LessThanHavingSpec.java,0,38,3,5,0,46
 druid-master\druid-master\core\src\main\java\org\apache\druid\math\expr\vector\BivariateFunctionVectorValueProcessor.java,0,32,5,7,1,45
 druid-master\druid-master\extensions-core\avro-extensions\src\main\java\org\apache\druid\data\input\AvroHadoopInputRowParser.java,0,52,0,5,0,57
 druid-master\druid-master\processing\src\main\java\org\apache\druid\segment\column\GenericIndexedBasedComplexColumn.java,0,23,1,4,0,28
 druid-master\druid-master\hll\src\main\java\org\apache\druid\hll\ByteBitLookup.java,0,321,0,1,1,323
 druid-master\druid-master\server\src\test\java\org\apache\druid\server\security\TrustedDomainAuthenticatorTest.java,0,15,0,7,0,22
 druid-master\druid-master\processing\src\main\java\org\apache\druid\query\aggregation\first\StringFirstFoldingAggregatorFactory.java,0,9,0,4,0,13
 druid-master\druid-master\core\src\test\java\org\apache\druid\timeline\SegmentWithOvershadowedStatusTest.java,0,57,3,22,0,82
 druid-master\druid-master\benchmarks\src\test\java\org\apache\druid\benchmark\query\SqlBenchmark.java,0,66,4,41,0,111
 druid-master\druid-master\server\src\main\java\org\apache\druid\client\TimelineServerView.java,0,16,0,12,0,28
 druid-master\druid-master\server\src\main\java\org\apache\druid\client\CoordinatorSegmentWatcherConfig.java,0,5,0,1,0,6
 druid-master\druid-master\extensions-contrib\opentsdb-emitter\src\test\java\org\apache\druid\emitter\opentsdb\OpentsdbEmitterConfigTest.java,0,57,0,20,0,77
 druid-master\druid-master\extensions-contrib\gce-extensions\src\main\java\org\apache\druid\indexing\overlord\autoscaling\gce\GceServiceException.java,0,5,0,1,0,6
 druid-master\druid-master\core\src\main\java\org\apache\druid\java\util\common\parsers\CSVParser.java,0,10,0,1,0,11
 druid-master\druid-master\server\src\main\java\org\apache\druid\server\http\TiersResource.java,0,29,0,11,0,40
 druid-master\druid-master\processing\src\main\java\org\apache\druid\segment\DictionaryEncodedColumnMerger.java,0,206,3,43,0,252
 druid-master\druid-master\server\src\main\java\org\apache\druid\server\coordination\DataSegmentAnnouncerProvider.java,0,4,0,4,0,8
 druid-master\druid-master\core\src\test\java\org\apache\druid\guice\ConditionalMultibindTest.java,0,171,9,41,9,230
 druid-master\druid-master\processing\src\main\java\org\apache\druid\segment\selector\settable\package-info.java,0,1,0,1,0,2
 druid-master\druid-master\processing\src\main\java\org\apache\druid\query\dimension\BaseFilteredDimensionSpec.java,0,24,0,2,0,26
 druid-master\druid-master\processing\src\main\java\org\apache\druid\query\filter\ExpressionDimFilter.java,0,42,0,2,0,44
 druid-master\druid-master\processing\src\test\java\org\apache\druid\segment\join\JoinFilterAnalyzerTest.java,0,294,43,161,0,498
 druid-master\druid-master\processing\src\main\java\org\apache\druid\segment\data\ColumnarLongsSerializer.java,0,4,0,1,0,5
 druid-master\druid-master\sql\src\test\java\org\apache\druid\sql\calcite\DruidPlannerResourceAnalyzeTest.java,0,59,0,33,0,92
 druid-master\druid-master\core\src\test\java\org\apache\druid\collections\ReferenceCountingResourceHolderTest.java,0,36,1,12,2,51
 druid-master\druid-master\core\src\test\java\org\apache\druid\segment\column\ColumnTypeTest.java,0,73,0,55,0,128
 druid-master\druid-master\server\src\main\java\org\apache\druid\server\coordinator\duty\CompactionSegmentIterator.java,0,10,0,8,0,18
 druid-master\druid-master\extensions-core\druid-bloom-filter\src\main\java\org\apache\druid\query\aggregation\bloom\StringBloomFilterAggregator.java,0,12,0,3,0,15
 druid-master\druid-master\processing\src\main\java\org\apache\druid\query\groupby\epinephelinae\package-info.java,0,1,0,1,0,2
 druid-master\druid-master\benchmarks\src\test\java\org\apache\druid\benchmark\RendezvousHasherBenchmark.java,0,18,1,1,0,20
 druid-master\druid-master\extensions-core\s3-extensions\src\main\java\org\apache\druid\storage\s3\S3LoadSpec.java,0,22,0,2,0,24
 druid-master\druid-master\extensions-core\s3-extensions\src\test\java\org\apache\druid\storage\s3\S3DataSegmentPusherTest.java,0,23,0,9,0,32
 druid-master\druid-master\server\src\main\java\org\apache\druid\segment\realtime\appenderator\AppenderatorDriverSegmentLockHelper.java,0,4,0,2,0,6
 druid-master\druid-master\sql\src\main\java\org\apache\druid\sql\calcite\aggregation\builtin\EarliestLatestAnySqlAggregator.java,0,78,0,28,0,106
 druid-master\druid-master\core\src\main\java\org\apache\druid\java\util\common\MappedByteBufferHandler.java,0,10,0,3,1,14
 druid-master\druid-master\indexing-service\src\test\java\org\apache\druid\indexing\common\task\SupervisorTaskAccessWithNullClient.java,0,4,0,2,0,6
 druid-master\druid-master\processing\src\main\java\org\apache\druid\query\groupby\epinephelinae\GroupByQueryEngineV2.java,0,270,3,113,0,386
 druid-master\druid-master\indexing-service\src\main\java\org\apache\druid\indexing\overlord\SpecificSegmentLockRequest.java,0,76,0,2,0,78
 druid-master\druid-master\sql\src\main\java\org\apache\druid\sql\http\ArrayLinesWriter.java,0,25,0,6,0,31
 druid-master\druid-master\extensions-core\kinesis-indexing-service\src\test\java\org\apache\druid\indexing\kinesis\KinesisIndexTaskTest.java,0,673,3,386,0,1062
 druid-master\druid-master\processing\src\main\java\org\apache\druid\segment\DictionaryMergingIterator.java,0,51,0,13,0,64
 druid-master\druid-master\server\src\main\java\org\apache\druid\client\cache\CachePopulatorStats.java,0,40,0,4,0,44
 druid-master\druid-master\extensions-core\druid-kerberos\src\main\java\org\apache\druid\security\kerberos\KerberosEscalator.java,0,22,1,4,0,27
 druid-master\druid-master\processing\src\test\java\org\apache\druid\segment\data\ComparableStringArrayTest.java,0,22,1,12,0,35
 druid-master\druid-master\processing\src\main\java\org\apache\druid\query\timeseries\DefaultTimeseriesQueryMetricsFactory.java,0,7,0,2,0,9
 druid-master\druid-master\services\src\main\java\org\apache\druid\cli\PullDependencies.java,0,173,7,68,0,248
 druid-master\druid-master\core\src\main\java\org\apache\druid\java\util\common\concurrent\ScheduledExecutorFactory.java,0,2,0,1,0,3
 druid-master\druid-master\extensions-core\datasketches\src\main\java\org\apache\druid\query\aggregation\datasketches\quantiles\sql\DoublesSketchObjectSqlAggregator.java,0,19,1,9,0,29
 druid-master\druid-master\server\src\main\java\org\apache\druid\segment\realtime\plumber\RejectionPolicyFactory.java,0,4,0,3,0,7
 druid-master\druid-master\extensions-contrib\moving-average-query\src\main\java\org\apache\druid\query\movingaverage\MovingAverageQuery.java,0,149,0,19,0,168
 druid-master\druid-master\processing\src\main\java\org\apache\druid\query\aggregation\ExpressionLambdaBufferAggregator.java,0,43,0,3,0,46
 druid-master\druid-master\server\src\main\java\org\apache\druid\segment\realtime\appenderator\StreamAppenderatorDriver.java,0,136,1,78,0,215
 druid-master\druid-master\processing\src\main\java\org\apache\druid\query\LookupDataSource.java,0,34,0,3,0,37
 druid-master\druid-master\sql\src\main\java\org\apache\druid\sql\avatica\DruidStatement.java,0,104,8,27,0,139
 druid-master\druid-master\extensions-core\avro-extensions\src\main\java\org\apache\druid\data\input\avro\AvroParseSpec.java,0,16,0,3,0,19
 druid-master\druid-master\indexing-service\src\test\java\org\apache\druid\indexing\common\actions\TaskActionTestKit.java,0,28,0,3,0,31
 druid-master\druid-master\indexing-service\src\main\java\org\apache\druid\indexing\common\index\RealtimeAppenderatorIngestionSpec.java,0,9,0,3,0,12
 druid-master\druid-master\processing\src\test\java\org\apache\druid\segment\join\filter\rewrite\RhsRewriteCandateTest.java,0,3,0,1,0,4
 druid-master\druid-master\core\src\test\java\org\apache\druid\java\util\http\client\FriendlyServersTest.java,0,68,11,26,11,116
 druid-master\druid-master\extensions-core\avro-extensions\src\main\java\org\apache\druid\data\input\avro\AvroValueRecordReader.java,0,7,0,2,0,9
 druid-master\druid-master\processing\src\test\java\org\apache\druid\query\filter\BoundDimFilterTest.java,0,46,0,27,0,73
 druid-master\druid-master\indexing-service\src\main\java\org\apache\druid\indexing\input\DruidSegmentInputEntity.java,0,29,1,3,0,33
 druid-master\druid-master\core\src\test\java\org\apache\druid\math\expr\OutputTypeTest.java,0,176,0,128,0,304
 druid-master\druid-master\core\src\main\java\org\apache\druid\java\util\common\lifecycle\LifecycleStart.java,0,1,0,1,0,2
 druid-master\druid-master\processing\src\main\java\org\apache\druid\segment\transform\TransformingInputSourceReader.java,0,14,0,3,0,17
 druid-master\druid-master\server\src\main\java\org\apache\druid\server\coordinator\CoordinatorOverlordServiceConfig.java,0,17,2,3,0,22
 druid-master\druid-master\server\src\main\java\org\apache\druid\server\coordinator\rules\ForeverLoadRule.java,0,27,0,2,0,29
 druid-master\druid-master\processing\src\main\java\org\apache\druid\segment\writeout\TmpFileSegmentWriteOutMedium.java,0,10,1,2,0,13
 druid-master\druid-master\core\src\main\java\org\apache\druid\indexer\TaskState.java,0,12,0,1,0,13
 druid-master\druid-master\extensions-core\ec2-extensions\src\test\java\org\apache\druid\indexing\overlord\setup\WorkerBehaviorConfigTest.java,0,15,0,2,0,17
 druid-master\druid-master\core\src\main\java\org\apache\druid\initialization\TombstoneDataStorageModule.java,0,11,1,1,1,14
 druid-master\druid-master\server\src\main\java\org\apache\druid\segment\realtime\appenderator\AppenderatorConfig.java,0,18,0,2,0,20
 druid-master\druid-master\core\src\main\java\org\apache\druid\java\util\metrics\cgroups\ProcCgroupDiscoverer.java,0,63,0,16,0,79
 druid-master\druid-master\server\src\test\java\org\apache\druid\server\ConsistentHasherTest.java,0,47,3,13,0,63
 druid-master\druid-master\extensions-contrib\distinctcount\src\main\java\org\apache\druid\query\aggregation\distinctcount\BitMapFactory.java,0,4,0,2,0,6
 druid-master\druid-master\server\src\main\java\org\apache\druid\server\coordinator\DiskNormalizedCostBalancerStrategy.java,0,8,0,4,0,12
 druid-master\druid-master\core\src\main\java\org\apache\druid\timeline\partition\StringPartitionChunk.java,0,50,1,4,0,55
 druid-master\druid-master\sql\src\main\java\org\apache\druid\sql\avatica\DruidAvaticaJsonHandler.java,0,10,0,4,0,14
 druid-master\druid-master\processing\src\test\java\org\apache\druid\query\extraction\TimeFormatExtractionFnTest.java,0,41,0,13,0,54
 druid-master\druid-master\indexing-service\src\main\java\org\apache\druid\indexing\common\SingleFileTaskReportFileWriter.java,0,19,0,2,0,21
 druid-master\druid-master\core\src\main\java\org\apache\druid\collections\DummyNonBlockingPool.java,0,9,0,3,0,12
 druid-master\druid-master\server\src\main\java\org\apache\druid\segment\loading\OmniDataSegmentArchiver.java,0,19,0,3,0,22
 druid-master\druid-master\extensions-core\orc-extensions\src\main\java\org\apache\druid\data\input\orc\OrcStructFlattenerMaker.java,0,30,1,7,0,38
 druid-master\druid-master\processing\src\test\java\org\apache\druid\segment\TestHelper.java,0,140,1,52,0,193
 druid-master\druid-master\processing\src\main\java\org\apache\druid\query\aggregation\SuppressedAggregatorFactory.java,0,211,0,15,0,226
 druid-master\druid-master\server\src\main\java\org\apache\druid\segment\indexing\granularity\GranularitySpec.java,0,14,1,7,0,22
 druid-master\druid-master\extensions-core\avro-extensions\src\main\java\org\apache\druid\data\input\avro\InlineSchemasAvroBytesDecoder.java,0,30,1,8,0,39
 druid-master\druid-master\processing\src\test\java\org\apache\druid\query\metadata\metadata\ColumnAnalysisTest.java,0,26,0,5,0,31
 druid-master\druid-master\extensions-core\datasketches\src\test\java\org\apache\druid\query\aggregation\datasketches\hll\GenerateTestData.java,0,28,1,5,0,34
 druid-master\druid-master\extensions-core\hdfs-storage\src\main\java\org\apache\druid\storage\hdfs\HdfsLoadSpec.java,0,14,0,1,0,15
 druid-master\druid-master\core\src\test\java\org\apache\druid\java\util\common\parsers\FlatTextFormatParserTest.java,0,56,0,15,0,71
 druid-master\druid-master\indexing-service\src\main\java\org\apache\druid\indexing\worker\WorkerCuratorCoordinator.java,0,84,4,14,0,102
 druid-master\druid-master\sql\src\main\java\org\apache\druid\sql\guice\SqlModule.java,0,29,1,11,0,41
 druid-master\druid-master\processing\src\main\java\org\apache\druid\segment\BaseLongColumnValueSelector.java,0,7,0,6,0,13
 druid-master\druid-master\server\src\test\java\org\apache\druid\segment\loading\LocalDataSegmentPullerTest.java,0,15,0,2,0,17
 druid-master\druid-master\processing\src\main\java\org\apache\druid\query\filter\DruidDoublePredicate.java,0,14,0,4,0,18
 druid-master\druid-master\processing\src\main\java\org\apache\druid\query\aggregation\AggregatorAdapters.java,0,108,1,29,0,138
 druid-master\druid-master\services\src\main\java\org\apache\druid\cli\Main.java,0,11,1,6,0,18
 druid-master\druid-master\processing\src\test\java\org\apache\druid\query\aggregation\post\LongGreatestPostAggregatorTest.java,0,14,0,4,0,18
 druid-master\druid-master\processing\src\main\java\org\apache\druid\query\context\DefaultResponseContext.java,0,7,1,1,0,9
 druid-master\druid-master\services\src\main\java\org\apache\druid\cli\PropertyChecker.java,0,5,0,5,0,10
 druid-master\druid-master\extensions-core\kafka-indexing-service\src\main\java\org\apache\druid\data\input\kafkainput\KafkaStringHeaderReader.java,0,16,1,1,0,18
 druid-master\druid-master\benchmarks\src\test\java\org\apache\druid\benchmark\compression\BaseColumnarLongsFromSegmentsBenchmark.java,0,25,0,11,0,36
 druid-master\druid-master\server\src\main\java\org\apache\druid\guice\security\AuthenticatorModule.java,0,9,0,2,0,11
 druid-master\druid-master\server\src\main\java\org\apache\druid\client\cache\CachePopulator.java,0,8,0,7,0,15
 druid-master\druid-master\indexing-service\src\main\java\org\apache\druid\indexing\common\task\batch\parallel\DeepStoragePartitionStat.java,0,43,0,5,0,48
 druid-master\druid-master\indexing-service\src\test\java\org\apache\druid\indexing\common\task\KillUnusedSegmentsTaskTest.java,0,24,0,11,0,35
 druid-master\druid-master\indexing-service\src\main\java\org\apache\druid\indexing\common\TaskToolboxFactory.java,0,122,0,8,0,130
 druid-master\druid-master\core\src\main\java\org\apache\druid\data\input\impl\ByteEntity.java,0,16,0,1,2,19
 druid-master\druid-master\processing\src\test\java\org\apache\druid\query\scan\ScanResultValueTimestampComparatorTest.java,0,29,8,10,0,47
 druid-master\druid-master\server\src\test\java\org\apache\druid\server\QueryDetailsTest.java,0,6,0,2,0,8
 druid-master\druid-master\extensions-core\druid-basic-security\src\main\java\org\apache\druid\security\basic\authorization\db\cache\MetadataStoragePollingBasicAuthorizerCacheManager.java,0,29,2,8,0,39
 druid-master\druid-master\processing\src\test\java\org\apache\druid\query\DruidsTest.java,0,76,0,32,0,108
 druid-master\druid-master\processing\src\main\java\org\apache\druid\query\QueryCapacityExceededException.java,0,38,0,9,0,47
 druid-master\druid-master\indexing-service\src\main\java\org\apache\druid\indexing\common\task\batch\parallel\PartialGenericSegmentMergeParallelIndexTaskRunner.java,0,29,0,6,0,35
 druid-master\druid-master\processing\src\main\java\org\apache\druid\query\groupby\resource\GroupByQueryResource.java,0,23,0,6,0,29
 druid-master\druid-master\server\src\test\java\org\apache\druid\metadata\SqlSegmentsMetadataManagerEmptyTest.java,0,17,0,5,0,22
 druid-master\druid-master\services\src\main\java\org\apache\druid\server\router\TieredBrokerConfig.java,0,25,2,2,0,29
 druid-master\druid-master\processing\src\main\java\org\apache\druid\query\aggregation\hyperloglog\HyperUniquesAggregatorFactory.java,0,110,0,19,0,129
 druid-master\druid-master\processing\src\test\java\org\apache\druid\query\InlineDataSourceTest.java,0,113,20,37,0,170
 druid-master\druid-master\extensions-core\kinesis-indexing-service\src\main\java\org\apache\druid\indexing\kinesis\KinesisRecordSupplier.java,0,322,19,137,0,478
 druid-master\druid-master\sql\src\main\java\org\apache\druid\sql\calcite\rel\Projection.java,0,69,1,35,0,105
 druid-master\druid-master\sql\src\main\java\org\apache\druid\sql\calcite\expression\builtin\LTrimOperatorConversion.java,0,6,0,1,0,7
 druid-master\druid-master\processing\src\test\java\org\apache\druid\segment\filter\FiltersTest.java,0,38,0,5,0,43
 druid-master\druid-master\processing\src\main\java\org\apache\druid\segment\generator\DataGenerator.java,0,56,1,4,0,61
 druid-master\druid-master\extensions-core\s3-extensions\src\main\java\org\apache\druid\storage\s3\ObjectSummaryIterator.java,0,43,1,15,0,59
 druid-master\druid-master\benchmarks\src\test\java\org\apache\druid\benchmark\VarianceBenchmark.java,0,19,2,2,0,23
 druid-master\druid-master\core\src\main\java\org\apache\druid\java\util\common\parsers\NotImplementedMappingProvider.java,0,13,0,3,0,16
 druid-master\druid-master\extensions-core\azure-extensions\src\test\java\org\apache\druid\storage\azure\AzureTaskLogsTest.java,0,152,16,70,0,238
 druid-master\druid-master\sql\src\main\java\org\apache\druid\sql\calcite\aggregation\builtin\MinSqlAggregator.java,0,10,0,5,0,15
 druid-master\druid-master\indexing-service\src\test\java\org\apache\druid\indexing\common\task\batch\parallel\ParallelIndexTuningConfigTest.java,0,66,1,18,0,85
 druid-master\druid-master\extensions-core\datasketches\src\main\java\org\apache\druid\query\aggregation\datasketches\theta\SketchHolderJsonSerializer.java,0,7,0,2,0,9
 druid-master\druid-master\extensions-core\druid-bloom-filter\src\test\java\org\apache\druid\query\aggregation\bloom\BloomFilterAggregatorTest.java,0,184,5,60,0,249
 druid-master\druid-master\extensions-core\datasketches\src\main\java\org\apache\druid\query\aggregation\datasketches\theta\SketchHolder.java,0,94,4,25,0,123
 druid-master\druid-master\indexing-service\src\main\java\org\apache\druid\indexing\common\task\batch\parallel\distribution\StringDistribution.java,0,14,0,7,0,21
 druid-master\druid-master\processing\src\test\java\org\apache\druid\segment\column\ColumnCapabilitiesTest.java,0,16,0,12,0,28
 druid-master\druid-master\processing\src\test\java\org\apache\druid\segment\virtual\ExpressionPlannerTest.java,0,111,0,78,0,189
 druid-master\druid-master\core\src\main\java\org\apache\druid\java\util\common\config\Config.java,0,7,1,2,0,10
 druid-master\druid-master\sql\src\test\java\org\apache\druid\sql\calcite\expression\IPv4AddressParseExpressionTest.java,0,55,3,9,0,67
 druid-master\druid-master\sql\src\main\java\org\apache\druid\sql\calcite\expression\ExtractionFns.java,0,15,1,11,0,27
 druid-master\druid-master\core\src\main\java\org\apache\druid\java\util\common\guava\ConcatSequence.java,0,37,1,5,0,43
 druid-master\druid-master\indexing-service\src\main\java\org\apache\druid\indexing\overlord\config\RemoteTaskRunnerConfig.java,0,79,0,6,0,85
 druid-master\druid-master\server\src\test\java\org\apache\druid\client\cache\CacheConfigTest.java,0,36,4,4,0,44
 druid-master\druid-master\extensions-contrib\graphite-emitter\src\main\java\org\apache\druid\emitter\graphite\WhiteListBasedConverter.java,0,83,5,27,0,115
 druid-master\druid-master\core\src\main\java\org\apache\druid\math\expr\vector\SymmetricalBivariateFunctionVectorProcessor.java,0,7,0,2,0,9
 druid-master\druid-master\server\src\main\java\org\apache\druid\client\HttpServerInventoryView.java,0,171,13,59,0,243
 druid-master\druid-master\server\src\main\java\org\apache\druid\server\security\AllowAllAuthenticator.java,0,29,4,5,0,38
 druid-master\druid-master\server\src\main\java\org\apache\druid\segment\realtime\plumber\CustomVersioningPolicy.java,0,12,0,1,0,13
 druid-master\druid-master\extensions-core\datasketches\src\main\java\org\apache\druid\query\aggregation\datasketches\hll\HllSketchBuildComplexMetricSerde.java,0,4,0,2,0,6
 druid-master\druid-master\extensions-core\datasketches\src\main\java\org\apache\druid\query\aggregation\datasketches\theta\SketchSetPostAggregator.java,0,53,0,3,0,56
 druid-master\druid-master\server\src\main\java\org\apache\druid\segment\indexing\DataSchema.java,0,154,2,32,0,188
 druid-master\druid-master\processing\src\main\java\org\apache\druid\query\DefaultQueryRunnerFactoryConglomerate.java,0,13,0,5,0,18
 druid-master\druid-master\processing\src\main\java\org\apache\druid\query\aggregation\FloatSumBufferAggregator.java,0,12,0,1,0,13
 druid-master\druid-master\indexing-service\src\main\java\org\apache\druid\indexing\overlord\helpers\TaskLogAutoCleaner.java,0,24,1,3,0,28
 druid-master\druid-master\extensions-core\lookups-cached-global\src\test\java\org\apache\druid\query\lookup\namespace\StaticMapExtractionNamespaceTest.java,0,12,0,4,0,16
 druid-master\druid-master\extensions-core\avro-extensions\src\main\java\org\apache\druid\data\input\avro\SchemaRepoBasedAvroBytesDecoder.java,0,36,2,10,0,48
 druid-master\druid-master\core\src\main\java\org\apache\druid\java\util\http\client\io\AppendableByteArrayInputStream.java,0,56,9,6,5,76
 druid-master\druid-master\server\src\main\java\org\apache\druid\client\cache\HybridCache.java,0,45,4,1,0,50
 druid-master\druid-master\processing\src\test\java\org\apache\druid\segment\data\IndexedIntsTest.java,0,11,0,1,0,12
 druid-master\druid-master\processing\src\main\java\org\apache\druid\segment\join\table\IndexedTableColumnSelectorFactory.java,0,28,0,11,0,39
 druid-master\druid-master\indexing-service\src\main\java\org\apache\druid\indexing\worker\shuffle\ShuffleResource.java,0,39,0,15,0,54
 druid-master\druid-master\core\src\test\java\org\apache\druid\timeline\partition\PartitionBoundariesTest.java,0,55,3,8,6,72
 druid-master\druid-master\processing\src\main\java\org\apache\druid\segment\data\Offset.java,0,19,0,12,0,31
 druid-master\druid-master\server\src\main\java\org\apache\druid\server\security\ForbiddenException.java,0,17,0,5,0,22
 druid-master\druid-master\extensions-core\druid-basic-security\src\main\java\org\apache\druid\security\basic\authorization\entity\BasicAuthorizerUserFullSimplifiedPermissions.java,0,24,0,4,0,28
 druid-master\druid-master\indexing-hadoop\src\test\java\org\apache\druid\indexer\HadoopDruidIndexerMapperTest.java,0,51,5,18,0,74
 druid-master\druid-master\processing\src\main\java\org\apache\druid\segment\virtual\ExpressionVectorObjectSelector.java,0,18,0,2,0,20
 druid-master\druid-master\benchmarks\src\test\java\org\apache\druid\benchmark\compression\FloatCompressionBenchmarkFileGenerator.java,0,36,1,11,0,48
 druid-master\druid-master\core\src\main\java\org\apache\druid\tasklogs\TaskLogPusher.java,0,6,1,3,0,10
 druid-master\druid-master\server\src\test\java\org\apache\druid\segment\realtime\appenderator\StreamAppenderatorTest.java,0,441,21,245,0,707
 druid-master\druid-master\indexing-service\src\main\java\org\apache\druid\indexing\common\task\batch\parallel\ParallelIndexSupervisorTask.java,0,526,14,250,0,790
 druid-master\druid-master\core\src\main\java\org\apache\druid\math\expr\ExpressionProcessingModule.java,0,5,0,2,0,7
 druid-master\druid-master\processing\src\test\java\org\apache\druid\collections\bitmap\WrappedBitSetBitmapBitSetTest.java,0,45,0,14,0,59
 druid-master\druid-master\processing\src\main\java\org\apache\druid\query\BadJsonQueryException.java,0,10,0,1,0,11
 druid-master\druid-master\processing\src\main\java\org\apache\druid\query\topn\HistoricalSingleValueDimSelector1SimpleDoubleAggPooledTopNScannerPrototype.java,0,19,0,12,0,31
 druid-master\druid-master\indexing-service\src\test\java\org\apache\druid\indexing\common\task\batch\parallel\PartialDimensionCardinalityTaskTest.java,0,130,0,55,0,185
 druid-master\druid-master\processing\src\test\java\org\apache\druid\segment\RoaringBitmapIndexMergerV9Test.java,0,7,0,1,0,8
 druid-master\druid-master\extensions-core\datasketches\src\main\java\org\apache\druid\query\aggregation\datasketches\hll\HllSketchBuildVectorAggregator.java,0,22,0,9,0,31
 druid-master\druid-master\processing\src\test\java\org\apache\druid\query\filter\vector\VectorMatchTest.java,0,39,1,15,0,55
 druid-master\druid-master\core\src\main\java\org\apache\druid\guice\Binders.java,0,24,1,7,0,32
 druid-master\druid-master\processing\src\main\java\org\apache\druid\query\topn\TopNQueryConfig.java,0,6,0,1,0,7
 druid-master\druid-master\processing\src\main\java\org\apache\druid\query\aggregation\cardinality\CardinalityAggregatorFactory.java,0,109,0,16,0,125
 druid-master\druid-master\core\src\main\java\org\apache\druid\java\util\emitter\factory\NoopEmitterFactory.java,0,11,0,2,0,13
 druid-master\druid-master\server\src\main\java\org\apache\druid\server\audit\AuditManagerProvider.java,0,2,0,1,0,3
 druid-master\druid-master\sql\src\main\java\org\apache\druid\sql\calcite\planner\DruidPlanner.java,0,228,4,119,0,351
 druid-master\druid-master\core\src\main\java\org\apache\druid\data\input\impl\prefetch\ObjectOpenFunction.java,0,6,0,1,0,7
 druid-master\druid-master\processing\src\main\java\org\apache\druid\query\filter\BitmapIndexSelector.java,0,8,0,1,0,9
 druid-master\druid-master\server\src\test\java\org\apache\druid\initialization\ComposingEmitterModuleTest.java,0,21,1,9,0,31
 druid-master\druid-master\processing\src\main\java\org\apache\druid\query\topn\TopNParams.java,0,29,0,2,0,31
 druid-master\druid-master\processing\src\main\java\org\apache\druid\segment\column\ColumnDescriptor.java,0,61,1,6,0,68
 druid-master\druid-master\server\src\main\java\org\apache\druid\server\ResponseContextConfig.java,0,28,1,7,0,36
 druid-master\druid-master\processing\src\main\java\org\apache\druid\segment\incremental\NoopRowIngestionMeters.java,0,19,4,2,0,25
 druid-master\druid-master\extensions-core\druid-basic-security\src\test\java\org\apache\druid\security\authentication\CoordinatorBasicAuthenticatorResourceTest.java,0,77,0,32,0,109
 druid-master\druid-master\indexing-service\src\main\java\org\apache\druid\indexing\common\task\batch\parallel\SupervisorTaskAccess.java,0,15,0,1,0,16
 druid-master\druid-master\services\src\main\java\org\apache\druid\server\router\ManualTieredBrokerSelectorStrategy.java,0,40,0,13,0,53
 druid-master\druid-master\extendedset\src\test\java\org\apache\druid\extendedset\intset\ImmutableConciseSetTest.java,0,391,0,45,0,436
 druid-master\druid-master\extensions-core\lookups-cached-single\src\main\java\org\apache\druid\server\lookup\LoadingLookupFactory.java,0,46,0,6,0,52
 druid-master\druid-master\server\src\main\java\org\apache\druid\client\cache\ForegroundCachePopulator.java,0,27,1,10,0,38
 druid-master\druid-master\server\src\main\java\org\apache\druid\server\security\DefaultTLSCertificateCheckerModule.java,0,8,0,2,0,10
 druid-master\druid-master\indexing-service\src\test\java\org\apache\druid\indexing\common\task\batch\parallel\RangePartitionMultiPhaseParallelIndexingTest.java,0,158,3,66,0,227
 druid-master\druid-master\processing\src\main\java\org\apache\druid\collections\spatial\search\PolygonBound.java,0,68,1,14,0,83
 druid-master\druid-master\extensions-core\s3-extensions\src\main\java\org\apache\druid\data\input\s3\S3InputSource.java,0,110,0,32,0,142
 druid-master\druid-master\core\src\main\java\org\apache\druid\data\input\AbstractInputSource.java,0,21,0,6,0,27
 druid-master\druid-master\core\src\test\java\org\apache\druid\indexer\ChecksTest.java,0,32,0,9,0,41
 druid-master\druid-master\processing\src\test\java\org\apache\druid\segment\join\MapJoinableFactoryTest.java,0,34,0,10,0,44
 druid-master\druid-master\extendedset\src\main\java\org\apache\druid\extendedset\intset\ConciseSet.java,0,396,26,60,0,482
 druid-master\druid-master\extensions-core\s3-extensions\src\test\java\org\apache\druid\storage\s3\S3DataSegmentPullerTest.java,0,35,1,23,0,59
 druid-master\druid-master\sql\src\main\java\org\apache\druid\sql\calcite\aggregation\builtin\SumZeroSqlAggregator.java,0,3,0,1,0,4
 druid-master\druid-master\extensions-core\datasketches\src\test\java\org\apache\druid\query\aggregation\datasketches\tuple\ArrayOfDoublesSketchToStringPostAggregatorTest.java,0,16,0,5,0,21
 druid-master\druid-master\server\src\main\java\org\apache\druid\segment\InlineSegmentWrangler.java,0,8,0,3,0,11
 druid-master\druid-master\sql\src\main\java\org\apache\druid\sql\calcite\rel\Subtotals.java,0,29,3,7,0,39
 druid-master\druid-master\extensions-core\histogram\src\test\java\org\apache\druid\query\aggregation\histogram\ApproximateHistogramFoldingVectorAggregatorTest.java,0,50,0,19,0,69
 druid-master\druid-master\indexing-service\src\test\java\org\apache\druid\indexing\common\actions\SurrogateActionTest.java,0,6,0,4,0,10
 druid-master\druid-master\server\src\main\java\org\apache\druid\server\listener\resource\ListenerResource.java,0,64,0,28,0,92
 druid-master\druid-master\server\src\test\java\org\apache\druid\segment\realtime\appenderator\OpenAndClosedSegmentsAppenderatorTester.java,0,66,2,9,0,77
 druid-master\druid-master\processing\src\main\java\org\apache\druid\query\extraction\BucketExtractionFn.java,0,44,0,1,0,45
 druid-master\druid-master\indexing-service\src\main\java\org\apache\druid\indexing\common\stats\DropwizardRowIngestionMeters.java,0,33,0,3,0,36
 druid-master\druid-master\extensions-core\kinesis-indexing-service\src\test\java\org\apache\druid\indexing\kinesis\KinesisRecordSupplierTest.java,0,400,2,198,0,600
 druid-master\druid-master\extensions-contrib\gce-extensions\src\main\java\org\apache\druid\indexing\overlord\autoscaling\gce\GceUtils.java,0,21,1,6,0,28
 druid-master\druid-master\processing\src\main\java\org\apache\druid\segment\QueryableIndexColumnSelectorFactory.java,0,55,0,20,0,75
 druid-master\druid-master\extensions-core\datasketches\src\main\java\org\apache\druid\query\aggregation\datasketches\theta\sql\ThetaSketchSetUnionOperatorConversion.java,0,4,0,2,0,6
 druid-master\druid-master\server\src\main\java\org\apache\druid\server\coordination\SegmentLoadDropHandler.java,0,284,15,70,0,369
 druid-master\druid-master\processing\src\test\java\org\apache\druid\query\filter\DimFilterUtilsTest.java,0,23,0,8,0,31
 druid-master\druid-master\extensions-contrib\momentsketch\src\main\java\org\apache\druid\query\aggregation\momentsketch\MomentSketchModule.java,0,11,0,8,0,19
 druid-master\druid-master\core\src\test\java\org\apache\druid\data\input\impl\NoopInputFormat.java,0,11,0,2,0,13
 druid-master\druid-master\integration-tests\src\main\java\org\apache\druid\testing\utils\AvroSchemaRegistryEventSerializer.java,0,19,2,1,0,22
 druid-master\druid-master\core\src\test\java\org\apache\druid\utils\ThrowablesTest.java,0,17,4,5,0,26
 druid-master\druid-master\extensions-contrib\materialized-view-selection\src\main\java\org\apache\druid\query\materializedview\MaterializedViewUtils.java,0,24,1,11,0,36
 druid-master\druid-master\sql\src\test\java\org\apache\druid\sql\calcite\schema\DruidSchemaNoDataInitTest.java,0,7,1,3,0,11
 druid-master\druid-master\core\src\main\java\org\apache\druid\java\util\common\guava\Accumulator.java,0,5,2,1,0,8
 druid-master\druid-master\processing\src\test\java\org\apache\druid\guice\ExtensionsConfigTest.java,0,15,0,8,0,23
 druid-master\druid-master\indexing-service\src\test\java\org\apache\druid\indexing\input\DruidSegmentReaderTest.java,0,77,1,12,0,90
 druid-master\druid-master\processing\src\main\java\org\apache\druid\query\aggregation\FloatMinBufferAggregator.java,0,12,0,1,0,13
 druid-master\druid-master\processing\src\main\java\org\apache\druid\query\BySegmentSkippingQueryRunner.java,0,14,0,3,0,17
 druid-master\druid-master\server\src\main\java\org\apache\druid\metadata\NoopMetadataStorageProvider.java,0,5,0,1,0,6
 druid-master\druid-master\server\src\main\java\org\apache\druid\server\QueryStats.java,0,15,0,1,0,16
 druid-master\druid-master\server\src\main\java\org\apache\druid\client\cache\MemcachedCacheConfig.java,0,51,0,4,0,55
 druid-master\druid-master\core\src\test\java\org\apache\druid\utils\CircularBufferTest.java,0,27,0,1,0,28
 druid-master\druid-master\extensions-core\simple-client-sslcontext\src\main\java\org\apache\druid\https\SSLClientConfig.java,0,63,0,2,0,65
 druid-master\druid-master\processing\src\test\java\org\apache\druid\segment\virtual\ListFilteredVirtualColumnTest.java,0,13,0,6,0,19
 druid-master\druid-master\extensions-core\druid-basic-security\src\main\java\org\apache\druid\security\basic\authorization\db\updater\CoordinatorBasicAuthorizerMetadataStorageUpdater.java,0,422,4,173,0,599
 druid-master\druid-master\core\src\main\java\org\apache\druid\guice\DruidScopes.java,0,8,0,1,0,9
 druid-master\druid-master\extensions-core\histogram\src\test\java\org\apache\druid\query\aggregation\histogram\sql\FixedBucketsHistogramQuantileSqlAggregatorTest.java,0,160,0,58,0,218
 druid-master\druid-master\integration-tests\src\test\java\org\apache\druid\tests\indexer\ITLocalInputSourceAllInputFormatTest.java,0,26,0,12,0,38
 druid-master\druid-master\processing\src\test\java\org\apache\druid\query\filter\OrDimFilterTest.java,0,12,0,2,0,14
 druid-master\druid-master\processing\src\main\java\org\apache\druid\query\topn\TopNQueryRunnerFactory.java,0,30,0,7,0,37
 druid-master\druid-master\extensions-core\histogram\src\test\java\org\apache\druid\query\aggregation\histogram\ApproximateHistogramAggregationTest.java,0,62,0,26,0,88
 druid-master\druid-master\server\src\main\java\org\apache\druid\client\indexing\IndexingTotalWorkerCapacityInfo.java,0,19,0,6,0,25
 druid-master\druid-master\processing\src\main\java\org\apache\druid\segment\writeout\OffHeapMemorySegmentWriteOutMedium.java,0,9,0,4,0,13
 druid-master\druid-master\core\src\main\java\org\apache\druid\data\input\MaxSizeSplitHintSpec.java,0,51,1,16,0,68
 druid-master\druid-master\benchmarks\src\test\java\org\apache\druid\benchmark\ExpressionSelectorBenchmark.java,0,80,1,27,0,108
 druid-master\druid-master\processing\src\main\java\org\apache\druid\query\Druids.java,0,482,0,23,0,505
 druid-master\druid-master\extensions-core\kafka-indexing-service\src\main\java\org\apache\druid\indexing\kafka\supervisor\KafkaSupervisorReportPayload.java,0,41,0,6,0,47
 druid-master\druid-master\processing\src\test\java\org\apache\druid\query\metadata\SegmentAnalyzerTest.java,0,107,3,35,0,145
 druid-master\druid-master\server\src\main\java\org\apache\druid\client\cache\CacheStats.java,0,58,0,1,0,59
 druid-master\druid-master\server\src\main\java\org\apache\druid\query\lookup\LookupSerdeModule.java,0,20,0,11,0,31
 druid-master\druid-master\processing\src\test\java\org\apache\druid\query\groupby\GroupByQueryQueryToolChestTest.java,0,176,0,102,0,278
 druid-master\druid-master\integration-tests\src\main\java\org\apache\druid\testing\clients\TaskResponseObject.java,0,28,2,1,0,31
 druid-master\druid-master\core\src\main\java\org\apache\druid\utils\JvmUtils.java,0,35,1,10,0,46
 druid-master\druid-master\server\src\test\java\org\apache\druid\query\lookup\LookupSerdeModuleTest.java,0,21,0,9,0,30
 druid-master\druid-master\server\src\main\java\org\apache\druid\query\lookup\LookupReferencesManager.java,0,226,19,87,0,332
 druid-master\druid-master\processing\src\main\java\org\apache\druid\query\expression\TimestampCeilExprMacro.java,0,32,0,5,0,37
 druid-master\druid-master\server\src\main\java\org\apache\druid\curator\discovery\DiscoveryModule.java,0,156,6,29,0,191
 druid-master\druid-master\server\src\main\java\org\apache\druid\guice\MetadataConfigModule.java,0,8,0,5,0,13
 druid-master\druid-master\server\src\main\java\org\apache\druid\metadata\SegmentPublisherProvider.java,0,3,0,3,0,6
 druid-master\druid-master\extensions-contrib\moving-average-query\src\main\java\org\apache\druid\query\movingaverage\DefaultMovingAverageQueryMetricsFactory.java,0,7,0,2,0,9
 druid-master\druid-master\server\src\main\java\org\apache\druid\metadata\SqlSegmentsMetadataManagerProvider.java,0,24,1,2,0,27
 druid-master\druid-master\core\src\main\java\org\apache\druid\segment\column\TypeDescriptor.java,0,14,0,10,0,24
 druid-master\druid-master\indexing-service\src\test\java\org\apache\druid\indexing\overlord\TaskLockBoxConcurrencyTest.java,0,45,0,17,0,62
 druid-master\druid-master\server\src\test\java\org\apache\druid\server\emitter\EmitterModuleTest.java,0,26,0,14,0,40
 druid-master\druid-master\core\src\test\java\org\apache\druid\java\util\metrics\cgroups\MemoryTest.java,0,42,2,3,1,48
 druid-master\druid-master\extensions-core\druid-basic-security\src\main\java\org\apache\druid\security\basic\BasicSecuritySSLSocketFactory.java,0,44,1,6,0,51
 druid-master\druid-master\server\src\test\java\org\apache\druid\server\lookup\cache\LookupNodeDiscoveryTest.java,0,21,0,6,0,27
 druid-master\druid-master\server\src\test\java\org\apache\druid\segment\InlineSegmentWranglerTest.java,0,13,2,3,0,18
 druid-master\druid-master\server\src\main\java\org\apache\druid\metadata\storage\derby\DerbyMetadataStorageProvider.java,0,7,0,1,0,8
 druid-master\druid-master\core\src\main\java\org\apache\druid\math\expr\vector\ExprEvalDoubleVector.java,0,10,0,1,0,11
 druid-master\druid-master\processing\src\main\java\org\apache\druid\segment\join\table\SortedIntIntersectionIterator.java,0,14,0,3,0,17
 druid-master\druid-master\indexing-service\src\main\java\org\apache\druid\indexing\overlord\ForkingTaskRunnerFactory.java,0,25,0,3,0,28
 druid-master\druid-master\processing\src\test\java\org\apache\druid\query\TimewarpOperatorTest.java,0,68,0,19,0,87
 druid-master\druid-master\processing\src\main\java\org\apache\druid\segment\data\ArrayBasedIndexedInts.java,0,36,0,4,0,40
 druid-master\druid-master\extensions-core\lookups-cached-global\src\test\java\org\apache\druid\server\lookup\namespace\cache\JdbcExtractionNamespaceTest.java,0,115,6,30,0,151
 druid-master\druid-master\core\src\main\java\org\apache\druid\java\util\common\lifecycle\Lifecycle.java,0,183,3,54,0,240
 druid-master\druid-master\processing\src\main\java\org\apache\druid\segment\filter\AndFilter.java,0,74,4,17,0,95
 druid-master\druid-master\integration-tests\src\main\java\org\apache\druid\testing\clients\CoordinatorResourceTestClient.java,0,124,4,26,0,154
 druid-master\druid-master\extensions-core\kubernetes-extensions\src\test\java\org\apache\druid\k8s\discovery\K8sDruidLeaderSelectorTest.java,0,50,3,9,0,62
 druid-master\druid-master\integration-tests\src\test\java\org\apache\druid\tests\coordinator\duty\ITAutoCompactionUpgradeTest.java,0,22,4,13,0,39
 druid-master\druid-master\core\src\main\java\org\apache\druid\java\util\common\io\smoosh\SmooshedFileMapper.java,0,34,3,9,0,46
 druid-master\druid-master\processing\src\test\java\org\apache\druid\query\dimension\RegexFilteredDimensionSpecTest.java,0,9,0,3,0,12
 druid-master\druid-master\sql\src\main\java\org\apache\druid\sql\calcite\schema\NamedViewSchema.java,0,14,0,1,0,15
 druid-master\druid-master\benchmarks\src\test\java\org\apache\druid\benchmark\query\CachingClusteredClientBenchmark.java,0,138,2,39,0,179
 druid-master\druid-master\extensions-core\lookups-cached-single\src\main\java\org\apache\druid\server\lookup\cache\polling\OnHeapPollingCache.java,0,17,0,2,0,19
 druid-master\druid-master\sql\src\main\java\org\apache\druid\sql\calcite\expression\DruidExpression.java,0,208,0,55,0,263
 druid-master\druid-master\extensions-core\kubernetes-extensions\src\main\java\org\apache\druid\k8s\discovery\PodInfo.java,0,20,0,3,0,23
 druid-master\druid-master\processing\src\test\java\org\apache\druid\query\filter\AndDimFilterTest.java,0,16,0,3,0,19
 druid-master\druid-master\extensions-contrib\distinctcount\src\test\java\org\apache\druid\query\aggregation\distinctcount\DistinctCountTopNQueryTest.java,0,20,2,5,0,27
 druid-master\druid-master\indexing-service\src\main\java\org\apache\druid\indexing\firehose\IngestSegmentFirehoseFactory.java,0,112,2,30,0,144
 druid-master\druid-master\core\src\main\java\org\apache\druid\data\input\impl\prefetch\OpenObject.java,0,31,0,7,0,38
 druid-master\druid-master\processing\src\test\java\org\apache\druid\collections\bitmap\BitmapOperationTestBase.java,0,79,0,23,0,102
 druid-master\druid-master\processing\src\main\java\org\apache\druid\query\datasourcemetadata\DataSourceMetadataResultValue.java,0,18,1,1,0,20
 druid-master\druid-master\core\src\test\java\org\apache\druid\java\util\common\parsers\ParserUtilsTest.java,0,8,0,4,0,12
 druid-master\druid-master\indexing-service\src\main\java\org\apache\druid\indexing\common\actions\SegmentTransactionalInsertAction.java,0,111,1,46,0,158
 druid-master\druid-master\processing\src\main\java\org\apache\druid\query\lookup\LookupExtractor.java,0,31,0,17,0,48
 druid-master\druid-master\processing\src\main\java\org\apache\druid\segment\data\GenericIndexed.java,0,231,3,63,0,297
 druid-master\druid-master\extensions-contrib\aliyun-oss-extensions\src\test\java\org\apache\druid\storage\aliyun\OssDataSegmentPullerTest.java,0,23,0,16,0,39
 druid-master\druid-master\server\src\main\java\org\apache\druid\curator\discovery\ServiceAnnouncer.java,0,10,2,3,0,15
 druid-master\druid-master\core\src\test\java\org\apache\druid\java\util\metrics\JvmPidDiscovererTest.java,0,3,0,1,0,4
 druid-master\druid-master\server\src\main\java\org\apache\druid\server\emitter\EmitterModule.java,0,42,0,10,0,52
 druid-master\druid-master\sql\src\main\java\org\apache\druid\sql\calcite\expression\builtin\LeastOperatorConversion.java,0,6,0,1,0,7
 druid-master\druid-master\extensions-contrib\kafka-emitter\src\main\java\org\apache\druid\emitter\kafka\KafkaEmitter.java,0,75,2,18,0,95
 druid-master\druid-master\extensions-contrib\moving-average-query\src\test\java\org\apache\druid\query\movingaverage\averagers\BaseAveragerTest.java,0,47,0,16,0,63
 druid-master\druid-master\processing\src\main\java\org\apache\druid\query\DefaultQueryConfig.java,0,14,0,7,0,21
 druid-master\druid-master\server\src\test\java\org\apache\druid\server\coordinator\rules\IntervalLoadRuleTest.java,0,15,0,9,0,24
 druid-master\druid-master\sql\src\main\java\org\apache\druid\sql\calcite\external\ExternalTableMacro.java,0,33,0,6,0,39
 druid-master\druid-master\indexing-hadoop\src\test\java\org\apache\druid\indexer\updater\MetadataStorageUpdaterJobSpecTest.java,0,22,0,3,0,25
 druid-master\druid-master\extensions-contrib\ambari-metrics-emitter\src\test\java\org\apache\druid\emitter\ambari\metrics\DruidToWhiteListBasedConverterTest.java,0,4,0,2,0,6
 druid-master\druid-master\sql\src\main\java\org\apache\druid\sql\calcite\aggregation\Aggregations.java,0,18,2,13,0,33
 druid-master\druid-master\processing\src\main\java\org\apache\druid\query\topn\DimValHolder.java,0,64,0,8,0,72
 druid-master\druid-master\processing\src\main\java\org\apache\druid\query\expression\TrimExprMacro.java,0,98,1,13,0,112
 druid-master\druid-master\processing\src\test\java\org\apache\druid\query\timeseries\TimeSeriesUnionQueryRunnerTest.java,0,45,0,12,0,57
 druid-master\druid-master\server\src\test\java\org\apache\druid\server\http\CoordinatorRedirectInfoTest.java,0,21,0,9,0,30
 druid-master\druid-master\indexing-hadoop\src\test\java\org\apache\druid\indexer\HadoopDruidIndexerJobTest.java,0,13,2,9,0,24
 druid-master\druid-master\core\src\main\java\org\apache\druid\segment\loading\DataSegmentArchiver.java,0,8,0,6,0,14
 druid-master\druid-master\processing\src\main\java\org\apache\druid\query\topn\Historical1SimpleDoubleAggPooledTopNScannerPrototype.java,0,16,0,8,0,24
 druid-master\druid-master\processing\src\main\java\org\apache\druid\segment\join\filter\JoinableClauses.java,0,30,1,7,0,38
 druid-master\druid-master\indexing-service\src\main\java\org\apache\druid\indexing\common\actions\TimeChunkLockTryAcquireAction.java,0,32,0,4,0,36
 druid-master\druid-master\processing\src\main\java\org\apache\druid\segment\join\filter\JoinFilterAnalyzer.java,0,121,1,87,0,209
 druid-master\druid-master\server\src\test\java\org\apache\druid\server\AsyncManagementForwardingServletTest.java,0,146,15,56,0,217
 druid-master\druid-master\indexing-service\src\main\java\org\apache\druid\indexing\common\TimeChunkLock.java,0,88,0,3,0,91
 druid-master\druid-master\processing\src\main\java\org\apache\druid\query\aggregation\Histogram.java,0,67,2,4,0,73
 druid-master\druid-master\processing\src\main\java\org\apache\druid\query\expression\GuiceExprMacroTable.java,0,3,0,1,0,4
 druid-master\druid-master\extensions-core\google-extensions\src\main\java\org\apache\druid\storage\google\GoogleTaskLogs.java,0,58,5,11,0,74
 druid-master\druid-master\extensions-core\druid-basic-security\src\test\java\org\apache\druid\security\authorization\NoopBasicAuthorizerCacheNotifier.java,0,9,2,4,0,15
 druid-master\druid-master\processing\src\test\java\org\apache\druid\segment\incremental\IncrementalIndexIngestionTest.java,0,32,0,6,0,38
 druid-master\druid-master\processing\src\main\java\org\apache\druid\query\aggregation\post\PostAggregatorIds.java,0,35,0,1,0,36
 druid-master\druid-master\sql\src\main\java\org\apache\druid\sql\calcite\filtration\ConvertSelectorsToIns.java,0,18,1,10,0,29
 druid-master\druid-master\indexing-service\src\main\java\org\apache\druid\indexing\common\task\SupervisorTaskCoordinatingSegmentAllocator.java,0,22,0,7,0,29
 druid-master\druid-master\server\src\test\java\org\apache\druid\server\coordination\SegmentChangeRequestLoadTest.java,0,9,0,6,0,15
 druid-master\druid-master\core\src\main\java\org\apache\druid\data\input\impl\TimeAndDimsParseSpec.java,0,20,0,2,1,23
 druid-master\druid-master\extensions-core\kafka-indexing-service\src\main\java\org\apache\druid\data\input\kafkainput\KafkaInputReader.java,0,64,4,26,0,94
 druid-master\druid-master\sql\src\main\java\org\apache\druid\sql\calcite\planner\PlannerFactory.java,0,59,0,12,0,71
 druid-master\druid-master\extensions-contrib\aliyun-oss-extensions\src\test\java\org\apache\druid\storage\aliyun\OssDataSegmentPusherTest.java,0,20,0,6,0,26
 druid-master\druid-master\indexing-service\src\main\java\org\apache\druid\indexing\common\task\batch\parallel\iterator\DefaultIndexTaskInputRowIteratorBuilder.java,0,29,0,12,0,41
 druid-master\druid-master\processing\src\test\java\org\apache\druid\query\filter\ExtractionDimFilterTest.java,0,6,0,4,0,10
 druid-master\druid-master\indexing-hadoop\src\test\java\org\apache\druid\indexer\IndexGeneratorCombinerTest.java,0,42,0,23,0,65
 druid-master\druid-master\benchmarks\src\test\java\org\apache\druid\benchmark\compression\ColumnarLongsSelectRowsFromSegmentBenchmark.java,0,29,1,7,0,37
 druid-master\druid-master\core\src\main\java\org\apache\druid\timeline\partition\HashPartitioner.java,0,24,0,8,0,32
 druid-master\druid-master\core\src\test\java\org\apache\druid\common\utils\ServletResourceUtilsTest.java,0,8,0,4,1,13
 druid-master\druid-master\indexing-service\src\test\java\org\apache\druid\indexing\overlord\sampler\SamplerResponseTest.java,0,13,0,4,0,17
 druid-master\druid-master\core\src\main\java\org\apache\druid\java\util\common\collect\Utils.java,0,23,1,3,0,27
 druid-master\druid-master\sql\src\test\java\org\apache\druid\sql\calcite\util\CalciteTests.java,0,282,5,100,0,387
 druid-master\druid-master\core\src\main\java\org\apache\druid\data\input\impl\prefetch\PrefetchableTextFilesFirehoseFactory.java,0,104,3,36,0,143
 druid-master\druid-master\processing\src\main\java\org\apache\druid\query\aggregation\GroupingAggregatorFactory.java,0,133,0,39,0,172
 druid-master\druid-master\server\src\main\java\org\apache\druid\server\http\CoordinatorCompactionConfigsResource.java,0,68,2,22,0,92
 druid-master\druid-master\indexing-hadoop\src\main\java\org\apache\druid\indexer\DeterminePartitionsJob.java,0,267,18,99,0,384
 druid-master\druid-master\processing\src\test\java\org\apache\druid\query\topn\DefaultTopNQueryMetricsTest.java,0,14,0,9,0,23
 druid-master\druid-master\extensions-core\stats\src\main\java\org\apache\druid\query\aggregation\variance\StandardDeviationPostAggregator.java,0,54,1,3,0,58
 druid-master\druid-master\processing\src\main\java\org\apache\druid\query\monomorphicprocessing\SpecializationService.java,0,149,1,61,0,211
 druid-master\druid-master\processing\src\main\java\org\apache\druid\segment\column\ComplexColumn.java,0,22,0,10,0,32
 druid-master\druid-master\processing\src\test\java\org\apache\druid\segment\V9IndexLoaderTest.java,0,34,2,8,0,44
 druid-master\druid-master\core\src\main\java\org\apache\druid\timeline\DataSegment.java,0,321,1,34,6,362
 druid-master\druid-master\processing\src\main\java\org\apache\druid\query\filter\vector\BaseVectorValueMatcher.java,0,10,0,1,0,11
 druid-master\druid-master\indexing-service\src\main\java\org\apache\druid\indexing\overlord\LockResult.java,0,38,0,6,0,44
 druid-master\druid-master\core\src\main\java\org\apache\druid\timeline\partition\OvershadowableManager.java,0,440,7,225,0,672
 druid-master\druid-master\server\src\test\java\org\apache\druid\segment\indexing\DataSchemaTest.java,0,119,4,80,0,203
 druid-master\druid-master\processing\src\test\java\org\apache\druid\query\groupby\GroupByLimitPushDownInsufficientBufferTest.java,0,133,2,27,0,162
 druid-master\druid-master\sql\src\main\java\org\apache\druid\sql\avatica\AvaticaMonitor.java,0,46,1,8,0,55
 druid-master\druid-master\processing\src\main\java\org\apache\druid\query\groupby\epinephelinae\StreamingMergeSortedGrouper.java,0,146,5,77,0,228
 druid-master\druid-master\server\src\main\java\org\apache\druid\client\selector\ServerSelector.java,0,58,0,7,0,65
 druid-master\druid-master\server\src\test\java\org\apache\druid\server\coordinator\rules\BroadcastDistributionRuleTest.java,0,56,0,12,0,68
 druid-master\druid-master\processing\src\test\java\org\apache\druid\query\topn\TopNBinaryFnTest.java,0,80,0,6,0,86
 druid-master\druid-master\benchmarks\src\test\java\org\apache\druid\benchmark\indexing\StringDimensionIndexerBenchmark.java,0,23,1,2,0,26
 druid-master\druid-master\server\src\test\java\org\apache\druid\segment\loading\LocalDataSegmentPusherTest.java,0,47,0,17,0,64
 druid-master\druid-master\processing\src\test\java\org\apache\druid\query\groupby\epinephelinae\ParallelCombinerTest.java,0,29,1,10,0,40
 druid-master\druid-master\processing\src\main\java\org\apache\druid\segment\loading\TombstoneSegmentizerFactory.java,0,31,3,4,0,38
 druid-master\druid-master\processing\src\main\java\org\apache\druid\query\aggregation\first\LongFirstAggregator.java,0,19,0,3,0,22
 druid-master\druid-master\server\src\main\java\org\apache\druid\client\selector\LowestPriorityTierSelectorStrategy.java,0,8,0,3,0,11
 druid-master\druid-master\extensions-contrib\opentsdb-emitter\src\main\java\org\apache\druid\emitter\opentsdb\OpentsdbEmitterModule.java,0,13,0,2,0,15
 druid-master\druid-master\core\src\test\java\org\apache\druid\data\input\impl\TimeAndDimsParseSpecTest.java,0,7,0,2,0,9
 druid-master\druid-master\server\src\main\java\org\apache\druid\segment\loading\LocalDataSegmentPusherConfig.java,0,6,0,1,0,7
 druid-master\druid-master\indexing-service\src\main\java\org\apache\druid\indexing\overlord\TaskQueue.java,0,194,12,74,0,280
 druid-master\druid-master\server\src\main\java\org\apache\druid\server\coordinator\rules\PeriodBroadcastDistributionRule.java,0,35,0,3,0,38
 druid-master\druid-master\server\src\main\java\org\apache\druid\segment\indexing\RealtimeTuningConfig.java,0,163,0,27,0,190
 druid-master\druid-master\indexing-service\src\main\java\org\apache\druid\indexing\seekablestream\StreamChunkParser.java,0,47,1,8,0,56
 druid-master\druid-master\core\src\main\java\org\apache\druid\math\expr\vector\LongOutStringInFunctionVectorProcessor.java,0,12,0,4,0,16
 druid-master\druid-master\core\src\main\java\org\apache\druid\math\expr\vector\DoubleOutDoublesInFunctionVectorValueProcessor.java,0,16,0,2,0,18
 druid-master\druid-master\extensions-contrib\moving-average-query\src\test\java\org\apache\druid\query\movingaverage\averagers\DoubleMinAveragerFactoryTest.java,0,6,0,3,0,9
 druid-master\druid-master\server\src\main\java\org\apache\druid\curator\CuratorModule.java,0,53,1,17,0,71
 druid-master\druid-master\core\src\test\java\org\apache\druid\concurrent\LifecycleLockTest.java,0,29,0,1,0,30
 druid-master\druid-master\processing\src\test\java\org\apache\druid\query\lookup\LookupsStateTest.java,0,7,0,4,0,11
 druid-master\druid-master\server\src\main\java\org\apache\druid\server\http\RedirectFilter.java,0,20,3,4,0,27
 druid-master\druid-master\core\src\main\java\org\apache\druid\java\util\common\guava\ParallelMergeCombiningSequence.java,0,539,14,153,6,712
 druid-master\druid-master\processing\src\main\java\org\apache\druid\segment\column\DoublesColumnWithNulls.java,0,16,0,3,0,19
 druid-master\druid-master\core\src\main\java\org\apache\druid\metadata\DynamicConfigProvider.java,0,7,0,5,0,12
 druid-master\druid-master\server\src\main\java\org\apache\druid\metadata\MetadataSegmentPublisher.java,0,1,0,1,0,2
 druid-master\druid-master\indexing-hadoop\src\main\java\org\apache\druid\indexer\IndexingHadoopModule.java,0,6,1,2,0,9
 druid-master\druid-master\extensions-core\druid-basic-security\src\main\java\org\apache\druid\security\basic\BasicSecurityAuthenticationException.java,0,14,0,5,0,19
 druid-master\druid-master\core\src\test\java\org\apache\druid\segment\loading\NoopDataSegmentArchiver.java,0,8,0,1,0,9
 druid-master\druid-master\extensions-core\druid-aws-rds-extensions\src\main\java\org\apache\druid\aws\rds\AWSRDSTokenPasswordProvider.java,0,40,1,7,0,48
 druid-master\druid-master\sql\src\main\java\org\apache\druid\sql\calcite\rule\SortCollapseRule.java,0,11,0,4,0,15
 druid-master\druid-master\indexing-hadoop\src\main\java\org\apache\druid\indexer\hadoop\DatasourceInputSplit.java,0,29,2,4,0,35
 druid-master\druid-master\processing\src\main\java\org\apache\druid\segment\virtual\SingleStringInputDeferredEvaluationExpressionDimensionVectorSelector.java,0,53,0,15,0,68
 druid-master\druid-master\extensions-core\lookups-cached-single\src\main\java\org\apache\druid\server\lookup\jdbc\KeyValueResultSetMapper.java,0,17,0,4,0,21
 druid-master\druid-master\server\src\main\java\org\apache\druid\client\HttpServerInventoryViewProvider.java,0,11,0,2,0,13
 druid-master\druid-master\server\src\main\java\org\apache\druid\segment\join\LookupJoinableFactory.java,0,15,0,5,0,20
 druid-master\druid-master\processing\src\main\java\org\apache\druid\segment\incremental\IncrementalIndexRowIterator.java,0,31,0,13,0,44
 druid-master\druid-master\extensions-core\kafka-indexing-service\src\main\java\org\apache\druid\data\input\kafkainput\KafkaStringHeaderFormat.java,0,19,0,2,0,21
 druid-master\druid-master\core\src\main\java\org\apache\druid\java\util\emitter\core\HttpEmitterConfig.java,0,61,1,2,1,65
 druid-master\druid-master\server\src\main\java\org\apache\druid\client\BatchServerInventoryViewProvider.java,0,7,0,2,0,9
 druid-master\druid-master\core\src\test\java\org\apache\druid\common\guava\GuavaUtilsTest.java,0,24,1,10,1,36
 druid-master\druid-master\extensions-core\lookups-cached-global\src\test\java\org\apache\druid\server\lookup\namespace\UriCacheGeneratorTest.java,0,98,0,18,0,116
 druid-master\druid-master\indexing-service\src\main\java\org\apache\druid\indexing\overlord\TaskStorage.java,0,18,0,15,0,33
 druid-master\druid-master\server\src\main\java\org\apache\druid\curator\discovery\CuratorDruidNodeAnnouncer.java,0,31,0,6,0,37
 druid-master\druid-master\server\src\main\java\org\apache\druid\guice\http\JettyHttpClientModule.java,0,36,1,11,0,48
 druid-master\druid-master\server\src\main\java\org\apache\druid\server\coordinator\RandomBalancerStrategy.java,0,26,2,10,0,38
 druid-master\druid-master\processing\src\main\java\org\apache\druid\query\ResultGranularTimestampComparator.java,0,18,0,5,0,23
 druid-master\druid-master\processing\src\main\java\org\apache\druid\query\expression\RegexpLikeExprMacro.java,0,21,0,6,0,27
 druid-master\druid-master\server\src\test\java\org\apache\druid\query\lookup\LookupReferencesManagerTest.java,0,130,1,62,0,193
 druid-master\druid-master\indexing-service\src\test\java\org\apache\druid\indexing\overlord\autoscaling\SimpleProvisioningStrategyTest.java,0,81,0,32,0,113
 druid-master\druid-master\server\src\main\java\org\apache\druid\server\coordinator\rules\PeriodLoadRule.java,0,39,1,4,0,44
 druid-master\druid-master\processing\src\test\java\org\apache\druid\segment\incremental\SimpleRowIngestionMeters.java,0,26,0,2,0,28
 druid-master\druid-master\processing\src\main\java\org\apache\druid\query\topn\Historical1AggPooledTopNScanner.java,0,9,3,4,0,16
 druid-master\druid-master\core\src\main\java\org\apache\druid\java\util\RetryableException.java,0,11,0,5,0,16
 druid-master\druid-master\processing\src\test\java\org\apache\druid\query\groupby\GroupByLimitPushDownMultiNodeMergeTest.java,0,238,2,41,0,281
 druid-master\druid-master\processing\src\test\java\org\apache\druid\segment\filter\DimensionPredicateFilterTest.java,0,6,0,2,0,8
 druid-master\druid-master\sql\src\main\java\org\apache\druid\sql\calcite\planner\SqlResourceCollectorShuttle.java,0,29,0,10,0,39
 druid-master\druid-master\core\src\main\java\org\apache\druid\java\util\common\concurrent\Execs.java,0,65,1,17,0,83
 druid-master\druid-master\extensions-core\avro-extensions\src\main\java\org\apache\druid\data\input\schemarepo\SubjectAndIdConverter.java,0,17,2,12,0,31
 druid-master\druid-master\indexing-service\src\main\java\org\apache\druid\indexing\common\task\batch\parallel\SinglePhaseParallelIndexTaskRunner.java,0,100,0,47,0,147
 druid-master\druid-master\processing\src\main\java\org\apache\druid\segment\join\filter\JoinFilterCorrelations.java,0,122,4,80,0,206
 druid-master\druid-master\processing\src\test\java\org\apache\druid\segment\data\NumericNullColumnSelectorTest.java,0,90,7,24,0,121
 druid-master\druid-master\integration-tests\src\test\java\org\apache\druid\tests\TestNGGroup.java,0,76,0,48,0,124
 druid-master\druid-master\processing\src\main\java\org\apache\druid\segment\writeout\OffHeapMemorySegmentWriteOutMediumFactory.java,0,9,1,2,0,12
 druid-master\druid-master\extensions-contrib\influxdb-emitter\src\test\java\org\apache\druid\emitter\influxdb\InfluxdbEmitterConfigTest.java,0,98,4,19,0,121
 druid-master\druid-master\extensions-core\druid-basic-security\src\main\java\org\apache\druid\security\basic\authentication\BasicHTTPAuthenticator.java,0,76,7,27,0,110
 druid-master\druid-master\core\src\main\java\org\apache\druid\java\util\common\guava\DroppingIterator.java,0,17,0,1,1,19
 druid-master\druid-master\core\src\main\java\org\apache\druid\common\utils\PropUtils.java,0,18,1,3,0,22
 druid-master\druid-master\server\src\main\java\org\apache\druid\server\coordination\NoopDataSegmentAnnouncer.java,0,9,4,1,0,14
 druid-master\druid-master\server\src\test\java\org\apache\druid\segment\realtime\FireDepartmentMetricsTest.java,0,26,0,2,0,28
 druid-master\druid-master\server\src\test\java\org\apache\druid\server\coordinator\duty\CompactSegmentsTest.java,0,608,6,292,0,906
 druid-master\druid-master\extensions-contrib\moving-average-query\src\main\java\org\apache\druid\query\movingaverage\averagers\DoubleSumAverager.java,0,10,1,2,0,13
 druid-master\druid-master\integration-tests\src\test\java\org\apache\druid\tests\query\ITTwitterQueryTest.java,0,13,0,3,0,16
 druid-master\druid-master\core\src\main\java\org\apache\druid\math\expr\vector\ExprEvalStringVector.java,0,13,0,1,3,17
 druid-master\druid-master\processing\src\main\java\org\apache\druid\segment\ColumnProcessorFactory.java,0,18,0,10,0,28
 druid-master\druid-master\benchmarks\src\test\java\org\apache\druid\benchmark\DataSourcesSnapshotBenchmark.java,0,26,2,5,0,33
 druid-master\druid-master\extensions-core\datasketches\src\test\java\org\apache\druid\query\aggregation\datasketches\tuple\ArrayOfDoublesSketchToNumEntriesPostAggregatorTest.java,0,30,0,18,0,48
 druid-master\druid-master\server\src\test\java\org\apache\druid\segment\realtime\plumber\ServerTimeRejectionPolicyFactoryTest.java,0,6,0,2,0,8
 druid-master\druid-master\indexing-service\src\main\java\org\apache\druid\indexing\common\tasklogs\SwitchingTaskLogStreamer.java,0,16,0,4,0,20
 druid-master\druid-master\processing\src\test\java\org\apache\druid\query\groupby\epinephelinae\column\ArrayLongGroupByColumnSelectorStrategyTest.java,0,58,2,21,0,81
 druid-master\druid-master\core\src\test\java\org\apache\druid\common\utils\SerializerUtilsTest.java,0,45,4,4,1,54
 druid-master\druid-master\indexing-service\src\test\java\org\apache\druid\indexing\common\task\batch\parallel\HashPartitionAdjustingCorePartitionSizeTest.java,0,48,2,19,0,69
 druid-master\druid-master\server\src\main\java\org\apache\druid\server\scheduling\ThresholdBasedQueryPrioritizationStrategy.java,0,34,0,15,0,49
 druid-master\druid-master\core\src\test\java\org\apache\druid\timeline\partition\BuildingNumberedShardSpecTest.java,0,19,0,5,0,24
 druid-master\druid-master\processing\src\test\java\org\apache\druid\segment\data\VSizeColumnarMultiIntsTest.java,0,30,0,2,0,32
 druid-master\druid-master\benchmarks\src\test\java\org\apache\druid\timeline\VersionedIntervalTimelineBenchmark.java,0,76,0,24,0,100
 druid-master\druid-master\core\src\test\java\org\apache\druid\data\input\StringTupleTest.java,0,16,0,1,0,17
 druid-master\druid-master\processing\src\main\java\org\apache\druid\segment\join\PossiblyNullColumnValueSelector.java,0,31,0,9,0,40
 druid-master\druid-master\server\src\main\java\org\apache\druid\metadata\storage\derby\DerbyMetadataStorageDruidModule.java,0,10,0,4,0,14
 druid-master\druid-master\indexing-service\src\main\java\org\apache\druid\indexing\common\actions\SurrogateTaskActionClient.java,0,16,0,5,0,21
 druid-master\druid-master\extensions-core\orc-extensions\src\test\java\org\apache\druid\data\input\orc\OrcStructConverterTest.java,0,148,0,27,0,175
 druid-master\druid-master\extensions-core\kinesis-indexing-service\src\main\java\org\apache\druid\indexing\kinesis\KinesisIndexTaskClientFactory.java,0,13,0,3,0,16
 druid-master\druid-master\extensions-core\avro-extensions\src\main\java\org\apache\druid\data\input\avro\GenericAvroJsonProvider.java,0,49,0,9,0,58
 druid-master\druid-master\extensions-core\druid-ranger-security\src\test\java\org\apache\druid\security\ranger\authorizer\RangerAuthorizerTest.java,0,30,0,14,0,44
 druid-master\druid-master\extensions-core\google-extensions\src\test\java\org\apache\druid\data\input\google\GoogleCloudStorageInputSourceTest.java,0,90,2,48,0,140
 druid-master\druid-master\services\src\main\java\org\apache\druid\cli\CliInternalHadoopIndexer.java,0,36,0,18,0,54
 druid-master\druid-master\processing\src\main\java\org\apache\druid\collections\spatial\ImmutableNode.java,0,84,1,7,0,92
 druid-master\druid-master\indexing-service\src\main\java\org\apache\druid\indexing\overlord\ZkWorker.java,0,106,1,14,0,121
 druid-master\druid-master\extensions-core\azure-extensions\src\main\java\org\apache\druid\storage\azure\AzureDataSegmentPusher.java,0,61,0,15,0,76
 druid-master\druid-master\processing\src\main\java\org\apache\druid\segment\historical\HistoricalDimensionSelector.java,0,3,0,2,0,5
 druid-master\druid-master\sql\src\main\java\org\apache\druid\sql\calcite\expression\builtin\ArrayConcatOperatorConversion.java,0,4,0,1,0,5
 druid-master\druid-master\sql\src\main\java\org\apache\druid\sql\calcite\expression\builtin\ArraySliceOperatorConversion.java,0,4,0,1,0,5
 druid-master\druid-master\core\src\main\java\org\apache\druid\data\input\InputEntity.java,0,27,0,13,0,40
 druid-master\druid-master\processing\src\main\java\org\apache\druid\query\spec\QuerySegmentSpec.java,0,6,0,4,0,10
 druid-master\druid-master\server\src\test\java\org\apache\druid\query\expression\LookupExprMacroTest.java,0,20,1,11,0,32
 druid-master\druid-master\processing\src\main\java\org\apache\druid\segment\join\JoinMatcher.java,0,14,0,11,0,25
 druid-master\druid-master\sql\src\main\java\org\apache\druid\sql\calcite\expression\builtin\RegexpExtractOperatorConversion.java,0,13,0,7,0,20
 druid-master\druid-master\server\src\main\java\org\apache\druid\server\listener\resource\AbstractListenerHandler.java,0,51,1,24,0,76
 druid-master\druid-master\core\src\main\java\org\apache\druid\java\util\http\client\response\BytesFullResponseHandler.java,0,25,0,7,0,32
 druid-master\druid-master\server\src\main\java\org\apache\druid\server\coordinator\CuratorLoadQueuePeon.java,0,152,4,51,0,207
 druid-master\druid-master\indexing-service\src\test\java\org\apache\druid\indexing\common\task\batch\parallel\PerfectRollupWorkerTaskTest.java,0,53,0,12,0,65
 druid-master\druid-master\core\src\main\java\org\apache\druid\java\util\metrics\ClockDriftSafeMonitorScheduler.java,0,26,6,4,0,36
 druid-master\druid-master\extensions-contrib\aliyun-oss-extensions\src\main\java\org\apache\druid\storage\aliyun\OssTaskLogsConfig.java,0,25,0,1,0,26
 druid-master\druid-master\server\src\test\java\org\apache\druid\guice\StorageNodeModuleTest.java,0,57,1,25,0,83
 druid-master\druid-master\processing\src\test\java\org\apache\druid\segment\IndexMergerV9WithSpatialIndexTest.java,0,113,1,25,0,139
 druid-master\druid-master\server\src\main\java\org\apache\druid\guice\BrokerProcessingModule.java,0,54,1,19,0,74
 druid-master\druid-master\extensions-core\druid-basic-security\src\main\java\org\apache\druid\security\basic\authentication\BasicHTTPEscalator.java,0,23,0,6,0,29
 druid-master\druid-master\processing\src\main\java\org\apache\druid\query\filter\SearchQueryDimFilter.java,0,67,0,5,0,72
 druid-master\druid-master\extensions-core\datasketches\src\test\java\org\apache\druid\query\aggregation\datasketches\quantiles\DoublesSketchToQuantilePostAggregatorTest.java,0,8,0,2,0,10
 druid-master\druid-master\processing\src\main\java\org\apache\druid\query\planning\PreJoinableClause.java,0,40,0,3,0,43
 druid-master\druid-master\server\src\main\java\org\apache\druid\server\initialization\jetty\ServletFilterHolder.java,0,13,0,7,0,20
 druid-master\druid-master\core\src\main\java\org\apache\druid\java\util\http\client\HttpClientProxyConfig.java,0,39,1,3,0,43
 druid-master\druid-master\indexing-service\src\main\java\org\apache\druid\indexing\overlord\autoscaling\SimpleWorkerProvisioningStrategy.java,0,95,7,44,0,146
 druid-master\druid-master\server\src\main\java\org\apache\druid\client\selector\AbstractTierSelectorStrategy.java,0,24,0,6,0,30
 druid-master\druid-master\indexing-service\src\test\java\org\apache\druid\indexing\overlord\config\RemoteTaskRunnerConfigTest.java,0,69,0,17,0,86
 druid-master\druid-master\processing\src\main\java\org\apache\druid\query\extraction\CascadeExtractionFn.java,0,76,2,7,0,85
 druid-master\druid-master\core\src\test\java\org\apache\druid\concurrent\ConcurrentAwaitableCounterTest.java,0,17,0,1,0,18
 druid-master\druid-master\processing\src\test\java\org\apache\druid\query\search\SearchBinaryFnTest.java,0,49,0,20,0,69
 druid-master\druid-master\server\src\main\java\org\apache\druid\segment\MapSegmentWrangler.java,0,11,0,5,0,16
 druid-master\druid-master\processing\src\test\java\org\apache\druid\query\dimension\PrefixFilteredDimensionSpecTest.java,0,9,0,3,0,12
 druid-master\druid-master\extensions-contrib\dropwizard-emitter\src\main\java\org\apache\druid\emitter\dropwizard\reporters\DropwizardConsoleReporter.java,0,53,1,3,0,57
 druid-master\druid-master\indexing-service\src\main\java\org\apache\druid\indexing\overlord\http\TaskPayloadResponse.java,0,24,0,2,0,26
 druid-master\druid-master\processing\src\main\java\org\apache\druid\query\aggregation\SimpleDoubleBufferAggregator.java,0,35,0,1,0,36
 druid-master\druid-master\extensions-core\datasketches\src\main\java\org\apache\druid\query\aggregation\datasketches\quantiles\DoublesSketchToRankPostAggregator.java,0,46,0,4,0,50
 druid-master\druid-master\core\src\test\java\org\apache\druid\indexer\partitions\SingleDimensionPartitionsSpecTest.java,0,117,0,22,0,139
 druid-master\druid-master\server\src\main\java\org\apache\druid\server\initialization\AuthorizerMapperModule.java,0,34,0,9,0,43
 druid-master\druid-master\server\src\main\java\org\apache\druid\segment\realtime\appenderator\BaseAppenderatorDriver.java,0,223,4,105,0,332
 druid-master\druid-master\server\src\test\java\org\apache\druid\server\WebserverTestUtils.java,0,27,3,13,0,43
 druid-master\druid-master\extensions-core\kinesis-indexing-service\src\test\java\org\apache\druid\indexing\kinesis\test\TestModifiedKinesisIndexTaskTuningConfig.java,0,55,0,14,0,69
 druid-master\druid-master\core\src\main\java\org\apache\druid\guice\JacksonConfigManagerModule.java,0,11,1,2,0,14
 druid-master\druid-master\core\src\test\java\org\apache\druid\TestObjectMapper.java,0,11,0,2,1,14
 druid-master\druid-master\extensions-core\datasketches\src\main\java\org\apache\druid\query\aggregation\datasketches\theta\SketchAggregator.java,0,45,1,7,0,53
 druid-master\druid-master\core\src\test\java\org\apache\druid\jackson\JacksonExtremeDoubleValuesSerdeTest.java,0,7,1,4,1,13
 druid-master\druid-master\extensions-contrib\distinctcount\src\test\java\org\apache\druid\query\aggregation\distinctcount\DistinctCountGroupByQueryTest.java,0,20,2,6,0,28
 druid-master\druid-master\server\src\main\java\org\apache\druid\server\emitter\HttpEmitterSSLClientConfig.java,0,40,0,8,0,48
 druid-master\druid-master\server\src\test\java\org\apache\druid\guice\JsonConfigTesterBaseTest.java,0,37,0,8,0,45
 druid-master\druid-master\processing\src\main\java\org\apache\druid\segment\vector\VectorSizeInspector.java,0,7,0,5,0,12
 druid-master\druid-master\server\src\main\java\org\apache\druid\jackson\StringObjectPairList.java,0,20,0,2,0,22
 druid-master\druid-master\server\src\main\java\org\apache\druid\server\metrics\EventReceiverFirehoseRegister.java,0,21,0,6,0,27
 druid-master\druid-master\processing\src\main\java\org\apache\druid\query\aggregation\package-info.java,0,1,0,1,0,2
 druid-master\druid-master\server\src\main\java\org\apache\druid\segment\realtime\plumber\ServerTimeRejectionPolicyFactory.java,0,8,0,1,0,9
 druid-master\druid-master\core\src\main\java\org\apache\druid\data\input\InputFileAttribute.java,0,8,0,1,0,9
 druid-master\druid-master\processing\src\test\java\org\apache\druid\query\topn\DimensionTopNMetricSpecTest.java,0,25,0,17,0,42
 druid-master\druid-master\server\src\main\java\org\apache\druid\server\log\DefaultRequestLogEvent.java,0,33,1,5,0,39
 druid-master\druid-master\server\src\main\java\org\apache\druid\server\coordinator\DiskNormalizedCostBalancerStrategyFactory.java,0,5,0,2,0,7
 druid-master\druid-master\indexing-service\src\main\java\org\apache\druid\indexing\input\DruidInputSource.java,0,178,6,68,0,252
 druid-master\druid-master\indexing-hadoop\src\main\java\org\apache\druid\indexer\hadoop\WindowedDataSegment.java,0,26,0,1,0,27
 druid-master\druid-master\processing\src\main\java\org\apache\druid\segment\data\CompressedVSizeColumnarIntsSupplier.java,0,149,2,30,0,181
 druid-master\druid-master\integration-tests\src\main\java\org\apache\druid\testing\guice\ITTLSCertificateCheckerModule.java,0,10,0,2,0,12
 druid-master\druid-master\server\src\test\java\org\apache\druid\client\HttpServerInventoryViewConfigTest.java,0,15,0,7,0,22
 druid-master\druid-master\core\src\test\java\org\apache\druid\crypto\CryptoServiceTest.java,0,13,1,1,0,15
 druid-master\druid-master\core\src\main\java\org\apache\druid\timeline\partition\BuildingNumberedShardSpec.java,0,32,0,6,0,38
 druid-master\druid-master\extensions-core\datasketches\src\test\java\org\apache\druid\query\aggregation\datasketches\theta\SketchEstimateWithErrorBoundsTest.java,0,9,0,3,0,12
 druid-master\druid-master\benchmarks\src\test\java\org\apache\druid\benchmark\FixedHistogramAddBenchmark.java,0,26,1,2,0,29
 druid-master\druid-master\indexing-service\src\test\java\org\apache\druid\indexing\overlord\hrtr\HttpRemoteTaskRunnerTest.java,0,471,15,176,0,662
 druid-master\druid-master\indexing-service\src\main\java\org\apache\druid\indexing\worker\shuffle\LocalIntermediaryDataManager.java,0,100,8,50,0,158
 druid-master\druid-master\processing\src\main\java\org\apache\druid\segment\data\CompressedVSizeColumnarMultiIntsSupplier.java,0,68,0,15,0,83
 druid-master\druid-master\core\src\main\java\org\apache\druid\timeline\partition\HashBasedNumberedShardSpec.java,0,118,0,45,2,165
 druid-master\druid-master\processing\src\test\java\org\apache\druid\query\extraction\UpperExtractionFnTest.java,0,12,0,4,0,16
 druid-master\druid-master\extendedset\src\main\java\org\apache\druid\extendedset\intset\BitIterator.java,0,80,2,4,0,86
 druid-master\druid-master\server\src\main\java\org\apache\druid\server\http\security\DatasourceResourceFilter.java,0,16,0,5,0,21
 druid-master\druid-master\server\src\test\java\org\apache\druid\segment\realtime\plumber\MessageTimeRejectionPolicyFactoryTest.java,0,4,0,2,0,6
 druid-master\druid-master\processing\src\main\java\org\apache\druid\query\AbstractPrioritizedCallable.java,0,10,0,2,0,12
 druid-master\druid-master\indexing-hadoop\src\test\java\org\apache\druid\indexer\DataSegmentAndIndexZipFilePathTest.java,0,29,7,3,0,39
 druid-master\druid-master\indexing-service\src\main\java\org\apache\druid\indexing\package-info.java,0,1,0,1,0,2
 druid-master\druid-master\processing\src\main\java\org\apache\druid\query\metadata\metadata\ColumnIncluderator.java,0,2,0,1,0,3
 druid-master\druid-master\server\src\main\java\org\apache\druid\curator\CuratorConfig.java,0,64,0,2,0,66
 druid-master\druid-master\sql\src\main\java\org\apache\druid\sql\calcite\planner\UnsupportedSQLQueryException.java,0,10,0,6,0,16
 druid-master\druid-master\processing\src\main\java\org\apache\druid\query\topn\TopNUtils.java,0,15,0,10,0,25
 druid-master\druid-master\server\src\main\java\org\apache\druid\server\coordinator\SegmentReplicantLookup.java,0,59,1,19,0,79
 druid-master\druid-master\indexing-service\src\main\java\org\apache\druid\indexing\common\task\batch\parallel\PerfectRollupWorkerTask.java,0,27,0,5,0,32
 druid-master\druid-master\extensions-contrib\graphite-emitter\src\main\java\org\apache\druid\emitter\graphite\GraphiteEvent.java,0,25,0,5,0,30
 druid-master\druid-master\processing\src\main\java\org\apache\druid\segment\data\DeltaLongEncodingReader.java,0,45,0,8,0,53
 druid-master\druid-master\sql\src\test\java\org\apache\druid\sql\calcite\expression\TimeFormatOperatorConversionTest.java,0,21,0,2,0,23
 druid-master\druid-master\core\src\main\java\org\apache\druid\java\util\common\guava\WrappingSequence.java,0,23,2,4,0,29
 druid-master\druid-master\extensions-contrib\redis-cache\src\main\java\org\apache\druid\client\cache\RedisCacheConfig.java,0,76,0,1,0,77
 druid-master\druid-master\extensions-contrib\cloudfiles-extensions\src\main\java\org\apache\druid\storage\cloudfiles\CloudFilesDataSegmentPusher.java,0,41,4,14,0,59
 druid-master\druid-master\indexing-service\src\test\java\org\apache\druid\indexing\overlord\supervisor\SupervisorManagerTest.java,0,98,0,34,0,132
 druid-master\druid-master\integration-tests\src\test\java\org\apache\druid\tests\indexer\AbstractKafkaIndexingServiceTest.java,0,33,0,12,0,45
 druid-master\druid-master\core\src\main\java\org\apache\druid\segment\loading\DataSegmentKiller.java,0,12,0,6,0,18
 druid-master\druid-master\server\src\test\java\org\apache\druid\guice\LocalDataStorageDruidModuleTest.java,0,11,0,5,0,16
 druid-master\druid-master\extensions-core\protobuf-extensions\src\main\java\org\apache\druid\data\input\protobuf\ProtobufBytesDecoder.java,0,5,0,4,0,9
 druid-master\druid-master\processing\src\test\java\org\apache\druid\segment\join\NoopJoinableFactory.java,0,11,0,2,0,13
 druid-master\druid-master\indexing-service\src\main\java\org\apache\druid\indexing\worker\executor\ExecutorLifecycle.java,0,62,9,15,0,86
 druid-master\druid-master\server\src\main\java\org\apache\druid\curator\discovery\CuratorDruidLeaderSelector.java,0,62,2,17,0,81
 druid-master\druid-master\core\src\test\java\org\apache\druid\timeline\partition\HashBasedNumberedShardSpecTest.java,0,114,3,34,1,152
 druid-master\druid-master\extensions-core\datasketches\src\main\java\org\apache\druid\query\aggregation\datasketches\quantiles\DoublesSketchObjectStrategy.java,0,12,0,4,0,16
 druid-master\druid-master\processing\src\test\java\org\apache\druid\query\expression\IPv4AddressMatchExprMacroTest.java,0,69,5,9,0,83
 druid-master\druid-master\server\src\main\java\org\apache\druid\server\log\EmittingRequestLoggerProvider.java,0,14,1,4,0,19
 druid-master\druid-master\processing\src\test\java\org\apache\druid\segment\CustomSegmentizerFactoryTest.java,0,31,0,12,0,43
 druid-master\druid-master\processing\src\main\java\org\apache\druid\query\topn\types\StringTopNColumnAggregatesProcessor.java,0,71,1,25,0,97
 druid-master\druid-master\indexing-service\src\test\java\org\apache\druid\indexing\overlord\sampler\InputSourceSamplerTest.java,0,349,8,85,0,442
 druid-master\druid-master\processing\src\main\java\org\apache\druid\query\groupby\GroupByQueryRunnerFactory.java,0,38,0,7,0,45
 druid-master\druid-master\extensions-core\mysql-metadata-storage\src\test\java\org\apache\druid\metadata\storage\mysql\MySQLConnectorDriverConfigTest.java,0,4,0,1,0,5
 druid-master\druid-master\extensions-contrib\aliyun-oss-extensions\src\main\java\org\apache\druid\storage\aliyun\OssTimestampVersionedDataFinder.java,0,16,0,11,0,27
 druid-master\druid-master\core\src\main\java\org\apache\druid\utils\CloseableUtils.java,0,43,4,12,0,59
 druid-master\druid-master\extensions-core\lookups-cached-single\src\main\java\org\apache\druid\server\lookup\PollingLookup.java,0,79,0,13,0,92
 druid-master\druid-master\server\src\main\java\org\apache\druid\client\cache\MapCache.java,0,43,0,2,0,45
 druid-master\druid-master\processing\src\main\java\org\apache\druid\segment\incremental\IncrementalIndexStorageAdapter.java,0,105,0,23,0,128
 druid-master\druid-master\extensions-core\datasketches\src\main\java\org\apache\druid\query\aggregation\datasketches\theta\SketchBufferAggregator.java,0,46,0,3,0,49
 druid-master\druid-master\indexing-hadoop\src\main\java\org\apache\druid\indexer\SortableBytes.java,0,78,1,4,0,83
 druid-master\druid-master\processing\src\main\java\org\apache\druid\query\aggregation\cardinality\types\CardinalityAggregatorColumnSelectorStrategyFactory.java,0,7,0,3,0,10
 druid-master\druid-master\extensions-contrib\aliyun-oss-extensions\src\main\java\org\apache\druid\storage\aliyun\OssDataSegmentPusher.java,0,44,1,11,0,56
 druid-master\druid-master\processing\src\test\java\org\apache\druid\query\aggregation\first\DoubleFirstAggregationTest.java,0,96,0,15,0,111
 druid-master\druid-master\benchmarks\src\test\java\org\apache\druid\benchmark\compression\EncodingSizeProfiler.java,0,20,1,7,0,28
 druid-master\druid-master\server\src\main\java\org\apache\druid\guice\LocalDataStorageDruidModule.java,0,18,0,5,0,23
 druid-master\druid-master\processing\src\main\java\org\apache\druid\jackson\JodaStuff.java,0,29,1,6,0,36
 druid-master\druid-master\indexing-service\src\main\java\org\apache\druid\indexing\overlord\autoscaling\ProvisioningStrategy.java,0,10,0,5,0,15
 druid-master\druid-master\processing\src\main\java\org\apache\druid\query\groupby\GroupByQueryQueryToolChest.java,0,179,3,64,0,246
 druid-master\druid-master\indexing-hadoop\src\main\java\org\apache\druid\indexer\path\UsedSegmentsRetriever.java,0,11,0,11,0,22
 druid-master\druid-master\server\src\test\java\org\apache\druid\client\ImmutableDruidServerTests.java,0,9,0,4,0,13
 druid-master\druid-master\extensions-core\azure-extensions\src\main\java\org\apache\druid\data\input\azure\AzureEntity.java,0,19,0,3,0,22
 druid-master\druid-master\processing\src\test\java\org\apache\druid\query\extraction\JavaScriptExtractionFnTest.java,0,59,0,31,0,90
 druid-master\druid-master\extensions-core\lookups-cached-global\src\main\java\org\apache\druid\server\lookup\namespace\cache\OffHeapNamespaceExtractionCacheManager.java,0,99,4,36,0,139
 druid-master\druid-master\sql\src\main\java\org\apache\druid\sql\http\SqlQuery.java,0,67,0,4,0,71
 druid-master\druid-master\extensions-core\datasketches\src\main\java\org\apache\druid\query\aggregation\datasketches\theta\SketchConstantPostAggregator.java,0,42,1,5,0,48
 druid-master\druid-master\processing\src\test\java\org\apache\druid\segment\join\filter\rewrite\JoinFilterRewriteConfigTest.java,0,5,0,2,0,7
 druid-master\druid-master\indexing-service\src\main\java\org\apache\druid\indexing\common\task\batch\parallel\PartialSegmentMergeIOConfig.java,0,9,0,2,0,11
 druid-master\druid-master\server\src\main\java\org\apache\druid\metadata\SQLMetadataStorageActionHandlerFactory.java,0,16,0,2,0,18
 druid-master\druid-master\processing\src\main\java\org\apache\druid\segment\Segment.java,0,20,0,11,0,31
 druid-master\druid-master\hll\src\test\java\org\apache\druid\hll\HyperLogLogSerdeBenchmarkTest.java,0,86,18,27,15,146
 druid-master\druid-master\processing\src\main\java\org\apache\druid\collections\bitmap\BitmapFactory.java,0,11,0,6,0,17
 druid-master\druid-master\extensions-core\testing-tools\src\test\java\org\apache\druid\query\sql\SleepSqlTest.java,0,10,0,3,0,13
 druid-master\druid-master\core\src\main\java\org\apache\druid\java\util\common\config\DurationCoercible.java,0,7,0,1,1,9
 druid-master\druid-master\sql\src\test\java\org\apache\druid\sql\calcite\CalciteCorrelatedQueryTest.java,0,183,2,161,0,346
 druid-master\druid-master\extensions-core\histogram\src\main\java\org\apache\druid\query\aggregation\histogram\MinPostAggregator.java,0,27,0,3,0,30
 druid-master\druid-master\server\src\test\java\org\apache\druid\client\cache\MemcachedCacheTest.java,0,439,1,28,0,468
 druid-master\druid-master\integration-tests\src\main\java\org\apache\druid\testing\utils\AbstractQueryWithResults.java,0,29,1,2,0,32
 druid-master\druid-master\processing\src\main\java\org\apache\druid\query\aggregation\SimpleDoubleAggregatorFactory.java,0,86,1,16,0,103
 druid-master\druid-master\core\src\main\java\org\apache\druid\data\input\FirehoseFactory.java,0,25,0,16,0,41
 druid-master\druid-master\integration-tests\src\test\java\org\apache\druid\tests\parallelized\ITKinesisIndexingServiceDataFormatTest.java,0,20,1,8,0,29
 druid-master\druid-master\extensions-core\histogram\src\main\java\org\apache\druid\query\aggregation\histogram\ApproximateHistogramFoldingAggregator.java,0,27,0,5,0,32
 druid-master\druid-master\processing\src\main\java\org\apache\druid\query\monomorphicprocessing\RuntimeShapeInspector.java,0,11,0,5,0,16
 druid-master\druid-master\server\src\test\java\org\apache\druid\segment\realtime\firehose\LocalFirehoseFactoryTest.java,0,20,3,5,0,28
 druid-master\druid-master\processing\src\test\java\org\apache\druid\query\aggregation\post\ExpressionPostAggregatorTest.java,0,24,0,11,0,35
 druid-master\druid-master\indexing-service\src\main\java\org\apache\druid\indexing\common\task\FilteringCloseableInputRowIterator.java,0,28,0,6,0,34
 druid-master\druid-master\processing\src\main\java\org\apache\druid\segment\writeout\OnHeapMemorySegmentWriteOutMedium.java,0,9,0,4,0,13
 druid-master\druid-master\core\src\main\java\org\apache\druid\java\util\common\Pair.java,0,28,2,1,0,31
 druid-master\druid-master\core\src\main\java\org\apache\druid\segment\column\ValueType.java,0,42,0,28,0,70
 druid-master\druid-master\server\src\test\java\org\apache\druid\server\metrics\ExceptionCapturingServiceEmitter.java,0,26,3,5,0,34
 druid-master\druid-master\extensions-contrib\opentsdb-emitter\src\main\java\org\apache\druid\emitter\opentsdb\OpentsdbEmitterConfig.java,0,83,5,8,0,96
 druid-master\druid-master\processing\src\main\java\org\apache\druid\segment\filter\FalseFilter.java,0,36,1,5,0,42
 druid-master\druid-master\server\src\main\java\org\apache\druid\client\BrokerServerView.java,0,116,4,40,0,160
 druid-master\druid-master\extensions-contrib\moving-average-query\src\main\java\org\apache\druid\query\movingaverage\averagers\LongSumAveragerFactory.java,0,10,0,2,0,12
 druid-master\druid-master\core\src\main\java\org\apache\druid\collections\StupidResourceHolder.java,0,13,0,1,0,14
 druid-master\druid-master\cloud\aws-common\src\main\java\org\apache\druid\common\aws\AWSProxyConfig.java,0,17,0,1,0,18
 druid-master\druid-master\extensions-core\kafka-indexing-service\src\main\java\org\apache\druid\indexing\kafka\supervisor\KafkaSupervisorIOConfig.java,0,69,0,14,0,83
 druid-master\druid-master\processing\src\main\java\org\apache\druid\query\aggregation\post\DoubleLeastPostAggregator.java,0,46,3,6,0,55
 druid-master\druid-master\extensions-core\datasketches\src\main\java\org\apache\druid\query\aggregation\datasketches\theta\SketchMergeComplexMetricSerde.java,0,26,0,7,0,33
 druid-master\druid-master\core\src\main\java\org\apache\druid\segment\loading\DataSegmentMover.java,0,5,0,4,0,9
 druid-master\druid-master\processing\src\main\java\org\apache\druid\query\groupby\having\DimFilterHavingSpec.java,0,41,0,7,0,48
 druid-master\druid-master\processing\src\test\java\org\apache\druid\query\scan\ScanQueryConfigTest.java,0,18,0,4,0,22
 druid-master\druid-master\integration-tests\src\main\java\org\apache\druid\testing\utils\SqlQueryWithResults.java,0,5,0,1,0,6
 druid-master\druid-master\indexing-service\src\main\java\org\apache\druid\indexing\common\task\MoveTask.java,0,25,1,5,0,31
 druid-master\druid-master\processing\src\main\java\org\apache\druid\query\ordering\StringComparator.java,0,6,0,1,0,7
 druid-master\druid-master\processing\src\main\java\org\apache\druid\query\search\SearchStrategy.java,0,20,0,6,0,26
 druid-master\druid-master\core\src\main\java\org\apache\druid\java\util\http\client\response\StatusResponseHolder.java,0,18,1,1,2,22
 druid-master\druid-master\extensions-contrib\aliyun-oss-extensions\src\main\java\org\apache\druid\storage\aliyun\OssDataSegmentPuller.java,0,73,4,23,0,100
 druid-master\druid-master\processing\src\main\java\org\apache\druid\query\aggregation\mean\DoubleMeanAggregator.java,0,20,0,1,0,21
 druid-master\druid-master\sql\src\main\java\org\apache\druid\sql\calcite\expression\builtin\ExtractOperatorConversion.java,0,13,0,8,0,21
 druid-master\druid-master\server\src\main\java\org\apache\druid\server\http\CoordinatorRedirectInfo.java,0,16,1,2,0,19
 druid-master\druid-master\server\src\main\java\org\apache\druid\server\http\SegmentToMove.java,0,21,0,1,0,22
 druid-master\druid-master\indexing-service\src\main\java\org\apache\druid\indexing\common\task\Task.java,0,60,0,53,0,113
 druid-master\druid-master\core\src\test\java\org\apache\druid\common\exception\AllowedRegexErrorResponseTransformStrategyTest.java,0,18,0,9,0,27
 druid-master\druid-master\extensions-core\druid-basic-security\src\main\java\org\apache\druid\security\basic\authentication\db\cache\BasicAuthenticatorCacheNotifier.java,0,4,0,3,0,7
 druid-master\druid-master\core\src\test\java\org\apache\druid\java\util\common\guava\MappedSequenceTest.java,0,8,0,1,1,10
 druid-master\druid-master\processing\src\main\java\org\apache\druid\segment\column\BaseColumn.java,0,10,0,5,0,15
 druid-master\druid-master\processing\src\test\java\org\apache\druid\segment\CloserRule.java,0,21,1,1,0,23
 druid-master\druid-master\core\src\main\java\org\apache\druid\java\util\emitter\EmittingLogger.java,0,50,3,7,0,60
 druid-master\druid-master\processing\src\test\java\org\apache\druid\segment\incremental\RowIngestionMetersTotalsTest.java,0,4,0,2,0,6
 druid-master\druid-master\processing\src\main\java\org\apache\druid\query\search\UseIndexesStrategy.java,0,64,3,30,0,97
 druid-master\druid-master\server\src\test\java\org\apache\druid\segment\realtime\appenderator\CommittedTest.java,0,27,0,9,0,36
 druid-master\druid-master\core\src\main\java\org\apache\druid\java\util\common\guava\DroppingIterable.java,0,12,0,1,0,13
 druid-master\druid-master\processing\src\test\java\org\apache\druid\segment\incremental\IncrementalIndexMultiValueSpecTest.java,0,36,0,12,0,48
 druid-master\druid-master\processing\src\main\java\org\apache\druid\query\aggregation\CountVectorAggregator.java,0,11,0,2,0,13
 druid-master\druid-master\server\src\main\java\org\apache\druid\discovery\LookupNodeService.java,0,21,0,1,0,22
 druid-master\druid-master\processing\src\main\java\org\apache\druid\query\aggregation\LongMinAggregatorFactory.java,0,43,0,3,0,46
 druid-master\druid-master\core\src\test\java\org\apache\druid\data\input\impl\StringDimensionSchemaTest.java,0,11,0,4,0,15
 druid-master\druid-master\core\src\main\java\org\apache\druid\data\input\InputFormat.java,0,7,0,3,0,10
 druid-master\druid-master\indexing-service\src\main\java\org\apache\druid\indexing\common\actions\SegmentInsertAction.java,0,26,0,6,0,32
 druid-master\druid-master\processing\src\main\java\org\apache\druid\query\aggregation\first\DoubleFirstAggregator.java,0,20,0,3,0,23
 druid-master\druid-master\indexing-service\src\main\java\org\apache\druid\indexing\common\IngestionStatsAndErrorsTaskReportData.java,0,68,0,8,0,76
 druid-master\druid-master\indexing-service\src\main\java\org\apache\druid\indexing\common\tasklogs\LogUtils.java,0,6,2,3,0,11
 druid-master\druid-master\server\src\main\java\org\apache\druid\server\coordinator\LoadQueuePeon.java,0,18,0,5,0,23
 druid-master\druid-master\extensions-core\datasketches\src\main\java\org\apache\druid\query\aggregation\datasketches\theta\sql\ThetaSketchEstimateOperatorConversion.java,0,18,0,4,0,22
 druid-master\druid-master\extensions-core\kafka-indexing-service\src\main\java\org\apache\druid\indexing\kafka\supervisor\KafkaSupervisor.java,0,128,10,40,0,178
 druid-master\druid-master\server\src\test\java\org\apache\druid\server\http\IntervalsResourceTest.java,0,66,1,36,0,103
 druid-master\druid-master\processing\src\main\java\org\apache\druid\query\PrioritizedExecutorService.java,0,120,1,16,0,137
 druid-master\druid-master\extensions-core\druid-basic-security\src\main\java\org\apache\druid\security\basic\authentication\db\cache\BasicAuthenticatorCacheManager.java,0,8,0,8,0,16
 druid-master\druid-master\processing\src\test\java\org\apache\druid\segment\SimpleQueryableIndexTest.java,0,14,3,1,0,18
 druid-master\druid-master\core\src\main\java\org\apache\druid\java\util\metrics\MonitorScheduler.java,0,39,1,3,0,43
 druid-master\druid-master\server\src\main\java\org\apache\druid\server\coordinator\rules\RuleMap.java,0,13,0,1,0,14
 druid-master\druid-master\extensions-contrib\virtual-columns\src\test\java\org\apache\druid\segment\MapVirtualColumnTopNTest.java,0,19,0,10,0,29
 druid-master\druid-master\extensions-core\datasketches\src\main\java\org\apache\druid\query\aggregation\datasketches\util\ToObjectVectorColumnProcessorFactory.java,0,32,1,10,0,43
 druid-master\druid-master\indexing-service\src\main\java\org\apache\druid\indexing\overlord\TaskRunner.java,0,27,0,10,0,37
 druid-master\druid-master\processing\src\main\java\org\apache\druid\query\aggregation\any\LongAnyAggregatorFactory.java,0,84,0,12,0,96
 druid-master\druid-master\sql\src\test\java\org\apache\druid\sql\http\SqlHttpModuleTest.java,0,19,1,6,0,26
 druid-master\druid-master\processing\src\main\java\org\apache\druid\segment\incremental\IncrementalIndex.java,0,492,2,127,0,621
 druid-master\druid-master\indexing-service\src\main\java\org\apache\druid\indexing\common\actions\RetrieveUsedSegmentsAction.java,0,54,1,11,0,66
 druid-master\druid-master\extensions-contrib\cassandra-storage\src\main\java\org\apache\druid\storage\cassandra\CassandraLoadSpec.java,0,12,0,1,0,13
 druid-master\druid-master\server\src\test\java\org\apache\druid\server\initialization\AuthorizerMapperModuleTest.java,0,9,1,2,0,12
 druid-master\druid-master\server\src\test\java\org\apache\druid\query\lookup\LookupSnapshotTakerTest.java,0,29,1,8,0,38
 druid-master\druid-master\benchmarks\src\test\java\org\apache\druid\benchmark\ExpressionVectorSelectorBenchmark.java,0,31,1,11,0,43
 druid-master\druid-master\server\src\main\java\org\apache\druid\segment\realtime\RealtimeMetricsMonitor.java,0,40,0,22,0,62
 druid-master\druid-master\processing\src\test\java\org\apache\druid\query\aggregation\DoubleSumAggregatorTest.java,0,12,2,5,0,19
 druid-master\druid-master\services\src\main\java\org\apache\druid\guice\IndexerServiceModule.java,0,12,0,1,0,13
 druid-master\druid-master\processing\src\test\java\org\apache\druid\query\topn\TopNMetricSpecOptimizationsTest.java,0,88,13,22,0,123
 druid-master\druid-master\extensions-contrib\redis-cache\src\main\java\org\apache\druid\client\cache\RedisCacheProvider.java,0,4,0,2,0,6
 druid-master\druid-master\extensions-contrib\kafka-emitter\src\test\java\org\apache\druid\emitter\kafka\KafkaEmitterTest.java,0,18,0,9,0,27
 druid-master\druid-master\core\src\main\java\org\apache\druid\java\util\metrics\CompoundMonitor.java,0,19,0,2,1,22
 druid-master\druid-master\server\src\main\java\org\apache\druid\client\indexing\HttpIndexingServiceClient.java,0,132,3,44,0,179
 druid-master\druid-master\processing\src\test\java\org\apache\druid\guice\MetadataStorageTablesConfigTest.java,0,16,0,10,0,26
 druid-master\druid-master\extensions-core\ec2-extensions\src\main\java\org\apache\druid\indexing\overlord\autoscaling\ec2\EC2Module.java,0,6,1,2,0,9
 druid-master\druid-master\core\src\main\java\org\apache\druid\data\input\impl\prefetch\FetchedFile.java,0,21,0,3,0,24
 druid-master\druid-master\processing\src\main\java\org\apache\druid\query\groupby\epinephelinae\GrouperBufferComparatorUtils.java,0,130,4,34,0,168
 druid-master\druid-master\indexing-hadoop\src\test\java\org\apache\druid\indexer\BatchDeltaIngestionTest.java,0,69,0,25,0,94
 druid-master\druid-master\extensions-core\histogram\src\main\java\org\apache\druid\query\aggregation\histogram\FixedBucketsHistogramAggregatorFactory.java,0,134,2,17,0,153
 druid-master\druid-master\extensions-core\kinesis-indexing-service\src\main\java\org\apache\druid\indexing\kinesis\supervisor\KinesisSupervisorIngestionSpec.java,0,20,0,4,0,24
 druid-master\druid-master\processing\src\main\java\org\apache\druid\segment\column\FloatsColumnWithNulls.java,0,16,0,3,0,19
 druid-master\druid-master\extensions-core\lookups-cached-global\src\main\java\org\apache\druid\server\lookup\namespace\JdbcCacheGenerator.java,0,38,2,14,0,54
 druid-master\druid-master\extensions-core\histogram\src\test\java\org\apache\druid\query\aggregation\histogram\MinPostAggregatorTest.java,0,10,0,2,0,12
 druid-master\druid-master\extensions-core\ec2-extensions\src\test\java\org\apache\druid\indexing\overlord\autoscaling\ec2\EC2AutoScalerSerdeTest.java,0,27,0,14,0,41
 druid-master\druid-master\indexing-service\src\test\java\org\apache\druid\indexing\overlord\TaskQueueTest.java,0,113,9,37,0,159
 druid-master\druid-master\processing\src\test\java\org\apache\druid\collections\test\annotation\Benchmark.java,0,2,0,1,0,3
 druid-master\druid-master\server\src\test\java\org\apache\druid\client\BrokerServerViewTest.java,0,200,4,86,0,290
 druid-master\druid-master\processing\src\main\java\org\apache\druid\segment\writeout\FileWriteOutBytes.java,0,36,0,2,0,38
 druid-master\druid-master\core\src\main\java\org\apache\druid\data\input\impl\TimedShutoffInputSourceReader.java,0,33,1,10,0,44
 druid-master\druid-master\server\src\test\java\org\apache\druid\server\coordinator\DiskNormalizedCostBalancerStrategyTest.java,0,49,1,18,0,68
 druid-master\druid-master\core\src\main\java\org\apache\druid\common\utils\ByteUtils.java,0,6,0,1,0,7
 druid-master\druid-master\processing\src\main\java\org\apache\druid\query\aggregation\MetricManipulatorFns.java,0,23,1,7,0,31
 druid-master\druid-master\extensions-core\avro-extensions\target\generated-test-sources\avro\org\apache\druid\data\input\SomeAvroDatum.java,0,597,222,135,0,954
 druid-master\druid-master\server\src\main\java\org\apache\druid\server\coordinator\rules\DropRule.java,0,10,0,3,0,13
 druid-master\druid-master\extensions-core\datasketches\src\test\java\org\apache\druid\query\aggregation\datasketches\tuple\ArrayOfDoublesSketchToEstimatePostAggregatorTest.java,0,29,0,17,0,46
 druid-master\druid-master\indexing-service\src\test\java\org\apache\druid\indexing\overlord\sampler\SamplerTestUtils.java,0,12,1,1,0,14
 druid-master\druid-master\processing\src\main\java\org\apache\druid\query\groupby\epinephelinae\VectorGrouper.java,0,12,0,11,0,23
 druid-master\druid-master\server\src\main\java\org\apache\druid\server\RequestLogLine.java,0,77,1,9,0,87
 druid-master\druid-master\extensions-core\kinesis-indexing-service\src\main\java\org\apache\druid\indexing\kinesis\KinesisIndexTaskTuningConfig.java,0,126,0,23,0,149
 druid-master\druid-master\extensions-core\hdfs-storage\src\test\java\org\apache\druid\indexing\common\tasklogs\HdfsTaskLogsTest.java,0,28,0,13,0,41
 druid-master\druid-master\indexing-service\src\main\java\org\apache\druid\indexing\overlord\config\TaskQueueConfig.java,0,26,0,3,0,29
 druid-master\druid-master\extensions-core\datasketches\src\main\java\org\apache\druid\query\aggregation\datasketches\hll\HllSketchAggregatorFactory.java,0,69,1,8,0,78
 druid-master\druid-master\processing\src\test\java\org\apache\druid\segment\serde\NullColumnPartSerdeTest.java,0,10,0,6,0,16
 druid-master\druid-master\processing\src\main\java\org\apache\druid\segment\join\lookup\LookupColumnSelectorFactory.java,0,20,0,1,0,21
 druid-master\druid-master\processing\src\main\java\org\apache\druid\query\aggregation\first\LongFirstAggregatorFactory.java,0,105,0,17,0,122
 druid-master\druid-master\indexing-service\src\test\java\org\apache\druid\indexing\common\actions\TaskLocksTest.java,0,60,0,14,0,74
 druid-master\druid-master\processing\src\test\java\org\apache\druid\query\groupby\GroupByQueryRunnerTestHelper.java,0,32,1,12,0,45
 druid-master\druid-master\processing\src\main\java\org\apache\druid\query\groupby\GroupByQueryEngine.java,0,108,3,29,0,140
 druid-master\druid-master\server\src\test\java\org\apache\druid\server\scheduling\ThresholdBasedQueryPrioritizationStrategyTest.java,0,38,1,17,0,56
 druid-master\druid-master\server\src\test\java\org\apache\druid\segment\realtime\appenderator\UnifiedIndexerAppenderatorsManagerTest.java,0,93,10,26,0,129
 druid-master\druid-master\core\src\test\java\org\apache\druid\java\util\metrics\CpuAcctDeltaMonitorTest.java,0,19,3,5,1,28
 druid-master\druid-master\processing\src\test\java\org\apache\druid\segment\data\CompressedVSizeColumnarIntsSerializerTest.java,0,63,0,22,0,85
 druid-master\druid-master\extensions-contrib\time-min-max\src\main\java\org\apache\druid\query\aggregation\TimestampMinMaxModule.java,0,5,1,1,0,7
 druid-master\druid-master\extensions-contrib\influx-extensions\src\main\java\org\apache\druid\data\input\influx\InfluxParser.java,0,47,4,9,3,63
 druid-master\druid-master\core\src\main\java\org\apache\druid\java\util\emitter\core\ComposingEmitter.java,0,22,5,1,0,28
 druid-master\druid-master\processing\src\main\java\org\apache\druid\segment\DimensionHandlerUtils.java,0,153,0,60,0,213
 druid-master\druid-master\indexing-service\src\main\java\org\apache\druid\indexing\overlord\TaskRunnerListener.java,0,9,0,3,0,12
 druid-master\druid-master\processing\src\main\java\org\apache\druid\segment\vector\VectorValueSelector.java,0,11,0,7,0,18
 druid-master\druid-master\processing\src\test\java\org\apache\druid\segment\IdMappingTest.java,0,20,0,1,0,21
 druid-master\druid-master\sql\src\main\java\org\apache\druid\sql\calcite\rel\DruidUnionDataSourceRel.java,0,45,1,15,0,61
 druid-master\druid-master\server\src\test\java\org\apache\druid\client\CachingClusteredClientFunctionalityTest.java,0,96,2,28,0,126
 druid-master\druid-master\core\src\test\java\org\apache\druid\java\util\http\client\pool\ResourcePoolTest.java,0,97,10,21,5,133
 druid-master\druid-master\processing\src\main\java\org\apache\druid\query\expression\LookupExprMacro.java,0,31,0,11,0,42
 druid-master\druid-master\processing\src\main\java\org\apache\druid\query\groupby\having\NeverHavingSpec.java,0,9,0,1,0,10
 druid-master\druid-master\processing\src\main\java\org\apache\druid\collections\spatial\ImmutablePoint.java,0,17,0,2,0,19
 druid-master\druid-master\core\src\main\java\org\apache\druid\metadata\MapStringDynamicConfigProvider.java,0,9,0,2,0,11
 druid-master\druid-master\extensions-core\kafka-indexing-service\src\main\java\org\apache\druid\data\input\kafkainput\KafkaInputFormat.java,0,75,0,14,0,89
 druid-master\druid-master\cloud\aws-common\src\test\java\org\apache\druid\common\aws\AWSCredentialsConfigTest.java,0,28,0,16,0,44
 druid-master\druid-master\integration-tests\src\test\java\org\apache\druid\tests\query\ITQueryRetryTestOnMissingSegments.java,0,69,0,35,0,104
 druid-master\druid-master\server\src\main\java\org\apache\druid\server\coordinator\LoadQueueTaskMaster.java,0,30,0,2,0,32
 druid-master\druid-master\extensions-core\histogram\src\main\java\org\apache\druid\query\aggregation\histogram\ApproximateHistogramFoldingBufferAggregator.java,0,44,0,7,0,51
 druid-master\druid-master\processing\src\main\java\org\apache\druid\query\groupby\epinephelinae\GroupByBinaryFnV2.java,0,15,0,7,0,22
 druid-master\druid-master\sql\src\main\java\org\apache\druid\sql\calcite\expression\builtin\QueryLookupOperatorConversion.java,0,14,0,5,0,19
 druid-master\druid-master\server\src\main\java\org\apache\druid\server\router\ConsistentHashAvaticaConnectionBalancer.java,0,7,0,2,0,9
 druid-master\druid-master\extensions-core\histogram\src\test\java\org\apache\druid\query\aggregation\histogram\MaxPostAggregatorTest.java,0,10,0,2,0,12
 druid-master\druid-master\indexing-service\src\main\java\org\apache\druid\indexing\worker\shuffle\ShuffleMetrics.java,0,40,0,18,0,58
 druid-master\druid-master\processing\src\test\java\org\apache\druid\segment\filter\InFilterTest.java,0,74,2,30,0,106
 druid-master\druid-master\processing\src\test\java\org\apache\druid\query\aggregation\AggregatorUtilTest.java,0,22,0,10,0,32
 druid-master\druid-master\processing\src\main\java\org\apache\druid\segment\filter\ConstantValueMatcherFactory.java,0,29,0,7,0,36
 druid-master\druid-master\indexing-service\src\test\java\org\apache\druid\indexing\common\task\IndexIngestionSpecTest.java,0,14,4,5,0,23
 druid-master\druid-master\core\src\main\java\org\apache\druid\common\utils\SocketUtil.java,0,13,1,3,0,17
 druid-master\druid-master\server\src\test\java\org\apache\druid\segment\realtime\plumber\IntervalStartVersioningPolicyTest.java,0,3,0,1,0,4
 druid-master\druid-master\processing\src\main\java\org\apache\druid\query\spec\MultipleSpecificSegmentSpec.java,0,25,1,1,0,27
 druid-master\druid-master\indexing-hadoop\src\test\java\org\apache\druid\indexer\BucketTest.java,0,40,2,6,0,48
 druid-master\druid-master\extensions-core\kubernetes-extensions\src\main\java\org\apache\druid\k8s\discovery\K8sDruidNodeAnnouncer.java,0,89,1,29,0,119
 druid-master\druid-master\extensions-core\azure-extensions\src\main\java\org\apache\druid\storage\azure\AzureInputDataConfig.java,0,11,0,1,0,12
 druid-master\druid-master\processing\src\main\java\org\apache\druid\segment\data\VSizeColumnarInts.java,0,82,1,10,0,93
 druid-master\druid-master\processing\src\main\java\org\apache\druid\segment\RowAdapter.java,0,10,1,5,0,16
 druid-master\druid-master\server\src\main\java\org\apache\druid\server\http\HostAndPortWithScheme.java,0,53,0,7,0,60
 druid-master\druid-master\sql\src\main\java\org\apache\druid\sql\http\CsvWriter.java,0,25,0,7,0,32
 druid-master\druid-master\extensions-core\datasketches\src\main\java\org\apache\druid\query\aggregation\datasketches\RawInputValueExtractor.java,0,10,1,2,0,13
 druid-master\druid-master\indexing-service\src\test\java\org\apache\druid\indexing\common\task\batch\parallel\AbstractParallelIndexSupervisorTaskTest.java,0,326,8,94,0,428
 druid-master\druid-master\processing\src\main\java\org\apache\druid\segment\selector\settable\SettableObjectColumnValueSelector.java,0,10,0,2,0,12
 druid-master\druid-master\core\src\test\java\org\apache\druid\indexer\TaskLocationTest.java,0,14,0,4,0,18
 druid-master\druid-master\server\src\main\java\org\apache\druid\server\QueryResource.java,0,195,2,46,0,243
 druid-master\druid-master\server\src\test\java\org\apache\druid\guice\FirehoseModuleTest.java,0,19,1,11,0,31
 druid-master\druid-master\indexing-service\src\main\java\org\apache\druid\indexing\common\task\CompactionIntervalSpec.java,0,40,0,7,0,47
 druid-master\druid-master\extensions-core\orc-extensions\src\main\java\org\apache\druid\data\input\orc\OrcStructConverter.java,0,43,0,12,0,55
 druid-master\druid-master\core\src\main\java\org\apache\druid\data\input\impl\NestedInputFormat.java,0,14,0,2,0,16
 druid-master\druid-master\core\src\main\java\org\apache\druid\guice\Jerseys.java,0,10,2,2,0,14
 druid-master\druid-master\server\src\test\java\org\apache\druid\server\security\AllowHttpMethodsResourceFilterTest.java,0,21,0,6,0,27
 druid-master\druid-master\server\src\main\java\org\apache\druid\server\LocalQuerySegmentWalker.java,0,34,0,14,0,48
 druid-master\druid-master\server\src\main\java\org\apache\druid\client\selector\CustomTierSelectorStrategyConfig.java,0,5,0,1,0,6
 druid-master\druid-master\extensions-core\avro-extensions\src\main\java\org\apache\druid\data\input\avro\SchemaRegistryBasedAvroBytesDecoder.java,0,61,1,11,0,73
 druid-master\druid-master\extensions-core\datasketches\src\main\java\org\apache\druid\query\aggregation\datasketches\tuple\package-info.java,0,1,0,1,0,2
 druid-master\druid-master\indexing-service\src\main\java\org\apache\druid\indexing\common\task\CompactionTask.java,0,428,2,161,0,591
 druid-master\druid-master\indexing-service\src\main\java\org\apache\druid\indexing\worker\shuffle\IntermediaryDataManager.java,0,20,0,10,0,30
 druid-master\druid-master\server\src\test\java\org\apache\druid\discovery\DataNodeServiceTest.java,0,19,0,4,0,23
 druid-master\druid-master\server\src\test\java\org\apache\druid\server\coordination\SegmentLoadDropHandlerCacheTest.java,0,46,1,9,0,56
 druid-master\druid-master\extensions-core\datasketches\src\main\java\org\apache\druid\query\aggregation\datasketches\theta\SketchToStringPostAggregator.java,0,38,0,3,0,41
 druid-master\druid-master\server\src\main\java\org\apache\druid\server\coordination\CuratorDataSegmentServerAnnouncer.java,0,27,1,3,0,31
 druid-master\druid-master\extensions-core\druid-kerberos\src\test\java\org\apache\druid\security\kerberos\KerberosUtilTest.java,0,8,0,5,0,13
 druid-master\druid-master\processing\src\test\java\org\apache\druid\segment\vector\BitmapVectorOffsetTest.java,0,29,0,15,0,44
 druid-master\druid-master\extensions-core\hdfs-storage\src\main\java\org\apache\druid\storage\hdfs\HdfsStorageDruidModule.java,0,25,0,11,0,36
 druid-master\druid-master\extensions-core\druid-basic-security\src\main\java\org\apache\druid\security\basic\authorization\entity\GroupMappingAndRoleMap.java,0,16,0,2,0,18
 druid-master\druid-master\processing\src\main\java\org\apache\druid\query\groupby\epinephelinae\vector\GroupByVectorColumnSelector.java,0,14,0,13,0,27
 druid-master\druid-master\extensions-core\datasketches\src\main\java\org\apache\druid\query\aggregation\datasketches\hll\HllSketchMergeComplexMetricSerde.java,0,22,0,9,0,31
 druid-master\druid-master\indexing-service\src\test\java\org\apache\druid\indexing\seekablestream\supervisor\SeekableStreamSupervisorStateTest.java,0,440,5,208,0,653
 druid-master\druid-master\extensions-core\kinesis-indexing-service\src\test\java\org\apache\druid\indexing\kinesis\KinesisDataSourceMetadataTest.java,0,39,0,16,0,55
 druid-master\druid-master\extensions-core\druid-basic-security\src\test\java\org\apache\druid\security\authorization\CoordinatorBasicAuthorizerResourceTest.java,0,304,2,138,0,444
 druid-master\druid-master\extensions-core\stats\src\test\java\org\apache\druid\query\aggregation\variance\VarianceAggregatorTest.java,0,116,0,34,0,150
 druid-master\druid-master\processing\src\main\java\org\apache\druid\segment\data\TableLongEncodingWriter.java,0,36,0,3,0,39
 druid-master\druid-master\indexing-service\src\test\java\org\apache\druid\indexing\test\TestDataSegmentAnnouncer.java,0,16,0,1,0,17
 druid-master\druid-master\processing\src\main\java\org\apache\druid\query\aggregation\LongSumAggregateCombiner.java,0,7,0,1,0,8
 druid-master\druid-master\extensions-core\lookups-cached-single\src\test\java\org\apache\druid\server\lookup\PollingLookupFactoryTest.java,0,16,0,2,0,18
 druid-master\druid-master\processing\src\test\java\org\apache\druid\segment\StringDimensionIndexerTest.java,0,43,3,4,0,50
 druid-master\druid-master\benchmarks\src\test\java\org\apache\druid\benchmark\sequences\ParallelMergeCombiningSequenceThreadedBenchmark.java,0,22,0,5,0,27
 druid-master\druid-master\processing\src\main\java\org\apache\druid\query\topn\TopNBinaryFn.java,0,25,0,8,0,33
 druid-master\druid-master\indexing-service\src\main\java\org\apache\druid\indexing\common\task\RestoreTask.java,0,17,2,4,0,23
 druid-master\druid-master\extensions-core\stats\src\test\java\org\apache\druid\query\aggregation\variance\sql\VarianceSqlAggregatorTest.java,0,144,0,89,0,233
 druid-master\druid-master\core\src\main\java\org\apache\druid\data\input\impl\DelimitedInputFormat.java,0,28,0,6,0,34
 druid-master\druid-master\indexing-hadoop\src\main\java\org\apache\druid\indexer\MetadataStorageUpdaterJob.java,0,15,0,5,0,20
 druid-master\druid-master\core\src\main\java\org\apache\druid\common\utils\IdUtils.java,0,55,1,13,0,69
 druid-master\druid-master\hll\src\main\java\org\apache\druid\hll\VersionOneHyperLogLogCollector.java,0,72,0,11,0,83
 druid-master\druid-master\server\src\test\java\org\apache\druid\server\http\security\PreResponseAuthorizationCheckFilterTest.java,0,46,1,31,0,78
 druid-master\druid-master\sql\src\main\java\org\apache\druid\sql\calcite\view\ViewManager.java,0,8,0,4,0,12
 druid-master\druid-master\core\src\main\java\org\apache\druid\utils\CollectionUtils.java,0,66,3,18,0,87
 druid-master\druid-master\core\src\main\java\org\apache\druid\data\input\impl\JavaScriptParseSpec.java,0,26,0,4,1,31
 druid-master\druid-master\extensions-core\druid-bloom-filter\src\main\java\org\apache\druid\query\aggregation\bloom\sql\BloomFilterSqlAggregator.java,0,37,0,16,0,53
 druid-master\druid-master\extensions-core\azure-extensions\src\main\java\org\apache\druid\storage\azure\AzureByteSourceFactory.java,0,4,0,2,0,6
 druid-master\druid-master\processing\src\test\java\org\apache\druid\segment\filter\InvalidFilteringTest.java,0,38,0,13,0,51
 druid-master\druid-master\processing\src\test\java\org\apache\druid\segment\join\NoopDataSource.java,0,16,2,2,0,20
 druid-master\druid-master\web-console\node_modules\ace-builds\demo\kitchen-sink\docs\java.java,16,7,4,2,0,13
 druid-master\druid-master\extensions-core\datasketches\src\main\java\org\apache\druid\query\aggregation\datasketches\quantiles\DoublesSketchAggregatorFactory.java,0,133,0,27,0,160
 druid-master\druid-master\indexing-service\src\test\java\org\apache\druid\indexing\common\TaskLockTest.java,0,43,1,2,0,46
 druid-master\druid-master\server\src\main\java\org\apache\druid\server\router\ConsistentHasher.java,0,32,1,4,0,37
 druid-master\druid-master\cloud\gcp-common\src\main\java\org\apache\druid\common\gcp\GcpModule.java,0,21,0,5,0,26
 druid-master\druid-master\extensions-core\histogram\src\test\java\org\apache\druid\query\aggregation\histogram\ApproximateHistogramTest.java,0,468,0,32,0,500
 druid-master\druid-master\integration-tests\src\test\java\org\apache\druid\tests\indexer\AbstractS3InputSourceParallelIndexTest.java,0,26,1,10,0,37
 druid-master\druid-master\processing\src\main\java\org\apache\druid\segment\FloatDimensionMergerV9.java,0,12,0,4,0,16
 druid-master\druid-master\extensions-contrib\distinctcount\src\main\java\org\apache\druid\query\aggregation\distinctcount\RoaringBitMapFactory.java,0,14,2,2,0,18
 druid-master\druid-master\processing\src\main\java\org\apache\druid\query\Queries.java,0,68,1,44,0,113
 druid-master\druid-master\processing\src\main\java\org\apache\druid\segment\join\JoinType.java,0,17,0,3,0,20
 druid-master\druid-master\core\src\main\java\org\apache\druid\guice\annotations\ExtensionPoint.java,0,11,0,11,0,22
 druid-master\druid-master\integration-tests\src\test\java\org\apache\druid\tests\indexer\AbstractStreamIndexingTest.java,0,264,13,104,0,381
 druid-master\druid-master\core\src\main\java\org\apache\druid\data\input\impl\FlatTextInputFormat.java,0,46,1,5,1,53
 druid-master\druid-master\processing\src\main\java\org\apache\druid\segment\data\ComparableList.java,0,26,3,4,0,33
 druid-master\druid-master\core\src\main\java\org\apache\druid\java\util\http\client\response\FullResponseHolder.java,0,14,0,2,0,16
 druid-master\druid-master\extensions-core\lookups-cached-global\src\test\java\org\apache\druid\server\lookup\namespace\JdbcCacheGeneratorTest.java,0,32,1,12,0,45
 druid-master\druid-master\processing\src\main\java\org\apache\druid\query\filter\AbstractOptimizableDimFilter.java,0,7,0,3,0,10
 druid-master\druid-master\sql\src\main\java\org\apache\druid\sql\SqlLifecycle.java,0,164,7,50,0,221
 druid-master\druid-master\server\src\main\java\org\apache\druid\server\QueryLifecycle.java,0,95,3,25,0,123
 druid-master\druid-master\processing\src\main\java\org\apache\druid\segment\SegmentMissingException.java,0,11,0,2,0,13
 druid-master\druid-master\processing\src\main\java\org\apache\druid\jackson\DefaultObjectMapper.java,0,11,0,1,0,12
 druid-master\druid-master\processing\src\main\java\org\apache\druid\query\TimewarpOperator.java,0,37,0,13,0,50
 druid-master\druid-master\extensions-core\datasketches\src\main\java\org\apache\druid\query\aggregation\datasketches\quantiles\NoopDoublesSketchBufferAggregator.java,0,29,0,3,0,32
 druid-master\druid-master\core\src\main\java\org\apache\druid\utils\RuntimeInfo.java,0,27,1,8,0,36
 druid-master\druid-master\extensions-core\druid-basic-security\src\main\java\org\apache\druid\security\basic\authentication\db\updater\CoordinatorBasicAuthenticatorMetadataStorageUpdater.java,0,141,6,50,0,197
 druid-master\druid-master\processing\src\main\java\org\apache\druid\query\expression\ContainsExprMacro.java,0,9,0,4,0,13
 druid-master\druid-master\processing\src\main\java\org\apache\druid\segment\IndexIO.java,0,200,3,65,0,268
 druid-master\druid-master\core\src\main\java\org\apache\druid\math\expr\vector\DoubleOutLongDoubleInFunctionVectorValueProcessor.java,0,16,0,2,0,18
 druid-master\druid-master\integration-tests\src\test\java\org\apache\druid\tests\security\ITBasicAuthLdapConfigurationTest.java,0,58,2,15,0,75
 druid-master\druid-master\processing\src\main\java\org\apache\druid\segment\ReferenceCountedObject.java,0,10,0,9,0,19
 druid-master\druid-master\extensions-core\hdfs-storage\src\test\java\org\apache\druid\inputsource\hdfs\HdfsInputSourceTest.java,0,103,0,27,0,130
 druid-master\druid-master\server\src\main\java\org\apache\druid\server\coordinator\CachingCostBalancerStrategyConfig.java,0,5,0,1,0,6
 druid-master\druid-master\server\src\main\java\org\apache\druid\server\coordinator\DataSourceCompactionConfig.java,0,106,0,12,0,118
 druid-master\druid-master\integration-tests\src\main\java\org\apache\druid\cli\CliCustomNodeRole.java,0,36,0,13,0,49
 druid-master\druid-master\processing\src\test\java\org\apache\druid\segment\loading\BroadcastJoinableMMappedQueryableSegmentizerFactoryTest.java,0,19,0,14,0,33
 druid-master\druid-master\server\src\main\java\org\apache\druid\server\ClientQuerySegmentWalker.java,0,196,0,88,0,284
 druid-master\druid-master\extensions-core\datasketches\src\main\java\org\apache\druid\query\aggregation\datasketches\tuple\ArrayOfDoublesSketchObjectStrategy.java,0,15,1,6,0,22
 druid-master\druid-master\extensions-core\google-extensions\src\test\java\org\apache\druid\storage\google\ObjectStorageIteratorTest.java,0,74,7,21,0,102
 druid-master\druid-master\processing\src\main\java\org\apache\druid\query\groupby\GroupByQuery.java,0,498,4,88,0,590
 druid-master\druid-master\processing\src\main\java\org\apache\druid\query\filter\vector\FloatVectorValueMatcher.java,0,19,0,4,0,23
 druid-master\druid-master\extensions-contrib\materialized-view-selection\src\main\java\org\apache\druid\query\materializedview\MaterializedViewConfig.java,0,5,0,1,0,6
 druid-master\druid-master\processing\src\main\java\org\apache\druid\query\search\CursorOnlyStrategy.java,0,32,0,7,0,39
 druid-master\druid-master\server\src\main\java\org\apache\druid\query\lookup\LookupListeningResource.java,0,31,0,13,0,44
 druid-master\druid-master\services\src\main\java\org\apache\druid\server\router\TimeBoundaryTieredBrokerSelectorStrategy.java,0,8,0,4,0,12
 druid-master\druid-master\core\src\main\java\org\apache\druid\timeline\partition\SingleDimensionPartialShardSpec.java,0,51,0,3,0,54
 druid-master\druid-master\core\src\main\java\org\apache\druid\java\util\common\concurrent\DummyExecutorService.java,0,33,0,3,0,36
 druid-master\druid-master\extensions-core\avro-extensions\src\main\java\org\apache\druid\data\input\avro\AvroOCFReader.java,0,39,0,7,0,46
 druid-master\druid-master\processing\src\main\java\org\apache\druid\segment\ColumnValueSelector.java,0,11,1,8,0,20
 druid-master\druid-master\extensions-core\datasketches\src\test\java\org\apache\druid\query\aggregation\datasketches\hll\sql\HllSketchSqlAggregatorTest.java,0,91,0,65,0,156
 druid-master\druid-master\processing\src\test\java\org\apache\druid\query\expression\ExprMacroTest.java,0,68,3,29,0,100
 druid-master\druid-master\processing\src\main\java\org\apache\druid\segment\data\CompressedColumnarIntsSerializer.java,0,36,0,6,0,42
 druid-master\druid-master\extensions-core\druid-basic-security\src\main\java\org\apache\druid\security\basic\BasicAuthLDAPConfig.java,0,54,0,1,0,55
 druid-master\druid-master\core\src\main\java\org\apache\druid\common\guava\CombiningSequence.java,0,76,3,6,0,85
 druid-master\druid-master\core\src\main\java\org\apache\druid\java\util\common\io\Closer.java,0,58,4,32,1,95
 druid-master\druid-master\processing\src\main\java\org\apache\druid\query\groupby\GroupByQueryMetricsFactory.java,0,3,0,1,0,4
 druid-master\druid-master\extensions-core\hdfs-storage\src\test\java\org\apache\druid\firehose\hdfs\HdfsFirehoseFactoryTest.java,0,23,0,6,0,29
 druid-master\druid-master\sql\src\main\java\org\apache\druid\sql\calcite\expression\builtin\TimeShiftOperatorConversion.java,0,9,0,3,0,12
 druid-master\druid-master\processing\src\main\java\org\apache\druid\segment\data\EntireLayoutColumnarLongsSupplier.java,0,21,1,3,0,25
 druid-master\druid-master\processing\src\main\java\org\apache\druid\query\expression\TimestampFloorExprMacro.java,0,56,0,9,0,65
 druid-master\druid-master\server\src\main\java\org\apache\druid\segment\loading\LocalLoadSpec.java,0,16,0,4,0,20
 druid-master\druid-master\processing\src\main\java\org\apache\druid\collections\bitmap\WrappedRoaringBitmap.java,0,52,0,5,0,57
 druid-master\druid-master\server\src\main\java\org\apache\druid\server\StatusResource.java,0,112,2,11,0,125
 druid-master\druid-master\indexing-service\src\main\java\org\apache\druid\indexing\common\task\batch\parallel\SubTaskReport.java,0,7,0,6,0,13
 druid-master\druid-master\extensions-contrib\distinctcount\src\main\java\org\apache\druid\query\aggregation\distinctcount\NoopDistinctCountBufferAggregator.java,0,28,3,4,0,35
 druid-master\druid-master\processing\src\main\java\org\apache\druid\query\aggregation\DoubleMinAggregateCombiner.java,0,7,0,1,0,8
 druid-master\druid-master\processing\src\main\java\org\apache\druid\segment\virtual\VirtualizedColumnSelectorFactory.java,0,16,0,3,0,19
 druid-master\druid-master\server\src\main\java\org\apache\druid\segment\realtime\plumber\PlumberSchool.java,0,7,0,3,0,10
 druid-master\druid-master\indexing-hadoop\src\test\java\org\apache\druid\indexer\hadoop\DatasourceIngestionSpecTest.java,0,18,0,8,0,26
 druid-master\druid-master\processing\src\main\java\org\apache\druid\segment\filter\NotFilter.java,0,61,0,7,0,68
 druid-master\druid-master\extensions-core\histogram\src\test\java\org\apache\druid\query\aggregation\histogram\BucketsPostAggregatorTest.java,0,16,0,6,0,22
 druid-master\druid-master\extensions-core\druid-basic-security\src\main\java\org\apache\druid\security\basic\authentication\endpoint\DefaultBasicAuthenticatorResourceHandler.java,0,53,0,13,0,66
 druid-master\druid-master\extensions-core\s3-extensions\src\main\java\org\apache\druid\storage\s3\S3DataSegmentArchiver.java,0,27,0,5,0,32
 druid-master\druid-master\extensions-contrib\momentsketch\src\main\java\org\apache\druid\query\aggregation\momentsketch\MomentSketchJsonSerializer.java,0,7,0,2,0,9
 druid-master\druid-master\sql\src\main\java\org\apache\druid\sql\calcite\planner\DruidTypeSystem.java,0,24,1,5,0,30
 druid-master\druid-master\extensions-contrib\cloudfiles-extensions\src\main\java\org\apache\druid\firehose\cloudfiles\CloudFilesFirehoseDruidModule.java,0,6,1,2,0,9
 druid-master\druid-master\integration-tests\src\main\java\org\apache\druid\testing\utils\HttpUtil.java,0,24,2,4,0,30
 druid-master\druid-master\server\src\main\java\org\apache\druid\server\coordinator\DruidCluster.java,0,77,2,9,0,88
 druid-master\druid-master\integration-tests\src\test\java\org\apache\druid\tests\query\ITWikipediaQueryTest.java,0,52,0,24,0,76
 druid-master\druid-master\extensions-core\azure-extensions\src\main\java\org\apache\druid\storage\azure\AzureByteSource.java,0,22,1,2,0,25
 druid-master\druid-master\server\src\main\java\org\apache\druid\client\DruidDataSource.java,0,62,0,10,0,72
 druid-master\druid-master\extensions-contrib\ambari-metrics-emitter\src\main\java\org\apache\druid\emitter\ambari\metrics\AmbariMetricsEmitter.java,0,73,9,14,0,96
 druid-master\druid-master\integration-tests\src\main\java\org\apache\druid\testing\utils\KinesisEventWriter.java,0,28,0,2,0,30
 druid-master\druid-master\extensions-core\druid-bloom-filter\src\main\java\org\apache\druid\guice\BloomFilterSerializersModule.java,0,37,0,12,0,49
 druid-master\druid-master\processing\src\main\java\org\apache\druid\segment\serde\MetaSerdeHelper.java,0,54,0,3,0,57
 druid-master\druid-master\extensions-core\druid-basic-security\src\main\java\org\apache\druid\security\basic\authorization\db\cache\CoordinatorPollingBasicAuthorizerCacheManager.java,0,143,2,63,0,208
 druid-master\druid-master\processing\src\test\java\org\apache\druid\query\expression\CaseInsensitiveExprMacroTest.java,0,40,0,15,0,55
 druid-master\druid-master\indexing-service\src\main\java\org\apache\druid\indexing\seekablestream\supervisor\autoscaler\AutoScalerConfig.java,0,9,0,4,0,13
 druid-master\druid-master\integration-tests\src\main\java\org\apache\druid\testing\clients\AbstractQueryResourceTestClient.java,0,73,1,12,0,86
 druid-master\druid-master\extensions-core\kubernetes-extensions\src\main\java\org\apache\druid\k8s\discovery\K8sDruidLeaderSelector.java,0,40,4,7,0,51
 druid-master\druid-master\core\src\main\java\org\apache\druid\math\expr\vector\StringOutMultiStringInVectorProcessor.java,0,20,0,2,2,24
 druid-master\druid-master\core\src\main\java\org\apache\druid\java\util\common\parsers\CloseableIterator.java,0,20,0,3,0,23
 druid-master\druid-master\extensions-core\histogram\src\main\java\org\apache\druid\query\aggregation\histogram\ApproximateHistogramBufferAggregator.java,0,41,0,6,0,47
 druid-master\druid-master\server\src\main\java\org\apache\druid\server\coordinator\cost\ServerCostCache.java,0,39,0,9,0,48
 druid-master\druid-master\processing\src\main\java\org\apache\druid\segment\writeout\DirectByteBufferWriteOutBytes.java,0,3,0,1,0,4
 druid-master\druid-master\server\src\test\java\org\apache\druid\server\QueryResourceTest.java,0,333,7,185,0,525
 druid-master\druid-master\integration-tests\src\test\java\org\apache\druid\tests\indexer\ITOssToOssParallelIndexTest.java,0,12,0,9,0,21
 druid-master\druid-master\processing\src\main\java\org\apache\druid\segment\incremental\SpatialDimensionRowTransformer.java,0,46,2,9,0,57
 druid-master\druid-master\processing\src\main\java\org\apache\druid\query\aggregation\hyperloglog\HyperUniquesBufferAggregator.java,0,51,0,8,0,59
 druid-master\druid-master\server\src\main\java\org\apache\druid\server\emitter\HttpEmitterModule.java,0,35,0,10,0,45
 druid-master\druid-master\server\src\test\java\org\apache\druid\server\log\DefaultRequestLogEventTest.java,0,24,4,9,0,37
 druid-master\druid-master\processing\src\test\java\org\apache\druid\query\LookupDataSourceTest.java,0,37,9,8,0,54
 druid-master\druid-master\extensions-core\datasketches\src\test\java\org\apache\druid\query\aggregation\datasketches\tuple\ArrayOfDoublesSketchToEstimateAndBoundsPostAggregatorTest.java,0,17,0,8,0,25
 druid-master\druid-master\server\src\main\java\org\apache\druid\segment\indexing\granularity\ArbitraryGranularitySpec.java,0,45,0,6,0,51
 druid-master\druid-master\integration-tests\src\main\java\org\apache\druid\testing\utils\ITRetryUtil.java,0,24,1,3,0,28
 druid-master\druid-master\extensions-core\google-extensions\src\test\java\org\apache\druid\storage\google\GoogleTimestampVersionedDataFinderTest.java,0,25,0,17,0,42
 druid-master\druid-master\services\src\main\java\org\apache\druid\cli\ResetCluster.java,0,46,0,18,0,64
 druid-master\druid-master\extensions-core\datasketches\src\main\java\org\apache\druid\query\aggregation\datasketches\quantiles\DoublesSketchOperations.java,0,13,1,5,0,19
 druid-master\druid-master\sql\src\test\java\org\apache\druid\sql\calcite\schema\NamedSystemSchemaTest.java,0,18,0,4,0,22
 druid-master\druid-master\processing\src\main\java\org\apache\druid\segment\selector\settable\SettableValueFloatColumnValueSelector.java,0,17,1,3,0,21
 druid-master\druid-master\indexing-hadoop\src\test\java\org\apache\druid\indexer\HadoopyStringInputRowParserTest.java,0,5,0,3,0,8
 druid-master\druid-master\processing\src\test\java\org\apache\druid\query\dimension\TestDimensionSelector.java,0,24,1,2,0,27
 druid-master\druid-master\sql\src\main\java\org\apache\druid\sql\calcite\expression\builtin\ArrayLengthOperatorConversion.java,0,4,0,1,0,5
 druid-master\druid-master\extensions-core\protobuf-extensions\src\test\java\org\apache\druid\data\input\protobuf\ProtobufReaderTest.java,0,54,0,19,0,73
 druid-master\druid-master\core\src\main\java\org\apache\druid\java\util\common\granularity\NoneGranularity.java,0,37,3,4,0,44
 druid-master\druid-master\core\src\main\java\org\apache\druid\java\util\emitter\core\HttpPostEmitter.java,0,301,13,95,1,410
 druid-master\druid-master\server\src\test\java\org\apache\druid\segment\indexing\granularity\ArbitraryGranularityTest.java,0,30,2,9,0,41
 druid-master\druid-master\server\src\main\java\org\apache\druid\query\ResultLevelCachingQueryRunner.java,0,99,6,30,0,135
 druid-master\druid-master\processing\src\test\java\org\apache\druid\query\aggregation\any\DoubleAnyVectorAggregatorTest.java,0,28,0,1,0,29
 druid-master\druid-master\processing\src\main\java\org\apache\druid\query\search\SearchQuery.java,0,86,1,8,0,95
 druid-master\druid-master\server\src\main\java\org\apache\druid\client\cache\BytesBoundedLinkedQueue.java,0,92,1,5,0,98
 druid-master\druid-master\processing\src\test\java\org\apache\druid\query\aggregation\any\LongAnyAggregationTest.java,0,54,0,8,0,62
 druid-master\druid-master\processing\src\main\java\org\apache\druid\query\expression\LikeExprMacro.java,0,25,1,9,0,35
 druid-master\druid-master\core\src\main\java\org\apache\druid\java\util\metrics\SysMonitor.java,0,103,12,18,0,133
 druid-master\druid-master\server\src\main\java\org\apache\druid\server\security\AllowAllAuthorizer.java,0,7,0,2,0,9
 druid-master\druid-master\sql\src\test\java\org\apache\druid\sql\calcite\util\TestServerInventoryView.java,0,64,0,17,0,81
 druid-master\druid-master\benchmarks\src\test\java\org\apache\druid\benchmark\StupidPoolConcurrencyBenchmark.java,0,12,0,1,0,13
 druid-master\druid-master\core\src\main\java\org\apache\druid\common\guava\SettableSupplier.java,0,16,1,1,0,18
 druid-master\druid-master\extensions-core\kinesis-indexing-service\src\main\java\org\apache\druid\indexing\kinesis\supervisor\KinesisSupervisorIOConfig.java,0,88,1,16,0,105
 druid-master\druid-master\extensions-contrib\opentelemetry-emitter\src\main\java\org\apache\druid\emitter\opentelemetry\OpenTelemetryEmitter.java,0,26,5,7,0,38
 druid-master\druid-master\server\src\main\java\org\apache\druid\server\coordinator\rules\BroadcastDistributionRule.java,0,32,2,9,0,43
 druid-master\druid-master\benchmarks\src\test\java\org\apache\druid\benchmark\FlattenJSONBenchmarkUtilTest.java,0,26,0,16,0,42
 druid-master\druid-master\server\src\test\java\org\apache\druid\discovery\BaseNodeRoleWatcherTest.java,0,38,0,12,0,50
 druid-master\druid-master\processing\src\main\java\org\apache\druid\segment\generator\GeneratorSchemaInfo.java,0,42,0,3,0,45
 druid-master\druid-master\server\src\main\java\org\apache\druid\guice\StartupLoggingModule.java,0,5,0,2,0,7
 druid-master\druid-master\processing\src\main\java\org\apache\druid\query\topn\DefaultTopNQueryMetricsFactory.java,0,8,0,3,0,11
 druid-master\druid-master\server\src\main\java\org\apache\druid\discovery\BaseNodeRoleWatcher.java,0,72,8,24,0,104
 druid-master\druid-master\sql\src\test\java\org\apache\druid\sql\calcite\util\TestDruidViewMacroFactory.java,0,6,0,2,0,8
 druid-master\druid-master\indexing-service\src\main\java\org\apache\druid\indexing\overlord\setup\FillCapacityWorkerSelectStrategy.java,0,22,0,3,0,25
 druid-master\druid-master\core\src\main\java\org\apache\druid\timeline\partition\PartitionHolder.java,0,62,0,8,0,70
 druid-master\druid-master\core\src\main\java\org\apache\druid\java\util\common\guava\ExecuteWhenDoneYielder.java,0,26,2,3,0,31
 druid-master\druid-master\processing\src\main\java\org\apache\druid\segment\data\SingleValueColumnarIntsSerializer.java,0,3,0,2,0,5
 druid-master\druid-master\server\src\test\java\org\apache\druid\query\RetryQueryRunnerTest.java,0,69,0,27,0,96
 druid-master\druid-master\sql\src\test\java\org\apache\druid\sql\calcite\planner\CalcitesTest.java,0,17,0,15,0,32
 druid-master\druid-master\server\src\main\java\org\apache\druid\guice\security\DruidAuthModule.java,0,6,0,1,0,7
 druid-master\druid-master\indexing-hadoop\src\test\java\org\apache\druid\indexer\path\DatasourcePathSpecTest.java,0,41,1,16,0,58
 druid-master\druid-master\server\src\main\java\org\apache\druid\server\coordinator\LoadPeonCallback.java,0,6,0,6,0,12
 druid-master\druid-master\server\src\test\java\org\apache\druid\server\QuerySchedulerTest.java,0,204,0,71,0,275
 druid-master\druid-master\core\src\main\java\org\apache\druid\java\util\emitter\core\ParametrizedUriEmitter.java,0,68,2,12,0,82
 druid-master\druid-master\sql\src\main\java\org\apache\druid\sql\calcite\schema\LookupSchema.java,0,15,0,8,0,23
 druid-master\druid-master\core\src\main\java\org\apache\druid\timeline\TimelineObjectHolder.java,0,53,2,3,2,60
 druid-master\druid-master\extensions-contrib\aliyun-oss-extensions\src\main\java\org\apache\druid\storage\aliyun\OssLoadSpec.java,0,22,0,2,0,24
 druid-master\druid-master\processing\src\main\java\org\apache\druid\segment\column\ColumnBuilder.java,0,72,0,7,0,79
 druid-master\druid-master\processing\src\test\java\org\apache\druid\query\search\DefaultSearchQueryMetricsTest.java,0,17,0,12,0,29
 druid-master\druid-master\server\src\test\java\org\apache\druid\client\DruidServerConfigTest.java,0,36,0,19,0,55
 druid-master\druid-master\processing\src\main\java\org\apache\druid\query\aggregation\CountAggregatorFactory.java,0,58,1,3,0,62
 druid-master\druid-master\server\src\test\java\org\apache\druid\server\coordinator\duty\KillSupervisorsTest.java,0,31,0,14,0,45
 druid-master\druid-master\processing\src\main\java\org\apache\druid\query\groupby\epinephelinae\ByteBufferHashTable.java,0,128,1,22,0,151
 druid-master\druid-master\core\src\main\java\org\apache\druid\java\util\emitter\factory\EmitterFactory.java,0,5,0,3,0,8
 druid-master\druid-master\integration-tests\src\test\java\org\apache\druid\tests\hadoop\ITS3InputToS3HadoopIndexTest.java,0,11,0,9,0,20
 druid-master\druid-master\extensions-core\s3-extensions\src\main\java\org\apache\druid\storage\s3\ServerSideEncryption.java,0,9,0,1,0,10
 druid-master\druid-master\extensions-core\datasketches\src\main\java\org\apache\druid\query\aggregation\datasketches\theta\oldapi\OldSketchSetPostAggregator.java,0,7,0,2,0,9
 druid-master\druid-master\extensions-core\s3-extensions\src\main\java\org\apache\druid\storage\s3\ServerSideEncryptingAmazonS3.java,0,108,0,13,0,121
 druid-master\druid-master\server\src\main\java\org\apache\druid\client\cache\CacheConfig.java,0,45,0,2,0,47
 druid-master\druid-master\indexing-service\src\main\java\org\apache\druid\indexing\common\actions\MarkSegmentsAsUnusedAction.java,0,25,1,2,0,28
 druid-master\druid-master\processing\src\test\java\org\apache\druid\collections\bitmap\WrappedRoaringBitmapTest.java,0,22,0,4,0,26
 druid-master\druid-master\server\src\test\java\org\apache\druid\client\cache\MapCacheTest.java,0,29,0,1,0,30
 druid-master\druid-master\server\src\test\java\org\apache\druid\segment\realtime\appenderator\OpenAndClosedSegmentsBatchAppenderatorTest.java,0,48,2,23,0,73
 druid-master\druid-master\integration-tests\src\main\java\org\apache\druid\testing\utils\KafkaAdminClient.java,0,41,0,14,0,55
 druid-master\druid-master\core\src\test\java\org\apache\druid\java\util\common\guava\FunctionalIterableTest.java,0,25,0,1,4,30
 druid-master\druid-master\server\src\test\java\org\apache\druid\segment\loading\OmniDataSegmentMoverTest.java,0,12,0,6,0,18
 druid-master\druid-master\core\src\main\java\org\apache\druid\math\expr\Function.java,0,1730,7,261,0,1998
 druid-master\druid-master\extensions-core\datasketches\src\main\java\org\apache\druid\query\aggregation\datasketches\theta\sql\ThetaSketchEstimateWithErrorBoundsOperatorConversion.java,0,20,0,6,0,26
 druid-master\druid-master\server\src\test\java\org\apache\druid\server\coordination\ServerTypeTest.java,0,13,0,5,0,18
 druid-master\druid-master\server\src\test\java\org\apache\druid\server\coordinator\HttpLoadQueuePeonTest.java,0,42,0,14,0,56
 druid-master\druid-master\indexing-service\src\test\java\org\apache\druid\indexing\overlord\ForkingTaskRunnerTest.java,0,129,0,42,0,171
 druid-master\druid-master\indexing-service\src\test\java\org\apache\druid\indexing\seekablestream\SequenceMetadataTest.java,0,29,0,19,0,48
 druid-master\druid-master\server\src\main\java\org\apache\druid\client\indexing\ClientCompactionTaskQueryTuningConfig.java,0,181,0,17,0,198
 druid-master\druid-master\processing\src\test\java\org\apache\druid\query\groupby\GroupByMultiSegmentTest.java,0,77,2,14,0,93
 druid-master\druid-master\sql\src\main\java\org\apache\druid\sql\calcite\rule\DruidUnionRule.java,0,13,0,3,0,16
 druid-master\druid-master\indexing-service\src\test\java\org\apache\druid\indexing\common\task\batch\parallel\iterator\IndexTaskInputRowIteratorBuilderTestingFactory.java,0,55,1,13,0,69
 druid-master\druid-master\core\src\main\java\org\apache\druid\collections\BlockingPool.java,0,8,0,6,0,14
 druid-master\druid-master\indexing-service\src\main\java\org\apache\druid\indexing\overlord\config\HttpRemoteTaskRunnerConfig.java,0,32,0,1,0,33
 druid-master\druid-master\core\src\test\java\org\apache\druid\java\util\common\TripleTest.java,0,6,0,2,0,8
 druid-master\druid-master\extensions-core\protobuf-extensions\src\test\java\org\apache\druid\data\input\protobuf\ProtoTestEventWrapper.java,0,978,467,186,0,1631
 druid-master\druid-master\integration-tests\src\test\java\org\apache\druid\tests\indexer\ITAppendBatchIndexTest.java,0,49,2,23,0,74
 druid-master\druid-master\processing\src\main\java\org\apache\druid\query\filter\SpatialDimFilter.java,0,54,0,3,0,57
 druid-master\druid-master\processing\src\main\java\org\apache\druid\query\filter\vector\StringObjectVectorValueMatcher.java,0,21,0,3,0,24
 druid-master\druid-master\extensions-contrib\moving-average-query\src\main\java\org\apache\druid\query\movingaverage\MovingAverageQueryMetrics.java,0,8,0,5,0,13
 druid-master\druid-master\sql\src\main\java\org\apache\druid\sql\calcite\aggregation\builtin\SumSqlAggregator.java,0,10,0,5,0,15
 druid-master\druid-master\processing\src\main\java\org\apache\druid\segment\incremental\IncrementalIndexAddResult.java,0,54,0,1,0,55
 druid-master\druid-master\extensions-contrib\momentsketch\src\main\java\org\apache\druid\query\aggregation\momentsketch\aggregator\MomentSketchQuantilePostAggregator.java,0,47,1,5,0,53
 druid-master\druid-master\extensions-core\histogram\src\main\java\org\apache\druid\query\aggregation\histogram\FixedBucketsHistogram.java,0,372,6,118,0,496
 druid-master\druid-master\server\src\main\java\org\apache\druid\client\DataSegmentInterner.java,0,17,1,10,0,28
 druid-master\druid-master\core\src\main\java\org\apache\druid\metadata\MetadataStorageActionHandlerFactory.java,0,4,0,3,0,7
 druid-master\druid-master\extensions-core\druid-pac4j\src\main\java\org\apache\druid\security\pac4j\Pac4jCallbackResource.java,0,10,2,3,0,15
 druid-master\druid-master\core\src\main\java\org\apache\druid\math\expr\vector\LongOutDoublesInFunctionVectorValueProcessor.java,0,16,0,2,0,18
 druid-master\druid-master\extensions-core\datasketches\src\main\java\org\apache\druid\query\aggregation\datasketches\tuple\ArrayOfDoublesSketchBuildAggregator.java,0,35,1,12,0,48
 druid-master\druid-master\sql\src\main\java\org\apache\druid\sql\calcite\expression\builtin\IPv4AddressParseOperatorConversion.java,0,7,0,2,0,9
 druid-master\druid-master\core\src\main\java\org\apache\druid\math\expr\ExpressionTypeFactory.java,0,25,2,8,0,35
 druid-master\druid-master\benchmarks\src\test\java\org\apache\druid\benchmark\JoinAndLookupBenchmark.java,0,115,1,31,0,147
 druid-master\druid-master\benchmarks\src\test\java\org\apache\druid\benchmark\ContainsBenchmark.java,0,25,1,1,0,27
 druid-master\druid-master\extensions-core\kinesis-indexing-service\src\main\java\org\apache\druid\indexing\kinesis\KinesisIndexTask.java,0,34,2,6,0,42
 druid-master\druid-master\indexing-service\src\main\java\org\apache\druid\indexing\common\IndexTaskClient.java,0,202,2,46,0,250
 druid-master\druid-master\sql\src\main\java\org\apache\druid\sql\calcite\rule\GroupByRules.java,0,30,1,12,0,43
 druid-master\druid-master\core\src\test\java\org\apache\druid\data\input\impl\RetryingInputStreamTest.java,0,68,0,13,5,86
 druid-master\druid-master\core\src\main\java\org\apache\druid\java\util\emitter\core\Emitters.java,0,46,1,24,0,71
 druid-master\druid-master\extensions-contrib\ambari-metrics-emitter\src\main\java\org\apache\druid\emitter\ambari\metrics\WhiteListBasedDruidToTimelineEventConverter.java,0,67,1,28,0,96
 druid-master\druid-master\extensions-contrib\moving-average-query\src\main\java\org\apache\druid\query\movingaverage\averagers\DoubleMinAverager.java,0,11,1,3,0,15
 druid-master\druid-master\processing\src\main\java\org\apache\druid\jackson\StringComparatorModule.java,0,11,0,7,0,18
 druid-master\druid-master\processing\src\main\java\org\apache\druid\segment\QueryableIndexStorageAdapter.java,0,111,3,36,0,150
 druid-master\druid-master\processing\src\test\java\org\apache\druid\query\timeseries\TimeseriesQueryTest.java,0,16,0,4,0,20
 druid-master\druid-master\extensions-core\histogram\src\test\java\org\apache\druid\query\aggregation\histogram\EqualBucketsPostAggregatorTest.java,0,13,0,5,0,18
 druid-master\druid-master\extensions-core\kafka-indexing-service\src\test\java\org\apache\druid\indexing\kafka\KafkaIndexTaskTuningConfigTest.java,0,86,0,49,0,135
 druid-master\druid-master\extensions-core\ec2-extensions\src\test\java\org\apache\druid\indexing\overlord\autoscaling\ec2\EC2NodeDataTest.java,0,7,0,5,0,12
 druid-master\druid-master\core\src\test\java\org\apache\druid\java\util\common\NonnullPairTest.java,0,11,0,2,1,14
 druid-master\druid-master\core\src\test\java\org\apache\druid\timeline\partition\SingleDimensionShardSpecTest.java,0,52,0,18,1,71
 druid-master\druid-master\processing\src\test\java\org\apache\druid\query\TestQueryRunners.java,0,23,1,3,0,27
 druid-master\druid-master\processing\src\test\java\org\apache\druid\segment\incremental\IncrementalIndexAddResultTest.java,0,10,0,6,0,16
 druid-master\druid-master\core\src\test\java\org\apache\druid\data\input\impl\RegexInputFormatTest.java,0,10,0,3,0,13
 druid-master\druid-master\processing\src\main\java\org\apache\druid\query\topn\TopNResultBuilder.java,0,5,0,1,0,6
 druid-master\druid-master\core\src\test\java\org\apache\druid\indexer\TaskStatusTest.java,0,4,0,2,0,6
 druid-master\druid-master\server\src\main\java\org\apache\druid\server\metrics\MonitorsConfig.java,0,40,0,15,0,55
 druid-master\druid-master\indexing-service\src\main\java\org\apache\druid\indexing\overlord\autoscaling\AutoScaler.java,0,13,0,5,0,18
 druid-master\druid-master\core\src\test\java\org\apache\druid\data\input\impl\CsvInputFormatTest.java,0,28,0,9,0,37
 druid-master\druid-master\processing\src\main\java\org\apache\druid\query\topn\DimensionTopNMetricSpec.java,0,62,1,6,0,69
 druid-master\druid-master\extensions-contrib\tdigestsketch\src\test\java\org\apache\druid\query\aggregation\tdigestsketch\TDigestSketchAggregatorFactoryTest.java,0,5,0,4,0,9
 druid-master\druid-master\core\src\main\java\org\apache\druid\math\expr\vector\CastToLongVectorProcessor.java,0,9,0,3,0,12
 druid-master\druid-master\extensions-contrib\moving-average-query\src\main\java\org\apache\druid\query\movingaverage\averagers\LongMeanAveragerFactory.java,0,10,0,2,0,12
 druid-master\druid-master\indexing-service\src\test\java\org\apache\druid\indexing\common\task\CompactionTaskParallelRunTest.java,0,153,2,91,0,246
 druid-master\druid-master\processing\src\test\java\org\apache\druid\segment\data\V3CompressedVSizeColumnarMultiIntsSupplierTest.java,0,31,0,5,0,36
 druid-master\druid-master\processing\src\test\java\org\apache\druid\collections\spatial\search\PolygonBoundTest.java,0,42,0,11,0,53
 druid-master\druid-master\indexing-service\src\main\java\org\apache\druid\indexing\overlord\ImmutableWorkerInfo.java,0,119,1,12,0,132
 druid-master\druid-master\indexing-hadoop\src\main\java\org\apache\druid\indexer\hadoop\DatasourceIngestionSpec.java,0,106,1,7,0,114
 druid-master\druid-master\extensions-contrib\materialized-view-maintenance\src\main\java\org\apache\druid\indexing\materializedview\MaterializedViewSupervisorReport.java,0,14,0,1,0,15
 druid-master\druid-master\extensions-core\kubernetes-extensions\src\main\java\org\apache\druid\k8s\discovery\K8sDiscoveryModule.java,0,36,0,17,0,53
 druid-master\druid-master\core\src\main\java\org\apache\druid\data\input\ByteBufferInputRowParser.java,0,1,0,1,0,2
 druid-master\druid-master\benchmarks\src\test\java\org\apache\druid\benchmark\BitmapIterationBenchmark.java,0,83,0,19,0,102
 druid-master\druid-master\core\src\test\java\org\apache\druid\concurrent\ExecsTest.java,0,23,0,5,2,30
 druid-master\druid-master\core\src\main\java\org\apache\druid\java\util\emitter\factory\LoggingEmitterFactory.java,0,15,2,3,0,20
 druid-master\druid-master\integration-tests\src\test\java\org\apache\druid\tests\indexer\ITCombiningInputSourceParallelIndexTest.java,0,23,2,12,0,37
 druid-master\druid-master\services\src\main\java\org\apache\druid\cli\Version.java,0,4,0,2,0,6
 druid-master\druid-master\sql\src\main\java\org\apache\druid\sql\calcite\schema\ViewSchema.java,0,9,0,3,0,12
 druid-master\druid-master\core\src\main\java\org\apache\druid\guice\GuiceAnnotationIntrospector.java,0,32,0,27,0,59
 druid-master\druid-master\core\src\test\java\org\apache\druid\common\config\JacksonConfigManagerTest.java,0,70,1,19,4,94
 druid-master\druid-master\processing\src\main\java\org\apache\druid\query\aggregation\SimpleFloatBufferAggregator.java,0,27,0,1,0,28
 druid-master\druid-master\indexing-service\src\test\java\org\apache\druid\indexing\common\task\NoopTestTaskReportFileWriter.java,0,6,2,1,0,9
 druid-master\druid-master\processing\src\test\java\org\apache\druid\collections\bitmap\RoaringBitmapFactoryTest.java,0,17,0,2,0,19
 druid-master\druid-master\processing\src\test\java\org\apache\druid\segment\join\table\IndexedTableJoinableTest.java,0,110,0,34,0,144
 druid-master\druid-master\processing\src\test\java\org\apache\druid\query\aggregation\any\FloatAnyAggregationTest.java,0,55,0,8,0,63
