Class_Location,Class_Length,CheckStyle_Amount,PMD_Amount,SCAX_Amount,SpotBugs_Amount,Total_Amount
dubbo-3.0\dubbo-3.0\dubbo-metadata\dubbo-metadata-processor\src\main\java\org\apache\dubbo\metadata\annotation\processing\rest\AnnotatedMethodParameterProcessor.java,0,8,0,5,0,13
dubbo-3.0\dubbo-3.0\dubbo-rpc\dubbo-rpc-api\src\main\java\org\apache\dubbo\rpc\support\AccessLogData.java,0,51,1,8,0,60
dubbo-3.0\dubbo-3.0\dubbo-remoting\dubbo-remoting-api\src\main\java\org\apache\dubbo\remoting\Dispatcher.java,0,2,0,2,0,4
dubbo-3.0\dubbo-3.0\dubbo-common\src\test\java\org\apache\dubbo\rpc\service\ServiceDescriptorInternalCacheTest.java,0,4,0,4,0,8
dubbo-3.0\dubbo-3.0\dubbo-remoting\dubbo-remoting-api\src\main\java\org\apache\dubbo\remoting\api\MultiplexProtocolConnectionManager.java,27,16,1,6,0,23
dubbo-3.0\dubbo-3.0\dubbo-config\dubbo-config-api\src\main\java\org\apache\dubbo\config\invoker\DelegateProviderMetaDataInvoker.java,39,20,0,2,0,22
dubbo-3.0\dubbo-3.0\dubbo-config\dubbo-config-spring\src\main\java\org\apache\dubbo\config\spring\reference\ReferenceBeanBuilder.java,302,156,0,13,0,169
dubbo-3.0\dubbo-3.0\dubbo-common\src\main\java\org\apache\dubbo\common\threadpool\concurrent\ScheduledCompletableFuture.java,42,10,3,1,0,14
dubbo-3.0\dubbo-3.0\dubbo-metadata\dubbo-metadata-api\src\test\java\org\apache\dubbo\metadata\store\InterfaceNameTestService2.java,0,2,0,1,0,3
dubbo-3.0\dubbo-3.0\dubbo-remoting\dubbo-remoting-netty4\src\test\java\org\apache\dubbo\remoting\transport\netty4\ClientsTest.java,35,9,0,6,0,15
dubbo-3.0\dubbo-3.0\dubbo-remoting\dubbo-remoting-api\src\test\java\org\apache\dubbo\remoting\buffer\ByteBufferBackedChannelBufferTest.java,16,6,0,3,0,9
dubbo-3.0\dubbo-3.0\dubbo-cluster\src\main\java\org\apache\dubbo\rpc\cluster\router\condition\ConditionStateRouterFactory.java,10,6,0,2,0,8
dubbo-3.0\dubbo-3.0\dubbo-common\src\main\java\org\apache\dubbo\common\extension\ExtensionAccessor.java,0,9,0,4,0,13
dubbo-3.0\dubbo-3.0\dubbo-remoting\dubbo-remoting-api\src\main\java\org\apache\dubbo\remoting\buffer\ChannelBuffer.java,0,82,0,6,0,88
dubbo-3.0\dubbo-3.0\dubbo-config\dubbo-config-spring\src\main\java\org\apache\dubbo\config\spring\context\DubboDeployApplicationListener.java,0,36,4,14,0,54
dubbo-3.0\dubbo-3.0\dubbo-filter\dubbo-filter-validation\src\main\java\org\apache\dubbo\validation\Validation.java,0,1,0,2,0,3
dubbo-3.0\dubbo-3.0\dubbo-rpc\dubbo-rpc-dubbo\src\test\java\org\apache\dubbo\rpc\protocol\dubbo\support\ProtocolUtils.java,38,27,2,8,0,37
dubbo-3.0\dubbo-3.0\dubbo-remoting\dubbo-remoting-api\src\test\java\org\apache\dubbo\remoting\buffer\AbstractChannelBufferTest.java,854,143,6,58,0,207
dubbo-3.0\dubbo-3.0\dubbo-common\src\test\java\org\apache\dubbo\common\extension\injection\impl\InjectExtImpl.java,49,31,0,1,0,32
dubbo-3.0\dubbo-3.0\dubbo-cluster\src\test\java\org\apache\dubbo\rpc\cluster\router\mock\MockInvokersSelectorTest.java,41,17,0,11,0,28
dubbo-3.0\dubbo-3.0\dubbo-cluster\src\test\java\org\apache\dubbo\rpc\cluster\router\mesh\route\MeshAppRuleListenerTest.java,323,159,16,55,0,230
dubbo-3.0\dubbo-3.0\dubbo-common\src\test\java\org\apache\dubbo\common\extension\activate\impl\ActivateWrapperExt1Wrapper.java,13,6,0,1,0,7
dubbo-3.0\dubbo-3.0\dubbo-rpc\dubbo-rpc-api\src\test\java\org\apache\dubbo\rpc\RpcInvocationTest.java,24,5,0,4,0,9
dubbo-3.0\dubbo-3.0\dubbo-config\dubbo-config-spring\src\test\java\org\apache\dubbo\config\spring\schema\DubboNamespaceHandlerTest.java,247,88,4,59,0,151
dubbo-3.0\dubbo-3.0\dubbo-metadata\dubbo-metadata-report-nacos\src\main\java\org\apache\dubbo\metadata\store\nacos\NacosConfigServiceWrapper.java,58,63,0,16,0,79
dubbo-3.0\dubbo-3.0\dubbo-rpc\dubbo-rpc-grpc\src\test\java\org\apache\dubbo\rpc\protocol\grpc\support\HelloRequestOrBuilder.java,0,4,0,1,0,5
dubbo-3.0\dubbo-3.0\dubbo-monitor\dubbo-monitor-api\src\main\java\org\apache\dubbo\monitor\Monitor.java,0,1,0,2,0,3
dubbo-3.0\dubbo-3.0\dubbo-spring-boot\dubbo-spring-boot-actuator\src\main\java\org\apache\dubbo\spring\boot\actuate\autoconfigure\DubboEndpointAnnotationAutoConfiguration.java,52,16,0,9,0,25
dubbo-3.0\dubbo-3.0\dubbo-common\src\main\java\org\apache\dubbo\config\annotation\Method.java,0,21,0,2,0,23
dubbo-3.0\dubbo-3.0\dubbo-cluster\src\main\java\org\apache\dubbo\rpc\cluster\support\wrapper\MockClusterWrapper.java,19,11,0,2,0,13
dubbo-3.0\dubbo-3.0\dubbo-common\src\main\java\org\apache\dubbo\common\deploy\AbstractDeployer.java,141,44,13,8,0,65
dubbo-3.0\dubbo-3.0\dubbo-rpc\dubbo-rpc-api\src\test\java\org\apache\dubbo\rpc\stub\StubProxyFactoryTest.java,0,4,0,2,0,6
dubbo-3.0\dubbo-3.0\dubbo-rpc\dubbo-rpc-triple\src\main\java\org\apache\dubbo\rpc\protocol\tri\DeadlineFuture.java,147,64,2,18,0,84
dubbo-3.0\dubbo-3.0\dubbo-metadata\dubbo-metadata-processor\src\test\java\org\apache\dubbo\metadata\annotation\processing\util\MethodUtilsTest.java,148,32,2,21,0,55
dubbo-3.0\dubbo-3.0\dubbo-rpc\dubbo-rpc-dubbo\src\test\java\org\apache\dubbo\rpc\protocol\dubbo\RpcFilterTest.java,28,13,0,7,0,20
dubbo-3.0\dubbo-3.0\dubbo-config\dubbo-config-api\src\test\java\org\apache\dubbo\config\mock\MockRegistryFactory.java,13,4,0,2,0,6
dubbo-3.0\dubbo-3.0\dubbo-config\dubbo-config-api\src\test\java\org\apache\dubbo\config\utils\service\XxxService.java,0,0,0,1,0,1
dubbo-3.0\dubbo-3.0\dubbo-registry\dubbo-registry-api\src\main\java\org\apache\dubbo\registry\client\metadata\MetadataServiceURLBuilder.java,0,2,0,2,0,4
dubbo-3.0\dubbo-3.0\dubbo-common\src\main\java\org\apache\dubbo\common\lang\ShutdownHookCallback.java,0,3,0,3,0,6
dubbo-3.0\dubbo-3.0\dubbo-metadata\dubbo-metadata-api\src\main\java\org\apache\dubbo\metadata\report\MetadataReportInstance.java,84,40,3,18,0,61
dubbo-3.0\dubbo-3.0\dubbo-cluster\src\main\java\org\apache\dubbo\rpc\cluster\configurator\absent\AbsentConfiguratorFactory.java,9,3,0,1,0,4
dubbo-3.0\dubbo-3.0\dubbo-common\src\test\java\org\apache\dubbo\common\extension\ext6_inject\impl\DaoImpl.java,6,2,1,1,0,4
dubbo-3.0\dubbo-3.0\dubbo-cluster\src\main\java\org\apache\dubbo\rpc\cluster\router\mesh\rule\virtualservice\match\StringMatch.java,77,45,0,1,0,46
dubbo-3.0\dubbo-3.0\dubbo-registry\dubbo-registry-api\src\main\java\org\apache\dubbo\registry\support\DefaultProviderFirstParams.java,12,5,1,4,0,10
dubbo-3.0\dubbo-3.0\dubbo-config\dubbo-config-spring\src\main\java\org\apache\dubbo\config\spring\context\annotation\DubboConfigConfiguration.java,42,27,0,24,0,51
dubbo-3.0\dubbo-3.0\dubbo-common\src\test\java\org\apache\dubbo\common\config\configcenter\AbstractDynamicConfigurationTest.java,160,49,2,25,0,76
dubbo-3.0\dubbo-3.0\dubbo-metadata\dubbo-metadata-processor\src\main\java\org\apache\dubbo\metadata\annotation\processing\builder\TypeBuilder.java,0,4,0,2,0,6
dubbo-3.0\dubbo-3.0\dubbo-plugin\dubbo-qos\src\test\java\org\apache\dubbo\qos\legacy\service\generic\GenericServiceTest.java,284,59,5,34,0,98
dubbo-3.0\dubbo-3.0\dubbo-config\dubbo-config-api\src\main\java\org\apache\dubbo\config\bootstrap\builders\ModuleBuilder.java,0,43,0,3,0,46
dubbo-3.0\dubbo-3.0\dubbo-test\dubbo-test-check\src\main\java\org\apache\dubbo\test\check\RegistryCenterFinished.java,16,7,1,3,0,11
dubbo-3.0\dubbo-3.0\dubbo-plugin\dubbo-qos\src\test\java\org\apache\dubbo\qos\command\impl\InvokeTelnetTest.java,230,90,1,65,0,156
dubbo-3.0\dubbo-3.0\dubbo-cluster\src\main\java\org\apache\dubbo\rpc\cluster\support\BroadcastClusterInvoker.java,86,25,4,12,0,41
dubbo-3.0\dubbo-3.0\dubbo-common\src\main\java\org\apache\dubbo\metadata\definition\MethodDefinitionBuilder.java,48,11,0,3,0,14
dubbo-3.0\dubbo-3.0\dubbo-plugin\dubbo-qos\src\main\java\org\apache\dubbo\qos\command\impl\GetRecentRouterSnapshot.java,14,8,0,3,0,11
dubbo-3.0\dubbo-3.0\dubbo-rpc\dubbo-rpc-api\src\main\java\org\apache\dubbo\rpc\AttachmentsAdapter.java,48,15,0,3,0,18
dubbo-3.0\dubbo-3.0\dubbo-common\src\main\java\org\apache\dubbo\common\threadpool\MemoryLimiter.java,242,51,0,3,0,54
dubbo-3.0\dubbo-3.0\dubbo-common\src\test\java\org\apache\dubbo\common\function\ThrowableFunctionTest.java,10,2,0,1,0,3
dubbo-3.0\dubbo-3.0\dubbo-cluster\src\main\java\org\apache\dubbo\rpc\cluster\loadbalance\ShortestResponseLoadBalance.java,126,35,1,14,0,50
dubbo-3.0\dubbo-3.0\dubbo-remoting\dubbo-remoting-api\src\test\java\org\apache\dubbo\remoting\PerformanceServerTest.java,127,45,9,25,0,79
dubbo-3.0\dubbo-3.0\dubbo-rpc\dubbo-rpc-api\src\test\java\org\apache\dubbo\rpc\filter\DeprecatedFilterTest.java,15,7,0,4,0,11
dubbo-3.0\dubbo-3.0\dubbo-common\src\main\java\org\apache\dubbo\common\utils\MethodUtils.java,0,48,7,38,0,93
dubbo-3.0\dubbo-3.0\dubbo-config\dubbo-config-spring\src\main\java\org\apache\dubbo\config\spring\context\event\DubboConfigInitEvent.java,20,4,0,2,0,6
dubbo-3.0\dubbo-3.0\dubbo-rpc\dubbo-rpc-api\src\main\java\org\apache\dubbo\rpc\filter\AccessLogFilter.java,148,44,5,21,0,70
dubbo-3.0\dubbo-3.0\dubbo-common\src\main\java\org\apache\dubbo\rpc\model\MethodDescriptor.java,0,15,0,1,0,16
dubbo-3.0\dubbo-3.0\dubbo-common\src\main\java\org\apache\dubbo\common\config\ModuleEnvironment.java,197,64,0,14,0,78
dubbo-3.0\dubbo-3.0\dubbo-common\src\main\java\org\apache\dubbo\common\compiler\support\JdkCompiler.java,250,89,4,37,0,130
dubbo-3.0\dubbo-3.0\dubbo-remoting\dubbo-remoting-api\src\main\java\org\apache\dubbo\remoting\exchange\support\ExchangeHandlerDispatcher.java,84,50,0,7,0,57
dubbo-3.0\dubbo-3.0\dubbo-test\dubbo-test-check\src\main\java\org\apache\dubbo\test\check\registrycenter\RegistryCenter.java,0,0,0,1,0,1
dubbo-3.0\dubbo-3.0\dubbo-config\dubbo-config-spring\src\test\java\org\apache\dubbo\config\spring\impl\NotifyService.java,15,13,0,3,0,16
dubbo-3.0\dubbo-3.0\dubbo-registry\dubbo-registry-multiple\src\test\java\org\apache\dubbo\registry\multiple\MultipleRegistry2S2RTest.java,144,65,6,43,0,114
dubbo-3.0\dubbo-3.0\dubbo-compatible\src\test\java\org\apache\dubbo\generic\GenericServiceTest.java,239,110,2,64,0,176
dubbo-3.0\dubbo-3.0\dubbo-rpc\dubbo-rpc-api\src\test\java\org\apache\dubbo\rpc\CustomArgument.java,30,22,1,1,0,24
dubbo-3.0\dubbo-3.0\dubbo-rpc\dubbo-rpc-triple\src\main\java\org\apache\dubbo\rpc\protocol\tri\RequestMetadata.java,53,34,0,4,0,38
dubbo-3.0\dubbo-3.0\dubbo-cluster\src\main\java\org\apache\dubbo\rpc\cluster\ClusterScopeModelInitializer.java,21,6,0,1,0,7
dubbo-3.0\dubbo-3.0\dubbo-compatible\src\main\java\com\alibaba\dubbo\container\page\ResourceFilter.java,111,19,4,3,0,26
dubbo-3.0\dubbo-3.0\dubbo-registry\dubbo-registry-api\src\test\java\org\apache\dubbo\registry\SimpleRegistryFactory.java,8,4,0,1,0,5
dubbo-3.0\dubbo-3.0\dubbo-common\src\test\java\org\apache\dubbo\common\extension\duplicated\impl\DuplicatedWithoutOverriddenExt2.java,8,2,0,3,0,5
dubbo-3.0\dubbo-3.0\dubbo-metadata\dubbo-metadata-processor\src\test\java\org\apache\dubbo\metadata\annotation\processing\util\ServiceAnnotationUtilsTest.java,85,22,2,29,0,53
dubbo-3.0\dubbo-3.0\dubbo-common\src\test\java\org\apache\dubbo\rpc\support\ProtocolUtilsTest.java,55,20,0,7,0,27
dubbo-3.0\dubbo-3.0\dubbo-native\src\main\java\org\apache\dubbo\utils\ClassFinder.java,63,22,2,9,0,33
dubbo-3.0\dubbo-3.0\dubbo-rpc\dubbo-rpc-triple\src\test\java\org\apache\dubbo\rpc\protocol\tri\stream\StreamUtilsTest.java,0,1,0,2,0,3
dubbo-3.0\dubbo-3.0\dubbo-spring-boot\dubbo-spring-boot-actuator\src\main\java\org\apache\dubbo\spring\boot\actuate\endpoint\DubboServicesMetadataEndpoint.java,11,5,0,3,0,8
dubbo-3.0\dubbo-3.0\dubbo-compatible\src\main\java\com\alibaba\dubbo\rpc\RpcContext.java,357,129,3,9,0,141
dubbo-3.0\dubbo-3.0\dubbo-config\dubbo-config-api\src\main\java\org\apache\dubbo\config\metadata\MetadataServiceURLParamsMetadataCustomizer.java,34,17,1,14,0,32
dubbo-3.0\dubbo-3.0\dubbo-registry\dubbo-registry-zookeeper\src\test\java\org\apache\dubbo\registry\zookeeper\ZookeeperServiceDiscoveryTest.java,77,20,3,8,0,31
dubbo-3.0\dubbo-3.0\dubbo-config\dubbo-config-spring\src\main\java\org\apache\dubbo\config\spring\beans\factory\annotation\AnnotationPropertyValuesAdapter.java,50,28,0,7,0,35
dubbo-3.0\dubbo-3.0\dubbo-registry\dubbo-registry-multiple\src\main\java\org\apache\dubbo\registry\multiple\MultipleServiceDiscovery.java,192,98,3,37,0,138
dubbo-3.0\dubbo-3.0\dubbo-common\src\main\java\org\apache\dubbo\common\extension\ExtensionInjector.java,0,1,1,1,0,3
dubbo-3.0\dubbo-3.0\dubbo-cluster\src\test\java\org\apache\dubbo\rpc\cluster\merger\ResultMergerTest.java,421,116,10,30,0,156
dubbo-3.0\dubbo-3.0\dubbo-demo\dubbo-demo-interface\src\main\java\org\apache\dubbo\demo\RestDemoService.java,0,4,0,1,0,5
dubbo-3.0\dubbo-3.0\dubbo-rpc\dubbo-rpc-rest\src\main\java\org\apache\dubbo\rpc\protocol\rest\DubboResourceFactory.java,50,19,2,3,0,24
dubbo-3.0\dubbo-3.0\dubbo-compatible\src\test\java\org\apache\dubbo\cache\MyCacheFactory.java,8,2,0,1,0,3
dubbo-3.0\dubbo-3.0\dubbo-serialization\dubbo-serialization-api\src\main\java\org\apache\dubbo\common\serialize\support\SerializableClassRegistry.java,37,12,0,4,0,16
dubbo-3.0\dubbo-3.0\dubbo-rpc\dubbo-rpc-dubbo\src\test\java\org\apache\dubbo\rpc\protocol\dubbo\ArgumentCallbackTest.java,348,113,15,23,0,151
dubbo-3.0\dubbo-3.0\dubbo-common\src\main\java\org\apache\dubbo\config\context\ConfigMode.java,0,6,0,3,0,9
dubbo-3.0\dubbo-3.0\dubbo-rpc\dubbo-rpc-dubbo\src\main\java\org\apache\dubbo\rpc\protocol\dubbo\filter\TraceFilter.java,83,33,2,16,0,51
dubbo-3.0\dubbo-3.0\dubbo-rpc\dubbo-rpc-api\src\test\java\org\apache\dubbo\rpc\stub\StubSuppliersTest.java,0,3,4,3,0,10
dubbo-3.0\dubbo-3.0\dubbo-common\src\test\java\org\apache\dubbo\common\model\User.java,52,26,2,2,0,30
dubbo-3.0\dubbo-3.0\dubbo-common\src\test\java\org\apache\dubbo\rpc\support\DemoService.java,0,2,0,1,0,3
dubbo-3.0\dubbo-3.0\dubbo-common\src\test\java\org\apache\dubbo\common\extension\ExtensionLoader_Adaptive_Test.java,278,88,28,42,0,158
dubbo-3.0\dubbo-3.0\dubbo-rpc\dubbo-rpc-injvm\src\test\java\org\apache\dubbo\rpc\protocol\injvm\ProtocolTest.java,43,18,3,7,0,28
dubbo-3.0\dubbo-3.0\dubbo-common\src\test\java\org\apache\dubbo\common\extension\convert\String2BooleanConverter.java,3,3,0,1,0,4
dubbo-3.0\dubbo-3.0\dubbo-plugin\dubbo-qos\src\test\java\org\apache\dubbo\qos\command\impl\MockLivenessProbe.java,13,5,0,1,0,6
dubbo-3.0\dubbo-3.0\dubbo-remoting\dubbo-remoting-http\src\main\java\org\apache\dubbo\remoting\http\jetty\JettyHttpBinder.java,9,5,0,1,0,6
dubbo-3.0\dubbo-3.0\dubbo-metadata\dubbo-metadata-processor\src\test\java\org\apache\dubbo\metadata\rest\User.java,38,24,0,2,0,26
dubbo-3.0\dubbo-3.0\dubbo-rpc\dubbo-rpc-triple\src\test\java\org\apache\dubbo\rpc\protocol\tri\support\MockStreamObserver.java,39,18,0,1,0,19
dubbo-3.0\dubbo-3.0\dubbo-registry\dubbo-registry-api\src\test\java\org\apache\dubbo\registry\client\metadata\ServiceInstanceHostPortCustomizerTest.java,0,17,2,12,0,31
dubbo-3.0\dubbo-3.0\dubbo-config\dubbo-config-spring\src\test\java\org\apache\dubbo\config\spring\ServiceBeanTest.java,26,5,1,1,0,7
dubbo-3.0\dubbo-3.0\dubbo-common\src\main\java\org\apache\dubbo\config\support\Parameter.java,0,13,0,2,0,15
dubbo-3.0\dubbo-3.0\dubbo-common\src\test\java\org\apache\dubbo\common\extension\activate\impl\OldActivateExt1Impl3.java,6,3,0,1,0,4
dubbo-3.0\dubbo-3.0\dubbo-filter\dubbo-filter-cache\src\main\java\org\apache\dubbo\cache\support\expiring\ExpiringMap.java,0,107,1,7,0,115
dubbo-3.0\dubbo-3.0\dubbo-common\src\main\java\org\apache\dubbo\common\URLStrParser.java,0,105,3,35,0,143
dubbo-3.0\dubbo-3.0\dubbo-metadata\dubbo-metadata-processor\src\main\java\org\apache\dubbo\metadata\annotation\processing\builder\ArrayTypeDefinitionBuilder.java,23,15,0,5,0,20
dubbo-3.0\dubbo-3.0\dubbo-remoting\dubbo-remoting-api\src\test\java\org\apache\dubbo\remoting\api\Http2ProtocolDetectorTest.java,24,2,0,1,0,3
dubbo-3.0\dubbo-3.0\dubbo-remoting\dubbo-remoting-netty4\src\test\java\org\apache\dubbo\remoting\transport\netty4\MockResult.java,14,5,0,1,0,6
dubbo-3.0\dubbo-3.0\dubbo-common\src\main\java\org\apache\dubbo\common\Version.java,0,84,8,20,0,112
dubbo-3.0\dubbo-3.0\dubbo-config\dubbo-config-api\src\main\java\org\apache\dubbo\config\DubboShutdownHook.java,78,17,4,7,0,28
dubbo-3.0\dubbo-3.0\dubbo-remoting\dubbo-remoting-http\src\main\java\org\apache\dubbo\remoting\http\support\AbstractHttpServer.java,103,30,7,2,0,39
dubbo-3.0\dubbo-3.0\dubbo-rpc\dubbo-rpc-api\src\main\java\org\apache\dubbo\rpc\PathResolver.java,0,7,0,2,0,9
dubbo-3.0\dubbo-3.0\dubbo-rpc\dubbo-rpc-api\src\main\java\org\apache\dubbo\rpc\filter\CompatibleFilter.java,0,24,4,14,0,42
dubbo-3.0\dubbo-3.0\dubbo-common\src\main\java\org\apache\dubbo\common\threadpool\support\cached\CachedThreadPool.java,17,8,1,8,0,17
dubbo-3.0\dubbo-3.0\dubbo-common\src\test\java\org\apache\dubbo\common\config\EnvironmentConfigurationTest.java,74,20,7,14,0,41
dubbo-3.0\dubbo-3.0\dubbo-rpc\dubbo-rpc-triple\src\main\java\org\apache\dubbo\rpc\protocol\tri\compressor\DeCompressor.java,0,5,0,3,0,8
dubbo-3.0\dubbo-3.0\dubbo-rpc\dubbo-rpc-triple\src\main\java\org\apache\dubbo\rpc\protocol\tri\call\AbstractServerCall.java,0,116,6,22,0,144
dubbo-3.0\dubbo-3.0\dubbo-rpc\dubbo-rpc-dubbo\src\test\java\org\apache\dubbo\rpc\protocol\dubbo\FutureFilterTest.java,46,7,0,2,0,9
dubbo-3.0\dubbo-3.0\dubbo-filter\dubbo-filter-validation\src\test\java\org\apache\dubbo\validation\support\jvalidation\mock\JValidatorTestTarget.java,0,6,0,1,0,7
dubbo-3.0\dubbo-3.0\dubbo-plugin\dubbo-auth\src\test\java\org\apache\dubbo\auth\utils\SignatureUtilsTest.java,34,6,1,2,0,9
dubbo-3.0\dubbo-3.0\dubbo-remoting\dubbo-remoting-http\src\main\java\org\apache\dubbo\remoting\http\HttpHandler.java,0,1,0,2,0,3
dubbo-3.0\dubbo-3.0\dubbo-rpc\dubbo-rpc-injvm\src\main\java\org\apache\dubbo\rpc\protocol\injvm\InjvmProtocol.java,78,26,2,12,0,40
dubbo-3.0\dubbo-3.0\dubbo-config\dubbo-config-api\src\test\java\org\apache\dubbo\config\SysProps.java,22,9,1,2,0,12
dubbo-3.0\dubbo-3.0\dubbo-common\src\test\java\org\apache\dubbo\common\extension\ext1\SimpleExt.java,0,5,0,1,0,6
dubbo-3.0\dubbo-3.0\dubbo-compatible\src\main\java\com\alibaba\dubbo\config\ApplicationConfig.java,0,5,0,2,0,7
dubbo-3.0\dubbo-3.0\dubbo-rpc\dubbo-rpc-rest\src\main\java\org\apache\dubbo\rpc\protocol\rest\RpcContextFilter.java,0,22,0,15,0,37
dubbo-3.0\dubbo-3.0\dubbo-remoting\dubbo-remoting-netty\src\test\java\org\apache\dubbo\remoting\transport\netty\NettyStringTest.java,35,12,2,3,0,17
dubbo-3.0\dubbo-3.0\dubbo-plugin\dubbo-auth\src\main\java\org\apache\dubbo\auth\exception\RpcAuthenticationException.java,13,6,1,1,0,8
dubbo-3.0\dubbo-3.0\dubbo-config\dubbo-config-spring\src\test\java\org\apache\dubbo\config\spring\beans\factory\annotation\ServiceAnnotationPostProcessorTest.java,53,16,0,9,0,25
dubbo-3.0\dubbo-3.0\dubbo-plugin\dubbo-qos\src\test\java\org\apache\dubbo\qos\legacy\service\Man.java,23,15,0,1,0,16
dubbo-3.0\dubbo-3.0\dubbo-remoting\dubbo-remoting-api\src\test\java\org\apache\dubbo\remoting\telnet\TelnetUtilsTest.java,46,18,0,1,0,19
dubbo-3.0\dubbo-3.0\dubbo-rpc\dubbo-rpc-api\src\main\java\org\apache\dubbo\rpc\filter\tps\TPSLimiter.java,0,3,0,3,0,6
dubbo-3.0\dubbo-3.0\dubbo-spring-boot\dubbo-spring-boot-compatible\actuator\src\main\java\org\apache\dubbo\spring\boot\actuate\endpoint\DubboEndpoint.java,0,7,0,2,0,9
dubbo-3.0\dubbo-3.0\dubbo-common\src\test\java\org\apache\dubbo\metadata\definition\common\ColorEnum.java,0,3,0,1,0,4
dubbo-3.0\dubbo-3.0\dubbo-registry\dubbo-registry-zookeeper\src\main\java\org\apache\dubbo\registry\zookeeper\ZookeeperServiceDiscoveryChangeWatcher.java,68,41,1,14,0,56
dubbo-3.0\dubbo-3.0\dubbo-cluster\src\main\java\org\apache\dubbo\rpc\cluster\router\mesh\util\MeshRuleListener.java,0,3,0,1,0,4
dubbo-3.0\dubbo-3.0\dubbo-config\dubbo-config-spring\src\main\java\org\apache\dubbo\config\spring\context\DubboSpringInitializer.java,165,58,7,33,0,98
dubbo-3.0\dubbo-3.0\dubbo-config\dubbo-config-api\src\main\java\org\apache\dubbo\config\metadata\MetadataServiceDelegation.java,0,64,2,21,0,87
dubbo-3.0\dubbo-3.0\dubbo-rpc\dubbo-rpc-triple\src\test\java\org\apache\dubbo\rpc\protocol\tri\call\ReflectionServerCallTest.java,0,5,2,6,0,13
dubbo-3.0\dubbo-3.0\dubbo-rpc\dubbo-rpc-dubbo\src\test\java\org\apache\dubbo\rpc\protocol\dubbo\DecodeableRpcResultTest.java,79,32,2,22,0,56
dubbo-3.0\dubbo-3.0\dubbo-config\dubbo-config-spring\src\test\java\org\apache\dubbo\config\spring\schema\GenericServiceWithoutInterfaceTest.java,30,9,0,7,0,16
dubbo-3.0\dubbo-3.0\dubbo-registry\dubbo-registry-api\src\test\java\org\apache\dubbo\registry\client\metadata\SpringCloudMetadataServiceURLBuilderTest.java,19,8,2,5,0,15
dubbo-3.0\dubbo-3.0\dubbo-rpc\dubbo-rpc-grpc\src\test\java\org\apache\dubbo\rpc\protocol\grpc\support\GrpcGreeterImpl.java,0,6,0,4,0,10
dubbo-3.0\dubbo-3.0\dubbo-metadata\dubbo-metadata-processor\src\main\java\org\apache\dubbo\metadata\annotation\processing\rest\springmvc\AbstractRequestAnnotationParameterProcessor.java,39,21,0,12,0,33
dubbo-3.0\dubbo-3.0\dubbo-config\dubbo-config-api\src\test\java\org\apache\dubbo\config\bootstrap\builders\ReferenceBuilderTest.java,0,5,0,6,0,11
dubbo-3.0\dubbo-3.0\dubbo-config\dubbo-config-api\src\test\java\org\apache\dubbo\config\integration\multiple\injvm\MultipleRegistryCenterInjvmService.java,0,3,0,2,0,5
dubbo-3.0\dubbo-3.0\dubbo-cluster\src\main\java\org\apache\dubbo\rpc\cluster\router\condition\config\ServiceStateRouterFactory.java,11,7,0,2,0,9
dubbo-3.0\dubbo-3.0\dubbo-common\src\main\java\org\apache\dubbo\common\status\Status.java,59,31,0,1,0,32
dubbo-3.0\dubbo-3.0\dubbo-registry\dubbo-registry-api\src\test\java\org\apache\dubbo\registry\PerformanceUtils.java,99,30,4,11,0,45
dubbo-3.0\dubbo-3.0\dubbo-cluster\src\main\java\org\apache\dubbo\rpc\cluster\router\mesh\rule\destination\TcpKeepalive.java,7,3,3,1,0,7
dubbo-3.0\dubbo-3.0\dubbo-metadata\dubbo-metadata-report-zookeeper\src\main\java\org\apache\dubbo\metadata\store\zookeeper\ZookeeperMetadataReportFactory.java,23,14,2,4,0,20
dubbo-3.0\dubbo-3.0\dubbo-common\src\test\java\org\apache\dubbo\common\beans\model\FooBeanWithApplicationModel.java,22,11,0,1,0,12
dubbo-3.0\dubbo-3.0\dubbo-rpc\dubbo-rpc-triple\src\main\java\org\apache\dubbo\rpc\protocol\tri\observer\ClientCallToObserverAdapter.java,59,20,0,2,0,22
dubbo-3.0\dubbo-3.0\dubbo-common\src\main\java\org\apache\dubbo\metadata\definition\util\JaketConfigurationUtils.java,77,13,3,3,0,19
dubbo-3.0\dubbo-3.0\dubbo-compatible\src\main\java\com\alibaba\dubbo\qos\command\BaseCommand.java,0,4,0,3,0,7
dubbo-3.0\dubbo-3.0\dubbo-metadata\dubbo-metadata-processor\src\test\java\org\apache\dubbo\metadata\tools\GenericTestService.java,0,4,0,2,0,6
dubbo-3.0\dubbo-3.0\dubbo-config\dubbo-config-api\src\test\java\org\apache\dubbo\config\MethodConfigTest.java,0,163,1,43,0,207
dubbo-3.0\dubbo-3.0\dubbo-config\dubbo-config-spring\src\main\java\org\apache\dubbo\config\spring\beans\factory\annotation\ServicePackagesHolder.java,63,20,0,1,0,21
dubbo-3.0\dubbo-3.0\dubbo-compatible\src\main\java\com\alibaba\dubbo\rpc\cluster\RouterFactory.java,0,2,0,2,0,4
dubbo-3.0\dubbo-3.0\dubbo-metadata\dubbo-metadata-processor\src\test\java\org\apache\dubbo\metadata\tools\SpringRestServiceTest.java,9,3,0,2,0,5
dubbo-3.0\dubbo-3.0\dubbo-config\dubbo-config-api\src\test\java\org\apache\dubbo\config\bootstrap\ZookeeperDubboServiceConsumerBootstrap.java,27,10,1,9,0,20
dubbo-3.0\dubbo-3.0\dubbo-cluster\src\test\java\org\apache\dubbo\rpc\cluster\router\mesh\rule\virtualservice\match\ListDoubleMatchTest.java,24,6,0,1,0,7
dubbo-3.0\dubbo-3.0\dubbo-common\src\main\java\org\apache\dubbo\common\convert\StringToBooleanConverter.java,13,5,0,1,0,6
dubbo-3.0\dubbo-3.0\dubbo-common\src\main\java\org\apache\dubbo\common\beans\support\InstantiationStrategy.java,93,22,1,7,0,30
dubbo-3.0\dubbo-3.0\dubbo-common\src\main\java\org\apache\dubbo\common\convert\StringToLongConverter.java,14,4,0,1,0,5
dubbo-3.0\dubbo-3.0\dubbo-registry\dubbo-registry-zookeeper\src\test\java\org\apache\dubbo\registry\zookeeper\ZookeeperRegistryTest.java,156,34,0,9,0,43
dubbo-3.0\dubbo-3.0\dubbo-config\dubbo-config-spring\src\test\java\org\apache\dubbo\config\spring\impl\DemoServiceImpl.java,22,14,0,1,0,15
dubbo-3.0\dubbo-3.0\dubbo-rpc\dubbo-rpc-dubbo\src\test\java\org\apache\dubbo\rpc\protocol\dubbo\decode\DubboTelnetDecodeTest.java,460,93,1,42,0,136
dubbo-3.0\dubbo-3.0\dubbo-config\dubbo-config-api\src\test\java\org\apache\dubbo\metadata\MetadataServiceExporterTest.java,0,23,0,23,0,46
dubbo-3.0\dubbo-3.0\dubbo-rpc\dubbo-rpc-triple\src\main\java\org\apache\dubbo\rpc\protocol\tri\TripleHeaderEnum.java,0,25,0,1,0,26
dubbo-3.0\dubbo-3.0\dubbo-config\dubbo-config-api\src\test\java\org\apache\dubbo\config\mock\MockProxyFactory.java,17,11,0,3,0,14
dubbo-3.0\dubbo-3.0\dubbo-configcenter\dubbo-configcenter-apollo\src\main\java\org\apache\dubbo\configcenter\support\apollo\ApolloDynamicConfiguration.java,204,89,6,43,0,138
dubbo-3.0\dubbo-3.0\dubbo-common\src\main\java\org\apache\dubbo\common\utils\ServiceAnnotationResolver.java,93,29,0,8,0,37
dubbo-3.0\dubbo-3.0\dubbo-common\src\test\java\org\apache\dubbo\common\extension\support\Filter1.java,3,1,0,1,0,2
dubbo-3.0\dubbo-3.0\dubbo-config\dubbo-config-api\src\test\java\org\apache\dubbo\config\RegistryConfigTest.java,217,42,0,10,0,52
dubbo-3.0\dubbo-3.0\dubbo-plugin\dubbo-qos\src\test\java\org\apache\dubbo\qos\legacy\ProtocolUtils.java,29,22,1,6,0,29
dubbo-3.0\dubbo-3.0\dubbo-plugin\dubbo-qos\src\test\java\org\apache\dubbo\qos\command\impl\OfflineTest.java,60,18,0,12,0,30
dubbo-3.0\dubbo-3.0\dubbo-compatible\src\main\java\com\alibaba\dubbo\rpc\cluster\loadbalance\AbstractLoadBalance.java,0,2,1,2,0,5
dubbo-3.0\dubbo-3.0\dubbo-cluster\src\test\java\org\apache\dubbo\rpc\cluster\filter\DemoServiceMock.java,10,8,0,1,0,9
dubbo-3.0\dubbo-3.0\dubbo-common\src\main\java\org\apache\dubbo\metadata\definition\TypeDefinitionBuilder.java,50,24,1,6,0,31
dubbo-3.0\dubbo-3.0\dubbo-common\src\test\java\org\apache\dubbo\common\bytecode\WrapperTest.java,224,84,11,18,0,113
dubbo-3.0\dubbo-3.0\dubbo-metadata\dubbo-metadata-report-redis\src\main\java\org\apache\dubbo\metadata\store\redis\RedisMetadataReportFactory.java,10,2,0,1,0,3
dubbo-3.0\dubbo-3.0\dubbo-metadata\dubbo-metadata-processor\src\main\java\org\apache\dubbo\metadata\annotation\processing\builder\ServiceDefinitionBuilder.java,0,6,0,8,0,14
dubbo-3.0\dubbo-3.0\dubbo-common\src\main\java\org\apache\dubbo\metadata\definition\builder\EnumTypeBuilder.java,40,11,3,4,0,18
dubbo-3.0\dubbo-3.0\dubbo-common\src\test\java\org\apache\dubbo\common\extension\injection\InjectExt.java,0,2,0,1,0,3
dubbo-3.0\dubbo-3.0\dubbo-rpc\dubbo-rpc-triple\src\main\java\org\apache\dubbo\rpc\protocol\tri\stream\ServerStream.java,0,5,0,2,0,7
dubbo-3.0\dubbo-3.0\dubbo-remoting\dubbo-remoting-api\src\main\java\org\apache\dubbo\remoting\exchange\support\header\HeaderExchangeServer.java,230,59,5,16,0,80
dubbo-3.0\dubbo-3.0\dubbo-common\src\test\java\org\apache\dubbo\common\convert\multiple\StringToSortedSetConverterTest.java,67,13,5,5,0,23
dubbo-3.0\dubbo-3.0\dubbo-config\dubbo-config-api\src\test\java\org\apache\dubbo\config\mock\MockExporterListener.java,12,2,2,1,0,5
dubbo-3.0\dubbo-3.0\dubbo-remoting\dubbo-remoting-api\src\main\java\org\apache\dubbo\remoting\zookeeper\EventType.java,0,14,0,1,0,15
dubbo-3.0\dubbo-3.0\dubbo-rpc\dubbo-rpc-api\src\test\java\org\apache\dubbo\rpc\filter\ExecuteLimitFilterTest.java,96,18,1,11,0,30
dubbo-3.0\dubbo-3.0\dubbo-rpc\dubbo-rpc-api\src\test\java\org\apache\dubbo\rpc\support\BlockMyInvoker.java,39,20,0,1,0,21
dubbo-3.0\dubbo-3.0\dubbo-registry\dubbo-registry-api\src\test\java\org\apache\dubbo\registry\client\event\listener\MockServiceInstancesChangedListener.java,20,12,0,3,0,15
dubbo-3.0\dubbo-3.0\dubbo-remoting\dubbo-remoting-api\src\main\java\org\apache\dubbo\remoting\transport\dispatcher\ChannelEventRunnable.java,112,62,7,13,0,82
dubbo-3.0\dubbo-3.0\dubbo-common\src\main\java\org\apache\dubbo\config\annotation\Reference.java,0,100,0,15,0,115
dubbo-3.0\dubbo-3.0\dubbo-filter\dubbo-filter-validation\src\main\java\org\apache\dubbo\validation\support\jvalidation\JValidationNew.java,14,2,0,1,0,3
dubbo-3.0\dubbo-3.0\dubbo-remoting\dubbo-remoting-api\src\main\java\org\apache\dubbo\remoting\telnet\TelnetHandler.java,0,3,0,1,0,4
dubbo-3.0\dubbo-3.0\dubbo-common\src\main\java\org\apache\dubbo\common\utils\DefaultPage.java,0,25,1,3,0,29
dubbo-3.0\dubbo-3.0\dubbo-plugin\dubbo-qos\src\test\java\org\apache\dubbo\qos\legacy\service\DemoServiceImpl.java,109,68,5,2,0,75
dubbo-3.0\dubbo-3.0\dubbo-compatible\src\main\java\com\alibaba\dubbo\container\page\MenuComparator.java,0,5,1,2,0,8
dubbo-3.0\dubbo-3.0\dubbo-config\dubbo-config-api\src\test\java\org\apache\dubbo\config\mock\MockTelnetHandler.java,7,4,0,2,0,6
dubbo-3.0\dubbo-3.0\dubbo-demo\dubbo-demo-triple\src\main\java\org\apache\dubbo\demo\consumer\ApiConsumer.java,34,12,2,6,0,20
dubbo-3.0\dubbo-3.0\dubbo-registry\dubbo-registry-api\src\main\java\org\apache\dubbo\registry\RegistryFactoryWrapper.java,15,7,0,2,0,9
dubbo-3.0\dubbo-3.0\dubbo-compatible\src\main\java\com\alibaba\dubbo\remoting\Dispatcher.java,0,3,0,3,0,6
dubbo-3.0\dubbo-3.0\dubbo-common\src\main\java\com\alibaba\dubbo\config\annotation\Reference.java,0,46,0,2,0,48
dubbo-3.0\dubbo-3.0\dubbo-remoting\dubbo-remoting-api\src\main\java\org\apache\dubbo\remoting\api\WireProtocol.java,0,6,0,3,0,9
dubbo-3.0\dubbo-3.0\dubbo-common\src\main\java\org\apache\dubbo\metadata\definition\model\ServiceDefinition.java,108,47,0,3,0,50
dubbo-3.0\dubbo-3.0\dubbo-common\src\main\java\org\apache\dubbo\rpc\model\ScopeModel.java,258,90,1,13,0,104
dubbo-3.0\dubbo-3.0\dubbo-rpc\dubbo-rpc-api\src\test\java\org\apache\dubbo\rpc\proxy\DemoRequest.java,0,10,0,2,0,12
dubbo-3.0\dubbo-3.0\dubbo-rpc\dubbo-rpc-api\src\test\java\org\apache\dubbo\rpc\proxy\javassist\JavassistProxyFactoryTest.java,8,1,0,1,0,2
dubbo-3.0\dubbo-3.0\dubbo-plugin\dubbo-qos\src\test\java\org\apache\dubbo\qos\command\impl\CountTelnetTest.java,77,24,0,4,0,28
dubbo-3.0\dubbo-3.0\dubbo-config\dubbo-config-spring\src\test\java\org\apache\dubbo\config\spring\schema\GenericServiceTest.java,36,10,0,7,0,17
dubbo-3.0\dubbo-3.0\dubbo-remoting\dubbo-remoting-api\src\main\java\org\apache\dubbo\remoting\exchange\support\header\HeartbeatHandler.java,84,29,0,8,0,37
dubbo-3.0\dubbo-3.0\dubbo-remoting\dubbo-remoting-netty\src\main\java\org\apache\dubbo\remoting\transport\netty\NettyTransporter.java,16,9,0,3,0,12
dubbo-3.0\dubbo-3.0\dubbo-common\src\main\java\org\apache\dubbo\rpc\model\ProviderMethodModel.java,54,24,0,2,0,26
dubbo-3.0\dubbo-3.0\dubbo-remoting\dubbo-remoting-http\src\main\java\org\apache\dubbo\remoting\http\servlet\ServletManager.java,25,16,0,2,0,18
dubbo-3.0\dubbo-3.0\dubbo-common\src\main\java\org\apache\dubbo\common\config\configcenter\DynamicConfiguration.java,0,42,0,21,0,63
dubbo-3.0\dubbo-3.0\dubbo-remoting\dubbo-remoting-netty4\src\main\java\org\apache\dubbo\remoting\transport\netty4\NettyChannel.java,0,35,5,11,0,51
dubbo-3.0\dubbo-3.0\dubbo-cluster\src\test\java\org\apache\dubbo\rpc\cluster\support\FailoverClusterInvokerTest.java,317,116,16,43,0,175
dubbo-3.0\dubbo-3.0\dubbo-metadata\dubbo-metadata-api\src\main\java\org\apache\dubbo\metadata\MetadataService.java,0,51,0,31,0,82
dubbo-3.0\dubbo-3.0\dubbo-rpc\dubbo-rpc-grpc\src\test\java\org\apache\dubbo\rpc\protocol\grpc\support\HelloReplyOrBuilder.java,0,4,0,1,0,5
dubbo-3.0\dubbo-3.0\dubbo-config\dubbo-config-spring\src\test\java\org\apache\dubbo\config\spring\AbstractRegistryService.java,201,78,2,15,0,95
dubbo-3.0\dubbo-3.0\dubbo-config\dubbo-config-api\src\main\java\org\apache\dubbo\config\bootstrap\builders\MonitorBuilder.java,0,54,0,4,0,58
dubbo-3.0\dubbo-3.0\dubbo-config\dubbo-config-api\src\main\java\org\apache\dubbo\config\bootstrap\builders\AbstractMethodBuilder.java,0,88,0,6,0,94
dubbo-3.0\dubbo-3.0\dubbo-demo\dubbo-demo-xml\dubbo-demo-xml-consumer\src\main\java\org\apache\dubbo\demo\consumer\Application.java,74,16,3,8,0,27
dubbo-3.0\dubbo-3.0\dubbo-common\src\test\java\org\apache\dubbo\common\utils\StackTest.java,102,12,0,1,0,13
dubbo-3.0\dubbo-3.0\dubbo-config\dubbo-config-spring\src\test\java\org\apache\dubbo\config\spring\context\properties\DefaultDubboConfigBinderTest.java,29,6,1,3,0,10
dubbo-3.0\dubbo-3.0\dubbo-common\src\test\java\org\apache\dubbo\common\extension\ext4\impl\Ext4Impl2.java,7,4,0,1,0,5
dubbo-3.0\dubbo-3.0\dubbo-common\src\main\java\org\apache\dubbo\config\RegistryConfig.java,508,247,1,20,0,268
dubbo-3.0\dubbo-3.0\dubbo-remoting\dubbo-remoting-netty\src\test\java\org\apache\dubbo\remoting\transport\dispatcher\FakeChannelHandlers.java,21,7,1,1,0,9
dubbo-3.0\dubbo-3.0\dubbo-compatible\src\test\java\org\apache\dubbo\config\ConfigTest.java,42,11,2,5,0,18
dubbo-3.0\dubbo-3.0\dubbo-compatible\src\main\java\com\alibaba\dubbo\container\page\PageHandler.java,0,1,0,1,0,2
dubbo-3.0\dubbo-3.0\dubbo-config\dubbo-config-api\src\main\java\org\apache\dubbo\config\utils\DefaultConfigValidator.java,29,8,0,7,0,15
dubbo-3.0\dubbo-3.0\dubbo-compatible\src\test\java\org\apache\dubbo\service\ComplexObject.java,0,169,9,3,0,181
dubbo-3.0\dubbo-3.0\dubbo-common\src\main\java\org\apache\dubbo\common\utils\NativeUtils.java,8,1,0,1,0,2
dubbo-3.0\dubbo-3.0\dubbo-configcenter\dubbo-configcenter-nacos\src\main\java\org\apache\dubbo\configcenter\support\nacos\NacosDynamicConfigurationFactory.java,13,6,0,5,0,11
dubbo-3.0\dubbo-3.0\dubbo-common\src\main\java\org\apache\dubbo\common\utils\ClassLoaderResourceLoader.java,86,24,7,12,0,43
dubbo-3.0\dubbo-3.0\dubbo-serialization\dubbo-serialization-api\src\main\java\org\apache\dubbo\common\serialize\DefaultMultipleSerialization.java,27,16,1,5,0,22
dubbo-3.0\dubbo-3.0\dubbo-spring-boot\dubbo-spring-boot-autoconfigure\src\main\java\org\apache\dubbo\spring\boot\autoconfigure\DubboRelaxedBinding2AutoConfiguration.java,37,19,0,16,0,35
dubbo-3.0\dubbo-3.0\dubbo-config\dubbo-config-api\src\test\java\org\apache\dubbo\config\mock\GreetingMock2.java,10,1,2,1,0,4
dubbo-3.0\dubbo-3.0\dubbo-serialization\dubbo-serialization-api\src\main\java\org\apache\dubbo\common\serialize\Constants.java,0,16,15,1,0,32
dubbo-3.0\dubbo-3.0\dubbo-common\src\test\java\org\apache\dubbo\common\extension\activate\impl\ValueActivateExtImpl.java,7,3,0,1,0,4
dubbo-3.0\dubbo-3.0\dubbo-registry\dubbo-registry-api\src\test\java\org\apache\dubbo\registry\PerformanceRegistryTest.java,38,9,0,5,0,14
dubbo-3.0\dubbo-3.0\dubbo-remoting\dubbo-remoting-api\src\test\java\org\apache\dubbo\remoting\transport\codec\DeprecatedTelnetCodec.java,288,73,9,21,0,103
dubbo-3.0\dubbo-3.0\dubbo-rpc\dubbo-rpc-dubbo\src\main\java\org\apache\dubbo\rpc\protocol\dubbo\DubboProtocolServer.java,46,17,0,2,0,19
dubbo-3.0\dubbo-3.0\dubbo-metadata\dubbo-metadata-api\src\main\java\org\apache\dubbo\metadata\rest\jaxrs\JAXRSServiceRestMetadataResolver.java,59,50,0,23,0,73
dubbo-3.0\dubbo-3.0\dubbo-common\src\main\java\org\apache\dubbo\rpc\model\ReflectionMethodDescriptor.java,142,55,2,16,0,73
dubbo-3.0\dubbo-3.0\dubbo-config\dubbo-config-spring\src\test\java\org\apache\dubbo\config\spring\impl\HelloServiceImpl.java,7,3,0,1,0,4
dubbo-3.0\dubbo-3.0\dubbo-rpc\dubbo-rpc-api\src\main\java\org\apache\dubbo\rpc\ExecutableListener.java,45,29,1,4,0,34
dubbo-3.0\dubbo-3.0\dubbo-rpc\dubbo-rpc-triple\src\main\java\org\apache\dubbo\rpc\protocol\tri\compressor\Gzip.java,0,11,0,4,0,15
dubbo-3.0\dubbo-3.0\dubbo-metadata\dubbo-metadata-api\src\main\java\org\apache\dubbo\metadata\rest\DefaultServiceRestMetadataResolver.java,33,29,2,7,0,38
dubbo-3.0\dubbo-3.0\dubbo-common\src\main\java\org\apache\dubbo\common\utils\CompatibleTypeUtils.java,199,23,11,11,0,45
dubbo-3.0\dubbo-3.0\dubbo-rpc\dubbo-rpc-triple\src\main\java\org\apache\dubbo\rpc\protocol\tri\transport\WriteQueue.java,84,27,1,3,0,31
dubbo-3.0\dubbo-3.0\dubbo-config\dubbo-config-api\src\test\java\org\apache\dubbo\config\api\DemoException.java,22,9,0,1,0,10
dubbo-3.0\dubbo-3.0\dubbo-common\src\test\java\org\apache\dubbo\common\utils\MD5UtilsTest.java,67,28,2,10,0,40
dubbo-3.0\dubbo-3.0\dubbo-compatible\src\test\java\org\apache\dubbo\rpc\cluster\CompatibleRouter.java,18,9,1,2,0,12
dubbo-3.0\dubbo-3.0\dubbo-rpc\dubbo-rpc-api\src\main\java\org\apache\dubbo\rpc\listener\ListenerInvokerWrapper.java,80,25,4,4,0,33
dubbo-3.0\dubbo-3.0\dubbo-common\src\main\java\org\apache\dubbo\common\utils\Assert.java,31,12,1,1,0,14
dubbo-3.0\dubbo-3.0\dubbo-common\src\main\java\org\apache\dubbo\rpc\model\ScopeModelAware.java,0,5,4,3,0,12
dubbo-3.0\dubbo-3.0\dubbo-rpc\dubbo-rpc-injvm\src\test\java\demo\MultiClassLoaderServiceRequest.java,3,0,0,1,0,1
dubbo-3.0\dubbo-3.0\dubbo-remoting\dubbo-remoting-api\src\main\java\org\apache\dubbo\remoting\transport\AbstractChannelHandlerDelegate.java,43,21,0,4,0,25
dubbo-3.0\dubbo-3.0\dubbo-remoting\dubbo-remoting-api\src\main\java\org\apache\dubbo\remoting\transport\ChannelHandlerAdapter.java,24,10,5,3,0,18
dubbo-3.0\dubbo-3.0\dubbo-common\src\test\java\org\apache\dubbo\common\function\ThrowableConsumerTest.java,10,2,0,1,0,3
dubbo-3.0\dubbo-3.0\dubbo-remoting\dubbo-remoting-api\src\test\java\org\apache\dubbo\remoting\transport\MultiMessageHandlerTest.java,38,16,0,14,0,30
dubbo-3.0\dubbo-3.0\dubbo-registry\dubbo-registry-api\src\test\java\org\apache\dubbo\registry\integration\CountRegistryProtocolListener.java,24,13,2,3,0,18
dubbo-3.0\dubbo-3.0\dubbo-registry\dubbo-registry-zookeeper\src\main\java\org\apache\dubbo\registry\zookeeper\ZookeeperRegistryFactory.java,26,12,0,3,0,15
dubbo-3.0\dubbo-3.0\dubbo-rpc\dubbo-rpc-api\src\main\java\org\apache\dubbo\rpc\filter\GenericImplFilter.java,0,56,12,32,0,100
dubbo-3.0\dubbo-3.0\dubbo-config\dubbo-config-spring\src\test\java\org\apache\dubbo\config\spring\schema\MyGenericService.java,10,7,2,2,0,11
dubbo-3.0\dubbo-3.0\dubbo-cluster\src\test\java\org\apache\dubbo\rpc\cluster\filter\LogFilter.java,0,12,2,4,0,18
dubbo-3.0\dubbo-3.0\dubbo-registry\dubbo-registry-api\src\main\java\org\apache\dubbo\registry\Constants.java,0,48,44,3,0,95
dubbo-3.0\dubbo-3.0\dubbo-rpc\dubbo-rpc-triple\src\test\java\org\apache\dubbo\rpc\protocol\tri\service\HealthStatusManagerTest.java,0,7,0,5,0,12
dubbo-3.0\dubbo-3.0\dubbo-common\src\test\java\org\apache\dubbo\common\utils\ExecutorUtilTest.java,49,19,0,6,0,25
dubbo-3.0\dubbo-3.0\dubbo-config\dubbo-config-api\src\test\java\org\apache\dubbo\config\bootstrap\compatible\DubboInterfaceConsumerBootstrap.java,30,11,1,6,0,18
dubbo-3.0\dubbo-3.0\dubbo-test\dubbo-test-common\src\main\java\org\apache\dubbo\test\common\api\RestDemoService.java,0,4,0,1,0,5
dubbo-3.0\dubbo-3.0\dubbo-remoting\dubbo-remoting-netty4\src\test\java\org\apache\dubbo\remoting\transport\netty4\RpcMessage.java,36,18,0,2,0,20
dubbo-3.0\dubbo-3.0\dubbo-config\dubbo-config-api\src\main\java\org\apache\dubbo\config\bootstrap\builders\AbstractBuilder.java,0,18,0,4,0,22
dubbo-3.0\dubbo-3.0\dubbo-remoting\dubbo-remoting-zookeeper-curator5\src\test\java\org\apache\dubbo\remoting\zookeeper\curator5\support\AbstractZookeeperTransporterTest.java,153,77,2,56,0,135
dubbo-3.0\dubbo-3.0\dubbo-config\dubbo-config-spring\src\main\java\org\apache\dubbo\config\spring\context\event\DubboBootstrapStatedEvent.java,21,5,0,3,0,8
dubbo-3.0\dubbo-3.0\dubbo-plugin\dubbo-qos\src\main\java\org\apache\dubbo\qos\command\impl\Help.java,88,14,0,3,0,17
dubbo-3.0\dubbo-3.0\dubbo-compatible\src\main\java\com\alibaba\dubbo\common\compiler\Compiler.java,0,1,0,1,0,2
dubbo-3.0\dubbo-3.0\dubbo-common\src\test\java\org\apache\dubbo\common\extension\AdaptiveClassCodeGeneratorTest.java,16,8,0,5,0,13
dubbo-3.0\dubbo-3.0\dubbo-config\dubbo-config-spring\src\main\java\org\apache\dubbo\config\spring\extension\SpringExtensionInjector.java,0,30,3,8,0,41
dubbo-3.0\dubbo-3.0\dubbo-cluster\src\test\java\org\apache\dubbo\rpc\cluster\filter\DefaultFilterChainBuilderTest.java,72,27,0,22,0,49
dubbo-3.0\dubbo-3.0\dubbo-common\src\test\java\org\apache\dubbo\common\model\person\PersonStatus.java,0,2,0,1,0,3
dubbo-3.0\dubbo-3.0\dubbo-compatible\src\main\java\com\alibaba\dubbo\rpc\cluster\ConfiguratorFactory.java,0,1,0,2,0,3
dubbo-3.0\dubbo-3.0\dubbo-compatible\src\main\java\com\alibaba\dubbo\rpc\Protocol.java,0,4,0,3,0,7
dubbo-3.0\dubbo-3.0\dubbo-remoting\dubbo-remoting-zookeeper\src\main\java\org\apache\dubbo\remoting\zookeeper\curator\CuratorZookeeperTransporter.java,9,2,0,1,0,3
dubbo-3.0\dubbo-3.0\dubbo-plugin\dubbo-qos\src\test\java\org\apache\dubbo\qos\server\handler\TelnetProcessHandlerTest.java,41,9,0,6,0,15
dubbo-3.0\dubbo-3.0\dubbo-config\dubbo-config-spring\src\test\java\org\apache\dubbo\config\spring\context\annotation\provider\ProviderConfiguration.java,0,19,4,8,0,31
dubbo-3.0\dubbo-3.0\dubbo-compatible\src\main\java\com\alibaba\dubbo\config\MonitorConfig.java,0,3,1,1,0,5
dubbo-3.0\dubbo-3.0\dubbo-compatible\src\main\java\com\alibaba\dubbo\container\page\PageServlet.java,0,53,10,28,0,91
dubbo-3.0\dubbo-3.0\dubbo-remoting\dubbo-remoting-api\src\test\java\org\apache\dubbo\remoting\buffer\ChannelBufferFactoryTest.java,24,12,0,7,0,19
dubbo-3.0\dubbo-3.0\dubbo-rpc\dubbo-rpc-api\src\test\java\org\apache\dubbo\rpc\support\MockInvokerTest.java,134,16,0,7,0,23
dubbo-3.0\dubbo-3.0\dubbo-monitor\dubbo-monitor-api\src\main\java\org\apache\dubbo\monitor\support\MetricsServiceDetector.java,9,1,0,1,0,2
dubbo-3.0\dubbo-3.0\dubbo-common\src\test\java\org\apache\dubbo\common\extension\director\impl\TestFrameworkProvider.java,7,1,1,1,0,3
dubbo-3.0\dubbo-3.0\dubbo-common\src\test\java\org\apache\dubbo\common\extension\adaptive\impl\HasAdaptiveExt_ManualAdaptive.java,7,6,1,2,0,9
dubbo-3.0\dubbo-3.0\dubbo-common\src\main\java\org\apache\dubbo\common\utils\CollectionUtils.java,369,61,9,9,0,79
dubbo-3.0\dubbo-3.0\dubbo-remoting\dubbo-remoting-http\src\test\java\org\apache\dubbo\remoting\http\jetty\JettyHttpBinderTest.java,21,6,0,3,0,9
dubbo-3.0\dubbo-3.0\dubbo-compatible\src\main\java\com\alibaba\dubbo\common\store\DataStore.java,0,1,0,1,0,2
dubbo-3.0\dubbo-3.0\dubbo-config\dubbo-config-spring\src\test\java\org\apache\dubbo\config\spring\boot\importxml\SpringBootImportDubboXmlTest.java,29,9,0,3,0,12
dubbo-3.0\dubbo-3.0\dubbo-spring-boot\dubbo-spring-boot-compatible\actuator\src\main\java\org\apache\dubbo\spring\boot\actuate\autoconfigure\DubboMvcEndpointManagementContextConfiguration.java,10,6,0,5,0,11
dubbo-3.0\dubbo-3.0\dubbo-metadata\dubbo-metadata-api\src\main\java\org\apache\dubbo\metadata\report\identifier\MetadataIdentifier.java,74,45,1,4,0,50
dubbo-3.0\dubbo-3.0\dubbo-remoting\dubbo-remoting-api\src\main\java\org\apache\dubbo\remoting\telnet\support\TelnetHandlerAdapter.java,71,11,1,7,0,19
dubbo-3.0\dubbo-3.0\dubbo-common\src\test\java\org\apache\dubbo\config\context\ConfigManagerTest.java,352,48,22,22,0,92
dubbo-3.0\dubbo-3.0\dubbo-remoting\dubbo-remoting-api\src\test\java\org\apache\dubbo\remoting\PerformanceClientCloseTest.java,72,16,0,11,0,27
dubbo-3.0\dubbo-3.0\dubbo-plugin\dubbo-qos\src\main\java\org\apache\dubbo\qos\command\impl\EnableSimpleProfiler.java,11,8,0,3,0,11
dubbo-3.0\dubbo-3.0\dubbo-rpc\dubbo-rpc-api\src\main\java\org\apache\dubbo\rpc\RpcContextAttachment.java,247,38,3,4,0,45
dubbo-3.0\dubbo-3.0\dubbo-rpc\dubbo-rpc-triple\src\main\java\org\apache\dubbo\rpc\protocol\tri\compressor\Compressor.java,0,11,1,6,0,18
dubbo-3.0\dubbo-3.0\dubbo-compatible\src\main\java\com\alibaba\dubbo\remoting\http\HttpBinder.java,0,1,0,1,0,2
dubbo-3.0\dubbo-3.0\dubbo-config\dubbo-config-api\src\test\java\org\apache\dubbo\config\integration\single\injvm\SingleRegistryCenterInjvmExporterListener.java,11,3,0,3,0,6
dubbo-3.0\dubbo-3.0\dubbo-monitor\dubbo-monitor-api\src\main\java\org\apache\dubbo\monitor\MonitorFactory.java,0,0,0,1,0,1
dubbo-3.0\dubbo-3.0\dubbo-config\dubbo-config-api\src\test\java\org\apache\dubbo\config\bootstrap\builders\ApplicationBuilderTest.java,0,26,0,19,0,45
dubbo-3.0\dubbo-3.0\dubbo-remoting\dubbo-remoting-api\src\main\java\org\apache\dubbo\remoting\zookeeper\ChildListener.java,0,1,0,1,0,2
dubbo-3.0\dubbo-3.0\dubbo-rpc\dubbo-rpc-api\src\test\java\org\apache\dubbo\rpc\support\DemoServiceA.java,0,1,0,1,0,2
dubbo-3.0\dubbo-3.0\dubbo-plugin\dubbo-qos\src\main\java\org\apache\dubbo\qos\command\impl\Ready.java,38,13,0,5,0,18
dubbo-3.0\dubbo-3.0\dubbo-rpc\dubbo-rpc-api\src\test\java\org\apache\dubbo\rpc\protocol\ProtocolListenerWrapperTest.java,89,27,0,23,0,50
dubbo-3.0\dubbo-3.0\dubbo-metadata\dubbo-metadata-api\src\test\java\org\apache\dubbo\metadata\report\identifier\MetadataIdentifierTest.java,22,12,2,9,0,23
dubbo-3.0\dubbo-3.0\dubbo-plugin\dubbo-auth\src\test\java\org\apache\dubbo\auth\filter\ConsumerSignFilterTest.java,0,5,0,5,0,10
dubbo-3.0\dubbo-3.0\dubbo-remoting\dubbo-remoting-api\src\main\java\org\apache\dubbo\remoting\transport\dispatcher\execution\ExecutionDispatcher.java,11,5,0,1,0,6
dubbo-3.0\dubbo-3.0\dubbo-common\src\main\java\org\apache\dubbo\common\url\component\DubboServiceAddressURL.java,147,52,0,13,0,65
dubbo-3.0\dubbo-3.0\dubbo-common\src\test\java\org\apache\dubbo\common\extension\ext5\impl\Ext5Impl1.java,6,5,0,1,0,6
dubbo-3.0\dubbo-3.0\dubbo-rpc\dubbo-rpc-triple\src\main\java\org\apache\dubbo\rpc\protocol\tri\service\TriBuiltinService.java,38,18,0,7,0,25
dubbo-3.0\dubbo-3.0\dubbo-common\src\main\java\org\apache\dubbo\common\io\StreamUtils.java,210,21,3,4,0,28
dubbo-3.0\dubbo-3.0\dubbo-config\dubbo-config-api\src\test\java\org\apache\dubbo\config\integration\multiple\package-info.java,0,1,0,2,0,3
dubbo-3.0\dubbo-3.0\dubbo-config\dubbo-config-spring\src\test\java\org\apache\dubbo\config\spring\impl\UnserializableBox.java,28,16,0,1,0,17
dubbo-3.0\dubbo-3.0\dubbo-common\src\main\java\org\apache\dubbo\common\constants\LoadbalanceRules.java,0,6,6,4,0,16
dubbo-3.0\dubbo-3.0\dubbo-common\src\test\java\org\apache\dubbo\common\extension\duplicated\DuplicatedWithoutOverriddenExt.java,0,2,0,1,0,3
dubbo-3.0\dubbo-3.0\dubbo-common\src\test\java\org\apache\dubbo\rpc\model\media\Image.java,0,73,9,3,0,85
dubbo-3.0\dubbo-3.0\dubbo-configcenter\dubbo-configcenter-zookeeper\src\test\java\org\apache\dubbo\configcenter\support\zookeeper\ZookeeperDynamicConfigurationTest.java,138,58,11,28,0,97
dubbo-3.0\dubbo-3.0\dubbo-remoting\dubbo-remoting-netty4\src\test\java\org\apache\dubbo\remoting\transport\netty4\DemoService.java,0,3,0,1,0,4
dubbo-3.0\dubbo-3.0\dubbo-compatible\src\test\java\org\apache\dubbo\common\extension\MockDispatcher.java,7,3,0,1,0,4
dubbo-3.0\dubbo-3.0\dubbo-rpc\dubbo-rpc-triple\src\test\java\org\apache\dubbo\rpc\protocol\tri\frame\RecordListener.java,0,10,0,1,0,11
dubbo-3.0\dubbo-3.0\dubbo-registry\dubbo-registry-api\src\main\java\org\apache\dubbo\registry\client\AbstractServiceDiscovery.java,261,105,9,40,0,154
dubbo-3.0\dubbo-3.0\dubbo-rpc\dubbo-rpc-api\src\test\java\org\apache\dubbo\rpc\support\IEcho.java,0,1,0,1,0,2
dubbo-3.0\dubbo-3.0\dubbo-cluster\src\main\java\org\apache\dubbo\rpc\cluster\router\mesh\rule\destination\TCPSettings.java,6,3,3,1,0,7
dubbo-3.0\dubbo-3.0\dubbo-common\src\test\java\org\apache\dubbo\common\extension\ext6_wrap\impl\Ext6Wrapper1.java,0,12,0,1,0,13
dubbo-3.0\dubbo-3.0\dubbo-plugin\dubbo-qos\src\main\java\org\apache\dubbo\qos\command\impl\ChangeTelnet.java,43,14,0,8,0,22
dubbo-3.0\dubbo-3.0\dubbo-compatible\src\main\java\com\alibaba\dubbo\config\ProviderConfig.java,0,0,0,1,0,1
dubbo-3.0\dubbo-3.0\dubbo-common\src\main\java\org\apache\dubbo\common\extension\support\ActivateComparator.java,0,26,0,10,0,36
dubbo-3.0\dubbo-3.0\dubbo-common\src\main\java\org\apache\dubbo\common\compiler\support\ClassUtils.java,373,96,5,12,0,113
dubbo-3.0\dubbo-3.0\dubbo-rpc\dubbo-rpc-dubbo\src\test\java\org\apache\dubbo\rpc\protocol\dubbo\decode\MockChannelHandler.java,36,21,0,4,0,25
dubbo-3.0\dubbo-3.0\dubbo-metadata\dubbo-metadata-processor\src\main\java\org\apache\dubbo\metadata\annotation\processing\util\MethodUtils.java,0,47,0,30,0,77
dubbo-3.0\dubbo-3.0\dubbo-config\dubbo-config-api\src\main\java\org\apache\dubbo\config\metadata\ExporterDeployListener.java,0,28,5,12,0,45
dubbo-3.0\dubbo-3.0\dubbo-common\src\main\java\org\apache\dubbo\common\utils\PathUtils.java,0,3,0,1,0,4
dubbo-3.0\dubbo-3.0\dubbo-common\src\main\java\org\apache\dubbo\common\utils\ExecutorUtil.java,110,25,3,6,0,34
dubbo-3.0\dubbo-3.0\dubbo-filter\dubbo-filter-validation\src\test\java\org\apache\dubbo\validation\support\jvalidation\JValidationTest.java,21,6,0,3,0,9
dubbo-3.0\dubbo-3.0\dubbo-remoting\dubbo-remoting-api\src\main\java\org\apache\dubbo\remoting\buffer\HeapChannelBufferFactory.java,37,12,1,2,0,15
dubbo-3.0\dubbo-3.0\dubbo-config\dubbo-config-spring\src\test\java\org\apache\dubbo\config\spring\reference\javaconfig\JavaConfigReferenceBeanTest.java,392,116,1,68,0,185
dubbo-3.0\dubbo-3.0\dubbo-common\src\test\java\org\apache\dubbo\common\extension\support\Order0Filter2.java,3,0,0,1,0,1
dubbo-3.0\dubbo-3.0\dubbo-config\dubbo-config-api\src\main\java\org\apache\dubbo\config\bootstrap\builders\ServiceBuilder.java,0,55,1,4,0,60
dubbo-3.0\dubbo-3.0\dubbo-rpc\dubbo-rpc-triple\src\main\java\org\apache\dubbo\rpc\protocol\tri\stream\Stream.java,0,3,0,4,0,7
dubbo-3.0\dubbo-3.0\dubbo-config\dubbo-config-api\src\test\java\org\apache\dubbo\config\mock\MockCodec.java,12,8,1,3,0,12
dubbo-3.0\dubbo-3.0\dubbo-rpc\dubbo-rpc-api\src\main\java\com\alibaba\dubbo\rpc\service\GenericException.java,41,22,1,1,0,24
dubbo-3.0\dubbo-3.0\dubbo-common\src\test\java\org\apache\dubbo\common\extension\adaptive\impl\HasAdaptiveExtImpl1.java,6,5,0,1,0,6
dubbo-3.0\dubbo-3.0\dubbo-rpc\dubbo-rpc-triple\src\main\java\org\apache\dubbo\rpc\protocol\tri\ReflectionPackableMethod.java,415,138,0,52,0,190
dubbo-3.0\dubbo-3.0\dubbo-spring-boot\dubbo-spring-boot-actuator\src\main\java\org\apache\dubbo\spring\boot\actuate\endpoint\condition\CompatibleOnEnabledEndpointCondition.java,0,22,1,12,0,35
dubbo-3.0\dubbo-3.0\dubbo-rpc\dubbo-rpc-dubbo\src\test\java\org\apache\dubbo\rpc\protocol\dubbo\DubboLazyConnectTest.java,59,14,2,6,0,22
dubbo-3.0\dubbo-3.0\dubbo-rpc\dubbo-rpc-api\src\main\java\org\apache\dubbo\rpc\listener\DeprecatedInvokerListener.java,13,7,1,3,0,11
dubbo-3.0\dubbo-3.0\dubbo-cluster\src\test\java\org\apache\dubbo\rpc\cluster\loadbalance\LoadBalanceBaseTest.java,251,170,2,43,0,215
dubbo-3.0\dubbo-3.0\dubbo-cluster\src\main\java\org\apache\dubbo\rpc\cluster\support\wrapper\AbstractCluster.java,227,62,0,29,0,91
dubbo-3.0\dubbo-3.0\dubbo-cluster\src\test\java\org\apache\dubbo\rpc\cluster\support\FailbackClusterInvokerTest.java,240,93,8,40,0,141
dubbo-3.0\dubbo-3.0\dubbo-common\src\test\java\org\apache\dubbo\common\beanutil\Bean.java,63,43,0,1,0,44
dubbo-3.0\dubbo-3.0\dubbo-common\src\test\java\org\apache\dubbo\common\extension\wrapper\impl\DemoWrapper.java,12,7,0,1,0,8
dubbo-3.0\dubbo-3.0\dubbo-plugin\dubbo-qos\src\test\java\org\apache\dubbo\qos\command\impl\SelectTelnetTest.java,104,36,0,21,0,57
dubbo-3.0\dubbo-3.0\dubbo-common\src\test\java\org\apache\dubbo\common\beans\InstantiationStrategyTest.java,38,15,0,13,0,28
dubbo-3.0\dubbo-3.0\dubbo-cluster\src\main\java\org\apache\dubbo\rpc\cluster\router\mesh\rule\destination\DestinationRuleSpec.java,39,26,0,1,0,27
dubbo-3.0\dubbo-3.0\dubbo-plugin\dubbo-qos\src\test\java\org\apache\dubbo\qos\command\impl\PwdTelnetTest.java,44,17,0,6,0,23
dubbo-3.0\dubbo-3.0\dubbo-cluster\src\test\java\org\apache\dubbo\rpc\cluster\merger\IntFindFirstMerger.java,8,2,0,1,0,3
dubbo-3.0\dubbo-3.0\dubbo-metadata\dubbo-metadata-processor\src\test\java\org\apache\dubbo\metadata\annotation\processing\rest\AnnotatedMethodParameterProcessorTest.java,28,10,0,3,0,13
dubbo-3.0\dubbo-3.0\dubbo-cluster\src\main\java\org\apache\dubbo\rpc\cluster\support\MergeableClusterInvoker.java,147,35,4,22,0,61
dubbo-3.0\dubbo-3.0\dubbo-cluster\src\test\java\org\apache\dubbo\rpc\cluster\configurator\parser\ConfigParserTest.java,146,42,6,23,0,71
dubbo-3.0\dubbo-3.0\dubbo-metadata\dubbo-metadata-processor\src\test\java\org\apache\dubbo\metadata\annotation\processing\AnnotationProcessingTestProcessor.java,44,25,5,9,0,39
dubbo-3.0\dubbo-3.0\dubbo-remoting\dubbo-remoting-api\src\main\java\org\apache\dubbo\remoting\zookeeper\AbstractZookeeperClient.java,0,96,5,28,0,129
dubbo-3.0\dubbo-3.0\dubbo-spring-boot\dubbo-spring-boot-autoconfigure\src\test\java\org\apache\dubbo\spring\boot\autoconfigure\DubboRelaxedBinding2AutoConfigurationTest.java,45,12,2,9,0,23
dubbo-3.0\dubbo-3.0\dubbo-remoting\dubbo-remoting-api\src\main\java\org\apache\dubbo\remoting\telnet\support\Help.java,0,5,0,1,0,6
dubbo-3.0\dubbo-3.0\dubbo-remoting\dubbo-remoting-netty\src\main\java\org\apache\dubbo\remoting\transport\netty\NettyChannel.java,0,32,5,12,0,49
dubbo-3.0\dubbo-3.0\dubbo-rpc\dubbo-rpc-api\src\test\java\org\apache\dubbo\rpc\proxy\jdk\JdkProxyFactoryTest.java,8,1,0,1,0,2
dubbo-3.0\dubbo-3.0\dubbo-rpc\dubbo-rpc-api\src\main\java\org\apache\dubbo\rpc\filter\TimeoutFilter.java,0,24,1,11,0,36
dubbo-3.0\dubbo-3.0\dubbo-config\dubbo-config-spring\src\main\java\org\apache\dubbo\config\spring\Constants.java,0,5,3,2,0,10
dubbo-3.0\dubbo-3.0\dubbo-common\src\test\java\org\apache\dubbo\common\extension\ext8_add\impl\AddExt2Impl1.java,6,4,0,1,0,5
dubbo-3.0\dubbo-3.0\dubbo-plugin\dubbo-qos\src\test\java\org\apache\dubbo\qos\textui\TTreeTest.java,20,7,0,1,0,8
dubbo-3.0\dubbo-3.0\dubbo-rpc\dubbo-rpc-triple\src\main\java\org\apache\dubbo\rpc\protocol\tri\stream\TripleServerStream.java,381,121,2,51,0,174
dubbo-3.0\dubbo-3.0\dubbo-remoting\dubbo-remoting-api\src\test\java\org\apache\dubbo\remoting\codec\AbstractMockChannel.java,112,50,5,4,0,59
dubbo-3.0\dubbo-3.0\dubbo-common\src\main\java\org\apache\dubbo\common\convert\StringToIntegerConverter.java,13,4,0,1,0,5
dubbo-3.0\dubbo-3.0\dubbo-compatible\src\main\java\com\alibaba\dubbo\config\ReferenceConfig.java,0,4,1,2,0,7
dubbo-3.0\dubbo-3.0\dubbo-remoting\dubbo-remoting-api\src\main\java\org\apache\dubbo\remoting\zookeeper\DataListener.java,0,2,0,1,0,3
dubbo-3.0\dubbo-3.0\dubbo-config\dubbo-config-spring\src\main\java\org\apache\dubbo\config\spring\schema\DubboNamespaceHandler.java,57,24,0,19,0,43
dubbo-3.0\dubbo-3.0\dubbo-spring-boot\dubbo-spring-boot-actuator\src\test\java\org\apache\dubbo\spring\boot\actuate\autoconfigure\DubboEndpointAnnotationAutoConfigurationTest.java,180,57,4,33,0,94
dubbo-3.0\dubbo-3.0\dubbo-cluster\src\main\java\org\apache\dubbo\rpc\cluster\router\mesh\route\MeshAppRuleListener.java,106,34,4,11,0,49
dubbo-3.0\dubbo-3.0\dubbo-common\src\main\java\org\apache\dubbo\common\config\configcenter\nop\NopDynamicConfiguration.java,49,23,1,5,0,29
dubbo-3.0\dubbo-3.0\dubbo-registry\dubbo-registry-nacos\src\test\java\org\apache\dubbo\registry\nacos\util\NacosInstanceManageUtilTest.java,71,14,5,9,0,28
dubbo-3.0\dubbo-3.0\dubbo-config\dubbo-config-spring\src\main\java\org\apache\dubbo\config\spring\beans\factory\annotation\AbstractAnnotationBeanPostProcessor.java,0,204,8,87,0,299
dubbo-3.0\dubbo-3.0\dubbo-plugin\dubbo-qos\src\main\java\org\apache\dubbo\qos\legacy\ChangeTelnetHandler.java,36,14,0,9,0,23
dubbo-3.0\dubbo-3.0\dubbo-plugin\dubbo-qos\src\main\java\org\apache\dubbo\qos\command\decoder\TelnetCommandDecoder.java,19,6,1,2,0,9
dubbo-3.0\dubbo-3.0\dubbo-rpc\dubbo-rpc-dubbo\src\test\java\org\apache\dubbo\rpc\protocol\dubbo\support\RemoteServiceImpl.java,11,6,0,2,0,8
dubbo-3.0\dubbo-3.0\dubbo-common\src\main\java\org\apache\dubbo\common\utils\ConcurrentHashSet.java,0,10,0,5,0,15
dubbo-3.0\dubbo-3.0\dubbo-remoting\dubbo-remoting-api\src\test\java\org\apache\dubbo\remoting\utils\PayloadDropperTest.java,20,5,0,4,0,9
dubbo-3.0\dubbo-3.0\dubbo-cluster\src\main\java\org\apache\dubbo\rpc\cluster\router\condition\config\model\ConditionRouterRule.java,29,13,2,3,0,18
dubbo-3.0\dubbo-3.0\dubbo-common\src\test\java\org\apache\dubbo\common\config\MockOrderedPropertiesProvider2.java,14,3,0,2,0,5
dubbo-3.0\dubbo-3.0\dubbo-registry\dubbo-registry-multiple\src\test\java\org\apache\dubbo\registry\multiple\MultipleRegistryTestUtil.java,57,17,4,14,0,35
dubbo-3.0\dubbo-3.0\dubbo-rpc\dubbo-rpc-api\src\test\java\org\apache\dubbo\rpc\CancellationContextTest.java,35,4,0,2,0,6
dubbo-3.0\dubbo-3.0\dubbo-common\src\test\java\org\apache\dubbo\common\utils\StringUtilsTest.java,456,80,0,28,0,108
dubbo-3.0\dubbo-3.0\dubbo-common\src\main\java\org\apache\dubbo\common\extension\ExtensionScope.java,0,12,0,8,0,20
dubbo-3.0\dubbo-3.0\dubbo-common\src\test\java\org\apache\dubbo\common\lang\DefaultShutdownHookCallback.java,14,6,0,1,0,7
dubbo-3.0\dubbo-3.0\dubbo-registry\dubbo-registry-zookeeper\src\main\java\org\apache\dubbo\registry\zookeeper\ZookeeperServiceDiscovery.java,130,61,0,34,0,95
dubbo-3.0\dubbo-3.0\dubbo-config\dubbo-config-api\src\test\java\org\apache\dubbo\config\integration\AbstractRegistryCenterExporterListener.java,116,32,6,12,0,50
dubbo-3.0\dubbo-3.0\dubbo-common\src\main\java\org\apache\dubbo\rpc\model\AsyncMethodInfo.java,68,42,0,1,0,43
dubbo-3.0\dubbo-3.0\dubbo-remoting\dubbo-remoting-api\src\main\java\org\apache\dubbo\remoting\telnet\support\command\HelpTelnetHandler.java,52,24,0,12,0,36
dubbo-3.0\dubbo-3.0\dubbo-metadata\dubbo-metadata-processor\src\main\java\org\apache\dubbo\metadata\annotation\processing\rest\ServiceRestMetadataResolver.java,0,5,0,3,0,8
dubbo-3.0\dubbo-3.0\dubbo-common\src\test\java\org\apache\dubbo\common\threadpool\support\cached\CachedThreadPoolTest.java,38,14,0,8,0,22
dubbo-3.0\dubbo-3.0\dubbo-common\src\main\java\org\apache\dubbo\common\profiler\ProfilerSwitch.java,40,23,1,4,0,28
dubbo-3.0\dubbo-3.0\dubbo-common\src\test\java\org\apache\dubbo\common\logger\LoggerAdapterTest.java,34,10,0,3,0,13
dubbo-3.0\dubbo-3.0\dubbo-spring-boot\dubbo-spring-boot-actuator\src\main\java\org\apache\dubbo\spring\boot\actuate\endpoint\DubboPropertiesMetadataEndpoint.java,11,4,0,3,0,7
dubbo-3.0\dubbo-3.0\dubbo-filter\dubbo-filter-cache\src\main\java\org\apache\dubbo\cache\Cache.java,0,3,0,2,0,5
dubbo-3.0\dubbo-3.0\dubbo-metadata\dubbo-metadata-definition-protobuf\src\test\java\org\apache\dubbo\metadata\definition\protobuf\model\ServiceInterface.java,0,1,0,1,0,2
dubbo-3.0\dubbo-3.0\dubbo-common\src\test\java\org\apache\dubbo\common\extension\ext8_add\impl\AddExt1_ManualAdd2.java,6,5,1,1,0,7
dubbo-3.0\dubbo-3.0\dubbo-common\src\main\java\org\apache\dubbo\rpc\model\ScopeModelInitializer.java,0,3,0,1,0,4
dubbo-3.0\dubbo-3.0\dubbo-config\dubbo-config-spring\src\test\java\org\apache\dubbo\config\spring\registry\nacos\demo\service\DemoService.java,0,2,0,1,0,3
dubbo-3.0\dubbo-3.0\dubbo-remoting\dubbo-remoting-netty\src\main\java\org\apache\dubbo\remoting\transport\netty\NettyCodecAdapter.java,0,36,0,15,0,51
dubbo-3.0\dubbo-3.0\dubbo-registry\dubbo-registry-api\src\main\java\org\apache\dubbo\registry\retry\FailedUnregisteredTask.java,0,9,0,2,0,11
dubbo-3.0\dubbo-3.0\dubbo-remoting\dubbo-remoting-api\src\test\java\org\apache\dubbo\remoting\api\PortUnificationServerTest.java,13,4,0,2,0,6
dubbo-3.0\dubbo-3.0\dubbo-cluster\src\main\java\org\apache\dubbo\rpc\cluster\router\mesh\rule\virtualservice\match\DoubleMatch.java,44,24,0,1,0,25
dubbo-3.0\dubbo-3.0\dubbo-config\dubbo-config-spring\src\test\java\org\apache\dubbo\config\spring\extension\BeanForContext2.java,7,3,0,1,0,4
dubbo-3.0\dubbo-3.0\dubbo-metadata\dubbo-metadata-report-zookeeper\src\test\java\org\apache\dubbo\metadata\store\zookeeper\ZookeeperMetadataReport4TstService.java,0,4,0,1,0,5
dubbo-3.0\dubbo-3.0\dubbo-rpc\dubbo-rpc-triple\src\test\java\org\apache\dubbo\rpc\protocol\tri\CancelableStreamObserverTest.java,0,4,4,2,0,10
dubbo-3.0\dubbo-3.0\dubbo-config\dubbo-config-api\src\test\java\org\apache\dubbo\config\integration\single\exportprovider\SingleRegistryCenterExportProviderServiceListener.java,11,3,0,4,0,7
dubbo-3.0\dubbo-3.0\dubbo-cluster\src\main\java\org\apache\dubbo\rpc\cluster\router\state\CacheableStateRouterFactory.java,12,9,0,6,0,15
dubbo-3.0\dubbo-3.0\dubbo-common\src\main\java\org\apache\dubbo\common\extension\support\MultiInstanceActivateComparator.java,0,26,0,12,0,38
dubbo-3.0\dubbo-3.0\dubbo-compatible\src\main\java\com\alibaba\dubbo\remoting\exchange\Exchanger.java,0,2,0,2,0,4
dubbo-3.0\dubbo-3.0\dubbo-remoting\dubbo-remoting-api\src\main\java\org\apache\dubbo\remoting\buffer\AbstractChannelBuffer.java,318,113,0,2,0,115
dubbo-3.0\dubbo-3.0\dubbo-rpc\dubbo-rpc-api\src\main\java\org\apache\dubbo\rpc\filter\ExecuteLimitFilter.java,0,28,2,14,0,44
dubbo-3.0\dubbo-3.0\dubbo-common\src\main\java\org\apache\dubbo\rpc\model\ServiceDescriptor.java,0,9,0,4,0,13
dubbo-3.0\dubbo-3.0\dubbo-common\src\test\java\org\apache\dubbo\common\logger\slf4j\Slf4jLoggerTest.java,33,9,0,6,0,15
dubbo-3.0\dubbo-3.0\dubbo-common\src\main\java\org\apache\dubbo\common\config\Configuration.java,0,15,0,7,0,22
dubbo-3.0\dubbo-3.0\dubbo-metadata\dubbo-metadata-processor\src\test\java\org\apache\dubbo\metadata\annotation\processing\util\FieldUtilsTest.java,201,42,3,16,0,61
dubbo-3.0\dubbo-3.0\dubbo-cluster\src\main\java\org\apache\dubbo\rpc\cluster\support\registry\ZoneAwareCluster.java,11,6,0,2,0,8
dubbo-3.0\dubbo-3.0\dubbo-rpc\dubbo-rpc-api\src\main\java\org\apache\dubbo\rpc\AsyncContextImpl.java,69,17,0,2,0,19
dubbo-3.0\dubbo-3.0\dubbo-registry\dubbo-registry-api\src\main\java\org\apache\dubbo\registry\retry\FailedSubscribedTask.java,0,13,0,3,0,16
dubbo-3.0\dubbo-3.0\dubbo-metadata\dubbo-metadata-processor\src\test\java\org\apache\dubbo\metadata\annotation\processing\model\CollectionTypeModel.java,14,9,5,4,0,18
dubbo-3.0\dubbo-3.0\dubbo-rpc\dubbo-rpc-dubbo\src\test\java\org\apache\dubbo\rpc\protocol\dubbo\decode\MockHandler.java,16,11,0,2,0,13
dubbo-3.0\dubbo-3.0\dubbo-native\src\main\java\org\apache\dubbo\remoting\Transporter$Adaptive.java,0,28,21,12,0,61
dubbo-3.0\dubbo-3.0\dubbo-registry\dubbo-registry-multiple\src\main\java\org\apache\dubbo\registry\multiple\MultipleRegistryFactory.java,9,3,0,1,0,4
dubbo-3.0\dubbo-3.0\dubbo-common\src\main\java\org\apache\dubbo\common\io\UnsafeStringWriter.java,84,30,9,1,0,40
dubbo-3.0\dubbo-3.0\dubbo-demo\dubbo-demo-triple\src\main\java\org\apache\dubbo\demo\provider\ApiProvider.java,16,5,1,2,0,8
dubbo-3.0\dubbo-3.0\dubbo-cluster\src\main\java\org\apache\dubbo\rpc\cluster\merger\SetMerger.java,0,2,0,1,0,3
dubbo-3.0\dubbo-3.0\dubbo-common\src\test\java\org\apache\dubbo\common\config\configcenter\ConfigChangeTypeTest.java,8,3,0,5,0,8
dubbo-3.0\dubbo-3.0\dubbo-compatible\src\main\java\com\alibaba\dubbo\validation\Validator.java,0,0,0,1,0,1
dubbo-3.0\dubbo-3.0\dubbo-compatible\src\test\java\org\apache\dubbo\config\ModuleConfigTest.java,72,9,0,2,0,11
dubbo-3.0\dubbo-3.0\dubbo-config\dubbo-config-spring\src\main\java\org\apache\dubbo\config\spring\context\properties\DefaultDubboConfigBinder.java,0,14,0,8,0,22
dubbo-3.0\dubbo-3.0\dubbo-rpc\dubbo-rpc-api\src\main\java\org\apache\dubbo\rpc\filter\EchoFilter.java,12,8,0,5,0,13
dubbo-3.0\dubbo-3.0\dubbo-registry\dubbo-registry-api\src\main\java\org\apache\dubbo\registry\RegistryNotifier.java,85,40,3,8,0,51
dubbo-3.0\dubbo-3.0\dubbo-rpc\dubbo-rpc-api\src\test\java\org\apache\dubbo\rpc\filter\EchoFilterTest.java,49,6,0,3,0,9
dubbo-3.0\dubbo-3.0\dubbo-rpc\dubbo-rpc-api\src\main\java\org\apache\dubbo\rpc\filter\tps\StatItem.java,0,16,0,3,0,19
dubbo-3.0\dubbo-3.0\dubbo-config\dubbo-config-api\src\test\java\org\apache\dubbo\config\mock\GreetingLocal1.java,4,1,0,1,0,2
dubbo-3.0\dubbo-3.0\dubbo-config\dubbo-config-api\src\test\java\org\apache\dubbo\config\ArgumentConfigTest.java,35,4,0,1,0,5
dubbo-3.0\dubbo-3.0\dubbo-common\src\main\java\org\apache\dubbo\common\utils\Holder.java,14,8,1,1,0,10
dubbo-3.0\dubbo-3.0\dubbo-config\dubbo-config-api\src\test\java\org\apache\dubbo\config\integration\multiple\exportmetadata\MultipleRegistryCenterExportMetadataService.java,0,3,0,2,0,5
dubbo-3.0\dubbo-3.0\dubbo-config\dubbo-config-api\src\test\java\org\apache\dubbo\config\integration\multiple\servicediscoveryregistry\MultipleRegistryCenterServiceDiscoveryRegistryRegistryServiceListener.java,76,41,1,16,0,58
dubbo-3.0\dubbo-3.0\dubbo-rpc\dubbo-rpc-rest\src\main\java\org\apache\dubbo\rpc\protocol\rest\support\ContentType.java,7,8,0,4,0,12
dubbo-3.0\dubbo-3.0\dubbo-common\src\main\java\org\apache\dubbo\config\AbstractServiceConfig.java,302,149,1,8,0,158
dubbo-3.0\dubbo-3.0\dubbo-rpc\dubbo-rpc-dubbo\src\main\java\org\apache\dubbo\rpc\protocol\dubbo\DubboCodec.java,204,71,3,26,0,100
dubbo-3.0\dubbo-3.0\dubbo-compatible\src\test\java\org\apache\dubbo\rpc\cluster\NewRouter.java,27,9,1,2,0,12
dubbo-3.0\dubbo-3.0\dubbo-common\src\main\java\org\apache\dubbo\common\url\component\URLAddress.java,235,108,6,8,0,122
dubbo-3.0\dubbo-3.0\dubbo-rpc\dubbo-rpc-api\src\main\java\org\apache\dubbo\rpc\protocol\InvokerWrapper.java,38,16,0,1,0,17
dubbo-3.0\dubbo-3.0\dubbo-common\src\main\java\org\apache\dubbo\rpc\model\ModuleServiceRepository.java,233,130,3,31,0,164
dubbo-3.0\dubbo-3.0\dubbo-common\src\test\java\org\apache\dubbo\common\extension\ext6_inject\Dao.java,0,2,0,1,0,3
dubbo-3.0\dubbo-3.0\dubbo-common\src\test\java\org\apache\dubbo\common\extension\wrapper\WrapperTest.java,11,4,0,3,0,7
dubbo-3.0\dubbo-3.0\dubbo-registry\dubbo-registry-multicast\src\main\java\org\apache\dubbo\registry\multicast\MulticastServiceDiscoveryFactory.java,7,3,0,2,0,5
dubbo-3.0\dubbo-3.0\dubbo-rpc\dubbo-rpc-api\src\main\java\org\apache\dubbo\rpc\Invocation.java,0,24,0,2,0,26
dubbo-3.0\dubbo-3.0\dubbo-common\src\main\java\org\apache\dubbo\common\logger\log4j\Log4jLoggerAdapter.java,104,14,3,1,0,18
dubbo-3.0\dubbo-3.0\dubbo-config\dubbo-config-api\src\test\java\org\apache\dubbo\config\url\RpcConfigGetSetProxy.java,141,38,4,4,0,46
dubbo-3.0\dubbo-3.0\dubbo-cluster\src\main\java\org\apache\dubbo\rpc\cluster\router\mesh\rule\destination\loadbalance\ConsistentHashLB.java,3,1,0,1,0,2
dubbo-3.0\dubbo-3.0\dubbo-metadata\dubbo-metadata-processor\src\main\java\org\apache\dubbo\metadata\annotation\processing\rest\springmvc\RequestParamParameterProcessor.java,15,15,0,7,0,22
dubbo-3.0\dubbo-3.0\dubbo-registry\dubbo-registry-api\src\test\java\org\apache\dubbo\registry\client\AbstractServiceDiscoveryFactoryTest.java,23,9,0,7,0,16
dubbo-3.0\dubbo-3.0\dubbo-rpc\dubbo-rpc-dubbo\src\test\java\org\apache\dubbo\rpc\protocol\dubbo\DubboCountCodecTest.java,46,13,0,7,0,20
dubbo-3.0\dubbo-3.0\dubbo-metadata\dubbo-metadata-processor\src\main\java\org\apache\dubbo\metadata\annotation\processing\rest\springmvc\RequestHeaderParameterProcessor.java,14,14,0,6,0,20
dubbo-3.0\dubbo-3.0\dubbo-remoting\dubbo-remoting-api\src\main\java\org\apache\dubbo\remoting\transport\MultiMessageHandler.java,31,9,2,3,0,14
dubbo-3.0\dubbo-3.0\dubbo-cluster\src\main\java\org\apache\dubbo\rpc\cluster\router\RouterResult.java,36,25,0,2,0,27
dubbo-3.0\dubbo-3.0\dubbo-common\src\test\java\org\apache\dubbo\common\convert\multiple\StringToBlockingDequeConverterTest.java,68,16,5,7,0,28
dubbo-3.0\dubbo-3.0\dubbo-cluster\src\main\java\org\apache\dubbo\rpc\cluster\router\tag\TagStateRouterFactory.java,10,7,0,2,0,9
dubbo-3.0\dubbo-3.0\dubbo-config\dubbo-config-spring\src\test\java\org\apache\dubbo\config\spring\issues\issue6000\dubbo\MyReferenceConfig.java,5,4,0,1,0,5
dubbo-3.0\dubbo-3.0\dubbo-rpc\dubbo-rpc-triple\src\main\java\org\apache\dubbo\rpc\protocol\tri\call\BiStreamServerCallListener.java,39,13,0,2,0,15
dubbo-3.0\dubbo-3.0\dubbo-config\dubbo-config-api\src\test\java\demo\MultiClassLoaderService.java,0,2,0,1,0,3
dubbo-3.0\dubbo-3.0\dubbo-plugin\dubbo-auth\src\main\java\org\apache\dubbo\auth\exception\AccessKeyNotFoundException.java,13,5,1,1,0,7
dubbo-3.0\dubbo-3.0\dubbo-registry\dubbo-registry-api\src\main\java\org\apache\dubbo\registry\ProviderFirstParams.java,0,1,0,1,0,2
dubbo-3.0\dubbo-3.0\dubbo-remoting\dubbo-remoting-http\src\test\java\org\apache\dubbo\remoting\http\jetty\JettyLoggerAdapterTest.java,85,23,2,11,0,36
dubbo-3.0\dubbo-3.0\dubbo-rpc\dubbo-rpc-triple\src\test\java\org\apache\dubbo\rpc\protocol\tri\service\TriHealthImplTest.java,110,23,6,13,0,42
dubbo-3.0\dubbo-3.0\dubbo-registry\dubbo-registry-api\src\main\java\org\apache\dubbo\registry\retry\AbstractRetryTask.java,96,36,4,8,0,48
dubbo-3.0\dubbo-3.0\dubbo-common\src\main\java\org\apache\dubbo\config\context\AbstractConfigManager.java,610,198,15,76,0,289
dubbo-3.0\dubbo-3.0\dubbo-config\dubbo-config-api\src\test\java\org\apache\dubbo\config\bootstrap\builders\AbstractReferenceBuilderTest.java,0,3,0,5,0,8
dubbo-3.0\dubbo-3.0\dubbo-compatible\src\main\java\com\alibaba\dubbo\rpc\Filter.java,0,5,0,5,0,10
dubbo-3.0\dubbo-3.0\dubbo-compatible\src\test\java\org\apache\dubbo\serialization\SerializationTest.java,58,18,1,6,0,25
dubbo-3.0\dubbo-3.0\dubbo-config\dubbo-config-api\src\test\java\org\apache\dubbo\config\bootstrap\builders\ServiceBuilderTest.java,0,5,0,9,0,14
dubbo-3.0\dubbo-3.0\dubbo-serialization\dubbo-serialization-jdk\src\main\java\org\apache\dubbo\common\serialize\java\CompactedJavaSerialization.java,24,10,0,3,0,13
dubbo-3.0\dubbo-3.0\dubbo-metadata\dubbo-metadata-api\src\test\java\org\apache\dubbo\metadata\rest\springmvc\SpringMvcServiceRestMetadataResolverTest.java,42,11,0,7,0,18
dubbo-3.0\dubbo-3.0\dubbo-registry\dubbo-registry-api\src\main\java\org\apache\dubbo\registry\client\migration\ServiceDiscoveryMigrationInvoker.java,39,19,1,4,0,24
dubbo-3.0\dubbo-3.0\dubbo-common\src\main\java\org\apache\dubbo\common\timer\TimerTask.java,0,2,0,2,0,4
dubbo-3.0\dubbo-3.0\dubbo-registry\dubbo-registry-api\src\main\java\org\apache\dubbo\registry\RegistryFactory.java,0,2,0,3,0,5
dubbo-3.0\dubbo-3.0\dubbo-cluster\src\main\java\org\apache\dubbo\rpc\cluster\router\RouterSnapshotFilter.java,0,23,0,7,0,30
dubbo-3.0\dubbo-3.0\dubbo-plugin\dubbo-qos\src\test\java\org\apache\dubbo\qos\command\CommandContextTest.java,27,2,0,2,0,4
dubbo-3.0\dubbo-3.0\dubbo-registry\dubbo-registry-nacos\src\test\java\org\apache\dubbo\registry\nacos\NacosRegistryFactoryTest.java,31,14,1,7,0,22
dubbo-3.0\dubbo-3.0\dubbo-compatible\src\main\java\com\alibaba\dubbo\config\ProtocolConfig.java,0,6,1,1,0,8
dubbo-3.0\dubbo-3.0\dubbo-plugin\dubbo-qos\src\test\java\org\apache\dubbo\qos\legacy\service\Person.java,23,15,0,1,0,16
dubbo-3.0\dubbo-3.0\dubbo-common\src\main\java\org\apache\dubbo\common\config\SystemConfiguration.java,12,6,0,2,0,8
dubbo-3.0\dubbo-3.0\dubbo-common\src\test\java\org\apache\dubbo\common\config\OrderedPropertiesConfigurationTest.java,10,4,0,3,0,7
dubbo-3.0\dubbo-3.0\dubbo-common\src\main\java\org\apache\dubbo\common\config\ConfigurationUtils.java,380,165,4,53,0,222
dubbo-3.0\dubbo-3.0\dubbo-config\dubbo-config-api\src\test\java\org\apache\dubbo\config\api\Greeting.java,0,1,0,1,0,2
dubbo-3.0\dubbo-3.0\dubbo-registry\dubbo-registry-api\src\test\java\org\apache\dubbo\registry\support\AbstractRegistryTest.java,514,108,34,55,0,197
dubbo-3.0\dubbo-3.0\dubbo-remoting\dubbo-remoting-api\src\main\java\org\apache\dubbo\remoting\Transporters.java,56,20,1,6,0,27
dubbo-3.0\dubbo-3.0\dubbo-rpc\dubbo-rpc-triple\src\main\java\org\apache\dubbo\rpc\protocol\tri\call\ObserverToClientCallListenerAdapter.java,0,15,0,3,0,18
dubbo-3.0\dubbo-3.0\dubbo-cluster\src\main\java\org\apache\dubbo\rpc\cluster\support\merger\DefaultProviderURLMergeProcessor.java,78,10,2,13,0,25
dubbo-3.0\dubbo-3.0\dubbo-plugin\dubbo-qos\src\test\java\org\apache\dubbo\qos\legacy\LogTelnetHandlerTest.java,25,5,0,1,0,6
dubbo-3.0\dubbo-3.0\dubbo-common\src\test\java\org\apache\dubbo\rpc\model\ScopeModelTest.java,85,17,2,16,0,35
dubbo-3.0\dubbo-3.0\dubbo-metadata\dubbo-metadata-api\src\main\java\org\apache\dubbo\metadata\report\MetadataReport.java,0,43,3,13,0,59
dubbo-3.0\dubbo-3.0\dubbo-native-plugin\src\main\java\org\apache\dubbo\maven\plugin\CodeGenerator.java,80,37,9,16,0,62
dubbo-3.0\dubbo-3.0\dubbo-rpc\dubbo-rpc-triple\src\test\java\org\apache\dubbo\rpc\protocol\tri\stream\MockClientStreamListener.java,0,17,1,1,0,19
dubbo-3.0\dubbo-3.0\dubbo-plugin\dubbo-qos\src\test\java\org\apache\dubbo\qos\server\handler\HttpProcessHandlerTest.java,52,16,3,10,0,29
dubbo-3.0\dubbo-3.0\dubbo-config\dubbo-config-api\src\main\java\org\apache\dubbo\config\bootstrap\builders\ProtocolBuilder.java,0,173,1,3,0,177
dubbo-3.0\dubbo-3.0\dubbo-common\src\main\java\org\apache\dubbo\common\threadpool\support\AbortPolicyWithReport.java,0,42,6,12,0,60
dubbo-3.0\dubbo-3.0\dubbo-common\src\main\java\org\apache\dubbo\rpc\service\GenericException.java,41,23,1,1,0,25
dubbo-3.0\dubbo-3.0\dubbo-remoting\dubbo-remoting-api\src\main\java\org\apache\dubbo\remoting\transport\dispatcher\direct\DirectChannelHandler.java,22,10,1,5,0,16
dubbo-3.0\dubbo-3.0\dubbo-common\src\main\java\org\apache\dubbo\common\logger\LoggerAdapter.java,0,7,0,1,0,8
dubbo-3.0\dubbo-3.0\dubbo-metadata\dubbo-metadata-api\src\main\java\org\apache\dubbo\metadata\report\identifier\BaseApplicationMetadataIdentifier.java,25,13,0,1,0,14
dubbo-3.0\dubbo-3.0\dubbo-cluster\src\main\java\org\apache\dubbo\rpc\cluster\Merger.java,0,1,0,1,0,2
dubbo-3.0\dubbo-3.0\dubbo-config\dubbo-config-spring\src\test\java\org\apache\dubbo\config\spring\issues\issue6252\Issue6252Test.java,27,8,2,3,0,13
dubbo-3.0\dubbo-3.0\compiler\src\main\java\org\apache\dubbo\gen\grpc\reactive\ReactorDubboGrpcGenerator.java,21,5,0,1,0,6
dubbo-3.0\dubbo-3.0\dubbo-compatible\src\main\java\com\alibaba\dubbo\common\utils\UrlUtils.java,82,76,1,26,0,103
dubbo-3.0\dubbo-3.0\dubbo-metadata\dubbo-metadata-processor\src\test\java\org\apache\dubbo\metadata\annotation\processing\util\TypeUtilsTest.java,387,83,0,70,0,153
dubbo-3.0\dubbo-3.0\dubbo-demo\dubbo-demo-spring-boot\dubbo-demo-spring-boot-consumer\src\main\java\org\apache\dubbo\springboot\demo\consumer\ConsumerApplication.java,18,9,0,3,0,12
dubbo-3.0\dubbo-3.0\dubbo-rpc\dubbo-rpc-api\src\test\java\org\apache\dubbo\rpc\support\MyInvoker.java,60,29,0,2,0,31
dubbo-3.0\dubbo-3.0\dubbo-common\src\test\java\org\apache\dubbo\common\logger\LoggerTest.java,51,8,0,3,0,11
dubbo-3.0\dubbo-3.0\dubbo-common\src\main\java\org\apache\dubbo\config\ConfigKeys.java,0,10,4,6,0,20
dubbo-3.0\dubbo-3.0\dubbo-rpc\dubbo-rpc-triple\src\main\java\org\apache\dubbo\rpc\protocol\tri\PbUnpack.java,0,6,0,1,0,7
dubbo-3.0\dubbo-3.0\dubbo-rpc\dubbo-rpc-rest\src\main\java\org\apache\dubbo\rpc\protocol\rest\RestProtocol.java,237,71,5,37,0,113
dubbo-3.0\dubbo-3.0\dubbo-remoting\dubbo-remoting-api\src\test\java\org\apache\dubbo\remoting\exchange\ResponseTest.java,21,1,0,1,0,2
dubbo-3.0\dubbo-3.0\dubbo-config\dubbo-config-api\src\test\java\org\apache\dubbo\config\integration\Constants.java,0,5,2,3,0,10
dubbo-3.0\dubbo-3.0\dubbo-filter\dubbo-filter-cache\src\test\java\org\apache\dubbo\cache\support\expiring\ExpiringCacheFactoryTest.java,77,20,0,4,0,24
dubbo-3.0\dubbo-3.0\dubbo-plugin\dubbo-qos\src\main\java\org\apache\dubbo\qos\command\util\CommandHelper.java,43,17,1,5,0,23
dubbo-3.0\dubbo-3.0\dubbo-test\dubbo-test-spring\src\main\java\org\apache\dubbo\test\spring\context\MockSpringInitCustomizer.java,59,19,0,9,0,28
dubbo-3.0\dubbo-3.0\dubbo-remoting\dubbo-remoting-netty4\src\test\java\org\apache\dubbo\remoting\transport\netty4\DemoServiceImpl.java,10,8,0,1,0,9
dubbo-3.0\dubbo-3.0\dubbo-spring-boot\dubbo-spring-boot-compatible\autoconfigure\src\main\java\org\apache\dubbo\spring\boot\context\event\AwaitingNonWebApplicationListener.java,170,56,1,23,0,80
dubbo-3.0\dubbo-3.0\dubbo-common\src\main\java\org\apache\dubbo\common\threadpool\ThreadlessExecutor.java,154,50,2,16,0,68
dubbo-3.0\dubbo-3.0\dubbo-registry\dubbo-registry-api\src\main\java\org\apache\dubbo\registry\client\migration\InvokersChangedListener.java,0,1,0,1,0,2
dubbo-3.0\dubbo-3.0\dubbo-common\src\test\java\org\apache\dubbo\common\extension\ext8_add\impl\AddExt2_ManualAdaptive.java,7,6,1,2,0,9
dubbo-3.0\dubbo-3.0\dubbo-common\src\main\java\org\apache\dubbo\common\store\DataStore.java,0,7,0,1,0,8
dubbo-3.0\dubbo-3.0\dubbo-cluster\src\main\java\org\apache\dubbo\rpc\cluster\support\wrapper\MockClusterInvoker.java,160,43,1,19,0,63
dubbo-3.0\dubbo-3.0\dubbo-remoting\dubbo-remoting-api\src\main\java\org\apache\dubbo\remoting\transport\AbstractPeer.java,0,38,3,2,0,43
dubbo-3.0\dubbo-3.0\dubbo-common\src\test\java\org\apache\dubbo\common\utils\MemberUtilsTest.java,24,4,4,1,0,9
dubbo-3.0\dubbo-3.0\dubbo-metadata\dubbo-metadata-api\src\test\java\org\apache\dubbo\metadata\test\JTestMetadataReport4Test.java,72,53,4,18,0,75
dubbo-3.0\dubbo-3.0\dubbo-plugin\dubbo-qos\src\main\java\org\apache\dubbo\qos\command\impl\OnlineApp.java,13,4,0,1,0,5
dubbo-3.0\dubbo-3.0\dubbo-cluster\src\main\java\org\apache\dubbo\rpc\cluster\configurator\absent\AbsentConfigurator.java,13,7,0,1,0,8
dubbo-3.0\dubbo-3.0\dubbo-common\src\main\java\org\apache\dubbo\config\annotation\DubboService.java,0,105,0,14,0,119
dubbo-3.0\dubbo-3.0\dubbo-metadata\dubbo-metadata-processor\src\test\java\org\apache\dubbo\metadata\annotation\processing\builder\ServiceDefinitionBuilderTest.java,47,12,1,8,0,21
dubbo-3.0\dubbo-3.0\dubbo-common\src\test\java\org\apache\dubbo\common\extension\ext2\impl\Ext2Impl1.java,10,9,0,1,0,10
dubbo-3.0\dubbo-3.0\dubbo-serialization\dubbo-serialization-hessian2\src\main\java\org\apache\dubbo\common\serialize\hessian2\dubbo\Hessian2FactoryInitializer.java,0,6,0,2,0,8
dubbo-3.0\dubbo-3.0\dubbo-common\src\test\java\org\apache\dubbo\common\extension\ext3\impl\UseProtocolKeyExtImpl3.java,10,8,0,1,0,9
dubbo-3.0\dubbo-3.0\dubbo-common\src\test\java\org\apache\dubbo\rpc\model\User.java,52,26,2,2,0,30
dubbo-3.0\dubbo-3.0\dubbo-metadata\dubbo-metadata-definition-protobuf\src\test\java\org\apache\dubbo\metadata\definition\protobuf\model\GooglePB.java,0,1618,639,402,0,2659
dubbo-3.0\dubbo-3.0\dubbo-metadata\dubbo-metadata-processor\src\test\java\org\apache\dubbo\metadata\annotation\processing\builder\GeneralTypeDefinitionBuilderTest.java,30,14,1,10,0,25
dubbo-3.0\dubbo-3.0\dubbo-config\dubbo-config-api\src\test\java\org\apache\dubbo\config\nested\PrometheusConfigTest.java,43,16,0,11,0,27
dubbo-3.0\dubbo-3.0\dubbo-registry\dubbo-registry-api\src\test\java\org\apache\dubbo\registry\integration\RegistryProtocolTest.java,468,114,31,100,0,245
dubbo-3.0\dubbo-3.0\dubbo-config\dubbo-config-api\src\test\java\org\apache\dubbo\config\integration\single\exportmetadata\SingleRegistryCenterExportMetadataIntegrationTest.java,146,35,2,25,0,62
dubbo-3.0\dubbo-3.0\dubbo-remoting\dubbo-remoting-api\src\main\java\org\apache\dubbo\remoting\Constants.java,0,54,55,4,0,113
dubbo-3.0\dubbo-3.0\dubbo-config\dubbo-config-api\src\main\java\org\apache\dubbo\config\bootstrap\builders\MetadataReportBuilder.java,0,61,0,4,0,65
dubbo-3.0\dubbo-3.0\dubbo-plugin\dubbo-qos\src\test\java\org\apache\dubbo\qos\textui\TTableTest.java,33,12,0,1,0,13
dubbo-3.0\dubbo-3.0\dubbo-spring-boot\dubbo-spring-boot-actuator\src\main\java\org\apache\dubbo\spring\boot\actuate\endpoint\condition\CompatibleConditionalOnEnabledEndpoint.java,0,8,0,5,0,13
dubbo-3.0\dubbo-3.0\dubbo-rpc\dubbo-rpc-triple\src\main\java\org\apache\dubbo\rpc\protocol\tri\ExceptionUtils.java,55,12,2,4,0,18
dubbo-3.0\dubbo-3.0\dubbo-metadata\dubbo-metadata-processor\src\main\java\org\apache\dubbo\metadata\annotation\processing\util\FieldUtils.java,0,35,0,19,0,54
dubbo-3.0\dubbo-3.0\dubbo-registry\dubbo-registry-api\src\main\java\org\apache\dubbo\registry\client\migration\MigrationInvoker.java,487,167,9,44,0,220
dubbo-3.0\dubbo-3.0\dubbo-config\dubbo-config-spring\src\main\java\org\apache\dubbo\config\spring\context\annotation\DubboComponentScanRegistrar.java,72,25,0,14,0,39
dubbo-3.0\dubbo-3.0\dubbo-remoting\dubbo-remoting-zookeeper\src\test\java\org\apache\dubbo\remoting\zookeeper\curator\CuratorZookeeperTransporterTest.java,24,9,2,3,0,14
dubbo-3.0\dubbo-3.0\dubbo-common\src\test\java\org\apache\dubbo\common\PojoUtilsForNonPublicStaticTest.java,29,9,0,3,0,12
dubbo-3.0\dubbo-3.0\dubbo-common\src\test\java\org\apache\dubbo\rpc\model\person\Phone.java,120,55,12,3,0,70
dubbo-3.0\dubbo-3.0\dubbo-common\src\test\java\org\apache\dubbo\common\extension\ext6_wrap\impl\Ext6Impl3.java,8,3,0,1,0,4
dubbo-3.0\dubbo-3.0\dubbo-common\src\test\java\org\apache\dubbo\common\extension\ext11_no_adaptive\NoAdaptiveExtImpl.java,7,3,0,1,0,4
dubbo-3.0\dubbo-3.0\dubbo-spring-boot\dubbo-spring-boot-compatible\actuator\src\main\java\org\apache\dubbo\spring\boot\actuate\autoconfigure\DubboEndpointMetadataAutoConfiguration.java,3,3,0,4,0,7
dubbo-3.0\dubbo-3.0\dubbo-metadata\dubbo-metadata-processor\src\test\java\org\apache\dubbo\metadata\rest\DefaultRestService.java,42,25,1,1,0,27
dubbo-3.0\dubbo-3.0\dubbo-config\dubbo-config-api\src\test\java\org\apache\dubbo\config\integration\multiple\exportmetadata\MultipleRegistryCenterExportMetadataServiceListener.java,11,3,0,4,0,7
dubbo-3.0\dubbo-3.0\dubbo-common\src\test\java\org\apache\dubbo\common\extension\support\Filter3.java,3,1,0,1,0,2
dubbo-3.0\dubbo-3.0\dubbo-rpc\dubbo-rpc-grpc\src\test\java\org\apache\dubbo\rpc\protocol\grpc\support\HelloReply.java,0,112,22,9,0,143
dubbo-3.0\dubbo-3.0\dubbo-rpc\dubbo-rpc-triple\src\main\java\org\apache\dubbo\rpc\protocol\tri\stream\StreamUtils.java,87,27,3,10,0,40
dubbo-3.0\dubbo-3.0\dubbo-compatible\src\main\java\com\alibaba\dubbo\cache\Cache.java,0,1,0,1,0,2
dubbo-3.0\dubbo-3.0\dubbo-remoting\dubbo-remoting-api\src\test\java\org\apache\dubbo\remoting\PerformanceClientMain.java,8,4,1,1,0,6
dubbo-3.0\dubbo-3.0\dubbo-cluster\src\main\java\org\apache\dubbo\rpc\cluster\filter\FilterChainBuilder.java,0,141,9,37,0,187
dubbo-3.0\dubbo-3.0\dubbo-common\src\test\java\org\apache\dubbo\common\utils\MethodUtilsTest.java,140,37,0,9,0,46
dubbo-3.0\dubbo-3.0\dubbo-common\src\test\java\org\apache\dubbo\common\beanutil\JavaBeanSerializeUtilTest.java,511,171,15,120,0,306
dubbo-3.0\dubbo-3.0\dubbo-native\src\main\java\org\apache\dubbo\monitor\MonitorFactory$Adaptive.java,0,16,11,6,0,33
dubbo-3.0\dubbo-3.0\dubbo-config\dubbo-config-api\src\test\java\org\apache\dubbo\config\AbstractServiceConfigTest.java,148,31,0,9,0,40
dubbo-3.0\dubbo-3.0\dubbo-common\src\test\java\org\apache\dubbo\common\compiler\support\HelloService.java,0,1,0,1,0,2
dubbo-3.0\dubbo-3.0\dubbo-rpc\dubbo-rpc-dubbo\src\test\java\org\apache\dubbo\rpc\protocol\dubbo\MultiThreadTest.java,44,23,2,10,0,35
dubbo-3.0\dubbo-3.0\dubbo-rpc\dubbo-rpc-dubbo\src\test\java\org\apache\dubbo\rpc\protocol\dubbo\support\Man.java,23,15,0,1,0,16
dubbo-3.0\dubbo-3.0\dubbo-common\src\main\java\org\apache\dubbo\common\extension\DisableInject.java,0,0,0,1,0,1
dubbo-3.0\dubbo-3.0\dubbo-cluster\src\test\java\org\apache\dubbo\rpc\cluster\filter\DemoServiceStub.java,14,10,2,1,0,13
dubbo-3.0\dubbo-3.0\dubbo-cluster\src\test\java\org\apache\dubbo\rpc\cluster\filter\MockService.java,10,8,0,1,0,9
dubbo-3.0\dubbo-3.0\dubbo-filter\dubbo-filter-cache\src\test\java\org\apache\dubbo\cache\support\threadlocal\ThreadLocalCacheFactoryTest.java,13,3,0,1,0,4
dubbo-3.0\dubbo-3.0\dubbo-cluster\src\main\java\org\apache\dubbo\rpc\cluster\filter\ProtocolFilterWrapper.java,50,18,0,6,0,24
dubbo-3.0\dubbo-3.0\dubbo-remoting\dubbo-remoting-netty\src\test\java\org\apache\dubbo\remoting\transport\netty\ClientToServerTest.java,59,15,3,3,0,21
dubbo-3.0\dubbo-3.0\dubbo-config\dubbo-config-spring\src\test\java\org\apache\dubbo\config\spring\action\DemoActionBySetter.java,14,8,0,1,0,9
dubbo-3.0\dubbo-3.0\dubbo-registry\dubbo-registry-api\src\test\java\org\apache\dubbo\registry\client\metadata\MetadataServiceNameMappingTest.java,97,29,6,15,0,50
dubbo-3.0\dubbo-3.0\dubbo-remoting\dubbo-remoting-api\src\test\java\org\apache\dubbo\remoting\transport\CodecSupportTest.java,21,1,0,1,0,2
dubbo-3.0\dubbo-3.0\dubbo-rpc\dubbo-rpc-grpc\src\main\java\org\apache\dubbo\rpc\protocol\grpc\GrpcInvoker.java,89,26,2,6,0,34
dubbo-3.0\dubbo-3.0\dubbo-spring-boot\dubbo-spring-boot-compatible\autoconfigure\src\main\java\org\apache\dubbo\spring\boot\context\DubboApplicationContextInitializer.java,0,12,1,7,0,20
dubbo-3.0\dubbo-3.0\dubbo-metadata\dubbo-metadata-api\src\main\java\org\apache\dubbo\metadata\rest\jaxrs\HeaderParamParameterProcessor.java,16,16,0,8,0,24
dubbo-3.0\dubbo-3.0\dubbo-remoting\dubbo-remoting-api\src\test\java\org\apache\dubbo\remoting\buffer\HeapChannelBufferTest.java,32,4,0,1,0,5
dubbo-3.0\dubbo-3.0\dubbo-common\src\main\java\org\apache\dubbo\common\config\configcenter\AbstractDynamicConfigurationFactory.java,13,7,1,5,0,13
dubbo-3.0\dubbo-3.0\dubbo-common\src\test\java\org\apache\dubbo\common\io\UnsafeStringWriterTest.java,74,11,0,2,0,13
dubbo-3.0\dubbo-3.0\dubbo-metadata\dubbo-metadata-definition-protobuf\src\test\java\org\apache\dubbo\metadata\definition\protobuf\ProtobufTypeBuilderTest.java,56,17,0,12,0,29
dubbo-3.0\dubbo-3.0\dubbo-remoting\dubbo-remoting-api\src\test\java\org\apache\dubbo\remoting\transport\DecodeHandlerTest.java,52,6,0,1,0,7
dubbo-3.0\dubbo-3.0\dubbo-plugin\dubbo-qos\src\main\java\org\apache\dubbo\qos\textui\TComponent.java,0,4,0,1,0,5
dubbo-3.0\dubbo-3.0\dubbo-metadata\dubbo-metadata-report-redis\src\test\java\org\apache\dubbo\metadata\store\redis\RedisMetadataReportTest.java,191,89,4,37,0,130
dubbo-3.0\dubbo-3.0\dubbo-monitor\dubbo-monitor-default\src\test\java\org\apache\dubbo\monitor\dubbo\StatisticsTest.java,68,16,19,11,0,46
dubbo-3.0\dubbo-3.0\dubbo-rpc\dubbo-rpc-api\src\main\java\org\apache\dubbo\rpc\CancellationContext.java,87,27,2,4,0,33
dubbo-3.0\dubbo-3.0\dubbo-filter\dubbo-filter-validation\src\main\java\org\apache\dubbo\validation\MethodValidated.java,0,4,0,3,0,7
dubbo-3.0\dubbo-3.0\dubbo-common\src\test\java\org\apache\dubbo\common\utils\ConfigUtilsTest.java,245,67,4,35,0,106
dubbo-3.0\dubbo-3.0\dubbo-common\src\test\java\org\apache\dubbo\common\compiler\support\JavaCodeTest.java,91,19,1,7,0,27
dubbo-3.0\dubbo-3.0\dubbo-plugin\dubbo-qos\src\test\java\org\apache\dubbo\qos\legacy\service\generic\User.java,43,15,1,1,0,17
dubbo-3.0\dubbo-3.0\dubbo-remoting\dubbo-remoting-api\src\main\java\org\apache\dubbo\remoting\exchange\Exchanger.java,0,3,0,4,0,7
dubbo-3.0\dubbo-3.0\dubbo-remoting\dubbo-remoting-api\src\test\java\org\apache\dubbo\remoting\telnet\support\HelpTelnetHandlerTest.java,23,10,0,4,0,14
dubbo-3.0\dubbo-3.0\dubbo-common\src\test\java\org\apache\dubbo\common\io\BytesTest.java,138,75,1,11,0,87
dubbo-3.0\dubbo-3.0\dubbo-cluster\src\test\java\org\apache\dubbo\rpc\cluster\router\mesh\rule\virtualservice\match\DubboAttachmentMatchTest.java,176,26,0,24,0,50
dubbo-3.0\dubbo-3.0\dubbo-common\src\test\java\org\apache\dubbo\config\AbstractInterfaceConfigTest.java,212,37,0,10,0,47
dubbo-3.0\dubbo-3.0\dubbo-common\src\main\java\org\apache\dubbo\common\utils\DubboAppender.java,45,12,0,1,0,13
dubbo-3.0\dubbo-3.0\dubbo-filter\dubbo-filter-validation\src\main\java\org\apache\dubbo\validation\filter\ValidationFilter.java,41,20,1,13,0,34
dubbo-3.0\dubbo-3.0\dubbo-common\src\test\java\org\apache\dubbo\config\GreetingLocal2.java,7,1,0,1,0,2
dubbo-3.0\dubbo-3.0\dubbo-config\dubbo-config-api\src\test\java\org\apache\dubbo\config\integration\single\SingleRegistryCenterIntegrationService.java,0,1,0,1,0,2
dubbo-3.0\dubbo-3.0\dubbo-monitor\dubbo-monitor-api\src\test\java\org\apache\dubbo\monitor\support\AbstractMonitorFactoryTest.java,73,15,3,5,0,23
dubbo-3.0\dubbo-3.0\dubbo-remoting\dubbo-remoting-netty\src\main\java\org\apache\dubbo\remoting\transport\netty\NettyServer.java,114,30,12,13,0,55
dubbo-3.0\dubbo-3.0\dubbo-rpc\dubbo-rpc-triple\src\main\java\org\apache\dubbo\rpc\protocol\tri\TripleProtocol.java,138,46,2,20,0,68
dubbo-3.0\dubbo-3.0\dubbo-config\dubbo-config-api\src\test\java\org\apache\dubbo\config\cache\CacheServiceImpl.java,10,5,0,1,0,6
dubbo-3.0\dubbo-3.0\dubbo-container\dubbo-container-api\src\main\java\org\apache\dubbo\container\Main.java,70,18,8,10,0,36
dubbo-3.0\dubbo-3.0\dubbo-common\src\main\java\org\apache\dubbo\common\threadpool\support\eager\EagerThreadPoolExecutor.java,33,13,1,3,0,17
dubbo-3.0\dubbo-3.0\dubbo-common\src\test\java\org\apache\dubbo\common\constants\CommonConstantsTest.java,11,5,0,7,0,12
dubbo-3.0\dubbo-3.0\dubbo-common\src\test\java\org\apache\dubbo\common\extension\ext8_add\AddExt1.java,0,3,0,1,0,4
dubbo-3.0\dubbo-3.0\dubbo-rpc\dubbo-rpc-rest\src\main\java\org\apache\dubbo\rpc\protocol\rest\support\LoggingFilter.java,0,39,3,11,0,53
dubbo-3.0\dubbo-3.0\dubbo-rpc\dubbo-rpc-api\src\main\java\org\apache\dubbo\rpc\filter\ProfilerServerFilter.java,0,44,2,18,0,64
dubbo-3.0\dubbo-3.0\dubbo-config\dubbo-config-api\src\test\java\org\apache\dubbo\config\bootstrap\builders\AbstractBuilderTest.java,0,1,0,1,0,2
dubbo-3.0\dubbo-3.0\dubbo-config\dubbo-config-api\src\test\java\org\apache\dubbo\config\integration\single\exportmetadata\SingleRegistryCenterExportMetadataExporterListener.java,11,3,0,3,0,6
dubbo-3.0\dubbo-3.0\dubbo-config\dubbo-config-api\src\test\java\org\apache\dubbo\config\bootstrap\builders\AbstractServiceBuilderTest.java,0,21,0,8,0,29
dubbo-3.0\dubbo-3.0\dubbo-rpc\dubbo-rpc-api\src\test\java\org\apache\dubbo\rpc\RpcStatusTest.java,101,31,4,7,0,42
dubbo-3.0\dubbo-3.0\dubbo-cluster\src\test\java\org\apache\dubbo\rpc\cluster\loadbalance\ConsistentHashLoadBalanceTest.java,35,14,1,9,0,24
dubbo-3.0\dubbo-3.0\dubbo-cluster\src\test\java\org\apache\dubbo\rpc\cluster\router\condition\ConditionStateRouterTest.java,334,142,16,106,0,264
dubbo-3.0\dubbo-3.0\dubbo-common\src\test\java\org\apache\dubbo\common\config\configcenter\file\FileSystemDynamicConfigurationFactoryTest.java,8,4,0,2,0,6
dubbo-3.0\dubbo-3.0\dubbo-common\src\test\java\org\apache\dubbo\common\extension\director\FooModuleProvider.java,0,1,0,1,0,2
dubbo-3.0\dubbo-3.0\dubbo-remoting\dubbo-remoting-netty\src\test\java\org\apache\dubbo\remoting\transport\netty\WorldHandler.java,12,8,0,2,0,10
dubbo-3.0\dubbo-3.0\dubbo-cluster\src\main\java\org\apache\dubbo\rpc\cluster\Directory.java,0,17,0,4,0,21
dubbo-3.0\dubbo-3.0\dubbo-cluster\src\test\java\org\apache\dubbo\rpc\cluster\merger\IntSumMerger.java,9,2,0,1,0,3
dubbo-3.0\dubbo-3.0\dubbo-compatible\src\main\java\com\alibaba\dubbo\common\extension\ExtensionFactory.java,0,2,0,2,0,4
dubbo-3.0\dubbo-3.0\dubbo-common\src\main\java\org\apache\dubbo\common\extension\ExtensionDirector.java,129,45,1,12,0,58
dubbo-3.0\dubbo-3.0\dubbo-remoting\dubbo-remoting-api\src\main\java\org\apache\dubbo\remoting\RemotingServer.java,0,3,0,3,0,6
dubbo-3.0\dubbo-3.0\dubbo-common\src\test\java\org\apache\dubbo\common\concurrent\CompletableFutureTaskTest.java,58,16,1,8,0,25
dubbo-3.0\dubbo-3.0\dubbo-plugin\dubbo-qos\src\main\java\org\apache\dubbo\qos\command\impl\EnableRouterSnapshot.java,31,14,2,7,0,23
dubbo-3.0\dubbo-3.0\dubbo-cluster\src\main\java\org\apache\dubbo\rpc\cluster\directory\AbstractDirectory.java,364,115,13,39,0,167
dubbo-3.0\dubbo-3.0\dubbo-cluster\src\test\java\org\apache\dubbo\rpc\cluster\router\mesh\rule\DestinationRuleTest.java,72,21,0,24,0,45
dubbo-3.0\dubbo-3.0\dubbo-registry\dubbo-registry-api\src\main\java\org\apache\dubbo\registry\client\migration\MigrationRuleListener.java,0,82,9,33,0,124
dubbo-3.0\dubbo-3.0\dubbo-common\src\main\java\org\apache\dubbo\common\utils\RegexProperties.java,32,5,0,2,0,7
dubbo-3.0\dubbo-3.0\dubbo-registry\dubbo-registry-multiple\src\main\java\org\apache\dubbo\registry\multiple\MultipleServiceDiscoveryFactory.java,7,3,0,2,0,5
dubbo-3.0\dubbo-3.0\dubbo-remoting\dubbo-remoting-api\src\main\java\org\apache\dubbo\remoting\transport\ServerDelegate.java,91,33,1,1,0,35
dubbo-3.0\dubbo-3.0\dubbo-metadata\dubbo-metadata-processor\src\main\java\org\apache\dubbo\metadata\annotation\processing\util\MemberUtils.java,0,11,1,7,0,19
dubbo-3.0\dubbo-3.0\dubbo-common\src\main\java\org\apache\dubbo\common\constants\ClusterRules.java,0,14,9,7,0,30
dubbo-3.0\dubbo-3.0\dubbo-common\src\test\java\org\apache\dubbo\common\extension\ext2\Ext2.java,0,4,0,1,0,5
dubbo-3.0\dubbo-3.0\dubbo-compatible\src\main\java\com\alibaba\dubbo\rpc\ProxyFactory.java,0,10,2,8,0,20
dubbo-3.0\dubbo-3.0\dubbo-plugin\dubbo-qos\src\test\java\org\apache\dubbo\qos\server\handler\QosProcessHandlerTest.java,33,6,0,5,0,11
dubbo-3.0\dubbo-3.0\dubbo-remoting\dubbo-remoting-api\src\main\java\org\apache\dubbo\remoting\telnet\support\command\StatusTelnetHandler.java,60,9,2,6,0,17
dubbo-3.0\dubbo-3.0\dubbo-rpc\dubbo-rpc-triple\src\main\java\org\apache\dubbo\rpc\protocol\tri\call\UnaryServerCallListener.java,35,10,0,1,0,11
dubbo-3.0\dubbo-3.0\dubbo-config\dubbo-config-api\src\main\java\org\apache\dubbo\config\bootstrap\BootstrapTakeoverMode.java,0,8,0,2,0,10
dubbo-3.0\dubbo-3.0\dubbo-common\src\main\java\org\apache\dubbo\common\logger\log4j2\Log4j2Logger.java,109,45,0,1,0,46
dubbo-3.0\dubbo-3.0\dubbo-config\dubbo-config-spring\src\test\java\org\apache\dubbo\config\spring\boot\importxml2\HelloServiceImpl.java,9,3,0,1,0,4
dubbo-3.0\dubbo-3.0\dubbo-metadata\dubbo-metadata-processor\src\test\java\org\apache\dubbo\metadata\annotation\processing\model\SimpleTypeModel.java,135,93,1,1,0,95
dubbo-3.0\dubbo-3.0\dubbo-plugin\dubbo-qos\src\main\java\org\apache\dubbo\qos\command\impl\InvokeTelnet.java,230,48,4,24,0,76
dubbo-3.0\dubbo-3.0\dubbo-rpc\dubbo-rpc-api\src\test\java\org\apache\dubbo\rpc\support\DemoServiceStub.java,12,7,0,1,0,8
dubbo-3.0\dubbo-3.0\dubbo-config\dubbo-config-api\src\test\java\org\apache\dubbo\config\integration\single\exportprovider\SingleRegistryCenterExportProviderServiceImpl.java,10,3,0,2,0,5
dubbo-3.0\dubbo-3.0\dubbo-demo\dubbo-demo-xml\dubbo-demo-xml-provider\src\main\java\org\apache\dubbo\demo\provider\Application.java,8,5,1,2,0,8
dubbo-3.0\dubbo-3.0\dubbo-test\dubbo-test-common\src\main\java\org\apache\dubbo\test\common\api\DemoService.java,0,3,0,1,0,4
dubbo-3.0\dubbo-3.0\dubbo-cluster\src\main\java\org\apache\dubbo\rpc\cluster\router\file\FileStateRouterFactory.java,43,13,0,4,0,17
dubbo-3.0\dubbo-3.0\dubbo-common\src\test\java\org\apache\dubbo\rpc\model\ModuleServiceRepositoryTest.java,84,24,1,16,0,41
dubbo-3.0\dubbo-3.0\dubbo-compatible\src\test\java\org\apache\dubbo\serialization\MyObjectInput.java,69,21,0,3,0,24
dubbo-3.0\dubbo-3.0\dubbo-common\src\main\java\org\apache\dubbo\common\config\configcenter\DynamicConfigurationFactory.java,0,3,0,2,0,5
dubbo-3.0\dubbo-3.0\dubbo-remoting\dubbo-remoting-api\src\main\java\org\apache\dubbo\remoting\api\ProtocolDetector.java,0,6,1,1,0,8
dubbo-3.0\dubbo-3.0\dubbo-plugin\dubbo-qos\src\test\java\org\apache\dubbo\qos\legacy\service\generic\DemoServiceImpl.java,21,12,0,1,0,13
dubbo-3.0\dubbo-3.0\dubbo-rpc\dubbo-rpc-dubbo\src\test\java\org\apache\dubbo\rpc\protocol\dubbo\IDemoService.java,0,1,0,1,0,2
dubbo-3.0\dubbo-3.0\dubbo-rpc\dubbo-rpc-triple\src\test\java\org\apache\dubbo\rpc\protocol\tri\support\IGreeterImpl.java,41,14,0,3,0,17
dubbo-3.0\dubbo-3.0\dubbo-cluster\src\main\java\org\apache\dubbo\rpc\cluster\merger\MergerFactory.java,74,21,3,7,0,31
dubbo-3.0\dubbo-3.0\dubbo-common\src\test\java\org\apache\dubbo\common\extension\ext8_add\AddExt4.java,0,1,0,1,0,2
dubbo-3.0\dubbo-3.0\dubbo-filter\dubbo-filter-cache\src\main\java\org\apache\dubbo\cache\support\lfu\LfuCacheFactory.java,14,3,0,3,0,6
dubbo-3.0\dubbo-3.0\dubbo-rpc\dubbo-rpc-triple\src\main\java\org\apache\dubbo\rpc\protocol\tri\TripleHttp2Protocol.java,102,49,2,25,0,76
dubbo-3.0\dubbo-3.0\dubbo-common\src\test\java\org\apache\dubbo\config\context\ConfigConfigurationAdapterTest.java,16,7,2,4,0,13
dubbo-3.0\dubbo-3.0\dubbo-compatible\src\main\java\com\alibaba\dubbo\rpc\cluster\Merger.java,0,0,0,1,0,1
dubbo-3.0\dubbo-3.0\dubbo-rpc\dubbo-rpc-dubbo\src\main\java\org\apache\dubbo\rpc\protocol\dubbo\status\ThreadPoolStatusChecker.java,35,8,0,7,0,15
dubbo-3.0\dubbo-3.0\dubbo-compatible\src\test\java\org\apache\dubbo\service\MockInvocation.java,136,58,2,2,0,62
dubbo-3.0\dubbo-3.0\dubbo-compatible\src\main\java\com\alibaba\dubbo\cache\CacheFactory.java,0,1,0,1,0,2
dubbo-3.0\dubbo-3.0\dubbo-config\dubbo-config-spring\src\main\java\org\apache\dubbo\config\spring\context\DubboInfraBeanRegisterPostProcessor.java,0,30,0,22,0,52
dubbo-3.0\dubbo-3.0\dubbo-rpc\dubbo-rpc-api\src\main\java\org\apache\dubbo\rpc\AsyncRpcResult.java,0,124,2,38,0,164
dubbo-3.0\dubbo-3.0\dubbo-common\src\main\java\org\apache\dubbo\common\config\configcenter\TreePathDynamicConfiguration.java,141,66,0,25,0,91
dubbo-3.0\dubbo-3.0\dubbo-metadata\dubbo-metadata-api\src\main\java\org\apache\dubbo\metadata\rest\jaxrs\QueryParamParameterProcessor.java,8,5,0,4,0,9
dubbo-3.0\dubbo-3.0\dubbo-registry\dubbo-registry-api\src\main\java\org\apache\dubbo\registry\client\ServiceDiscoveryRegistry.java,373,140,11,72,0,223
dubbo-3.0\dubbo-3.0\dubbo-monitor\dubbo-monitor-default\src\test\java\org\apache\dubbo\monitor\dubbo\AppResponseBuilder.java,34,17,9,1,0,27
dubbo-3.0\dubbo-3.0\dubbo-config\dubbo-config-spring\src\test\java\org\apache\dubbo\config\spring\boot\conditional2\JavaConfigAnnotationReferenceBeanConditionalTest.java,54,18,1,4,0,23
dubbo-3.0\dubbo-3.0\dubbo-cluster\src\main\java\org\apache\dubbo\rpc\cluster\router\mesh\rule\destination\Subset.java,29,18,0,1,0,19
dubbo-3.0\dubbo-3.0\dubbo-cluster\src\test\java\org\apache\dubbo\rpc\cluster\router\mesh\route\MeshRuleCacheTest.java,70,10,1,8,0,19
dubbo-3.0\dubbo-3.0\dubbo-common\src\main\java\org\apache\dubbo\common\utils\Utf8Utils.java,0,100,2,25,0,127
dubbo-3.0\dubbo-3.0\dubbo-config\dubbo-config-api\src\main\java\org\apache\dubbo\config\utils\CompositeReferenceCache.java,81,28,0,4,0,32
dubbo-3.0\dubbo-3.0\dubbo-config\dubbo-config-api\src\test\java\org\apache\dubbo\config\mock\MockRegistry.java,80,21,6,6,0,33
dubbo-3.0\dubbo-3.0\dubbo-rpc\dubbo-rpc-api\src\main\java\org\apache\dubbo\rpc\filter\ContextFilter.java,0,26,0,17,0,43
dubbo-3.0\dubbo-3.0\dubbo-registry\dubbo-registry-api\src\test\java\org\apache\dubbo\registry\service\DemoService2.java,0,1,0,1,0,2
dubbo-3.0\dubbo-3.0\dubbo-metadata\dubbo-metadata-api\src\test\java\org\apache\dubbo\metadata\report\support\AbstractMetadataReportTest.java,345,178,7,90,0,275
dubbo-3.0\dubbo-3.0\dubbo-remoting\dubbo-remoting-api\src\test\java\org\apache\dubbo\remoting\codec\ExchangeCodecTest.java,427,181,25,52,0,258
dubbo-3.0\dubbo-3.0\dubbo-spring-boot\dubbo-spring-boot-autoconfigure\src\test\java\org\apache\dubbo\spring\boot\env\DubboDefaultPropertiesEnvironmentPostProcessorTest.java,66,21,0,16,0,37
dubbo-3.0\dubbo-3.0\dubbo-metadata\dubbo-metadata-definition-protobuf\src\main\java\org\apache\dubbo\metadata\definition\protobuf\ProtobufTypeBuilder.java,0,72,5,29,0,106
dubbo-3.0\dubbo-3.0\dubbo-metadata\dubbo-metadata-processor\src\main\java\org\apache\dubbo\metadata\annotation\processing\util\TypeUtils.java,0,97,0,38,0,135
dubbo-3.0\dubbo-3.0\dubbo-cluster\src\test\java\org\apache\dubbo\rpc\cluster\support\ClusterUtilsTest.java,131,26,0,21,0,47
dubbo-3.0\dubbo-3.0\dubbo-config\dubbo-config-api\src\test\java\org\apache\dubbo\config\bootstrap\builders\ConsumerBuilderTest.java,0,17,0,2,0,19
dubbo-3.0\dubbo-3.0\dubbo-config\dubbo-config-api\src\test\java\org\apache\dubbo\config\MetricsConfigTest.java,93,29,0,18,0,47
dubbo-3.0\dubbo-3.0\dubbo-common\src\test\java\org\apache\dubbo\common\convert\multiple\StringToListConverterTest.java,67,13,5,6,0,24
dubbo-3.0\dubbo-3.0\dubbo-filter\dubbo-filter-cache\src\main\java\org\apache\dubbo\cache\support\threadlocal\ThreadLocalCacheFactory.java,14,4,0,4,0,8
dubbo-3.0\dubbo-3.0\dubbo-rpc\dubbo-rpc-dubbo\src\test\java\org\apache\dubbo\rpc\protocol\dubbo\ReferenceCountExchangeClientTest.java,282,109,9,52,0,170
dubbo-3.0\dubbo-3.0\dubbo-rpc\dubbo-rpc-api\src\main\java\org\apache\dubbo\rpc\proxy\AbstractProxyInvoker.java,116,37,2,17,0,56
dubbo-3.0\dubbo-3.0\dubbo-test\dubbo-test-check\src\main\java\org\apache\dubbo\test\check\registrycenter\context\ZookeeperWindowsContext.java,80,15,0,6,0,21
dubbo-3.0\dubbo-3.0\dubbo-cluster\src\main\java\org\apache\dubbo\rpc\cluster\Cluster.java,0,8,0,5,0,13
dubbo-3.0\dubbo-3.0\dubbo-common\src\main\java\org\apache\dubbo\config\annotation\Argument.java,0,4,0,1,0,5
dubbo-3.0\dubbo-3.0\dubbo-rpc\dubbo-rpc-dubbo\src\main\java\org\apache\dubbo\rpc\protocol\dubbo\DubboCodecSupport.java,25,15,2,9,0,26
dubbo-3.0\dubbo-3.0\dubbo-native\src\main\java\org\apache\dubbo\remoting\Dispatcher$Adaptive.java,0,15,11,7,0,33
dubbo-3.0\dubbo-3.0\dubbo-config\dubbo-config-api\src\test\java\org\apache\dubbo\config\AbstractMethodConfigTest.java,104,21,0,1,0,22
dubbo-3.0\dubbo-3.0\dubbo-config\dubbo-config-spring\src\test\java\org\apache\dubbo\config\spring\beans\factory\config\YamlPropertySourceFactory.java,72,24,1,8,0,33
dubbo-3.0\dubbo-3.0\dubbo-metadata\dubbo-metadata-api\src\test\java\org\apache\dubbo\metadata\test\JTestMetadataReportFactory4Test.java,9,3,0,2,0,5
dubbo-3.0\dubbo-3.0\dubbo-plugin\dubbo-auth\src\main\java\org\apache\dubbo\auth\filter\ConsumerSignFilter.java,20,14,0,5,0,19
dubbo-3.0\dubbo-3.0\dubbo-config\dubbo-config-api\src\test\java\org\apache\dubbo\config\mock\MockServiceDiscovery.java,47,24,1,6,0,31
dubbo-3.0\dubbo-3.0\dubbo-rpc\dubbo-rpc-dubbo\src\main\java\org\apache\dubbo\rpc\protocol\dubbo\LazyConnectExchangeClient.java,0,52,3,19,0,74
dubbo-3.0\dubbo-3.0\dubbo-common\src\test\java\org\apache\dubbo\common\extension\adaptive\HasAdaptiveExt.java,0,2,0,1,0,3
dubbo-3.0\dubbo-3.0\dubbo-common\src\test\java\org\apache\dubbo\common\io\UnsafeByteArrayInputStreamTest.java,69,14,0,7,0,21
dubbo-3.0\dubbo-3.0\dubbo-common\src\test\java\org\apache\dubbo\common\CommonScopeModelInitializerTest.java,30,14,0,6,0,20
dubbo-3.0\dubbo-3.0\dubbo-rpc\dubbo-rpc-rest\src\test\java\org\apache\dubbo\rpc\protocol\rest\RestProtocolTest.java,212,61,1,32,0,94
dubbo-3.0\dubbo-3.0\dubbo-cluster\src\main\java\org\apache\dubbo\rpc\cluster\support\MergeableCluster.java,11,4,0,2,0,6
dubbo-3.0\dubbo-3.0\dubbo-plugin\dubbo-qos\src\main\java\org\apache\dubbo\qos\server\handler\TelnetIdleEventHandler.java,17,8,1,4,0,13
dubbo-3.0\dubbo-3.0\dubbo-rpc\dubbo-rpc-rest\src\main\java\org\apache\dubbo\rpc\protocol\rest\ViolationReport.java,22,14,0,3,0,17
dubbo-3.0\dubbo-3.0\dubbo-remoting\dubbo-remoting-api\src\main\java\org\apache\dubbo\remoting\exchange\support\DefaultFuture.java,252,95,3,29,0,127
dubbo-3.0\dubbo-3.0\dubbo-common\src\test\java\org\apache\dubbo\common\model\person\BigPerson.java,132,75,16,6,0,97
dubbo-3.0\dubbo-3.0\dubbo-remoting\dubbo-remoting-api\src\main\java\org\apache\dubbo\remoting\api\NettyEventLoopFactory.java,33,16,2,9,0,27
dubbo-3.0\dubbo-3.0\dubbo-demo\dubbo-demo-annotation\dubbo-demo-annotation-provider\src\main\java\org\apache\dubbo\demo\provider\Application.java,20,5,1,3,0,9
dubbo-3.0\dubbo-3.0\dubbo-config\dubbo-config-api\src\test\java\org\apache\dubbo\config\bootstrap\EchoServiceImpl.java,9,4,0,2,0,6
dubbo-3.0\dubbo-3.0\dubbo-cluster\src\test\java\org\apache\dubbo\rpc\cluster\support\MergeableClusterInvokerTest.java,0,78,32,52,0,162
dubbo-3.0\dubbo-3.0\dubbo-common\src\main\java\org\apache\dubbo\rpc\model\ServiceMetadata.java,78,48,1,3,0,52
dubbo-3.0\dubbo-3.0\dubbo-metadata\dubbo-metadata-api\src\main\java\org\apache\dubbo\metadata\rest\ServiceRestMetadataResolver.java,0,4,0,2,0,6
dubbo-3.0\dubbo-3.0\dubbo-metadata\dubbo-metadata-processor\src\main\java\org\apache\dubbo\metadata\annotation\processing\AbstractServiceAnnotationProcessor.java,67,29,0,9,0,38
dubbo-3.0\dubbo-3.0\dubbo-common\src\main\java\org\apache\dubbo\common\convert\multiple\StringToQueueConverter.java,11,7,0,1,0,8
dubbo-3.0\dubbo-3.0\dubbo-common\src\main\java\org\apache\dubbo\rpc\model\ScopeModelUtil.java,100,32,1,15,0,48
dubbo-3.0\dubbo-3.0\dubbo-common\src\test\java\org\apache\dubbo\common\cache\FileCacheStoreTest.java,51,9,1,3,0,13
dubbo-3.0\dubbo-3.0\dubbo-monitor\dubbo-monitor-api\src\main\java\org\apache\dubbo\monitor\support\AbstractMonitorFactory.java,66,16,2,7,0,25
dubbo-3.0\dubbo-3.0\dubbo-rpc\dubbo-rpc-api\src\test\java\org\apache\dubbo\rpc\support\DemoService.java,0,20,2,1,0,23
dubbo-3.0\dubbo-3.0\dubbo-native\src\main\java\org\apache\dubbo\rpc\cluster\router\state\StateRouterFactory$Adaptive.java,0,18,12,6,0,36
dubbo-3.0\dubbo-3.0\dubbo-common\src\main\java\org\apache\dubbo\common\utils\StringUtils.java,0,223,23,34,0,280
dubbo-3.0\dubbo-3.0\dubbo-registry\dubbo-registry-api\src\test\java\org\apache\dubbo\registry\support\FailbackRegistryTest.java,210,56,12,15,0,83
dubbo-3.0\dubbo-3.0\dubbo-cluster\src\test\java\org\apache\dubbo\rpc\cluster\support\wrapper\MockProviderRpcExceptionTest.java,203,100,12,15,0,127
dubbo-3.0\dubbo-3.0\dubbo-config\dubbo-config-api\src\test\java\org\apache\dubbo\config\bootstrap\ConsulDubboServiceProviderBootstrap.java,17,9,1,6,0,16
dubbo-3.0\dubbo-3.0\dubbo-compatible\src\main\java\com\alibaba\dubbo\qos\command\CommandContext.java,0,9,0,2,0,11
dubbo-3.0\dubbo-3.0\dubbo-common\src\main\java\org\apache\dubbo\common\config\configcenter\file\FileSystemDynamicConfiguration.java,552,185,9,55,0,249
dubbo-3.0\dubbo-3.0\dubbo-cluster\src\main\java\org\apache\dubbo\rpc\cluster\router\mesh\rule\virtualservice\match\ListDoubleMatch.java,22,10,0,1,0,11
dubbo-3.0\dubbo-3.0\dubbo-test\dubbo-test-check\src\main\java\org\apache\dubbo\test\check\registrycenter\context\ZookeeperContext.java,67,12,0,1,0,13
dubbo-3.0\dubbo-3.0\dubbo-plugin\dubbo-qos\src\main\java\org\apache\dubbo\qos\command\impl\PublishMetadata.java,37,17,0,9,0,26
dubbo-3.0\dubbo-3.0\dubbo-metadata\dubbo-metadata-processor\src\test\java\org\apache\dubbo\metadata\tools\DefaultRestServiceTest.java,13,2,0,1,0,3
dubbo-3.0\dubbo-3.0\dubbo-metadata\dubbo-metadata-processor\src\test\java\org\apache\dubbo\metadata\annotation\processing\util\MemberUtilsTest.java,65,27,1,13,0,41
dubbo-3.0\dubbo-3.0\dubbo-common\src\test\java\org\apache\dubbo\common\extension\ext4\NoUrlParamExt.java,0,2,0,1,0,3
dubbo-3.0\dubbo-3.0\dubbo-common\src\main\java\org\apache\dubbo\common\config\OrderedPropertiesConfiguration.java,63,30,0,6,0,36
dubbo-3.0\dubbo-3.0\dubbo-common\src\test\java\org\apache\dubbo\rpc\support\MockScopeModelDestroyListener.java,19,10,0,2,0,12
dubbo-3.0\dubbo-3.0\dubbo-config\dubbo-config-spring\src\test\java\org\apache\dubbo\config\spring\GenericDemoService.java,7,7,2,2,0,11
dubbo-3.0\dubbo-3.0\dubbo-common\src\main\java\org\apache\dubbo\common\function\Predicates.java,0,10,0,4,0,14
dubbo-3.0\dubbo-3.0\dubbo-common\src\test\java\org\apache\dubbo\common\beans\model\FooBeanWithModuleModel.java,12,6,0,1,0,7
dubbo-3.0\dubbo-3.0\dubbo-common\src\test\java\org\apache\dubbo\common\extension\ext9_empty\Ext9Empty.java,0,2,0,1,0,3
dubbo-3.0\dubbo-3.0\dubbo-metadata\dubbo-metadata-processor\src\main\java\org\apache\dubbo\metadata\annotation\processing\rest\DefaultServiceRestMetadataResolver.java,140,66,1,30,0,97
dubbo-3.0\dubbo-3.0\dubbo-remoting\dubbo-remoting-zookeeper\src\test\java\org\apache\dubbo\remoting\zookeeper\curator\CuratorZookeeperClientTest.java,158,38,2,10,0,50
dubbo-3.0\dubbo-3.0\dubbo-rpc\dubbo-rpc-api\src\test\java\org\apache\dubbo\rpc\proxy\DemoService.java,0,9,0,1,0,10
dubbo-3.0\dubbo-3.0\dubbo-metadata\dubbo-metadata-api\src\main\java\org\apache\dubbo\metadata\AbstractServiceNameMapping.java,0,95,13,33,0,141
dubbo-3.0\dubbo-3.0\dubbo-registry\dubbo-registry-api\src\test\java\org\apache\dubbo\registry\client\ServiceDiscoveryRegistryTest.java,201,67,1,48,0,116
dubbo-3.0\dubbo-3.0\dubbo-remoting\dubbo-remoting-netty4\src\main\java\org\apache\dubbo\remoting\transport\netty4\NettyServer.java,184,48,10,20,0,78
dubbo-3.0\dubbo-3.0\dubbo-metadata\dubbo-metadata-api\src\test\java\org\apache\dubbo\metadata\rest\SpringRestService.java,57,29,1,9,0,39
dubbo-3.0\dubbo-3.0\dubbo-remoting\dubbo-remoting-netty4\src\test\java\org\apache\dubbo\remoting\transport\netty4\ClientToServerTest.java,38,14,2,3,0,19
dubbo-3.0\dubbo-3.0\dubbo-config\dubbo-config-spring\src\test\java\org\apache\dubbo\config\spring\impl\DemoServiceImpl_LongWaiting.java,16,9,1,1,0,11
dubbo-3.0\dubbo-3.0\dubbo-registry\dubbo-registry-api\src\main\java\org\apache\dubbo\registry\client\metadata\ServiceInstanceMetadataUtils.java,196,84,1,40,0,125
dubbo-3.0\dubbo-3.0\dubbo-plugin\dubbo-qos\src\main\java\org\apache\dubbo\qos\command\impl\GetRouterSnapshot.java,43,20,2,13,0,35
dubbo-3.0\dubbo-3.0\dubbo-common\src\test\java\org\apache\dubbo\common\extension\director\impl\TestFrameworkService.java,38,23,1,2,0,26
dubbo-3.0\dubbo-3.0\dubbo-rpc\dubbo-rpc-api\src\main\java\org\apache\dubbo\rpc\filter\DeprecatedFilter.java,39,13,1,8,0,22
dubbo-3.0\dubbo-3.0\dubbo-common\src\test\java\org\apache\dubbo\metadata\definition\common\OuterClass.java,20,8,0,1,0,9
dubbo-3.0\dubbo-3.0\dubbo-metadata\dubbo-metadata-processor\src\main\java\org\apache\dubbo\metadata\annotation\processing\rest\jaxrs\HeaderParamParameterProcessor.java,17,16,0,10,0,26
dubbo-3.0\dubbo-3.0\dubbo-rpc\dubbo-rpc-api\src\main\java\org\apache\dubbo\rpc\RpcInvocation.java,0,346,1,42,0,389
dubbo-3.0\dubbo-3.0\dubbo-rpc\dubbo-rpc-triple\src\test\java\org\apache\dubbo\rpc\protocol\tri\frame\TriDecoderTest.java,0,1,0,1,0,2
dubbo-3.0\dubbo-3.0\dubbo-common\src\test\java\org\apache\dubbo\common\extension\support\OldFilter5.java,3,0,0,1,0,1
dubbo-3.0\dubbo-3.0\dubbo-filter\dubbo-filter-validation\src\main\java\org\apache\dubbo\validation\support\jvalidation\JValidation.java,14,3,0,1,0,4
dubbo-3.0\dubbo-3.0\dubbo-remoting\dubbo-remoting-http\src\test\java\org\apache\dubbo\remoting\http\tomcat\TomcatHttpBinderTest.java,23,7,0,4,0,11
dubbo-3.0\dubbo-3.0\dubbo-plugin\dubbo-qos\src\test\java\org\apache\dubbo\qos\command\decoder\HttpCommandDecoderTest.java,29,3,0,1,0,4
dubbo-3.0\dubbo-3.0\dubbo-filter\dubbo-filter-validation\src\test\java\org\apache\dubbo\validation\support\jvalidation\mock\ValidationParameter.java,12,5,3,1,0,9
dubbo-3.0\dubbo-3.0\dubbo-rpc\dubbo-rpc-api\src\main\java\org\apache\dubbo\rpc\RpcContext.java,799,176,3,31,0,210
dubbo-3.0\dubbo-3.0\dubbo-common\src\test\java\org\apache\dubbo\metadata\definition\common\ResultWithRawCollections.java,30,20,1,1,0,22
dubbo-3.0\dubbo-3.0\dubbo-compatible\src\test\java\org\apache\dubbo\rpc\cluster\RouterTest.java,25,5,0,1,0,6
dubbo-3.0\dubbo-3.0\dubbo-demo\dubbo-demo-native\dubbo-demo-native-interface\src\main\java\org\apace\dubbo\graalvm\demo\DemoService.java,0,2,0,1,0,3
dubbo-3.0\dubbo-3.0\dubbo-common\src\main\java\org\apache\dubbo\rpc\model\ModelConstants.java,0,3,2,1,0,6
dubbo-3.0\dubbo-3.0\dubbo-plugin\dubbo-qos\src\test\java\org\apache\dubbo\qos\command\impl\ShutdownTelnetTest.java,37,13,0,4,0,17
dubbo-3.0\dubbo-3.0\dubbo-rpc\dubbo-rpc-api\src\main\java\org\apache\dubbo\rpc\Filter.java,0,9,0,10,0,19
dubbo-3.0\dubbo-3.0\dubbo-common\src\main\java\org\apache\dubbo\common\config\configcenter\AbstractDynamicConfiguration.java,269,107,2,27,0,136
dubbo-3.0\dubbo-3.0\dubbo-config\dubbo-config-spring\src\main\java\org\apache\dubbo\config\spring\context\properties\DubboConfigBinder.java,0,4,0,1,0,5
dubbo-3.0\dubbo-3.0\dubbo-rpc\dubbo-rpc-injvm\src\test\java\org\apache\dubbo\rpc\protocol\injvm\IEcho.java,0,1,0,1,0,2
dubbo-3.0\dubbo-3.0\dubbo-registry\dubbo-registry-api\src\main\java\org\apache\dubbo\registry\support\SkipFailbackWrapperException.java,12,4,0,2,0,6
dubbo-3.0\dubbo-3.0\dubbo-common\src\main\java\org\apache\dubbo\common\deploy\Deployer.java,0,5,0,1,0,6
dubbo-3.0\dubbo-3.0\dubbo-common\src\main\java\org\apache\dubbo\common\convert\multiple\StringToMultiValueConverter.java,0,6,0,5,0,11
dubbo-3.0\dubbo-3.0\dubbo-common\src\test\java\org\apache\dubbo\common\threadpool\support\AbortPolicyWithReportTest.java,99,26,7,14,0,47
dubbo-3.0\dubbo-3.0\dubbo-rpc\dubbo-rpc-triple\src\main\java\org\apache\dubbo\rpc\protocol\tri\compressor\Identity.java,0,8,0,1,0,9
dubbo-3.0\dubbo-3.0\dubbo-plugin\dubbo-qos\src\test\java\org\apache\dubbo\qos\command\util\ServiceCheckUtilsTest.java,54,15,0,10,0,25
dubbo-3.0\dubbo-3.0\dubbo-rpc\dubbo-rpc-dubbo\src\test\java\org\apache\dubbo\rpc\protocol\dubbo\DubboProtocolTest.java,214,74,2,37,0,113
dubbo-3.0\dubbo-3.0\dubbo-remoting\dubbo-remoting-api\src\test\java\org\apache\dubbo\remoting\exchange\support\DefaultFutureTest.java,170,49,2,22,0,73
dubbo-3.0\dubbo-3.0\dubbo-remoting\dubbo-remoting-netty4\src\test\java\org\apache\dubbo\remoting\transport\netty4\World.java,23,12,1,1,0,14
dubbo-3.0\dubbo-3.0\dubbo-cluster\src\main\java\org\apache\dubbo\rpc\cluster\router\RouterSnapshotSwitcher.java,49,26,3,2,0,31
dubbo-3.0\dubbo-3.0\dubbo-common\src\test\java\org\apache\dubbo\common\extension\compatible\CompatibleExt.java,0,2,0,1,0,3
dubbo-3.0\dubbo-3.0\dubbo-metadata\dubbo-metadata-api\src\test\java\org\apache\dubbo\metadata\report\MetadataReportInstanceTest.java,0,17,1,13,0,31
dubbo-3.0\dubbo-3.0\dubbo-rpc\dubbo-rpc-api\src\main\java\org\apache\dubbo\rpc\filter\GenericFilter.java,0,96,2,52,0,150
dubbo-3.0\dubbo-3.0\dubbo-cluster\src\test\java\org\apache\dubbo\rpc\cluster\merger\IntFindAnyMerger.java,8,2,0,1,0,3
dubbo-3.0\dubbo-3.0\dubbo-common\src\main\java\org\apache\dubbo\common\deploy\ApplicationDeployer.java,0,19,0,1,0,20
dubbo-3.0\dubbo-3.0\dubbo-common\src\test\java\org\apache\dubbo\common\utils\CompatibleTypeUtilsTest.java,187,75,12,41,0,128
dubbo-3.0\dubbo-3.0\dubbo-registry\dubbo-registry-api\src\main\java\org\apache\dubbo\registry\client\OverrideInstanceAddressURL.java,312,150,5,33,0,188
dubbo-3.0\dubbo-3.0\dubbo-serialization\dubbo-serialization-hessian2\src\main\java\org\apache\dubbo\common\serialize\hessian2\Hessian2Serialization.java,24,10,0,4,0,14
dubbo-3.0\dubbo-3.0\dubbo-spring-boot\dubbo-spring-boot-compatible\actuator\src\main\java\org\apache\dubbo\spring\boot\actuate\endpoint\metadata\AbstractDubboMetadata.java,0,27,0,12,0,39
dubbo-3.0\dubbo-3.0\dubbo-cluster\src\test\java\org\apache\dubbo\rpc\cluster\router\mesh\rule\virtualservice\match\DoubleMatchTest.java,77,24,0,1,0,25
dubbo-3.0\dubbo-3.0\dubbo-common\src\test\java\org\apache\dubbo\common\extension\director\impl\TestModuleProvider.java,8,2,1,1,0,4
dubbo-3.0\dubbo-3.0\dubbo-test\dubbo-test-check\src\main\java\org\apache\dubbo\test\check\registrycenter\initializer\UnpackZookeeperInitializer.java,77,23,1,16,0,40
dubbo-3.0\dubbo-3.0\dubbo-metadata\dubbo-metadata-api\src\main\java\org\apache\dubbo\metadata\report\identifier\BaseMetadataIdentifier.java,0,2,0,1,0,3
dubbo-3.0\dubbo-3.0\dubbo-plugin\dubbo-qos\src\main\java\org\apache\dubbo\qos\QosScopeModelInitializer.java,18,5,2,1,0,8
dubbo-3.0\dubbo-3.0\dubbo-remoting\dubbo-remoting-zookeeper-curator5\src\test\java\org\apache\dubbo\remoting\zookeeper\curator5\Curator5ZookeeperClientTest.java,145,36,3,11,0,50
dubbo-3.0\dubbo-3.0\dubbo-configcenter\dubbo-configcenter-zookeeper\src\main\java\org\apache\dubbo\configcenter\support\zookeeper\CacheListener.java,0,31,0,8,0,39
dubbo-3.0\dubbo-3.0\dubbo-remoting\dubbo-remoting-api\src\main\java\org\apache\dubbo\remoting\transport\dispatcher\execution\ExecutionChannelHandler.java,30,15,2,10,0,27
dubbo-3.0\dubbo-3.0\dubbo-spring-boot\dubbo-spring-boot-actuator\src\test\java\org\apache\dubbo\spring\boot\actuate\endpoint\DubboEndpointTest.java,43,14,0,7,0,21
dubbo-3.0\dubbo-3.0\dubbo-rpc\dubbo-rpc-api\src\main\java\org\apache\dubbo\rpc\RpcStatus.java,289,50,2,7,0,59
dubbo-3.0\dubbo-3.0\dubbo-registry\dubbo-registry-api\src\test\java\org\apache\dubbo\registry\client\metadata\store\InMemoryMetadataServiceTest.java,0,39,0,40,0,79
dubbo-3.0\dubbo-3.0\dubbo-common\src\test\java\org\apache\dubbo\common\function\StreamsTest.java,21,17,0,2,0,19
dubbo-3.0\dubbo-3.0\dubbo-remoting\dubbo-remoting-zookeeper-curator5\src\test\java\org\apache\dubbo\remoting\zookeeper\curator5\Curator5ZookeeperTransporterTest.java,23,9,2,3,0,14
dubbo-3.0\dubbo-3.0\dubbo-common\src\main\java\org\apache\dubbo\common\logger\slf4j\Slf4jLogger.java,179,62,5,16,0,83
dubbo-3.0\dubbo-3.0\dubbo-cluster\src\main\java\org\apache\dubbo\rpc\cluster\Router.java,0,16,2,13,0,31
dubbo-3.0\dubbo-3.0\dubbo-common\src\test\java\org\apache\dubbo\rpc\model\ScopeModelUtilTest.java,0,33,1,22,0,56
dubbo-3.0\dubbo-3.0\dubbo-demo\dubbo-demo-spring-boot\dubbo-demo-spring-boot-interface\src\main\java\org\apache\dubbo\springboot\demo\DemoService.java,0,3,0,1,0,4
dubbo-3.0\dubbo-3.0\dubbo-common\src\main\java\org\apache\dubbo\common\lang\ShutdownHookCallbacks.java,42,16,0,2,0,18
dubbo-3.0\dubbo-3.0\dubbo-filter\dubbo-filter-validation\src\main\java\org\apache\dubbo\validation\support\jvalidation\JValidatorNew.java,262,71,7,41,0,119
dubbo-3.0\dubbo-3.0\dubbo-test\dubbo-test-check\src\main\java\org\apache\dubbo\test\check\DubboTestChecker.java,255,72,6,27,0,105
dubbo-3.0\dubbo-3.0\dubbo-common\src\test\java\org\apache\dubbo\common\extension\NoSpiExt.java,0,2,0,1,0,3
dubbo-3.0\dubbo-3.0\dubbo-metadata\dubbo-metadata-api\src\main\java\org\apache\dubbo\metadata\MetadataInfo.java,684,344,23,66,0,433
dubbo-3.0\dubbo-3.0\dubbo-config\dubbo-config-api\src\test\java\org\apache\dubbo\config\mock\MockStatusChecker.java,7,1,0,1,0,2
dubbo-3.0\dubbo-3.0\dubbo-remoting\dubbo-remoting-api\src\main\java\org\apache\dubbo\remoting\IdleSensible.java,0,4,0,5,0,9
dubbo-3.0\dubbo-3.0\dubbo-spring-boot\dubbo-spring-boot-compatible\autoconfigure\src\test\java\org\apache\dubbo\spring\boot\autoconfigure\CompatibleDubboAutoConfigurationTestWithoutProperties.java,27,8,0,5,0,13
dubbo-3.0\dubbo-3.0\dubbo-common\src\main\java\org\apache\dubbo\common\Extension.java,0,8,0,8,0,16
dubbo-3.0\dubbo-3.0\dubbo-common\src\main\java\org\apache\dubbo\common\convert\multiple\StringToBlockingQueueConverter.java,11,9,0,3,0,12
dubbo-3.0\dubbo-3.0\dubbo-registry\dubbo-registry-api\src\test\java\org\apache\dubbo\registry\integration\DynamicDirectoryTest.java,133,29,10,20,0,59
dubbo-3.0\dubbo-3.0\dubbo-common\src\test\java\org\apache\dubbo\common\extension\ext2\impl\Ext2Impl2.java,11,8,0,1,0,9
dubbo-3.0\dubbo-3.0\dubbo-native\src\main\java\org\apache\dubbo\remoting\Codec$Adaptive.java,0,33,21,13,0,67
dubbo-3.0\dubbo-3.0\dubbo-common\src\test\java\org\apache\dubbo\common\extension\ext6_wrap\WrappedExtWrapper.java,0,1,0,1,0,2
dubbo-3.0\dubbo-3.0\dubbo-cluster\src\main\java\org\apache\dubbo\rpc\cluster\Constants.java,0,45,41,4,0,90
dubbo-3.0\dubbo-3.0\dubbo-cluster\src\main\java\org\apache\dubbo\rpc\cluster\ConfiguratorFactory.java,0,0,0,1,0,1
dubbo-3.0\dubbo-3.0\dubbo-config\dubbo-config-spring\src\test\java\org\apache\dubbo\config\spring\beans\factory\config\MultipleServicesWithMethodConfigsTest.java,0,6,0,4,0,10
dubbo-3.0\dubbo-3.0\dubbo-rpc\dubbo-rpc-triple\src\test\java\org\apache\dubbo\rpc\protocol\tri\support\IGreeter.java,0,8,0,1,0,9
dubbo-3.0\dubbo-3.0\dubbo-common\src\main\java\org\apache\dubbo\common\convert\StringToDoubleConverter.java,14,5,0,1,0,6
dubbo-3.0\dubbo-3.0\dubbo-compatible\src\main\java\com\alibaba\dubbo\rpc\RpcException.java,0,21,0,1,0,22
dubbo-3.0\dubbo-3.0\dubbo-config\dubbo-config-spring\src\test\java\org\apache\dubbo\config\spring\propertyconfigurer\consumer3\PropertySourcesInJavaConfigTest.java,113,37,3,25,0,65
dubbo-3.0\dubbo-3.0\dubbo-rpc\dubbo-rpc-dubbo\src\test\java\org\apache\dubbo\rpc\protocol\dubbo\decode\LocalEmbeddedChannel.java,11,4,0,1,0,5
dubbo-3.0\dubbo-3.0\dubbo-rpc\dubbo-rpc-injvm\src\test\java\org\apache\dubbo\rpc\protocol\injvm\DemoServiceImpl.java,60,34,4,2,0,40
dubbo-3.0\dubbo-3.0\dubbo-cluster\src\test\java\org\apache\dubbo\rpc\cluster\filter\DemoService.java,0,3,0,1,0,4
dubbo-3.0\dubbo-3.0\dubbo-plugin\dubbo-qos\src\test\java\org\apache\dubbo\qos\legacy\service\DemoService.java,0,23,0,1,0,24
dubbo-3.0\dubbo-3.0\dubbo-cluster\src\main\java\org\apache\dubbo\rpc\cluster\router\mesh\rule\virtualservice\destination\DubboDestination.java,40,29,0,2,0,31
dubbo-3.0\dubbo-3.0\dubbo-remoting\dubbo-remoting-netty4\src\test\java\org\apache\dubbo\remoting\transport\netty4\NettyCodecAdapterTest.java,15,5,0,4,0,9
dubbo-3.0\dubbo-3.0\dubbo-common\src\main\java\org\apache\dubbo\rpc\service\EchoService.java,0,1,2,1,0,4
dubbo-3.0\dubbo-3.0\dubbo-compatible\src\main\java\com\alibaba\dubbo\config\spring\context\annotation\EnableDubbo.java,0,7,0,6,0,13
dubbo-3.0\dubbo-3.0\dubbo-remoting\dubbo-remoting-api\src\main\java\org\apache\dubbo\remoting\zookeeper\ZookeeperClient.java,0,21,0,2,0,23
dubbo-3.0\dubbo-3.0\dubbo-common\src\test\java\org\apache\dubbo\common\convert\StringToStringConverterTest.java,21,7,0,3,0,10
dubbo-3.0\dubbo-3.0\dubbo-common\src\test\java\org\apache\dubbo\common\extension\support\Order0Filter1.java,3,0,0,1,0,1
dubbo-3.0\dubbo-3.0\compiler\src\main\java\org\apache\dubbo\gen\AbstractGenerator.java,340,136,2,46,0,184
dubbo-3.0\dubbo-3.0\dubbo-plugin\dubbo-qos\src\main\java\org\apache\dubbo\qos\legacy\TraceTelnetHandler.java,59,14,2,11,0,27
dubbo-3.0\dubbo-3.0\dubbo-registry\dubbo-registry-api\src\main\java\org\apache\dubbo\registry\retry\FailedRegisteredTask.java,0,9,0,2,0,11
dubbo-3.0\dubbo-3.0\dubbo-common\src\test\java\org\apache\dubbo\common\compiler\support\ClassUtilsTest.java,151,48,3,34,0,85
dubbo-3.0\dubbo-3.0\dubbo-metadata\dubbo-metadata-api\src\main\java\org\apache\dubbo\metadata\rest\RestMetadataConstants.java,0,36,38,10,0,84
dubbo-3.0\dubbo-3.0\dubbo-common\src\test\java\org\apache\dubbo\common\extension\ExtensionLoaderTest.java,704,207,57,106,0,370
dubbo-3.0\dubbo-3.0\dubbo-common\src\test\java\org\apache\dubbo\common\config\configcenter\file\FileSystemDynamicConfigurationTest.java,140,30,4,14,0,48
dubbo-3.0\dubbo-3.0\dubbo-common\src\main\java\org\apache\dubbo\common\threadlocal\InternalThreadLocal.java,170,36,1,20,0,57
dubbo-3.0\dubbo-3.0\dubbo-rpc\dubbo-rpc-api\src\main\java\org\apache\dubbo\rpc\protocol\dubbo\package-info.java,0,2,0,3,0,5
dubbo-3.0\dubbo-3.0\dubbo-cluster\src\main\java\org\apache\dubbo\rpc\cluster\router\mesh\util\TracingContextProvider.java,0,1,0,1,0,2
dubbo-3.0\dubbo-3.0\dubbo-common\src\test\java\org\apache\dubbo\common\extension\ext1\impl\SimpleExtImpl1.java,14,13,0,1,0,14
dubbo-3.0\dubbo-3.0\dubbo-config\dubbo-config-api\src\test\java\org\apache\dubbo\config\mock\MockProtocol2.java,24,9,0,1,0,10
dubbo-3.0\dubbo-3.0\dubbo-demo\dubbo-demo-interface\src\main\java\org\apache\dubbo\demo\TripleService.java,0,1,0,1,0,2
dubbo-3.0\dubbo-3.0\dubbo-config\dubbo-config-api\src\test\java\org\apache\dubbo\config\integration\single\exportprovider\SingleRegistryCenterExportProviderService.java,0,2,0,1,0,3
dubbo-3.0\dubbo-3.0\dubbo-compatible\src\test\java\org\apache\dubbo\rpc\RpcContextTest.java,22,4,0,2,0,6
dubbo-3.0\dubbo-3.0\dubbo-registry\dubbo-registry-api\src\test\java\org\apache\dubbo\registry\service\DemoService.java,0,2,0,1,0,3
dubbo-3.0\dubbo-3.0\dubbo-spring-boot\dubbo-spring-boot-compatible\autoconfigure\src\main\java\org\apache\dubbo\spring\boot\env\DubboDefaultPropertiesEnvironmentPostProcessor.java,0,39,1,28,0,68
dubbo-3.0\dubbo-3.0\dubbo-config\dubbo-config-api\src\test\java\org\apache\dubbo\config\integration\single\injvm\SingleRegistryCenterInjvmServiceImpl.java,11,3,0,2,0,5
dubbo-3.0\dubbo-3.0\dubbo-common\src\main\java\org\apache\dubbo\common\utils\LRUCache.java,0,32,1,1,0,34
dubbo-3.0\dubbo-3.0\dubbo-common\src\main\java\org\apache\dubbo\rpc\support\ProtocolUtils.java,66,35,1,16,0,52
dubbo-3.0\dubbo-3.0\dubbo-rpc\dubbo-rpc-rest\src\main\java\org\apache\dubbo\rpc\protocol\rest\RestServerFactory.java,20,10,0,3,0,13
dubbo-3.0\dubbo-3.0\dubbo-config\dubbo-config-api\src\test\java\org\apache\dubbo\config\bootstrap\NacosDubboServiceConsumerBootstrap.java,29,11,1,7,0,19
dubbo-3.0\dubbo-3.0\dubbo-rpc\dubbo-rpc-api\src\main\java\org\apache\dubbo\rpc\filter\ActiveLimitFilter.java,0,38,0,22,0,60
dubbo-3.0\dubbo-3.0\dubbo-common\src\main\java\org\apache\dubbo\config\context\ConfigConfigurationAdapter.java,26,10,0,2,0,12
dubbo-3.0\dubbo-3.0\dubbo-common\src\main\java\org\apache\dubbo\common\threadpool\support\limited\LimitedThreadPool.java,17,8,1,8,0,17
dubbo-3.0\dubbo-3.0\dubbo-plugin\dubbo-qos\src\main\java\org\apache\dubbo\qos\command\impl\ShutdownTelnet.java,44,12,0,6,0,18
dubbo-3.0\dubbo-3.0\dubbo-remoting\dubbo-remoting-netty\src\test\java\org\apache\dubbo\remoting\transport\netty\ThreadNameTest.java,120,50,2,10,0,62
dubbo-3.0\dubbo-3.0\dubbo-cluster\src\test\java\org\apache\dubbo\rpc\cluster\router\mesh\rule\virtualservice\match\BoolMatchTest.java,18,2,0,1,0,3
dubbo-3.0\dubbo-3.0\dubbo-rpc\dubbo-rpc-triple\src\main\java\org\apache\dubbo\rpc\protocol\tri\frame\Deframer.java,0,5,0,5,0,10
dubbo-3.0\dubbo-3.0\compiler\src\main\java\org\apache\dubbo\gen\tri\Dubbo3TripleGenerator.java,42,9,0,1,0,10
dubbo-3.0\dubbo-3.0\dubbo-common\src\main\java\org\apache\dubbo\common\threadpool\manager\Ring.java,44,13,0,1,0,14
dubbo-3.0\dubbo-3.0\dubbo-cluster\src\main\java\org\apache\dubbo\rpc\cluster\router\mesh\rule\virtualservice\match\DubboMethodMatch.java,0,58,7,6,0,71
dubbo-3.0\dubbo-3.0\dubbo-common\src\test\java\org\apache\dubbo\common\threadpool\serial\SerializingExecutorTest.java,39,11,0,2,0,13
dubbo-3.0\dubbo-3.0\dubbo-plugin\dubbo-qos\src\main\java\org\apache\dubbo\qos\command\impl\Offline.java,12,4,1,1,0,6
dubbo-3.0\dubbo-3.0\dubbo-remoting\dubbo-remoting-api\src\test\java\org\apache\dubbo\remoting\transport\dispatcher\ChannelHandlersTest.java,18,4,1,3,0,8
dubbo-3.0\dubbo-3.0\dubbo-compatible\src\test\java\org\apache\dubbo\config\ProtocolConfigTest.java,125,25,0,1,0,26
dubbo-3.0\dubbo-3.0\dubbo-registry\dubbo-registry-zookeeper\src\main\java\org\apache\dubbo\registry\zookeeper\ZookeeperInstance.java,50,32,0,3,0,35
dubbo-3.0\dubbo-3.0\dubbo-rpc\dubbo-rpc-api\src\test\java\org\apache\dubbo\rpc\support\DemoServiceImpl.java,100,58,7,2,0,67
dubbo-3.0\dubbo-3.0\dubbo-filter\dubbo-filter-cache\src\test\java\org\apache\dubbo\cache\support\jcache\JCacheFactoryTest.java,25,6,0,2,0,8
dubbo-3.0\dubbo-3.0\dubbo-common\src\main\java\org\apache\dubbo\common\threadpool\support\fixed\FixedThreadPool.java,16,8,1,5,0,14
dubbo-3.0\dubbo-3.0\dubbo-rpc\dubbo-rpc-injvm\src\test\java\demo\MultiClassLoaderServiceImpl.java,16,12,0,4,0,16
dubbo-3.0\dubbo-3.0\dubbo-plugin\dubbo-qos\src\main\java\org\apache\dubbo\qos\command\impl\DisableSimpleProfiler.java,11,8,0,3,0,11
dubbo-3.0\dubbo-3.0\dubbo-metadata\dubbo-metadata-api\src\test\java\org\apache\dubbo\metadata\rest\StandardRestService.java,70,25,2,5,0,32
dubbo-3.0\dubbo-3.0\dubbo-plugin\dubbo-qos\src\main\java\org\apache\dubbo\qos\probe\LivenessProbe.java,0,3,0,1,0,4
dubbo-3.0\dubbo-3.0\dubbo-metadata\dubbo-metadata-processor\src\main\java\org\apache\dubbo\metadata\annotation\processing\builder\PrimitiveTypeDefinitionBuilder.java,19,13,1,5,0,19
dubbo-3.0\dubbo-3.0\dubbo-registry\dubbo-registry-nacos\src\main\java\org\apache\dubbo\registry\nacos\NacosServiceDiscovery.java,94,38,0,22,0,60
dubbo-3.0\dubbo-3.0\dubbo-metadata\dubbo-metadata-api\src\main\java\org\apache\dubbo\metadata\rest\ServiceRestMetadata.java,79,38,0,3,0,41
dubbo-3.0\dubbo-3.0\dubbo-common\src\test\java\org\apache\dubbo\rpc\model\Person.java,76,42,8,2,0,52
dubbo-3.0\dubbo-3.0\dubbo-remoting\dubbo-remoting-api\src\test\java\org\apache\dubbo\remoting\transport\AbstractCodecTest.java,64,29,4,8,0,41
dubbo-3.0\dubbo-3.0\dubbo-rpc\dubbo-rpc-api\src\main\java\org\apache\dubbo\rpc\ServerService.java,0,2,0,1,0,3
dubbo-3.0\dubbo-3.0\dubbo-cluster\src\main\java\org\apache\dubbo\rpc\cluster\CacheableRouterFactory.java,11,6,0,3,0,9
dubbo-3.0\dubbo-3.0\dubbo-cluster\src\test\java\org\apache\dubbo\rpc\cluster\support\ForkingClusterInvokerTest.java,127,34,1,19,0,54
dubbo-3.0\dubbo-3.0\dubbo-config\dubbo-config-api\src\test\java\org\apache\dubbo\config\integration\single\injvm\SingleRegistryCenterInjvmFilter.java,0,22,0,5,0,27
dubbo-3.0\dubbo-3.0\dubbo-common\src\test\java\org\apache\dubbo\config\GreetingLocal3.java,13,5,2,1,0,8
dubbo-3.0\dubbo-3.0\dubbo-rpc\dubbo-rpc-grpc\src\test\java\org\apache\dubbo\rpc\protocol\grpc\support\GreeterGrpc.java,0,121,37,49,0,207
dubbo-3.0\dubbo-3.0\dubbo-rpc\dubbo-rpc-triple\src\test\java\org\apache\dubbo\rpc\protocol\tri\compressor\GzipTest.java,35,8,0,4,0,12
dubbo-3.0\dubbo-3.0\dubbo-config\dubbo-config-api\src\main\java\org\apache\dubbo\config\ConfigScopeModelInitializer.java,26,8,0,3,0,11
dubbo-3.0\dubbo-3.0\dubbo-configcenter\dubbo-configcenter-nacos\src\main\java\org\apache\dubbo\configcenter\support\nacos\NacosDynamicConfiguration.java,329,98,8,18,0,124
dubbo-3.0\dubbo-3.0\dubbo-remoting\dubbo-remoting-api\src\main\java\org\apache\dubbo\remoting\Client.java,0,3,0,3,0,6
dubbo-3.0\dubbo-3.0\dubbo-remoting\dubbo-remoting-api\src\main\java\org\apache\dubbo\remoting\telnet\support\command\ExitTelnetHandler.java,10,4,0,1,0,5
dubbo-3.0\dubbo-3.0\dubbo-metadata\dubbo-metadata-processor\src\test\java\org\apache\dubbo\metadata\tools\TestProcessor.java,16,11,0,2,0,13
dubbo-3.0\dubbo-3.0\dubbo-remoting\dubbo-remoting-api\src\main\java\org\apache\dubbo\remoting\exchange\support\header\HeaderExchanger.java,16,12,0,5,0,17
dubbo-3.0\dubbo-3.0\dubbo-remoting\dubbo-remoting-api\src\main\java\org\apache\dubbo\remoting\RemotingException.java,54,43,0,9,0,52
dubbo-3.0\dubbo-3.0\dubbo-common\src\test\java\org\apache\dubbo\common\threadpool\event\ThreadPoolExhaustedEventListenerTest.java,33,10,0,3,0,13
dubbo-3.0\dubbo-3.0\dubbo-metadata\dubbo-metadata-api\src\main\java\org\apache\dubbo\metadata\report\support\Constants.java,0,8,7,1,0,16
dubbo-3.0\dubbo-3.0\dubbo-remoting\dubbo-remoting-api\src\test\java\org\apache\dubbo\remoting\PerformanceUtils.java,99,30,4,11,0,45
dubbo-3.0\dubbo-3.0\dubbo-rpc\dubbo-rpc-api\src\main\java\org\apache\dubbo\rpc\filter\TpsLimitFilter.java,21,13,0,6,0,19
dubbo-3.0\dubbo-3.0\dubbo-common\src\main\java\org\apache\dubbo\common\utils\Stack.java,118,12,2,4,0,18
dubbo-3.0\dubbo-3.0\dubbo-common\src\test\java\org\apache\dubbo\common\extension\ext6_wrap\impl\Ext6Wrapper2.java,0,13,0,1,0,14
dubbo-3.0\dubbo-3.0\dubbo-cluster\src\test\java\org\apache\dubbo\rpc\cluster\router\mesh\route\MeshRuleManagerTest.java,237,92,14,33,0,139
dubbo-3.0\dubbo-3.0\dubbo-registry\dubbo-registry-api\src\main\java\org\apache\dubbo\registry\integration\RegistryDirectory.java,505,145,14,91,0,250
dubbo-3.0\dubbo-3.0\dubbo-common\src\main\java\org\apache\dubbo\common\config\configcenter\file\FileSystemDynamicConfigurationFactory.java,8,5,0,3,0,8
dubbo-3.0\dubbo-3.0\dubbo-common\src\main\java\org\apache\dubbo\rpc\service\ServiceDescriptorInternalCache.java,13,9,1,3,0,13
dubbo-3.0\dubbo-3.0\dubbo-compatible\src\test\java\org\apache\dubbo\filter\LegacyInvoker.java,47,21,1,1,0,23
dubbo-3.0\dubbo-3.0\dubbo-cluster\src\main\java\org\apache\dubbo\rpc\cluster\router\mesh\rule\virtualservice\match\BoolMatch.java,19,13,0,1,0,14
dubbo-3.0\dubbo-3.0\dubbo-compatible\src\main\java\com\alibaba\dubbo\rpc\cluster\Cluster.java,0,4,0,3,0,7
dubbo-3.0\dubbo-3.0\dubbo-common\src\test\java\org\apache\dubbo\common\status\StatusTest.java,26,4,0,1,0,5
dubbo-3.0\dubbo-3.0\dubbo-compatible\src\main\java\com\alibaba\dubbo\rpc\Result.java,0,45,5,5,0,55
dubbo-3.0\dubbo-3.0\dubbo-config\dubbo-config-spring\src\test\java\org\apache\dubbo\config\spring\reference\ReferenceKeyTest.java,276,157,4,72,0,233
dubbo-3.0\dubbo-3.0\dubbo-cluster\src\main\java\org\apache\dubbo\rpc\cluster\filter\DefaultFilterChainBuilder.java,109,25,0,18,0,43
dubbo-3.0\dubbo-3.0\dubbo-config\dubbo-config-api\src\test\java\org\apache\dubbo\config\integration\multiple\injvm\MultipleRegistryCenterInjvmIntegrationTest.java,148,31,2,22,0,55
dubbo-3.0\dubbo-3.0\dubbo-common\src\main\java\org\apache\dubbo\common\config\configcenter\ConfigurationListener.java,0,1,0,2,0,3
dubbo-3.0\dubbo-3.0\dubbo-registry\dubbo-registry-api\src\main\java\org\apache\dubbo\registry\client\migration\PreMigratingConditionChecker.java,0,1,0,1,0,2
dubbo-3.0\dubbo-3.0\dubbo-config\dubbo-config-api\src\test\java\org\apache\dubbo\config\ApplicationConfigTest.java,295,38,2,7,0,47
dubbo-3.0\dubbo-3.0\dubbo-common\src\main\java\org\apache\dubbo\common\logger\jcl\JclLoggerAdapter.java,37,14,0,1,0,15
dubbo-3.0\dubbo-3.0\dubbo-config\dubbo-config-api\src\test\java\org\apache\dubbo\config\utils\service\FooServiceImpl.java,3,0,0,1,0,1
dubbo-3.0\dubbo-3.0\dubbo-remoting\dubbo-remoting-api\src\main\java\org\apache\dubbo\remoting\zookeeper\StateListener.java,0,6,0,1,0,7
dubbo-3.0\dubbo-3.0\dubbo-common\src\main\java\org\apache\dubbo\common\url\component\ServiceAddressURL.java,206,54,1,9,0,64
dubbo-3.0\dubbo-3.0\dubbo-common\src\main\java\org\apache\dubbo\common\compiler\Compiler.java,0,4,0,4,0,8
dubbo-3.0\dubbo-3.0\dubbo-config\dubbo-config-api\src\test\java\demo\MultiClassLoaderServiceResult.java,3,0,0,1,0,1
dubbo-3.0\dubbo-3.0\dubbo-test\dubbo-test-check\src\main\java\org\apache\dubbo\test\check\registrycenter\Config.java,0,9,0,1,0,10
dubbo-3.0\dubbo-3.0\dubbo-config\dubbo-config-api\src\test\java\org\apache\dubbo\config\metadata\MetadataServiceURLParamsMetadataCustomizerTest.java,61,29,1,15,0,45
dubbo-3.0\dubbo-3.0\dubbo-monitor\dubbo-monitor-default\src\main\java\org\apache\dubbo\monitor\dubbo\DubboMonitor.java,151,43,5,23,0,71
dubbo-3.0\dubbo-3.0\dubbo-rpc\dubbo-rpc-triple\src\main\java\org\apache\dubbo\rpc\protocol\tri\CancelableStreamObserver.java,14,10,0,2,0,12
dubbo-3.0\dubbo-3.0\dubbo-common\src\main\java\org\apache\dubbo\common\extension\ServicesLoadingStrategy.java,19,4,0,1,0,5
dubbo-3.0\dubbo-3.0\dubbo-metadata\dubbo-metadata-api\src\main\java\org\apache\dubbo\metadata\rest\RequestMetadata.java,187,94,3,12,0,109
dubbo-3.0\dubbo-3.0\dubbo-common\src\main\java\org\apache\dubbo\config\support\Nested.java,0,2,0,1,0,3
dubbo-3.0\dubbo-3.0\dubbo-plugin\dubbo-qos\src\test\java\org\apache\dubbo\qos\command\DefaultCommandExecutorTest.java,17,5,0,4,0,9
dubbo-3.0\dubbo-3.0\dubbo-common\src\test\java\org\apache\dubbo\common\threadpool\event\ThreadPoolExhaustedEventTest.java,11,3,0,2,0,5
dubbo-3.0\dubbo-3.0\dubbo-metadata\dubbo-metadata-processor\src\test\java\org\apache\dubbo\metadata\tools\TestService.java,0,7,0,2,0,9
dubbo-3.0\dubbo-3.0\dubbo-cluster\src\test\java\org\apache\dubbo\rpc\cluster\configurator\override\OverrideConfiguratorTest.java,86,26,2,18,0,46
dubbo-3.0\dubbo-3.0\dubbo-registry\dubbo-registry-nacos\src\main\java\org\apache\dubbo\registry\nacos\util\NacosNamingServiceUtils.java,111,31,2,11,0,44
dubbo-3.0\dubbo-3.0\dubbo-common\src\main\java\org\apache\dubbo\rpc\model\ConsumerModel.java,148,67,0,18,0,85
dubbo-3.0\dubbo-3.0\dubbo-rpc\dubbo-rpc-triple\src\main\java\org\apache\dubbo\rpc\protocol\tri\call\AbstractServerCallListener.java,0,26,2,8,0,36
dubbo-3.0\dubbo-3.0\dubbo-common\src\main\java\org\apache\dubbo\common\context\LifecycleAdapter.java,18,0,3,1,0,4
dubbo-3.0\dubbo-3.0\dubbo-registry\dubbo-registry-nacos\src\test\java\org\apache\dubbo\registry\nacos\NacosRegistryTest.java,260,66,7,45,0,118
dubbo-3.0\dubbo-3.0\dubbo-compatible\src\main\java\com\alibaba\dubbo\config\ConsumerConfig.java,0,0,0,1,0,1
dubbo-3.0\dubbo-3.0\dubbo-configcenter\dubbo-configcenter-nacos\src\test\java\org\apache\dubbo\configcenter\support\nacos\NacosDynamicConfigurationTest.java,142,40,12,9,0,61
dubbo-3.0\dubbo-3.0\dubbo-registry\dubbo-registry-api\src\test\java\org\apache\dubbo\registry\client\FileSystemServiceDiscoveryTest.java,0,2,0,3,0,5
dubbo-3.0\dubbo-3.0\dubbo-registry\dubbo-registry-api\src\test\java\org\apache\dubbo\registry\client\migration\MigrationRuleHandlerTest.java,56,31,0,21,0,52
dubbo-3.0\dubbo-3.0\dubbo-common\src\main\java\org\apache\dubbo\metadata\definition\builder\ArrayTypeBuilder.java,30,9,0,3,0,12
dubbo-3.0\dubbo-3.0\dubbo-metadata\dubbo-metadata-api\src\test\java\org\apache\dubbo\metadata\rest\DefaultRestService.java,42,25,1,1,0,27
dubbo-3.0\dubbo-3.0\dubbo-registry\dubbo-registry-api\src\test\java\org\apache\dubbo\registry\client\support\MockServiceDiscovery.java,44,19,5,5,0,29
dubbo-3.0\dubbo-3.0\dubbo-config\dubbo-config-api\src\test\java\org\apache\dubbo\config\url\UrlTestBase.java,0,109,5,19,0,133
dubbo-3.0\dubbo-3.0\dubbo-rpc\dubbo-rpc-api\src\test\java\org\apache\dubbo\rpc\proxy\InvokerInvocationHandlerTest.java,26,7,0,3,0,10
dubbo-3.0\dubbo-3.0\dubbo-remoting\dubbo-remoting-http\src\main\java\org\apache\dubbo\remoting\http\servlet\ServletHttpBinder.java,9,4,0,1,0,5
dubbo-3.0\dubbo-3.0\dubbo-config\dubbo-config-api\src\test\java\org\apache\dubbo\config\utils\MockReferenceConfig.java,38,17,1,1,0,19
dubbo-3.0\dubbo-3.0\dubbo-cluster\src\main\java\org\apache\dubbo\rpc\cluster\loadbalance\RoundRobinLoadBalance.java,100,34,1,9,0,44
dubbo-3.0\dubbo-3.0\dubbo-config\dubbo-config-spring\src\main\java\org\apache\dubbo\config\spring\status\DataSourceStatusChecker.java,64,14,2,3,0,19
dubbo-3.0\dubbo-3.0\dubbo-compatible\src\main\java\com\alibaba\dubbo\remoting\telnet\TelnetHandler.java,0,5,0,4,0,9
dubbo-3.0\dubbo-3.0\dubbo-spring-boot\dubbo-spring-boot-compatible\autoconfigure\src\main\java\org\apache\dubbo\spring\boot\autoconfigure\DubboConfigurationProperties.java,289,165,0,7,0,172
dubbo-3.0\dubbo-3.0\dubbo-test\dubbo-test-check\src\main\java\org\apache\dubbo\test\check\registrycenter\initializer\ConfigZookeeperInitializer.java,108,33,2,20,0,55
dubbo-3.0\dubbo-3.0\dubbo-rpc\dubbo-rpc-api\src\test\java\org\apache\dubbo\rpc\support\PenetrateAttachmentSelectorMock.java,10,3,0,3,0,6
dubbo-3.0\dubbo-3.0\dubbo-config\dubbo-config-api\src\main\java\org\apache\dubbo\config\bootstrap\builders\AbstractReferenceBuilder.java,0,64,0,3,0,67
dubbo-3.0\dubbo-3.0\dubbo-registry\dubbo-registry-api\src\main\java\org\apache\dubbo\registry\client\DefaultRegistryClusterIdentifier.java,12,5,0,3,0,8
dubbo-3.0\dubbo-3.0\dubbo-cluster\src\main\java\org\apache\dubbo\rpc\cluster\support\AvailableClusterInvoker.java,18,9,0,2,0,11
dubbo-3.0\dubbo-3.0\dubbo-cluster\src\test\java\org\apache\dubbo\rpc\cluster\merger\FloatSumMerger.java,9,2,0,1,0,3
dubbo-3.0\dubbo-3.0\dubbo-config\dubbo-config-spring\src\test\java\org\apache\dubbo\config\spring\registry\nacos\demo\provider\DemoServiceProviderXmlBootstrap.java,11,7,1,4,0,12
dubbo-3.0\dubbo-3.0\dubbo-common\src\main\java\org\apache\dubbo\common\cache\FileCacheStore.java,183,67,5,12,0,84
dubbo-3.0\dubbo-3.0\dubbo-rpc\dubbo-rpc-api\src\main\java\org\apache\dubbo\rpc\stub\FutureToObserverAdaptor.java,33,15,0,7,0,22
dubbo-3.0\dubbo-3.0\dubbo-serialization\dubbo-serialization-hessian2\src\main\java\org\apache\dubbo\common\serialize\hessian2\dubbo\AbstractHessian2FactoryInitializer.java,34,9,1,5,0,15
dubbo-3.0\dubbo-3.0\dubbo-common\src\main\java\org\apache\dubbo\common\convert\ConverterUtil.java,45,18,1,6,0,25
dubbo-3.0\dubbo-3.0\dubbo-registry\dubbo-registry-api\src\main\java\org\apache\dubbo\registry\integration\AbstractConfiguratorListener.java,86,35,1,9,0,45
dubbo-3.0\dubbo-3.0\dubbo-common\src\test\java\org\apache\dubbo\common\extension\activate\impl\OrderActivateExtImpl1.java,7,3,0,1,0,4
dubbo-3.0\dubbo-3.0\dubbo-config\dubbo-config-spring\src\test\java\org\apache\dubbo\config\spring\reference\localcallam\LocalCallMultipleReferenceAnnotationsTest.java,87,28,3,14,0,45
dubbo-3.0\dubbo-3.0\dubbo-remoting\dubbo-remoting-api\src\main\java\org\apache\dubbo\remoting\api\ConnectionManager.java,0,2,0,1,0,3
dubbo-3.0\dubbo-3.0\dubbo-native\src\main\java\org\apache\dubbo\rpc\Protocol$Adaptive.java,0,41,24,14,0,79
dubbo-3.0\dubbo-3.0\dubbo-metadata\dubbo-metadata-api\src\main\java\org\apache\dubbo\metadata\rest\ServiceRestMetadataReader.java,0,2,0,1,0,3
dubbo-3.0\dubbo-3.0\dubbo-rpc\dubbo-rpc-grpc\src\main\java\org\apache\dubbo\rpc\protocol\grpc\GrpcConfig.java,4,0,0,1,0,1
dubbo-3.0\dubbo-3.0\dubbo-remoting\dubbo-remoting-netty\src\test\java\org\apache\dubbo\remoting\transport\netty\Hello.java,23,12,1,1,0,14
dubbo-3.0\dubbo-3.0\dubbo-common\src\main\java\org\apache\dubbo\common\extension\Adaptive.java,0,9,0,9,0,18
dubbo-3.0\dubbo-3.0\dubbo-config\dubbo-config-api\src\test\java\org\apache\dubbo\config\integration\single\exportprovider\SingleRegistryCenterExportProviderExporterListener.java,11,3,0,3,0,6
dubbo-3.0\dubbo-3.0\dubbo-config\dubbo-config-spring\src\test\java\org\apache\dubbo\config\spring\boot\conditional4\JavaConfigReferenceBeanConditionalTest4.java,56,22,1,5,0,28
dubbo-3.0\dubbo-3.0\dubbo-rpc\dubbo-rpc-api\src\main\java\org\apache\dubbo\rpc\HeaderFilter.java,0,2,0,2,0,4
dubbo-3.0\dubbo-3.0\dubbo-native\src\main\java\org\apache\dubbo\remoting\exchange\Exchanger$Adaptive.java,0,27,19,10,0,56
dubbo-3.0\dubbo-3.0\dubbo-rpc\dubbo-rpc-triple\src\main\java\org\apache\dubbo\rpc\protocol\tri\transport\AbstractH2TransportListener.java,54,10,1,6,0,17
dubbo-3.0\dubbo-3.0\dubbo-common\src\main\java\org\apache\dubbo\common\config\configcenter\nop\NopDynamicConfigurationFactory.java,8,3,0,3,0,6
dubbo-3.0\dubbo-3.0\dubbo-rpc\dubbo-rpc-triple\src\main\java\org\apache\dubbo\rpc\protocol\tri\transport\TripleHttp2ClientResponseHandler.java,56,19,3,8,0,30
dubbo-3.0\dubbo-3.0\dubbo-common\src\test\java\org\apache\dubbo\common\extension\ext6_wrap\impl\Ext6Wrapper4.java,0,14,0,1,0,15
dubbo-3.0\dubbo-3.0\dubbo-config\dubbo-config-api\src\test\java\org\apache\dubbo\config\integration\multiple\exportmetadata\MultipleRegistryCenterExportMetadataIntegrationTest.java,150,37,2,27,0,66
dubbo-3.0\dubbo-3.0\dubbo-common\src\test\java\org\apache\dubbo\common\threadpool\support\fixed\FixedThreadPoolTest.java,41,13,0,8,0,21
dubbo-3.0\dubbo-3.0\dubbo-metadata\dubbo-metadata-processor\src\test\java\org\apache\dubbo\metadata\annotation\processing\builder\EnumTypeDefinitionBuilderTest.java,32,11,0,6,0,17
dubbo-3.0\dubbo-3.0\dubbo-plugin\dubbo-qos\src\test\java\org\apache\dubbo\qos\command\impl\QuitTest.java,9,1,0,1,0,2
dubbo-3.0\dubbo-3.0\dubbo-rpc\dubbo-rpc-api\src\test\java\org\apache\dubbo\rpc\AppResponseTest.java,104,17,0,7,0,24
dubbo-3.0\dubbo-3.0\dubbo-compatible\src\test\java\org\apache\dubbo\common\extension\ExtensionTest.java,21,6,0,5,0,11
dubbo-3.0\dubbo-3.0\dubbo-rpc\dubbo-rpc-triple\src\main\java\org\apache\dubbo\rpc\protocol\tri\transport\TripleTailHandler.java,9,5,0,2,0,7
dubbo-3.0\dubbo-3.0\dubbo-config\dubbo-config-api\src\test\java\org\apache\dubbo\config\integration\multiple\injvm\MultipleRegistryCenterInjvmExporterListener.java,11,3,0,3,0,6
dubbo-3.0\dubbo-3.0\dubbo-config\dubbo-config-spring\src\main\java\org\apache\dubbo\config\spring\schema\DubboBeanDefinitionParser.java,513,196,10,112,0,318
dubbo-3.0\dubbo-3.0\dubbo-rpc\dubbo-rpc-grpc\src\main\java\org\apache\dubbo\rpc\protocol\grpc\interceptors\GrpcConfigurator.java,0,5,0,3,0,8
dubbo-3.0\dubbo-3.0\dubbo-spring-boot\dubbo-spring-boot-compatible\autoconfigure\src\main\java\org\apache\dubbo\spring\boot\autoconfigure\RelaxedDubboConfigBinder.java,0,9,0,4,0,13
dubbo-3.0\dubbo-3.0\dubbo-config\dubbo-config-api\src\test\java\org\apache\dubbo\config\integration\single\injvm\SingleRegistryCenterInjvmIntegrationTest.java,147,30,2,21,0,53
dubbo-3.0\dubbo-3.0\dubbo-remoting\dubbo-remoting-netty4\src\main\java\org\apache\dubbo\remoting\transport\netty4\NettyClient.java,194,52,9,31,0,92
dubbo-3.0\dubbo-3.0\dubbo-rpc\dubbo-rpc-api\src\main\java\org\apache\dubbo\rpc\support\MockInvoker.java,0,60,1,29,0,90
dubbo-3.0\dubbo-3.0\dubbo-common\src\test\java\org\apache\dubbo\common\status\support\StatusUtilsTest.java,41,3,0,1,0,4
dubbo-3.0\dubbo-3.0\dubbo-config\dubbo-config-api\src\test\java\org\apache\dubbo\config\ConfigCenterConfigTest.java,261,55,0,26,0,81
dubbo-3.0\dubbo-3.0\dubbo-rpc\dubbo-rpc-triple\src\test\java\org\apache\dubbo\rpc\protocol\tri\HelloReply.java,0,1,0,1,0,2
dubbo-3.0\dubbo-3.0\dubbo-plugin\dubbo-qos\src\main\java\org\apache\dubbo\qos\command\impl\OnlineInterface.java,13,4,0,1,0,5
dubbo-3.0\dubbo-3.0\dubbo-rpc\dubbo-rpc-triple\src\test\java\org\apache\dubbo\rpc\protocol\tri\call\StubServerCallTest.java,0,4,0,5,0,9
dubbo-3.0\dubbo-3.0\dubbo-remoting\dubbo-remoting-api\src\main\java\org\apache\dubbo\remoting\ExecutionException.java,44,44,0,6,0,50
dubbo-3.0\dubbo-3.0\dubbo-test\dubbo-test-check\src\main\java\org\apache\dubbo\test\check\registrycenter\config\ZookeeperConfig.java,153,22,0,14,0,36
dubbo-3.0\dubbo-3.0\dubbo-metadata\dubbo-metadata-api\src\main\java\org\apache\dubbo\metadata\rest\jaxrs\DefaultValueParameterProcessor.java,39,23,0,9,0,32
dubbo-3.0\dubbo-3.0\dubbo-rpc\dubbo-rpc-api\src\main\java\org\apache\dubbo\rpc\stub\StubInvocationUtil.java,42,30,3,9,0,42
dubbo-3.0\dubbo-3.0\dubbo-remoting\dubbo-remoting-api\src\test\java\org\apache\dubbo\remoting\transport\codec\DeprecatedExchangeCodec.java,0,129,27,41,0,197
dubbo-3.0\dubbo-3.0\dubbo-config\dubbo-config-spring\src\main\java\org\apache\dubbo\config\spring\reference\ReferenceCreator.java,201,77,2,36,0,115
dubbo-3.0\dubbo-3.0\dubbo-cluster\src\main\java\org\apache\dubbo\rpc\cluster\filter\support\ConsumerContextFilter.java,0,42,2,26,0,70
dubbo-3.0\dubbo-3.0\dubbo-common\src\test\java\org\apache\dubbo\common\status\reporter\FrameworkStatusReportServiceTest.java,70,23,0,24,0,47
dubbo-3.0\dubbo-3.0\dubbo-remoting\dubbo-remoting-api\src\main\java\org\apache\dubbo\remoting\Decodeable.java,0,1,0,1,0,2
dubbo-3.0\dubbo-3.0\dubbo-metadata\dubbo-metadata-processor\src\test\java\org\apache\dubbo\metadata\tools\Parent.java,43,29,0,1,0,30
dubbo-3.0\dubbo-3.0\dubbo-compatible\src\main\java\com\alibaba\dubbo\container\page\pages\LogPageHandler.java,65,9,5,3,0,17
dubbo-3.0\dubbo-3.0\dubbo-config\dubbo-config-api\src\test\java\org\apache\dubbo\config\api\User.java,43,15,1,1,0,17
dubbo-3.0\dubbo-3.0\dubbo-common\src\test\java\org\apache\dubbo\common\utils\RegexPropertiesTest.java,18,11,0,10,0,21
dubbo-3.0\dubbo-3.0\dubbo-rpc\dubbo-rpc-dubbo\src\test\java\org\apache\dubbo\rpc\protocol\dubbo\status\ThreadPoolStatusCheckerTest.java,25,11,0,9,0,20
dubbo-3.0\dubbo-3.0\compiler\src\main\java\org\apache\dubbo\gen\grpc\reactive\RxDubboGrpcGenerator.java,20,4,0,1,0,5
dubbo-3.0\dubbo-3.0\dubbo-rpc\dubbo-rpc-grpc\src\main\java\org\apache\dubbo\rpc\protocol\grpc\ReferenceCountManagedChannel.java,57,20,0,4,0,24
dubbo-3.0\dubbo-3.0\dubbo-metadata\dubbo-metadata-api\src\test\java\org\apache\dubbo\metadata\AbstractServiceNameMappingTest.java,0,44,5,12,0,61
dubbo-3.0\dubbo-3.0\dubbo-remoting\dubbo-remoting-api\src\main\java\org\apache\dubbo\remoting\transport\codec\CodecAdapter.java,33,17,0,3,0,20
dubbo-3.0\dubbo-3.0\dubbo-registry\dubbo-registry-api\src\test\java\org\apache\dubbo\registry\client\DefaultServiceInstanceTest.java,65,19,3,10,0,32
dubbo-3.0\dubbo-3.0\dubbo-metadata\dubbo-metadata-api\src\main\java\org\apache\dubbo\metadata\rest\springmvc\SpringMvcServiceRestMetadataResolver.java,96,50,0,21,0,71
dubbo-3.0\dubbo-3.0\dubbo-compatible\src\main\java\com\alibaba\dubbo\remoting\Codec2.java,0,0,0,1,0,1
dubbo-3.0\dubbo-3.0\dubbo-filter\dubbo-filter-cache\src\main\java\org\apache\dubbo\cache\support\lfu\LfuCache.java,41,14,0,8,0,22
dubbo-3.0\dubbo-3.0\compiler\src\main\java\org\apache\dubbo\gen\dubbo\Dubbo3Generator.java,42,11,0,1,0,12
dubbo-3.0\dubbo-3.0\dubbo-common\src\test\java\org\apache\dubbo\common\convert\multiple\StringToSetConverterTest.java,67,11,5,2,0,18
dubbo-3.0\dubbo-3.0\dubbo-compatible\src\test\java\org\apache\dubbo\config\ProviderConfigTest.java,155,35,0,1,0,36
dubbo-3.0\dubbo-3.0\dubbo-config\dubbo-config-spring\src\test\java\org\apache\dubbo\config\spring\context\customize\DubboSpringInitCustomizerTest.java,75,16,0,12,0,28
dubbo-3.0\dubbo-3.0\dubbo-common\src\test\java\org\apache\dubbo\common\extension\ext9_empty\impl\Ext9EmptyImpl.java,7,1,1,1,0,3
dubbo-3.0\dubbo-3.0\dubbo-common\src\test\java\org\apache\dubbo\common\model\person\PersonInfo.java,186,117,21,9,0,147
dubbo-3.0\dubbo-3.0\dubbo-config\dubbo-config-spring\src\main\java\org\apache\dubbo\config\spring\context\DubboSpringInitCustomizerHolder.java,25,16,0,6,0,22
dubbo-3.0\dubbo-3.0\dubbo-common\src\test\java\org\apache\dubbo\common\utils\JVMUtilTest.java,3,0,0,1,0,1
dubbo-3.0\dubbo-3.0\dubbo-cluster\src\main\java\org\apache\dubbo\rpc\cluster\router\mesh\rule\virtualservice\VirtualServiceSpec.java,29,18,0,1,0,19
dubbo-3.0\dubbo-3.0\dubbo-registry\dubbo-registry-api\src\main\java\org\apache\dubbo\registry\retry\ReExportTask.java,17,14,0,3,0,17
dubbo-3.0\dubbo-3.0\dubbo-remoting\dubbo-remoting-api\src\main\java\org\apache\dubbo\remoting\api\ConnectionHandler.java,61,23,1,6,0,30
dubbo-3.0\dubbo-3.0\dubbo-plugin\dubbo-qos\src\main\java\org\apache\dubbo\qos\server\DubboLogo.java,8,10,0,5,0,15
dubbo-3.0\dubbo-3.0\dubbo-common\src\main\java\org\apache\dubbo\metadata\definition\model\FullServiceDefinition.java,21,12,0,1,0,13
dubbo-3.0\dubbo-3.0\dubbo-remoting\dubbo-remoting-api\src\test\java\org\apache\dubbo\remoting\utils\UrlUtilsTest.java,18,8,0,4,0,12
dubbo-3.0\dubbo-3.0\dubbo-common\src\main\java\org\apache\dubbo\common\convert\multiple\StringToDequeConverter.java,11,6,0,1,0,7
dubbo-3.0\dubbo-3.0\dubbo-remoting\dubbo-remoting-api\src\test\java\org\apache\dubbo\remoting\codec\TelnetCodecTest.java,344,172,30,36,0,238
dubbo-3.0\dubbo-3.0\dubbo-common\src\test\java\org\apache\dubbo\rpc\model\ModuleModelTest.java,61,13,0,10,0,23
dubbo-3.0\dubbo-3.0\dubbo-common\src\test\java\org\apache\dubbo\common\extension\activate\impl\ActivateWrapperExt1Impl1.java,6,3,0,1,0,4
dubbo-3.0\dubbo-3.0\dubbo-registry\dubbo-registry-api\src\main\java\org\apache\dubbo\registry\integration\RegistryProtocol.java,0,327,14,160,0,501
dubbo-3.0\dubbo-3.0\dubbo-config\dubbo-config-api\src\test\java\org\apache\dubbo\config\integration\multiple\exportprovider\MultipleRegistryCenterExportProviderService.java,0,3,0,2,0,5
dubbo-3.0\dubbo-3.0\dubbo-rpc\dubbo-rpc-triple\src\test\java\org\apache\dubbo\rpc\protocol\tri\transport\TripleHttp2ClientResponseHandlerTest.java,46,14,0,6,0,20
dubbo-3.0\dubbo-3.0\dubbo-cluster\src\test\java\org\apache\dubbo\rpc\cluster\loadbalance\RoundRobinLoadBalanceTest.java,129,35,1,22,0,58
dubbo-3.0\dubbo-3.0\dubbo-remoting\dubbo-remoting-api\src\main\java\org\apache\dubbo\remoting\buffer\ByteBufferBackedChannelBuffer.java,236,68,3,10,0,81
dubbo-3.0\dubbo-3.0\dubbo-common\src\test\java\org\apache\dubbo\common\utils\ParametersTest.java,25,14,3,2,0,19
dubbo-3.0\dubbo-3.0\dubbo-cluster\src\main\java\org\apache\dubbo\rpc\cluster\support\FailoverCluster.java,11,6,0,2,0,8
dubbo-3.0\dubbo-3.0\dubbo-rpc\dubbo-rpc-triple\src\main\java\org\apache\dubbo\rpc\protocol\tri\command\DataQueueCommand.java,45,19,1,2,0,22
dubbo-3.0\dubbo-3.0\dubbo-common\src\test\java\org\apache\dubbo\common\extension\ext8_add\AddExt2.java,0,1,0,1,0,2
dubbo-3.0\dubbo-3.0\dubbo-remoting\dubbo-remoting-netty4\src\main\java\org\apache\dubbo\remoting\transport\netty4\NettyServerHandler.java,97,45,1,18,0,64
dubbo-3.0\dubbo-3.0\dubbo-compatible\src\main\java\com\alibaba\dubbo\registry\RegistryFactory.java,0,2,0,2,0,4
dubbo-3.0\dubbo-3.0\dubbo-common\src\test\java\org\apache\dubbo\common\utils\LogUtilTest.java,85,11,0,2,0,13
dubbo-3.0\dubbo-3.0\dubbo-rpc\dubbo-rpc-rest\src\main\java\org\apache\dubbo\rpc\protocol\rest\RestConstraintViolation.java,42,29,1,1,0,31
dubbo-3.0\dubbo-3.0\dubbo-config\dubbo-config-spring\src\test\java\org\apache\dubbo\config\spring\registry\nacos\demo\service\DefaultService.java,17,7,0,2,0,9
dubbo-3.0\dubbo-3.0\dubbo-metadata\dubbo-metadata-api\src\main\java\org\apache\dubbo\metadata\report\support\NopMetadataReport.java,60,25,10,8,0,43
dubbo-3.0\dubbo-3.0\dubbo-remoting\dubbo-remoting-netty4\src\test\java\org\apache\dubbo\remoting\transport\netty4\NettyBackedChannelBufferTest.java,38,12,0,3,0,15
dubbo-3.0\dubbo-3.0\dubbo-common\src\main\java\org\apache\dubbo\common\beans\ScopeBeanExtensionInjector.java,0,11,2,2,0,15
dubbo-3.0\dubbo-3.0\dubbo-compatible\src\test\java\org\apache\dubbo\service\DemoServiceImpl.java,72,52,4,3,0,59
dubbo-3.0\dubbo-3.0\dubbo-common\src\main\java\org\apache\dubbo\config\ArgumentConfig.java,56,25,1,1,0,27
dubbo-3.0\dubbo-3.0\dubbo-common\src\test\java\org\apache\dubbo\common\extension\ext7\InitErrorExt.java,0,4,0,3,0,7
dubbo-3.0\dubbo-3.0\dubbo-config\dubbo-config-api\src\main\java\org\apache\dubbo\config\bootstrap\builders\ReferenceBuilder.java,0,53,1,5,0,59
dubbo-3.0\dubbo-3.0\dubbo-plugin\dubbo-qos\src\main\java\org\apache\dubbo\qos\server\Server.java,113,47,3,5,0,55
dubbo-3.0\dubbo-3.0\dubbo-filter\dubbo-filter-cache\src\main\java\org\apache\dubbo\cache\support\AbstractCacheFactory.java,51,12,0,8,0,20
dubbo-3.0\dubbo-3.0\dubbo-compatible\src\main\java\com\alibaba\dubbo\container\page\pages\SystemPageHandler.java,103,15,0,7,0,22
dubbo-3.0\dubbo-3.0\dubbo-filter\dubbo-filter-cache\src\main\java\org\apache\dubbo\cache\filter\CacheFilter.java,67,26,0,17,0,43
dubbo-3.0\dubbo-3.0\dubbo-rpc\dubbo-rpc-api\src\main\java\org\apache\dubbo\rpc\ProxyFactory.java,0,4,0,2,0,6
dubbo-3.0\dubbo-3.0\dubbo-metadata\dubbo-metadata-api\src\main\java\org\apache\dubbo\metadata\report\identifier\SubscriberMetadataIdentifier.java,45,26,1,2,0,29
dubbo-3.0\dubbo-3.0\dubbo-registry\dubbo-registry-multicast\src\main\java\org\apache\dubbo\registry\multicast\MulticastServiceDiscovery.java,44,21,4,6,0,31
dubbo-3.0\dubbo-3.0\dubbo-compatible\src\main\java\com\alibaba\dubbo\config\ModuleConfig.java,0,3,1,1,0,5
dubbo-3.0\dubbo-3.0\dubbo-metadata\dubbo-metadata-report-nacos\src\main\java\org\apache\dubbo\metadata\store\nacos\NacosMetadataReportFactory.java,7,3,0,1,0,4
dubbo-3.0\dubbo-3.0\dubbo-plugin\dubbo-qos\src\main\java\org\apache\dubbo\qos\command\impl\DisableRouterSnapshot.java,31,13,2,6,0,21
dubbo-3.0\dubbo-3.0\dubbo-common\src\main\java\org\apache\dubbo\common\url\component\param\DynamicParamTable.java,0,24,0,4,0,28
dubbo-3.0\dubbo-3.0\dubbo-rpc\dubbo-rpc-api\src\main\java\org\apache\dubbo\rpc\ProtocolServer.java,0,9,2,2,0,13
dubbo-3.0\dubbo-3.0\dubbo-rpc\dubbo-rpc-triple\src\main\java\org\apache\dubbo\rpc\protocol\tri\service\TriHealthImpl.java,0,44,3,22,0,69
dubbo-3.0\dubbo-3.0\dubbo-remoting\dubbo-remoting-api\src\main\java\org\apache\dubbo\remoting\transport\ChannelDelegate.java,99,36,1,1,0,38
dubbo-3.0\dubbo-3.0\dubbo-rpc\dubbo-rpc-api\src\test\java\org\apache\dubbo\rpc\support\DemoServiceB.java,0,1,0,1,0,2
dubbo-3.0\dubbo-3.0\dubbo-cluster\src\main\java\org\apache\dubbo\rpc\cluster\LoadBalance.java,0,3,0,3,0,6
dubbo-3.0\dubbo-3.0\dubbo-common\src\main\java\org\apache\dubbo\common\utils\NamedThreadFactory.java,40,20,1,2,0,23
dubbo-3.0\dubbo-3.0\dubbo-common\src\test\java\org\apache\dubbo\common\compiler\support\internal\HelloServiceInternalImpl.java,0,1,0,1,0,2
dubbo-3.0\dubbo-3.0\dubbo-registry\dubbo-registry-api\src\main\java\org\apache\dubbo\registry\client\metadata\store\MetaCacheManager.java,47,16,1,4,0,21
dubbo-3.0\dubbo-3.0\dubbo-spring-boot\dubbo-spring-boot-compatible\autoconfigure\src\test\java\org\apache\dubbo\spring\boot\util\DubboUtilsTest.java,40,13,0,24,0,37
dubbo-3.0\dubbo-3.0\dubbo-rpc\dubbo-rpc-api\src\test\java\org\apache\dubbo\rpc\stub\FutureToObserverAdaptorTest.java,0,8,4,9,0,21
dubbo-3.0\dubbo-3.0\dubbo-common\src\main\java\org\apache\dubbo\metadata\definition\model\MethodDefinition.java,87,43,0,6,0,49
dubbo-3.0\dubbo-3.0\dubbo-demo\dubbo-demo-triple\src\main\java\org\apache\dubbo\demo\GreeterWrapperServiceImpl.java,12,3,0,1,0,4
dubbo-3.0\dubbo-3.0\dubbo-native\src\main\java\org\apache\dubbo\metadata\report\MetadataReportFactory$Adaptive.java,0,19,11,7,0,37
dubbo-3.0\dubbo-3.0\dubbo-remoting\dubbo-remoting-zookeeper\src\test\java\org\apache\dubbo\remoting\zookeeper\curator\support\AbstractZookeeperTransporterTest.java,154,78,2,55,0,135
dubbo-3.0\dubbo-3.0\dubbo-rpc\dubbo-rpc-api\src\test\java\org\apache\dubbo\rpc\support\LocalException.java,8,2,0,1,0,3
dubbo-3.0\dubbo-3.0\dubbo-common\src\main\java\org\apache\dubbo\common\utils\JsonUtils.java,8,4,1,1,0,6
dubbo-3.0\dubbo-3.0\dubbo-common\src\main\java\org\apache\dubbo\config\ApplicationConfig.java,542,268,2,26,0,296
dubbo-3.0\dubbo-3.0\dubbo-plugin\dubbo-qos\src\test\java\org\apache\dubbo\qos\command\impl\OnlineTest.java,60,17,0,11,0,28
dubbo-3.0\dubbo-3.0\dubbo-registry\dubbo-registry-api\src\main\java\org\apache\dubbo\registry\client\AbstractServiceDiscoveryFactory.java,0,17,0,7,0,24
dubbo-3.0\dubbo-3.0\dubbo-config\dubbo-config-api\src\test\java\org\apache\dubbo\config\url\ExporterSideConfigUrlTest.java,72,21,3,6,0,30
dubbo-3.0\dubbo-3.0\dubbo-cluster\src\main\java\org\apache\dubbo\rpc\cluster\merger\ArrayMerger.java,50,5,0,2,0,7
dubbo-3.0\dubbo-3.0\dubbo-serialization\dubbo-serialization-jdk\src\main\java\org\apache\dubbo\common\serialize\java\CompactedObjectOutputStream.java,18,6,0,2,0,8
dubbo-3.0\dubbo-3.0\dubbo-common\src\main\java\org\apache\dubbo\metadata\definition\builder\MapTypeBuilder.java,47,10,0,5,0,15
dubbo-3.0\dubbo-3.0\dubbo-rpc\dubbo-rpc-triple\src\main\java\org\apache\dubbo\rpc\protocol\tri\observer\ServerCallToObserverAdapter.java,87,38,1,3,0,42
dubbo-3.0\dubbo-3.0\dubbo-common\src\main\java\org\apache\dubbo\common\bytecode\NoSuchMethodException.java,12,3,0,1,0,4
dubbo-3.0\dubbo-3.0\dubbo-common\src\test\java\org\apache\dubbo\common\threadpool\manager\ExecutorRepositoryTest.java,114,35,0,6,0,41
dubbo-3.0\dubbo-3.0\dubbo-rpc\dubbo-rpc-api\src\main\java\org\apache\dubbo\rpc\protocol\AbstractExporter.java,49,12,2,1,0,15
dubbo-3.0\dubbo-3.0\dubbo-common\src\test\java\org\apache\dubbo\common\extension\ext6_inject\impl\Ext6Impl1.java,20,17,0,2,0,19
dubbo-3.0\dubbo-3.0\dubbo-rpc\dubbo-rpc-grpc\src\test\java\org\apache\dubbo\rpc\protocol\grpc\support\DubboGreeterGrpc.java,0,102,27,33,0,162
dubbo-3.0\dubbo-3.0\dubbo-remoting\dubbo-remoting-api\src\main\java\org\apache\dubbo\remoting\exchange\ExchangeServer.java,0,0,0,1,0,1
dubbo-3.0\dubbo-3.0\dubbo-cluster\src\main\java\org\apache\dubbo\rpc\cluster\router\mesh\route\MeshRuleCache.java,135,51,2,24,0,77
dubbo-3.0\dubbo-3.0\dubbo-config\dubbo-config-api\src\test\java\org\apache\dubbo\config\ConsumerConfigTest.java,212,47,0,13,0,60
dubbo-3.0\dubbo-3.0\dubbo-compatible\src\test\java\org\apache\dubbo\service\CustomArgument.java,30,22,1,1,0,24
dubbo-3.0\dubbo-3.0\dubbo-rpc\dubbo-rpc-rest\src\main\java\org\apache\dubbo\rpc\protocol\rest\Constants.java,0,4,3,1,0,8
dubbo-3.0\dubbo-3.0\dubbo-remoting\dubbo-remoting-netty\src\test\java\org\apache\dubbo\remoting\transport\netty\ClientsTest.java,35,9,0,6,0,15
dubbo-3.0\dubbo-3.0\dubbo-serialization\dubbo-serialization-hessian2\src\main\java\org\apache\dubbo\common\serialize\hessian2\Hessian2ObjectInput.java,0,33,0,10,0,43
dubbo-3.0\dubbo-3.0\dubbo-demo\dubbo-demo-generic-call\src\main\java\org\apache\dubbo\demo\consumer\GenericApplication.java,48,9,1,4,0,14
dubbo-3.0\dubbo-3.0\dubbo-common\src\test\java\org\apache\dubbo\common\url\URLParamTest.java,244,42,0,28,0,70
dubbo-3.0\dubbo-3.0\dubbo-rpc\dubbo-rpc-api\src\main\java\com\alibaba\dubbo\rpc\service\GenericService.java,0,1,2,2,0,5
dubbo-3.0\dubbo-3.0\dubbo-rpc\dubbo-rpc-api\src\main\java\org\apache\dubbo\rpc\RpcException.java,98,62,0,3,0,65
dubbo-3.0\dubbo-3.0\dubbo-common\src\main\java\org\apache\dubbo\metadata\definition\util\ClassUtils.java,0,10,0,6,0,16
dubbo-3.0\dubbo-3.0\dubbo-plugin\dubbo-qos\src\main\java\org\apache\dubbo\qos\command\impl\OfflineApp.java,14,4,0,1,0,5
dubbo-3.0\dubbo-3.0\dubbo-config\dubbo-config-spring\src\test\java\org\apache\dubbo\config\spring\registry\nacos\nacos\NacosServiceNameTest.java,92,20,0,5,0,25
dubbo-3.0\dubbo-3.0\dubbo-common\src\main\java\org\apache\dubbo\common\io\Bytes.java,901,319,23,35,0,377
dubbo-3.0\dubbo-3.0\dubbo-common\src\test\java\org\apache\dubbo\common\config\PrefixedConfigurationTest.java,28,11,0,10,0,21
dubbo-3.0\dubbo-3.0\dubbo-common\src\test\java\org\apache\dubbo\config\Greeting.java,0,1,0,1,0,2
dubbo-3.0\dubbo-3.0\dubbo-config\dubbo-config-api\src\test\java\org\apache\dubbo\config\ModuleConfigTest.java,79,12,0,2,0,14
dubbo-3.0\dubbo-3.0\dubbo-config\dubbo-config-api\src\test\java\org\apache\dubbo\config\integration\single\exportprovider\SingleRegistryCenterExportProviderFilter.java,0,23,0,6,0,29
dubbo-3.0\dubbo-3.0\dubbo-rpc\dubbo-rpc-api\src\test\java\org\apache\dubbo\rpc\filter\ActiveLimitFilterTest.java,185,43,1,24,0,68
dubbo-3.0\dubbo-3.0\dubbo-metadata\dubbo-metadata-api\src\main\java\org\apache\dubbo\metadata\report\support\AbstractMetadataReport.java,445,170,13,80,0,263
dubbo-3.0\dubbo-3.0\dubbo-registry\dubbo-registry-api\src\main\java\org\apache\dubbo\registry\client\FileSystemServiceDiscovery.java,0,24,0,25,0,49
dubbo-3.0\dubbo-3.0\dubbo-config\dubbo-config-spring\src\test\java\org\apache\dubbo\config\spring\api\DemoService.java,0,3,0,1,0,4
dubbo-3.0\dubbo-3.0\dubbo-common\src\main\java\org\apache\dubbo\common\extension\support\WrapperComparator.java,54,14,0,4,0,18
dubbo-3.0\dubbo-3.0\dubbo-metadata\dubbo-metadata-processor\src\main\java\org\apache\dubbo\metadata\annotation\processing\rest\ServiceRestMetadataStorage.java,28,14,0,6,0,20
dubbo-3.0\dubbo-3.0\dubbo-serialization\dubbo-serialization-api\src\main\java\org\apache\dubbo\common\serialize\Serialization.java,0,8,0,5,0,13
dubbo-3.0\dubbo-3.0\dubbo-common\src\test\java\org\apache\dubbo\common\extension\ext7\impl\Ext7InitErrorImpl.java,14,4,1,1,0,6
dubbo-3.0\dubbo-3.0\dubbo-compatible\src\main\java\com\alibaba\dubbo\rpc\cluster\Router.java,0,12,0,8,0,20
dubbo-3.0\dubbo-3.0\dubbo-registry\dubbo-registry-api\src\main\java\org\apache\dubbo\registry\client\package-info.java,0,1,0,2,0,3
dubbo-3.0\dubbo-3.0\dubbo-remoting\dubbo-remoting-netty4\src\main\java\org\apache\dubbo\remoting\transport\netty4\NettyBackedChannelBuffer.java,421,152,0,5,0,157
dubbo-3.0\dubbo-3.0\dubbo-demo\dubbo-demo-annotation\dubbo-demo-annotation-consumer\src\main\java\org\apache\dubbo\demo\consumer\Application.java,22,8,2,5,0,15
dubbo-3.0\dubbo-3.0\dubbo-plugin\dubbo-qos\src\test\java\org\apache\dubbo\qos\command\impl\ChangeTelnetTest.java,87,36,0,18,0,54
dubbo-3.0\dubbo-3.0\dubbo-common\src\main\java\org\apache\dubbo\common\convert\StringToFloatConverter.java,13,5,0,1,0,6
dubbo-3.0\dubbo-3.0\dubbo-common\src\main\java\org\apache\dubbo\common\url\component\param\DynamicParamSource.java,0,1,0,1,0,2
dubbo-3.0\dubbo-3.0\dubbo-rpc\dubbo-rpc-api\src\main\java\org\apache\dubbo\rpc\support\MockProtocol.java,0,7,0,3,0,10
dubbo-3.0\dubbo-3.0\dubbo-remoting\dubbo-remoting-api\src\test\java\org\apache\dubbo\remoting\TransportersTest.java,23,9,0,6,0,15
dubbo-3.0\dubbo-3.0\dubbo-config\dubbo-config-spring\src\main\java\org\apache\dubbo\config\spring\ServiceBean.java,0,33,0,6,0,39
dubbo-3.0\dubbo-3.0\dubbo-registry\dubbo-registry-api\src\main\java\org\apache\dubbo\registry\client\ServiceDiscoveryFactory.java,0,6,0,3,0,9
dubbo-3.0\dubbo-3.0\dubbo-config\dubbo-config-api\src\test\java\org\apache\dubbo\config\bootstrap\ZookeeperDubboServiceProviderBootstrap.java,16,9,1,8,0,18
dubbo-3.0\dubbo-3.0\dubbo-cluster\src\main\java\org\apache\dubbo\rpc\cluster\router\mesh\rule\destination\DestinationRule.java,20,11,0,1,0,12
dubbo-3.0\dubbo-3.0\dubbo-spring-boot\dubbo-spring-boot-autoconfigure\src\test\java\org\apache\dubbo\spring\boot\autoconfigure\BinderDubboConfigBinderTest.java,29,9,1,4,0,14
dubbo-3.0\dubbo-3.0\dubbo-common\src\main\java\org\apache\dubbo\common\config\PropertiesConfiguration.java,42,25,0,1,0,26
dubbo-3.0\dubbo-3.0\dubbo-compatible\src\main\java\com\alibaba\dubbo\remoting\exchange\ResponseCallback.java,0,1,0,1,0,2
dubbo-3.0\dubbo-3.0\dubbo-remoting\dubbo-remoting-api\src\main\java\org\apache\dubbo\remoting\api\SslContexts.java,115,31,8,22,0,61
dubbo-3.0\dubbo-3.0\dubbo-remoting\dubbo-remoting-api\src\main\java\org\apache\dubbo\remoting\buffer\DirectChannelBufferFactory.java,58,12,1,2,0,15
dubbo-3.0\dubbo-3.0\dubbo-common\src\main\java\org\apache\dubbo\common\Resetable.java,0,0,0,1,0,1
dubbo-3.0\dubbo-3.0\dubbo-cluster\src\main\java\org\apache\dubbo\rpc\cluster\loadbalance\ConsistentHashLoadBalance.java,173,72,2,19,0,93
dubbo-3.0\dubbo-3.0\dubbo-remoting\dubbo-remoting-api\src\test\java\org\apache\dubbo\remoting\telnet\support\ClearTelnetHandlerTest.java,22,7,0,4,0,11
dubbo-3.0\dubbo-3.0\dubbo-config\dubbo-config-spring\src\test\java\org\apache\dubbo\config\spring\context\annotation\EnableDubboTest.java,130,27,2,20,0,49
dubbo-3.0\dubbo-3.0\dubbo-rpc\dubbo-rpc-injvm\src\main\java\org\apache\dubbo\rpc\protocol\injvm\DefaultParamDeepCopyUtil.java,36,16,1,8,0,25
dubbo-3.0\dubbo-3.0\dubbo-rpc\dubbo-rpc-injvm\src\main\java\org\apache\dubbo\rpc\protocol\injvm\ParamDeepCopyUtil.java,0,1,0,1,0,2
dubbo-3.0\dubbo-3.0\dubbo-spring-boot\dubbo-spring-boot-actuator\src\main\java\org\apache\dubbo\spring\boot\actuate\endpoint\DubboConfigsMetadataEndpoint.java,11,5,0,3,0,8
dubbo-3.0\dubbo-3.0\dubbo-common\src\test\java\org\apache\dubbo\common\extension\ext6_wrap\impl\Ext6Impl2.java,6,4,0,1,0,5
dubbo-3.0\dubbo-3.0\dubbo-plugin\dubbo-qos\src\main\java\org\apache\dubbo\qos\command\impl\GetEnabledRouterSnapshot.java,13,8,0,3,0,11
dubbo-3.0\dubbo-3.0\dubbo-rpc\dubbo-rpc-triple\src\test\java\org\apache\dubbo\rpc\protocol\tri\ClassLoadUtilTest.java,0,1,0,2,0,3
dubbo-3.0\dubbo-3.0\dubbo-common\src\test\java\org\apache\dubbo\common\extension\director\FooAppProvider.java,0,2,0,1,0,3
dubbo-3.0\dubbo-3.0\dubbo-common\src\main\java\org\apache\dubbo\common\utils\CharSequenceComparator.java,13,7,1,2,0,10
dubbo-3.0\dubbo-3.0\dubbo-config\dubbo-config-api\src\test\java\org\apache\dubbo\config\bootstrap\MultiInstanceTest.java,866,199,15,134,0,348
dubbo-3.0\dubbo-3.0\dubbo-cluster\src\main\java\org\apache\dubbo\rpc\cluster\support\BroadcastCluster.java,9,4,0,2,0,6
dubbo-3.0\dubbo-3.0\dubbo-common\src\main\java\org\apache\dubbo\common\utils\ClassHelper.java,129,39,1,4,0,44
dubbo-3.0\dubbo-3.0\dubbo-plugin\dubbo-qos\src\main\java\org\apache\dubbo\qos\command\impl\EnableDetailProfiler.java,11,9,0,4,0,13
dubbo-3.0\dubbo-3.0\dubbo-config\dubbo-config-spring\src\test\java\org\apache\dubbo\config\spring\SysProps.java,22,9,1,2,0,12
dubbo-3.0\dubbo-3.0\dubbo-compatible\src\test\java\org\apache\dubbo\serialization\MyObjectOutput.java,70,18,10,1,0,29
dubbo-3.0\dubbo-3.0\dubbo-metadata\dubbo-metadata-api\src\main\java\org\apache\dubbo\metadata\MappingCacheManager.java,48,22,1,7,0,30
dubbo-3.0\dubbo-3.0\dubbo-common\src\main\java\org\apache\dubbo\common\url\component\param\ParamValue.java,0,2,0,1,0,3
dubbo-3.0\dubbo-3.0\dubbo-metadata\dubbo-metadata-api\src\main\java\org\apache\dubbo\metadata\rest\springmvc\AbstractRequestAnnotationParameterProcessor.java,41,25,0,10,0,35
dubbo-3.0\dubbo-3.0\dubbo-plugin\dubbo-qos\src\main\java\org\apache\dubbo\qos\command\CommandContext.java,68,52,0,1,0,53
dubbo-3.0\dubbo-3.0\dubbo-common\src\test\java\org\apache\dubbo\common\extension\ext3\impl\UseProtocolKeyExtImpl1.java,10,9,0,1,0,10
dubbo-3.0\dubbo-3.0\dubbo-common\src\test\java\org\apache\dubbo\metadata\definition\Test3TypeBuilder.java,18,12,0,2,0,14
dubbo-3.0\dubbo-3.0\dubbo-rpc\dubbo-rpc-api\src\main\java\org\apache\dubbo\rpc\Exporter.java,0,1,0,1,0,2
dubbo-3.0\dubbo-3.0\dubbo-common\src\test\java\org\apache\dubbo\common\model\person\FullAddress.java,183,104,18,8,0,130
dubbo-3.0\dubbo-3.0\dubbo-config\dubbo-config-api\src\test\java\org\apache\dubbo\config\mock\MockTransporter.java,15,10,0,3,0,13
dubbo-3.0\dubbo-3.0\dubbo-plugin\dubbo-qos\src\main\java\org\apache\dubbo\qos\server\handler\TelnetProcessHandler.java,43,17,2,9,0,28
dubbo-3.0\dubbo-3.0\dubbo-plugin\dubbo-qos\src\test\java\org\apache\dubbo\qos\legacy\service\Type.java,0,3,0,1,0,4
dubbo-3.0\dubbo-3.0\dubbo-rpc\dubbo-rpc-api\src\main\java\org\apache\dubbo\rpc\listener\ListenerExporterWrapper.java,63,15,2,3,0,20
dubbo-3.0\dubbo-3.0\dubbo-test\dubbo-test-check\src\main\java\org\apache\dubbo\test\check\registrycenter\processor\StopZookeeperUnixProcessor.java,34,14,1,9,0,24
dubbo-3.0\dubbo-3.0\dubbo-metadata\dubbo-metadata-processor\src\main\java\org\apache\dubbo\metadata\annotation\processing\ServiceDefinitionMetadataAnnotationProcessor.java,22,16,1,9,0,26
dubbo-3.0\dubbo-3.0\dubbo-common\src\main\java\org\apache\dubbo\common\deploy\ModuleDeployListener.java,0,1,0,1,0,2
dubbo-3.0\dubbo-3.0\dubbo-metadata\dubbo-metadata-processor\src\test\java\org\apache\dubbo\metadata\annotation\processing\model\MapTypeModel.java,13,10,7,5,0,22
dubbo-3.0\dubbo-3.0\dubbo-compatible\src\main\java\com\alibaba\dubbo\rpc\cluster\RuleConverter.java,0,5,0,5,0,10
dubbo-3.0\dubbo-3.0\dubbo-common\src\main\java\org\apache\dubbo\common\convert\StringToCharArrayConverter.java,14,5,0,1,0,6
dubbo-3.0\dubbo-3.0\dubbo-common\src\main\java\org\apache\dubbo\config\context\ModuleConfigManager.java,321,139,0,24,0,163
dubbo-3.0\dubbo-3.0\dubbo-registry\dubbo-registry-nacos\src\main\java\org\apache\dubbo\registry\nacos\NacosRegistry.java,605,157,10,69,0,236
dubbo-3.0\dubbo-3.0\dubbo-common\src\main\java\org\apache\dubbo\rpc\model\PackableMethod.java,0,11,0,4,0,15
dubbo-3.0\dubbo-3.0\dubbo-common\src\main\java\org\apache\dubbo\rpc\model\StubMethodDescriptor.java,0,54,3,4,0,61
dubbo-3.0\dubbo-3.0\dubbo-registry\dubbo-registry-api\src\main\java\org\apache\dubbo\registry\client\metadata\MetadataUtils.java,147,57,5,40,0,102
dubbo-3.0\dubbo-3.0\dubbo-demo\dubbo-demo-api\dubbo-demo-api-provider\src\main\java\org\apache\dubbo\demo\provider\DemoServiceImpl.java,16,9,1,4,0,14
dubbo-3.0\dubbo-3.0\dubbo-common\src\test\java\org\apache\dubbo\common\threadpool\MemoryLimitedLinkedBlockingQueueTest.java,15,6,0,5,0,11
dubbo-3.0\dubbo-3.0\dubbo-common\src\main\java\org\apache\dubbo\config\AbstractInterfaceConfig.java,843,363,7,76,0,446
dubbo-3.0\dubbo-3.0\dubbo-plugin\dubbo-qos\src\test\java\org\apache\dubbo\qos\DemoServiceImpl.java,8,2,0,1,0,3
dubbo-3.0\dubbo-3.0\dubbo-remoting\dubbo-remoting-http\src\main\java\org\apache\dubbo\remoting\http\HttpBinder.java,0,3,0,1,0,4
dubbo-3.0\dubbo-3.0\dubbo-common\src\test\java\org\apache\dubbo\common\store\support\SimpleDataStoreTest.java,34,5,0,1,0,6
dubbo-3.0\dubbo-3.0\dubbo-monitor\dubbo-monitor-default\src\main\java\org\apache\dubbo\monitor\dubbo\MetricsFilter.java,0,69,7,32,0,108
dubbo-3.0\dubbo-3.0\dubbo-registry\dubbo-registry-api\src\main\java\org\apache\dubbo\registry\client\migration\model\SubMigrationRule.java,98,61,1,5,0,67
dubbo-3.0\dubbo-3.0\dubbo-remoting\dubbo-remoting-api\src\test\java\org\apache\dubbo\remoting\telnet\support\StatusTelnetHandlerTest.java,19,9,0,4,0,13
dubbo-3.0\dubbo-3.0\dubbo-remoting\dubbo-remoting-api\src\main\java\org\apache\dubbo\remoting\telnet\support\command\LogTelnetHandler.java,58,12,1,8,0,21
dubbo-3.0\dubbo-3.0\dubbo-rpc\dubbo-rpc-api\src\test\java\org\apache\dubbo\rpc\proxy\Type.java,0,3,0,1,0,4
dubbo-3.0\dubbo-3.0\dubbo-common\src\test\java\org\apache\dubbo\common\utils\FieldUtilsTest.java,0,8,3,1,0,12
dubbo-3.0\dubbo-3.0\dubbo-plugin\dubbo-qos\src\main\java\org\apache\dubbo\qos\server\handler\LocalHostPermitHandler.java,21,8,0,3,0,11
dubbo-3.0\dubbo-3.0\dubbo-common\src\main\java\org\apache\dubbo\common\extension\Activate.java,0,13,0,10,0,23
dubbo-3.0\dubbo-3.0\dubbo-rpc\dubbo-rpc-api\src\main\java\org\apache\dubbo\rpc\proxy\wrapper\StubProxyFactoryWrapper.java,80,37,2,14,0,53
dubbo-3.0\dubbo-3.0\dubbo-common\src\main\java\org\apache\dubbo\common\bytecode\Mixin.java,201,33,5,13,0,51
dubbo-3.0\dubbo-3.0\dubbo-rpc\dubbo-rpc-api\src\main\java\org\apache\dubbo\rpc\listener\InvokerListenerAdapter.java,12,3,2,1,0,6
dubbo-3.0\dubbo-3.0\dubbo-cluster\src\test\java\org\apache\dubbo\rpc\cluster\router\MockInvoker.java,46,20,2,1,0,23
dubbo-3.0\dubbo-3.0\dubbo-config\dubbo-config-api\src\test\java\org\apache\dubbo\config\nested\AggregationConfigTest.java,24,8,0,1,0,9
dubbo-3.0\dubbo-3.0\dubbo-common\src\test\java\org\apache\dubbo\common\beans\model\FooBeanWithoutUniqueConstructors.java,13,8,4,1,0,13
dubbo-3.0\dubbo-3.0\dubbo-remoting\dubbo-remoting-netty\src\test\java\org\apache\dubbo\remoting\transport\netty\TelnetServerHandler.java,21,8,0,2,0,10
dubbo-3.0\dubbo-3.0\dubbo-configcenter\dubbo-configcenter-zookeeper\src\main\java\org\apache\dubbo\configcenter\support\zookeeper\ZookeeperDynamicConfiguration.java,106,46,0,14,0,60
dubbo-3.0\dubbo-3.0\dubbo-common\src\test\java\org\apache\dubbo\common\utils\DefaultCharSequence.java,0,8,0,1,0,9
dubbo-3.0\dubbo-3.0\dubbo-remoting\dubbo-remoting-api\src\main\java\org\apache\dubbo\remoting\transport\AbstractServer.java,138,46,10,17,0,73
dubbo-3.0\dubbo-3.0\dubbo-rpc\dubbo-rpc-dubbo\src\test\java\org\apache\dubbo\rpc\protocol\dubbo\decode\MockChannel.java,89,25,7,1,0,33
dubbo-3.0\dubbo-3.0\dubbo-common\src\main\java\org\apache\dubbo\common\logger\Logger.java,0,1,0,1,0,2
dubbo-3.0\dubbo-3.0\dubbo-remoting\dubbo-remoting-api\src\test\java\org\apache\dubbo\remoting\ChanelHandlerTest.java,92,32,2,10,0,44
dubbo-3.0\dubbo-3.0\dubbo-rpc\dubbo-rpc-triple\src\main\java\org\apache\dubbo\rpc\protocol\tri\command\QueuedCommand.java,0,19,0,2,0,21
dubbo-3.0\dubbo-3.0\dubbo-rpc\dubbo-rpc-api\src\test\java\org\apache\dubbo\rpc\proxy\wrapper\StubProxyFactoryWrapperTest.java,23,4,0,2,0,6
dubbo-3.0\dubbo-3.0\dubbo-config\dubbo-config-api\src\test\java\org\apache\dubbo\config\bootstrap\NacosDubboServiceProviderBootstrap.java,21,11,1,9,0,21
dubbo-3.0\dubbo-3.0\dubbo-rpc\dubbo-rpc-api\src\main\java\org\apache\dubbo\rpc\TimeoutCountDown.java,0,19,1,6,0,26
dubbo-3.0\dubbo-3.0\dubbo-remoting\dubbo-remoting-api\src\main\java\org\apache\dubbo\remoting\api\SslClientTlsHandler.java,36,19,2,7,0,28
dubbo-3.0\dubbo-3.0\dubbo-remoting\dubbo-remoting-api\src\test\java\org\apache\dubbo\remoting\api\ConnectionTest.java,0,4,6,4,0,14
dubbo-3.0\dubbo-3.0\dubbo-common\src\main\java\org\apache\dubbo\config\ConfigCenterConfig.java,294,140,1,16,0,157
dubbo-3.0\dubbo-3.0\dubbo-config\dubbo-config-api\src\test\java\org\apache\dubbo\config\integration\multiple\servicediscoveryregistry\MultipleRegistryCenterServiceDiscoveryRegistryServiceImpl.java,10,4,0,3,0,7
dubbo-3.0\dubbo-3.0\dubbo-cluster\src\main\java\org\apache\dubbo\rpc\cluster\ProviderURLMergeProcessor.java,0,6,0,3,0,9
dubbo-3.0\dubbo-3.0\dubbo-cluster\src\test\java\org\apache\dubbo\rpc\cluster\router\file\FileRouterEngineTest.java,153,65,6,19,0,90
dubbo-3.0\dubbo-3.0\dubbo-config\dubbo-config-spring\src\main\java\org\apache\dubbo\config\spring\context\annotation\EnableDubboConfig.java,0,11,0,4,0,15
dubbo-3.0\dubbo-3.0\dubbo-config\dubbo-config-api\src\test\java\org\apache\dubbo\config\bootstrap\builders\ArgumentBuilderTest.java,0,0,0,1,0,1
dubbo-3.0\dubbo-3.0\dubbo-remoting\dubbo-remoting-zookeeper\src\main\java\org\apache\dubbo\remoting\zookeeper\curator\CuratorZookeeperClient.java,0,159,18,54,0,231
dubbo-3.0\dubbo-3.0\dubbo-common\src\test\java\org\apache\dubbo\metadata\definition\service\annotation\MockMethodAnnotation2.java,0,1,0,1,0,2
dubbo-3.0\dubbo-3.0\dubbo-plugin\dubbo-qos\src\test\java\org\apache\dubbo\qos\textui\TLadderTest.java,18,4,0,1,0,5
dubbo-3.0\dubbo-3.0\dubbo-rpc\dubbo-rpc-api\src\test\java\org\apache\dubbo\rpc\FutureContextTest.java,28,8,0,5,0,13
dubbo-3.0\dubbo-3.0\dubbo-common\src\test\java\org\apache\dubbo\common\compiler\support\JdkCompilerTest.java,65,18,6,7,0,31
dubbo-3.0\dubbo-3.0\dubbo-common\src\test\java\org\apache\dubbo\common\utils\LRU2CacheTest.java,46,17,0,1,0,18
dubbo-3.0\dubbo-3.0\dubbo-test\dubbo-test-common\src\main\java\org\apache\dubbo\test\common\api\GreetingService.java,0,1,0,1,0,2
dubbo-3.0\dubbo-3.0\dubbo-rpc\dubbo-rpc-triple\src\test\java\org\apache\dubbo\rpc\protocol\tri\DescriptorService.java,0,43,0,14,0,57
dubbo-3.0\dubbo-3.0\dubbo-cluster\src\test\java\org\apache\dubbo\rpc\cluster\router\mesh\route\MeshRuleRouterTest.java,331,201,3,63,0,267
dubbo-3.0\dubbo-3.0\dubbo-common\src\test\java\org\apache\dubbo\common\extension\DubboExternalLoadingStrategy.java,18,4,0,1,0,5
dubbo-3.0\dubbo-3.0\dubbo-common\src\main\java\org\apache\dubbo\rpc\model\ModuleModel.java,142,46,1,10,0,57
dubbo-3.0\dubbo-3.0\dubbo-cluster\src\main\java\org\apache\dubbo\rpc\cluster\router\script\ScriptStateRouterFactory.java,11,6,0,2,0,8
dubbo-3.0\dubbo-3.0\dubbo-plugin\dubbo-auth\src\main\java\org\apache\dubbo\auth\spi\Authenticator.java,0,4,0,3,0,7
dubbo-3.0\dubbo-3.0\dubbo-common\src\main\java\org\apache\dubbo\rpc\service\GenericServiceDetector.java,9,1,0,1,0,2
dubbo-3.0\dubbo-3.0\dubbo-config\dubbo-config-spring\src\test\java\org\apache\dubbo\config\spring\context\KeepRunningOnSpringClosedTest.java,52,14,0,11,0,25
dubbo-3.0\dubbo-3.0\dubbo-remoting\dubbo-remoting-api\src\test\java\org\apache\dubbo\remoting\exchange\support\header\ReconnectTimerTaskTest.java,48,18,0,6,0,24
dubbo-3.0\dubbo-3.0\dubbo-common\src\main\java\org\apache\dubbo\common\constants\QosConstants.java,0,10,8,1,0,19
dubbo-3.0\dubbo-3.0\dubbo-config\dubbo-config-api\src\main\java\org\apache\dubbo\config\bootstrap\builders\ArgumentBuilder.java,40,17,0,1,0,18
dubbo-3.0\dubbo-3.0\dubbo-common\src\test\java\org\apache\dubbo\common\utils\LogTest.java,59,4,0,1,0,5
dubbo-3.0\dubbo-3.0\dubbo-common\src\test\java\org\apache\dubbo\common\extension\support\OldFilter0.java,0,0,0,1,0,1
dubbo-3.0\dubbo-3.0\dubbo-remoting\dubbo-remoting-netty\src\main\java\org\apache\dubbo\remoting\transport\netty\NettyHelper.java,0,18,1,2,0,21
dubbo-3.0\dubbo-3.0\dubbo-registry\dubbo-registry-api\src\main\java\org\apache\dubbo\registry\ListenerRegistryWrapper.java,144,31,4,5,0,40
dubbo-3.0\dubbo-3.0\dubbo-rpc\dubbo-rpc-api\src\test\java\org\apache\dubbo\rpc\proxy\RemoteServiceImpl.java,11,6,0,2,0,8
dubbo-3.0\dubbo-3.0\dubbo-config\dubbo-config-api\src\test\java\org\apache\dubbo\config\integration\single\injvm\SingleRegistryCenterInjvmServiceListener.java,11,3,0,4,0,7
dubbo-3.0\dubbo-3.0\dubbo-filter\dubbo-filter-cache\src\test\java\org\apache\dubbo\cache\support\lru\LruCacheFactoryTest.java,13,4,0,1,0,5
dubbo-3.0\dubbo-3.0\dubbo-rpc\dubbo-rpc-dubbo\src\test\java\org\apache\dubbo\rpc\protocol\dubbo\support\RemoteService.java,0,2,0,1,0,3
dubbo-3.0\dubbo-3.0\dubbo-config\dubbo-config-spring\src\test\java\org\apache\dubbo\config\spring\issues\issue6000\Issue6000Test.java,32,8,0,4,0,12
dubbo-3.0\dubbo-3.0\dubbo-common\src\test\java\org\apache\dubbo\rpc\model\ReflectionServiceDescriptorTest.java,0,6,0,6,0,12
dubbo-3.0\dubbo-3.0\dubbo-config\dubbo-config-api\src\test\java\org\apache\dubbo\config\MonitorConfigTest.java,85,13,0,2,0,15
dubbo-3.0\dubbo-3.0\dubbo-config\dubbo-config-api\src\main\java\org\apache\dubbo\config\utils\SimpleReferenceCache.java,217,70,4,25,0,99
dubbo-3.0\dubbo-3.0\dubbo-cluster\src\test\java\org\apache\dubbo\rpc\cluster\filter\DemoServiceImpl.java,13,6,0,1,0,7
dubbo-3.0\dubbo-3.0\dubbo-demo\dubbo-demo-triple\src\main\java\org\apache\dubbo\demo\provider\ApiWrapperProvider.java,16,5,1,3,0,9
dubbo-3.0\dubbo-3.0\dubbo-common\src\main\java\org\apache\dubbo\common\status\reporter\FrameworkStatusReportService.java,78,48,2,8,0,58
dubbo-3.0\dubbo-3.0\dubbo-common\src\test\java\org\apache\dubbo\common\extension\duplicated\impl\DuplicatedOverriddenExt2.java,8,1,0,1,0,2
dubbo-3.0\dubbo-3.0\dubbo-config\dubbo-config-spring\src\main\java\org\apache\dubbo\config\spring\schema\AnnotationBeanDefinitionParser.java,44,14,0,8,0,22
dubbo-3.0\dubbo-3.0\dubbo-metadata\dubbo-metadata-processor\src\main\java\org\apache\dubbo\metadata\annotation\processing\rest\AbstractAnnotatedMethodParameterProcessor.java,21,24,0,12,0,36
dubbo-3.0\dubbo-3.0\dubbo-config\dubbo-config-api\src\test\java\org\apache\dubbo\config\bootstrap\ConsulDubboServiceConsumerBootstrap.java,26,11,1,6,0,18
dubbo-3.0\dubbo-3.0\dubbo-test\dubbo-test-common\src\main\java\org\apache\dubbo\test\common\impl\RestDemoServiceImpl.java,35,13,0,1,0,14
dubbo-3.0\dubbo-3.0\dubbo-common\src\main\java\org\apache\dubbo\common\convert\Converter.java,0,7,0,2,0,9
dubbo-3.0\dubbo-3.0\dubbo-common\src\main\java\org\apache\dubbo\metadata\definition\builder\DefaultTypeBuilder.java,0,5,0,3,0,8
dubbo-3.0\dubbo-3.0\dubbo-config\dubbo-config-api\src\test\java\org\apache\dubbo\config\bootstrap\builders\ConfigCenterBuilderTest.java,0,11,0,8,0,19
dubbo-3.0\dubbo-3.0\dubbo-cluster\src\test\java\org\apache\dubbo\rpc\cluster\router\mesh\rule\virtualservice\match\ListStringMatchTest.java,27,1,0,1,0,2
dubbo-3.0\dubbo-3.0\dubbo-registry\dubbo-registry-api\src\test\java\org\apache\dubbo\registry\support\AbstractRegistryFactoryTest.java,108,27,6,10,0,43
dubbo-3.0\dubbo-3.0\dubbo-remoting\dubbo-remoting-netty4\src\main\java\org\apache\dubbo\remoting\transport\netty4\NettyCodecAdapter.java,0,26,0,6,0,32
dubbo-3.0\dubbo-3.0\dubbo-config\dubbo-config-spring\src\test\java\org\apache\dubbo\config\spring\beans\factory\annotation\ReferenceAnnotationBeanPostProcessorTest.java,282,104,1,60,0,165
dubbo-3.0\dubbo-3.0\dubbo-common\src\test\java\org\apache\dubbo\common\config\PropertiesConfigurationTest.java,21,9,0,8,0,17
dubbo-3.0\dubbo-3.0\dubbo-cluster\src\main\java\org\apache\dubbo\rpc\cluster\governance\GovernanceRuleRepository.java,0,11,0,8,0,19
dubbo-3.0\dubbo-3.0\dubbo-plugin\dubbo-qos\src\test\java\org\apache\dubbo\qos\legacy\service\generic\DemoService.java,0,5,0,1,0,6
dubbo-3.0\dubbo-3.0\dubbo-metadata\dubbo-metadata-api\src\test\java\org\apache\dubbo\metadata\report\identifier\KeyTypeEnumTest.java,12,2,0,1,0,3
dubbo-3.0\dubbo-3.0\dubbo-rpc\dubbo-rpc-dubbo\src\main\java\org\apache\dubbo\rpc\protocol\dubbo\DecodeableRpcInvocation.java,0,56,4,29,0,89
dubbo-3.0\dubbo-3.0\dubbo-config\dubbo-config-api\src\test\java\org\apache\dubbo\config\utils\service\FooService.java,0,1,0,1,0,2
dubbo-3.0\dubbo-3.0\dubbo-common\src\main\java\org\apache\dubbo\common\convert\multiple\MultiValueConverter.java,0,14,0,6,0,20
dubbo-3.0\dubbo-3.0\dubbo-plugin\dubbo-qos\src\test\java\org\apache\dubbo\qos\command\GreetingCommand.java,7,5,0,2,0,7
dubbo-3.0\dubbo-3.0\dubbo-config\dubbo-config-spring\src\test\java\org\apache\dubbo\config\spring\reference\localcallmix\LocalCallReferenceMixTest.java,41,14,2,7,0,23
dubbo-3.0\dubbo-3.0\dubbo-common\src\main\java\org\apache\dubbo\common\config\PrefixedConfiguration.java,26,9,0,1,0,10
dubbo-3.0\dubbo-3.0\dubbo-filter\dubbo-filter-cache\src\main\java\org\apache\dubbo\cache\support\threadlocal\ThreadLocalCache.java,38,10,1,6,0,17
dubbo-3.0\dubbo-3.0\dubbo-common\src\main\java\org\apache\dubbo\common\logger\log4j2\Log4j2LoggerAdapter.java,82,14,5,1,0,20
dubbo-3.0\dubbo-3.0\dubbo-plugin\dubbo-qos\src\main\java\org\apache\dubbo\qos\textui\TLadder.java,52,11,0,1,0,12
dubbo-3.0\dubbo-3.0\dubbo-common\src\main\java\org\apache\dubbo\common\extension\ExtensionLoader.java,1181,366,36,134,0,536
dubbo-3.0\dubbo-3.0\dubbo-compatible\src\test\java\org\apache\dubbo\filter\FilterTest.java,30,6,0,1,0,7
dubbo-3.0\dubbo-3.0\dubbo-registry\dubbo-registry-multicast\src\main\java\org\apache\dubbo\registry\multicast\MulticastRegistryFactory.java,9,3,0,1,0,4
dubbo-3.0\dubbo-3.0\dubbo-container\dubbo-container-api\src\main\java\org\apache\dubbo\container\Container.java,0,1,0,1,0,2
dubbo-3.0\dubbo-3.0\dubbo-common\src\main\java\org\apache\dubbo\common\url\component\param\DynamicValues.java,50,13,0,1,0,14
dubbo-3.0\dubbo-3.0\dubbo-common\src\main\java\org\apache\dubbo\common\utils\Page.java,0,8,0,1,0,9
dubbo-3.0\dubbo-3.0\dubbo-plugin\dubbo-qos\src\main\java\org\apache\dubbo\qos\command\CommandContextFactory.java,10,8,1,2,0,11
dubbo-3.0\dubbo-3.0\dubbo-config\dubbo-config-api\src\test\java\org\apache\dubbo\config\bootstrap\builders\AbstractMethodBuilderTest.java,0,17,0,8,0,25
dubbo-3.0\dubbo-3.0\dubbo-registry\dubbo-registry-api\src\test\java\org\apache\dubbo\registry\client\event\listener\ServiceInstancesChangedListenerTest.java,450,221,46,110,0,377
dubbo-3.0\dubbo-3.0\dubbo-rpc\dubbo-rpc-triple\src\main\java\org\apache\dubbo\rpc\protocol\tri\TripleConstant.java,21,12,0,1,0,13
dubbo-3.0\dubbo-3.0\dubbo-config\dubbo-config-spring\src\main\java\org\apache\dubbo\config\spring\util\DubboAnnotationUtils.java,145,41,2,26,0,69
dubbo-3.0\dubbo-3.0\dubbo-common\src\test\java\org\apache\dubbo\common\threadpool\support\limited\LimitedThreadPoolTest.java,40,13,0,8,0,21
dubbo-3.0\dubbo-3.0\dubbo-registry\dubbo-registry-api\src\main\java\org\apache\dubbo\registry\client\ServiceInstanceCustomizer.java,0,4,0,2,0,6
dubbo-3.0\dubbo-3.0\dubbo-cluster\src\test\java\org\apache\dubbo\rpc\cluster\support\wrapper\MockClusterInvokerTest.java,835,231,35,90,0,356
dubbo-3.0\dubbo-3.0\dubbo-remoting\dubbo-remoting-netty4\src\main\java\org\apache\dubbo\remoting\transport\netty4\logging\MessageFormatter.java,0,60,2,26,0,88
dubbo-3.0\dubbo-3.0\dubbo-cluster\src\test\java\org\apache\dubbo\rpc\cluster\configurator\absent\AbsentConfiguratorTest.java,90,24,0,18,0,42
dubbo-3.0\dubbo-3.0\dubbo-registry\dubbo-registry-api\src\main\java\org\apache\dubbo\registry\client\InstanceAddressURL.java,554,136,5,25,0,166
dubbo-3.0\dubbo-3.0\dubbo-cluster\src\main\java\org\apache\dubbo\rpc\cluster\filter\ClusterFilter.java,0,1,0,1,0,2
dubbo-3.0\dubbo-3.0\dubbo-rpc\dubbo-rpc-dubbo\src\main\java\org\apache\dubbo\rpc\protocol\dubbo\DubboProtocol.java,680,173,13,103,0,289
dubbo-3.0\dubbo-3.0\dubbo-common\src\main\java\org\apache\dubbo\common\utils\ClassUtils.java,532,95,9,29,0,133
dubbo-3.0\dubbo-3.0\dubbo-config\dubbo-config-api\src\test\java\org\apache\dubbo\config\integration\multiple\injvm\MultipleRegistryCenterInjvmServiceListener.java,11,3,0,4,0,7
dubbo-3.0\dubbo-3.0\dubbo-config\dubbo-config-api\src\test\java\org\apache\dubbo\config\mock\GreetingLocal3.java,13,5,2,1,0,8
dubbo-3.0\dubbo-3.0\dubbo-rpc\dubbo-rpc-triple\src\main\java\org\apache\dubbo\rpc\protocol\tri\call\ServerCall.java,0,3,0,3,0,6
dubbo-3.0\dubbo-3.0\dubbo-config\dubbo-config-spring\src\test\java\org\apache\dubbo\config\spring\beans\factory\annotation\MethodConfigCallbackTest.java,80,17,0,9,0,26
dubbo-3.0\dubbo-3.0\dubbo-remoting\dubbo-remoting-api\src\main\java\org\apache\dubbo\remoting\exchange\support\ExchangeServerDelegate.java,102,36,1,1,0,38
dubbo-3.0\dubbo-3.0\dubbo-rpc\dubbo-rpc-api\src\test\java\org\apache\dubbo\rpc\proxy\RemoteService.java,0,2,0,1,0,3
dubbo-3.0\dubbo-3.0\dubbo-rpc\dubbo-rpc-grpc\src\main\java\org\apache\dubbo\rpc\protocol\grpc\interceptors\ServerTransportFilter.java,0,2,0,2,0,4
dubbo-3.0\dubbo-3.0\dubbo-cluster\src\main\java\org\apache\dubbo\rpc\cluster\configurator\parser\model\ConfigItem.java,131,79,0,9,0,88
dubbo-3.0\dubbo-3.0\dubbo-common\src\main\java\org\apache\dubbo\common\BaseServiceMetadata.java,132,66,1,5,0,72
dubbo-3.0\dubbo-3.0\dubbo-registry\dubbo-registry-api\src\main\java\org\apache\dubbo\registry\client\NopServiceDiscovery.java,35,14,5,4,0,23
dubbo-3.0\dubbo-3.0\dubbo-cluster\src\test\java\org\apache\dubbo\rpc\cluster\router\mesh\util\MeshRuleDispatcherTest.java,0,48,20,26,0,94
dubbo-3.0\dubbo-3.0\dubbo-common\src\test\java\org\apache\dubbo\common\utils\LogHelperTest.java,68,5,0,1,0,6
dubbo-3.0\dubbo-3.0\dubbo-common\src\main\java\org\apache\dubbo\common\deploy\DeployState.java,0,8,0,1,0,9
dubbo-3.0\dubbo-3.0\dubbo-common\src\main\java\org\apache\dubbo\common\utils\LogUtil.java,106,25,9,3,0,37
dubbo-3.0\dubbo-3.0\dubbo-config\dubbo-config-api\src\test\java\org\apache\dubbo\config\ServiceConfigTest.java,471,74,23,26,0,123
dubbo-3.0\dubbo-3.0\dubbo-common\src\main\java\org\apache\dubbo\common\utils\FieldUtils.java,0,15,4,5,0,24
dubbo-3.0\dubbo-3.0\dubbo-rpc\dubbo-rpc-triple\src\main\java\org\apache\dubbo\rpc\protocol\tri\ClientStreamObserver.java,0,3,1,3,0,7
dubbo-3.0\dubbo-3.0\dubbo-monitor\dubbo-monitor-api\src\test\java\org\apache\dubbo\monitor\support\MonitorFilterTest.java,172,47,4,27,0,78
dubbo-3.0\dubbo-3.0\dubbo-spring-boot\dubbo-spring-boot-compatible\actuator\src\main\java\org\apache\dubbo\spring\boot\actuate\endpoint\metadata\DubboServicesMetadata.java,53,11,0,6,0,17
dubbo-3.0\dubbo-3.0\dubbo-plugin\dubbo-qos\src\main\java\org\apache\dubbo\qos\command\impl\Startup.java,38,13,0,5,0,18
dubbo-3.0\dubbo-3.0\dubbo-metadata\dubbo-metadata-report-nacos\src\main\java\org\apache\dubbo\metadata\store\nacos\NacosMetadataReport.java,403,189,13,58,0,260
dubbo-3.0\dubbo-3.0\dubbo-spring-boot\dubbo-spring-boot-compatible\autoconfigure\src\test\java\org\apache\dubbo\spring\boot\autoconfigure\RelaxedDubboConfigBinderTest.java,40,10,1,4,0,15
dubbo-3.0\dubbo-3.0\dubbo-remoting\dubbo-remoting-api\src\test\java\org\apache\dubbo\remoting\exchange\RequestTest.java,30,1,0,1,0,2
dubbo-3.0\dubbo-3.0\dubbo-compatible\src\main\java\com\alibaba\dubbo\registry\support\AbstractRegistry.java,117,77,1,23,0,101
dubbo-3.0\dubbo-3.0\dubbo-common\src\test\java\org\apache\dubbo\common\utils\CollectionUtilsTest.java,188,40,14,16,0,70
dubbo-3.0\dubbo-3.0\dubbo-rpc\dubbo-rpc-injvm\src\test\java\demo\MultiClassLoaderServiceResult.java,3,0,0,1,0,1
dubbo-3.0\dubbo-3.0\dubbo-config\dubbo-config-spring\src\main\java\org\apache\dubbo\config\spring\context\event\DubboApplicationStateEvent.java,30,22,0,3,0,25
dubbo-3.0\dubbo-3.0\dubbo-config\dubbo-config-spring\src\test\java\org\apache\dubbo\config\spring\reference\localcall\LocalHelloServiceImpl.java,10,3,0,2,0,5
dubbo-3.0\dubbo-3.0\dubbo-config\dubbo-config-api\src\test\java\org\apache\dubbo\config\mock\MockCluster.java,7,4,0,2,0,6
dubbo-3.0\dubbo-3.0\dubbo-cluster\src\main\java\org\apache\dubbo\rpc\cluster\merger\ListMerger.java,0,2,0,1,0,3
dubbo-3.0\dubbo-3.0\dubbo-config\dubbo-config-api\src\test\java\org\apache\dubbo\config\bootstrap\builders\MetadataReportBuilderTest.java,0,9,0,6,0,15
dubbo-3.0\dubbo-3.0\dubbo-config\dubbo-config-spring\src\test\java\org\apache\dubbo\config\spring\annotation\consumer\AnnotationAction.java,11,8,0,2,0,10
dubbo-3.0\dubbo-3.0\dubbo-common\src\main\java\org\apache\dubbo\common\Node.java,0,0,0,1,0,1
dubbo-3.0\dubbo-3.0\dubbo-common\src\main\java\org\apache\dubbo\rpc\service\Destroyable.java,0,3,2,1,0,6
dubbo-3.0\dubbo-3.0\dubbo-config\dubbo-config-spring\src\main\java\org\apache\dubbo\config\spring\beans\factory\annotation\DubboConfigAliasPostProcessor.java,0,24,0,12,0,36
dubbo-3.0\dubbo-3.0\dubbo-common\src\test\java\org\apache\dubbo\rpc\model\SerializablePerson.java,77,42,8,2,0,52
dubbo-3.0\dubbo-3.0\dubbo-config\dubbo-config-spring\src\test\java\org\apache\dubbo\config\spring\boot\configprops\SpringBootMultipleConfigPropsTest.java,78,35,1,29,0,65
dubbo-3.0\dubbo-3.0\dubbo-config\dubbo-config-spring\src\test\java\org\apache\dubbo\config\spring\reference\localcall\LocalCallTest2.java,28,7,2,4,0,13
dubbo-3.0\dubbo-3.0\dubbo-remoting\dubbo-remoting-api\src\test\java\org\apache\dubbo\remoting\telnet\support\ExitTelnetHandlerTest.java,12,1,0,1,0,2
dubbo-3.0\dubbo-3.0\dubbo-remoting\dubbo-remoting-netty4\src\test\java\org\apache\dubbo\remoting\transport\netty4\WorldHandler.java,12,8,0,2,0,10
dubbo-3.0\dubbo-3.0\dubbo-rpc\dubbo-rpc-injvm\src\test\java\org\apache\dubbo\rpc\protocol\injvm\Type.java,0,3,0,1,0,4
dubbo-3.0\dubbo-3.0\dubbo-config\dubbo-config-spring\src\main\java\org\apache\dubbo\config\spring\beans\factory\config\ConfigurableSourceBeanMetadataElement.java,0,5,0,3,0,8
dubbo-3.0\dubbo-3.0\dubbo-cluster\src\main\java\org\apache\dubbo\rpc\cluster\router\mesh\rule\virtualservice\match\ListBoolMatch.java,0,10,0,1,0,11
dubbo-3.0\dubbo-3.0\dubbo-common\src\main\java\org\apache\dubbo\common\utils\CIDRUtils.java,105,23,3,2,0,28
dubbo-3.0\dubbo-3.0\dubbo-common\src\test\java\org\apache\dubbo\common\extension\ext10_multi_names\Ext10MultiNames.java,0,1,0,1,0,2
dubbo-3.0\dubbo-3.0\dubbo-rpc\dubbo-rpc-grpc\src\main\java\org\apache\dubbo\rpc\protocol\grpc\GrpcOptionsUtils.java,192,46,7,43,0,96
dubbo-3.0\dubbo-3.0\dubbo-config\dubbo-config-spring\src\test\java\org\apache\dubbo\config\spring\status\SpringStatusCheckerTest.java,64,13,0,8,0,21
dubbo-3.0\dubbo-3.0\dubbo-common\src\main\java\org\apache\dubbo\common\extension\ExtensionAccessorAware.java,0,2,0,2,0,4
dubbo-3.0\dubbo-3.0\dubbo-common\src\main\java\org\apache\dubbo\common\status\reporter\FrameworkStatusReporter.java,0,2,0,1,0,3
dubbo-3.0\dubbo-3.0\dubbo-rpc\dubbo-rpc-triple\src\test\java\org\apache\dubbo\rpc\protocol\tri\TripleProtocolTest.java,77,26,1,21,0,48
dubbo-3.0\dubbo-3.0\dubbo-common\src\test\java\org\apache\dubbo\common\extension\director\impl\BaseTestService.java,0,23,1,1,0,25
dubbo-3.0\dubbo-3.0\dubbo-registry\dubbo-registry-api\src\test\java\org\apache\dubbo\registry\client\fastjson\DefaultServiceInstanceDeserializerTest.java,0,4,0,4,0,8
dubbo-3.0\dubbo-3.0\dubbo-spring-boot\dubbo-spring-boot-compatible\actuator\src\test\java\org\apache\dubbo\spring\boot\actuate\health\DubboHealthIndicatorTest.java,30,12,0,8,0,20
dubbo-3.0\dubbo-3.0\dubbo-common\src\test\java\org\apache\dubbo\common\extension\support\Filter2.java,3,1,0,1,0,2
dubbo-3.0\dubbo-3.0\dubbo-remoting\dubbo-remoting-netty\src\test\java\org\apache\dubbo\remoting\transport\netty\World.java,23,12,1,1,0,14
dubbo-3.0\dubbo-3.0\dubbo-cluster\src\main\java\org\apache\dubbo\rpc\cluster\router\mesh\rule\destination\loadbalance\LoadBalancerSettings.java,29,18,0,1,0,19
dubbo-3.0\dubbo-3.0\dubbo-rpc\dubbo-rpc-api\src\main\java\org\apache\dubbo\rpc\stub\StubInvoker.java,17,13,0,2,0,15
dubbo-3.0\dubbo-3.0\dubbo-common\src\main\java\org\apache\dubbo\config\AbstractConfig.java,945,244,33,118,0,395
dubbo-3.0\dubbo-3.0\dubbo-common\src\test\java\org\apache\dubbo\common\extension\ext8_add\impl\AddExt1_ManualAdaptive.java,7,6,1,2,0,9
dubbo-3.0\dubbo-3.0\dubbo-test\dubbo-test-common\src\main\java\org\apache\dubbo\test\common\impl\DemoServiceImpl.java,20,5,1,1,0,7
dubbo-3.0\dubbo-3.0\dubbo-cluster\src\main\java\org\apache\dubbo\rpc\cluster\configurator\override\OverrideConfigurator.java,13,7,0,1,0,8
dubbo-3.0\dubbo-3.0\dubbo-common\src\main\java\org\apache\dubbo\common\config\EnvironmentConfiguration.java,16,5,0,1,0,6
dubbo-3.0\dubbo-3.0\dubbo-monitor\dubbo-monitor-default\src\test\java\org\apache\dubbo\monitor\dubbo\MetricsFilterTest.java,289,128,13,57,0,198
dubbo-3.0\dubbo-3.0\dubbo-common\src\test\java\org\apache\dubbo\common\extension\director\FooModuleService.java,0,1,0,1,0,2
dubbo-3.0\dubbo-3.0\dubbo-config\dubbo-config-spring\src\main\java\org\apache\dubbo\config\spring\util\DubboBeanUtils.java,0,53,2,46,0,101
dubbo-3.0\dubbo-3.0\dubbo-registry\dubbo-registry-api\src\main\java\org\apache\dubbo\registry\client\migration\DefaultMigrationAddressComparator.java,85,29,6,12,0,47
dubbo-3.0\dubbo-3.0\dubbo-compatible\src\test\java\org\apache\dubbo\cache\MyCache.java,18,8,2,1,0,11
dubbo-3.0\dubbo-3.0\dubbo-common\src\test\java\org\apache\dubbo\rpc\model\person\BigPerson.java,132,75,16,6,0,97
dubbo-3.0\dubbo-3.0\dubbo-config\dubbo-config-api\src\main\java\org\apache\dubbo\config\utils\ConfigValidationUtils.java,597,212,10,105,0,327
dubbo-3.0\dubbo-3.0\dubbo-compatible\src\main\java\com\alibaba\dubbo\registry\Registry.java,0,10,2,6,0,18
dubbo-3.0\dubbo-3.0\dubbo-config\dubbo-config-api\src\test\java\org\apache\dubbo\config\utils\XxxMockReferenceConfig.java,38,17,1,1,0,19
dubbo-3.0\dubbo-3.0\dubbo-cluster\src\main\java\org\apache\dubbo\rpc\cluster\Configurator.java,0,8,0,10,0,18
dubbo-3.0\dubbo-3.0\dubbo-cluster\src\main\java\org\apache\dubbo\rpc\cluster\router\mesh\rule\destination\loadbalance\SimpleLB.java,0,4,0,1,0,5
dubbo-3.0\dubbo-3.0\dubbo-registry\dubbo-registry-nacos\src\test\java\org\apache\dubbo\registry\nacos\NacosServiceDiscoveryTest.java,125,44,2,26,0,72
dubbo-3.0\dubbo-3.0\dubbo-cluster\src\test\java\org\apache\dubbo\rpc\cluster\loadbalance\LeastActiveBalanceTest.java,43,11,4,7,0,22
dubbo-3.0\dubbo-3.0\dubbo-config\dubbo-config-spring\src\test\java\org\apache\dubbo\config\spring\filter\MockDaoImpl.java,4,1,0,1,0,2
dubbo-3.0\dubbo-3.0\dubbo-common\src\main\java\org\apache\dubbo\common\convert\multiple\StringToNavigableSetConverter.java,11,8,0,2,0,10
dubbo-3.0\dubbo-3.0\dubbo-rpc\dubbo-rpc-api\src\main\java\org\apache\dubbo\rpc\InvokerListener.java,0,2,0,2,0,4
dubbo-3.0\dubbo-3.0\dubbo-compatible\src\main\java\com\alibaba\dubbo\registry\support\FailbackRegistry.java,0,98,5,25,0,128
dubbo-3.0\dubbo-3.0\dubbo-rpc\dubbo-rpc-api\src\main\java\org\apache\dubbo\rpc\stub\ServerStreamMethodHandler.java,0,7,0,2,0,9
dubbo-3.0\dubbo-3.0\dubbo-registry\dubbo-registry-api\src\main\java\org\apache\dubbo\registry\client\metadata\MetadataServiceNameMapping.java,116,41,1,22,0,64
dubbo-3.0\dubbo-3.0\dubbo-filter\dubbo-filter-validation\src\main\java\org\apache\dubbo\validation\support\jvalidation\JValidator.java,262,71,7,41,0,119
dubbo-3.0\dubbo-3.0\dubbo-cluster\src\main\java\org\apache\dubbo\rpc\cluster\support\ForkingCluster.java,11,6,0,2,0,8
dubbo-3.0\dubbo-3.0\dubbo-rpc\dubbo-rpc-rest\src\test\java\org\apache\dubbo\rpc\protocol\rest\RpcExceptionMapperTest.java,33,9,0,5,0,14
dubbo-3.0\dubbo-3.0\dubbo-common\src\test\java\org\apache\dubbo\common\extension\ext6_wrap\impl\Ext6Impl4.java,8,3,0,1,0,4
dubbo-3.0\dubbo-3.0\dubbo-common\src\test\java\org\apache\dubbo\rpc\support\DemoServiceImpl.java,7,2,0,1,0,3
dubbo-3.0\dubbo-3.0\dubbo-config\dubbo-config-api\src\main\java\org\apache\dubbo\config\deploy\DefaultModuleDeployer.java,424,65,23,31,0,119
dubbo-3.0\dubbo-3.0\dubbo-rpc\dubbo-rpc-grpc\src\test\java\org\apache\dubbo\rpc\protocol\grpc\GrpcProtocolTest.java,80,20,0,14,0,34
dubbo-3.0\dubbo-3.0\dubbo-test\dubbo-test-check\src\main\java\org\apache\dubbo\test\check\exception\DubboTestException.java,23,10,0,7,0,17
dubbo-3.0\dubbo-3.0\dubbo-remoting\dubbo-remoting-http\src\main\java\org\apache\dubbo\remoting\http\HttpServer.java,0,1,0,1,0,2
dubbo-3.0\dubbo-3.0\dubbo-rpc\dubbo-rpc-triple\src\main\java\org\apache\dubbo\rpc\protocol\tri\compressor\MessageEncoding.java,0,1,0,1,0,2
dubbo-3.0\dubbo-3.0\dubbo-config\dubbo-config-api\src\test\java\org\apache\dubbo\config\integration\single\injvm\SingleRegistryCenterInjvmService.java,0,3,0,2,0,5
dubbo-3.0\dubbo-3.0\dubbo-config\dubbo-config-api\src\test\java\org\apache\dubbo\config\integration\multiple\injvm\MultipleRegistryCenterInjvmFilter.java,0,24,0,6,0,30
dubbo-3.0\dubbo-3.0\dubbo-registry\dubbo-registry-api\src\test\java\org\apache\dubbo\registry\MockCacheableRegistryImpl.java,89,37,2,1,0,40
dubbo-3.0\dubbo-3.0\dubbo-cluster\src\main\java\org\apache\dubbo\rpc\cluster\merger\LongArrayMerger.java,13,2,0,1,0,3
dubbo-3.0\dubbo-3.0\dubbo-common\src\test\java\org\apache\dubbo\common\utils\LFUCacheTest.java,58,39,0,5,0,44
dubbo-3.0\dubbo-3.0\dubbo-config\dubbo-config-api\src\test\java\org\apache\dubbo\config\bootstrap\builders\ModuleBuilderTest.java,0,5,0,6,0,11
dubbo-3.0\dubbo-3.0\dubbo-config\dubbo-config-api\src\test\java\org\apache\dubbo\config\integration\multiple\servicediscoveryregistry\ServiceDiscoveryRegistryStorage.java,4,2,0,3,0,5
dubbo-3.0\dubbo-3.0\dubbo-compatible\src\test\java\org\apache\dubbo\config\ApplicationConfigTest.java,146,21,0,3,0,24
dubbo-3.0\dubbo-3.0\dubbo-remoting\dubbo-remoting-api\src\main\java\org\apache\dubbo\remoting\exchange\support\header\HeartbeatTimerTask.java,36,15,4,6,0,25
dubbo-3.0\dubbo-3.0\dubbo-cluster\src\main\java\org\apache\dubbo\rpc\cluster\merger\ShortArrayMerger.java,25,2,0,1,0,3
dubbo-3.0\dubbo-3.0\dubbo-cluster\src\test\java\org\apache\dubbo\rpc\cluster\merger\LongSumMerger.java,9,2,0,1,0,3
dubbo-3.0\dubbo-3.0\dubbo-common\src\test\java\org\apache\dubbo\common\extension\ext5\impl\Ext5Impl2.java,6,4,0,1,0,5
dubbo-3.0\dubbo-3.0\dubbo-cluster\src\main\java\org\apache\dubbo\rpc\cluster\merger\IntArrayMerger.java,14,2,0,1,0,3
dubbo-3.0\dubbo-3.0\dubbo-config\dubbo-config-spring\src\test\java\org\apache\dubbo\config\spring\beans\factory\annotation\ParameterConvertTest.java,36,11,0,9,0,20
dubbo-3.0\dubbo-3.0\dubbo-serialization\dubbo-serialization-api\src\main\java\org\apache\dubbo\common\serialize\support\SerializationOptimizer.java,0,2,0,2,0,4
dubbo-3.0\dubbo-3.0\dubbo-plugin\dubbo-qos\src\test\java\org\apache\dubbo\qos\command\util\CommandHelperTest.java,57,8,0,4,0,12
dubbo-3.0\dubbo-3.0\dubbo-config\dubbo-config-spring\src\test\java\org\apache\dubbo\config\spring\action\DemoInterceptor.java,8,4,0,1,0,5
dubbo-3.0\dubbo-3.0\dubbo-remoting\dubbo-remoting-netty4\src\test\java\org\apache\dubbo\remoting\transport\netty4\NettyChannelTest.java,88,28,3,13,0,44
dubbo-3.0\dubbo-3.0\dubbo-rpc\dubbo-rpc-api\src\main\java\org\apache\dubbo\rpc\BaseFilter.java,0,25,0,11,0,36
dubbo-3.0\dubbo-3.0\dubbo-cluster\src\main\java\org\apache\dubbo\rpc\cluster\support\FailfastClusterInvoker.java,27,14,3,8,0,25
dubbo-3.0\dubbo-3.0\dubbo-common\src\test\java\org\apache\dubbo\common\convert\multiple\StringToNavigableSetConverterTest.java,67,13,5,5,0,23
dubbo-3.0\dubbo-3.0\dubbo-compatible\src\main\java\com\alibaba\dubbo\remoting\RemotingException.java,0,30,0,5,0,35
dubbo-3.0\dubbo-3.0\dubbo-spring-boot\dubbo-spring-boot-compatible\actuator\src\main\java\org\apache\dubbo\spring\boot\actuate\endpoint\metadata\DubboPropertiesMetadata.java,7,3,0,2,0,5
dubbo-3.0\dubbo-3.0\dubbo-plugin\dubbo-auth\src\main\java\org\apache\dubbo\auth\DefaultAccessKeyStorage.java,12,5,0,2,0,7
dubbo-3.0\dubbo-3.0\dubbo-plugin\dubbo-qos\src\main\java\org\apache\dubbo\qos\textui\TKv.java,54,11,0,2,0,13
dubbo-3.0\dubbo-3.0\dubbo-metadata\dubbo-metadata-api\src\test\java\org\apache\dubbo\metadata\rest\jaxrs\JAXRSServiceRestMetadataResolverTest.java,42,11,0,7,0,18
dubbo-3.0\dubbo-3.0\dubbo-rpc\dubbo-rpc-triple\src\main\java\org\apache\dubbo\rpc\protocol\tri\transport\TripleClientHandler.java,18,9,2,3,0,14
dubbo-3.0\dubbo-3.0\dubbo-common\src\main\java\org\apache\dubbo\common\convert\StringToByteConverter.java,12,5,0,1,0,6
dubbo-3.0\dubbo-3.0\dubbo-test\dubbo-test-check\src\main\java\org\apache\dubbo\test\check\registrycenter\processor\FindPidWindowsProcessor.java,81,24,6,16,0,46
dubbo-3.0\dubbo-3.0\dubbo-rpc\dubbo-rpc-api\src\main\java\org\apache\dubbo\rpc\ExporterListener.java,0,0,0,1,0,1
dubbo-3.0\dubbo-3.0\dubbo-spring-boot\dubbo-spring-boot-compatible\autoconfigure\src\main\java\org\apache\dubbo\spring\boot\beans\factory\config\ServiceBeanIdConflictProcessor.java,0,31,0,17,0,48
dubbo-3.0\dubbo-3.0\dubbo-metadata\dubbo-metadata-report-redis\src\main\java\org\apache\dubbo\metadata\store\redis\RedisMetadataReport.java,151,84,12,39,0,135
dubbo-3.0\dubbo-3.0\dubbo-remoting\dubbo-remoting-api\src\main\java\org\apache\dubbo\remoting\Codec.java,0,1,0,2,0,3
dubbo-3.0\dubbo-3.0\dubbo-common\src\test\java\org\apache\dubbo\common\utils\ClassLoaderResourceLoaderTest.java,27,9,0,8,0,17
dubbo-3.0\dubbo-3.0\dubbo-compatible\src\test\java\org\apache\dubbo\config\MethodConfigTest.java,159,34,0,13,0,47
dubbo-3.0\dubbo-3.0\dubbo-test\dubbo-test-spring\src\main\java\org\apache\dubbo\test\spring\SpringAnnotationBeanTest.java,45,7,0,3,0,10
dubbo-3.0\dubbo-3.0\dubbo-common\src\test\java\org\apache\dubbo\common\extension\compatible\impl\CompatibleExtImpl2.java,15,12,0,1,0,13
dubbo-3.0\dubbo-3.0\dubbo-common\src\test\java\org\apache\dubbo\common\config\SystemConfigurationTest.java,0,24,0,14,0,38
dubbo-3.0\dubbo-3.0\dubbo-test\dubbo-test-check\src\main\java\org\apache\dubbo\test\check\registrycenter\processor\StartZookeeperUnixProcessor.java,36,14,1,9,0,24
dubbo-3.0\dubbo-3.0\dubbo-rpc\dubbo-rpc-api\src\test\java\org\apache\dubbo\rpc\stub\ServerStreamMethodHandlerTest.java,0,6,0,5,0,11
dubbo-3.0\dubbo-3.0\dubbo-monitor\dubbo-monitor-default\src\main\java\org\apache\dubbo\monitor\dubbo\StatisticsItem.java,115,112,2,5,0,119
dubbo-3.0\dubbo-3.0\dubbo-spring-boot\dubbo-spring-boot-actuator\src\main\java\org\apache\dubbo\spring\boot\actuate\endpoint\DubboReferencesMetadataEndpoint.java,11,5,0,3,0,8
dubbo-3.0\dubbo-3.0\dubbo-rpc\dubbo-rpc-api\src\main\java\org\apache\dubbo\rpc\proxy\AbstractProxyFactory.java,87,21,5,10,0,36
dubbo-3.0\dubbo-3.0\dubbo-config\dubbo-config-api\src\test\java\org\apache\dubbo\config\integration\single\exportmetadata\SingleRegistryCenterExportMetadataService.java,0,3,0,2,0,5
dubbo-3.0\dubbo-3.0\dubbo-rpc\dubbo-rpc-triple\src\main\java\org\apache\dubbo\rpc\protocol\tri\call\TripleClientCall.java,0,63,7,19,0,89
dubbo-3.0\dubbo-3.0\dubbo-cluster\src\test\java\org\apache\dubbo\rpc\cluster\support\BroadCastClusterInvokerTest.java,0,25,2,7,0,34
dubbo-3.0\dubbo-3.0\dubbo-remoting\dubbo-remoting-api\src\main\java\org\apache\dubbo\remoting\transport\dispatcher\all\AllChannelHandler.java,51,27,5,13,0,45
dubbo-3.0\dubbo-3.0\dubbo-registry\dubbo-registry-api\src\main\java\org\apache\dubbo\registry\client\metadata\ServiceInstanceHostPortCustomizer.java,57,18,1,11,0,30
dubbo-3.0\dubbo-3.0\dubbo-common\src\main\java\org\apache\dubbo\common\context\ApplicationExt.java,0,1,0,1,0,2
dubbo-3.0\dubbo-3.0\dubbo-remoting\dubbo-remoting-api\src\main\java\org\apache\dubbo\remoting\buffer\ChannelBufferInputStream.java,88,26,0,1,0,27
dubbo-3.0\dubbo-3.0\dubbo-common\src\main\java\org\apache\dubbo\common\utils\LRU2Cache.java,0,44,2,4,0,50
dubbo-3.0\dubbo-3.0\dubbo-common\src\test\java\org\apache\dubbo\common\utils\NamedThreadFactoryTest.java,20,4,1,3,0,8
dubbo-3.0\dubbo-3.0\dubbo-remoting\dubbo-remoting-api\src\test\java\org\apache\dubbo\remoting\buffer\ChannelBufferStreamTest.java,79,13,5,1,0,19
dubbo-3.0\dubbo-3.0\dubbo-config\dubbo-config-spring\src\main\java\org\apache\dubbo\config\spring\context\config\DubboConfigBeanCustomizer.java,0,11,0,8,0,19
dubbo-3.0\dubbo-3.0\dubbo-rpc\dubbo-rpc-triple\src\main\java\org\apache\dubbo\rpc\protocol\tri\call\ReflectionAbstractServerCall.java,153,32,2,12,0,46
dubbo-3.0\dubbo-3.0\dubbo-common\src\test\java\org\apache\dubbo\common\convert\StringToCharArrayConverterTest.java,21,7,0,3,0,10
dubbo-3.0\dubbo-3.0\dubbo-rpc\dubbo-rpc-api\src\main\java\org\apache\dubbo\rpc\AppResponse.java,205,85,2,14,0,101
dubbo-3.0\dubbo-3.0\dubbo-metadata\dubbo-metadata-processor\src\test\java\org\apache\dubbo\metadata\annotation\processing\AbstractAnnotationProcessingTest.java,29,17,0,3,0,20
dubbo-3.0\dubbo-3.0\dubbo-common\src\main\java\org\apache\dubbo\rpc\model\ScopeModelDestroyListener.java,0,2,0,1,0,3
dubbo-3.0\dubbo-3.0\dubbo-cluster\src\main\java\org\apache\dubbo\rpc\cluster\governance\DefaultGovernanceRuleRepositoryImpl.java,0,22,0,6,0,28
dubbo-3.0\dubbo-3.0\dubbo-remoting\dubbo-remoting-netty4\src\test\java\org\apache\dubbo\remoting\transport\netty4\ReplierDispatcherTest.java,112,40,5,9,0,54
dubbo-3.0\dubbo-3.0\dubbo-config\dubbo-config-spring\src\test\java\org\apache\dubbo\config\spring\extension\SpringExtensionInjectorTest.java,54,17,1,7,0,25
dubbo-3.0\dubbo-3.0\dubbo-remoting\dubbo-remoting-api\src\test\java\org\apache\dubbo\remoting\exchange\support\header\CloseTimerTaskTest.java,40,17,0,5,0,22
dubbo-3.0\dubbo-3.0\dubbo-cluster\src\main\java\org\apache\dubbo\rpc\cluster\router\mesh\route\MeshRuleRouter.java,301,122,6,57,0,185
dubbo-3.0\dubbo-3.0\dubbo-compatible\src\test\java\org\apache\dubbo\config\ArgumentConfigTest.java,35,4,0,1,0,5
dubbo-3.0\dubbo-3.0\dubbo-monitor\dubbo-monitor-api\src\main\java\org\apache\dubbo\monitor\MetricsService.java,0,1,0,1,0,2
dubbo-3.0\dubbo-3.0\dubbo-common\src\main\java\org\apache\dubbo\common\threadpool\serial\SerializingExecutor.java,0,23,1,15,0,39
dubbo-3.0\dubbo-3.0\dubbo-common\src\main\java\org\apache\dubbo\common\config\configcenter\ConfigChangeType.java,0,1,0,1,0,2
dubbo-3.0\dubbo-3.0\dubbo-common\src\test\java\org\apache\dubbo\common\compiler\support\HelloServiceImpl0.java,7,1,0,1,0,2
dubbo-3.0\dubbo-3.0\dubbo-common\src\test\java\org\apache\dubbo\common\extension\activate\ActivateWrapperExt1.java,0,1,0,1,0,2
dubbo-3.0\dubbo-3.0\dubbo-filter\dubbo-filter-cache\src\main\java\org\apache\dubbo\cache\support\expiring\ExpiringCacheFactory.java,13,3,0,3,0,6
dubbo-3.0\dubbo-3.0\dubbo-common\src\main\java\org\apache\dubbo\config\ServiceConfigBase.java,435,132,8,30,0,170
dubbo-3.0\dubbo-3.0\dubbo-common\src\test\java\org\apache\dubbo\common\profiler\ProfilerTest.java,77,11,0,9,0,20
dubbo-3.0\dubbo-3.0\dubbo-compatible\src\main\java\com\alibaba\dubbo\rpc\InvokerListener.java,0,5,2,4,0,11
dubbo-3.0\dubbo-3.0\dubbo-rpc\dubbo-rpc-api\src\main\java\org\apache\dubbo\rpc\FutureContext.java,96,26,0,13,0,39
dubbo-3.0\dubbo-3.0\dubbo-common\src\test\java\org\apache\dubbo\common\status\support\LoadStatusCheckerTest.java,13,4,2,2,0,8
dubbo-3.0\dubbo-3.0\dubbo-remoting\dubbo-remoting-api\src\main\java\org\apache\dubbo\remoting\buffer\ChannelBufferOutputStream.java,41,17,0,1,0,18
dubbo-3.0\dubbo-3.0\dubbo-config\dubbo-config-api\src\main\java\org\apache\dubbo\config\bootstrap\builders\AbstractInterfaceBuilder.java,0,148,0,7,0,155
dubbo-3.0\dubbo-3.0\dubbo-config\dubbo-config-api\src\test\java\org\apache\dubbo\config\bootstrap\rest\User.java,45,27,1,1,0,29
dubbo-3.0\dubbo-3.0\dubbo-filter\dubbo-filter-cache\src\main\java\org\apache\dubbo\cache\support\jcache\JCache.java,0,17,0,7,0,24
dubbo-3.0\dubbo-3.0\dubbo-metadata\dubbo-metadata-processor\src\test\java\org\apache\dubbo\metadata\tools\DefaultTestService.java,30,16,1,2,0,19
dubbo-3.0\dubbo-3.0\dubbo-config\dubbo-config-api\src\test\java\org\apache\dubbo\config\integration\multiple\servicediscoveryregistry\MultipleRegistryCenterServiceDiscoveryRegistryIntegrationTest.java,167,46,4,32,0,82
dubbo-3.0\dubbo-3.0\dubbo-rpc\dubbo-rpc-api\src\test\java\org\apache\dubbo\rpc\PenetrateAttachmentSelectorTest.java,17,5,0,4,0,9
dubbo-3.0\dubbo-3.0\dubbo-config\dubbo-config-api\src\test\java\org\apache\dubbo\config\integration\AbstractRegistryCenterServiceListener.java,36,7,0,3,0,10
dubbo-3.0\dubbo-3.0\dubbo-rpc\dubbo-rpc-api\src\main\java\org\apache\dubbo\rpc\RpcServiceContext.java,603,104,6,19,0,129
dubbo-3.0\dubbo-3.0\dubbo-config\dubbo-config-spring\src\test\java\org\apache\dubbo\config\spring\boot\conditional3\JavaConfigRawReferenceBeanConditionalTest.java,56,18,1,4,0,23
dubbo-3.0\dubbo-3.0\dubbo-remoting\dubbo-remoting-http\src\main\java\org\apache\dubbo\remoting\http\servlet\ServletHttpServer.java,9,5,0,2,0,7
dubbo-3.0\dubbo-3.0\dubbo-config\dubbo-config-api\src\test\java\org\apache\dubbo\config\mock\GreetingMock1.java,3,0,0,1,0,1
dubbo-3.0\dubbo-3.0\dubbo-remoting\dubbo-remoting-api\src\test\java\org\apache\dubbo\remoting\exchange\support\header\HeartBeatTaskTest.java,47,14,1,6,0,21
dubbo-3.0\dubbo-3.0\dubbo-plugin\dubbo-auth\src\test\java\org\apache\dubbo\auth\filter\ProviderAuthFilterTest.java,0,21,0,22,0,43
dubbo-3.0\dubbo-3.0\dubbo-demo\dubbo-demo-annotation\dubbo-demo-annotation-consumer\src\main\java\org\apache\dubbo\demo\consumer\comp\DemoServiceComponent.java,15,6,0,1,0,7
dubbo-3.0\dubbo-3.0\dubbo-common\src\test\java\org\apache\dubbo\common\extension\activate\impl\OldActivateExt1Impl2.java,6,3,0,1,0,4
dubbo-3.0\dubbo-3.0\dubbo-metadata\dubbo-metadata-processor\src\test\java\org\apache\dubbo\metadata\tools\StandardRestServiceTest.java,9,3,0,2,0,5
dubbo-3.0\dubbo-3.0\dubbo-remoting\dubbo-remoting-api\src\main\java\org\apache\dubbo\remoting\transport\dispatcher\connection\ConnectionOrderedChannelHandler.java,68,32,5,19,0,56
dubbo-3.0\dubbo-3.0\dubbo-plugin\dubbo-qos\src\test\java\org\apache\dubbo\qos\command\impl\HelpTest.java,24,3,0,2,0,5
dubbo-3.0\dubbo-3.0\dubbo-common\src\main\java\org\apache\dubbo\common\extension\LoadingStrategy.java,0,10,3,8,0,21
dubbo-3.0\dubbo-3.0\dubbo-cluster\src\main\java\org\apache\dubbo\rpc\cluster\support\FailbackClusterInvoker.java,142,65,10,24,0,99
dubbo-3.0\dubbo-3.0\dubbo-common\src\test\java\org\apache\dubbo\common\convert\multiple\StringToBlockingQueueConverterTest.java,72,16,5,6,0,27
dubbo-3.0\dubbo-3.0\dubbo-compatible\src\test\java\org\apache\dubbo\config\ConsumerConfigTest.java,29,6,0,2,0,8
dubbo-3.0\dubbo-3.0\dubbo-remoting\dubbo-remoting-api\src\test\java\org\apache\dubbo\remoting\handler\HeaderExchangeHandlerTest.java,217,61,0,27,0,88
dubbo-3.0\dubbo-3.0\dubbo-common\src\main\java\org\apache\dubbo\rpc\support\GroupServiceKeyCache.java,49,21,0,7,0,28
dubbo-3.0\dubbo-3.0\dubbo-config\dubbo-config-api\src\test\java\org\apache\dubbo\config\bootstrap\EtcdDubboServiceProviderBootstrap.java,63,12,7,9,0,28
dubbo-3.0\dubbo-3.0\dubbo-common\src\main\java\org\apache\dubbo\common\beanutil\JavaBeanAccessor.java,0,5,0,1,0,6
dubbo-3.0\dubbo-3.0\dubbo-common\src\main\java\org\apache\dubbo\config\nested\PrometheusConfig.java,180,92,0,2,0,94
dubbo-3.0\dubbo-3.0\dubbo-common\src\test\java\org\apache\dubbo\common\cache\FileCacheStoreFactoryTest.java,48,12,1,9,0,22
dubbo-3.0\dubbo-3.0\dubbo-metadata\dubbo-metadata-processor\src\main\java\org\apache\dubbo\metadata\annotation\processing\rest\jaxrs\ParamAnnotationParameterProcessor.java,9,14,0,7,0,21
dubbo-3.0\dubbo-3.0\dubbo-config\dubbo-config-spring\src\test\java\org\apache\dubbo\config\spring\samples\ZookeeperDubboSpringProviderBootstrap.java,0,8,1,5,0,14
dubbo-3.0\dubbo-3.0\dubbo-metadata\dubbo-metadata-processor\src\test\java\org\apache\dubbo\metadata\annotation\processing\util\AnnotationUtilsTest.java,174,46,1,42,0,89
dubbo-3.0\dubbo-3.0\dubbo-plugin\dubbo-qos\src\test\java\org\apache\dubbo\qos\command\decoder\TelnetCommandDecoderTest.java,10,1,0,1,0,2
dubbo-3.0\dubbo-3.0\dubbo-config\dubbo-config-api\src\main\java\org\apache\dubbo\config\deploy\DefaultApplicationDeployer.java,964,173,23,106,0,302
dubbo-3.0\dubbo-3.0\dubbo-plugin\dubbo-qos\src\main\java\org\apache\dubbo\qos\command\decoder\HttpCommandDecoder.java,49,16,1,11,0,28
dubbo-3.0\dubbo-3.0\dubbo-plugin\dubbo-qos\src\main\java\org\apache\dubbo\qos\command\impl\CountTelnet.java,143,21,1,7,0,29
dubbo-3.0\dubbo-3.0\dubbo-cluster\src\main\java\org\apache\dubbo\rpc\cluster\configurator\parser\ConfigParser.java,187,33,2,18,0,53
dubbo-3.0\dubbo-3.0\dubbo-compatible\src\main\java\com\alibaba\dubbo\registry\support\AbstractRegistryFactory.java,0,5,0,3,0,8
dubbo-3.0\dubbo-3.0\dubbo-monitor\dubbo-monitor-default\src\test\java\org\apache\dubbo\monitor\dubbo\service\DemoService.java,0,5,0,1,0,6
dubbo-3.0\dubbo-3.0\dubbo-common\src\main\java\org\apache\dubbo\common\utils\SerializeClassChecker.java,122,46,3,20,0,69
dubbo-3.0\dubbo-3.0\dubbo-compatible\src\main\java\com\alibaba\dubbo\validation\Validation.java,0,1,0,1,0,2
dubbo-3.0\dubbo-3.0\dubbo-remoting\dubbo-remoting-api\src\main\java\org\apache\dubbo\remoting\transport\CodecSupport.java,143,64,4,24,0,92
dubbo-3.0\dubbo-3.0\dubbo-filter\dubbo-filter-validation\src\test\java\org\apache\dubbo\validation\filter\ValidationFilterTest.java,102,26,0,14,0,40
dubbo-3.0\dubbo-3.0\dubbo-serialization\dubbo-serialization-jdk\src\main\java\org\apache\dubbo\common\serialize\nativejava\NativeJavaObjectInput.java,89,24,1,3,0,28
dubbo-3.0\dubbo-3.0\dubbo-metadata\dubbo-metadata-api\src\test\java\org\apache\dubbo\metadata\filter\ExcludedParamsFilter.java,16,2,0,1,0,3
dubbo-3.0\dubbo-3.0\dubbo-remoting\dubbo-remoting-api\src\main\java\org\apache\dubbo\remoting\exchange\Request.java,128,58,1,4,0,63
dubbo-3.0\dubbo-3.0\dubbo-config\dubbo-config-api\src\main\java\org\apache\dubbo\config\ConfigPostProcessor.java,0,3,2,1,0,6
dubbo-3.0\dubbo-3.0\dubbo-config\dubbo-config-api\src\test\java\org\apache\dubbo\config\bootstrap\builders\RegistryBuilderTest.java,0,24,0,9,0,33
dubbo-3.0\dubbo-3.0\dubbo-config\dubbo-config-spring\src\main\java\org\apache\dubbo\config\spring\status\SpringStatusChecker.java,87,19,4,8,0,31
dubbo-3.0\dubbo-3.0\dubbo-plugin\dubbo-qos\src\test\java\org\apache\dubbo\qos\DemoService.java,0,2,0,1,0,3
dubbo-3.0\dubbo-3.0\dubbo-metadata\dubbo-metadata-api\src\main\java\org\apache\dubbo\metadata\MappingListener.java,0,2,0,1,0,3
dubbo-3.0\dubbo-3.0\dubbo-registry\dubbo-registry-api\src\main\java\org\apache\dubbo\registry\support\CacheableFailbackRegistry.java,295,101,11,48,0,160
dubbo-3.0\dubbo-3.0\dubbo-cluster\src\main\java\org\apache\dubbo\rpc\cluster\filter\InvocationInterceptorBuilder.java,0,3,1,2,0,6
dubbo-3.0\dubbo-3.0\dubbo-common\src\main\java\org\apache\dubbo\common\resource\GlobalResourceInitializer.java,40,19,0,5,0,24
dubbo-3.0\dubbo-3.0\dubbo-common\src\main\java\org\apache\dubbo\common\Experimental.java,0,1,0,1,0,2
dubbo-3.0\dubbo-3.0\dubbo-remoting\dubbo-remoting-api\src\test\java\org\apache\dubbo\remoting\exchange\PortUnificationExchangerTest.java,16,6,0,4,0,10
dubbo-3.0\dubbo-3.0\dubbo-rpc\dubbo-rpc-triple\src\test\java\org\apache\dubbo\rpc\protocol\tri\SingleProtobufUtilsTest.java,35,16,0,15,0,31
dubbo-3.0\dubbo-3.0\dubbo-cluster\src\test\java\org\apache\dubbo\rpc\cluster\support\TagProviderURLMergeProcessor.java,17,5,0,1,0,6
dubbo-3.0\dubbo-3.0\dubbo-cluster\src\main\java\org\apache\dubbo\rpc\cluster\router\mesh\rule\VsDestinationGroup.java,34,27,2,7,0,36
dubbo-3.0\dubbo-3.0\dubbo-common\src\test\java\org\apache\dubbo\common\utils\CIDRUtilsTest.java,31,4,13,3,0,20
dubbo-3.0\dubbo-3.0\dubbo-config\dubbo-config-api\src\test\java\org\apache\dubbo\config\integration\multiple\exportprovider\MultipleRegistryCenterExportProviderRegistryProtocolListener.java,40,15,2,7,0,24
dubbo-3.0\dubbo-3.0\dubbo-common\src\test\java\org\apache\dubbo\common\extension\ExtensionDirectorTest.java,247,88,1,72,0,161
dubbo-3.0\dubbo-3.0\dubbo-remoting\dubbo-remoting-api\src\main\java\org\apache\dubbo\remoting\telnet\codec\TelnetCodec.java,258,65,6,17,0,88
dubbo-3.0\dubbo-3.0\dubbo-remoting\dubbo-remoting-api\src\test\java\org\apache\dubbo\remoting\PerformanceServerMain.java,8,4,1,1,0,6
dubbo-3.0\dubbo-3.0\dubbo-rpc\dubbo-rpc-rest\src\test\java\org\apache\dubbo\rpc\protocol\rest\DemoService.java,0,4,0,1,0,5
dubbo-3.0\dubbo-3.0\dubbo-plugin\dubbo-qos\src\main\java\org\apache\dubbo\qos\command\NoSuchCommandException.java,6,2,0,1,0,3
dubbo-3.0\dubbo-3.0\dubbo-common\src\main\java\org\apache\dubbo\common\utils\LFUCache.java,0,36,1,1,0,38
dubbo-3.0\dubbo-3.0\dubbo-container\dubbo-container-spring\src\test\java\org\apache\dubbo\container\spring\SpringContainerTest.java,12,5,0,3,0,8
dubbo-3.0\dubbo-3.0\dubbo-rpc\dubbo-rpc-api\src\test\java\org\apache\dubbo\rpc\StatusRpcExceptionTest.java,0,1,0,2,0,3
dubbo-3.0\dubbo-3.0\dubbo-native\src\main\java\org\apache\dubbo\common\threadpool\ThreadPool$Adaptive.java,0,14,9,6,0,29
dubbo-3.0\dubbo-3.0\dubbo-config\dubbo-config-spring\src\test\java\org\apache\dubbo\config\spring\samples\ZookeeperDubboSpringConsumerBootstrap.java,22,11,0,6,0,17
dubbo-3.0\dubbo-3.0\dubbo-config\dubbo-config-spring\src\test\java\org\apache\dubbo\config\spring\annotation\merged\MergedReference.java,0,3,0,1,0,4
dubbo-3.0\dubbo-3.0\dubbo-config\dubbo-config-api\src\test\java\org\apache\dubbo\config\AbstractReferenceConfigTest.java,171,25,0,14,0,39
dubbo-3.0\dubbo-3.0\dubbo-metadata\dubbo-metadata-api\src\main\java\org\apache\dubbo\metadata\rest\ClassPathServiceRestMetadataReader.java,42,13,0,9,0,22
dubbo-3.0\dubbo-3.0\dubbo-demo\dubbo-demo-triple\src\main\java\org\apache\dubbo\demo\GreeterServiceImpl.java,15,4,0,1,0,5
dubbo-3.0\dubbo-3.0\dubbo-metadata\dubbo-metadata-api\src\main\java\org\apache\dubbo\metadata\report\support\AbstractMetadataReportFactory.java,79,22,2,8,0,32
dubbo-3.0\dubbo-3.0\dubbo-metadata\dubbo-metadata-processor\src\main\java\org\apache\dubbo\metadata\annotation\processing\builder\EnumTypeDefinitionBuilder.java,24,12,0,6,0,18
dubbo-3.0\dubbo-3.0\dubbo-cluster\src\main\java\org\apache\dubbo\rpc\cluster\router\mesh\route\StandardMeshRuleRouter.java,12,3,0,2,0,5
dubbo-3.0\dubbo-3.0\dubbo-registry\dubbo-registry-api\src\main\java\org\apache\dubbo\registry\RegistryServiceListener.java,0,4,4,1,0,9
dubbo-3.0\dubbo-3.0\dubbo-registry\dubbo-registry-api\src\test\java\org\apache\dubbo\registry\client\migration\MigrationRuleListenerTest.java,183,84,1,43,0,128
dubbo-3.0\dubbo-3.0\dubbo-cluster\src\main\java\org\apache\dubbo\rpc\cluster\merger\CharArrayMerger.java,25,2,0,1,0,3
dubbo-3.0\dubbo-3.0\dubbo-remoting\dubbo-remoting-api\src\test\java\org\apache\dubbo\remoting\exchange\ExchangersTest.java,31,8,0,6,0,14
dubbo-3.0\dubbo-3.0\dubbo-cluster\src\test\java\org\apache\dubbo\rpc\cluster\filter\DemoServiceLocal.java,22,12,4,1,0,17
dubbo-3.0\dubbo-3.0\dubbo-configcenter\dubbo-configcenter-apollo\src\test\java\org\apache\dubbo\configcenter\support\apollo\EmbeddedApolloJunit5.java,0,64,3,22,0,89
dubbo-3.0\dubbo-3.0\dubbo-metadata\dubbo-metadata-api\src\main\java\org\apache\dubbo\metadata\report\identifier\BaseServiceMetadataIdentifier.java,35,19,0,3,0,22
dubbo-3.0\dubbo-3.0\dubbo-rpc\dubbo-rpc-api\src\test\java\org\apache\dubbo\rpc\filter\tps\DefaultTPSLimiterTest.java,128,51,0,17,0,68
dubbo-3.0\dubbo-3.0\dubbo-cluster\src\main\java\org\apache\dubbo\rpc\cluster\merger\FloatArrayMerger.java,25,2,0,1,0,3
dubbo-3.0\dubbo-3.0\dubbo-remoting\dubbo-remoting-api\src\main\java\org\apache\dubbo\remoting\transport\dispatcher\message\MessageOnlyDispatcher.java,11,4,0,1,0,5
dubbo-3.0\dubbo-3.0\dubbo-common\src\main\java\org\apache\dubbo\common\extension\DubboInternalLoadingStrategy.java,13,3,0,1,0,4
dubbo-3.0\dubbo-3.0\dubbo-rpc\dubbo-rpc-api\src\main\java\org\apache\dubbo\rpc\stub\StubProxyFactory.java,19,13,0,5,0,18
dubbo-3.0\dubbo-3.0\dubbo-metadata\dubbo-metadata-report-zookeeper\src\test\java\org\apache\dubbo\metadata\store\zookeeper\ZookeeperMetadataReportTest.java,277,119,8,72,0,199
dubbo-3.0\dubbo-3.0\dubbo-common\src\test\java\org\apache\dubbo\common\config\ConfigurationCacheTest.java,12,2,0,1,0,3
dubbo-3.0\dubbo-3.0\dubbo-config\dubbo-config-spring\src\test\java\org\apache\dubbo\config\spring\registry\MockRegistryFactory.java,20,6,0,2,0,8
dubbo-3.0\dubbo-3.0\dubbo-common\src\main\java\org\apache\dubbo\common\constants\RemotingConstants.java,0,3,1,1,0,5
dubbo-3.0\dubbo-3.0\dubbo-remoting\dubbo-remoting-api\src\main\java\org\apache\dubbo\remoting\telnet\support\command\ClearTelnetHandler.java,21,9,0,2,0,11
dubbo-3.0\dubbo-3.0\dubbo-rpc\dubbo-rpc-api\src\test\java\org\apache\dubbo\rpc\TriRpcStatusTest.java,0,21,3,18,0,42
dubbo-3.0\dubbo-3.0\dubbo-spring-boot\dubbo-spring-boot-compatible\actuator\src\main\java\org\apache\dubbo\spring\boot\actuate\endpoint\metadata\DubboMetadata.java,26,4,0,5,0,9
dubbo-3.0\dubbo-3.0\dubbo-common\src\test\java\org\apache\dubbo\common\extension\director\FooAppService.java,0,1,0,1,0,2
dubbo-3.0\dubbo-3.0\dubbo-common\src\test\java\org\apache\dubbo\common\extension\ext7\impl\Ext7Impl.java,7,5,0,1,0,6
dubbo-3.0\dubbo-3.0\dubbo-compatible\src\main\java\com\alibaba\dubbo\common\serialize\ObjectOutput.java,0,1,0,2,0,3
dubbo-3.0\dubbo-3.0\dubbo-rpc\dubbo-rpc-api\src\main\java\org\apache\dubbo\rpc\Result.java,0,21,0,5,0,26
dubbo-3.0\dubbo-3.0\dubbo-plugin\dubbo-qos\src\test\java\org\apache\dubbo\qos\legacy\service\generic\DemoException.java,22,10,0,1,0,11
dubbo-3.0\dubbo-3.0\dubbo-common\src\test\java\org\apache\dubbo\common\convert\multiple\StringToTransferQueueConverterTest.java,69,14,5,6,0,25
dubbo-3.0\dubbo-3.0\dubbo-rpc\dubbo-rpc-api\src\test\java\org\apache\dubbo\rpc\filter\GenericFilterTest.java,108,43,3,22,0,68
dubbo-3.0\dubbo-3.0\dubbo-rpc\dubbo-rpc-dubbo\src\test\java\org\apache\dubbo\rpc\protocol\dubbo\support\DemoServiceImpl.java,111,68,5,2,0,75
dubbo-3.0\dubbo-3.0\dubbo-registry\dubbo-registry-api\src\main\java\org\apache\dubbo\registry\client\metadata\StandardMetadataServiceURLBuilder.java,110,42,0,24,0,66
dubbo-3.0\dubbo-3.0\dubbo-compatible\src\main\java\com\alibaba\dubbo\config\RegistryConfig.java,0,6,1,1,0,8
dubbo-3.0\dubbo-3.0\dubbo-container\dubbo-container-spring\src\main\java\org\apache\dubbo\container\spring\SpringContainer.java,37,13,2,4,0,19
dubbo-3.0\dubbo-3.0\dubbo-metadata\dubbo-metadata-api\src\main\java\org\apache\dubbo\metadata\rest\AnnotatedMethodParameterProcessor.java,0,10,0,6,0,16
dubbo-3.0\dubbo-3.0\dubbo-common\src\main\java\org\apache\dubbo\common\function\ThrowableFunction.java,0,4,1,1,0,6
dubbo-3.0\dubbo-3.0\dubbo-common\src\test\java\org\apache\dubbo\common\convert\StringToShortConverterTest.java,24,7,0,3,0,10
dubbo-3.0\dubbo-3.0\dubbo-rpc\dubbo-rpc-api\src\test\java\org\apache\dubbo\rpc\support\Person.java,30,23,1,1,0,25
dubbo-3.0\dubbo-3.0\dubbo-config\dubbo-config-api\src\main\java\org\apache\dubbo\config\bootstrap\builders\MethodBuilder.java,0,94,0,4,0,98
dubbo-3.0\dubbo-3.0\dubbo-common\src\main\java\org\apache\dubbo\common\threadpool\MemoryLimitedLinkedBlockingQueue.java,89,43,0,7,0,50
dubbo-3.0\dubbo-3.0\dubbo-config\dubbo-config-spring\src\test\java\org\apache\dubbo\config\spring\JavaConfigBeanTest.java,136,28,0,17,0,45
dubbo-3.0\dubbo-3.0\dubbo-cluster\src\main\java\org\apache\dubbo\rpc\cluster\router\mesh\rule\virtualservice\match\DoubleRangeMatch.java,34,17,0,1,0,18
dubbo-3.0\dubbo-3.0\dubbo-rpc\dubbo-rpc-triple\src\main\java\org\apache\dubbo\rpc\protocol\tri\transport\TripleCommandOutBoundHandler.java,13,6,0,3,0,9
dubbo-3.0\dubbo-3.0\dubbo-metadata\dubbo-metadata-processor\src\main\java\org\apache\dubbo\metadata\annotation\processing\rest\springmvc\SpringMvcServiceRestMetadataResolver.java,116,57,0,29,0,86
dubbo-3.0\dubbo-3.0\dubbo-registry\dubbo-registry-api\src\main\java\org\apache\dubbo\registry\RegistryScopeModelInitializer.java,18,4,2,1,0,7
dubbo-3.0\dubbo-3.0\dubbo-cluster\src\main\java\org\apache\dubbo\rpc\cluster\router\mesh\rule\BaseRule.java,39,27,0,1,0,28
dubbo-3.0\dubbo-3.0\dubbo-config\dubbo-config-spring\src\test\java\org\apache\dubbo\config\spring\reference\localcall\LocalCallTest.java,33,10,1,6,0,17
dubbo-3.0\dubbo-3.0\dubbo-plugin\dubbo-qos\src\main\java\org\apache\dubbo\qos\probe\impl\DeployerReadinessProbe.java,25,7,0,2,0,9
dubbo-3.0\dubbo-3.0\dubbo-rpc\dubbo-rpc-dubbo\src\main\java\org\apache\dubbo\rpc\protocol\dubbo\DubboCountCodec.java,0,16,6,5,0,27
dubbo-3.0\dubbo-3.0\dubbo-common\src\test\java\org\apache\dubbo\common\threadlocal\NamedInternalThreadFactoryTest.java,15,3,1,3,0,7
dubbo-3.0\dubbo-3.0\dubbo-common\src\main\java\org\apache\dubbo\common\url\component\URLPlainParam.java,16,11,0,4,0,15
dubbo-3.0\dubbo-3.0\dubbo-common\src\test\java\org\apache\dubbo\common\model\media\Media.java,0,157,16,7,0,180
dubbo-3.0\dubbo-3.0\dubbo-config\dubbo-config-api\src\test\java\org\apache\dubbo\config\url\InvokerSideConfigUrlTest.java,0,87,8,33,0,128
dubbo-3.0\dubbo-3.0\dubbo-common\src\test\java\org\apache\dubbo\common\extension\duplicated\impl\DuplicatedOverriddenExt1.java,8,2,0,1,0,3
dubbo-3.0\dubbo-3.0\dubbo-rpc\dubbo-rpc-api\src\test\java\org\apache\dubbo\rpc\filter\tps\TpsLimitFilterTest.java,35,11,0,5,0,16
dubbo-3.0\dubbo-3.0\dubbo-cluster\src\test\java\org\apache\dubbo\rpc\cluster\RouterChainTest.java,198,88,4,30,0,122
dubbo-3.0\dubbo-3.0\dubbo-demo\dubbo-demo-triple\src\main\java\org\apache\dubbo\demo\GreeterWrapperService.java,0,3,0,1,0,4
dubbo-3.0\dubbo-3.0\dubbo-plugin\dubbo-qos\src\test\java\org\apache\dubbo\qos\command\impl\TestInterface.java,0,1,0,1,0,2
dubbo-3.0\dubbo-3.0\dubbo-cluster\src\test\java\org\apache\dubbo\rpc\cluster\support\MenuService.java,0,2,0,1,0,3
dubbo-3.0\dubbo-3.0\dubbo-filter\dubbo-filter-cache\src\main\java\org\apache\dubbo\cache\CacheFactory.java,0,4,0,5,0,9
dubbo-3.0\dubbo-3.0\dubbo-remoting\dubbo-remoting-api\src\main\java\org\apache\dubbo\remoting\exchange\support\header\ReconnectTimerTask.java,41,17,6,7,0,30
dubbo-3.0\dubbo-3.0\dubbo-common\src\test\java\org\apache\dubbo\common\model\media\Image.java,0,73,9,3,0,85
dubbo-3.0\dubbo-3.0\dubbo-plugin\dubbo-qos\src\main\java\org\apache\dubbo\qos\probe\StartupProbe.java,0,2,0,1,0,3
dubbo-3.0\dubbo-3.0\dubbo-config\dubbo-config-spring\src\test\java\org\apache\dubbo\config\spring\registry\nacos\demo\consumer\DemoServiceConsumerBootstrap.java,22,10,1,4,0,15
dubbo-3.0\dubbo-3.0\dubbo-rpc\dubbo-rpc-api\src\test\java\org\apache\dubbo\rpc\DemoRequest.java,0,10,0,2,0,12
dubbo-3.0\dubbo-3.0\dubbo-cluster\src\main\java\org\apache\dubbo\rpc\cluster\support\FailsafeCluster.java,11,6,0,2,0,8
dubbo-3.0\dubbo-3.0\dubbo-common\src\main\java\org\apache\dubbo\config\MonitorConfig.java,128,70,1,3,0,74
dubbo-3.0\dubbo-3.0\dubbo-common\src\test\java\org\apache\dubbo\common\utils\StringConstantFieldValuePredicateTest.java,17,5,0,2,0,7
dubbo-3.0\dubbo-3.0\dubbo-common\src\test\java\org\apache\dubbo\rpc\model\ReflectionMethodDescriptorTest.java,0,3,1,3,0,7
dubbo-3.0\dubbo-3.0\dubbo-config\dubbo-config-api\src\main\java\org\apache\dubbo\config\bootstrap\builders\package-info.java,0,1,0,2,0,3
dubbo-3.0\dubbo-3.0\dubbo-config\dubbo-config-api\src\test\java\org\apache\dubbo\config\mock\GreetingLocal2.java,7,1,0,1,0,2
dubbo-3.0\dubbo-3.0\dubbo-common\src\main\java\org\apache\dubbo\common\constants\MetricsConstants.java,0,5,4,1,0,10
dubbo-3.0\dubbo-3.0\dubbo-config\dubbo-config-spring\src\test\java\org\apache\dubbo\config\spring\annotation\provider\AnnotationServiceImpl.java,12,7,0,1,0,8
dubbo-3.0\dubbo-3.0\dubbo-spring-boot\dubbo-spring-boot-compatible\actuator\src\main\java\org\apache\dubbo\spring\boot\actuate\endpoint\metadata\DubboReferencesMetadata.java,45,14,0,10,0,24
dubbo-3.0\dubbo-3.0\dubbo-rpc\dubbo-rpc-api\src\test\java\org\apache\dubbo\rpc\stub\StubInvocationUtilTest.java,0,33,8,16,0,57
dubbo-3.0\dubbo-3.0\dubbo-common\src\main\java\org\apache\dubbo\common\utils\LogHelper.java,157,51,1,1,0,53
dubbo-3.0\dubbo-3.0\dubbo-common\src\test\java\org\apache\dubbo\common\extension\ext6_inject\impl\Ext6Impl2.java,17,12,0,1,0,13
dubbo-3.0\dubbo-3.0\dubbo-test\dubbo-test-common\src\main\java\org\apache\dubbo\test\common\ErrorHandler.java,0,2,0,1,0,3
dubbo-3.0\dubbo-3.0\dubbo-common\src\test\java\org\apache\dubbo\common\utils\DubboAppenderTest.java,52,8,0,1,0,9
dubbo-3.0\dubbo-3.0\dubbo-remoting\dubbo-remoting-api\src\test\java\org\apache\dubbo\remoting\buffer\ChannelBuffersTest.java,85,32,0,8,0,40
dubbo-3.0\dubbo-3.0\dubbo-rpc\dubbo-rpc-api\src\main\java\org\apache\dubbo\rpc\RpcConstants.java,0,2,1,2,0,5
dubbo-3.0\dubbo-3.0\dubbo-plugin\dubbo-qos\src\test\java\org\apache\dubbo\qos\command\impl\LsTest.java,66,12,0,5,0,17
dubbo-3.0\dubbo-3.0\dubbo-common\src\main\java\org\apache\dubbo\common\logger\slf4j\Slf4jLoggerAdapter.java,37,14,0,1,0,15
dubbo-3.0\dubbo-3.0\dubbo-compatible\src\main\java\com\alibaba\dubbo\config\MethodConfig.java,0,0,0,1,0,1
dubbo-3.0\dubbo-3.0\dubbo-metadata\dubbo-metadata-processor\src\test\java\org\apache\dubbo\metadata\tools\TestServiceImpl.java,0,4,1,2,0,7
dubbo-3.0\dubbo-3.0\dubbo-common\src\main\java\org\apache\dubbo\common\context\Lifecycle.java,0,6,0,1,0,7
dubbo-3.0\dubbo-3.0\dubbo-compatible\src\main\java\com\alibaba\dubbo\config\ServiceConfig.java,0,3,1,1,0,5
dubbo-3.0\dubbo-3.0\dubbo-remoting\dubbo-remoting-api\src\main\java\org\apache\dubbo\remoting\exchange\codec\ExchangeCodec.java,456,172,14,50,0,236
dubbo-3.0\dubbo-3.0\dubbo-common\src\main\java\org\apache\dubbo\common\extension\ExtensionFactory.java,0,2,0,1,0,3
dubbo-3.0\dubbo-3.0\dubbo-monitor\dubbo-monitor-default\src\main\java\org\apache\dubbo\monitor\dubbo\DubboMonitorFactory.java,36,14,0,3,0,17
dubbo-3.0\dubbo-3.0\dubbo-common\src\main\java\org\apache\dubbo\common\threadpool\event\ThreadPoolExhaustedEvent.java,13,8,0,1,0,9
dubbo-3.0\dubbo-3.0\dubbo-metadata\dubbo-metadata-api\src\main\java\org\apache\dubbo\metadata\rest\AbstractServiceRestMetadataResolver.java,289,95,1,54,0,150
dubbo-3.0\dubbo-3.0\dubbo-common\src\main\java\org\apache\dubbo\common\compiler\support\AdaptiveCompiler.java,0,14,1,3,0,18
dubbo-3.0\dubbo-3.0\dubbo-common\src\test\java\org\apache\dubbo\common\bytecode\ProxyTest.java,49,7,0,3,0,10
dubbo-3.0\dubbo-3.0\dubbo-common\src\test\java\org\apache\dubbo\common\resource\GlobalResourcesRepositoryTest.java,52,11,0,5,0,16
dubbo-3.0\dubbo-3.0\dubbo-filter\dubbo-filter-cache\src\test\java\org\apache\dubbo\cache\support\AbstractCacheFactoryTest.java,11,2,0,1,0,3
dubbo-3.0\dubbo-3.0\dubbo-metadata\dubbo-metadata-processor\src\test\java\org\apache\dubbo\metadata\annotation\processing\CompilerInvocationInterceptor.java,16,9,0,7,0,16
dubbo-3.0\dubbo-3.0\dubbo-serialization\dubbo-serialization-api\src\main\java\org\apache\dubbo\common\serialize\DataOutput.java,0,0,0,1,0,1
dubbo-3.0\dubbo-3.0\dubbo-common\src\main\java\org\apache\dubbo\rpc\model\ServiceRepository.java,48,15,0,5,0,20
dubbo-3.0\dubbo-3.0\dubbo-registry\dubbo-registry-api\src\main\java\org\apache\dubbo\registry\client\event\ServiceInstancesChangedEvent.java,38,9,0,4,0,13
dubbo-3.0\dubbo-3.0\dubbo-plugin\dubbo-auth\src\test\java\org\apache\dubbo\auth\AccessKeyAuthenticatorTest.java,0,19,0,19,0,38
dubbo-3.0\dubbo-3.0\dubbo-plugin\dubbo-qos\src\main\java\org\apache\dubbo\qos\probe\impl\ProviderReadinessProbe.java,35,8,0,3,0,11
dubbo-3.0\dubbo-3.0\dubbo-rpc\dubbo-rpc-triple\src\main\java\org\apache\dubbo\rpc\protocol\tri\command\TextDataQueueCommand.java,22,12,1,2,0,15
dubbo-3.0\dubbo-3.0\dubbo-common\src\test\java\org\apache\dubbo\common\convert\StringToLongConverterTest.java,24,7,0,3,0,10
dubbo-3.0\dubbo-3.0\dubbo-metadata\dubbo-metadata-processor\src\test\java\org\apache\dubbo\metadata\tools\Ancestor.java,13,9,0,1,0,10
dubbo-3.0\dubbo-3.0\dubbo-rpc\dubbo-rpc-api\src\main\java\org\apache\dubbo\rpc\Protocol.java,0,13,0,12,0,25
dubbo-3.0\dubbo-3.0\dubbo-common\src\main\java\org\apache\dubbo\common\beanutil\JavaBeanSerializeUtil.java,0,102,5,57,0,164
dubbo-3.0\dubbo-3.0\dubbo-config\dubbo-config-api\src\test\java\org\apache\dubbo\config\mock\MockRegistryFactory2.java,9,4,0,1,0,5
dubbo-3.0\dubbo-3.0\dubbo-common\src\main\java\org\apache\dubbo\common\logger\support\FailsafeLogger.java,253,57,45,2,0,104
dubbo-3.0\dubbo-3.0\dubbo-remoting\dubbo-remoting-api\src\test\java\org\apache\dubbo\remoting\api\MultiplexProtocolConnectionManagerTest.java,0,10,4,7,0,21
dubbo-3.0\dubbo-3.0\dubbo-common\src\test\java\org\apache\dubbo\common\convert\StringToOptionalConverterTest.java,21,7,0,3,0,10
dubbo-3.0\dubbo-3.0\dubbo-monitor\dubbo-monitor-api\src\main\java\org\apache\dubbo\monitor\support\MonitorClusterFilter.java,3,1,0,2,0,3
dubbo-3.0\dubbo-3.0\dubbo-common\src\main\java\org\apache\dubbo\common\concurrent\CallableSafeInitializer.java,71,11,0,1,0,12
dubbo-3.0\dubbo-3.0\dubbo-rpc\dubbo-rpc-triple\src\main\java\org\apache\dubbo\rpc\protocol\tri\transport\GracefulShutdown.java,50,24,0,6,0,30
dubbo-3.0\dubbo-3.0\dubbo-metadata\dubbo-metadata-api\src\main\java\org\apache\dubbo\metadata\report\identifier\ServiceMetadataIdentifier.java,55,40,1,5,0,46
dubbo-3.0\dubbo-3.0\dubbo-rpc\dubbo-rpc-api\src\main\java\org\apache\dubbo\rpc\CancellationListener.java,0,0,0,1,0,1
dubbo-3.0\dubbo-3.0\dubbo-rpc\dubbo-rpc-api\src\main\java\org\apache\dubbo\rpc\filter\TokenHeaderFilter.java,18,10,1,6,0,17
dubbo-3.0\dubbo-3.0\dubbo-common\src\test\java\org\apache\dubbo\common\bytecode\MixinTest.java,51,17,0,2,0,19
dubbo-3.0\dubbo-3.0\dubbo-config\dubbo-config-spring\src\test\java\org\apache\dubbo\config\spring\beans\factory\annotation\ReferenceCreatorTest.java,175,54,1,26,0,81
dubbo-3.0\dubbo-3.0\dubbo-rpc\dubbo-rpc-triple\src\test\java\org\apache\dubbo\rpc\protocol\tri\PbUnpackTest.java,0,6,0,3,0,9
dubbo-3.0\dubbo-3.0\dubbo-common\src\test\java\org\apache\dubbo\common\threadpool\ThreadlessExecutorTest.java,28,19,4,1,0,24
dubbo-3.0\dubbo-3.0\dubbo-cluster\src\main\java\org\apache\dubbo\rpc\cluster\router\state\AbstractStateRouter.java,168,70,3,21,0,94
dubbo-3.0\dubbo-3.0\dubbo-common\src\main\java\org\apache\dubbo\common\threadlocal\InternalThread.java,52,34,1,6,0,41
dubbo-3.0\dubbo-3.0\dubbo-common\src\test\java\org\apache\dubbo\config\GreetingLocal1.java,4,0,0,1,0,1
dubbo-3.0\dubbo-3.0\dubbo-common\src\main\java\org\apache\dubbo\rpc\model\ProviderModel.java,152,78,4,10,0,92
dubbo-3.0\dubbo-3.0\dubbo-metadata\dubbo-metadata-processor\src\test\java\org\apache\dubbo\metadata\rest\SpringRestService.java,57,29,1,9,0,39
dubbo-3.0\dubbo-3.0\dubbo-common\src\test\java\org\apache\dubbo\common\function\ThrowableActionTest.java,10,2,0,1,0,3
dubbo-3.0\dubbo-3.0\dubbo-common\src\test\java\org\apache\dubbo\common\config\MockOrderedPropertiesProvider1.java,14,4,0,2,0,6
dubbo-3.0\dubbo-3.0\dubbo-registry\dubbo-registry-api\src\test\java\org\apache\dubbo\registry\client\ServiceDiscoveryTest.java,0,11,0,12,0,23
dubbo-3.0\dubbo-3.0\dubbo-metadata\dubbo-metadata-processor\src\test\java\org\apache\dubbo\metadata\annotation\processing\util\LoggerUtilsTest.java,22,4,0,3,0,7
dubbo-3.0\dubbo-3.0\dubbo-test\dubbo-test-check\src\main\java\org\apache\dubbo\test\check\RegistryCenterStarted.java,25,8,3,4,0,15
dubbo-3.0\dubbo-3.0\dubbo-common\src\main\java\org\apache\dubbo\common\config\ConfigurationCache.java,23,8,0,3,0,11
dubbo-3.0\dubbo-3.0\dubbo-plugin\dubbo-qos\src\test\java\org\apache\dubbo\qos\command\impl\channel\MockNettyChannel.java,394,121,2,12,0,135
dubbo-3.0\dubbo-3.0\dubbo-remoting\dubbo-remoting-http\src\main\java\org\apache\dubbo\remoting\http\servlet\DispatcherServlet.java,35,17,1,4,0,22
dubbo-3.0\dubbo-3.0\dubbo-common\src\main\java\org\apache\dubbo\rpc\model\StubServiceDescriptor.java,97,47,0,14,0,61
dubbo-3.0\dubbo-3.0\dubbo-metadata\dubbo-metadata-api\src\main\java\org\apache\dubbo\metadata\RevisionResolver.java,12,5,1,1,0,7
dubbo-3.0\dubbo-3.0\dubbo-test\dubbo-test-check\src\main\java\org\apache\dubbo\test\check\registrycenter\processor\ZookeeperUnixProcessor.java,76,15,5,10,0,30
dubbo-3.0\dubbo-3.0\dubbo-compatible\src\test\java\org\apache\dubbo\filter\MyFilter.java,17,7,2,3,0,12
dubbo-3.0\dubbo-3.0\dubbo-common\src\main\java\org\apache\dubbo\config\ProviderConfig.java,414,198,1,6,0,205
dubbo-3.0\dubbo-3.0\dubbo-serialization\dubbo-serialization-hessian2\src\main\java\org\apache\dubbo\common\serialize\hessian2\dubbo\DefaultHessian2FactoryInitializer.java,10,4,0,4,0,8
dubbo-3.0\dubbo-3.0\dubbo-cluster\src\main\java\org\apache\dubbo\rpc\cluster\router\mesh\rule\destination\TrafficPolicy.java,19,10,0,2,0,12
dubbo-3.0\dubbo-3.0\dubbo-plugin\dubbo-qos\src\main\java\org\apache\dubbo\qos\command\impl\Version.java,13,4,0,2,0,6
dubbo-3.0\dubbo-3.0\dubbo-common\src\main\java\org\apache\dubbo\config\annotation\Service.java,0,99,0,10,0,109
dubbo-3.0\dubbo-3.0\dubbo-config\dubbo-config-api\src\test\java\org\apache\dubbo\config\bootstrap\builders\MonitorBuilderTest.java,0,4,0,5,0,9
dubbo-3.0\dubbo-3.0\dubbo-remoting\dubbo-remoting-api\src\main\java\org\apache\dubbo\remoting\ChannelHandler.java,0,2,0,3,0,5
dubbo-3.0\dubbo-3.0\dubbo-cluster\src\main\java\org\apache\dubbo\rpc\cluster\support\ForkingClusterInvoker.java,74,23,2,15,0,40
dubbo-3.0\dubbo-3.0\dubbo-common\src\main\java\org\apache\dubbo\rpc\model\ReflectionServiceDescriptor.java,120,54,1,19,0,74
dubbo-3.0\dubbo-3.0\dubbo-config\dubbo-config-spring\src\main\java\org\apache\dubbo\config\spring\context\DubboSpringInitContext.java,83,45,1,6,0,52
dubbo-3.0\dubbo-3.0\dubbo-metadata\dubbo-metadata-api\src\main\java\org\apache\dubbo\metadata\MappingChangedEvent.java,25,13,0,1,0,14
dubbo-3.0\dubbo-3.0\dubbo-test\dubbo-test-check\src\main\java\org\apache\dubbo\test\check\AbstractRegistryCenterTestExecutionListener.java,71,17,0,8,0,25
dubbo-3.0\dubbo-3.0\dubbo-common\src\test\java\org\apache\dubbo\common\extension\director\impl\TestAppService.java,48,29,1,1,0,31
dubbo-3.0\dubbo-3.0\dubbo-cluster\src\test\java\org\apache\dubbo\rpc\cluster\support\wrapper\DemoClusterFilter.java,7,5,0,2,0,7
dubbo-3.0\dubbo-3.0\dubbo-demo\dubbo-demo-api\dubbo-demo-api-consumer\src\main\java\org\apache\dubbo\demo\consumer\Application.java,48,8,1,4,0,13
dubbo-3.0\dubbo-3.0\dubbo-common\src\main\java\org\apache\dubbo\common\logger\Level.java,0,9,0,1,0,10
dubbo-3.0\dubbo-3.0\dubbo-common\src\main\java\org\apache\dubbo\common\store\support\SimpleDataStore.java,40,15,0,2,0,17
dubbo-3.0\dubbo-3.0\dubbo-rpc\dubbo-rpc-triple\src\main\java\org\apache\dubbo\rpc\protocol\tri\transport\TripleServerConnectionHandler.java,66,28,1,12,0,41
dubbo-3.0\dubbo-3.0\dubbo-remoting\dubbo-remoting-api\src\main\java\org\apache\dubbo\remoting\api\SslServerTlsHandler.java,75,37,2,10,0,49
dubbo-3.0\dubbo-3.0\dubbo-config\dubbo-config-spring\src\main\java\org\apache\dubbo\config\spring\beans\factory\annotation\ReferenceAnnotationBeanPostProcessor.java,0,214,9,126,0,349
dubbo-3.0\dubbo-3.0\dubbo-metadata\dubbo-metadata-processor\src\main\java\org\apache\dubbo\metadata\annotation\processing\builder\SimpleTypeDefinitionBuilder.java,19,13,1,5,0,19
dubbo-3.0\dubbo-3.0\dubbo-rpc\dubbo-rpc-api\src\test\java\org\apache\dubbo\rpc\proxy\AbstractProxyTest.java,44,13,1,7,0,21
dubbo-3.0\dubbo-3.0\dubbo-rpc\dubbo-rpc-api\src\test\java\org\apache\dubbo\rpc\support\Type.java,0,3,0,1,0,4
dubbo-3.0\dubbo-3.0\dubbo-rpc\dubbo-rpc-rest\src\main\java\org\apache\dubbo\rpc\protocol\rest\RpcExceptionMapper.java,26,10,0,7,0,17
dubbo-3.0\dubbo-3.0\dubbo-rpc\dubbo-rpc-api\src\test\java\org\apache\dubbo\rpc\support\DemoServiceBMock.java,9,3,0,1,0,4
dubbo-3.0\dubbo-3.0\dubbo-common\src\test\java\org\apache\dubbo\common\utils\AtomicPositiveIntegerTest.java,178,50,0,3,0,53
dubbo-3.0\dubbo-3.0\dubbo-common\src\test\java\org\apache\dubbo\common\threadpool\support\eager\EagerThreadPoolExecutorTest.java,107,44,1,26,0,71
dubbo-3.0\dubbo-3.0\dubbo-plugin\dubbo-qos\src\test\java\org\apache\dubbo\qos\command\impl\PortTelnetTest.java,71,23,0,10,0,33
dubbo-3.0\dubbo-3.0\dubbo-native\src\main\java\org\apache\dubbo\rpc\cluster\RouterFactory$Adaptive.java,0,15,11,6,0,32
dubbo-3.0\dubbo-3.0\dubbo-rpc\dubbo-rpc-injvm\src\test\java\org\apache\dubbo\rpc\protocol\injvm\DemoService.java,0,11,0,1,0,12
dubbo-3.0\dubbo-3.0\dubbo-compatible\src\main\java\com\alibaba\dubbo\remoting\Channel.java,0,1,1,1,0,3
dubbo-3.0\dubbo-3.0\dubbo-config\dubbo-config-api\src\test\java\org\apache\dubbo\config\bootstrap\builders\ProviderBuilderTest.java,0,42,1,12,0,55
dubbo-3.0\dubbo-3.0\dubbo-registry\dubbo-registry-api\src\main\java\org\apache\dubbo\registry\client\metadata\ProtocolPortsMetadataCustomizer.java,29,13,1,9,0,23
dubbo-3.0\dubbo-3.0\dubbo-metadata\dubbo-metadata-api\src\test\java\org\apache\dubbo\metadata\rest\RestService.java,0,8,0,1,0,9
dubbo-3.0\dubbo-3.0\dubbo-rpc\dubbo-rpc-api\src\main\java\org\apache\dubbo\rpc\filter\ClassLoaderCallbackFilter.java,0,17,1,6,0,24
dubbo-3.0\dubbo-3.0\dubbo-rpc\dubbo-rpc-api\src\test\java\org\apache\dubbo\rpc\RpcContextTest.java,183,26,7,13,0,46
dubbo-3.0\dubbo-3.0\dubbo-common\src\main\java\com\alibaba\dubbo\common\extension\Activate.java,0,7,0,1,0,8
dubbo-3.0\dubbo-3.0\dubbo-common\src\main\java\org\apache\dubbo\config\MetadataReportConfig.java,0,153,1,15,0,169
dubbo-3.0\dubbo-3.0\dubbo-common\src\test\java\org\apache\dubbo\common\extension\ext1\impl\SimpleExtImpl3.java,15,12,0,1,0,13
dubbo-3.0\dubbo-3.0\dubbo-test\dubbo-test-check\src\main\java\org\apache\dubbo\test\check\registrycenter\processor\ResetZookeeperProcessor.java,25,7,0,3,0,10
dubbo-3.0\dubbo-3.0\dubbo-config\dubbo-config-spring\src\test\java\org\apache\dubbo\config\spring\context\annotation\provider\HelloServiceImpl.java,8,4,0,2,0,6
dubbo-3.0\dubbo-3.0\dubbo-cluster\src\main\java\org\apache\dubbo\rpc\cluster\ClusterInvoker.java,0,10,0,6,0,16
dubbo-3.0\dubbo-3.0\dubbo-rpc\dubbo-rpc-api\src\test\java\org\apache\dubbo\rpc\stub\StubInvokerTest.java,0,8,1,4,0,13
dubbo-3.0\dubbo-3.0\dubbo-metadata\dubbo-metadata-processor\src\main\java\org\apache\dubbo\metadata\annotation\processing\builder\GeneralTypeDefinitionBuilder.java,36,19,0,10,0,29
dubbo-3.0\dubbo-3.0\dubbo-rpc\dubbo-rpc-api\src\main\java\org\apache\dubbo\rpc\StatusRpcException.java,15,7,0,2,0,9
dubbo-3.0\dubbo-3.0\dubbo-rpc\dubbo-rpc-api\src\main\java\org\apache\dubbo\rpc\ListenableFilter.java,26,20,0,4,0,24
dubbo-3.0\dubbo-3.0\dubbo-spring-boot\dubbo-spring-boot-actuator\src\main\java\org\apache\dubbo\spring\boot\actuate\endpoint\DubboShutdownEndpoint.java,12,4,0,3,0,7
dubbo-3.0\dubbo-3.0\dubbo-common\src\main\java\org\apache\dubbo\common\deploy\DeployListenerAdapter.java,22,9,5,2,0,16
dubbo-3.0\dubbo-3.0\dubbo-rpc\dubbo-rpc-api\src\test\java\org\apache\dubbo\rpc\filter\TimeoutFilterTest.java,35,9,1,4,0,14
dubbo-3.0\dubbo-3.0\dubbo-common\src\test\java\org\apache\dubbo\common\convert\multiple\MultiValueConverterTest.java,36,7,0,5,0,12
dubbo-3.0\dubbo-3.0\dubbo-rpc\dubbo-rpc-dubbo\src\main\java\org\apache\dubbo\rpc\protocol\dubbo\DubboExporter.java,20,12,0,2,0,14
dubbo-3.0\dubbo-3.0\dubbo-common\src\main\java\org\apache\dubbo\common\resource\Disposable.java,0,3,0,1,0,4
dubbo-3.0\dubbo-3.0\dubbo-common\src\main\java\org\apache\dubbo\rpc\model\BuiltinServiceDetector.java,0,1,0,1,0,2
dubbo-3.0\dubbo-3.0\dubbo-metadata\dubbo-metadata-api\src\main\java\org\apache\dubbo\metadata\MetadataParamsFilter.java,0,2,0,1,0,3
dubbo-3.0\dubbo-3.0\dubbo-monitor\dubbo-monitor-api\src\main\java\org\apache\dubbo\monitor\support\MonitorFilter.java,0,61,4,20,0,85
dubbo-3.0\dubbo-3.0\dubbo-metadata\dubbo-metadata-processor\src\test\java\org\apache\dubbo\metadata\annotation\processing\model\ArrayTypeModel.java,14,8,5,2,0,15
dubbo-3.0\dubbo-3.0\dubbo-config\dubbo-config-api\src\test\java\org\apache\dubbo\config\bootstrap\DubboServiceConsumerBootstrap.java,33,16,1,9,0,26
dubbo-3.0\dubbo-3.0\dubbo-common\src\main\java\org\apache\dubbo\common\utils\ReflectUtils.java,0,205,28,68,0,301
dubbo-3.0\dubbo-3.0\dubbo-registry\dubbo-registry-api\src\main\java\org\apache\dubbo\registry\client\DefaultServiceInstance.java,334,161,3,19,0,183
dubbo-3.0\dubbo-3.0\dubbo-common\src\main\java\org\apache\dubbo\rpc\model\ScopeModelAccessor.java,0,5,0,2,0,7
dubbo-3.0\dubbo-3.0\dubbo-common\src\test\java\org\apache\dubbo\common\extension\support\Filter4.java,3,1,0,1,0,2
dubbo-3.0\dubbo-3.0\dubbo-config\dubbo-config-api\src\main\java\org\apache\dubbo\config\bootstrap\builders\ConfigCenterBuilder.java,0,74,0,3,0,77
dubbo-3.0\dubbo-3.0\dubbo-common\src\test\java\org\apache\dubbo\common\extension\ext3\UseProtocolKeyExt.java,0,3,0,1,0,4
dubbo-3.0\dubbo-3.0\dubbo-common\src\main\java\org\apache\dubbo\common\config\configcenter\ConfigChangedEvent.java,69,42,0,3,0,45
dubbo-3.0\dubbo-3.0\dubbo-remoting\dubbo-remoting-api\src\main\java\org\apache\dubbo\remoting\transport\dispatcher\WrappedChannelHandler.java,125,52,1,15,0,68
dubbo-3.0\dubbo-3.0\dubbo-rpc\dubbo-rpc-dubbo\src\test\java\org\apache\dubbo\rpc\protocol\dubbo\ImplicitCallBackTest.java,0,23,0,24,0,47
dubbo-3.0\dubbo-3.0\dubbo-common\src\test\java\org\apache\dubbo\rpc\model\FrameworkModelTest.java,82,25,0,21,0,46
dubbo-3.0\dubbo-3.0\dubbo-metadata\dubbo-metadata-api\src\main\java\org\apache\dubbo\metadata\report\MetadataScopeModelInitializer.java,18,4,2,1,0,7
dubbo-3.0\dubbo-3.0\dubbo-remoting\dubbo-remoting-api\src\test\java\org\apache\dubbo\remoting\TelnetServer.java,28,8,1,2,0,11
dubbo-3.0\dubbo-3.0\dubbo-rpc\dubbo-rpc-api\src\test\java\org\apache\dubbo\rpc\TimeoutCountDownTest.java,18,13,0,6,0,19
dubbo-3.0\dubbo-3.0\dubbo-config\dubbo-config-spring\src\test\java\org\apache\dubbo\config\spring\SimpleRegistryExporter.java,34,20,1,9,0,30
dubbo-3.0\dubbo-3.0\dubbo-remoting\dubbo-remoting-api\src\main\java\org\apache\dubbo\remoting\transport\dispatcher\all\AllDispatcher.java,11,5,0,1,0,6
dubbo-3.0\dubbo-3.0\dubbo-common\src\main\java\org\apache\dubbo\common\extension\SPI.java,0,9,0,7,0,16
dubbo-3.0\dubbo-3.0\dubbo-common\src\test\java\org\apache\dubbo\metadata\definition\ServiceDefinitionBuilderTest.java,86,38,1,35,0,74
dubbo-3.0\dubbo-3.0\dubbo-remoting\dubbo-remoting-api\src\test\java\org\apache\dubbo\remoting\transport\dispatcher\ChannelEventRunnableTest.java,32,18,0,16,0,34
dubbo-3.0\dubbo-3.0\dubbo-common\src\main\java\org\apache\dubbo\common\utils\NetUtils.java,644,152,19,47,0,218
dubbo-3.0\dubbo-3.0\dubbo-config\dubbo-config-spring\src\test\java\org\apache\dubbo\config\spring\status\DataSourceStatusCheckerTest.java,66,17,2,7,0,26
dubbo-3.0\dubbo-3.0\dubbo-registry\dubbo-registry-api\src\main\java\org\apache\dubbo\registry\RegistryService.java,0,22,0,23,0,45
dubbo-3.0\dubbo-3.0\dubbo-remoting\dubbo-remoting-api\src\test\java\org\apache\dubbo\remoting\exchange\MockExchanger.java,15,11,0,3,0,14
dubbo-3.0\dubbo-3.0\dubbo-cluster\src\test\java\org\apache\dubbo\rpc\cluster\support\merger\DefaultProviderURLMergeProcessorTest.java,132,40,0,34,0,74
dubbo-3.0\dubbo-3.0\dubbo-common\src\test\java\org\apache\dubbo\common\extension\inject\AdaptiveExtensionInjectorTest.java,27,12,0,10,0,22
dubbo-3.0\dubbo-3.0\dubbo-common\src\main\java\org\apache\dubbo\common\status\support\StatusUtils.java,30,4,1,1,0,6
dubbo-3.0\dubbo-3.0\dubbo-remoting\dubbo-remoting-netty4\src\test\java\org\apache\dubbo\remoting\transport\netty4\NettyClientHandlerTest.java,50,16,8,13,0,37
dubbo-3.0\dubbo-3.0\dubbo-rpc\dubbo-rpc-triple\src\main\java\org\apache\dubbo\rpc\protocol\tri\stream\TripleClientStream.java,298,103,0,41,0,144
dubbo-3.0\dubbo-3.0\dubbo-spring-boot\dubbo-spring-boot-compatible\autoconfigure\src\test\java\org\apache\dubbo\spring\boot\context\event\DubboConfigBeanDefinitionConflictApplicationListenerTest.java,67,14,0,10,0,24
dubbo-3.0\dubbo-3.0\dubbo-metadata\dubbo-metadata-processor\src\main\java\org\apache\dubbo\metadata\annotation\processing\builder\MapTypeDefinitionBuilder.java,31,15,0,6,0,21
dubbo-3.0\dubbo-3.0\dubbo-cluster\src\main\java\org\apache\dubbo\rpc\cluster\router\mesh\rule\virtualservice\DubboRouteDetail.java,39,26,0,2,0,28
dubbo-3.0\dubbo-3.0\dubbo-config\dubbo-config-spring\src\test\java\org\apache\dubbo\config\spring\registry\MockServiceDiscovery.java,44,21,4,6,0,31
dubbo-3.0\dubbo-3.0\dubbo-registry\dubbo-registry-api\src\main\java\org\apache\dubbo\registry\client\ServiceInstance.java,0,22,0,4,0,26
dubbo-3.0\dubbo-3.0\dubbo-plugin\dubbo-qos\src\main\java\org\apache\dubbo\qos\server\handler\QosProcessHandler.java,78,31,0,6,0,37
dubbo-3.0\dubbo-3.0\dubbo-rpc\dubbo-rpc-dubbo\src\test\java\org\apache\dubbo\rpc\protocol\dubbo\support\EnumBak.java,167,40,0,31,0,71
dubbo-3.0\dubbo-3.0\dubbo-common\src\main\java\org\apache\dubbo\common\utils\IOUtils.java,224,44,4,13,0,61
dubbo-3.0\dubbo-3.0\dubbo-remoting\dubbo-remoting-netty\src\test\java\org\apache\dubbo\remoting\transport\netty\NettyBackedChannelBufferTest.java,37,11,0,3,0,14
dubbo-3.0\dubbo-3.0\dubbo-common\src\main\java\org\apache\dubbo\common\url\component\ServiceConfigURL.java,137,115,4,21,0,140
dubbo-3.0\dubbo-3.0\dubbo-common\src\test\java\org\apache\dubbo\common\extension\director\FooFrameworkProvider.java,0,1,0,1,0,2
dubbo-3.0\dubbo-3.0\dubbo-compatible\src\main\java\com\alibaba\dubbo\common\URL.java,0,350,33,43,0,426
dubbo-3.0\dubbo-3.0\dubbo-monitor\dubbo-monitor-default\src\test\java\org\apache\dubbo\monitor\dubbo\DubboMonitorFactoryTest.java,31,9,0,6,0,15
dubbo-3.0\dubbo-3.0\dubbo-remoting\dubbo-remoting-api\src\main\java\org\apache\dubbo\remoting\api\Connection.java,0,74,2,21,0,97
dubbo-3.0\dubbo-3.0\dubbo-compatible\src\test\java\org\apache\dubbo\common\extension\MyExtensionFactory.java,20,7,0,1,0,8
dubbo-3.0\dubbo-3.0\dubbo-config\dubbo-config-api\src\test\java\org\apache\dubbo\config\integration\single\SingleRegistryCenterExportedServiceListener.java,11,3,0,4,0,7
dubbo-3.0\dubbo-3.0\dubbo-demo\dubbo-demo-native\dubbo-demo-native-consumer\src\main\java\com\apache\dubbo\demo\graalvm\consumer\Application.java,51,7,1,3,0,11
dubbo-3.0\dubbo-3.0\dubbo-remoting\dubbo-remoting-api\src\test\java\org\apache\dubbo\remoting\PerformanceClientTest.java,188,34,2,21,0,57
dubbo-3.0\dubbo-3.0\dubbo-spring-boot\dubbo-spring-boot-compatible\autoconfigure\src\test\java\org\apache\dubbo\spring\boot\TestSuite.java,3,1,0,9,0,10
dubbo-3.0\dubbo-3.0\dubbo-compatible\src\test\java\org\apache\dubbo\service\DemoService.java,0,13,0,2,0,15
dubbo-3.0\dubbo-3.0\dubbo-compatible\src\main\java\com\alibaba\dubbo\common\Constants.java,0,2,0,1,0,3
dubbo-3.0\dubbo-3.0\dubbo-remoting\dubbo-remoting-api\src\main\java\org\apache\dubbo\remoting\exchange\support\header\HeaderExchangeHandler.java,186,45,4,16,0,65
dubbo-3.0\dubbo-3.0\dubbo-cluster\src\main\java\org\apache\dubbo\rpc\cluster\RouterChain.java,314,113,10,37,0,160
dubbo-3.0\dubbo-3.0\dubbo-common\src\test\java\org\apache\dubbo\common\threadpool\support\eager\TaskQueueTest.java,65,14,0,3,0,17
dubbo-3.0\dubbo-3.0\dubbo-registry\dubbo-registry-api\src\main\java\org\apache\dubbo\registry\client\event\listener\ServiceInstancesChangedListener.java,497,178,14,84,0,276
dubbo-3.0\dubbo-3.0\dubbo-metadata\dubbo-metadata-processor\src\test\java\org\apache\dubbo\metadata\tools\CompilerTest.java,0,2,0,1,0,3
dubbo-3.0\dubbo-3.0\dubbo-common\src\test\java\org\apache\dubbo\rpc\support\MockScopeModelAware.java,0,21,0,2,0,23
dubbo-3.0\dubbo-3.0\dubbo-config\dubbo-config-spring\src\main\java\org\apache\dubbo\config\spring\reference\ReferenceAttributes.java,0,57,53,2,0,112
dubbo-3.0\dubbo-3.0\dubbo-remoting\dubbo-remoting-netty\src\test\java\org\apache\dubbo\remoting\transport\netty\TelnetClientHandler.java,11,8,0,2,0,10
dubbo-3.0\dubbo-3.0\dubbo-rpc\dubbo-rpc-dubbo\src\test\java\org\apache\dubbo\rpc\protocol\dubbo\decode\telnet\TestTelnetHandler.java,8,4,0,1,0,5
dubbo-3.0\dubbo-3.0\dubbo-config\dubbo-config-spring\src\test\java\org\apache\dubbo\config\spring\beans\factory\annotation\ServiceAnnotationTestConfiguration.java,72,17,2,4,0,23
dubbo-3.0\dubbo-3.0\dubbo-common\src\main\java\org\apache\dubbo\common\logger\jdk\JdkLogger.java,110,45,5,1,0,51
dubbo-3.0\dubbo-3.0\dubbo-config\dubbo-config-spring\src\test\java\org\apache\dubbo\config\spring\filter\MockFilter.java,38,27,0,2,0,29
dubbo-3.0\dubbo-3.0\dubbo-rpc\dubbo-rpc-dubbo\src\main\java\org\apache\dubbo\rpc\protocol\dubbo\ReferenceCountExchangeClient.java,0,50,3,11,0,64
dubbo-3.0\dubbo-3.0\dubbo-serialization\dubbo-serialization-api\src\main\java\org\apache\dubbo\common\serialize\DataInput.java,0,0,0,1,0,1
dubbo-3.0\dubbo-3.0\dubbo-common\src\main\java\org\apache\dubbo\common\status\StatusChecker.java,0,2,0,1,0,3
dubbo-3.0\dubbo-3.0\dubbo-common\src\test\java\org\apache\dubbo\common\extension\activate\ActivateExt1.java,0,2,0,1,0,3
dubbo-3.0\dubbo-3.0\dubbo-demo\dubbo-demo-native\dubbo-demo-native-provider\src\main\java\org\apache\dubbo\demo\graalvm\provider\DemoServiceImpl.java,11,4,0,2,0,6
dubbo-3.0\dubbo-3.0\dubbo-rpc\dubbo-rpc-dubbo\src\test\java\org\apache\dubbo\rpc\protocol\dubbo\support\Type.java,0,3,0,1,0,4
dubbo-3.0\dubbo-3.0\dubbo-config\dubbo-config-spring\src\main\java\org\apache\dubbo\config\spring\SpringScopeModelInitializer.java,18,4,3,1,0,8
dubbo-3.0\dubbo-3.0\dubbo-metadata\dubbo-metadata-processor\src\test\java\org\apache\dubbo\metadata\annotation\processing\builder\CollectionTypeDefinitionBuilderTest.java,69,30,0,18,0,48
dubbo-3.0\dubbo-3.0\dubbo-rpc\dubbo-rpc-triple\src\main\java\org\apache\dubbo\rpc\protocol\tri\observer\CallStreamObserver.java,0,6,0,4,0,10
dubbo-3.0\dubbo-3.0\dubbo-registry\dubbo-registry-api\src\main\java\org\apache\dubbo\registry\client\event\RetryServiceInstancesChangedEvent.java,14,9,1,3,0,13
dubbo-3.0\dubbo-3.0\dubbo-common\src\test\java\org\apache\dubbo\common\extension\support\Filter0.java,0,0,0,1,0,1
dubbo-3.0\dubbo-3.0\dubbo-rpc\dubbo-rpc-api\src\test\java\org\apache\dubbo\rpc\filter\ContextFilterTest.java,38,12,1,2,0,15
dubbo-3.0\dubbo-3.0\dubbo-remoting\dubbo-remoting-api\src\main\java\org\apache\dubbo\remoting\exchange\Exchangers.java,86,61,1,15,0,77
dubbo-3.0\dubbo-3.0\dubbo-common\src\main\java\org\apache\dubbo\common\logger\jdk\JdkLoggerAdapter.java,111,22,11,8,0,41
dubbo-3.0\dubbo-3.0\dubbo-remoting\dubbo-remoting-netty4\src\test\java\org\apache\dubbo\remoting\transport\netty4\Hello.java,23,12,1,1,0,14
dubbo-3.0\dubbo-3.0\dubbo-remoting\dubbo-remoting-http\src\main\java\org\apache\dubbo\remoting\http\servlet\BootstrapListener.java,13,9,0,4,0,13
dubbo-3.0\dubbo-3.0\dubbo-rpc\dubbo-rpc-api\src\main\java\org\apache\dubbo\rpc\Constants.java,0,56,51,5,0,112
dubbo-3.0\dubbo-3.0\dubbo-test\dubbo-test-common\src\main\java\org\apache\dubbo\test\common\impl\GreetingServiceImpl.java,7,1,0,1,0,2
dubbo-3.0\dubbo-3.0\dubbo-demo\dubbo-demo-interface\src\main\java\org\apache\dubbo\demo\GreetingService.java,0,1,0,1,0,2
dubbo-3.0\dubbo-3.0\dubbo-compatible\src\test\java\org\apache\dubbo\filter\LegacyInvocation.java,70,30,1,2,0,33
dubbo-3.0\dubbo-3.0\dubbo-metadata\dubbo-metadata-api\src\main\java\org\apache\dubbo\metadata\report\MetadataReportFactory.java,0,3,1,1,0,5
dubbo-3.0\dubbo-3.0\dubbo-plugin\dubbo-qos\src\test\java\org\apache\dubbo\qos\command\impl\PublishMetadataTest.java,43,16,0,6,0,22
dubbo-3.0\dubbo-3.0\dubbo-registry\dubbo-registry-api\src\main\java\org\apache\dubbo\registry\client\migration\MigrationRuleHandler.java,111,46,6,19,0,71
dubbo-3.0\dubbo-3.0\dubbo-remoting\dubbo-remoting-api\src\main\java\org\apache\dubbo\remoting\telnet\support\TelnetUtils.java,136,16,5,6,0,27
dubbo-3.0\dubbo-3.0\dubbo-cluster\src\test\java\org\apache\dubbo\rpc\cluster\router\mesh\rule\virtualservice\match\DubboMethodMatchTest.java,125,22,0,11,0,33
dubbo-3.0\dubbo-3.0\dubbo-common\src\test\java\org\apache\dubbo\common\utils\AnnotationUtilsTest.java,326,64,7,41,0,112
dubbo-3.0\dubbo-3.0\dubbo-common\src\main\java\org\apache\dubbo\common\extension\ExtensionPostProcessor.java,0,4,0,3,0,7
dubbo-3.0\dubbo-3.0\dubbo-rpc\dubbo-rpc-api\src\main\java\org\apache\dubbo\rpc\protocol\AbstractInvoker.java,248,90,5,32,0,127
dubbo-3.0\dubbo-3.0\dubbo-rpc\dubbo-rpc-triple\src\main\java\org\apache\dubbo\rpc\protocol\tri\ServerStreamObserver.java,0,1,0,1,0,2
dubbo-3.0\dubbo-3.0\dubbo-config\dubbo-config-spring\src\test\java\org\apache\dubbo\config\spring\api\DemoServiceSon.java,0,1,0,1,0,2
dubbo-3.0\dubbo-3.0\dubbo-common\src\test\java\org\apache\dubbo\common\extension\ext8_add\impl\AddExt1_ManualAdd1.java,6,5,1,1,0,7
dubbo-3.0\dubbo-3.0\dubbo-rpc\dubbo-rpc-triple\src\main\java\org\apache\dubbo\rpc\protocol\tri\call\ClientCall.java,0,4,0,2,0,6
dubbo-3.0\dubbo-3.0\dubbo-rpc\dubbo-rpc-dubbo\src\main\java\org\apache\dubbo\rpc\protocol\dubbo\CallbackServiceCodec.java,291,141,11,72,0,224
dubbo-3.0\dubbo-3.0\dubbo-rpc\dubbo-rpc-rest\src\main\java\org\apache\dubbo\rpc\protocol\rest\DubboHttpProtocolServer.java,94,28,0,10,0,38
dubbo-3.0\dubbo-3.0\dubbo-cluster\src\main\java\org\apache\dubbo\rpc\cluster\interceptor\ClusterInterceptor.java,0,14,0,8,0,22
dubbo-3.0\dubbo-3.0\dubbo-remoting\dubbo-remoting-netty\src\main\java\org\apache\dubbo\remoting\transport\netty\NettyBackedChannelBuffer.java,424,155,0,6,0,161
dubbo-3.0\dubbo-3.0\dubbo-common\src\main\java\org\apache\dubbo\rpc\model\FrameworkModel.java,316,68,8,25,0,101
dubbo-3.0\dubbo-3.0\dubbo-rpc\dubbo-rpc-triple\src\test\java\org\apache\dubbo\rpc\protocol\tri\DeadlineFutureTest.java,0,5,0,3,0,8
dubbo-3.0\dubbo-3.0\dubbo-config\dubbo-config-spring\src\main\java\org\apache\dubbo\config\spring\beans\factory\config\DubboConfigDefaultPropertyValueBeanPostProcessor.java,0,28,0,15,0,43
dubbo-3.0\dubbo-3.0\dubbo-remoting\dubbo-remoting-api\src\main\java\org\apache\dubbo\remoting\exchange\PortUnificationExchanger.java,31,13,2,5,0,20
dubbo-3.0\dubbo-3.0\dubbo-common\src\main\java\org\apache\dubbo\common\url\component\param\IgnoredParam.java,13,3,2,1,0,6
dubbo-3.0\dubbo-3.0\dubbo-serialization\dubbo-serialization-jdk\src\main\java\org\apache\dubbo\common\serialize\java\CompactedObjectInputStream.java,34,12,0,4,0,16
dubbo-3.0\dubbo-3.0\dubbo-metadata\dubbo-metadata-processor\src\main\java\org\apache\dubbo\metadata\annotation\processing\builder\DeclaredTypeDefinitionBuilder.java,0,4,0,4,0,8
dubbo-3.0\dubbo-3.0\dubbo-registry\dubbo-registry-api\src\test\java\org\apache\dubbo\registry\client\support\MockServiceDiscoveryFactory.java,7,3,0,2,0,5
dubbo-3.0\dubbo-3.0\dubbo-common\src\test\java\org\apache\dubbo\common\extension\director\impl\TestAppProvider.java,7,1,1,1,0,3
dubbo-3.0\dubbo-3.0\dubbo-registry\dubbo-registry-api\src\main\java\org\apache\dubbo\registry\integration\DynamicDirectory.java,304,120,16,32,0,168
dubbo-3.0\dubbo-3.0\dubbo-registry\dubbo-registry-api\src\test\java\org\apache\dubbo\registry\MockLogger.java,113,31,14,1,0,46
dubbo-3.0\dubbo-3.0\dubbo-config\dubbo-config-api\src\main\java\org\apache\dubbo\config\bootstrap\builders\ConsumerBuilder.java,0,40,0,4,0,44
dubbo-3.0\dubbo-3.0\dubbo-config\dubbo-config-api\src\test\java\org\apache\dubbo\config\integration\single\SingleRegistryCenterIntegrationServiceImpl.java,12,7,0,3,0,10
dubbo-3.0\dubbo-3.0\dubbo-remoting\dubbo-remoting-api\src\test\java\org\apache\dubbo\remoting\transport\codec\CodecAdapterTest.java,9,3,0,1,0,4
dubbo-3.0\dubbo-3.0\dubbo-rpc\dubbo-rpc-api\src\test\java\org\apache\dubbo\rpc\filter\ExceptionFilterTest.java,97,18,4,13,0,35
dubbo-3.0\dubbo-3.0\dubbo-config\dubbo-config-api\src\main\java\org\apache\dubbo\config\bootstrap\DubboBootstrap.java,0,293,17,52,0,362
dubbo-3.0\dubbo-3.0\dubbo-monitor\dubbo-monitor-api\src\main\java\org\apache\dubbo\monitor\MonitorService.java,0,9,0,10,0,19
dubbo-3.0\dubbo-3.0\dubbo-compatible\src\main\java\com\alibaba\dubbo\remoting\ChannelHandler.java,0,14,5,10,0,29
dubbo-3.0\dubbo-3.0\dubbo-common\src\main\java\org\apache\dubbo\common\status\support\LoadStatusChecker.java,24,7,2,5,0,14
dubbo-3.0\dubbo-3.0\dubbo-remoting\dubbo-remoting-api\src\main\java\org\apache\dubbo\remoting\buffer\DynamicChannelBuffer.java,185,84,0,8,0,92
dubbo-3.0\dubbo-3.0\dubbo-rpc\dubbo-rpc-grpc\src\main\java\org\apache\dubbo\rpc\protocol\grpc\interceptors\ClientInterceptor.java,0,2,0,2,0,4
dubbo-3.0\dubbo-3.0\dubbo-serialization\dubbo-serialization-api\src\main\java\org\apache\dubbo\common\serialize\ObjectOutput.java,0,10,0,8,0,18
dubbo-3.0\dubbo-3.0\dubbo-compatible\src\main\java\com\alibaba\dubbo\monitor\MonitorFactory.java,0,2,0,2,0,4
dubbo-3.0\dubbo-3.0\dubbo-monitor\dubbo-monitor-api\src\main\java\org\apache\dubbo\monitor\Constants.java,0,22,20,1,0,43
dubbo-3.0\dubbo-3.0\dubbo-common\src\test\java\org\apache\dubbo\metadata\definition\MetadataUtils.java,44,10,1,5,0,16
dubbo-3.0\dubbo-3.0\dubbo-config\dubbo-config-spring\src\main\java\org\apache\dubbo\config\spring\reference\ReferenceBeanManager.java,145,59,3,27,0,89
dubbo-3.0\dubbo-3.0\dubbo-metadata\dubbo-metadata-api\src\test\java\org\apache\dubbo\metadata\report\support\AbstractMetadataReportFactoryTest.java,112,50,7,28,0,85
dubbo-3.0\dubbo-3.0\dubbo-rpc\dubbo-rpc-api\src\main\java\org\apache\dubbo\rpc\proxy\InvocationUtil.java,57,20,2,12,0,34
dubbo-3.0\dubbo-3.0\dubbo-rpc\dubbo-rpc-api\src\main\java\org\apache\dubbo\rpc\stub\StubSuppliers.java,45,19,1,5,0,25
dubbo-3.0\dubbo-3.0\dubbo-config\dubbo-config-spring\src\test\java\org\apache\dubbo\config\spring\boot\importxml2\SpringBootImportAndScanTest.java,48,15,0,7,0,22
dubbo-3.0\dubbo-3.0\dubbo-cluster\src\main\java\org\apache\dubbo\rpc\cluster\configurator\override\OverrideConfiguratorFactory.java,9,3,0,1,0,4
dubbo-3.0\dubbo-3.0\dubbo-common\src\main\java\org\apache\dubbo\common\url\component\URLItemCache.java,62,24,1,6,0,31
dubbo-3.0\dubbo-3.0\dubbo-common\src\test\java\org\apache\dubbo\rpc\model\FrameworkServiceRepositoryTest.java,79,25,1,17,0,43
dubbo-3.0\dubbo-3.0\dubbo-demo\dubbo-demo-spring-boot\dubbo-demo-spring-boot-provider\src\main\java\org\apache\dubbo\springboot\demo\provider\ProviderApplication.java,8,3,1,1,0,5
dubbo-3.0\dubbo-3.0\dubbo-rpc\dubbo-rpc-triple\src\test\java\org\apache\dubbo\rpc\protocol\tri\compressor\IdentityTest.java,0,8,0,2,0,10
dubbo-3.0\dubbo-3.0\dubbo-common\src\test\java\org\apache\dubbo\common\utils\ClassUtilsTest.java,126,58,0,44,0,102
dubbo-3.0\dubbo-3.0\dubbo-common\src\main\java\org\apache\dubbo\common\status\support\MemoryStatusChecker.java,16,15,2,3,0,20
dubbo-3.0\dubbo-3.0\dubbo-common\src\main\java\org\apache\dubbo\common\utils\ArrayUtils.java,0,9,0,2,0,11
dubbo-3.0\dubbo-3.0\dubbo-config\dubbo-config-api\src\test\java\org\apache\dubbo\config\provider\impl\DemoServiceImpl.java,24,15,0,1,0,16
dubbo-3.0\dubbo-3.0\dubbo-config\dubbo-config-spring\src\test\java\org\apache\dubbo\config\spring\issues\issue7003\Issue7003Test.java,46,10,2,6,0,18
dubbo-3.0\dubbo-3.0\dubbo-common\src\main\java\org\apache\dubbo\common\utils\MD5Utils.java,43,15,1,3,0,19
dubbo-3.0\dubbo-3.0\dubbo-remoting\dubbo-remoting-api\src\main\java\org\apache\dubbo\remoting\transport\DecodeHandler.java,42,12,1,5,0,18
dubbo-3.0\dubbo-3.0\dubbo-rpc\dubbo-rpc-api\src\test\java\org\apache\dubbo\rpc\support\RpcUtilsTest.java,334,67,77,40,0,184
dubbo-3.0\dubbo-3.0\dubbo-cluster\src\main\java\org\apache\dubbo\registry\AddressListener.java,0,5,1,2,0,8
dubbo-3.0\dubbo-3.0\dubbo-common\src\main\java\org\apache\dubbo\config\ReferenceConfigBase.java,311,103,4,21,0,128
dubbo-3.0\dubbo-3.0\dubbo-registry\dubbo-registry-api\src\test\java\org\apache\dubbo\registry\RegistryFactoryWrapperTest.java,32,14,0,13,0,27
dubbo-3.0\dubbo-3.0\dubbo-rpc\dubbo-rpc-dubbo\src\main\java\org\apache\dubbo\rpc\protocol\dubbo\DecodeableRpcResult.java,0,47,2,17,0,66
dubbo-3.0\dubbo-3.0\dubbo-cluster\src\main\java\org\apache\dubbo\rpc\cluster\loadbalance\AbstractLoadBalance.java,67,23,1,10,0,34
dubbo-3.0\dubbo-3.0\dubbo-cluster\src\main\java\org\apache\dubbo\rpc\cluster\router\tag\TagStateRouter.java,239,95,1,48,0,144
dubbo-3.0\dubbo-3.0\dubbo-common\src\main\java\com\alibaba\dubbo\config\annotation\Service.java,0,46,0,1,0,47
dubbo-3.0\dubbo-3.0\dubbo-registry\dubbo-registry-api\src\test\java\org\apache\dubbo\registry\client\metadata\store\CustomizedParamsFilter.java,16,4,0,2,0,6
dubbo-3.0\dubbo-3.0\dubbo-common\src\main\java\org\apache\dubbo\common\url\component\param\DefaultDynamicParamSource.java,44,5,0,2,0,7
dubbo-3.0\dubbo-3.0\dubbo-compatible\src\test\java\org\apache\dubbo\config\ReferenceConfigTest.java,52,8,0,1,0,9
dubbo-3.0\dubbo-3.0\dubbo-compatible\src\test\java\org\apache\dubbo\config\RegistryConfigTest.java,142,25,0,2,0,27
dubbo-3.0\dubbo-3.0\dubbo-config\dubbo-config-spring\src\test\java\org\apache\dubbo\config\spring\impl\DemoServiceSonImpl.java,22,12,0,1,0,13
dubbo-3.0\dubbo-3.0\dubbo-rpc\dubbo-rpc-dubbo\src\main\java\org\apache\dubbo\rpc\protocol\dubbo\filter\FutureFilter.java,0,35,9,21,0,65
dubbo-3.0\dubbo-3.0\dubbo-compatible\src\main\java\com\alibaba\dubbo\rpc\Exporter.java,0,7,0,1,0,8
dubbo-3.0\dubbo-3.0\dubbo-remoting\dubbo-remoting-api\src\main\java\org\apache\dubbo\remoting\transport\ChannelHandlerDelegate.java,0,1,0,1,0,2
dubbo-3.0\dubbo-3.0\dubbo-registry\dubbo-registry-api\src\test\java\org\apache\dubbo\registry\ListenerRegistryWrapperTest.java,48,6,4,4,0,14
dubbo-3.0\dubbo-3.0\dubbo-common\src\test\java\org\apache\dubbo\common\config\configcenter\AbstractDynamicConfigurationFactoryTest.java,21,8,0,2,0,10
dubbo-3.0\dubbo-3.0\dubbo-remoting\dubbo-remoting-api\src\main\java\org\apache\dubbo\remoting\exchange\support\ReplierDispatcher.java,51,28,0,6,0,34
dubbo-3.0\dubbo-3.0\dubbo-common\src\main\java\org\apache\dubbo\common\threadlocal\InternalRunnable.java,28,26,1,5,0,32
dubbo-3.0\dubbo-3.0\dubbo-registry\dubbo-registry-nacos\src\main\java\org\apache\dubbo\registry\nacos\NacosServiceName.java,199,72,2,7,0,81
dubbo-3.0\dubbo-3.0\dubbo-remoting\dubbo-remoting-api\src\main\java\org\apache\dubbo\remoting\exchange\support\header\AbstractTimerTask.java,68,20,1,2,0,23
dubbo-3.0\dubbo-3.0\dubbo-rpc\dubbo-rpc-grpc\src\main\java\org\apache\dubbo\rpc\protocol\grpc\DubboHandlerRegistry.java,41,17,2,6,0,25
dubbo-3.0\dubbo-3.0\dubbo-registry\dubbo-registry-api\src\test\java\org\apache\dubbo\registry\client\InstanceAddressURLTest.java,120,63,2,41,0,106
dubbo-3.0\dubbo-3.0\dubbo-registry\dubbo-registry-api\src\test\java\org\apache\dubbo\registry\client\metadata\ProtocolPortsMetadataCustomizerTest.java,54,33,5,13,0,51
dubbo-3.0\dubbo-3.0\dubbo-registry\dubbo-registry-zookeeper\src\main\java\org\apache\dubbo\registry\zookeeper\util\CuratorFrameworkParams.java,0,24,1,5,0,30
dubbo-3.0\dubbo-3.0\dubbo-plugin\dubbo-qos\src\test\java\org\apache\dubbo\qos\command\impl\StartupTest.java,44,16,0,10,0,26
dubbo-3.0\dubbo-3.0\dubbo-common\src\main\java\org\apache\dubbo\common\convert\multiple\StringToIterableConverter.java,54,22,0,8,0,30
dubbo-3.0\dubbo-3.0\dubbo-config\dubbo-config-spring\src\test\java\org\apache\dubbo\config\spring\api\Box.java,0,2,0,1,0,3
dubbo-3.0\dubbo-3.0\dubbo-common\src\main\java\org\apache\dubbo\common\timer\HashedWheelTimer.java,736,186,7,68,0,261
dubbo-3.0\dubbo-3.0\dubbo-test\dubbo-test-check\src\main\java\org\apache\dubbo\test\check\registrycenter\Context.java,0,0,0,1,0,1
dubbo-3.0\dubbo-3.0\dubbo-registry\dubbo-registry-api\src\main\java\org\apache\dubbo\registry\status\RegistryStatusChecker.java,34,8,0,2,0,10
dubbo-3.0\dubbo-3.0\dubbo-config\dubbo-config-api\src\test\java\org\apache\dubbo\config\bootstrap\DubboBootstrapTest.java,296,80,8,47,0,135
dubbo-3.0\dubbo-3.0\dubbo-cluster\src\main\java\org\apache\dubbo\rpc\cluster\router\mesh\rule\virtualservice\DubboMatchRequest.java,87,51,0,6,0,57
dubbo-3.0\dubbo-3.0\dubbo-cluster\src\main\java\org\apache\dubbo\rpc\cluster\router\mesh\util\MeshRuleDispatcher.java,75,30,1,10,0,41
dubbo-3.0\dubbo-3.0\dubbo-compatible\src\main\java\com\alibaba\dubbo\container\page\pages\StatusPageHandler.java,49,12,0,7,0,19
dubbo-3.0\dubbo-3.0\dubbo-config\dubbo-config-spring\src\main\java\org\apache\dubbo\config\spring\context\DubboConfigApplicationListener.java,0,20,2,9,0,31
dubbo-3.0\dubbo-3.0\dubbo-compatible\src\main\java\com\alibaba\dubbo\rpc\protocol\rest\support\ContentType.java,0,2,0,2,0,4
dubbo-3.0\dubbo-3.0\dubbo-cluster\src\main\java\org\apache\dubbo\rpc\cluster\router\state\RouterGroupingState.java,54,23,0,3,0,26
dubbo-3.0\dubbo-3.0\dubbo-metadata\dubbo-metadata-api\src\test\java\org\apache\dubbo\metadata\MetadataInfoTest.java,102,41,1,23,0,65
dubbo-3.0\dubbo-3.0\dubbo-registry\dubbo-registry-nacos\src\test\java\org\apache\dubbo\registry\nacos\NacosServiceDiscoveryFactoryTest.java,21,7,0,3,0,10
dubbo-3.0\dubbo-3.0\dubbo-registry\dubbo-registry-api\src\main\java\org\apache\dubbo\registry\NotifyListener.java,0,10,1,9,0,20
dubbo-3.0\dubbo-3.0\dubbo-remoting\dubbo-remoting-api\src\main\java\org\apache\dubbo\remoting\buffer\HeapChannelBuffer.java,192,74,0,6,0,80
dubbo-3.0\dubbo-3.0\dubbo-common\src\main\java\org\apache\dubbo\common\url\component\URLParam.java,1057,240,3,92,0,335
dubbo-3.0\dubbo-3.0\dubbo-common\src\test\java\org\apache\dubbo\common\utils\DefaultPageTest.java,15,7,0,2,0,9
dubbo-3.0\dubbo-3.0\dubbo-registry\dubbo-registry-api\src\main\java\org\apache\dubbo\registry\client\ServiceDiscoveryService.java,0,3,0,1,0,4
dubbo-3.0\dubbo-3.0\dubbo-serialization\dubbo-serialization-jdk\src\main\java\org\apache\dubbo\common\serialize\nativejava\NativeJavaObjectOutput.java,87,31,0,1,0,32
dubbo-3.0\dubbo-3.0\dubbo-cluster\src\main\java\org\apache\dubbo\rpc\cluster\router\AbstractRouterRule.java,122,72,0,1,0,73
dubbo-3.0\dubbo-3.0\dubbo-cluster\src\main\java\org\apache\dubbo\rpc\cluster\support\AbstractClusterInvoker.java,392,127,9,63,0,199
dubbo-3.0\dubbo-3.0\dubbo-rpc\dubbo-rpc-api\src\main\java\org\apache\dubbo\rpc\ZoneDetector.java,0,3,0,2,0,5
dubbo-3.0\dubbo-3.0\dubbo-cluster\src\main\java\org\apache\dubbo\rpc\cluster\support\AvailableCluster.java,10,5,0,2,0,7
dubbo-3.0\dubbo-3.0\dubbo-common\src\main\java\org\apache\dubbo\common\function\ThrowableConsumer.java,0,6,2,1,0,9
dubbo-3.0\dubbo-3.0\dubbo-common\src\main\java\org\apache\dubbo\common\convert\multiple\StringToArrayConverter.java,37,17,1,4,0,22
dubbo-3.0\dubbo-3.0\dubbo-plugin\dubbo-qos\src\main\java\org\apache\dubbo\qos\command\impl\PortTelnet.java,65,10,0,5,0,15
dubbo-3.0\dubbo-3.0\dubbo-registry\dubbo-registry-api\src\test\java\org\apache\dubbo\registry\client\metadata\store\MetaCacheManagerTest.java,91,16,1,11,0,28
dubbo-3.0\dubbo-3.0\dubbo-rpc\dubbo-rpc-api\src\test\java\org\apache\dubbo\rpc\support\MockInvocation.java,133,55,2,2,0,59
dubbo-3.0\dubbo-3.0\dubbo-cluster\src\test\java\org\apache\dubbo\rpc\cluster\router\mesh\route\StandardMeshRuleRouterFactoryTest.java,9,3,0,3,0,6
dubbo-3.0\dubbo-3.0\dubbo-common\src\test\java\org\apache\dubbo\common\config\configcenter\DynamicConfigurationFactoryTest.java,10,4,0,5,0,9
dubbo-3.0\dubbo-3.0\dubbo-common\src\test\java\org\apache\dubbo\common\utils\MyEnum.java,0,3,0,1,0,4
dubbo-3.0\dubbo-3.0\dubbo-common\src\main\java\org\apache\dubbo\common\constants\CommonConstants.java,0,243,229,19,0,491
dubbo-3.0\dubbo-3.0\dubbo-registry\dubbo-registry-api\src\main\java\org\apache\dubbo\registry\retry\FailedUnsubscribedTask.java,0,13,0,3,0,16
dubbo-3.0\dubbo-3.0\dubbo-common\src\test\java\org\apache\dubbo\common\extension\director\impl\TestModuleService.java,58,37,1,2,0,40
dubbo-3.0\dubbo-3.0\dubbo-common\src\test\java\org\apache\dubbo\metadata\definition\MetadataTest.java,114,29,4,25,0,58
dubbo-3.0\dubbo-3.0\dubbo-remoting\dubbo-remoting-api\src\main\java\org\apache\dubbo\remoting\RemotingScopeModelInitializer.java,30,10,3,4,0,17
dubbo-3.0\dubbo-3.0\dubbo-plugin\dubbo-qos\src\main\java\org\apache\dubbo\qos\textui\TTree.java,236,68,2,7,0,77
dubbo-3.0\dubbo-3.0\dubbo-plugin\dubbo-qos\src\test\java\org\apache\dubbo\qos\command\impl\ReadyTest.java,50,20,1,13,0,34
dubbo-3.0\dubbo-3.0\dubbo-rpc\dubbo-rpc-dubbo\src\test\java\org\apache\dubbo\rpc\protocol\dubbo\support\DemoService.java,0,23,0,1,0,24
dubbo-3.0\dubbo-3.0\dubbo-config\dubbo-config-api\src\test\java\org\apache\dubbo\config\utils\service\XxxServiceImpl.java,3,0,0,1,0,1
dubbo-3.0\dubbo-3.0\dubbo-metadata\dubbo-metadata-processor\src\main\java\org\apache\dubbo\metadata\annotation\processing\rest\jaxrs\QueryParamParameterProcessor.java,8,5,0,5,0,10
dubbo-3.0\dubbo-3.0\dubbo-plugin\dubbo-qos\src\test\java\org\apache\dubbo\qos\command\CommandContextFactoryTest.java,12,3,0,2,0,5
dubbo-3.0\dubbo-3.0\dubbo-config\dubbo-config-api\src\test\java\org\apache\dubbo\config\mock\TestProxyFactory.java,10,7,0,2,0,9
dubbo-3.0\dubbo-3.0\dubbo-common\src\main\java\org\apache\dubbo\config\context\ConfigValidator.java,0,1,0,1,0,2
dubbo-3.0\dubbo-3.0\dubbo-cluster\src\main\java\org\apache\dubbo\rpc\cluster\router\mesh\route\MeshEnvListener.java,0,3,0,1,0,4
dubbo-3.0\dubbo-3.0\dubbo-serialization\dubbo-serialization-api\src\main\java\org\apache\dubbo\common\serialize\ObjectInput.java,0,19,0,12,0,31
dubbo-3.0\dubbo-3.0\dubbo-common\src\main\java\org\apache\dubbo\common\extension\AdaptiveClassCodeGenerator.java,383,158,1,50,0,209
dubbo-3.0\dubbo-3.0\dubbo-common\src\test\java\org\apache\dubbo\common\convert\multiple\StringToDequeConverterTest.java,67,13,5,5,0,23
dubbo-3.0\dubbo-3.0\dubbo-compatible\src\main\java\com\alibaba\dubbo\common\serialize\ObjectInput.java,0,2,0,2,0,4
dubbo-3.0\dubbo-3.0\dubbo-config\dubbo-config-api\src\test\java\org\apache\dubbo\config\mock\MockProtocol.java,64,8,2,2,0,12
dubbo-3.0\dubbo-3.0\dubbo-common\src\test\java\org\apache\dubbo\common\convert\multiple\StringToCollectionConverterTest.java,68,13,3,5,0,21
dubbo-3.0\dubbo-3.0\dubbo-test\dubbo-test-check\src\main\java\org\apache\dubbo\test\check\registrycenter\GlobalRegistryCenter.java,35,2,1,2,0,5
dubbo-3.0\dubbo-3.0\dubbo-demo\dubbo-demo-annotation\dubbo-demo-annotation-provider\src\main\java\org\apache\dubbo\demo\provider\DemoServiceImpl.java,16,9,1,4,0,14
dubbo-3.0\dubbo-3.0\dubbo-spring-boot\dubbo-spring-boot-compatible\actuator\src\main\java\org\apache\dubbo\spring\boot\actuate\endpoint\metadata\DubboShutdownMetadata.java,46,6,0,3,0,9
dubbo-3.0\dubbo-3.0\dubbo-common\src\test\java\org\apache\dubbo\rpc\model\person\PersonInfo.java,186,117,21,9,0,147
dubbo-3.0\dubbo-3.0\dubbo-remoting\dubbo-remoting-api\src\main\java\org\apache\dubbo\remoting\api\PortUnificationServerHandler.java,105,44,2,9,0,55
dubbo-3.0\dubbo-3.0\dubbo-config\dubbo-config-spring\src\test\java\org\apache\dubbo\config\spring\boot\configprops\SpringBootConfigPropsTest.java,76,32,1,25,0,58
dubbo-3.0\dubbo-3.0\dubbo-config\dubbo-config-spring\src\test\java\org\apache\dubbo\config\spring\api\MethodCallback.java,0,12,0,1,0,13
dubbo-3.0\dubbo-3.0\dubbo-metadata\dubbo-metadata-processor\src\test\java\org\apache\dubbo\metadata\annotation\processing\builder\MapTypeDefinitionBuilderTest.java,98,36,0,20,0,56
dubbo-3.0\dubbo-3.0\dubbo-monitor\dubbo-monitor-default\src\main\java\org\apache\dubbo\monitor\dubbo\Statistics.java,185,64,0,2,0,66
dubbo-3.0\dubbo-3.0\dubbo-common\src\test\java\org\apache\dubbo\metadata\definition\TestTypeBuilder.java,18,11,0,2,0,13
dubbo-3.0\dubbo-3.0\dubbo-config\dubbo-config-api\src\test\java\org\apache\dubbo\config\integration\multiple\exportprovider\MultipleRegistryCenterExportProviderIntegrationTest.java,199,58,2,43,0,103
dubbo-3.0\dubbo-3.0\dubbo-compatible\src\main\java\com\alibaba\dubbo\remoting\exchange\ResponseFuture.java,0,1,0,1,0,2
dubbo-3.0\dubbo-3.0\dubbo-test\dubbo-test-check\src\main\java\org\apache\dubbo\test\check\registrycenter\config\ZookeeperRegistryCenterConfig.java,62,10,1,4,0,15
dubbo-3.0\dubbo-3.0\dubbo-test\dubbo-test-check\src\main\java\org\apache\dubbo\test\check\registrycenter\initializer\ZookeeperInitializer.java,24,5,0,3,0,8
dubbo-3.0\dubbo-3.0\dubbo-spring-boot\dubbo-spring-boot-compatible\autoconfigure\src\test\java\org\apache\dubbo\spring\boot\env\DubboDefaultPropertiesEnvironmentPostProcessorTest.java,66,21,0,16,0,37
dubbo-3.0\dubbo-3.0\dubbo-test\dubbo-test-check\src\main\java\org\apache\dubbo\test\check\registrycenter\processor\StartZookeeperWindowsProcessor.java,48,17,1,13,0,31
dubbo-3.0\dubbo-3.0\dubbo-config\dubbo-config-spring\src\main\java\org\apache\dubbo\config\spring\beans\factory\annotation\ServiceAnnotationPostProcessor.java,0,207,5,111,0,323
dubbo-3.0\dubbo-3.0\dubbo-config\dubbo-config-spring\src\main\java\org\apache\dubbo\config\spring\reference\ReferenceBeanSupport.java,222,68,3,43,0,114
dubbo-3.0\dubbo-3.0\dubbo-rpc\dubbo-rpc-api\src\main\java\org\apache\dubbo\rpc\filter\tps\DefaultTPSLimiter.java,34,12,0,8,0,20
dubbo-3.0\dubbo-3.0\dubbo-metadata\dubbo-metadata-processor\src\main\java\org\apache\dubbo\metadata\annotation\processing\util\AnnotationUtils.java,0,94,0,57,0,151
dubbo-3.0\dubbo-3.0\dubbo-remoting\dubbo-remoting-api\src\main\java\org\apache\dubbo\remoting\transport\AbstractClient.java,312,80,19,39,0,138
dubbo-3.0\dubbo-3.0\dubbo-native\src\main\java\org\apache\dubbo\rpc\cluster\ConfiguratorFactory$Adaptive.java,0,15,11,6,0,32
dubbo-3.0\dubbo-3.0\dubbo-common\src\test\java\org\apache\dubbo\common\extension\activate\impl\ActivateExt1Impl1.java,6,4,0,1,0,5
dubbo-3.0\dubbo-3.0\dubbo-cluster\src\main\java\org\apache\dubbo\rpc\cluster\router\mesh\rule\virtualservice\VirtualServiceRule.java,20,11,0,1,0,12
dubbo-3.0\dubbo-3.0\dubbo-common\src\test\java\org\apache\dubbo\common\threadpool\manager\FrameworkExecutorRepositoryTest.java,75,25,0,7,0,32
dubbo-3.0\dubbo-3.0\dubbo-common\src\test\java\org\apache\dubbo\common\convert\StringToFloatConverterTest.java,24,7,0,3,0,10
dubbo-3.0\dubbo-3.0\dubbo-compatible\src\main\java\com\alibaba\dubbo\common\status\Status.java,0,10,0,1,0,11
dubbo-3.0\dubbo-3.0\dubbo-common\src\test\java\org\apache\dubbo\common\extension\wrapper\impl\DemoWrapper2.java,12,7,0,1,0,8
dubbo-3.0\dubbo-3.0\dubbo-metadata\dubbo-metadata-api\src\main\java\org\apache\dubbo\metadata\rest\RestMethodMetadata.java,164,88,0,4,0,92
dubbo-3.0\dubbo-3.0\dubbo-rpc\dubbo-rpc-triple\src\test\java\org\apache\dubbo\rpc\protocol\tri\ExceptionUtilsTest.java,0,13,0,6,0,19
dubbo-3.0\dubbo-3.0\dubbo-config\dubbo-config-api\src\main\java\org\apache\dubbo\config\bootstrap\builders\ProviderBuilder.java,0,116,0,3,0,119
dubbo-3.0\dubbo-3.0\dubbo-remoting\dubbo-remoting-api\src\main\java\org\apache\dubbo\remoting\exchange\support\ExchangeHandlerAdapter.java,9,6,0,3,0,9
dubbo-3.0\dubbo-3.0\dubbo-rpc\dubbo-rpc-api\src\test\java\org\apache\dubbo\rpc\filter\TokenFilterTest.java,0,10,0,7,0,17
dubbo-3.0\dubbo-3.0\dubbo-cluster\src\main\java\org\apache\dubbo\rpc\cluster\router\mesh\rule\virtualservice\destination\DubboRouteDestination.java,21,14,0,2,0,16
dubbo-3.0\dubbo-3.0\dubbo-registry\dubbo-registry-api\src\main\java\org\apache\dubbo\registry\support\AbstractRegistryFactory.java,0,18,0,8,0,26
dubbo-3.0\dubbo-3.0\dubbo-config\dubbo-config-api\src\test\java\org\apache\dubbo\config\integration\single\exportprovider\SingleRegistryCenterExportProviderIntegrationTest.java,193,51,2,39,0,92
dubbo-3.0\dubbo-3.0\dubbo-rpc\dubbo-rpc-triple\src\test\java\org\apache\dubbo\rpc\protocol\tri\transport\WriteQueueTest.java,65,27,1,16,0,44
dubbo-3.0\dubbo-3.0\dubbo-plugin\dubbo-qos\src\main\java\org\apache\dubbo\qos\command\CommandExecutor.java,0,1,0,1,0,2
dubbo-3.0\dubbo-3.0\dubbo-remoting\dubbo-remoting-api\src\main\java\org\apache\dubbo\remoting\exchange\ExchangeHandler.java,0,1,0,2,0,3
dubbo-3.0\dubbo-3.0\dubbo-common\src\test\java\org\apache\dubbo\common\URLBuilderTest.java,120,18,2,8,0,28
dubbo-3.0\dubbo-3.0\dubbo-plugin\dubbo-auth\src\test\java\org\apache\dubbo\auth\DefaultAccessKeyStorageTest.java,0,2,0,3,0,5
dubbo-3.0\dubbo-3.0\dubbo-rpc\dubbo-rpc-dubbo\src\test\java\org\apache\dubbo\rpc\protocol\dubbo\support\CustomArgument.java,30,23,1,1,0,25
dubbo-3.0\dubbo-3.0\dubbo-remoting\dubbo-remoting-netty4\src\main\java\org\apache\dubbo\remoting\transport\netty4\NettyClientHandler.java,120,45,0,16,0,61
dubbo-3.0\dubbo-3.0\dubbo-plugin\dubbo-qos\src\main\java\org\apache\dubbo\qos\command\impl\DisableDetailProfiler.java,11,8,0,3,0,11
dubbo-3.0\dubbo-3.0\dubbo-demo\dubbo-demo-xml\dubbo-demo-xml-provider\src\main\java\org\apache\dubbo\demo\provider\GreetingServiceImpl.java,7,1,0,1,0,2
dubbo-3.0\dubbo-3.0\dubbo-config\dubbo-config-spring\src\main\java\org\apache\dubbo\config\spring\context\event\ServiceBeanExportedEvent.java,21,5,0,2,0,7
dubbo-3.0\dubbo-3.0\dubbo-config\dubbo-config-spring\src\test\java\org\apache\dubbo\config\spring\context\annotation\provider\DemoServiceImpl.java,13,6,0,1,0,7
dubbo-3.0\dubbo-3.0\dubbo-plugin\dubbo-auth\src\main\java\org\apache\dubbo\auth\AccessKeyAuthenticator.java,74,40,0,22,0,62
dubbo-3.0\dubbo-3.0\dubbo-cluster\src\main\java\org\apache\dubbo\rpc\cluster\router\tag\model\TagRuleParser.java,16,3,1,1,0,5
dubbo-3.0\dubbo-3.0\dubbo-rpc\dubbo-rpc-dubbo\src\test\java\org\apache\dubbo\rpc\protocol\dubbo\DecodeableRpcInvocationTest.java,67,26,2,21,0,49
dubbo-3.0\dubbo-3.0\dubbo-config\dubbo-config-spring\src\test\java\org\apache\dubbo\config\spring\beans\factory\annotation\ServiceBeanNameBuilderTest.java,36,18,0,12,0,30
dubbo-3.0\dubbo-3.0\dubbo-common\src\main\java\org\apache\dubbo\config\SslConfig.java,184,136,2,26,0,164
dubbo-3.0\dubbo-3.0\dubbo-common\src\main\java\org\apache\dubbo\common\cache\FileCacheStoreFactory.java,137,35,6,12,0,53
dubbo-3.0\dubbo-3.0\dubbo-common\src\test\java\org\apache\dubbo\common\threadpool\support\eager\EagerThreadPoolTest.java,42,13,0,7,0,20
dubbo-3.0\dubbo-3.0\dubbo-plugin\dubbo-auth\src\main\java\org\apache\dubbo\auth\utils\SignatureUtils.java,69,21,4,8,0,33
dubbo-3.0\dubbo-3.0\dubbo-remoting\dubbo-remoting-api\src\test\java\org\apache\dubbo\remoting\exchange\support\header\HeaderExchangeServerTest.java,56,25,1,17,0,43
dubbo-3.0\dubbo-3.0\dubbo-config\dubbo-config-spring\src\main\java\org\apache\dubbo\config\spring\context\annotation\DubboClassPathBeanDefinitionScanner.java,40,19,0,8,0,27
dubbo-3.0\dubbo-3.0\dubbo-rpc\dubbo-rpc-api\src\main\java\org\apache\dubbo\rpc\stub\StubMethodHandler.java,0,3,0,2,0,5
dubbo-3.0\dubbo-3.0\dubbo-rpc\dubbo-rpc-rest\src\main\java\org\apache\dubbo\rpc\protocol\rest\RestProtocolServer.java,0,4,0,1,0,5
dubbo-3.0\dubbo-3.0\dubbo-plugin\dubbo-qos\src\main\java\org\apache\dubbo\qos\server\handler\HttpProcessHandler.java,55,26,3,13,0,42
dubbo-3.0\dubbo-3.0\dubbo-registry\dubbo-registry-zookeeper\src\main\java\org\apache\dubbo\registry\zookeeper\ZookeeperServiceDiscoveryFactory.java,8,3,0,2,0,5
dubbo-3.0\dubbo-3.0\dubbo-common\src\main\java\org\apache\dubbo\common\threadlocal\InternalThreadLocalMap.java,0,43,0,10,0,53
dubbo-3.0\dubbo-3.0\dubbo-cluster\src\main\java\org\apache\dubbo\rpc\cluster\router\state\TailStateRouter.java,48,11,3,2,0,16
dubbo-3.0\dubbo-3.0\dubbo-common\src\main\java\org\apache\dubbo\common\resource\GlobalResourcesRepository.java,117,29,6,9,0,44
dubbo-3.0\dubbo-3.0\dubbo-common\src\test\java\org\apache\dubbo\common\extension\ext6_inject\Ext6.java,0,2,0,1,0,3
dubbo-3.0\dubbo-3.0\dubbo-config\dubbo-config-spring\src\test\java\org\apache\dubbo\config\spring\context\annotation\consumer\test\TestConsumerConfiguration.java,85,50,0,8,0,58
dubbo-3.0\dubbo-3.0\dubbo-common\src\test\java\org\apache\dubbo\common\timer\HashedWheelTimerTest.java,169,47,4,8,0,59
dubbo-3.0\dubbo-3.0\dubbo-spring-boot\dubbo-spring-boot-compatible\actuator\src\main\java\org\apache\dubbo\spring\boot\actuate\autoconfigure\DubboHealthIndicatorAutoConfiguration.java,10,5,0,5,0,10
dubbo-3.0\dubbo-3.0\dubbo-cluster\src\main\java\org\apache\dubbo\rpc\cluster\router\condition\ConditionStateRouter.java,315,89,5,33,0,127
dubbo-3.0\dubbo-3.0\dubbo-config\dubbo-config-spring\src\test\java\org\apache\dubbo\config\spring\impl\MethodCallbackImpl.java,169,39,0,2,0,41
dubbo-3.0\dubbo-3.0\dubbo-monitor\dubbo-monitor-api\src\main\java\org\apache\dubbo\monitor\support\MonitorServiceDetector.java,9,1,0,1,0,2
dubbo-3.0\dubbo-3.0\dubbo-config\dubbo-config-api\src\test\java\org\apache\dubbo\config\cache\CacheTest.java,97,21,1,9,0,31
dubbo-3.0\dubbo-3.0\dubbo-plugin\dubbo-qos\src\main\java\org\apache\dubbo\qos\command\impl\BaseOnline.java,57,22,0,7,0,29
dubbo-3.0\dubbo-3.0\dubbo-remoting\dubbo-remoting-api\src\main\java\org\apache\dubbo\remoting\exchange\support\MultiMessage.java,0,16,0,1,0,17
dubbo-3.0\dubbo-3.0\dubbo-rpc\dubbo-rpc-api\src\main\java\org\apache\dubbo\rpc\InvokeMode.java,0,3,0,1,0,4
dubbo-3.0\dubbo-3.0\dubbo-common\src\main\java\org\apache\dubbo\common\bytecode\NoSuchPropertyException.java,12,3,0,1,0,4
dubbo-3.0\dubbo-3.0\dubbo-common\src\main\java\org\apache\dubbo\config\nested\AggregationConfig.java,42,22,0,1,0,23
dubbo-3.0\dubbo-3.0\dubbo-common\src\test\java\org\apache\dubbo\common\BaseServiceMetadataTest.java,43,22,0,19,0,41
dubbo-3.0\dubbo-3.0\dubbo-config\dubbo-config-api\src\test\java\org\apache\dubbo\config\ReferenceConfigTest.java,0,261,27,181,0,469
dubbo-3.0\dubbo-3.0\dubbo-rpc\dubbo-rpc-dubbo\src\main\java\org\apache\dubbo\rpc\protocol\dubbo\ChannelWrappedInvoker.java,0,34,3,11,0,48
dubbo-3.0\dubbo-3.0\dubbo-registry\dubbo-registry-nacos\src\main\java\org\apache\dubbo\registry\nacos\NacosRegistryFactory.java,19,6,0,3,0,9
dubbo-3.0\dubbo-3.0\dubbo-common\src\test\java\org\apache\dubbo\common\config\configcenter\ConfigChangedEventTest.java,44,11,0,5,0,16
dubbo-3.0\dubbo-3.0\dubbo-plugin\dubbo-qos\src\test\java\org\apache\dubbo\qos\legacy\TraceTelnetHandlerTest.java,44,12,1,4,0,17
dubbo-3.0\dubbo-3.0\dubbo-rpc\dubbo-rpc-api\src\test\java\org\apache\dubbo\rpc\filter\AccessLogFilterTest.java,47,16,1,10,0,27
dubbo-3.0\dubbo-3.0\dubbo-cluster\src\test\java\org\apache\dubbo\rpc\cluster\router\mesh\rule\virtualservice\match\ListBoolMatchTest.java,24,1,0,1,0,2
dubbo-3.0\dubbo-3.0\dubbo-filter\dubbo-filter-cache\src\main\java\org\apache\dubbo\cache\support\lru\LruCacheFactory.java,14,3,0,3,0,6
dubbo-3.0\dubbo-3.0\dubbo-plugin\dubbo-qos\src\main\java\org\apache\dubbo\qos\command\impl\OfflineInterface.java,13,4,0,1,0,5
dubbo-3.0\dubbo-3.0\dubbo-common\src\main\java\org\apache\dubbo\config\ModuleConfig.java,213,104,0,6,0,110
dubbo-3.0\dubbo-3.0\dubbo-remoting\dubbo-remoting-api\src\main\java\org\apache\dubbo\remoting\buffer\ChannelBufferFactory.java,0,3,0,1,0,4
dubbo-3.0\dubbo-3.0\dubbo-config\dubbo-config-spring\src\test\java\org\apache\dubbo\config\spring\ConfigTest.java,1078,218,23,141,0,382
dubbo-3.0\dubbo-3.0\dubbo-common\src\main\java\org\apache\dubbo\common\config\CompositeConfiguration.java,62,32,2,7,0,41
dubbo-3.0\dubbo-3.0\dubbo-common\src\main\java\org\apache\dubbo\config\MetricsConfig.java,0,34,1,3,0,38
dubbo-3.0\dubbo-3.0\dubbo-common\src\test\java\org\apache\dubbo\rpc\model\ApplicationModelTest.java,116,39,0,33,0,72
dubbo-3.0\dubbo-3.0\dubbo-rpc\dubbo-rpc-triple\src\test\java\org\apache\dubbo\rpc\protocol\tri\ReflectionPackableMethodTest.java,225,67,17,51,0,135
dubbo-3.0\dubbo-3.0\dubbo-remoting\dubbo-remoting-api\src\main\java\org\apache\dubbo\remoting\transport\ExceedPayloadLimitException.java,8,2,0,1,0,3
dubbo-3.0\dubbo-3.0\dubbo-cluster\src\main\java\org\apache\dubbo\rpc\cluster\RuleConverter.java,0,1,0,1,0,2
dubbo-3.0\dubbo-3.0\dubbo-common\src\main\java\org\apache\dubbo\config\ProtocolConfig.java,538,273,1,5,0,279
dubbo-3.0\dubbo-3.0\dubbo-registry\dubbo-registry-zookeeper\src\main\java\org\apache\dubbo\registry\zookeeper\util\CuratorFrameworkUtils.java,77,35,0,20,0,55
dubbo-3.0\dubbo-3.0\dubbo-plugin\dubbo-qos\src\test\java\org\apache\dubbo\qos\legacy\ChangeTelnetHandlerTest.java,86,30,2,14,0,46
dubbo-3.0\dubbo-3.0\dubbo-config\dubbo-config-api\src\test\java\org\apache\dubbo\config\integration\multiple\injvm\MultipleRegistryCenterInjvmServiceImpl.java,10,3,0,2,0,5
dubbo-3.0\dubbo-3.0\dubbo-metadata\dubbo-metadata-api\src\test\java\org\apache\dubbo\metadata\report\identifier\BaseApplicationMetadataIdentifierTest.java,0,7,1,5,0,13
dubbo-3.0\dubbo-3.0\dubbo-cluster\src\main\java\org\apache\dubbo\rpc\cluster\router\condition\config\ServiceStateRouter.java,8,5,0,1,0,6
dubbo-3.0\dubbo-3.0\dubbo-cluster\src\test\java\org\apache\dubbo\rpc\cluster\router\ConfigConditionRouterTest.java,108,56,0,5,0,61
dubbo-3.0\dubbo-3.0\dubbo-remoting\dubbo-remoting-api\src\main\java\org\apache\dubbo\remoting\api\SingleProtocolConnectionManager.java,28,8,0,3,0,11
dubbo-3.0\dubbo-3.0\dubbo-common\src\main\java\org\apache\dubbo\rpc\model\ServiceModel.java,149,92,0,10,0,102
dubbo-3.0\dubbo-3.0\dubbo-registry\dubbo-registry-api\src\main\java\org\apache\dubbo\registry\support\FailbackRegistry.java,407,114,16,38,0,168
dubbo-3.0\dubbo-3.0\dubbo-spring-boot\dubbo-spring-boot-compatible\actuator\src\main\java\org\apache\dubbo\spring\boot\actuate\endpoint\metadata\DubboConfigsMetadata.java,44,11,0,8,0,19
dubbo-3.0\dubbo-3.0\dubbo-serialization\dubbo-serialization-hessian2\src\main\java\org\apache\dubbo\common\serialize\hessian2\dubbo\WhitelistHessian2FactoryInitializer.java,30,5,0,4,0,9
dubbo-3.0\dubbo-3.0\dubbo-spring-boot\dubbo-spring-boot-compatible\actuator\src\main\java\org\apache\dubbo\spring\boot\actuate\endpoint\mvc\DubboMvcEndpoint.java,68,32,1,12,0,45
dubbo-3.0\dubbo-3.0\dubbo-cluster\src\main\java\org\apache\dubbo\rpc\cluster\support\FailoverClusterInvoker.java,87,21,1,13,0,35
dubbo-3.0\dubbo-3.0\dubbo-registry\dubbo-registry-api\src\main\java\org\apache\dubbo\registry\client\ServiceDiscoveryRegistryFactory.java,13,2,0,1,0,3
dubbo-3.0\dubbo-3.0\dubbo-common\src\main\java\org\apache\dubbo\common\io\UnsafeByteArrayInputStream.java,95,37,4,1,0,42
dubbo-3.0\dubbo-3.0\dubbo-cluster\src\main\java\org\apache\dubbo\rpc\cluster\router\mesh\rule\destination\ConnectionPoolSettings.java,3,1,0,1,0,2
dubbo-3.0\dubbo-3.0\dubbo-registry\dubbo-registry-api\src\test\java\org\apache\dubbo\registry\client\migration\model\MigrationRuleTest.java,80,47,10,14,0,71
dubbo-3.0\dubbo-3.0\dubbo-common\src\main\java\org\apache\dubbo\common\threadpool\support\eager\TaskQueue.java,0,20,0,6,0,26
dubbo-3.0\dubbo-3.0\dubbo-common\src\test\java\org\apache\dubbo\common\utils\UrlUtilsTest.java,351,86,14,50,0,150
dubbo-3.0\dubbo-3.0\dubbo-metadata\dubbo-metadata-api\src\main\java\org\apache\dubbo\metadata\MetadataConstants.java,14,16,0,3,0,19
dubbo-3.0\dubbo-3.0\dubbo-config\dubbo-config-spring\src\test\java\org\apache\dubbo\config\spring\util\EnvironmentUtilsTest.java,51,12,0,10,0,22
dubbo-3.0\dubbo-3.0\dubbo-common\src\main\java\org\apache\dubbo\common\threadpool\manager\DefaultExecutorRepository.java,0,87,15,43,0,145
dubbo-3.0\dubbo-3.0\dubbo-config\dubbo-config-api\src\test\java\org\apache\dubbo\config\bootstrap\EtcdDubboServiceConsumerBootstrap.java,26,12,1,6,0,19
dubbo-3.0\dubbo-3.0\dubbo-config\dubbo-config-api\src\test\java\org\apache\dubbo\config\cache\CacheService.java,0,3,0,1,0,4
dubbo-3.0\dubbo-3.0\dubbo-config\dubbo-config-spring\src\main\java\org\apache\dubbo\config\spring\context\annotation\EnableDubbo.java,0,6,0,6,0,12
dubbo-3.0\dubbo-3.0\dubbo-common\src\test\java\org\apache\dubbo\rpc\model\person\PersonStatus.java,0,2,0,1,0,3
dubbo-3.0\dubbo-3.0\dubbo-common\src\main\java\org\apache\dubbo\common\threadpool\event\ThreadPoolExhaustedListener.java,0,1,0,1,0,2
dubbo-3.0\dubbo-3.0\dubbo-metadata\dubbo-metadata-processor\src\test\java\org\apache\dubbo\metadata\rest\RestService.java,0,8,0,1,0,9
dubbo-3.0\dubbo-3.0\dubbo-config\dubbo-config-api\src\test\java\org\apache\dubbo\config\utils\ReferenceCacheTest.java,124,27,0,15,0,42
dubbo-3.0\dubbo-3.0\dubbo-cluster\src\test\java\org\apache\dubbo\rpc\cluster\support\ConnectivityValidationTest.java,274,64,0,18,0,82
dubbo-3.0\dubbo-3.0\dubbo-config\dubbo-config-spring\src\test\java\org\apache\dubbo\config\spring\impl\UnserializableBoxDemoServiceImpl.java,12,6,0,1,0,7
dubbo-3.0\dubbo-3.0\dubbo-cluster\src\main\java\org\apache\dubbo\rpc\cluster\router\mock\MockStateRouterFactory.java,10,5,0,1,0,6
dubbo-3.0\dubbo-3.0\dubbo-registry\dubbo-registry-api\src\test\java\org\apache\dubbo\registry\client\migration\DefaultMigrationAddressComparatorTest.java,65,19,0,19,0,38
dubbo-3.0\dubbo-3.0\dubbo-common\src\test\java\org\apache\dubbo\metadata\definition\common\TestService.java,0,2,0,1,0,3
dubbo-3.0\dubbo-3.0\dubbo-common\src\test\java\org\apache\dubbo\common\extension\wrapper\Demo.java,0,2,0,1,0,3
dubbo-3.0\dubbo-3.0\dubbo-metadata\dubbo-metadata-processor\src\main\java\org\apache\dubbo\metadata\annotation\processing\rest\ServiceRestMetadataAnnotationProcessor.java,47,28,0,16,0,44
dubbo-3.0\dubbo-3.0\dubbo-metadata\dubbo-metadata-processor\src\main\java\org\apache\dubbo\metadata\annotation\processing\util\ServiceAnnotationUtils.java,0,28,0,16,0,44
dubbo-3.0\dubbo-3.0\dubbo-common\src\main\java\org\apache\dubbo\common\timer\Timeout.java,0,4,0,1,0,5
dubbo-3.0\dubbo-3.0\dubbo-rpc\dubbo-rpc-api\src\test\java\org\apache\dubbo\rpc\support\DemoServiceAMock.java,8,4,0,1,0,5
dubbo-3.0\dubbo-3.0\dubbo-rpc\dubbo-rpc-dubbo\src\main\java\org\apache\dubbo\rpc\protocol\dubbo\status\ServerStatusChecker.java,31,4,0,2,0,6
dubbo-3.0\dubbo-3.0\dubbo-metadata\dubbo-metadata-api\src\main\java\org\apache\dubbo\metadata\rest\jaxrs\FormParamParameterProcessor.java,8,5,0,4,0,9
dubbo-3.0\dubbo-3.0\dubbo-remoting\dubbo-remoting-api\src\main\java\org\apache\dubbo\remoting\exchange\ExchangeClient.java,0,1,0,1,0,2
dubbo-3.0\dubbo-3.0\dubbo-remoting\dubbo-remoting-api\src\main\java\org\apache\dubbo\remoting\transport\dispatcher\direct\DirectDispatcher.java,11,5,0,1,0,6
dubbo-3.0\dubbo-3.0\dubbo-rpc\dubbo-rpc-api\src\test\java\org\apache\dubbo\rpc\filter\ClassLoaderFilterTest.java,0,9,1,6,0,16
dubbo-3.0\dubbo-3.0\dubbo-remoting\dubbo-remoting-api\src\test\java\org\apache\dubbo\remoting\api\EmptyProtocol.java,22,10,3,3,0,16
dubbo-3.0\dubbo-3.0\dubbo-cluster\src\main\java\org\apache\dubbo\rpc\cluster\merger\DoubleArrayMerger.java,13,2,0,1,0,3
dubbo-3.0\dubbo-3.0\dubbo-common\src\main\java\org\apache\dubbo\common\deploy\ApplicationDeployListener.java,0,3,1,2,0,6
dubbo-3.0\dubbo-3.0\dubbo-remoting\dubbo-remoting-netty\src\main\java\org\apache\dubbo\remoting\transport\netty\NettyHandler.java,90,44,0,17,0,61
dubbo-3.0\dubbo-3.0\dubbo-metadata\dubbo-metadata-api\src\main\java\org\apache\dubbo\metadata\rest\springmvc\RequestParamParameterProcessor.java,15,15,0,6,0,21
dubbo-3.0\dubbo-3.0\dubbo-config\dubbo-config-spring\src\main\java\org\apache\dubbo\config\spring\util\EnvironmentUtils.java,112,24,0,12,0,36
dubbo-3.0\dubbo-3.0\dubbo-rpc\dubbo-rpc-triple\src\main\java\org\apache\dubbo\rpc\protocol\tri\SingleProtobufUtils.java,94,38,1,13,0,52
dubbo-3.0\dubbo-3.0\dubbo-remoting\dubbo-remoting-api\src\main\java\org\apache\dubbo\remoting\api\Http2WireProtocol.java,15,6,1,3,0,10
dubbo-3.0\dubbo-3.0\dubbo-rpc\dubbo-rpc-triple\src\test\java\org\apache\dubbo\rpc\protocol\tri\TriplePathResolverTest.java,81,14,1,2,0,17
dubbo-3.0\dubbo-3.0\dubbo-cluster\src\main\java\org\apache\dubbo\rpc\cluster\merger\ByteArrayMerger.java,26,2,0,1,0,3
dubbo-3.0\dubbo-3.0\dubbo-common\src\test\java\org\apache\dubbo\common\extension\support\Order0Filter0.java,0,0,0,1,0,1
dubbo-3.0\dubbo-3.0\dubbo-demo\dubbo-demo-xml\dubbo-demo-xml-provider\src\main\java\org\apache\dubbo\demo\provider\TripleServiceImpl.java,9,1,0,1,0,2
dubbo-3.0\dubbo-3.0\dubbo-native\src\main\java\org\apache\dubbo\utils\CodeGenerator.java,68,35,3,17,0,55
dubbo-3.0\dubbo-3.0\dubbo-remoting\dubbo-remoting-api\src\test\java\org\apache\dubbo\remoting\api\NettyEventLoopFactoryTest.java,43,16,1,12,0,29
dubbo-3.0\dubbo-3.0\dubbo-common\src\main\java\org\apache\dubbo\common\convert\multiple\StringToSetConverter.java,11,6,0,1,0,7
dubbo-3.0\dubbo-3.0\dubbo-compatible\src\main\java\com\alibaba\dubbo\rpc\cluster\LoadBalance.java,0,7,0,7,0,14
dubbo-3.0\dubbo-3.0\dubbo-spring-boot\dubbo-spring-boot-compatible\autoconfigure\src\test\java\org\apache\dubbo\spring\boot\autoconfigure\DubboAutoConfigurationOnMultipleConfigTest.java,206,53,2,13,0,68
dubbo-3.0\dubbo-3.0\dubbo-remoting\dubbo-remoting-api\src\main\java\org\apache\dubbo\remoting\exchange\support\header\HeaderExchangeChannel.java,0,41,4,12,0,57
dubbo-3.0\dubbo-3.0\dubbo-common\src\main\java\org\apache\dubbo\common\logger\log4j\Log4jLogger.java,112,46,0,1,0,47
dubbo-3.0\dubbo-3.0\dubbo-filter\dubbo-filter-cache\src\main\java\org\apache\dubbo\cache\support\expiring\ExpiringCache.java,36,15,0,8,0,23
dubbo-3.0\dubbo-3.0\dubbo-remoting\dubbo-remoting-netty4\src\test\java\org\apache\dubbo\remoting\transport\netty4\NettyClientToServerTest.java,18,13,0,4,0,17
dubbo-3.0\dubbo-3.0\dubbo-compatible\src\main\java\com\alibaba\dubbo\container\page\pages\HomePageHandler.java,18,6,0,3,0,9
dubbo-3.0\dubbo-3.0\dubbo-plugin\dubbo-qos\src\main\java\org\apache\dubbo\qos\command\impl\Live.java,36,12,0,4,0,16
dubbo-3.0\dubbo-3.0\dubbo-common\src\test\java\org\apache\dubbo\common\extension\ext6_wrap\impl\Ext6Wrapper3.java,0,14,0,1,0,15
dubbo-3.0\dubbo-3.0\dubbo-config\dubbo-config-api\src\main\java\org\apache\dubbo\config\deploy\FrameworkModelCleaner.java,45,14,2,4,0,20
dubbo-3.0\dubbo-3.0\dubbo-plugin\dubbo-auth\src\main\java\org\apache\dubbo\auth\Constants.java,0,13,12,1,0,26
dubbo-3.0\dubbo-3.0\dubbo-plugin\dubbo-qos\src\test\java\org\apache\dubbo\qos\legacy\service\NonSerialized.java,4,1,0,1,0,2
dubbo-3.0\dubbo-3.0\dubbo-remoting\dubbo-remoting-api\src\test\java\org\apache\dubbo\remoting\handler\ConnectChannelHandlerTest.java,115,33,0,20,0,53
dubbo-3.0\dubbo-3.0\dubbo-common\src\test\java\org\apache\dubbo\common\status\support\MemoryStatusCheckerTest.java,13,4,2,2,0,8
dubbo-3.0\dubbo-3.0\dubbo-common\src\main\java\org\apache\dubbo\common\config\ReferenceCache.java,0,9,0,1,0,10
dubbo-3.0\dubbo-3.0\dubbo-common\src\test\java\org\apache\dubbo\common\convert\StringToIntegerConverterTest.java,24,7,0,3,0,10
dubbo-3.0\dubbo-3.0\dubbo-rpc\dubbo-rpc-api\src\main\java\org\apache\dubbo\rpc\protocol\ProtocolListenerWrapper.java,53,18,0,8,0,26
dubbo-3.0\dubbo-3.0\dubbo-config\dubbo-config-api\src\test\java\org\apache\dubbo\config\mock\MockServiceListener.java,26,9,1,2,0,12
dubbo-3.0\dubbo-3.0\dubbo-common\src\test\java\org\apache\dubbo\common\io\UnsafeStringReaderTest.java,50,6,0,1,0,7
dubbo-3.0\dubbo-3.0\dubbo-cluster\src\main\java\org\apache\dubbo\rpc\cluster\router\mesh\route\StandardMeshRuleRouterFactory.java,7,4,0,1,0,5
dubbo-3.0\dubbo-3.0\dubbo-rpc\dubbo-rpc-injvm\src\test\java\org\apache\dubbo\rpc\protocol\injvm\DemoRequest.java,0,11,0,2,0,13
dubbo-3.0\dubbo-3.0\dubbo-common\src\main\java\org\apache\dubbo\common\threadpool\ThreadPool.java,0,2,0,1,0,3
dubbo-3.0\dubbo-3.0\dubbo-metadata\dubbo-metadata-api\src\test\java\org\apache\dubbo\metadata\ServiceNameMappingTest.java,0,3,0,7,0,10
dubbo-3.0\dubbo-3.0\dubbo-config\dubbo-config-api\src\test\java\org\apache\dubbo\config\mock\MockExchanger.java,12,8,0,3,0,11
dubbo-3.0\dubbo-3.0\dubbo-metadata\dubbo-metadata-processor\src\main\java\org\apache\dubbo\metadata\annotation\processing\builder\CollectionTypeDefinitionBuilder.java,32,16,0,7,0,23
dubbo-3.0\dubbo-3.0\dubbo-remoting\dubbo-remoting-api\src\test\java\org\apache\dubbo\remoting\buffer\DynamicChannelBufferTest.java,0,20,2,1,0,23
dubbo-3.0\dubbo-3.0\dubbo-config\dubbo-config-api\src\main\java\org\apache\dubbo\config\ReferenceConfig.java,557,116,7,70,0,193
dubbo-3.0\dubbo-3.0\dubbo-rpc\dubbo-rpc-rest\src\main\java\org\apache\dubbo\rpc\protocol\rest\BaseRestProtocolServer.java,62,25,0,9,0,34
dubbo-3.0\dubbo-3.0\dubbo-common\src\main\java\org\apache\dubbo\rpc\model\ApplicationInitListener.java,0,2,0,1,0,3
dubbo-3.0\dubbo-3.0\dubbo-cluster\src\main\java\org\apache\dubbo\rpc\cluster\router\mesh\rule\virtualservice\match\DubboMethodArg.java,71,58,9,2,0,69
dubbo-3.0\dubbo-3.0\dubbo-remoting\dubbo-remoting-api\src\test\java\org\apache\dubbo\remoting\handler\WrappedChannelHandlerTest.java,144,50,3,16,0,69
dubbo-3.0\dubbo-3.0\dubbo-remoting\dubbo-remoting-api\src\main\java\org\apache\dubbo\remoting\transport\dispatcher\connection\ConnectionOrderedDispatcher.java,11,5,0,1,0,6
dubbo-3.0\dubbo-3.0\dubbo-plugin\dubbo-qos\src\test\java\org\apache\dubbo\qos\legacy\service\CustomArgument.java,31,23,1,1,0,25
dubbo-3.0\dubbo-3.0\dubbo-registry\dubbo-registry-nacos\src\main\java\org\apache\dubbo\registry\nacos\NacosNamingServiceWrapper.java,70,75,0,19,0,94
dubbo-3.0\dubbo-3.0\dubbo-registry\dubbo-registry-zookeeper\src\test\java\org\apache\dubbo\registry\zookeeper\util\CuratorFrameworkUtilsTest.java,0,23,2,21,0,46
dubbo-3.0\dubbo-3.0\dubbo-common\src\main\java\org\apache\dubbo\common\function\ThrowableAction.java,0,5,1,2,0,8
dubbo-3.0\dubbo-3.0\dubbo-common\src\test\java\org\apache\dubbo\common\convert\StringToCharacterConverterTest.java,24,7,0,3,0,10
dubbo-3.0\dubbo-3.0\dubbo-remoting\dubbo-remoting-api\src\main\java\org\apache\dubbo\remoting\exchange\support\header\HeaderExchangeClient.java,198,74,2,14,0,90
dubbo-3.0\dubbo-3.0\dubbo-common\src\main\java\org\apache\dubbo\common\config\OrderedPropertiesProvider.java,0,7,0,1,0,8
dubbo-3.0\dubbo-3.0\dubbo-common\src\main\java\org\apache\dubbo\common\convert\StringToOptionalConverter.java,14,4,0,1,0,5
dubbo-3.0\dubbo-3.0\dubbo-cluster\src\main\java\org\apache\dubbo\rpc\cluster\support\FailfastCluster.java,11,6,0,2,0,8
dubbo-3.0\dubbo-3.0\dubbo-config\dubbo-config-spring\src\main\java\org\apache\dubbo\config\spring\context\properties\AbstractDubboConfigBinder.java,45,18,0,2,0,20
dubbo-3.0\dubbo-3.0\dubbo-cluster\src\main\java\org\apache\dubbo\rpc\cluster\merger\MapMerger.java,0,2,0,1,0,3
dubbo-3.0\dubbo-3.0\dubbo-common\src\main\java\org\apache\dubbo\rpc\model\FrameworkServiceRepository.java,82,44,2,11,0,57
dubbo-3.0\dubbo-3.0\dubbo-spring-boot\dubbo-spring-boot-compatible\actuator\src\main\java\org\apache\dubbo\spring\boot\actuate\health\DubboHealthIndicatorProperties.java,64,28,0,4,0,32
dubbo-3.0\dubbo-3.0\dubbo-registry\dubbo-registry-api\src\main\java\org\apache\dubbo\registry\client\ServiceDiscovery.java,0,24,2,9,0,35
dubbo-3.0\dubbo-3.0\dubbo-cluster\src\test\java\org\apache\dubbo\rpc\cluster\router\mesh\rule\VirtualServiceRuleTest.java,50,12,0,14,0,26
dubbo-3.0\dubbo-3.0\dubbo-common\src\test\java\org\apache\dubbo\common\extension\duplicated\DuplicatedOverriddenExt.java,0,3,0,1,0,4
dubbo-3.0\dubbo-3.0\dubbo-cluster\src\main\java\org\apache\dubbo\rpc\cluster\router\mesh\route\MeshRuleManager.java,90,33,1,13,0,47
dubbo-3.0\dubbo-3.0\dubbo-spring-boot\dubbo-spring-boot-compatible\autoconfigure\src\main\java\org\apache\dubbo\spring\boot\autoconfigure\DubboRelaxedBindingAutoConfiguration.java,29,14,0,12,0,26
dubbo-3.0\dubbo-3.0\dubbo-registry\dubbo-registry-api\src\test\java\org\apache\dubbo\registry\integration\DemoService.java,0,0,0,1,0,1
dubbo-3.0\dubbo-3.0\dubbo-config\dubbo-config-api\src\test\java\org\apache\dubbo\config\MetadataReportConfigTest.java,15,1,0,1,0,2
dubbo-3.0\dubbo-3.0\dubbo-config\dubbo-config-spring\src\test\java\org\apache\dubbo\config\spring\api\HelloService.java,0,1,0,1,0,2
dubbo-3.0\dubbo-3.0\dubbo-common\src\test\java\org\apache\dubbo\common\compiler\support\AdaptiveCompilerTest.java,14,3,0,2,0,5
dubbo-3.0\dubbo-3.0\dubbo-common\src\test\java\org\apache\dubbo\common\io\StreamUtilsTest.java,151,17,7,8,0,32
dubbo-3.0\dubbo-3.0\dubbo-metadata\dubbo-metadata-api\src\main\java\org\apache\dubbo\metadata\rest\jaxrs\MatrixParamParameterProcessor.java,8,5,0,4,0,9
dubbo-3.0\dubbo-3.0\dubbo-common\src\main\java\org\apache\dubbo\common\logger\LoggerFactory.java,118,24,3,7,0,34
dubbo-3.0\dubbo-3.0\dubbo-compatible\src\test\java\org\apache\dubbo\rpc\cluster\CompatibleRouter2.java,17,8,1,2,0,11
dubbo-3.0\dubbo-3.0\dubbo-rpc\dubbo-rpc-injvm\src\test\java\org\apache\dubbo\rpc\protocol\injvm\InjvmDeepCopyTest.java,84,22,0,14,0,36
dubbo-3.0\dubbo-3.0\dubbo-cluster\src\test\java\org\apache\dubbo\rpc\cluster\loadbalance\RandomLoadBalanceTest.java,59,11,4,6,0,21
dubbo-3.0\dubbo-3.0\dubbo-config\dubbo-config-api\src\test\java\org\apache\dubbo\config\integration\multiple\exportprovider\MultipleRegistryCenterExportProviderFilter.java,0,23,0,6,0,29
dubbo-3.0\dubbo-3.0\dubbo-common\src\main\java\org\apache\dubbo\common\deploy\DeployListener.java,0,5,0,1,0,6
dubbo-3.0\dubbo-3.0\dubbo-test\dubbo-test-spring\src\main\java\org\apache\dubbo\test\spring\SpringXmlConfigTest.java,53,11,0,8,0,19
dubbo-3.0\dubbo-3.0\dubbo-config\dubbo-config-api\src\main\java\org\apache\dubbo\config\bootstrap\builders\ApplicationBuilder.java,0,132,0,4,0,136
dubbo-3.0\dubbo-3.0\dubbo-spring-boot\dubbo-spring-boot-compatible\autoconfigure\src\test\java\org\apache\dubbo\spring\boot\autoconfigure\DubboAutoConfigurationOnSingleConfigTest.java,90,23,3,4,0,30
dubbo-3.0\dubbo-3.0\dubbo-rpc\dubbo-rpc-api\src\main\java\org\apache\dubbo\rpc\filter\ExceptionFilter.java,0,35,5,20,0,60
dubbo-3.0\dubbo-3.0\dubbo-demo\dubbo-demo-api\dubbo-demo-api-provider\src\main\java\org\apache\dubbo\demo\provider\Application.java,41,7,1,3,0,11
dubbo-3.0\dubbo-3.0\dubbo-remoting\dubbo-remoting-api\src\test\java\org\apache\dubbo\remoting\buffer\DirectChannelBufferTest.java,17,4,0,1,0,5
dubbo-3.0\dubbo-3.0\dubbo-spring-boot\dubbo-spring-boot-actuator\src\main\java\org\apache\dubbo\spring\boot\actuate\endpoint\DubboMetadataEndpoint.java,12,4,0,1,0,5
dubbo-3.0\dubbo-3.0\dubbo-config\dubbo-config-api\src\test\java\org\apache\dubbo\config\mock\MockDispatcher.java,7,3,0,1,0,4
dubbo-3.0\dubbo-3.0\dubbo-native-plugin\src\main\java\org\apache\dubbo\maven\plugin\ClassFinder.java,63,22,2,10,0,34
dubbo-3.0\dubbo-3.0\dubbo-remoting\dubbo-remoting-api\src\main\java\org\apache\dubbo\remoting\api\Http2ProtocolDetector.java,21,5,0,2,0,7
dubbo-3.0\dubbo-3.0\dubbo-common\src\main\java\org\apache\dubbo\common\config\configcenter\Constants.java,0,6,4,2,0,12
dubbo-3.0\dubbo-3.0\dubbo-common\src\main\java\org\apache\dubbo\common\url\component\PathURLAddress.java,156,83,2,11,0,96
dubbo-3.0\dubbo-3.0\dubbo-common\src\test\java\org\apache\dubbo\common\utils\NetUtilsInterfaceDisplayNameHasMetaCharactersTest.java,84,38,6,21,0,65
dubbo-3.0\dubbo-3.0\dubbo-config\dubbo-config-api\src\test\java\org\apache\dubbo\config\integration\multiple\Storage.java,0,5,0,2,0,7
dubbo-3.0\dubbo-3.0\dubbo-filter\dubbo-filter-validation\src\main\java\org\apache\dubbo\validation\Validator.java,0,3,0,3,0,6
dubbo-3.0\dubbo-3.0\dubbo-plugin\dubbo-qos\src\test\java\org\apache\dubbo\qos\server\handler\LocalHostPermitHandlerTest.java,21,3,0,2,0,5
dubbo-3.0\dubbo-3.0\dubbo-cluster\src\main\java\org\apache\dubbo\rpc\cluster\loadbalance\LeastActiveLoadBalance.java,82,21,0,16,0,37
dubbo-3.0\dubbo-3.0\dubbo-config\dubbo-config-api\src\test\java\org\apache\dubbo\config\integration\single\SingleRegistryCenterDubboProtocolIntegrationTest.java,310,65,2,51,0,118
dubbo-3.0\dubbo-3.0\dubbo-config\dubbo-config-spring\src\test\java\org\apache\dubbo\config\spring\DubboStateListener.java,14,8,0,2,0,10
dubbo-3.0\dubbo-3.0\dubbo-metadata\dubbo-metadata-api\src\main\java\org\apache\dubbo\metadata\InstanceMetadataChangedListener.java,0,4,0,1,0,5
dubbo-3.0\dubbo-3.0\dubbo-registry\dubbo-registry-api\src\test\java\org\apache\dubbo\registry\RegistryServiceListener2.java,24,14,0,1,0,15
dubbo-3.0\dubbo-3.0\dubbo-native\src\main\java\org\apache\dubbo\remoting\Codec2$Adaptive.java,0,32,23,13,0,68
dubbo-3.0\dubbo-3.0\dubbo-plugin\dubbo-qos\src\test\java\org\apache\dubbo\qos\command\impl\TestInterface2.java,0,1,0,1,0,2
dubbo-3.0\dubbo-3.0\dubbo-metadata\dubbo-metadata-processor\src\test\java\org\apache\dubbo\metadata\annotation\processing\model\Model.java,63,43,0,1,0,44
dubbo-3.0\dubbo-3.0\dubbo-monitor\dubbo-monitor-default\src\test\java\org\apache\dubbo\monitor\dubbo\MockMonitorService.java,18,11,0,1,0,12
dubbo-3.0\dubbo-3.0\dubbo-cluster\src\test\java\org\apache\dubbo\rpc\cluster\router\RouterSnapshotFilterTest.java,46,12,0,12,0,24
dubbo-3.0\dubbo-3.0\dubbo-common\src\test\java\org\apache\dubbo\common\beans\model\FooBeanWithScopeModel.java,12,6,0,1,0,7
dubbo-3.0\dubbo-3.0\dubbo-config\dubbo-config-api\src\test\java\org\apache\dubbo\config\AbstractConfigTest.java,962,250,68,74,0,392
dubbo-3.0\dubbo-3.0\dubbo-common\src\main\java\org\apache\dubbo\common\constants\RegistryConstants.java,0,48,44,5,0,97
dubbo-3.0\dubbo-3.0\dubbo-common\src\main\java\org\apache\dubbo\metadata\definition\model\TypeDefinition.java,151,51,1,4,0,56
dubbo-3.0\dubbo-3.0\dubbo-test\dubbo-test-spring\src\main\java\org\apache\dubbo\test\spring\SpringJavaConfigBeanTest.java,148,30,0,16,0,46
dubbo-3.0\dubbo-3.0\dubbo-common\src\main\java\org\apache\dubbo\common\profiler\Profiler.java,88,40,1,10,0,51
dubbo-3.0\dubbo-3.0\dubbo-common\src\test\java\org\apache\dubbo\common\extension\ext3\impl\UseProtocolKeyExtImpl2.java,10,8,0,1,0,9
dubbo-3.0\dubbo-3.0\dubbo-common\src\main\java\org\apache\dubbo\config\ConsumerConfig.java,156,70,2,8,0,80
dubbo-3.0\dubbo-3.0\dubbo-common\src\main\java\org\apache\dubbo\common\beanutil\JavaBeanDescriptor.java,0,63,1,5,0,69
dubbo-3.0\dubbo-3.0\dubbo-common\src\test\java\org\apache\dubbo\common\extension\ext6_wrap\impl\Ext6Impl1.java,6,5,0,1,0,6
dubbo-3.0\dubbo-3.0\dubbo-configcenter\dubbo-configcenter-apollo\src\test\java\org\apache\dubbo\configcenter\support\apollo\ApolloDynamicConfigurationTest.java,148,40,2,18,0,60
dubbo-3.0\dubbo-3.0\dubbo-serialization\dubbo-serialization-hessian2\src\main\java\org\apache\dubbo\common\serialize\hessian2\Hessian2ObjectOutput.java,0,34,0,3,0,37
dubbo-3.0\dubbo-3.0\dubbo-metadata\dubbo-metadata-api\src\main\java\org\apache\dubbo\metadata\ServiceNameMapping.java,0,27,0,8,0,35
dubbo-3.0\dubbo-3.0\dubbo-test\dubbo-test-check\src\main\java\org\apache\dubbo\test\check\registrycenter\Initializer.java,0,1,0,2,0,3
dubbo-3.0\dubbo-3.0\dubbo-common\src\main\java\org\apache\dubbo\common\profiler\ProfilerEntry.java,58,34,0,2,0,36
dubbo-3.0\dubbo-3.0\dubbo-compatible\src\main\java\com\alibaba\dubbo\common\serialize\Serialization.java,0,5,0,4,0,9
dubbo-3.0\dubbo-3.0\dubbo-metadata\dubbo-metadata-processor\src\main\java\org\apache\dubbo\metadata\annotation\processing\builder\TypeDefinitionBuilder.java,0,15,1,11,0,27
dubbo-3.0\dubbo-3.0\dubbo-remoting\dubbo-remoting-netty\src\test\java\org\apache\dubbo\remoting\transport\netty\ClientReconnectTest.java,62,33,3,5,0,41
dubbo-3.0\dubbo-3.0\dubbo-config\dubbo-config-spring\src\main\java\org\apache\dubbo\config\spring\context\DubboSpringInitCustomizer.java,0,10,0,7,0,17
dubbo-3.0\dubbo-3.0\dubbo-common\src\main\java\org\apache\dubbo\common\utils\TypeUtils.java,0,33,1,20,0,54
dubbo-3.0\dubbo-3.0\dubbo-registry\dubbo-registry-api\src\main\java\org\apache\dubbo\registry\support\AbstractRegistry.java,517,118,19,48,0,185
dubbo-3.0\dubbo-3.0\dubbo-common\src\test\java\org\apache\dubbo\common\model\person\Phone.java,120,55,12,3,0,70
dubbo-3.0\dubbo-3.0\dubbo-rpc\dubbo-rpc-api\src\main\java\org\apache\dubbo\rpc\protocol\AbstractProxyProtocol.java,240,68,12,15,0,95
dubbo-3.0\dubbo-3.0\dubbo-rpc\dubbo-rpc-dubbo\src\main\java\org\apache\dubbo\rpc\protocol\dubbo\Constants.java,0,15,14,3,0,32
dubbo-3.0\dubbo-3.0\dubbo-common\src\main\java\org\apache\dubbo\metadata\definition\builder\CollectionTypeBuilder.java,52,11,0,6,0,17
dubbo-3.0\dubbo-3.0\dubbo-remoting\dubbo-remoting-api\src\main\java\org\apache\dubbo\remoting\exchange\support\header\CloseTimerTask.java,30,15,5,5,0,25
dubbo-3.0\dubbo-3.0\dubbo-rpc\dubbo-rpc-rest\src\test\java\org\apache\dubbo\rpc\protocol\rest\integration\swagger\DubboSwaggerApiListingResourceTest.java,29,10,2,4,0,16
dubbo-3.0\dubbo-3.0\dubbo-config\dubbo-config-api\src\test\java\demo\MultiClassLoaderServiceImpl.java,16,12,0,4,0,16
dubbo-3.0\dubbo-3.0\dubbo-cluster\src\main\java\org\apache\dubbo\rpc\cluster\router\state\StateRouter.java,0,15,0,11,0,26
dubbo-3.0\dubbo-3.0\dubbo-compatible\src\main\java\com\alibaba\dubbo\rpc\RpcInvocation.java,0,122,1,20,0,143
dubbo-3.0\dubbo-3.0\dubbo-config\dubbo-config-api\src\test\java\org\apache\dubbo\config\integration\single\exportmetadata\SingleRegistryCenterExportMetadataServiceImpl.java,11,4,0,3,0,7
dubbo-3.0\dubbo-3.0\dubbo-config\dubbo-config-spring\src\test\java\org\apache\dubbo\config\spring\registry\MockRegistry.java,63,31,2,1,0,34
dubbo-3.0\dubbo-3.0\dubbo-common\src\test\java\org\apache\dubbo\common\lang\ShutdownHookCallbacksTest.java,28,9,0,2,0,11
dubbo-3.0\dubbo-3.0\dubbo-rpc\dubbo-rpc-triple\src\main\java\org\apache\dubbo\rpc\protocol\tri\command\CancelQueueCommand.java,18,10,0,1,0,11
dubbo-3.0\dubbo-3.0\dubbo-config\dubbo-config-spring\src\main\java\org\apache\dubbo\config\spring\context\DubboBootstrapApplicationListener.java,0,45,7,18,0,70
dubbo-3.0\dubbo-3.0\dubbo-common\src\main\java\org\apache\dubbo\common\function\Streams.java,0,16,0,9,0,25
dubbo-3.0\dubbo-3.0\dubbo-config\dubbo-config-api\src\main\java\org\apache\dubbo\config\ServiceConfig.java,739,189,19,95,0,303
dubbo-3.0\dubbo-3.0\dubbo-registry\dubbo-registry-api\src\main\java\org\apache\dubbo\registry\client\ServiceDiscoveryRegistryDirectory.java,393,140,16,90,0,246
dubbo-3.0\dubbo-3.0\dubbo-rpc\dubbo-rpc-triple\src\main\java\org\apache\dubbo\rpc\protocol\tri\service\HealthStatusManager.java,0,23,0,14,0,37
dubbo-3.0\dubbo-3.0\dubbo-common\src\main\java\org\apache\dubbo\common\convert\multiple\StringToListConverter.java,11,6,0,1,0,7
dubbo-3.0\dubbo-3.0\dubbo-common\src\test\java\org\apache\dubbo\common\convert\multiple\StringToQueueConverterTest.java,68,12,5,3,0,20
dubbo-3.0\dubbo-3.0\dubbo-spring-boot\dubbo-spring-boot-autoconfigure\src\main\java\org\apache\dubbo\spring\boot\autoconfigure\BinderDubboConfigBinder.java,0,15,0,13,0,28
dubbo-3.0\dubbo-3.0\dubbo-common\src\test\java\org\apache\dubbo\common\extension\director\FooFrameworkService.java,0,1,0,1,0,2
dubbo-3.0\dubbo-3.0\dubbo-remoting\dubbo-remoting-api\src\main\java\org\apache\dubbo\remoting\transport\dispatcher\ChannelHandlers.java,25,10,1,2,0,13
dubbo-3.0\dubbo-3.0\dubbo-cluster\src\main\java\org\apache\dubbo\rpc\cluster\router\AbstractRouter.java,53,29,1,2,0,32
dubbo-3.0\dubbo-3.0\dubbo-rpc\dubbo-rpc-triple\src\main\java\org\apache\dubbo\rpc\protocol\tri\stream\ClientStream.java,0,7,1,6,0,14
dubbo-3.0\dubbo-3.0\dubbo-plugin\dubbo-qos\src\main\java\org\apache\dubbo\qos\protocol\QosProtocolWrapper.java,0,29,1,6,0,36
dubbo-3.0\dubbo-3.0\dubbo-metadata\dubbo-metadata-api\src\test\java\org\apache\dubbo\metadata\report\identifier\BaseServiceMetadataIdentifierTest.java,0,9,1,8,0,18
dubbo-3.0\dubbo-3.0\dubbo-rpc\dubbo-rpc-api\src\main\java\org\apache\dubbo\rpc\protocol\dubbo\FutureAdapter.java,68,16,3,5,0,24
dubbo-3.0\dubbo-3.0\dubbo-config\dubbo-config-api\src\test\java\org\apache\dubbo\config\mock\MockThreadPool.java,7,2,0,1,0,3
dubbo-3.0\dubbo-3.0\dubbo-serialization\dubbo-serialization-jdk\src\main\java\org\apache\dubbo\common\serialize\java\JavaSerialization.java,36,23,0,7,0,30
dubbo-3.0\dubbo-3.0\dubbo-serialization\dubbo-serialization-jdk\src\main\java\org\apache\dubbo\common\serialize\nativejava\NativeJavaSerialization.java,35,24,0,9,0,33
dubbo-3.0\dubbo-3.0\dubbo-serialization\dubbo-serialization-hessian2\src\main\java\org\apache\dubbo\common\serialize\hessian2\Hessian2SerializerFactory.java,7,1,2,1,0,4
dubbo-3.0\dubbo-3.0\dubbo-metadata\dubbo-metadata-processor\src\test\java\org\apache\dubbo\metadata\tools\Compiler.java,85,33,0,10,0,43
dubbo-3.0\dubbo-3.0\dubbo-rpc\dubbo-rpc-triple\src\test\java\org\apache\dubbo\rpc\protocol\tri\TripleInvokerTest.java,0,5,1,6,0,12
dubbo-3.0\dubbo-3.0\dubbo-metadata\dubbo-metadata-report-redis\src\test\java\org\apache\dubbo\metadata\store\redis\RedisMetadata4TstService.java,0,4,0,1,0,5
dubbo-3.0\dubbo-3.0\dubbo-remoting\dubbo-remoting-zookeeper-curator5\src\main\java\org\apache\dubbo\remoting\zookeeper\curator5\Curator5ZookeeperTransporter.java,9,2,0,1,0,3
dubbo-3.0\dubbo-3.0\dubbo-common\src\main\java\org\apache\dubbo\common\threadlocal\NamedInternalThreadFactory.java,23,10,0,2,0,12
dubbo-3.0\dubbo-3.0\dubbo-plugin\dubbo-qos\src\main\java\org\apache\dubbo\qos\command\BaseCommand.java,0,3,0,1,0,4
dubbo-3.0\dubbo-3.0\dubbo-metadata\dubbo-metadata-report-zookeeper\src\main\java\org\apache\dubbo\metadata\store\zookeeper\ZookeeperMetadataReport.java,214,111,1,30,0,142
dubbo-3.0\dubbo-3.0\dubbo-plugin\dubbo-qos\src\test\java\org\apache\dubbo\qos\textui\TKvTest.java,38,6,0,2,0,8
dubbo-3.0\dubbo-3.0\dubbo-rpc\dubbo-rpc-dubbo\src\main\java\org\apache\dubbo\rpc\protocol\dubbo\DubboInvoker.java,144,48,2,23,0,73
dubbo-3.0\dubbo-3.0\dubbo-config\dubbo-config-spring\src\main\java\org\apache\dubbo\config\spring\context\event\DubboBootstrapStopedEvent.java,21,5,0,3,0,8
dubbo-3.0\dubbo-3.0\dubbo-remoting\dubbo-remoting-api\src\main\java\org\apache\dubbo\remoting\exchange\Response.java,152,55,1,3,0,59
dubbo-3.0\dubbo-3.0\dubbo-cluster\src\test\java\org\apache\dubbo\rpc\cluster\support\wrapper\AbstractClusterTest.java,64,21,6,10,0,37
dubbo-3.0\dubbo-3.0\dubbo-metadata\dubbo-metadata-processor\src\main\java\org\apache\dubbo\metadata\annotation\processing\ClassPathMetadataStorage.java,67,20,3,6,0,29
dubbo-3.0\dubbo-3.0\dubbo-metadata\dubbo-metadata-processor\src\test\java\org\apache\dubbo\metadata\annotation\processing\model\Color.java,0,10,0,1,0,11
dubbo-3.0\dubbo-3.0\dubbo-rpc\dubbo-rpc-dubbo\src\test\java\org\apache\dubbo\rpc\protocol\dubbo\support\NonSerialized.java,4,1,0,1,0,2
dubbo-3.0\dubbo-3.0\dubbo-rpc\dubbo-rpc-triple\src\main\java\org\apache\dubbo\rpc\protocol\tri\frame\TriDecoder.java,147,37,0,10,0,47
dubbo-3.0\dubbo-3.0\dubbo-registry\dubbo-registry-api\src\test\java\org\apache\dubbo\registry\client\metadata\StandardMetadataServiceURLBuilderTest.java,53,16,3,10,0,29
dubbo-3.0\dubbo-3.0\dubbo-serialization\dubbo-serialization-jdk\src\main\java\org\apache\dubbo\common\serialize\java\JavaObjectInput.java,64,19,1,4,0,24
dubbo-3.0\dubbo-3.0\dubbo-demo\dubbo-demo-triple\src\main\java\org\apache\dubbo\demo\GreeterService.java,0,5,0,1,0,6
dubbo-3.0\dubbo-3.0\dubbo-rpc\dubbo-rpc-triple\src\main\java\org\apache\dubbo\rpc\protocol\tri\ClassLoadUtil.java,13,4,3,2,0,9
dubbo-3.0\dubbo-3.0\dubbo-common\src\test\java\org\apache\dubbo\common\extension\convert\String2IntegerConverter.java,3,2,0,1,0,3
dubbo-3.0\dubbo-3.0\dubbo-config\dubbo-config-api\src\test\java\org\apache\dubbo\config\api\DemoService.java,0,7,0,1,0,8
dubbo-3.0\dubbo-3.0\dubbo-rpc\dubbo-rpc-dubbo\src\test\java\org\apache\dubbo\rpc\protocol\dubbo\filter\TraceFilterTest.java,99,18,2,6,0,26
dubbo-3.0\dubbo-3.0\dubbo-common\src\test\java\org\apache\dubbo\common\threadlocal\InternalThreadLocalTest.java,247,63,16,36,0,115
dubbo-3.0\dubbo-3.0\dubbo-plugin\dubbo-qos\src\main\java\org\apache\dubbo\qos\command\impl\Online.java,6,2,0,1,0,3
dubbo-3.0\dubbo-3.0\dubbo-common\src\main\java\org\apache\dubbo\config\AbstractMethodConfig.java,211,110,0,6,0,116
dubbo-3.0\dubbo-3.0\dubbo-common\src\test\java\org\apache\dubbo\common\convert\ConverterTest.java,31,14,0,7,0,21
dubbo-3.0\dubbo-3.0\dubbo-remoting\dubbo-remoting-api\src\main\java\org\apache\dubbo\remoting\exchange\ExchangeChannel.java,0,6,0,4,0,10
dubbo-3.0\dubbo-3.0\dubbo-rpc\dubbo-rpc-api\src\test\java\org\apache\dubbo\rpc\filter\tps\StatItemTest.java,83,30,3,3,0,36
dubbo-3.0\dubbo-3.0\dubbo-rpc\dubbo-rpc-triple\src\test\java\org\apache\dubbo\rpc\protocol\tri\transport\AbstractH2TransportListenerTest.java,0,8,4,2,0,14
dubbo-3.0\dubbo-3.0\dubbo-common\src\test\java\org\apache\dubbo\common\URLTest.java,1043,263,84,137,0,484
dubbo-3.0\dubbo-3.0\dubbo-common\src\main\java\org\apache\dubbo\common\convert\multiple\StringToTransferQueueConverter.java,11,8,0,3,0,11
dubbo-3.0\dubbo-3.0\dubbo-config\dubbo-config-spring\src\main\java\org\apache\dubbo\config\spring\context\annotation\DubboConfigConfigurationRegistrar.java,24,11,0,6,0,17
dubbo-3.0\dubbo-3.0\dubbo-remoting\dubbo-remoting-api\src\main\java\org\apache\dubbo\remoting\transport\ChannelHandlerDispatcher.java,90,33,11,4,0,48
dubbo-3.0\dubbo-3.0\dubbo-compatible\src\main\java\com\alibaba\dubbo\common\threadpool\ThreadPool.java,0,3,0,2,0,5
dubbo-3.0\dubbo-3.0\dubbo-config\dubbo-config-spring\src\test\java\org\apache\dubbo\config\spring\reference\localcalla\LocalCallReferenceAnnotationTest.java,41,13,2,6,0,21
dubbo-3.0\dubbo-3.0\dubbo-common\src\test\java\org\apache\dubbo\common\extension\ext10_multi_names\impl\Ext10MultiNamesImpl.java,3,1,0,1,0,2
dubbo-3.0\dubbo-3.0\dubbo-rpc\dubbo-rpc-triple\src\test\java\org\apache\dubbo\rpc\protocol\tri\call\ClientCallTest.java,0,1,0,1,0,2
dubbo-3.0\dubbo-3.0\dubbo-registry\dubbo-registry-api\src\test\java\org\apache\dubbo\registry\ZKTools.java,305,137,3,25,0,165
dubbo-3.0\dubbo-3.0\dubbo-cluster\src\main\java\org\apache\dubbo\rpc\cluster\loadbalance\RandomLoadBalance.java,82,21,0,12,0,33
dubbo-3.0\dubbo-3.0\dubbo-common\src\test\java\org\apache\dubbo\common\utils\PojoUtilsTest.java,931,353,57,36,0,446
dubbo-3.0\dubbo-3.0\dubbo-common\src\test\java\org\apache\dubbo\common\convert\multiple\StringToArrayConverterTest.java,37,12,0,3,0,15
dubbo-3.0\dubbo-3.0\dubbo-metadata\dubbo-metadata-processor\src\main\java\org\apache\dubbo\metadata\annotation\processing\rest\jaxrs\FormParamParameterProcessor.java,8,5,0,5,0,10
dubbo-3.0\dubbo-3.0\dubbo-config\dubbo-config-spring\src\test\java\org\apache\dubbo\config\spring\reference\DubboConfigBeanInitializerTest.java,67,19,0,11,0,30
dubbo-3.0\dubbo-3.0\dubbo-registry\dubbo-registry-zookeeper\src\main\java\org\apache\dubbo\registry\zookeeper\ZookeeperRegistry.java,303,93,10,45,0,148
dubbo-3.0\dubbo-3.0\dubbo-remoting\dubbo-remoting-api\src\main\java\org\apache\dubbo\remoting\api\PortUnificationServer.java,147,43,3,19,0,65
dubbo-3.0\dubbo-3.0\dubbo-spring-boot\dubbo-spring-boot-compatible\actuator\src\main\java\org\apache\dubbo\spring\boot\actuate\autoconfigure\DubboEndpointAutoConfiguration.java,10,6,2,5,0,13
dubbo-3.0\dubbo-3.0\dubbo-common\src\test\java\org\apache\dubbo\common\extension\activate\impl\GroupActivateExtImpl.java,7,3,0,1,0,4
dubbo-3.0\dubbo-3.0\dubbo-compatible\src\main\java\com\alibaba\dubbo\rpc\Invocation.java,0,28,4,2,0,34
dubbo-3.0\dubbo-3.0\dubbo-remoting\dubbo-remoting-http\src\main\java\org\apache\dubbo\remoting\http\jetty\JettyLoggerAdapter.java,133,58,0,1,0,59
dubbo-3.0\dubbo-3.0\dubbo-common\src\main\java\org\apache\dubbo\common\logger\jcl\JclLogger.java,110,46,1,2,0,49
dubbo-3.0\dubbo-3.0\dubbo-rpc\dubbo-rpc-triple\src\test\java\org\apache\dubbo\rpc\protocol\tri\service\TriBuiltinServiceTest.java,18,6,0,5,0,11
dubbo-3.0\dubbo-3.0\dubbo-common\src\main\java\org\apache\dubbo\common\extension\inject\AdaptiveExtensionInjector.java,0,13,5,2,0,20
dubbo-3.0\dubbo-3.0\dubbo-rpc\dubbo-rpc-triple\src\main\java\org\apache\dubbo\rpc\protocol\tri\call\UnaryClientCallListener.java,0,12,0,2,0,14
dubbo-3.0\dubbo-3.0\dubbo-common\src\main\java\org\apache\dubbo\common\URLBuilder.java,0,187,0,15,0,202
dubbo-3.0\dubbo-3.0\dubbo-cluster\src\test\java\org\apache\dubbo\rpc\cluster\router\tag\TagStateRouterTest.java,94,33,3,10,0,46
dubbo-3.0\dubbo-3.0\dubbo-metadata\dubbo-metadata-api\src\main\java\org\apache\dubbo\metadata\rest\AbstractAnnotatedMethodParameterProcessor.java,22,28,0,12,0,40
dubbo-3.0\dubbo-3.0\dubbo-common\src\test\java\org\apache\dubbo\common\version\VersionTest.java,71,24,13,10,0,47
dubbo-3.0\dubbo-3.0\dubbo-common\src\main\java\org\apache\dubbo\common\bytecode\Proxy.java,206,45,1,25,0,71
dubbo-3.0\dubbo-3.0\dubbo-common\src\main\java\org\apache\dubbo\common\utils\MemberUtils.java,0,10,0,7,0,17
dubbo-3.0\dubbo-3.0\dubbo-common\src\test\java\org\apache\dubbo\common\beans\ScopeBeanFactoryTest.java,31,8,0,8,0,16
dubbo-3.0\dubbo-3.0\dubbo-compatible\src\main\java\com\alibaba\dubbo\rpc\cluster\Directory.java,0,5,0,5,0,10
dubbo-3.0\dubbo-3.0\dubbo-spring-boot\dubbo-spring-boot-compatible\actuator\src\main\java\org\apache\dubbo\spring\boot\actuate\health\DubboHealthIndicator.java,187,37,0,25,0,62
dubbo-3.0\dubbo-3.0\dubbo-registry\dubbo-registry-api\src\main\java\org\apache\dubbo\registry\client\migration\MigrationClusterInvoker.java,0,9,0,1,0,10
dubbo-3.0\dubbo-3.0\dubbo-registry\dubbo-registry-api\src\test\java\org\apache\dubbo\registry\client\metadata\ServiceInstanceMetadataUtilsTest.java,0,41,0,42,0,83
dubbo-3.0\dubbo-3.0\dubbo-remoting\dubbo-remoting-api\src\test\java\org\apache\dubbo\remoting\exchange\support\header\HeaderExchangeChannelTest.java,0,50,1,11,0,62
dubbo-3.0\dubbo-3.0\dubbo-common\src\test\java\org\apache\dubbo\common\utils\NetUtilsTest.java,358,140,68,53,0,261
dubbo-3.0\dubbo-3.0\dubbo-config\dubbo-config-spring\src\main\java\org\apache\dubbo\config\spring\context\DubboBootstrapStartStopListenerSpringAdapter.java,19,10,0,4,0,14
dubbo-3.0\dubbo-3.0\dubbo-remoting\dubbo-remoting-netty4\src\test\java\org\apache\dubbo\remoting\transport\netty4\NettyTransporterTest.java,39,7,0,3,0,10
dubbo-3.0\dubbo-3.0\dubbo-metadata\dubbo-metadata-processor\src\main\java\org\apache\dubbo\metadata\annotation\processing\rest\jaxrs\DefaultValueParameterProcessor.java,39,22,0,10,0,32
dubbo-3.0\dubbo-3.0\dubbo-common\src\main\java\org\apache\dubbo\common\convert\StringConverter.java,0,2,0,1,0,3
dubbo-3.0\dubbo-3.0\dubbo-rpc\dubbo-rpc-grpc\src\main\java\org\apache\dubbo\rpc\protocol\grpc\interceptors\ServerInterceptor.java,0,1,0,2,0,3
dubbo-3.0\dubbo-3.0\dubbo-spring-boot\dubbo-spring-boot-compatible\autoconfigure\src\main\java\org\apache\dubbo\spring\boot\autoconfigure\DubboListenerAutoConfiguration.java,15,8,0,7,0,15
dubbo-3.0\dubbo-3.0\dubbo-common\src\main\java\org\apache\dubbo\common\convert\StringToShortConverter.java,14,4,0,1,0,5
dubbo-3.0\dubbo-3.0\dubbo-test\dubbo-test-check\src\main\java\org\apache\dubbo\test\check\registrycenter\processor\ZookeeperWindowsProcessor.java,17,5,0,5,0,10
dubbo-3.0\dubbo-3.0\dubbo-common\src\test\java\org\apache\dubbo\common\extension\ext2\impl\Ext2Impl3.java,11,8,0,1,0,9
dubbo-3.0\dubbo-3.0\dubbo-remoting\dubbo-remoting-api\src\test\java\org\apache\dubbo\remoting\exchange\support\header\MockChannel.java,0,38,5,1,0,44
dubbo-3.0\dubbo-3.0\dubbo-cluster\src\test\java\org\apache\dubbo\rpc\cluster\directory\MockDirInvocation.java,135,56,2,2,0,60
dubbo-3.0\dubbo-3.0\dubbo-common\src\test\java\org\apache\dubbo\metadata\definition\service\annotation\MockTypeAnnotation.java,0,1,0,1,0,2
dubbo-3.0\dubbo-3.0\dubbo-common\src\main\java\org\apache\dubbo\common\threadpool\manager\FrameworkExecutorRepository.java,186,66,1,31,0,98
dubbo-3.0\dubbo-3.0\dubbo-common\src\main\java\org\apache\dubbo\common\convert\multiple\StringToCollectionConverter.java,11,7,0,2,0,9
dubbo-3.0\dubbo-3.0\dubbo-remoting\dubbo-remoting-http\src\main\java\org\apache\dubbo\remoting\http\jetty\JettyHttpServer.java,72,18,1,11,0,30
dubbo-3.0\dubbo-3.0\dubbo-serialization\dubbo-serialization-api\src\main\java\org\apache\dubbo\common\serialize\MultipleSerialization.java,0,4,0,3,0,7
dubbo-3.0\dubbo-3.0\dubbo-rpc\dubbo-rpc-grpc\src\test\java\org\apache\dubbo\rpc\protocol\grpc\support\HelloWorldProto.java,0,23,1,4,0,28
dubbo-3.0\dubbo-3.0\dubbo-cluster\src\main\java\org\apache\dubbo\rpc\cluster\RouterFactory.java,0,4,0,5,0,9
dubbo-3.0\dubbo-3.0\dubbo-remoting\dubbo-remoting-api\src\test\java\org\apache\dubbo\remoting\transport\ChannelHandlerDispatcherTest.java,0,20,0,7,0,27
dubbo-3.0\dubbo-3.0\dubbo-config\dubbo-config-spring\src\test\java\org\apache\dubbo\config\spring\context\annotation\EnableDubboConfigTest.java,95,29,1,18,0,48
dubbo-3.0\dubbo-3.0\compiler\src\main\java\org\apache\dubbo\gen\grpc\DubboGrpcGenerator.java,20,5,0,1,0,6
dubbo-3.0\dubbo-3.0\dubbo-common\src\test\java\org\apache\dubbo\common\utils\ArrayUtilsTest.java,18,2,0,1,0,3
dubbo-3.0\dubbo-3.0\dubbo-plugin\dubbo-qos\src\test\java\org\apache\dubbo\qos\command\impl\LiveTest.java,28,8,0,1,0,9
dubbo-3.0\dubbo-3.0\dubbo-config\dubbo-config-spring\src\test\java\org\apache\dubbo\config\spring\propertyconfigurer\consumer\PropertyConfigurerTest.java,48,13,2,11,0,26
dubbo-3.0\dubbo-3.0\dubbo-remoting\dubbo-remoting-api\src\main\java\org\apache\dubbo\remoting\transport\ClientDelegate.java,115,41,1,1,0,43
dubbo-3.0\dubbo-3.0\dubbo-registry\dubbo-registry-api\src\main\java\org\apache\dubbo\registry\client\metadata\SpringCloudMetadataServiceURLBuilder.java,15,9,0,8,0,17
dubbo-3.0\dubbo-3.0\dubbo-config\dubbo-config-spring\src\test\java\org\apache\dubbo\config\spring\samples\ZookeeperDubboSpringConsumerXmlBootstrap.java,16,8,1,4,0,13
dubbo-3.0\dubbo-3.0\dubbo-cluster\src\main\java\org\apache\dubbo\rpc\cluster\support\registry\ZoneAwareClusterInvoker.java,70,24,1,15,0,40
dubbo-3.0\dubbo-3.0\dubbo-remoting\dubbo-remoting-api\src\test\java\org\apache\dubbo\remoting\PerformanceClientFixedTest.java,107,19,5,11,0,35
dubbo-3.0\dubbo-3.0\dubbo-remoting\dubbo-remoting-api\src\main\java\org\apache\dubbo\remoting\transport\AbstractEndpoint.java,71,23,4,8,0,35
dubbo-3.0\dubbo-3.0\dubbo-common\src\main\java\org\apache\dubbo\common\utils\UrlUtils.java,597,146,6,81,0,233
dubbo-3.0\dubbo-3.0\dubbo-registry\dubbo-registry-api\src\test\java\org\apache\dubbo\registry\RegistryServiceListener1.java,24,14,0,1,0,15
dubbo-3.0\dubbo-3.0\dubbo-config\dubbo-config-api\src\test\java\org\apache\dubbo\config\utils\ConfigValidationUtilsTest.java,62,5,0,1,0,6
dubbo-3.0\dubbo-3.0\dubbo-rpc\dubbo-rpc-api\src\main\java\org\apache\dubbo\rpc\stub\UnaryStubMethodHandler.java,0,7,0,2,0,9
dubbo-3.0\dubbo-3.0\dubbo-rpc\dubbo-rpc-triple\src\main\java\org\apache\dubbo\rpc\protocol\tri\call\ServerStreamServerCallListener.java,32,11,1,2,0,14
dubbo-3.0\dubbo-3.0\dubbo-native\src\main\java\org\apache\dubbo\registry\RegistryFactory$Adaptive.java,0,16,11,6,0,33
dubbo-3.0\dubbo-3.0\dubbo-config\dubbo-config-spring\src\test\java\org\apache\dubbo\config\spring\beans\factory\config\YamlPropertySourceFactoryTest.java,34,16,0,9,0,25
dubbo-3.0\dubbo-3.0\dubbo-compatible\src\main\java\com\alibaba\dubbo\monitor\Monitor.java,0,5,0,3,0,8
dubbo-3.0\dubbo-3.0\dubbo-common\src\main\java\org\apache\dubbo\common\URL.java,0,957,9,122,0,1088
dubbo-3.0\dubbo-3.0\dubbo-common\src\test\java\org\apache\dubbo\common\status\reporter\MockFrameworkStatusReporter.java,13,7,0,1,0,8
dubbo-3.0\dubbo-3.0\dubbo-metadata\dubbo-metadata-processor\src\main\java\org\apache\dubbo\metadata\annotation\processing\builder\MethodDefinitionBuilder.java,0,7,0,8,0,15
dubbo-3.0\dubbo-3.0\dubbo-remoting\dubbo-remoting-api\src\test\java\org\apache\dubbo\remoting\exchange\support\MultiMessageTest.java,39,7,0,5,0,12
dubbo-3.0\dubbo-3.0\dubbo-rpc\dubbo-rpc-triple\src\main\java\org\apache\dubbo\rpc\protocol\tri\transport\H2TransportListener.java,0,4,0,2,0,6
dubbo-3.0\dubbo-3.0\dubbo-common\src\test\java\org\apache\dubbo\common\extension\ext5\NoAdaptiveMethodExt.java,0,2,0,1,0,3
dubbo-3.0\dubbo-3.0\dubbo-rpc\dubbo-rpc-triple\src\main\java\org\apache\dubbo\rpc\protocol\tri\command\EndStreamQueueCommand.java,12,4,0,1,0,5
dubbo-3.0\dubbo-3.0\dubbo-metadata\dubbo-metadata-processor\src\main\java\org\apache\dubbo\metadata\annotation\processing\rest\jaxrs\MatrixParamParameterProcessor.java,8,5,0,5,0,10
dubbo-3.0\dubbo-3.0\dubbo-common\src\main\java\org\apache\dubbo\config\Constants.java,0,39,42,7,0,88
dubbo-3.0\dubbo-3.0\dubbo-remoting\dubbo-remoting-api\src\main\java\org\apache\dubbo\remoting\Transporter.java,0,3,0,4,0,7
dubbo-3.0\dubbo-3.0\dubbo-remoting\dubbo-remoting-api\src\main\java\org\apache\dubbo\remoting\utils\PayloadDropper.java,26,6,1,2,0,9
dubbo-3.0\dubbo-3.0\dubbo-plugin\dubbo-qos\src\main\java\org\apache\dubbo\qos\common\QosConstants.java,0,5,3,1,0,9
dubbo-3.0\dubbo-3.0\dubbo-common\src\test\java\org\apache\dubbo\common\extension\ExtensionLoader_Compatible_Test.java,9,5,2,3,0,10
dubbo-3.0\dubbo-3.0\dubbo-rpc\dubbo-rpc-api\src\test\java\org\apache\dubbo\rpc\support\RuntimeExceptionInvoker.java,12,4,0,1,0,5
dubbo-3.0\dubbo-3.0\dubbo-native\src\main\java\org\apache\dubbo\common\serialize\Serialization$Adaptive.java,0,33,18,12,0,63
dubbo-3.0\dubbo-3.0\dubbo-rpc\dubbo-rpc-api\src\main\java\org\apache\dubbo\rpc\protocol\AbstractProtocol.java,0,42,4,13,0,59
dubbo-3.0\dubbo-3.0\dubbo-configcenter\dubbo-configcenter-zookeeper\src\main\java\org\apache\dubbo\configcenter\support\zookeeper\ZookeeperDynamicConfigurationFactory.java,22,15,2,6,0,23
dubbo-3.0\dubbo-3.0\dubbo-common\src\main\java\org\apache\dubbo\common\context\ModuleExt.java,0,0,0,1,0,1
dubbo-3.0\dubbo-3.0\dubbo-cluster\src\main\java\org\apache\dubbo\rpc\cluster\support\FailsafeClusterInvoker.java,20,14,2,6,0,22
dubbo-3.0\dubbo-3.0\dubbo-filter\dubbo-filter-validation\src\test\java\org\apache\dubbo\validation\support\jvalidation\JValidatorTest.java,57,21,0,15,0,36
dubbo-3.0\dubbo-3.0\dubbo-common\src\test\java\org\apache\dubbo\rpc\model\ScopeModelAwareExtensionProcessorTest.java,52,21,0,12,0,33
dubbo-3.0\dubbo-3.0\dubbo-rpc\dubbo-rpc-grpc\src\main\java\org\apache\dubbo\rpc\protocol\grpc\interceptors\RpcContextInterceptor.java,0,29,3,18,0,50
dubbo-3.0\dubbo-3.0\dubbo-registry\dubbo-registry-api\src\main\java\org\apache\dubbo\registry\integration\RegistryProtocolListener.java,0,7,0,4,0,11
dubbo-3.0\dubbo-3.0\dubbo-compatible\src\test\java\org\apache\dubbo\echo\EchoServiceTest.java,22,7,2,6,0,15
dubbo-3.0\dubbo-3.0\dubbo-cluster\src\main\java\org\apache\dubbo\rpc\cluster\configurator\parser\model\ConfiguratorConfig.java,76,49,0,6,0,55
dubbo-3.0\dubbo-3.0\dubbo-config\dubbo-config-api\src\test\java\org\apache\dubbo\config\bootstrap\rest\UserService.java,0,1,3,1,0,5
dubbo-3.0\dubbo-3.0\dubbo-common\src\main\java\org\apache\dubbo\rpc\model\ApplicationModel.java,404,127,2,33,0,162
dubbo-3.0\dubbo-3.0\dubbo-rpc\dubbo-rpc-api\src\main\java\org\apache\dubbo\rpc\filter\TokenFilter.java,21,11,1,6,0,18
dubbo-3.0\dubbo-3.0\dubbo-common\src\main\java\org\apache\dubbo\rpc\model\ConsumerMethodModel.java,74,34,0,3,0,37
dubbo-3.0\dubbo-3.0\dubbo-config\dubbo-config-spring\src\test\java\org\apache\dubbo\config\spring\context\annotation\DubboConfigConfigurationTest.java,57,19,0,10,0,29
dubbo-3.0\dubbo-3.0\dubbo-cluster\src\test\java\org\apache\dubbo\rpc\cluster\support\wrapper\MyMockException.java,10,2,0,1,0,3
dubbo-3.0\dubbo-3.0\dubbo-common\src\test\java\org\apache\dubbo\common\extension\support\ActivateComparatorTest.java,59,12,0,2,0,14
dubbo-3.0\dubbo-3.0\dubbo-config\dubbo-config-api\src\test\java\org\apache\dubbo\config\integration\single\exportprovider\SingleRegistryCenterExportProviderRegistryProtocolListener.java,40,15,2,8,0,25
dubbo-3.0\dubbo-3.0\dubbo-native\src\main\java\org\apache\dubbo\rpc\ProxyFactory$Adaptive.java,0,44,33,18,0,95
dubbo-3.0\dubbo-3.0\dubbo-common\src\test\java\org\apache\dubbo\common\beanutil\JavaBeanAccessorTest.java,17,10,0,7,0,17
dubbo-3.0\dubbo-3.0\dubbo-config\dubbo-config-api\src\main\java\org\apache\dubbo\config\bootstrap\DubboBootstrapStartStopListener.java,0,3,0,1,0,4
dubbo-3.0\dubbo-3.0\dubbo-rpc\dubbo-rpc-injvm\src\test\java\org\apache\dubbo\rpc\protocol\injvm\InjvmClassLoaderTest.java,204,70,5,44,0,119
dubbo-3.0\dubbo-3.0\dubbo-rpc\dubbo-rpc-api\src\test\java\org\apache\dubbo\rpc\filter\GenericImplFilterTest.java,78,28,2,15,0,45
dubbo-3.0\dubbo-3.0\dubbo-common\src\main\java\org\apache\dubbo\common\utils\Log.java,95,34,0,4,0,38
dubbo-3.0\dubbo-3.0\dubbo-plugin\dubbo-qos\src\main\java\org\apache\dubbo\qos\command\impl\SetProfilerWarnPercent.java,14,9,1,4,0,14
dubbo-3.0\dubbo-3.0\dubbo-common\src\test\java\org\apache\dubbo\common\io\UnsafeByteArrayOutputStreamTest.java,47,14,1,6,0,21
dubbo-3.0\dubbo-3.0\dubbo-cluster\src\main\java\org\apache\dubbo\rpc\cluster\router\condition\config\ListenableStateRouter.java,105,44,6,18,0,68
dubbo-3.0\dubbo-3.0\dubbo-compatible\src\main\java\com\alibaba\dubbo\rpc\Invoker.java,0,15,0,3,0,18
dubbo-3.0\dubbo-3.0\dubbo-metadata\dubbo-metadata-processor\src\main\java\org\apache\dubbo\metadata\annotation\processing\util\LoggerUtils.java,0,4,0,1,0,5
dubbo-3.0\dubbo-3.0\dubbo-cluster\src\main\java\org\apache\dubbo\rpc\cluster\configurator\AbstractConfigurator.java,124,35,1,22,0,58
dubbo-3.0\dubbo-3.0\dubbo-registry\dubbo-registry-api\src\main\java\org\apache\dubbo\registry\client\migration\MigrationAddressComparator.java,0,3,0,2,0,5
dubbo-3.0\dubbo-3.0\dubbo-common\src\main\java\org\apache\dubbo\common\bytecode\Wrapper.java,422,94,4,51,0,149
dubbo-3.0\dubbo-3.0\dubbo-remoting\dubbo-remoting-netty\src\test\java\org\apache\dubbo\remoting\transport\netty\NettyClientTest.java,46,27,3,6,0,36
dubbo-3.0\dubbo-3.0\dubbo-cluster\src\main\java\org\apache\dubbo\rpc\cluster\router\RouterSnapshotNode.java,139,66,0,7,0,73
dubbo-3.0\dubbo-3.0\dubbo-config\dubbo-config-spring\src\test\java\org\apache\dubbo\config\spring\context\annotation\consumer\ConsumerConfiguration.java,107,46,1,4,0,51
dubbo-3.0\dubbo-3.0\dubbo-common\src\main\java\org\apache\dubbo\common\utils\JVMUtil.java,71,11,1,4,0,16
dubbo-3.0\dubbo-3.0\dubbo-rpc\dubbo-rpc-api\src\main\java\org\apache\dubbo\rpc\support\RpcUtils.java,228,78,11,27,0,116
dubbo-3.0\dubbo-3.0\dubbo-metadata\dubbo-metadata-processor\src\test\java\org\apache\dubbo\metadata\rest\StandardRestService.java,70,25,2,5,0,32
dubbo-3.0\dubbo-3.0\dubbo-plugin\dubbo-qos\src\main\java\org\apache\dubbo\qos\command\impl\BaseOffline.java,58,21,0,6,0,27
dubbo-3.0\dubbo-3.0\dubbo-cluster\src\test\java\org\apache\dubbo\rpc\cluster\support\AbstractClusterInvokerTest.java,506,189,11,78,0,278
dubbo-3.0\dubbo-3.0\dubbo-remoting\dubbo-remoting-api\src\test\java\org\apache\dubbo\remoting\MockTransporter.java,15,10,0,3,0,13
dubbo-3.0\dubbo-3.0\dubbo-common\src\test\java\org\apache\dubbo\common\utils\ReflectUtilsTest.java,502,167,28,75,0,270
dubbo-3.0\dubbo-3.0\dubbo-cluster\src\main\java\org\apache\dubbo\rpc\cluster\directory\StaticDirectory.java,86,37,2,10,0,49
dubbo-3.0\dubbo-3.0\dubbo-common\src\main\java\org\apache\dubbo\rpc\service\GenericService.java,0,8,4,4,0,16
dubbo-3.0\dubbo-3.0\dubbo-cluster\src\test\java\org\apache\dubbo\rpc\cluster\support\FailfastClusterInvokerTest.java,101,25,0,9,0,34
dubbo-3.0\dubbo-3.0\dubbo-common\src\main\java\org\apache\dubbo\common\utils\MethodComparator.java,40,8,1,4,0,13
dubbo-3.0\dubbo-3.0\dubbo-plugin\dubbo-qos\src\main\java\org\apache\dubbo\qos\legacy\LogTelnetHandler.java,54,12,2,7,0,21
dubbo-3.0\dubbo-3.0\dubbo-test\dubbo-test-common\src\main\java\org\apache\dubbo\test\common\SysProps.java,22,9,1,2,0,12
dubbo-3.0\dubbo-3.0\dubbo-common\src\test\java\org\apache\dubbo\common\extension\ext8_add\impl\AddExt1Impl1.java,6,5,0,1,0,6
dubbo-3.0\dubbo-3.0\dubbo-config\dubbo-config-api\src\test\java\org\apache\dubbo\config\integration\multiple\exportprovider\MultipleRegistryCenterExportProviderServiceListener.java,11,3,0,4,0,7
dubbo-3.0\dubbo-3.0\dubbo-rpc\dubbo-rpc-dubbo\src\test\java\org\apache\dubbo\rpc\protocol\dubbo\filter\MockChannel.java,93,31,4,1,0,36
dubbo-3.0\dubbo-3.0\dubbo-rpc\dubbo-rpc-dubbo\src\test\java\org\apache\dubbo\rpc\protocol\dubbo\support\Person.java,23,15,0,1,0,16
dubbo-3.0\dubbo-3.0\dubbo-compatible\src\main\java\com\alibaba\dubbo\config\ArgumentConfig.java,0,0,0,1,0,1
dubbo-3.0\dubbo-3.0\dubbo-cluster\src\test\java\org\apache\dubbo\rpc\cluster\router\script\ScriptStateRouterTest.java,104,45,3,17,0,65
dubbo-3.0\dubbo-3.0\dubbo-plugin\dubbo-qos\src\main\java\org\apache\dubbo\qos\textui\TTable.java,533,115,3,14,0,132
dubbo-3.0\dubbo-3.0\dubbo-config\dubbo-config-spring\src\main\java\org\apache\dubbo\config\spring\util\SpringCompatUtils.java,97,30,5,16,0,51
dubbo-3.0\dubbo-3.0\dubbo-config\dubbo-config-api\src\test\java\org\apache\dubbo\config\bootstrap\EchoService.java,0,4,0,1,0,5
dubbo-3.0\dubbo-3.0\dubbo-plugin\dubbo-auth\src\main\java\org\apache\dubbo\auth\model\AccessKeyPair.java,69,52,0,1,0,53
dubbo-3.0\dubbo-3.0\dubbo-config\dubbo-config-api\src\test\java\org\apache\dubbo\config\integration\multiple\servicediscoveryregistry\ServiceDiscoveryRegistryInfoWrapper.java,50,39,1,3,0,43
dubbo-3.0\dubbo-3.0\dubbo-rpc\dubbo-rpc-api\src\main\java\org\apache\dubbo\rpc\proxy\javassist\JavassistProxyFactory.java,59,38,10,16,0,64
dubbo-3.0\dubbo-3.0\dubbo-config\dubbo-config-spring\src\test\java\org\apache\dubbo\config\spring\beans\factory\annotation\MergedAnnotationTest.java,46,10,2,6,0,18
dubbo-3.0\dubbo-3.0\dubbo-cluster\src\test\java\org\apache\dubbo\rpc\cluster\support\Menu.java,43,20,1,3,0,24
dubbo-3.0\dubbo-3.0\dubbo-demo\dubbo-demo-spring-boot\dubbo-demo-spring-boot-provider\src\main\java\org\apache\dubbo\springboot\demo\provider\DemoServiceImpl.java,11,4,0,2,0,6
dubbo-3.0\dubbo-3.0\dubbo-registry\dubbo-registry-nacos\src\main\java\org\apache\dubbo\registry\nacos\util\NacosInstanceManageUtil.java,36,22,1,10,0,33
dubbo-3.0\dubbo-3.0\dubbo-compatible\src\test\java\org\apache\dubbo\serialization\MySerialization.java,23,11,0,3,0,14
dubbo-3.0\dubbo-3.0\dubbo-metadata\dubbo-metadata-api\src\main\java\org\apache\dubbo\metadata\report\identifier\KeyTypeEnum.java,0,16,0,2,0,18
dubbo-3.0\dubbo-3.0\dubbo-rpc\dubbo-rpc-api\src\main\java\org\apache\dubbo\rpc\stub\BiStreamMethodHandler.java,0,8,0,2,0,10
dubbo-3.0\dubbo-3.0\dubbo-rpc\dubbo-rpc-api\src\main\java\org\apache\dubbo\rpc\proxy\jdk\JdkProxyFactory.java,23,15,0,3,0,18
dubbo-3.0\dubbo-3.0\dubbo-rpc\dubbo-rpc-rest\src\main\java\org\apache\dubbo\rpc\protocol\rest\integration\swagger\DubboSwaggerApiListingResource.java,17,14,0,6,0,20
dubbo-3.0\dubbo-3.0\dubbo-config\dubbo-config-api\src\test\java\org\apache\dubbo\config\ConfigScopeModelInitializerTest.java,24,9,0,1,0,10
dubbo-3.0\dubbo-3.0\dubbo-common\src\test\java\org\apache\dubbo\common\model\SerializablePerson.java,80,47,11,2,0,60
dubbo-3.0\dubbo-3.0\dubbo-config\dubbo-config-api\src\main\java\org\apache\dubbo\config\metadata\ConfigurableMetadataServiceExporter.java,146,39,3,17,0,59
dubbo-3.0\dubbo-3.0\dubbo-common\src\test\java\org\apache\dubbo\common\extension\ext11_no_adaptive\NoAdaptiveExt.java,0,3,0,1,0,4
dubbo-3.0\dubbo-3.0\dubbo-metadata\dubbo-metadata-processor\src\main\java\org\apache\dubbo\metadata\annotation\processing\util\ExecutableElementComparator.java,37,12,1,8,0,21
dubbo-3.0\dubbo-3.0\dubbo-test\dubbo-test-check\src\main\java\org\apache\dubbo\test\check\registrycenter\ZookeeperRegistryCenter.java,0,41,6,28,0,75
dubbo-3.0\dubbo-3.0\dubbo-cluster\src\test\java\org\apache\dubbo\rpc\cluster\loadbalance\ShortestResponseLoadBalanceTest.java,79,21,7,16,0,44
dubbo-3.0\dubbo-3.0\dubbo-metadata\dubbo-metadata-api\src\main\java\org\apache\dubbo\metadata\rest\springmvc\RequestHeaderParameterProcessor.java,15,15,0,6,0,21
dubbo-3.0\dubbo-3.0\dubbo-config\dubbo-config-spring\src\main\java\org\apache\dubbo\config\spring\context\annotation\DubboComponentScan.java,0,9,0,7,0,16
dubbo-3.0\dubbo-3.0\dubbo-compatible\src\main\java\com\alibaba\dubbo\remoting\Codec.java,0,0,0,1,0,1
dubbo-3.0\dubbo-3.0\dubbo-plugin\dubbo-qos\src\main\java\org\apache\dubbo\qos\command\util\ServiceCheckUtils.java,37,9,1,5,0,15
dubbo-3.0\dubbo-3.0\dubbo-common\src\test\java\org\apache\dubbo\common\extension\ext1\impl\SimpleExtImpl2.java,15,12,0,1,0,13
dubbo-3.0\dubbo-3.0\dubbo-rpc\dubbo-rpc-api\src\main\java\org\apache\dubbo\rpc\filter\ClassLoaderFilter.java,0,21,1,10,0,32
dubbo-3.0\dubbo-3.0\dubbo-config\dubbo-config-api\src\test\java\org\apache\dubbo\config\integration\single\exportmetadata\SingleRegistryCenterExportMetadataServiceListener.java,11,3,0,4,0,7
dubbo-3.0\dubbo-3.0\dubbo-cluster\src\test\java\org\apache\dubbo\rpc\cluster\loadbalance\AbstractLoadBalanceTest.java,49,27,0,14,0,41
dubbo-3.0\dubbo-3.0\dubbo-remoting\dubbo-remoting-netty4\src\main\java\org\apache\dubbo\remoting\transport\netty4\NettyTransporter.java,16,9,0,3,0,12
dubbo-3.0\dubbo-3.0\dubbo-cluster\src\test\java\org\apache\dubbo\rpc\cluster\support\registry\ZoneAwareClusterInvokerTest.java,0,23,3,9,0,35
dubbo-3.0\dubbo-3.0\dubbo-demo\dubbo-demo-interface\src\main\java\org\apache\dubbo\demo\DemoService.java,0,3,0,1,0,4
dubbo-3.0\dubbo-3.0\dubbo-common\src\main\java\org\apache\dubbo\common\bytecode\ClassGenerator.java,0,119,3,23,0,145
dubbo-3.0\dubbo-3.0\dubbo-remoting\dubbo-remoting-netty\src\test\java\org\apache\dubbo\remoting\transport\netty\NettyClientToServerTest.java,18,13,0,4,0,17
dubbo-3.0\dubbo-3.0\dubbo-remoting\dubbo-remoting-api\src\main\java\org\apache\dubbo\remoting\utils\UrlUtils.java,16,10,1,5,0,16
dubbo-3.0\dubbo-3.0\dubbo-rpc\dubbo-rpc-triple\src\main\java\org\apache\dubbo\rpc\protocol\tri\TriplePathResolver.java,37,16,0,3,0,19
dubbo-3.0\dubbo-3.0\dubbo-cluster\src\main\java\org\apache\dubbo\rpc\cluster\router\mesh\rule\virtualservice\match\ListStringMatch.java,23,10,0,1,0,11
dubbo-3.0\dubbo-3.0\dubbo-common\src\test\java\org\apache\dubbo\common\extension\ext8_add\impl\AddExt3_ManualAdaptive.java,7,6,1,2,0,9
dubbo-3.0\dubbo-3.0\dubbo-config\dubbo-config-spring\src\test\java\org\apache\dubbo\config\spring\issues\issue6000\adubbo\HelloDubbo.java,12,10,0,1,0,11
dubbo-3.0\dubbo-3.0\dubbo-spring-boot\dubbo-spring-boot-compatible\autoconfigure\src\test\java\org\apache\dubbo\spring\boot\context\event\WelcomeLogoApplicationListenerTest.java,14,3,0,1,0,4
dubbo-3.0\dubbo-3.0\dubbo-common\src\main\java\org\apache\dubbo\common\utils\PojoUtils.java,0,154,25,78,0,257
dubbo-3.0\dubbo-3.0\dubbo-common\src\test\java\org\apache\dubbo\common\URLStrParserTest.java,52,14,0,5,0,19
dubbo-3.0\dubbo-3.0\dubbo-common\src\main\java\org\apache\dubbo\common\infra\InfraAdapter.java,0,7,0,4,0,11
dubbo-3.0\dubbo-3.0\dubbo-compatible\src\main\java\com\alibaba\dubbo\remoting\Server.java,0,0,0,1,0,1
dubbo-3.0\dubbo-3.0\dubbo-common\src\test\java\org\apache\dubbo\common\bytecode\ClassGeneratorTest.java,0,20,10,6,0,36
dubbo-3.0\dubbo-3.0\dubbo-remoting\dubbo-remoting-api\src\main\java\org\apache\dubbo\remoting\Channel.java,0,1,0,1,0,2
dubbo-3.0\dubbo-3.0\dubbo-rpc\dubbo-rpc-grpc\src\main\java\org\apache\dubbo\rpc\protocol\grpc\GrpcProtocol.java,198,63,2,23,0,88
dubbo-3.0\dubbo-3.0\dubbo-registry\dubbo-registry-api\src\main\java\org\apache\dubbo\registry\integration\InterfaceCompatibleRegistryProtocol.java,41,29,0,9,0,38
dubbo-3.0\dubbo-3.0\dubbo-rpc\dubbo-rpc-rest\src\test\java\org\apache\dubbo\rpc\protocol\rest\integration\swagger\SwaggerService.java,0,1,2,1,0,4
dubbo-3.0\dubbo-3.0\dubbo-common\src\test\java\org\apache\dubbo\metadata\definition\service\DemoService.java,0,8,0,5,0,13
dubbo-3.0\dubbo-3.0\dubbo-spring-boot\dubbo-spring-boot-compatible\autoconfigure\src\main\java\org\apache\dubbo\spring\boot\context\event\WelcomeLogoApplicationListener.java,54,14,0,8,0,22
dubbo-3.0\dubbo-3.0\dubbo-compatible\src\test\java\org\apache\dubbo\service\Type.java,0,3,0,1,0,4
dubbo-3.0\dubbo-3.0\dubbo-rpc\dubbo-rpc-api\src\test\java\org\apache\dubbo\rpc\stub\BiStreamMethodHandlerTest.java,0,5,0,5,0,10
dubbo-3.0\dubbo-3.0\dubbo-config\dubbo-config-api\src\test\java\org\apache\dubbo\config\integration\multiple\exportmetadata\MultipleRegistryCenterExportMetadataServiceImpl.java,11,4,0,3,0,7
dubbo-3.0\dubbo-3.0\dubbo-remoting\dubbo-remoting-api\src\test\java\org\apache\dubbo\remoting\handler\MockedChannelHandler.java,36,21,0,4,0,25
dubbo-3.0\dubbo-3.0\dubbo-common\src\main\java\org\apache\dubbo\common\convert\StringToCharacterConverter.java,20,6,0,2,0,8
dubbo-3.0\dubbo-3.0\dubbo-common\src\test\java\org\apache\dubbo\common\extension\wrapper\impl\DemoImpl.java,7,3,0,1,0,4
dubbo-3.0\dubbo-3.0\dubbo-rpc\dubbo-rpc-api\src\main\java\org\apache\dubbo\rpc\listener\ExporterListenerAdapter.java,12,3,2,1,0,6
dubbo-3.0\dubbo-3.0\dubbo-metadata\dubbo-metadata-processor\src\test\java\org\apache\dubbo\metadata\tools\RestServiceTest.java,11,2,0,1,0,3
dubbo-3.0\dubbo-3.0\dubbo-serialization\dubbo-serialization-jdk\src\main\java\org\apache\dubbo\common\serialize\java\JavaObjectOutput.java,35,13,0,3,0,16
dubbo-3.0\dubbo-3.0\dubbo-common\src\main\java\org\apache\dubbo\common\utils\ConfigUtils.java,316,80,22,30,0,132
dubbo-3.0\dubbo-3.0\dubbo-spring-boot\dubbo-spring-boot-compatible\autoconfigure\src\test\java\org\apache\dubbo\spring\boot\autoconfigure\CompatibleDubboAutoConfigurationTest.java,18,7,1,5,0,13
dubbo-3.0\dubbo-3.0\dubbo-common\src\main\java\org\apache\dubbo\metadata\definition\builder\TypeBuilder.java,0,7,0,2,0,9
dubbo-3.0\dubbo-3.0\dubbo-registry\dubbo-registry-multicast\src\test\java\org\apache\dubbo\registry\multicast\MulticastRegistryTest.java,235,50,8,26,0,84
dubbo-3.0\dubbo-3.0\dubbo-rpc\dubbo-rpc-api\src\test\java\org\apache\dubbo\rpc\protocol\CountInvokerListener.java,20,8,1,1,0,10
dubbo-3.0\dubbo-3.0\dubbo-config\dubbo-config-api\src\test\java\org\apache\dubbo\config\integration\multiple\exportprovider\MultipleRegistryCenterExportProviderExporterListener.java,11,3,0,3,0,6
dubbo-3.0\dubbo-3.0\dubbo-config\dubbo-config-api\src\test\java\org\apache\dubbo\config\bootstrap\builders\ProtocolBuilderTest.java,0,50,0,19,0,69
dubbo-3.0\dubbo-3.0\dubbo-filter\dubbo-filter-cache\src\test\java\org\apache\dubbo\cache\filter\CacheFilterTest.java,103,34,0,7,0,41
dubbo-3.0\dubbo-3.0\dubbo-metadata\dubbo-metadata-api\src\main\java\org\apache\dubbo\metadata\AbstractCacheManager.java,127,61,2,8,0,71
dubbo-3.0\dubbo-3.0\dubbo-metadata\dubbo-metadata-processor\src\test\java\org\apache\dubbo\metadata\annotation\processing\builder\SimpleTypeDefinitionBuilderTest.java,109,22,0,5,0,27
dubbo-3.0\dubbo-3.0\dubbo-test\dubbo-test-check\src\main\java\org\apache\dubbo\test\check\registrycenter\initializer\DownloadZookeeperInitializer.java,137,49,3,33,0,85
dubbo-3.0\dubbo-3.0\dubbo-metadata\dubbo-metadata-processor\src\test\java\org\apache\dubbo\metadata\annotation\processing\builder\ArrayTypeDefinitionBuilderTest.java,83,37,1,20,0,58
dubbo-3.0\dubbo-3.0\dubbo-cluster\src\test\java\org\apache\dubbo\rpc\cluster\directory\StaticDirectoryTest.java,34,13,1,10,0,24
dubbo-3.0\dubbo-3.0\dubbo-config\dubbo-config-spring\src\test\java\org\apache\dubbo\config\spring\annotation\merged\MergedService.java,0,2,0,1,0,3
dubbo-3.0\dubbo-3.0\dubbo-configcenter\dubbo-configcenter-apollo\src\main\java\org\apache\dubbo\configcenter\support\apollo\ApolloDynamicConfigurationFactory.java,7,3,0,3,0,6
dubbo-3.0\dubbo-3.0\dubbo-cluster\src\main\java\org\apache\dubbo\rpc\cluster\router\mesh\route\MeshRuleConstants.java,18,9,0,1,0,10
dubbo-3.0\dubbo-3.0\dubbo-plugin\dubbo-qos\src\main\java\org\apache\dubbo\qos\command\DefaultCommandExecutor.java,22,8,2,3,0,13
dubbo-3.0\dubbo-3.0\dubbo-common\src\main\java\org\apache\dubbo\common\threadpool\manager\ExecutorRepository.java,0,26,0,19,0,45
dubbo-3.0\dubbo-3.0\dubbo-monitor\dubbo-monitor-default\src\test\java\org\apache\dubbo\monitor\dubbo\DubboMonitorTest.java,195,52,11,23,0,86
dubbo-3.0\dubbo-3.0\dubbo-common\src\test\java\org\apache\dubbo\common\utils\IOUtilsTest.java,91,28,0,4,0,32
dubbo-3.0\dubbo-3.0\dubbo-registry\dubbo-registry-api\src\test\java\org\apache\dubbo\registry\client\metadata\store\ExcludedParamsFilter.java,16,2,0,1,0,3
dubbo-3.0\dubbo-3.0\dubbo-common\src\main\java\org\apache\dubbo\common\stream\StreamObserver.java,0,5,0,2,0,7
dubbo-3.0\dubbo-3.0\dubbo-config\dubbo-config-spring\src\test\java\org\apache\dubbo\config\spring\propertyconfigurer\consumer\DemoBeanFactoryPostProcessor.java,0,10,0,3,0,13
dubbo-3.0\dubbo-3.0\dubbo-common\src\test\java\org\apache\dubbo\common\extension\ExtensionLoader_Adaptive_UseJdkCompiler_Test.java,12,4,1,2,0,7
dubbo-3.0\dubbo-3.0\dubbo-metadata\dubbo-metadata-api\src\test\java\org\apache\dubbo\metadata\store\InterfaceNameTestService.java,0,3,0,1,0,4
dubbo-3.0\dubbo-3.0\dubbo-remoting\dubbo-remoting-netty4\src\test\java\org\apache\dubbo\remoting\transport\netty4\RpcMessageHandler.java,48,18,1,5,0,24
dubbo-3.0\dubbo-3.0\dubbo-registry\dubbo-registry-multicast\src\main\java\org\apache\dubbo\registry\multicast\MulticastRegistry.java,369,92,17,29,0,138
dubbo-3.0\dubbo-3.0\dubbo-rpc\dubbo-rpc-api\src\test\java\org\apache\dubbo\rpc\filter\CompatibleFilterFilterTest.java,138,22,0,11,0,33
dubbo-3.0\dubbo-3.0\dubbo-rpc\dubbo-rpc-triple\src\main\java\org\apache\dubbo\rpc\protocol\tri\stream\AbstractStream.java,11,10,0,1,0,11
dubbo-3.0\dubbo-3.0\dubbo-common\src\test\java\org\apache\dubbo\common\utils\HolderTest.java,10,1,0,1,0,2
dubbo-3.0\dubbo-3.0\dubbo-remoting\dubbo-remoting-http\src\main\java\org\apache\dubbo\remoting\http\tomcat\TomcatHttpBinder.java,9,4,0,1,0,5
dubbo-3.0\dubbo-3.0\dubbo-common\src\test\java\org\apache\dubbo\common\extension\ext2\UrlHolder.java,42,28,0,1,0,29
dubbo-3.0\dubbo-3.0\dubbo-compatible\src\main\java\com\alibaba\dubbo\remoting\zookeeper\ZookeeperTransporter.java,0,2,0,2,0,4
dubbo-3.0\dubbo-3.0\dubbo-config\dubbo-config-spring\src\main\java\org\apache\dubbo\config\spring\ReferenceBean.java,0,89,2,35,0,126
dubbo-3.0\dubbo-3.0\dubbo-remoting\dubbo-remoting-api\src\main\java\org\apache\dubbo\remoting\TimeoutException.java,32,19,0,2,0,21
dubbo-3.0\dubbo-3.0\dubbo-common\src\main\java\org\apache\dubbo\common\io\UnsafeByteArrayOutputStream.java,76,33,6,5,0,44
dubbo-3.0\dubbo-3.0\dubbo-remoting\dubbo-remoting-api\src\test\java\org\apache\dubbo\remoting\api\SingleProtocolConnectionManagerTest.java,52,12,5,5,0,22
dubbo-3.0\dubbo-3.0\dubbo-common\src\main\java\org\apache\dubbo\common\convert\multiple\StringToBlockingDequeConverter.java,11,8,0,3,0,11
dubbo-3.0\dubbo-3.0\dubbo-config\dubbo-config-spring\src\main\java\org\apache\dubbo\config\spring\context\DubboConfigBeanInitializer.java,0,33,2,17,0,52
dubbo-3.0\dubbo-3.0\dubbo-filter\dubbo-filter-cache\src\main\java\org\apache\dubbo\cache\support\jcache\JCacheFactory.java,14,5,0,3,0,8
dubbo-3.0\dubbo-3.0\dubbo-config\dubbo-config-spring\src\test\java\org\apache\dubbo\config\spring\filter\MockDao.java,0,2,0,1,0,3
dubbo-3.0\dubbo-3.0\dubbo-compatible\src\main\java\com\alibaba\dubbo\container\page\Page.java,58,45,0,4,0,49
dubbo-3.0\dubbo-3.0\dubbo-remoting\dubbo-remoting-api\src\main\java\org\apache\dubbo\remoting\exchange\support\Replier.java,0,1,0,1,0,2
dubbo-3.0\dubbo-3.0\dubbo-common\src\test\java\org\apache\dubbo\common\config\CompositeConfigurationTest.java,19,7,0,5,0,12
dubbo-3.0\dubbo-3.0\dubbo-registry\dubbo-registry-api\src\main\java\org\apache\dubbo\registry\client\migration\model\MigrationStep.java,0,3,0,1,0,4
dubbo-3.0\dubbo-3.0\dubbo-cluster\src\test\java\org\apache\dubbo\rpc\cluster\support\AvailableClusterInvokerTest.java,73,23,0,11,0,34
dubbo-3.0\dubbo-3.0\dubbo-common\src\test\java\org\apache\dubbo\common\beans\model\FooBeanWithFrameworkModel.java,22,10,0,1,0,11
dubbo-3.0\dubbo-3.0\dubbo-config\dubbo-config-api\src\test\java\demo\MultiClassLoaderServiceRequest.java,3,0,0,1,0,1
dubbo-3.0\dubbo-3.0\dubbo-remoting\dubbo-remoting-netty4\src\main\java\org\apache\dubbo\remoting\transport\netty4\logging\FormattingTuple.java,0,15,0,2,0,17
dubbo-3.0\dubbo-3.0\dubbo-remoting\dubbo-remoting-api\src\main\java\org\apache\dubbo\remoting\zookeeper\AbstractZookeeperTransporter.java,153,42,6,23,0,71
dubbo-3.0\dubbo-3.0\dubbo-common\src\main\java\org\apache\dubbo\common\threadpool\support\eager\EagerThreadPool.java,24,5,0,6,0,11
dubbo-3.0\dubbo-3.0\dubbo-common\src\test\java\org\apache\dubbo\metadata\definition\service\ComplexObject.java,0,170,9,4,0,183
dubbo-3.0\dubbo-3.0\dubbo-plugin\dubbo-qos\src\test\java\org\apache\dubbo\qos\protocol\QosProtocolWrapperTest.java,49,17,1,3,0,21
dubbo-3.0\dubbo-3.0\dubbo-rpc\dubbo-rpc-api\src\main\java\org\apache\dubbo\rpc\protocol\ProtocolSerializationWrapper.java,34,13,0,2,0,15
dubbo-3.0\dubbo-3.0\dubbo-metadata\dubbo-metadata-api\src\main\java\org\apache\dubbo\metadata\rest\jaxrs\ParamAnnotationParameterProcessor.java,10,14,0,5,0,19
dubbo-3.0\dubbo-3.0\dubbo-registry\dubbo-registry-api\src\test\java\org\apache\dubbo\registry\client\metadata\MetadataServiceURLBuilderTest.java,11,8,1,4,0,13
dubbo-3.0\dubbo-3.0\dubbo-registry\dubbo-registry-api\src\test\java\org\apache\dubbo\registry\CacheableFailbackRegistryTest.java,209,41,6,13,0,60
dubbo-3.0\dubbo-3.0\dubbo-filter\dubbo-filter-validation\src\main\java\org\apache\dubbo\validation\support\AbstractValidation.java,19,7,0,4,0,11
dubbo-3.0\dubbo-3.0\dubbo-common\src\main\java\org\apache\dubbo\common\convert\multiple\StringToSortedSetConverter.java,11,7,0,2,0,9
dubbo-3.0\dubbo-3.0\dubbo-registry\dubbo-registry-api\src\test\java\org\apache\dubbo\registry\client\migration\MigrationInvokerTest.java,192,56,0,31,0,87
dubbo-3.0\dubbo-3.0\dubbo-common\src\main\java\org\apache\dubbo\common\timer\Timer.java,0,7,0,3,0,10
dubbo-3.0\dubbo-3.0\dubbo-plugin\dubbo-qos\src\main\java\org\apache\dubbo\qos\command\impl\SelectTelnet.java,32,16,0,9,0,25
dubbo-3.0\dubbo-3.0\dubbo-metadata\dubbo-metadata-api\src\test\java\org\apache\dubbo\metadata\DemoService.java,0,5,0,1,0,6
dubbo-3.0\dubbo-3.0\dubbo-rpc\dubbo-rpc-rest\src\main\java\org\apache\dubbo\rpc\protocol\rest\NettyRestProtocolServer.java,31,12,0,7,0,19
dubbo-3.0\dubbo-3.0\dubbo-config\dubbo-config-api\src\test\java\org\apache\dubbo\config\integration\multiple\servicediscoveryregistry\MultipleRegistryCenterServiceDiscoveryRegistryService.java,0,3,0,2,0,5
dubbo-3.0\dubbo-3.0\dubbo-plugin\dubbo-qos\src\main\java\org\apache\dubbo\qos\probe\ReadinessProbe.java,0,2,0,1,0,3
dubbo-3.0\dubbo-3.0\dubbo-common\src\main\java\org\apache\dubbo\common\url\component\param\FixedParamValue.java,44,13,0,2,0,15
dubbo-3.0\dubbo-3.0\dubbo-common\src\test\java\org\apache\dubbo\rpc\model\media\Media.java,0,157,16,7,0,180
dubbo-3.0\dubbo-3.0\dubbo-cluster\src\main\java\org\apache\dubbo\rpc\cluster\router\mesh\rule\virtualservice\DubboRoute.java,39,26,0,2,0,28
dubbo-3.0\dubbo-3.0\dubbo-remoting\dubbo-remoting-api\src\main\java\org\apache\dubbo\remoting\Codec2.java,0,5,0,2,0,7
dubbo-3.0\dubbo-3.0\dubbo-config\dubbo-config-api\src\test\java\org\apache\dubbo\config\bootstrap\DubboServiceProviderBootstrap.java,63,15,7,11,0,33
dubbo-3.0\dubbo-3.0\dubbo-rpc\dubbo-rpc-triple\src\main\java\org\apache\dubbo\rpc\protocol\tri\call\StubAbstractServerCall.java,36,14,0,3,0,17
dubbo-3.0\dubbo-3.0\dubbo-config\dubbo-config-api\src\test\java\org\apache\dubbo\config\invoker\DelegateProviderMetaDataInvokerTest.java,30,6,0,1,0,7
dubbo-3.0\dubbo-3.0\dubbo-spring-boot\dubbo-spring-boot-compatible\autoconfigure\src\main\java\org\apache\dubbo\spring\boot\util\DubboUtils.java,152,55,1,26,0,82
dubbo-3.0\dubbo-3.0\dubbo-spring-boot\dubbo-spring-boot-compatible\autoconfigure\src\test\java\org\apache\dubbo\spring\boot\context\event\AwaitingNonWebApplicationListenerTest.java,44,7,0,4,0,11
dubbo-3.0\dubbo-3.0\dubbo-common\src\main\java\org\apache\dubbo\common\infra\support\EnvironmentAdapter.java,0,11,0,7,0,18
dubbo-3.0\dubbo-3.0\dubbo-config\dubbo-config-spring\src\test\java\org\apache\dubbo\config\spring\context\annotation\provider\DefaultHelloService.java,9,4,0,1,0,5
dubbo-3.0\dubbo-3.0\dubbo-common\src\test\java\org\apache\dubbo\common\extension\convert\String2DoubleConverter.java,3,2,0,1,0,3
dubbo-3.0\dubbo-3.0\dubbo-cluster\src\main\java\org\apache\dubbo\rpc\cluster\router\state\BitList.java,500,125,8,24,0,157
dubbo-3.0\dubbo-3.0\dubbo-remoting\dubbo-remoting-api\src\main\java\org\apache\dubbo\remoting\transport\dispatcher\message\MessageOnlyChannelHandler.java,22,13,2,6,0,21
dubbo-3.0\dubbo-3.0\dubbo-metadata\dubbo-metadata-processor\src\main\java\org\apache\dubbo\metadata\annotation\processing\rest\AbstractServiceRestMetadataResolver.java,231,103,2,66,0,171
dubbo-3.0\dubbo-3.0\dubbo-registry\dubbo-registry-api\src\main\java\org\apache\dubbo\registry\client\DefaultServiceDiscoveryFactory.java,7,5,0,4,0,9
dubbo-3.0\dubbo-3.0\dubbo-config\dubbo-config-api\src\test\java\org\apache\dubbo\config\integration\multiple\AbstractStorage.java,57,11,0,1,0,12
dubbo-3.0\dubbo-3.0\dubbo-metadata\dubbo-metadata-processor\src\main\java\org\apache\dubbo\metadata\annotation\processing\rest\jaxrs\JAXRSServiceRestMetadataResolver.java,63,53,1,28,0,82
dubbo-3.0\dubbo-3.0\dubbo-common\src\main\java\org\apache\dubbo\common\Parameters.java,225,116,1,9,0,126
dubbo-3.0\dubbo-3.0\dubbo-remoting\dubbo-remoting-api\src\test\java\org\apache\dubbo\remoting\handler\MockedChannel.java,89,29,5,1,0,35
dubbo-3.0\dubbo-3.0\dubbo-compatible\src\test\java\org\apache\dubbo\cache\CacheTest.java,81,10,2,3,0,15
dubbo-3.0\dubbo-3.0\dubbo-compatible\src\main\java\com\alibaba\dubbo\rpc\support\RpcUtils.java,0,30,0,6,0,36
dubbo-3.0\dubbo-3.0\dubbo-metadata\dubbo-metadata-api\src\test\java\org\apache\dubbo\metadata\rest\User.java,38,24,0,2,0,26
dubbo-3.0\dubbo-3.0\dubbo-common\src\test\java\org\apache\dubbo\common\utils\AssertTest.java,37,11,0,5,0,16
dubbo-3.0\dubbo-3.0\dubbo-spring-boot\dubbo-spring-boot-compatible\autoconfigure\src\main\java\org\apache\dubbo\spring\boot\autoconfigure\DubboAutoConfiguration.java,18,11,0,10,0,21
dubbo-3.0\dubbo-3.0\dubbo-config\dubbo-config-spring\src\test\java\org\apache\dubbo\config\spring\propertyconfigurer\consumer2\PropertySourcesConfigurerTest.java,49,14,2,12,0,28
dubbo-3.0\dubbo-3.0\dubbo-rpc\dubbo-rpc-injvm\src\test\java\org\apache\dubbo\rpc\protocol\injvm\InjvmProtocolTest.java,89,33,0,22,0,55
dubbo-3.0\dubbo-3.0\dubbo-config\dubbo-config-spring\src\test\java\org\apache\dubbo\config\spring\issues\issue9172\MultipleConsumerAndProviderTest.java,68,17,0,14,0,31
dubbo-3.0\dubbo-3.0\dubbo-config\dubbo-config-spring\src\main\java\org\apache\dubbo\config\spring\context\config\NamePropertyDefaultValueDubboConfigBeanCustomizer.java,49,17,0,12,0,29
dubbo-3.0\dubbo-3.0\dubbo-config\dubbo-config-spring\src\test\java\org\apache\dubbo\config\spring\registry\nacos\demo\provider\DemoServiceProviderBootstrap.java,11,7,2,4,0,13
dubbo-3.0\dubbo-3.0\dubbo-native-plugin\src\main\java\org\apache\dubbo\maven\plugin\Test.java,10,3,1,1,0,5
dubbo-3.0\dubbo-3.0\dubbo-plugin\dubbo-qos\src\main\java\org\apache\dubbo\qos\command\annotation\Cmd.java,0,6,0,1,0,7
dubbo-3.0\dubbo-3.0\dubbo-cluster\src\main\java\org\apache\dubbo\rpc\cluster\support\ClusterUtils.java,39,16,0,6,0,22
dubbo-3.0\dubbo-3.0\dubbo-cluster\src\test\java\org\apache\dubbo\rpc\cluster\router\mesh\rule\virtualservice\DubboMatchRequestTest.java,104,13,0,15,0,28
dubbo-3.0\dubbo-3.0\dubbo-common\src\main\java\org\apache\dubbo\common\extension\DubboLoadingStrategy.java,20,4,0,1,0,5
dubbo-3.0\dubbo-3.0\dubbo-remoting\dubbo-remoting-api\src\main\java\org\apache\dubbo\remoting\zookeeper\ZookeeperTransporter.java,0,9,0,4,0,13
dubbo-3.0\dubbo-3.0\dubbo-remoting\dubbo-remoting-netty\src\main\java\org\apache\dubbo\remoting\transport\netty\NettyClient.java,127,27,7,17,0,51
dubbo-3.0\dubbo-3.0\dubbo-cluster\src\main\java\org\apache\dubbo\rpc\cluster\router\condition\config\AppStateRouterFactory.java,23,8,1,1,0,10
dubbo-3.0\dubbo-3.0\dubbo-cluster\src\main\java\org\apache\dubbo\rpc\cluster\router\condition\config\model\ConditionRuleParser.java,16,4,1,1,0,6
dubbo-3.0\dubbo-3.0\dubbo-config\dubbo-config-api\src\test\java\org\apache\dubbo\config\integration\single\package-info.java,0,1,0,2,0,3
dubbo-3.0\dubbo-3.0\dubbo-remoting\dubbo-remoting-netty\src\test\java\org\apache\dubbo\remoting\exchange\support\header\HeartbeatHandlerTest.java,144,58,2,17,0,77
dubbo-3.0\dubbo-3.0\dubbo-cluster\src\main\java\org\apache\dubbo\rpc\cluster\router\condition\config\AppStateRouter.java,8,6,0,1,0,7
dubbo-3.0\dubbo-3.0\dubbo-common\src\test\java\org\apache\dubbo\metadata\definition\TypeDefinitionBuilderTest.java,14,2,0,2,0,4
dubbo-3.0\dubbo-3.0\dubbo-serialization\dubbo-serialization-api\src\main\java\org\apache\dubbo\common\serialize\Cleanable.java,0,2,0,1,0,3
dubbo-3.0\dubbo-3.0\dubbo-cluster\src\main\java\org\apache\dubbo\rpc\cluster\router\mesh\route\MeshEnvListenerFactory.java,0,1,0,1,0,2
dubbo-3.0\dubbo-3.0\dubbo-config\dubbo-config-spring\src\test\java\org\apache\dubbo\config\spring\context\annotation\DubboComponentScanRegistrarTest.java,91,11,1,11,0,23
dubbo-3.0\dubbo-3.0\dubbo-common\src\main\java\org\apache\dubbo\config\AbstractReferenceConfig.java,235,102,2,8,0,112
dubbo-3.0\dubbo-3.0\dubbo-remoting\dubbo-remoting-api\src\test\java\org\apache\dubbo\remoting\exchange\support\ExchangeHandlerDispatcherTest.java,39,8,1,8,0,17
dubbo-3.0\dubbo-3.0\dubbo-plugin\dubbo-qos\src\main\java\org\apache\dubbo\qos\command\impl\Ls.java,63,15,0,5,0,20
dubbo-3.0\dubbo-3.0\dubbo-metadata\dubbo-metadata-processor\src\test\java\org\apache\dubbo\metadata\annotation\processing\model\PrimitiveTypeModel.java,51,25,0,1,0,26
dubbo-3.0\dubbo-3.0\dubbo-registry\dubbo-registry-api\src\main\java\org\apache\dubbo\registry\Registry.java,0,5,0,4,0,9
dubbo-3.0\dubbo-3.0\dubbo-common\src\main\java\org\apache\dubbo\common\extension\Wrapper.java,0,3,0,1,0,4
dubbo-3.0\dubbo-3.0\dubbo-registry\dubbo-registry-nacos\src\main\java\org\apache\dubbo\registry\nacos\NacosServiceDiscoveryFactory.java,9,3,0,2,0,5
dubbo-3.0\dubbo-3.0\dubbo-remoting\dubbo-remoting-api\src\main\java\org\apache\dubbo\remoting\transport\codec\TransportCodec.java,45,28,3,10,0,41
dubbo-3.0\dubbo-3.0\dubbo-common\src\test\java\org\apache\dubbo\common\convert\StringToBooleanConverterTest.java,25,7,0,3,0,10
dubbo-3.0\dubbo-3.0\dubbo-common\src\main\java\org\apache\dubbo\common\beans\factory\ScopeBeanFactory.java,231,94,4,21,0,119
dubbo-3.0\dubbo-3.0\dubbo-common\src\main\java\org\apache\dubbo\common\extension\inject\SpiExtensionInjector.java,26,10,0,2,0,12
dubbo-3.0\dubbo-3.0\dubbo-configcenter\dubbo-configcenter-nacos\src\main\java\org\apache\dubbo\configcenter\support\nacos\NacosConfigServiceWrapper.java,57,58,0,14,0,72
dubbo-3.0\dubbo-3.0\dubbo-common\src\main\java\org\apache\dubbo\common\utils\AnnotationUtils.java,0,132,0,96,0,228
dubbo-3.0\dubbo-3.0\dubbo-common\src\test\java\org\apache\dubbo\common\extension\ext8_add\AddExt3.java,0,1,0,1,0,2
dubbo-3.0\dubbo-3.0\dubbo-common\src\test\java\org\apache\dubbo\common\extension\compatible\impl\CompatibleExtImpl1.java,14,13,0,1,0,14
dubbo-3.0\dubbo-3.0\dubbo-config\dubbo-config-api\src\test\java\org\apache\dubbo\config\mock\MockFilter.java,7,4,0,2,0,6
dubbo-3.0\dubbo-3.0\dubbo-common\src\test\java\org\apache\dubbo\common\lang\PrioritizedTest.java,94,16,2,1,0,19
dubbo-3.0\dubbo-3.0\dubbo-plugin\dubbo-auth\src\main\java\org\apache\dubbo\auth\spi\AccessKeyStorage.java,0,4,0,2,0,6
dubbo-3.0\dubbo-3.0\dubbo-common\src\main\java\org\apache\dubbo\config\context\ConfigManager.java,254,99,2,15,0,116
dubbo-3.0\dubbo-3.0\dubbo-rpc\dubbo-rpc-grpc\src\test\java\org\apache\dubbo\rpc\protocol\grpc\support\HelloRequest.java,0,112,27,11,0,150
dubbo-3.0\dubbo-3.0\dubbo-cluster\src\main\java\org\apache\dubbo\rpc\cluster\router\tag\model\Tag.java,34,19,0,3,0,22
dubbo-3.0\dubbo-3.0\dubbo-remoting\dubbo-remoting-api\src\main\java\org\apache\dubbo\remoting\transport\AbstractChannel.java,21,11,0,3,0,14
dubbo-3.0\dubbo-3.0\dubbo-native-plugin\src\main\java\org\apache\dubbo\maven\plugin\DubboNativeCodeGeneratorMojo.java,54,13,6,9,0,28
dubbo-3.0\dubbo-3.0\dubbo-config\dubbo-config-api\src\test\java\org\apache\dubbo\config\api\Box.java,0,2,0,1,0,3
dubbo-3.0\dubbo-3.0\dubbo-common\src\main\java\org\apache\dubbo\config\annotation\DubboReference.java,0,113,0,23,0,136
dubbo-3.0\dubbo-3.0\dubbo-rpc\dubbo-rpc-triple\src\test\java\org\apache\dubbo\rpc\protocol\tri\stream\TripleClientStreamTest.java,0,9,0,8,0,17
dubbo-3.0\dubbo-3.0\dubbo-rpc\dubbo-rpc-api\src\main\java\com\alibaba\dubbo\rpc\service\EchoService.java,0,1,0,1,0,2
dubbo-3.0\dubbo-3.0\dubbo-demo\dubbo-demo-triple\src\main\java\org\apache\dubbo\demo\consumer\ApiWrapperConsumer.java,25,7,1,5,0,13
dubbo-3.0\dubbo-3.0\dubbo-config\dubbo-config-api\src\test\java\org\apache\dubbo\config\bootstrap\rest\UserServiceImpl.java,11,3,1,1,0,5
dubbo-3.0\dubbo-3.0\dubbo-common\src\main\java\org\apache\dubbo\metadata\definition\ServiceDefinitionBuilder.java,0,15,0,8,0,23
dubbo-3.0\dubbo-3.0\dubbo-remoting\dubbo-remoting-netty\src\main\java\org\apache\dubbo\remoting\transport\netty\NettyBackedChannelBufferFactory.java,29,14,0,5,0,19
dubbo-3.0\dubbo-3.0\dubbo-common\src\test\java\org\apache\dubbo\common\extension\activate\impl\ActivateWrapperExt1Impl2.java,6,3,0,1,0,4
dubbo-3.0\dubbo-3.0\dubbo-registry\dubbo-registry-api\src\main\java\org\apache\dubbo\registry\client\RegistryClusterIdentifier.java,0,5,0,4,0,9
dubbo-3.0\dubbo-3.0\dubbo-rpc\dubbo-rpc-api\src\main\java\org\apache\dubbo\rpc\Invoker.java,0,2,0,1,0,3
dubbo-3.0\dubbo-3.0\dubbo-common\src\test\java\org\apache\dubbo\common\extension\duplicated\impl\DuplicatedWithoutOverriddenExt1.java,8,2,0,3,0,5
dubbo-3.0\dubbo-3.0\dubbo-common\src\main\java\org\apache\dubbo\common\compiler\support\CtClassBuilder.java,137,58,0,4,0,62
dubbo-3.0\dubbo-3.0\dubbo-common\src\test\java\org\apache\dubbo\rpc\model\ServiceRepositoryTest.java,59,19,0,11,0,30
dubbo-3.0\dubbo-3.0\dubbo-compatible\src\test\java\org\apache\dubbo\service\Person.java,23,15,0,1,0,16
dubbo-3.0\dubbo-3.0\dubbo-cluster\src\main\java\org\apache\dubbo\rpc\cluster\router\mock\MockInvokersSelector.java,75,31,2,13,0,46
dubbo-3.0\dubbo-3.0\dubbo-common\src\test\java\org\apache\dubbo\common\convert\StringToDoubleConverterTest.java,24,7,0,3,0,10
dubbo-3.0\dubbo-3.0\dubbo-common\src\main\java\org\apache\dubbo\common\CommonScopeModelInitializer.java,23,6,0,1,0,7
dubbo-3.0\dubbo-3.0\dubbo-compatible\src\main\java\com\alibaba\dubbo\container\Container.java,0,1,0,1,0,2
dubbo-3.0\dubbo-3.0\dubbo-common\src\test\java\org\apache\dubbo\metadata\definition\common\ClassExtendsMap.java,0,5,2,1,0,8
dubbo-3.0\dubbo-3.0\dubbo-test\dubbo-test-check\src\main\java\org\apache\dubbo\test\check\registrycenter\processor\StopZookeeperWindowsProcessor.java,26,7,0,5,0,12
dubbo-3.0\dubbo-3.0\dubbo-cluster\src\test\java\org\apache\dubbo\rpc\cluster\router\state\BitListTest.java,549,134,0,69,0,203
dubbo-3.0\dubbo-3.0\dubbo-common\src\test\java\org\apache\dubbo\common\extension\ext8_add\impl\AddExt4_ManualAdaptive.java,7,6,1,2,0,9
dubbo-3.0\dubbo-3.0\dubbo-cluster\src\test\java\org\apache\dubbo\rpc\cluster\StickyTest.java,125,36,2,6,0,44
dubbo-3.0\dubbo-3.0\dubbo-cluster\src\test\java\org\apache\dubbo\rpc\cluster\merger\DoubleSumMerger.java,9,3,0,1,0,4
dubbo-3.0\dubbo-3.0\dubbo-common\src\main\java\org\apache\dubbo\common\compiler\support\JavassistCompiler.java,0,20,2,11,0,33
dubbo-3.0\dubbo-3.0\dubbo-config\dubbo-config-api\src\main\java\org\apache\dubbo\config\bootstrap\builders\RegistryBuilder.java,0,156,1,7,0,164
dubbo-3.0\dubbo-3.0\dubbo-common\src\main\java\org\apache\dubbo\common\io\UnsafeStringReader.java,95,20,6,1,0,27
dubbo-3.0\dubbo-3.0\dubbo-rpc\dubbo-rpc-triple\src\main\java\org\apache\dubbo\rpc\protocol\tri\command\HeaderQueueCommand.java,33,17,1,2,0,20
dubbo-3.0\dubbo-3.0\dubbo-common\src\test\java\org\apache\dubbo\metadata\definition\service\annotation\MockMethodAnnotation.java,0,2,0,1,0,3
dubbo-3.0\dubbo-3.0\dubbo-native\src\main\java\org\apache\dubbo\rpc\cluster\LoadBalance$Adaptive.java,0,17,10,7,0,34
dubbo-3.0\dubbo-3.0\dubbo-config\dubbo-config-api\src\test\java\org\apache\dubbo\config\mock\MockInvokerListener.java,12,2,2,1,0,5
dubbo-3.0\dubbo-3.0\dubbo-spring-boot\dubbo-spring-boot-compatible\autoconfigure\src\main\java\org\apache\dubbo\spring\boot\context\event\DubboConfigBeanDefinitionConflictApplicationListener.java,72,31,0,20,0,51
dubbo-3.0\dubbo-3.0\dubbo-plugin\dubbo-qos\src\test\java\org\apache\dubbo\qos\command\impl\TestRegistryFactory.java,9,4,0,1,0,5
dubbo-3.0\dubbo-3.0\dubbo-common\src\test\java\org\apache\dubbo\common\logger\LoggerFactoryTest.java,44,5,0,1,0,6
dubbo-3.0\dubbo-3.0\dubbo-cluster\src\main\java\org\apache\dubbo\rpc\cluster\merger\BooleanArrayMerger.java,26,2,0,1,0,3
dubbo-3.0\dubbo-3.0\dubbo-common\src\main\java\org\apache\dubbo\common\config\configcenter\wrapper\CompositeDynamicConfiguration.java,91,53,1,17,0,71
dubbo-3.0\dubbo-3.0\dubbo-compatible\src\main\java\com\alibaba\dubbo\common\logger\LoggerAdapter.java,0,2,0,2,0,4
dubbo-3.0\dubbo-3.0\dubbo-metadata\dubbo-metadata-api\src\test\java\org\apache\dubbo\metadata\filter\CustomizedParamsFilter.java,16,4,0,2,0,6
dubbo-3.0\dubbo-3.0\dubbo-registry\dubbo-registry-multicast\src\test\java\org\apache\dubbo\registry\multicast\MulticastRegistryFactoryTest.java,9,3,0,2,0,5
dubbo-3.0\dubbo-3.0\dubbo-rpc\dubbo-rpc-api\src\main\java\org\apache\dubbo\rpc\PenetrateAttachmentSelector.java,0,1,0,2,0,3
dubbo-3.0\dubbo-3.0\dubbo-common\src\main\java\org\apache\dubbo\common\constants\FilterConstants.java,0,3,2,1,0,6
dubbo-3.0\dubbo-3.0\dubbo-common\src\main\java\org\apache\dubbo\common\bytecode\DubboLoaderClassPath.java,22,8,0,3,0,11
dubbo-3.0\dubbo-3.0\dubbo-cluster\src\main\java\org\apache\dubbo\rpc\cluster\router\tag\model\TagRouterRule.java,63,24,0,4,0,28
dubbo-3.0\dubbo-3.0\dubbo-rpc\dubbo-rpc-triple\src\main\java\org\apache\dubbo\rpc\protocol\tri\transport\TripleHttp2FrameServerHandler.java,87,51,1,17,0,69
dubbo-3.0\dubbo-3.0\dubbo-metadata\dubbo-metadata-processor\src\test\java\org\apache\dubbo\metadata\annotation\processing\builder\PrimitiveTypeDefinitionBuilderTest.java,92,36,0,10,0,46
dubbo-3.0\dubbo-3.0\dubbo-config\dubbo-config-api\src\test\java\org\apache\dubbo\config\bootstrap\builders\MethodBuilderTest.java,0,12,0,13,0,25
dubbo-3.0\dubbo-3.0\dubbo-rpc\dubbo-rpc-dubbo\src\test\java\org\apache\dubbo\rpc\protocol\dubbo\status\ServerStatusCheckerTest.java,37,10,3,7,0,20
dubbo-3.0\dubbo-3.0\dubbo-config\dubbo-config-api\src\main\java\org\apache\dubbo\config\ConfigInitializer.java,0,4,2,1,0,7
dubbo-3.0\dubbo-3.0\dubbo-plugin\dubbo-qos\src\main\java\org\apache\dubbo\qos\command\impl\Quit.java,7,4,0,1,0,5
dubbo-3.0\dubbo-3.0\dubbo-rpc\dubbo-rpc-api\src\main\java\org\apache\dubbo\rpc\proxy\InvokerInvocationHandler.java,43,17,2,5,0,24
dubbo-3.0\dubbo-3.0\dubbo-config\dubbo-config-spring\src\test\java\org\apache\dubbo\config\spring\issues\issue9207\ConfigCenterBeanTest.java,64,22,2,16,0,40
dubbo-3.0\dubbo-3.0\dubbo-remoting\dubbo-remoting-http\src\main\java\org\apache\dubbo\remoting\http\tomcat\TomcatHttpServer.java,61,15,1,8,0,24
dubbo-3.0\dubbo-3.0\dubbo-common\src\main\java\org\apache\dubbo\rpc\service\EchoServiceDetector.java,9,1,0,1,0,2
dubbo-3.0\dubbo-3.0\dubbo-common\src\test\java\org\apache\dubbo\common\extension\ext6_wrap\WrappedExt.java,0,2,0,1,0,3
dubbo-3.0\dubbo-3.0\dubbo-config\dubbo-config-api\src\test\java\org\apache\dubbo\config\integration\multiple\exportmetadata\MultipleRegistryCenterExportMetadataExporterListener.java,11,3,0,3,0,6
dubbo-3.0\dubbo-3.0\dubbo-rpc\dubbo-rpc-api\src\test\java\org\apache\dubbo\rpc\proxy\DemoServiceImpl.java,49,32,4,2,0,38
dubbo-3.0\dubbo-3.0\dubbo-common\src\test\java\org\apache\dubbo\common\extension\ext4\impl\Ext4Impl1.java,6,5,0,1,0,6
dubbo-3.0\dubbo-3.0\dubbo-config\dubbo-config-spring\src\main\java\org\apache\dubbo\config\spring\ConfigCenterBean.java,0,32,3,12,0,47
dubbo-3.0\dubbo-3.0\dubbo-cluster\src\test\java\org\apache\dubbo\rpc\cluster\configurator\consts\UrlConstant.java,11,17,0,8,0,25
dubbo-3.0\dubbo-3.0\dubbo-common\src\main\java\org\apache\dubbo\common\compiler\support\AbstractCompiler.java,0,27,4,10,0,41
dubbo-3.0\dubbo-3.0\dubbo-demo\dubbo-demo-native\dubbo-demo-native-provider\src\main\java\org\apache\dubbo\demo\graalvm\provider\Application.java,61,7,1,3,0,11
dubbo-3.0\dubbo-3.0\dubbo-test\dubbo-test-check\src\main\java\org\apache\dubbo\test\check\registrycenter\processor\KillProcessWindowsProcessor.java,30,10,2,8,0,20
dubbo-3.0\dubbo-3.0\dubbo-cluster\src\test\java\org\apache\dubbo\rpc\cluster\support\FailSafeClusterInvokerTest.java,79,22,0,4,0,26
dubbo-3.0\dubbo-3.0\dubbo-remoting\dubbo-remoting-api\src\main\java\org\apache\dubbo\remoting\buffer\ChannelBuffers.java,0,33,0,3,0,36
dubbo-3.0\dubbo-3.0\dubbo-common\src\main\java\org\apache\dubbo\common\config\configcenter\ConfigItem.java,37,19,1,1,0,21
dubbo-3.0\dubbo-3.0\dubbo-common\src\test\java\org\apache\dubbo\rpc\model\person\FullAddress.java,183,104,18,8,0,130
dubbo-3.0\dubbo-3.0\dubbo-rpc\dubbo-rpc-api\src\main\java\org\apache\dubbo\rpc\TriRpcStatus.java,246,104,1,8,0,113
dubbo-3.0\dubbo-3.0\compiler\src\main\java\org\apache\dubbo\gen\dubbo\DubboGenerator.java,21,4,0,1,0,5
dubbo-3.0\dubbo-3.0\dubbo-metadata\dubbo-metadata-api\src\test\java\org\apache\dubbo\metadata\store\RetryTestService.java,0,3,0,1,0,4
dubbo-3.0\dubbo-3.0\dubbo-registry\dubbo-registry-api\src\main\java\org\apache\dubbo\registry\support\RegistryManager.java,157,46,10,7,0,63
dubbo-3.0\dubbo-3.0\dubbo-rpc\dubbo-rpc-injvm\src\test\java\demo\MultiClassLoaderService.java,0,2,0,1,0,3
dubbo-3.0\dubbo-3.0\dubbo-common\src\test\java\org\apache\dubbo\common\extension\activate\impl\OrderActivateExtImpl2.java,7,4,0,1,0,5
dubbo-3.0\dubbo-3.0\dubbo-common\src\test\java\org\apache\dubbo\common\logger\support\FailsafeLoggerTest.java,78,9,0,6,0,15
dubbo-3.0\dubbo-3.0\dubbo-demo\dubbo-demo-xml\dubbo-demo-xml-provider\src\main\java\org\apache\dubbo\demo\provider\RestDemoServiceImpl.java,35,13,0,1,0,14
dubbo-3.0\dubbo-3.0\dubbo-common\src\test\java\org\apache\dubbo\common\model\Person.java,76,43,8,2,0,53
dubbo-3.0\dubbo-3.0\dubbo-common\src\main\java\org\apache\dubbo\common\convert\StringToStringConverter.java,8,3,0,1,0,4
dubbo-3.0\dubbo-3.0\dubbo-rpc\dubbo-rpc-rest\src\main\java\org\apache\dubbo\rpc\protocol\rest\integration\swagger\DubboSwaggerService.java,0,3,0,3,0,6
dubbo-3.0\dubbo-3.0\dubbo-common\src\main\java\org\apache\dubbo\common\beans\ScopeBeanException.java,11,6,0,1,0,7
dubbo-3.0\dubbo-3.0\dubbo-rpc\dubbo-rpc-dubbo\src\test\java\org\apache\dubbo\rpc\protocol\dubbo\DubboInvokerAvailableTest.java,130,43,10,21,0,74
dubbo-3.0\dubbo-3.0\dubbo-config\dubbo-config-api\src\test\java\org\apache\dubbo\config\bootstrap\builders\AbstractInterfaceBuilderTest.java,0,14,0,15,0,29
dubbo-3.0\dubbo-3.0\dubbo-remoting\dubbo-remoting-api\src\test\java\org\apache\dubbo\remoting\telnet\support\TelnetHandlerAdapterTest.java,0,7,1,7,0,15
dubbo-3.0\dubbo-3.0\dubbo-config\dubbo-config-spring\src\test\java\org\apache\dubbo\config\spring\EmbeddedZooKeeper.java,208,26,4,12,0,42
dubbo-3.0\dubbo-3.0\dubbo-config\dubbo-config-api\src\test\java\org\apache\dubbo\config\integration\IntegrationTest.java,0,0,0,1,0,1
dubbo-3.0\dubbo-3.0\dubbo-rpc\dubbo-rpc-api\src\main\java\org\apache\dubbo\rpc\AsyncContext.java,0,6,0,4,0,10
dubbo-3.0\dubbo-3.0\dubbo-rpc\dubbo-rpc-dubbo\src\test\java\org\apache\dubbo\rpc\protocol\dubbo\support\DemoRequest.java,0,10,0,2,0,12
dubbo-3.0\dubbo-3.0\dubbo-common\src\test\java\org\apache\dubbo\common\config\InmemoryConfigurationTest.java,0,10,1,5,0,16
dubbo-3.0\dubbo-3.0\dubbo-config\dubbo-config-spring\src\test\java\org\apache\dubbo\config\spring\boot\conditional1\XmlReferenceBeanConditionalTest.java,52,18,1,4,0,23
dubbo-3.0\dubbo-3.0\dubbo-remoting\dubbo-remoting-api\src\main\java\org\apache\dubbo\remoting\Endpoint.java,0,2,0,1,0,3
dubbo-3.0\dubbo-3.0\dubbo-cluster\src\main\java\org\apache\dubbo\rpc\cluster\support\FailbackCluster.java,11,6,0,2,0,8
dubbo-3.0\dubbo-3.0\dubbo-common\src\main\java\org\apache\dubbo\common\utils\StringConstantFieldValuePredicate.java,33,12,0,3,0,15
dubbo-3.0\dubbo-3.0\dubbo-common\src\test\java\org\apache\dubbo\common\utils\SerializeClassCheckerTest.java,76,25,6,12,0,43
dubbo-3.0\dubbo-3.0\dubbo-common\src\main\java\org\apache\dubbo\common\config\InmemoryConfiguration.java,54,25,3,2,0,30
dubbo-3.0\dubbo-3.0\dubbo-common\src\test\java\org\apache\dubbo\common\compiler\support\JavassistCompilerTest.java,61,12,0,8,0,20
dubbo-3.0\dubbo-3.0\dubbo-common\src\test\java\org\apache\dubbo\common\function\PredicatesTest.java,29,7,0,2,0,9
dubbo-3.0\dubbo-3.0\dubbo-common\src\test\java\org\apache\dubbo\common\InterfaceAddressURLTest.java,78,30,0,20,0,50
dubbo-3.0\dubbo-3.0\dubbo-rpc\dubbo-rpc-rest\src\test\java\org\apache\dubbo\rpc\protocol\rest\DemoServiceImpl.java,30,12,0,1,0,13
dubbo-3.0\dubbo-3.0\dubbo-config\dubbo-config-spring\src\test\java\org\apache\dubbo\config\spring\registry\nacos\demo\consumer\DemoServiceConsumerXmlBootstrap.java,20,9,1,5,0,15
dubbo-3.0\dubbo-3.0\dubbo-native\src\main\java\org\apache\dubbo\rpc\cluster\Cluster$Adaptive.java,0,30,17,11,0,58
dubbo-3.0\dubbo-3.0\dubbo-test\dubbo-test-check\src\main\java\org\apache\dubbo\test\check\registrycenter\Processor.java,0,2,0,2,0,4
dubbo-3.0\dubbo-3.0\dubbo-config\dubbo-config-spring\src\test\java\org\apache\dubbo\config\spring\action\DemoActionByAnnotation.java,11,5,0,1,0,6
dubbo-3.0\dubbo-3.0\dubbo-config\dubbo-config-spring\src\test\java\org\apache\dubbo\config\spring\SimpleRegistryService.java,107,38,7,10,0,55
dubbo-3.0\dubbo-3.0\dubbo-remoting\dubbo-remoting-netty4\src\test\java\org\apache\dubbo\remoting\transport\netty4\ClientReconnectTest.java,64,35,3,5,0,43
dubbo-3.0\dubbo-3.0\dubbo-plugin\dubbo-qos\src\main\java\org\apache\dubbo\qos\command\impl\PwdTelnet.java,17,5,0,3,0,8
dubbo-3.0\dubbo-3.0\dubbo-common\src\test\java\org\apache\dubbo\common\config\ConfigurationUtilsTest.java,80,24,0,17,0,41
dubbo-3.0\dubbo-3.0\dubbo-config\dubbo-config-api\src\test\java\org\apache\dubbo\config\integration\multiple\exportprovider\MultipleRegistryCenterExportProviderServiceImpl.java,10,3,0,2,0,5
dubbo-3.0\dubbo-3.0\dubbo-remoting\dubbo-remoting-api\src\main\java\org\apache\dubbo\remoting\transport\AbstractCodec.java,0,31,1,5,0,37
dubbo-3.0\dubbo-3.0\dubbo-config\dubbo-config-spring\src\test\java\org\apache\dubbo\config\spring\propertyconfigurer\provider\HelloServiceImpl.java,16,9,1,4,0,14
dubbo-3.0\dubbo-3.0\dubbo-demo\dubbo-demo-xml\dubbo-demo-xml-provider\src\main\java\org\apache\dubbo\demo\provider\DemoServiceImpl.java,28,10,2,4,0,16
dubbo-3.0\dubbo-3.0\dubbo-config\dubbo-config-api\src\test\java\org\apache\dubbo\config\ProtocolConfigTest.java,350,50,0,5,0,55
dubbo-3.0\dubbo-3.0\dubbo-registry\dubbo-registry-multiple\src\main\java\org\apache\dubbo\registry\multiple\MultipleRegistry.java,301,131,4,34,0,169
dubbo-3.0\dubbo-3.0\dubbo-rpc\dubbo-rpc-grpc\src\main\java\org\apache\dubbo\rpc\protocol\grpc\GrpcConstants.java,23,18,0,4,0,22
dubbo-3.0\dubbo-3.0\dubbo-compatible\src\main\java\com\alibaba\dubbo\remoting\Transporter.java,0,13,0,5,0,18
dubbo-3.0\dubbo-3.0\dubbo-config\dubbo-config-api\src\test\java\org\apache\dubbo\config\ProviderConfigTest.java,197,44,0,2,0,46
dubbo-3.0\dubbo-3.0\dubbo-config\dubbo-config-api\src\main\java\org\apache\dubbo\config\bootstrap\builders\AbstractServiceBuilder.java,0,111,0,4,0,115
dubbo-3.0\dubbo-3.0\dubbo-common\src\main\java\org\apache\dubbo\common\utils\AtomicPositiveInteger.java,135,40,2,7,0,49
dubbo-3.0\dubbo-3.0\dubbo-registry\dubbo-registry-nacos\src\test\java\org\apache\dubbo\registry\nacos\util\NacosNamingServiceUtilsTest.java,39,10,3,5,0,18
dubbo-3.0\dubbo-3.0\dubbo-cluster\src\main\java\org\apache\dubbo\rpc\cluster\router\state\StateRouterFactory.java,0,2,0,1,0,3
dubbo-3.0\dubbo-3.0\dubbo-config\dubbo-config-spring\src\main\java\org\apache\dubbo\config\spring\beans\factory\annotation\ServiceBeanNameBuilder.java,86,61,1,15,0,77
dubbo-3.0\dubbo-3.0\dubbo-registry\dubbo-registry-api\src\main\java\org\apache\dubbo\registry\client\migration\model\MigrationRule.java,307,113,1,29,0,143
dubbo-3.0\dubbo-3.0\dubbo-cluster\src\main\java\org\apache\dubbo\rpc\cluster\router\script\ScriptStateRouter.java,125,58,4,15,0,77
dubbo-3.0\dubbo-3.0\dubbo-config\dubbo-config-api\src\test\java\org\apache\dubbo\config\bootstrap\DubboServiceProviderMinimumBootstrap.java,15,10,1,6,0,17
dubbo-3.0\dubbo-3.0\dubbo-compatible\src\main\java\com\alibaba\dubbo\container\page\Menu.java,0,5,0,1,0,6
dubbo-3.0\dubbo-3.0\dubbo-remoting\dubbo-remoting-zookeeper-curator5\src\main\java\org\apache\dubbo\remoting\zookeeper\curator5\Curator5ZookeeperClient.java,0,159,18,54,0,231
dubbo-3.0\dubbo-3.0\dubbo-rpc\dubbo-rpc-api\src\main\java\org\apache\dubbo\rpc\InvocationProfilerUtils.java,54,25,2,7,0,34
dubbo-3.0\dubbo-3.0\dubbo-rpc\dubbo-rpc-injvm\src\main\java\org\apache\dubbo\rpc\protocol\injvm\InjvmExporter.java,20,11,0,2,0,13
dubbo-3.0\dubbo-3.0\dubbo-plugin\dubbo-qos\src\test\java\org\apache\dubbo\qos\legacy\channel\MockChannel.java,116,52,4,2,0,58
dubbo-3.0\dubbo-3.0\dubbo-common\src\main\java\org\apache\dubbo\common\config\Environment.java,299,118,1,30,0,149
dubbo-3.0\dubbo-3.0\dubbo-compatible\src\main\java\com\alibaba\dubbo\cache\support\AbstractCacheFactory.java,24,11,0,4,0,15
dubbo-3.0\dubbo-3.0\dubbo-plugin\dubbo-auth\src\main\java\org\apache\dubbo\auth\filter\ProviderAuthFilter.java,26,11,0,4,0,15
dubbo-3.0\dubbo-3.0\dubbo-common\src\main\java\org\apache\dubbo\common\lang\Prioritized.java,0,6,0,1,0,7
dubbo-3.0\dubbo-3.0\dubbo-cluster\src\test\java\org\apache\dubbo\rpc\cluster\router\mesh\rule\virtualservice\match\StringMatchTest.java,57,8,0,4,0,12
dubbo-3.0\dubbo-3.0\dubbo-common\src\main\java\org\apache\dubbo\config\MethodConfig.java,459,182,4,33,0,219
dubbo-3.0\dubbo-3.0\dubbo-rpc\dubbo-rpc-triple\src\main\java\org\apache\dubbo\rpc\protocol\tri\TripleInvoker.java,263,81,4,40,0,125
dubbo-3.0\dubbo-3.0\dubbo-rpc\dubbo-rpc-injvm\src\main\java\org\apache\dubbo\rpc\protocol\injvm\InjvmInvoker.java,180,61,0,33,0,94
dubbo-3.0\dubbo-3.0\dubbo-config\dubbo-config-api\src\test\java\org\apache\dubbo\config\mock\MockLoadBalance.java,7,5,0,2,0,7
dubbo-3.0\dubbo-3.0\dubbo-plugin\dubbo-qos\src\main\java\org\apache\dubbo\qos\probe\impl\DeployerStartupProbe.java,24,6,0,2,0,8
dubbo-3.0\dubbo-3.0\dubbo-registry\dubbo-registry-api\src\main\java\org\apache\dubbo\registry\client\metadata\ServiceInstanceMetadataCustomizer.java,28,11,1,9,0,21
dubbo-3.0\dubbo-3.0\dubbo-common\src\main\java\org\apache\dubbo\rpc\model\ScopeModelAwareExtensionProcessor.java,0,21,0,8,0,29
dubbo-3.0\dubbo-3.0\dubbo-compatible\src\main\java\com\alibaba\dubbo\rpc\protocol\dubbo\FutureAdapter.java,118,32,2,5,0,39
dubbo-3.0\dubbo-3.0\dubbo-config\dubbo-config-api\src\main\java\org\apache\dubbo\config\ServiceListener.java,0,3,0,1,0,4
dubbo-3.0\dubbo-3.0\dubbo-compatible\src\main\java\com\alibaba\dubbo\common\status\StatusChecker.java,0,1,0,2,0,3
dubbo-3.0\dubbo-3.0\dubbo-filter\dubbo-filter-cache\src\main\java\org\apache\dubbo\cache\support\lru\LruCache.java,39,11,0,6,0,17
dubbo-3.0\dubbo-3.0\dubbo-spring-boot\dubbo-spring-boot-compatible\actuator\src\test\java\org\apache\dubbo\spring\boot\actuate\autoconfigure\DubboEndpointAutoConfigurationTest.java,157,40,3,26,0,69
dubbo-3.0\dubbo-3.0\dubbo-cluster\src\main\java\org\apache\dubbo\rpc\cluster\router\mesh\rule\virtualservice\match\DubboAttachmentMatch.java,50,24,0,6,0,30
dubbo-3.0\dubbo-3.0\dubbo-compatible\src\main\java\com\alibaba\dubbo\registry\NotifyListener.java,0,18,0,5,0,23
dubbo-3.0\dubbo-3.0\dubbo-common\src\main\java\org\apache\dubbo\common\deploy\ModuleDeployer.java,0,13,0,1,0,14
dubbo-3.0\dubbo-3.0\dubbo-common\src\test\java\org\apache\dubbo\common\config\EnvironmentTest.java,79,17,8,13,0,38
