Class_Location,Class_Length,CheckStyle_Amount,PMD_Amount,SCAX_Amount,SpotBugs_Amount,Total_Amount
file-management-system-master\file-management-system-master\src\main\java\com\fms\service\UploadFileService.java,128,68,1,27,0,96
file-management-system-master\file-management-system-master\src\test\java\com\fms\service\storage\FilePerDateStorageStrategyServiceTest.java,20,12,1,3,0,16
file-management-system-master\file-management-system-master\src\main\java\com\fms\FileManagementSystemApplication.java,7,5,1,1,0,7
file-management-system-master\file-management-system-master\src\main\java\com\fms\model\FileResponseDto.java,10,5,0,1,0,6
file-management-system-master\file-management-system-master\src\main\java\com\fms\config\SpringFoxConfig.java,24,4,2,2,0,8
file-management-system-master\file-management-system-master\src\test\java\com\fms\util\MapHelperTest.java,17,8,3,1,0,12
file-management-system-master\file-management-system-master\src\main\java\com\fms\service\id\InstantFileIdStrategyService.java,9,2,0,2,0,4
file-management-system-master\file-management-system-master\src\main\java\com\fms\model\FileCleanUpAgeType.java,0,5,0,1,0,6
file-management-system-master\file-management-system-master\src\main\java\com\fms\controller\UploadFileController.java,82,50,1,13,0,64
file-management-system-master\file-management-system-master\src\test\java\com\fms\service\id\FileIdServiceFactoryTest.java,26,17,2,7,0,26
file-management-system-master\file-management-system-master\src\main\java\com\fms\service\storage\FilePerYearMonthDayStorageStrategyService.java,57,22,2,6,0,30
file-management-system-master\file-management-system-master\src\test\java\com\fms\service\UploadFileServiceTest.java,3,0,0,1,0,1
file-management-system-master\file-management-system-master\src\main\java\com\fms\service\DownloadFileService.java,32,14,1,4,0,19
file-management-system-master\file-management-system-master\src\test\java\com\fms\util\FileUtilsTest.java,25,7,6,2,0,15
file-management-system-master\file-management-system-master\src\main\java\com\fms\model\FileRequestDto.java,7,2,0,1,0,3
file-management-system-master\file-management-system-master\src\main\java\com\fms\config\MultipartConfig.java,9,4,0,2,0,6
file-management-system-master\file-management-system-master\src\main\java\com\fms\controller\DownloadFileController.java,33,19,2,4,0,25
file-management-system-master\file-management-system-master\src\test\java\com\fms\service\storage\FilePerYearMonthDateStorageStrategyServiceTest.java,20,11,1,3,0,15
file-management-system-master\file-management-system-master\src\main\java\com\fms\scheduler\FileCleanUpScheduler.java,0,11,4,3,0,18
file-management-system-master\file-management-system-master\src\test\java\com\fms\controller\DownloadFileControllerTest.java,0,23,0,7,0,30
file-management-system-master\file-management-system-master\src\main\java\com\fms\service\id\FileIdStrategyService.java,0,1,0,1,0,2
file-management-system-master\file-management-system-master\src\test\java\com\fms\service\storage\FilePerYearMonthStorageStrategyServiceTest.java,20,11,1,3,0,15
file-management-system-master\file-management-system-master\src\main\java\com\fms\model\ErrorDTO.java,8,3,0,1,0,4
file-management-system-master\file-management-system-master\src\main\java\com\fms\exception\TenantIsNotAllowedException.java,14,4,0,1,0,5
file-management-system-master\file-management-system-master\src\test\java\com\fms\service\DownloadFileServiceTest.java,19,8,0,2,0,10
file-management-system-master\file-management-system-master\src\main\java\com\fms\service\storage\FileStorageStrategyService.java,49,15,2,4,0,21
file-management-system-master\file-management-system-master\src\test\java\com\fms\service\storage\FileStorageStrategyServiceTest.java,20,11,1,3,0,15
file-management-system-master\file-management-system-master\src\main\java\com\fms\exception\MissingFileDbLocationException.java,14,6,0,2,0,8
file-management-system-master\file-management-system-master\src\test\java\com\fms\model\CreateFileRequestDTOTests.java,15,7,2,2,0,11
file-management-system-master\file-management-system-master\src\test\java\com\fms\service\TenantServiceTest.java,52,31,6,8,0,45
file-management-system-master\file-management-system-master\src\main\java\com\fms\repository\FileRepository.java,0,9,2,4,0,15
file-management-system-master\file-management-system-master\src\main\java\com\fms\model\StorageStrategy.java,0,12,0,5,0,17
file-management-system-master\file-management-system-master\src\main\java\com\fms\util\FileUtils.java,60,15,2,5,0,22
file-management-system-master\file-management-system-master\src\main\java\com\fms\util\DateUtils.java,62,13,1,6,0,20
file-management-system-master\file-management-system-master\src\main\java\com\fms\service\TenantService.java,21,11,0,2,0,13
file-management-system-master\file-management-system-master\src\main\java\com\fms\exception\MissingTenantListException.java,14,5,0,2,0,7
file-management-system-master\file-management-system-master\src\test\java\com\fms\service\id\FileIdStrategyTest.java,10,5,1,3,0,9
file-management-system-master\file-management-system-master\src\main\java\com\fms\model\CreateFileResponseDTO.java,9,4,0,1,0,5
file-management-system-master\file-management-system-master\src\main\java\com\fms\service\storage\FilePerYearDateStorageStrategyService.java,56,19,2,4,0,25
file-management-system-master\file-management-system-master\src\test\java\com\fms\service\storage\FilePerYearMonthDayStorageStrategyServiceTest.java,20,11,1,3,0,15
file-management-system-master\file-management-system-master\src\main\java\com\fms\service\id\FileIdServiceFactory.java,37,14,0,3,0,17
file-management-system-master\file-management-system-master\src\main\java\com\fms\exception\MissingStorageStrategyException.java,14,5,0,2,0,7
file-management-system-master\file-management-system-master\src\main\java\com\fms\model\CreateFileRequestDTO.java,7,3,0,1,0,4
file-management-system-master\file-management-system-master\src\main\java\com\fms\service\storage\FilePerDateStorageStrategyService.java,52,18,2,6,0,26
file-management-system-master\file-management-system-master\src\main\java\com\fms\service\storage\StorageStrategyService.java,0,1,0,1,0,2
file-management-system-master\file-management-system-master\src\main\java\com\fms\util\MapHelper.java,21,7,1,2,0,10
file-management-system-master\file-management-system-master\src\main\java\com\fms\service\storage\FilePerYearMonthStorageStrategyService.java,56,20,2,5,0,27
file-management-system-master\file-management-system-master\src\main\java\com\fms\config\AppConfig.java,28,20,0,4,0,24
file-management-system-master\file-management-system-master\src\main\java\com\fms\model\StorageDto.java,9,4,0,1,0,5
file-management-system-master\file-management-system-master\src\main\java\com\fms\service\id\UUIDFileIdStrategyService.java,9,2,0,2,0,4
file-management-system-master\file-management-system-master\src\test\java\com\fms\model\CreateFileResponseDTOTests.java,18,15,0,2,0,17
file-management-system-master\file-management-system-master\src\main\java\com\fms\exception\MissingFileIdStrategyException.java,14,5,0,2,0,7
file-management-system-master\file-management-system-master\src\test\java\com\fms\service\storage\FilePerYearDateStorageStrategyServiceTest.java,20,11,1,3,0,15
file-management-system-master\file-management-system-master\src\test\java\com\fms\service\id\UUIDFileIdStrategyServiceTest.java,23,14,2,3,0,19
file-management-system-master\file-management-system-master\src\test\java\com\fms\service\id\InstantFileIdStrategyServiceTest.java,27,14,2,2,0,18
file-management-system-master\file-management-system-master\src\main\java\com\fms\service\storage\FilePerYearMonthDateStorageStrategyService.java,57,22,2,6,0,30
file-management-system-master\file-management-system-master\src\main\java\com\fms\model\FileEntity.java,90,59,2,2,0,63
file-management-system-master\file-management-system-master\src\main\java\com\fms\service\id\FileIdStrategy.java,0,3,0,1,0,4
file-management-system-master\file-management-system-master\src\main\java\com\fms\service\storage\FileStorageStrategyFactory.java,52,41,0,18,0,59
file-management-system-master\file-management-system-master\src\test\java\com\fms\service\storage\FileStorageStrategyFactoryTest.java,93,58,6,30,0,94
file-management-system-master\file-management-system-master\src\test\java\com\fms\util\DateUtilsTest.java,33,19,6,2,0,27
