Class_Location,Class_Length,CheckStyle_Amount,PMD_Amount,SCAX_Amount,SpotBugs_Amount,Total_Amount
hadoop-trunk\hadoop-trunk\hadoop-hdfs-project\hadoop-hdfs-rbf\src\main\java\org\apache\hadoop\hdfs\server\federation\store\protocol\impl\pb\GetDisabledNameservicesRequestPBImpl.java,0,9,25,5,0,39
hadoop-trunk\hadoop-trunk\hadoop-hdfs-project\hadoop-hdfs-client\src\main\java\org\apache\hadoop\hdfs\UnknownCryptoProtocolVersionException.java,12,4,0,1,0,5
hadoop-trunk\hadoop-trunk\hadoop-tools\hadoop-distcp\src\main\java\org\apache\hadoop\tools\RegexCopyFilter.java,62,10,5,2,0,17
hadoop-trunk\hadoop-trunk\hadoop-yarn-project\hadoop-yarn\hadoop-yarn-csi\src\main\java\org\apache\hadoop\yarn\csi\translator\GetPluginInfoResponseProtoTranslator.java,0,6,6,1,0,13
hadoop-trunk\hadoop-trunk\hadoop-common-project\hadoop-common\src\main\java\org\apache\hadoop\fs\Globber.java,448,76,7,2,0,85
hadoop-trunk\hadoop-trunk\hadoop-yarn-project\hadoop-yarn\hadoop-yarn-applications\hadoop-yarn-applications-catalog\hadoop-yarn-applications-catalog-webapp\src\test\java\org\apache\hadoop\yarn\appcatalog\controller\AppStoreControllerTest.java,58,8,5,1,0,14
hadoop-trunk\hadoop-trunk\hadoop-yarn-project\hadoop-yarn\hadoop-yarn-applications\hadoop-yarn-services\hadoop-yarn-services-core\src\main\java\org\apache\hadoop\yarn\service\component\instance\ComponentInstanceState.java,0,6,0,1,0,7
hadoop-trunk\hadoop-trunk\hadoop-yarn-project\hadoop-yarn\hadoop-yarn-server\hadoop-yarn-server-common\src\main\java\org\apache\hadoop\yarn\server\federation\utils\FederationStateStoreFacade.java,0,51,10,20,0,81
hadoop-trunk\hadoop-trunk\hadoop-yarn-project\hadoop-yarn\hadoop-yarn-server\hadoop-yarn-server-resourcemanager\src\test\java\org\apache\hadoop\yarn\server\resourcemanager\webapp\fairscheduler\FairSchedulerXmlVerifications.java,113,19,0,2,0,21
hadoop-trunk\hadoop-trunk\hadoop-tools\hadoop-aws\src\test\java\org\apache\hadoop\fs\s3a\TestBucketConfiguration.java,204,17,0,8,0,25
hadoop-trunk\hadoop-trunk\hadoop-yarn-project\hadoop-yarn\hadoop-yarn-server\hadoop-yarn-server-tests\src\test\java\org\apache\hadoop\yarn\server\TestMiniYarnClusterNodeUtilization.java,188,45,3,1,0,49
hadoop-trunk\hadoop-trunk\hadoop-yarn-project\hadoop-yarn\hadoop-yarn-common\src\test\java\org\apache\hadoop\yarn\logaggregation\TestAggregatedLogsBlock.java,336,44,4,9,0,57
hadoop-trunk\hadoop-trunk\hadoop-common-project\hadoop-auth\src\test\java\org\apache\hadoop\security\authentication\server\TestAuthenticationFilter.java,1226,152,23,59,0,234
hadoop-trunk\hadoop-trunk\hadoop-yarn-project\hadoop-yarn\hadoop-yarn-server\hadoop-yarn-server-common\src\main\java\org\apache\hadoop\yarn\server\federation\store\records\AddApplicationHomeSubClusterResponse.java,30,2,0,1,0,3
hadoop-trunk\hadoop-trunk\hadoop-hdfs-project\hadoop-hdfs\src\test\java\org\apache\hadoop\hdfs\server\balancer\TestBalancerWithMultipleNameNodes.java,0,157,15,2,0,174
hadoop-trunk\hadoop-trunk\hadoop-yarn-project\hadoop-yarn\hadoop-yarn-api\src\main\java\org\apache\hadoop\yarn\api\protocolrecords\GetAllResourceTypeInfoRequest.java,7,1,0,1,0,2
hadoop-trunk\hadoop-trunk\hadoop-yarn-project\hadoop-yarn\hadoop-yarn-api\src\main\java\org\apache\hadoop\yarn\api\records\AMCommand.java,0,11,0,5,0,16
hadoop-trunk\hadoop-trunk\hadoop-hdfs-project\hadoop-hdfs\src\main\java\org\apache\hadoop\hdfs\server\diskbalancer\command\CancelCommand.java,111,12,2,1,0,15
hadoop-trunk\hadoop-trunk\hadoop-yarn-project\hadoop-yarn\hadoop-yarn-server\hadoop-yarn-server-common\src\main\java\org\apache\hadoop\yarn\server\api\DistributedSchedulingAMProtocolPB.java,3,0,5,3,0,8
hadoop-trunk\hadoop-trunk\hadoop-yarn-project\hadoop-yarn\hadoop-yarn-server\hadoop-yarn-server-nodemanager\src\main\java\org\apache\hadoop\yarn\server\nodemanager\containermanager\scheduler\OpportunisticContainersQueuePolicy.java,0,2,0,1,0,3
hadoop-trunk\hadoop-trunk\hadoop-common-project\hadoop-common\src\test\java\org\apache\hadoop\net\TestClusterTopology.java,259,47,2,3,0,52
hadoop-trunk\hadoop-trunk\hadoop-hdfs-project\hadoop-hdfs\src\main\java\org\apache\hadoop\hdfs\server\namenode\FSImageFormatPBINode.java,0,137,128,18,0,283
hadoop-trunk\hadoop-trunk\hadoop-hdfs-project\hadoop-hdfs-rbf\src\main\java\org\apache\hadoop\hdfs\server\federation\router\ConnectionPool.java,394,39,5,3,0,47
hadoop-trunk\hadoop-trunk\hadoop-tools\hadoop-resourceestimator\src\main\java\org\apache\hadoop\resourceestimator\common\api\ResourceSkyline.java,182,0,3,2,0,5
hadoop-trunk\hadoop-trunk\hadoop-tools\hadoop-rumen\src\main\java\org\apache\hadoop\tools\rumen\state\StateDeserializer.java,28,11,0,1,0,12
hadoop-trunk\hadoop-trunk\hadoop-yarn-project\hadoop-yarn\hadoop-yarn-server\hadoop-yarn-server-resourcemanager\src\main\java\org\apache\hadoop\yarn\server\resourcemanager\scheduler\constraint\api\package-info.java,0,0,0,1,0,1
hadoop-trunk\hadoop-trunk\hadoop-yarn-project\hadoop-yarn\hadoop-yarn-server\hadoop-yarn-server-timelineservice-hbase\hadoop-yarn-server-timelineservice-hbase-client\src\main\java\org\apache\hadoop\yarn\server\timelineservice\storage\reader\ApplicationEntityReader.java,0,28,1,17,0,46
hadoop-trunk\hadoop-trunk\hadoop-common-project\hadoop-common\src\main\java\org\apache\hadoop\io\erasurecode\codec\package-info.java,0,1,0,1,0,2
hadoop-trunk\hadoop-trunk\hadoop-common-project\hadoop-common\src\main\java\org\apache\hadoop\io\compress\zlib\ZlibFactory.java,133,58,6,3,0,67
hadoop-trunk\hadoop-trunk\hadoop-common-project\hadoop-common\src\test\java\org\apache\hadoop\fs\TestDFCachingGetSpaceUsed.java,41,10,1,1,0,12
hadoop-trunk\hadoop-trunk\hadoop-mapreduce-project\hadoop-mapreduce-client\hadoop-mapreduce-client-core\src\main\java\org\apache\hadoop\mapreduce\lib\db\DataDrivenDBInputFormat.java,0,70,25,18,0,113
hadoop-trunk\hadoop-trunk\hadoop-mapreduce-project\hadoop-mapreduce-client\hadoop-mapreduce-client-nativetask\src\test\java\org\apache\hadoop\mapred\nativetask\testutil\ScenarioConfiguration.java,38,12,0,1,0,13
hadoop-trunk\hadoop-trunk\hadoop-tools\hadoop-azure\src\main\java\org\apache\hadoop\fs\azurebfs\contracts\services\ListResultSchema.java,29,1,1,1,0,3
hadoop-trunk\hadoop-trunk\hadoop-tools\hadoop-azure\src\test\java\org\apache\hadoop\fs\azurebfs\extensions\MockSASTokenProvider.java,54,26,1,6,0,33
hadoop-trunk\hadoop-trunk\hadoop-yarn-project\hadoop-yarn\hadoop-yarn-server\hadoop-yarn-server-resourcemanager\src\test\java\org\apache\hadoop\yarn\server\resourcemanager\TestApplicationMasterLauncher.java,495,83,11,10,0,104
hadoop-trunk\hadoop-trunk\hadoop-hdfs-project\hadoop-hdfs\src\main\java\org\apache\hadoop\hdfs\server\mover\package-info.java,0,2,0,1,0,3
hadoop-trunk\hadoop-trunk\hadoop-mapreduce-project\hadoop-mapreduce-client\hadoop-mapreduce-client-jobclient\src\test\java\org\apache\hadoop\mapred\lib\aggregate\TestAggregates.java,100,20,17,1,0,38
hadoop-trunk\hadoop-trunk\hadoop-hdfs-project\hadoop-hdfs\src\test\java\org\apache\hadoop\hdfs\TestExtendedAcls.java,384,20,6,2,0,28
hadoop-trunk\hadoop-trunk\hadoop-yarn-project\hadoop-yarn\hadoop-yarn-server\hadoop-yarn-server-resourcemanager\src\main\java\org\apache\hadoop\yarn\server\resourcemanager\webapp\dao\helper\CapacitySchedulerInfoHelper.java,74,29,1,8,0,38
hadoop-trunk\hadoop-trunk\hadoop-common-project\hadoop-common\src\main\java\org\apache\hadoop\ipc\RpcMultiplexer.java,0,0,0,1,0,1
hadoop-trunk\hadoop-trunk\hadoop-yarn-project\hadoop-yarn\hadoop-yarn-server\hadoop-yarn-server-timelineservice-documentstore\src\main\java\org\apache\hadoop\yarn\server\timelineservice\documentstore\reader\cosmosdb\package-info.java,0,0,0,2,0,2
hadoop-trunk\hadoop-trunk\hadoop-hdfs-project\hadoop-hdfs\src\main\java\org\apache\hadoop\hdfs\tools\snapshot\LsSnapshot.java,29,8,0,1,0,9
hadoop-trunk\hadoop-trunk\hadoop-yarn-project\hadoop-yarn\hadoop-yarn-server\hadoop-yarn-server-resourcemanager\src\main\java\org\apache\hadoop\yarn\server\resourcemanager\scheduler\event\NodeLabelsUpdateSchedulerEvent.java,13,7,0,1,0,8
hadoop-trunk\hadoop-trunk\hadoop-hdfs-project\hadoop-hdfs\src\test\java\org\apache\hadoop\fs\contract\hdfs\TestHDFSContractUnbuffer.java,18,4,0,1,0,5
hadoop-trunk\hadoop-trunk\hadoop-mapreduce-project\hadoop-mapreduce-client\hadoop-mapreduce-client-core\src\main\java\org\apache\hadoop\mapred\Clock.java,0,1,0,1,0,2
hadoop-trunk\hadoop-trunk\hadoop-yarn-project\hadoop-yarn\hadoop-yarn-common\src\main\java\org\apache\hadoop\yarn\nodelabels\AttributeExpressionOperation.java,0,4,0,1,0,5
hadoop-trunk\hadoop-trunk\hadoop-hdfs-project\hadoop-hdfs-rbf\src\test\java\org\apache\hadoop\hdfs\server\federation\router\TestRouterNamenodeWebScheme.java,151,8,0,4,0,12
hadoop-trunk\hadoop-trunk\hadoop-yarn-project\hadoop-yarn\hadoop-yarn-server\hadoop-yarn-server-resourcemanager\src\main\java\org\apache\hadoop\yarn\server\resourcemanager\webapp\ColumnHeader.java,26,5,0,1,0,6
hadoop-trunk\hadoop-trunk\hadoop-hdfs-project\hadoop-hdfs\src\test\java\org\apache\hadoop\fs\contract\hdfs\TestHDFSContractRename.java,18,4,0,1,0,5
hadoop-trunk\hadoop-trunk\hadoop-mapreduce-project\hadoop-mapreduce-client\hadoop-mapreduce-client-core\src\test\java\org\apache\hadoop\mapreduce\lib\output\committer\manifest\TestCreateOutputDirectoriesStage.java,248,22,3,21,0,46
hadoop-trunk\hadoop-trunk\hadoop-yarn-project\hadoop-yarn\hadoop-yarn-common\src\main\java\org\apache\hadoop\yarn\api\records\impl\pb\ContainerLaunchContextPBImpl.java,0,114,112,4,0,230
hadoop-trunk\hadoop-trunk\hadoop-hdfs-project\hadoop-hdfs\src\main\java\org\apache\hadoop\hdfs\server\mover\Mover.java,843,168,26,9,0,203
hadoop-trunk\hadoop-trunk\hadoop-yarn-project\hadoop-yarn\hadoop-yarn-applications\hadoop-yarn-services\hadoop-yarn-services-core\src\main\java\org\apache\hadoop\yarn\service\containerlaunch\JavaCommandLineBuilder.java,147,37,0,3,0,40
hadoop-trunk\hadoop-trunk\hadoop-common-project\hadoop-common\src\main\java\org\apache\hadoop\fs\local\LocalConfigKeys.java,0,25,0,1,0,26
hadoop-trunk\hadoop-trunk\hadoop-mapreduce-project\hadoop-mapreduce-client\hadoop-mapreduce-client-app\src\main\java\org\apache\hadoop\mapreduce\v2\app\job\TaskAttemptStateInternal.java,0,25,0,1,0,26
hadoop-trunk\hadoop-trunk\hadoop-mapreduce-project\hadoop-mapreduce-client\hadoop-mapreduce-client-core\src\main\java\org\apache\hadoop\mapreduce\lib\output\MultipleOutputs.java,0,160,29,23,0,212
hadoop-trunk\hadoop-trunk\hadoop-tools\hadoop-aws\src\test\java\org\apache\hadoop\fs\s3a\TestWildflyAndOpenSSLBinding.java,101,7,0,5,0,12
hadoop-trunk\hadoop-trunk\hadoop-tools\hadoop-openstack\src\main\java\org\apache\hadoop\fs\swift\exceptions\SwiftJsonMarshallingException.java,11,5,0,1,0,6
hadoop-trunk\hadoop-trunk\hadoop-mapreduce-project\hadoop-mapreduce-client\hadoop-mapreduce-client-app\src\main\java\org\apache\hadoop\mapreduce\v2\app\webapp\JobConfPage.java,0,42,0,2,0,44
hadoop-trunk\hadoop-trunk\hadoop-common-project\hadoop-common\src\main\java\org\apache\hadoop\util\concurrent\HadoopExecutors.java,0,24,2,1,0,27
hadoop-trunk\hadoop-trunk\hadoop-mapreduce-project\hadoop-mapreduce-client\hadoop-mapreduce-client-common\src\main\java\org\apache\hadoop\mapreduce\v2\api\HSAdminRefreshProtocolPB.java,0,3,2,4,0,9
hadoop-trunk\hadoop-trunk\hadoop-common-project\hadoop-common\src\main\java\org\apache\hadoop\io\erasurecode\rawcoder\NativeRSRawErasureCoderFactory.java,25,7,0,1,0,8
hadoop-trunk\hadoop-trunk\hadoop-yarn-project\hadoop-yarn\hadoop-yarn-csi\src\main\java\org\apache\hadoop\yarn\csi\adaptor\package-info.java,0,1,0,1,0,2
hadoop-trunk\hadoop-trunk\hadoop-tools\hadoop-streaming\src\test\java\org\apache\hadoop\streaming\TypedBytesReduceApp.java,32,9,0,3,0,12
hadoop-trunk\hadoop-trunk\hadoop-hdfs-project\hadoop-hdfs\src\main\java\org\apache\hadoop\hdfs\server\common\blockaliasmap\package-info.java,0,1,0,1,0,2
hadoop-trunk\hadoop-trunk\hadoop-yarn-project\hadoop-yarn\hadoop-yarn-common\src\main\java\org\apache\hadoop\yarn\logaggregation\LogAggregationMetaCollector.java,105,14,1,2,0,17
hadoop-trunk\hadoop-trunk\hadoop-yarn-project\hadoop-yarn\hadoop-yarn-server\hadoop-yarn-server-resourcemanager\src\main\java\org\apache\hadoop\yarn\server\resourcemanager\placement\UserPlacementRule.java,34,4,2,4,0,10
hadoop-trunk\hadoop-trunk\hadoop-yarn-project\hadoop-yarn\hadoop-yarn-server\hadoop-yarn-server-resourcemanager\src\main\java\org\apache\hadoop\yarn\server\resourcemanager\recovery\RMStateStoreFactory.java,13,6,2,1,0,9
hadoop-trunk\hadoop-trunk\hadoop-mapreduce-project\hadoop-mapreduce-client\hadoop-mapreduce-client-app\src\main\java\org\apache\hadoop\mapreduce\v2\app\speculate\ExponentiallySmoothedTaskRuntimeEstimator.java,158,48,0,6,0,54
hadoop-trunk\hadoop-trunk\hadoop-common-project\hadoop-common\src\main\java\org\apache\hadoop\fs\impl\FileSystemMultipartUploaderBuilder.java,0,11,7,2,0,20
hadoop-trunk\hadoop-trunk\hadoop-hdfs-project\hadoop-hdfs\src\main\java\org\apache\hadoop\hdfs\net\PeerServer.java,0,7,4,1,0,12
hadoop-trunk\hadoop-trunk\hadoop-hdfs-project\hadoop-hdfs\src\test\java\org\apache\hadoop\hdfs\server\namenode\snapshot\TestSnapshotMetrics.java,0,50,2,1,0,53
hadoop-trunk\hadoop-trunk\hadoop-hdfs-project\hadoop-hdfs\src\main\java\org\apache\hadoop\hdfs\server\blockmanagement\PendingReconstructionBlocks.java,0,45,8,2,0,55
hadoop-trunk\hadoop-trunk\hadoop-mapreduce-project\hadoop-mapreduce-client\hadoop-mapreduce-client-app\src\main\java\org\apache\hadoop\mapreduce\v2\app\commit\CommitterEventType.java,0,4,0,1,0,5
hadoop-trunk\hadoop-trunk\hadoop-yarn-project\hadoop-yarn\hadoop-yarn-server\hadoop-yarn-server-common\src\test\java\org\apache\hadoop\yarn\server\federation\utils\TestFederationRegistryClient.java,55,7,2,1,0,10
hadoop-trunk\hadoop-trunk\hadoop-common-project\hadoop-auth\src\main\java\org\apache\hadoop\security\authentication\server\HttpConstants.java,0,0,0,1,0,1
hadoop-trunk\hadoop-trunk\hadoop-yarn-project\hadoop-yarn\hadoop-yarn-server\hadoop-yarn-server-nodemanager\src\test\java\org\apache\hadoop\yarn\server\nodemanager\containermanager\linux\runtime\docker\TestDockerStopCommand.java,31,7,0,2,0,9
hadoop-trunk\hadoop-trunk\hadoop-hdfs-project\hadoop-hdfs\src\main\java\org\apache\hadoop\hdfs\protocolPB\DatanodeLifelineProtocolServerSideTranslatorPB.java,33,9,9,3,0,21
hadoop-trunk\hadoop-trunk\hadoop-hdfs-project\hadoop-hdfs-client\src\main\java\org\apache\hadoop\hdfs\protocol\OpenFileEntry.java,31,21,0,1,0,22
hadoop-trunk\hadoop-trunk\hadoop-yarn-project\hadoop-yarn\hadoop-yarn-common\src\main\java\org\apache\hadoop\yarn\api\protocolrecords\impl\pb\ReInitializeContainerRequestPBImpl.java,143,35,46,8,0,89
hadoop-trunk\hadoop-trunk\hadoop-common-project\hadoop-registry\src\main\java\org\apache\hadoop\registry\server\services\RegistryAdminService.java,452,55,7,4,0,66
hadoop-trunk\hadoop-trunk\hadoop-mapreduce-project\hadoop-mapreduce-client\hadoop-mapreduce-client-common\src\main\java\org\apache\hadoop\mapreduce\v2\api\protocolrecords\GetTaskReportResponse.java,0,7,2,1,0,10
hadoop-trunk\hadoop-trunk\hadoop-common-project\hadoop-common\src\main\java\org\apache\hadoop\util\OperationDuration.java,86,6,2,1,0,9
hadoop-trunk\hadoop-trunk\hadoop-mapreduce-project\hadoop-mapreduce-examples\src\test\java\org\apache\hadoop\examples\pi\math\TestSummation.java,123,50,11,3,0,64
hadoop-trunk\hadoop-trunk\hadoop-common-project\hadoop-common\src\test\java\org\apache\hadoop\ha\DummySharedResource.java,24,13,0,1,0,14
hadoop-trunk\hadoop-trunk\hadoop-hdfs-project\hadoop-hdfs-client\src\test\java\org\apache\hadoop\hdfs\web\TestWebHdfsContentLength.java,0,63,9,1,0,73
hadoop-trunk\hadoop-trunk\hadoop-mapreduce-project\hadoop-mapreduce-client\hadoop-mapreduce-client-core\src\main\java\org\apache\hadoop\mapreduce\lib\output\committer\manifest\impl\AuditingIntegration.java,0,6,0,5,0,11
hadoop-trunk\hadoop-trunk\hadoop-yarn-project\hadoop-yarn\hadoop-yarn-server\hadoop-yarn-server-timelineservice\src\test\java\org\apache\hadoop\yarn\server\timelineservice\reader\TestTimelineReaderServer.java,71,7,1,2,0,10
hadoop-trunk\hadoop-trunk\hadoop-common-project\hadoop-common\src\test\java\org\apache\hadoop\ha\ClientBaseWithFixes.java,422,129,12,9,0,150
hadoop-trunk\hadoop-trunk\hadoop-yarn-project\hadoop-yarn\hadoop-yarn-server\hadoop-yarn-server-resourcemanager\src\main\java\org\apache\hadoop\yarn\server\resourcemanager\recovery\records\ApplicationStateData.java,216,109,2,5,0,116
hadoop-trunk\hadoop-trunk\hadoop-yarn-project\hadoop-yarn\hadoop-yarn-server\hadoop-yarn-server-resourcemanager\src\test\java\org\apache\hadoop\yarn\server\resourcemanager\scheduler\TestSchedulerOvercommit.java,656,154,4,4,0,162
hadoop-trunk\hadoop-trunk\hadoop-tools\hadoop-aws\src\test\java\org\apache\hadoop\fs\contract\s3a\ITestS3AContractDelete.java,8,2,0,1,0,3
hadoop-trunk\hadoop-trunk\hadoop-common-project\hadoop-common\src\test\java\org\apache\hadoop\io\compress\bzip2\TestBzip2CompressorDecompressor.java,69,36,15,3,0,54
hadoop-trunk\hadoop-trunk\hadoop-yarn-project\hadoop-yarn\hadoop-yarn-server\hadoop-yarn-server-resourcemanager\src\main\java\org\apache\hadoop\yarn\server\resourcemanager\webapp\RMWebAppFilter.java,220,49,5,1,0,55
hadoop-trunk\hadoop-trunk\hadoop-yarn-project\hadoop-yarn\hadoop-yarn-client\src\main\java\org\apache\hadoop\yarn\client\api\impl\AHSClientImpl.java,101,22,0,5,0,27
hadoop-trunk\hadoop-trunk\hadoop-yarn-project\hadoop-yarn\hadoop-yarn-common\src\main\java\org\apache\hadoop\yarn\client\NMProxy.java,22,2,0,1,0,3
hadoop-trunk\hadoop-trunk\hadoop-yarn-project\hadoop-yarn\hadoop-yarn-applications\hadoop-yarn-services\hadoop-yarn-services-core\src\main\java\org\apache\hadoop\yarn\service\utils\PublishedConfigurationOutputter.java,172,44,0,3,0,47
hadoop-trunk\hadoop-trunk\hadoop-yarn-project\hadoop-yarn\hadoop-yarn-common\src\main\java\org\apache\hadoop\yarn\webapp\WebApps.java,475,177,25,4,0,206
hadoop-trunk\hadoop-trunk\hadoop-common-project\hadoop-common\src\main\java\org\apache\hadoop\io\AbstractMapWritable.java,0,74,2,2,0,78
hadoop-trunk\hadoop-trunk\hadoop-hdfs-project\hadoop-hdfs\src\test\java\org\apache\hadoop\hdfs\server\namenode\snapshot\TestOrderedSnapshotDeletion.java,236,37,3,3,0,43
hadoop-trunk\hadoop-trunk\hadoop-mapreduce-project\hadoop-mapreduce-client\hadoop-mapreduce-client-core\src\main\java\org\apache\hadoop\mapreduce\JobSubmissionFiles.java,128,44,5,1,0,50
hadoop-trunk\hadoop-trunk\hadoop-common-project\hadoop-common\src\main\java\org\apache\hadoop\http\HttpConfig.java,26,8,0,1,0,9
hadoop-trunk\hadoop-trunk\hadoop-mapreduce-project\hadoop-mapreduce-client\hadoop-mapreduce-client-common\src\main\java\org\apache\hadoop\mapreduce\v2\jobhistory\package-info.java,0,1,0,1,0,2
hadoop-trunk\hadoop-trunk\hadoop-yarn-project\hadoop-yarn\hadoop-yarn-server\hadoop-yarn-server-resourcemanager\src\test\java\org\apache\hadoop\yarn\server\resourcemanager\scheduler\policy\TestFifoOrderingPolicyForPendingApps.java,66,26,1,1,0,28
hadoop-trunk\hadoop-trunk\hadoop-yarn-project\hadoop-yarn\hadoop-yarn-server\hadoop-yarn-server-common\src\test\java\org\apache\hadoop\yarn\server\federation\policies\TestRouterPolicyFacade.java,171,18,4,12,0,34
hadoop-trunk\hadoop-trunk\hadoop-hdfs-project\hadoop-hdfs\src\test\java\org\apache\hadoop\hdfs\server\datanode\TestCachingStrategy.java,353,108,17,13,0,138
hadoop-trunk\hadoop-trunk\hadoop-hdfs-project\hadoop-hdfs-client\src\main\java\org\apache\hadoop\hdfs\server\namenode\NotReplicatedYetException.java,8,3,0,1,0,4
hadoop-trunk\hadoop-trunk\hadoop-mapreduce-project\hadoop-mapreduce-client\hadoop-mapreduce-client-core\src\main\java\org\apache\hadoop\mapred\pipes\PipesNonJavaInputFormat.java,0,23,4,2,0,29
hadoop-trunk\hadoop-trunk\hadoop-yarn-project\hadoop-yarn\hadoop-yarn-server\hadoop-yarn-server-resourcemanager\src\main\java\org\apache\hadoop\yarn\server\resourcemanager\placement\ApplicationPlacementContext.java,41,24,0,1,0,25
hadoop-trunk\hadoop-trunk\hadoop-common-project\hadoop-common\src\test\java\org\apache\hadoop\fs\shell\find\TestResult.java,153,21,7,1,0,29
hadoop-trunk\hadoop-trunk\hadoop-yarn-project\hadoop-yarn\hadoop-yarn-applications\hadoop-yarn-applications-mawo\hadoop-yarn-applications-mawo-core\src\main\java\org\apache\hadoop\applications\mawo\server\master\job\package-info.java,0,1,0,1,0,2
hadoop-trunk\hadoop-trunk\hadoop-yarn-project\hadoop-yarn\hadoop-yarn-server\hadoop-yarn-server-timelineservice-hbase\hadoop-yarn-server-timelineservice-hbase-client\src\main\java\org\apache\hadoop\yarn\server\timelineservice\storage\flow\FlowActivityTableRW.java,57,8,2,1,0,11
hadoop-trunk\hadoop-trunk\hadoop-tools\hadoop-openstack\src\test\java\org\apache\hadoop\fs\swift\contract\TestSwiftContractRename.java,9,2,0,1,0,3
hadoop-trunk\hadoop-trunk\hadoop-yarn-project\hadoop-yarn\hadoop-yarn-server\hadoop-yarn-server-common\src\test\java\org\apache\hadoop\yarn\server\scheduler\TestDistributedOpportunisticContainerAllocator.java,792,110,4,1,0,115
hadoop-trunk\hadoop-trunk\hadoop-tools\hadoop-azure\src\main\java\org\apache\hadoop\fs\azure\ShellDecryptionKeyProvider.java,31,4,0,1,0,5
hadoop-trunk\hadoop-trunk\hadoop-hdfs-project\hadoop-hdfs\src\test\java\org\apache\hadoop\fs\viewfs\TestViewFsAtHdfsRoot.java,63,14,1,1,0,16
hadoop-trunk\hadoop-trunk\hadoop-tools\hadoop-azure\src\test\java\org\apache\hadoop\fs\azure\ITestListPerformance.java,142,20,6,3,0,29
hadoop-trunk\hadoop-trunk\hadoop-tools\hadoop-aws\src\main\java\org\apache\hadoop\fs\s3a\impl\S3AMultipartUploader.java,0,22,3,2,0,27
hadoop-trunk\hadoop-trunk\hadoop-hdfs-project\hadoop-hdfs-httpfs\src\test\java\org\apache\hadoop\lib\lang\TestRunnableCallable.java,68,13,2,1,0,16
hadoop-trunk\hadoop-trunk\hadoop-tools\hadoop-distcp\src\main\java\org\apache\hadoop\tools\DistCp.java,449,50,12,4,0,66
hadoop-trunk\hadoop-trunk\hadoop-common-project\hadoop-auth\src\main\java\org\apache\hadoop\security\authentication\util\SignerException.java,14,2,0,1,0,3
hadoop-trunk\hadoop-trunk\hadoop-common-project\hadoop-common\src\main\java\org\apache\hadoop\net\unix\DomainSocketWatcher.java,0,66,21,3,0,90
hadoop-trunk\hadoop-trunk\hadoop-tools\hadoop-azure\src\main\java\org\apache\hadoop\fs\azurebfs\security\AbfsDtFetcher.java,49,8,0,1,0,9
hadoop-trunk\hadoop-trunk\hadoop-yarn-project\hadoop-yarn\hadoop-yarn-server\hadoop-yarn-server-nodemanager\src\main\java\org\apache\hadoop\yarn\server\nodemanager\webapp\dao\AuxiliaryServicesInfo.java,24,10,3,2,0,15
hadoop-trunk\hadoop-trunk\hadoop-yarn-project\hadoop-yarn\hadoop-yarn-server\hadoop-yarn-server-common\src\main\java\org\apache\hadoop\yarn\server\federation\store\records\GetApplicationsHomeSubClusterRequest.java,12,1,1,1,0,3
hadoop-trunk\hadoop-trunk\hadoop-yarn-project\hadoop-yarn\hadoop-yarn-server\hadoop-yarn-server-timelineservice-hbase\hadoop-yarn-server-timelineservice-hbase-common\src\main\java\org\apache\hadoop\yarn\server\timelineservice\storage\common\KeyConverter.java,0,1,0,1,0,2
hadoop-trunk\hadoop-trunk\hadoop-yarn-project\hadoop-yarn\hadoop-yarn-api\src\main\java\org\apache\hadoop\yarn\api\protocolrecords\GetApplicationReportResponse.java,25,13,2,3,0,18
hadoop-trunk\hadoop-trunk\hadoop-mapreduce-project\hadoop-mapreduce-examples\src\main\java\org\apache\hadoop\examples\terasort\TeraChecksum.java,69,19,2,1,0,22
hadoop-trunk\hadoop-trunk\hadoop-yarn-project\hadoop-yarn\hadoop-yarn-client\src\test\java\org\apache\hadoop\yarn\client\TestGetGroups.java,66,18,3,1,0,22
hadoop-trunk\hadoop-trunk\hadoop-yarn-project\hadoop-yarn\hadoop-yarn-server\hadoop-yarn-server-resourcemanager\src\test\java\org\apache\hadoop\yarn\server\resourcemanager\MockNodes.java,387,189,12,9,0,210
hadoop-trunk\hadoop-trunk\hadoop-hdfs-project\hadoop-hdfs\src\test\java\org\apache\hadoop\hdfs\tools\TestGetGroups.java,25,8,0,1,0,9
hadoop-trunk\hadoop-trunk\hadoop-yarn-project\hadoop-yarn\hadoop-yarn-server\hadoop-yarn-server-router\src\main\java\org\apache\hadoop\yarn\server\router\rmadmin\AbstractRMAdminRequestInterceptor.java,0,7,0,1,0,8
hadoop-trunk\hadoop-trunk\hadoop-tools\hadoop-aws\src\main\java\org\apache\hadoop\fs\s3a\audit\impl\LoggingAuditor.java,0,8,7,7,0,22
hadoop-trunk\hadoop-trunk\hadoop-yarn-project\hadoop-yarn\hadoop-yarn-server\hadoop-yarn-server-common\src\main\java\org\apache\hadoop\yarn\server\api\protocolrecords\impl\pb\RegisterNodeManagerRequestPBImpl.java,517,114,104,12,0,230
hadoop-trunk\hadoop-trunk\hadoop-yarn-project\hadoop-yarn\hadoop-yarn-server\hadoop-yarn-server-router\src\test\java\org\apache\hadoop\yarn\server\router\webapp\BaseRouterWebServicesTest.java,330,104,0,9,0,113
hadoop-trunk\hadoop-trunk\hadoop-yarn-project\hadoop-yarn\hadoop-yarn-api\src\main\java\org\apache\hadoop\yarn\api\records\ResourceTypeInfo.java,170,15,0,1,0,16
hadoop-trunk\hadoop-trunk\hadoop-mapreduce-project\hadoop-mapreduce-client\hadoop-mapreduce-client-core\src\main\java\org\apache\hadoop\mapred\lib\MultipleOutputs.java,444,81,29,3,0,113
hadoop-trunk\hadoop-trunk\hadoop-tools\hadoop-resourceestimator\src\main\java\org\apache\hadoop\resourceestimator\solver\preprocess\SolverPreprocessor.java,176,7,8,5,0,20
hadoop-trunk\hadoop-trunk\hadoop-common-project\hadoop-registry\src\main\java\org\apache\hadoop\registry\client\types\yarn\PersistencePolicies.java,0,5,4,1,0,10
hadoop-trunk\hadoop-trunk\hadoop-yarn-project\hadoop-yarn\hadoop-yarn-api\src\main\java\org\apache\hadoop\yarn\api\protocolrecords\RenewDelegationTokenRequest.java,23,3,0,1,0,4
hadoop-trunk\hadoop-trunk\hadoop-common-project\hadoop-common\src\test\java\org\apache\hadoop\util\TestCpuTimeTracker.java,30,6,2,1,0,9
hadoop-trunk\hadoop-trunk\hadoop-yarn-project\hadoop-yarn\hadoop-yarn-server\hadoop-yarn-server-common\src\main\java\org\apache\hadoop\yarn\server\federation\policies\exceptions\NoActiveSubclustersException.java,6,2,0,1,0,3
hadoop-trunk\hadoop-trunk\hadoop-yarn-project\hadoop-yarn\hadoop-yarn-server\hadoop-yarn-server-resourcemanager\src\test\java\org\apache\hadoop\yarn\server\resourcemanager\webapp\TestRMWebServicesDelegationTokenAuthentication.java,425,52,11,18,0,81
hadoop-trunk\hadoop-trunk\hadoop-yarn-project\hadoop-yarn\hadoop-yarn-server\hadoop-yarn-server-resourcemanager\src\main\java\org\apache\hadoop\yarn\server\resourcemanager\AMSProcessingChain.java,0,20,2,6,0,28
hadoop-trunk\hadoop-trunk\hadoop-common-project\hadoop-common\src\main\java\org\apache\hadoop\security\authentication\server\ProxyUserAuthenticationFilterInitializer.java,0,8,0,1,0,9
hadoop-trunk\hadoop-trunk\hadoop-common-project\hadoop-common\src\main\java\org\apache\hadoop\fs\store\audit\HttpReferrerAuditHeader.java,0,16,1,1,0,18
hadoop-trunk\hadoop-trunk\hadoop-tools\hadoop-gridmix\src\main\java\org\apache\hadoop\mapred\gridmix\GenerateDistCacheData.java,0,24,4,2,0,30
hadoop-trunk\hadoop-trunk\hadoop-yarn-project\hadoop-yarn\hadoop-yarn-server\hadoop-yarn-server-timeline-pluginstorage\src\test\java\org\apache\hadoop\yarn\server\timeline\EntityGroupPlugInForTest.java,0,12,2,1,0,15
hadoop-trunk\hadoop-trunk\hadoop-yarn-project\hadoop-yarn\hadoop-yarn-api\src\main\java\org\apache\hadoop\yarn\api\records\URL.java,138,20,0,2,0,22
hadoop-trunk\hadoop-trunk\hadoop-hdfs-project\hadoop-hdfs\src\test\java\org\apache\hadoop\hdfs\server\namenode\snapshot\TestSnapshotNameWithInvalidCharacters.java,0,24,7,1,0,32
hadoop-trunk\hadoop-trunk\hadoop-mapreduce-project\hadoop-mapreduce-client\hadoop-mapreduce-client-common\src\main\java\org\apache\hadoop\mapreduce\v2\api\impl\pb\service\package-info.java,0,1,0,1,0,2
hadoop-trunk\hadoop-trunk\hadoop-yarn-project\hadoop-yarn\hadoop-yarn-server\hadoop-yarn-server-resourcemanager\src\test\java\org\apache\hadoop\yarn\server\resourcemanager\scheduler\capacity\TestQueueMappings.java,127,30,3,3,0,36
hadoop-trunk\hadoop-trunk\hadoop-common-project\hadoop-registry\src\main\java\org\apache\hadoop\registry\conf\package-info.java,0,0,0,1,0,1
hadoop-trunk\hadoop-trunk\hadoop-yarn-project\hadoop-yarn\hadoop-yarn-applications\hadoop-yarn-services\hadoop-yarn-services-core\src\main\java\org\apache\hadoop\yarn\service\ContainerFailureTracker.java,53,16,2,3,0,21
hadoop-trunk\hadoop-trunk\hadoop-mapreduce-project\hadoop-mapreduce-examples\src\main\java\org\apache\hadoop\examples\pi\DistSum.java,0,292,17,17,0,326
hadoop-trunk\hadoop-trunk\hadoop-mapreduce-project\hadoop-mapreduce-examples\src\test\java\org\apache\hadoop\examples\pi\math\TestModular.java,339,132,53,1,0,186
hadoop-trunk\hadoop-trunk\hadoop-tools\hadoop-openstack\src\main\java\org\apache\hadoop\fs\swift\exceptions\SwiftConfigurationException.java,10,6,0,1,0,7
hadoop-trunk\hadoop-trunk\hadoop-yarn-project\hadoop-yarn\hadoop-yarn-api\src\main\java\org\apache\hadoop\yarn\api\protocolrecords\FailApplicationAttemptRequest.java,26,5,0,2,0,7
hadoop-trunk\hadoop-trunk\hadoop-hdfs-project\hadoop-hdfs\src\main\java\org\apache\hadoop\hdfs\qjournal\protocolPB\QJournalProtocolTranslatorPB.java,0,103,101,33,0,237
hadoop-trunk\hadoop-trunk\hadoop-hdfs-project\hadoop-hdfs-client\src\main\java\org\apache\hadoop\hdfs\ReaderStrategy.java,0,41,12,1,0,54
hadoop-trunk\hadoop-trunk\hadoop-hdfs-project\hadoop-hdfs-rbf\src\test\java\org\apache\hadoop\hdfs\rbfbalance\TestMountTableProcedure.java,159,20,6,8,0,34
hadoop-trunk\hadoop-trunk\hadoop-yarn-project\hadoop-yarn\hadoop-yarn-server\hadoop-yarn-server-resourcemanager\src\main\java\org\apache\hadoop\yarn\server\resourcemanager\reservation\Plan.java,0,4,2,1,0,7
hadoop-trunk\hadoop-trunk\hadoop-hdfs-project\hadoop-hdfs\src\main\java\org\apache\hadoop\hdfs\server\common\MetricsLoggerTask.java,133,19,12,1,0,32
hadoop-trunk\hadoop-trunk\hadoop-hdfs-project\hadoop-hdfs\src\main\java\org\apache\hadoop\hdfs\server\datanode\SecureDataNodeStarter.java,153,47,3,2,0,52
hadoop-trunk\hadoop-trunk\hadoop-mapreduce-project\hadoop-mapreduce-client\hadoop-mapreduce-client-core\src\main\java\org\apache\hadoop\mapred\CleanupQueue.java,0,28,5,1,0,34
hadoop-trunk\hadoop-trunk\hadoop-yarn-project\hadoop-yarn\hadoop-yarn-common\src\main\java\org\apache\hadoop\yarn\api\protocolrecords\impl\pb\SignalContainerRequestPBImpl.java,0,35,46,3,0,84
hadoop-trunk\hadoop-trunk\hadoop-common-project\hadoop-common\src\main\java\org\apache\hadoop\crypto\UnsupportedCodecException.java,39,9,1,1,0,11
hadoop-trunk\hadoop-trunk\hadoop-mapreduce-project\hadoop-mapreduce-client\hadoop-mapreduce-client-core\src\main\java\org\apache\hadoop\mapred\MRConstants.java,0,38,18,1,0,57
hadoop-trunk\hadoop-trunk\hadoop-tools\hadoop-aws\src\main\java\org\apache\hadoop\fs\s3a\S3AStorageStatistics.java,0,3,0,2,0,5
hadoop-trunk\hadoop-trunk\hadoop-tools\hadoop-aws\src\test\java\org\apache\hadoop\fs\s3a\audit\TestHttpReferrerAuditHeader.java,268,7,4,4,0,15
hadoop-trunk\hadoop-trunk\hadoop-mapreduce-project\hadoop-mapreduce-client\hadoop-mapreduce-client-core\src\main\java\org\apache\hadoop\mapreduce\split\package-info.java,0,1,0,1,0,2
hadoop-trunk\hadoop-trunk\hadoop-tools\hadoop-sls\src\main\java\org\apache\hadoop\yarn\sls\scheduler\RMNodeWrapper.java,200,54,2,2,0,58
hadoop-trunk\hadoop-trunk\hadoop-yarn-project\hadoop-yarn\hadoop-yarn-server\hadoop-yarn-server-resourcemanager\src\main\java\org\apache\hadoop\yarn\server\resourcemanager\webapp\dao\ResourceAllocationInfo.java,42,22,0,2,0,24
hadoop-trunk\hadoop-trunk\hadoop-mapreduce-project\hadoop-mapreduce-client\hadoop-mapreduce-client-common\src\main\java\org\apache\hadoop\mapreduce\v2\api\records\impl\pb\JobIdPBImpl.java,91,28,39,1,0,68
hadoop-trunk\hadoop-trunk\hadoop-yarn-project\hadoop-yarn\hadoop-yarn-server\hadoop-yarn-server-resourcemanager\src\main\java\org\apache\hadoop\yarn\server\resourcemanager\scheduler\SchedContainerChangeRequest.java,94,49,0,1,0,50
hadoop-trunk\hadoop-trunk\hadoop-hdfs-project\hadoop-hdfs\src\main\java\org\apache\hadoop\hdfs\server\datanode\ReplicaInfo.java,0,54,0,1,0,55
hadoop-trunk\hadoop-trunk\hadoop-yarn-project\hadoop-yarn\hadoop-yarn-server\hadoop-yarn-server-resourcemanager\src\main\java\org\apache\hadoop\yarn\server\resourcemanager\scheduler\capacity\conf\QueueAdminConfigurationMutationACLPolicy.java,101,14,3,3,0,20
hadoop-trunk\hadoop-trunk\hadoop-hdfs-project\hadoop-hdfs-rbf\src\main\java\org\apache\hadoop\hdfs\server\federation\store\records\impl\pb\DisabledNameservicePBImpl.java,0,18,44,6,0,68
hadoop-trunk\hadoop-trunk\hadoop-mapreduce-project\hadoop-mapreduce-client\hadoop-mapreduce-client-common\src\main\java\org\apache\hadoop\mapreduce\v2\api\protocolrecords\impl\pb\GetJobReportResponsePBImpl.java,79,34,33,5,0,72
hadoop-trunk\hadoop-trunk\hadoop-yarn-project\hadoop-yarn\hadoop-yarn-server\hadoop-yarn-server-resourcemanager\src\main\java\org\apache\hadoop\yarn\server\resourcemanager\rmnode\RMNodeResourceUpdateEvent.java,15,9,0,2,0,11
hadoop-trunk\hadoop-trunk\hadoop-yarn-project\hadoop-yarn\hadoop-yarn-server\hadoop-yarn-server-resourcemanager\src\main\java\org\apache\hadoop\yarn\server\resourcemanager\scheduler\capacity\CSQueueUtils.java,275,61,9,9,0,79
hadoop-trunk\hadoop-trunk\hadoop-hdfs-project\hadoop-hdfs\src\test\java\org\apache\hadoop\hdfs\server\namenode\top\window\TestRollingWindowManager.java,226,109,9,4,0,122
hadoop-trunk\hadoop-trunk\hadoop-common-project\hadoop-common\src\test\java\org\apache\hadoop\util\TestLimitInputStream.java,44,11,2,1,0,14
hadoop-trunk\hadoop-trunk\hadoop-mapreduce-project\hadoop-mapreduce-client\hadoop-mapreduce-client-common\src\main\java\org\apache\hadoop\mapreduce\v2\security\MRDelegationTokenRenewer.java,80,18,0,3,0,21
hadoop-trunk\hadoop-trunk\hadoop-yarn-project\hadoop-yarn\hadoop-yarn-server\hadoop-yarn-server-resourcemanager\src\main\java\org\apache\hadoop\yarn\server\resourcemanager\scheduler\constraint\PlacementConstraintManager.java,0,2,2,1,0,5
hadoop-trunk\hadoop-trunk\hadoop-hdfs-project\hadoop-hdfs-rbf\src\test\java\org\apache\hadoop\hdfs\server\federation\router\TestRouterMissingFolderMulti.java,126,7,0,7,0,14
hadoop-trunk\hadoop-trunk\hadoop-mapreduce-project\hadoop-mapreduce-client\hadoop-mapreduce-client-app\src\main\java\org\apache\hadoop\mapreduce\v2\app\webapp\JobPage.java,16,3,0,1,0,4
hadoop-trunk\hadoop-trunk\hadoop-mapreduce-project\hadoop-mapreduce-client\hadoop-mapreduce-client-common\src\test\java\org\apache\hadoop\mapreduce\v2\util\TestMRApps.java,490,146,12,24,0,182
hadoop-trunk\hadoop-trunk\hadoop-yarn-project\hadoop-yarn\hadoop-yarn-common\src\main\java\org\apache\hadoop\yarn\util\RackResolver.java,0,17,3,1,0,21
hadoop-trunk\hadoop-trunk\hadoop-yarn-project\hadoop-yarn\hadoop-yarn-applications\hadoop-yarn-services\hadoop-yarn-services-core\src\main\java\org\apache\hadoop\yarn\service\utils\Duration.java,83,21,2,1,0,24
hadoop-trunk\hadoop-trunk\hadoop-common-project\hadoop-registry\src\main\java\org\apache\hadoop\registry\client\impl\zk\CuratorService.java,0,65,3,3,0,71
hadoop-trunk\hadoop-trunk\hadoop-hdfs-project\hadoop-hdfs-rbf\src\main\java\org\apache\hadoop\hdfs\server\federation\store\protocol\NamenodeHeartbeatResponse.java,22,6,0,2,0,8
hadoop-trunk\hadoop-trunk\hadoop-yarn-project\hadoop-yarn\hadoop-yarn-server\hadoop-yarn-server-resourcemanager\src\test\java\org\apache\hadoop\yarn\server\resourcemanager\webapp\TestAppPage.java,51,9,1,3,0,13
hadoop-trunk\hadoop-trunk\hadoop-mapreduce-project\hadoop-mapreduce-client\hadoop-mapreduce-client-hs\src\test\java\org\apache\hadoop\mapreduce\v2\hs\webapp\TestHsWebServicesLogs.java,777,104,3,3,0,110
hadoop-trunk\hadoop-trunk\hadoop-yarn-project\hadoop-yarn\hadoop-yarn-server\hadoop-yarn-server-router\src\main\java\org\apache\hadoop\yarn\server\router\webapp\AppsPage.java,0,2,1,1,0,4
hadoop-trunk\hadoop-trunk\hadoop-yarn-project\hadoop-yarn\hadoop-yarn-server\hadoop-yarn-server-nodemanager\src\test\java\org\apache\hadoop\yarn\server\nodemanager\TestContainerManagerWithLCE.java,55,8,6,3,0,17
hadoop-trunk\hadoop-trunk\hadoop-common-project\hadoop-common\src\test\java\org\apache\hadoop\fs\shell\find\TestIname.java,68,14,2,1,0,17
hadoop-trunk\hadoop-trunk\hadoop-hdfs-project\hadoop-hdfs\src\test\java\org\apache\hadoop\hdfs\server\namenode\ha\TestDNFencingWithReplication.java,111,36,2,1,0,39
hadoop-trunk\hadoop-trunk\hadoop-tools\hadoop-azure\src\main\java\org\apache\hadoop\fs\azurebfs\Abfs.java,13,3,0,2,0,5
hadoop-trunk\hadoop-trunk\hadoop-hdfs-project\hadoop-hdfs\src\test\java\org\apache\hadoop\fs\viewfs\TestViewFsDefaultValue.java,167,52,0,10,0,62
hadoop-trunk\hadoop-trunk\hadoop-yarn-project\hadoop-yarn\hadoop-yarn-server\hadoop-yarn-server-timelineservice-documentstore\src\test\java\org\apache\hadoop\yarn\server\timelineservice\documentstore\JsonUtils.java,0,9,0,3,0,12
hadoop-trunk\hadoop-trunk\hadoop-hdfs-project\hadoop-hdfs-rbf\src\main\java\org\apache\hadoop\hdfs\server\federation\store\protocol\impl\pb\GetDestinationRequestPBImpl.java,0,12,29,5,0,46
hadoop-trunk\hadoop-trunk\hadoop-yarn-project\hadoop-yarn\hadoop-yarn-applications\hadoop-yarn-services\hadoop-yarn-services-core\src\main\java\org\apache\hadoop\yarn\service\conf\RestApiConstants.java,0,29,23,2,0,54
hadoop-trunk\hadoop-trunk\hadoop-hdfs-project\hadoop-hdfs-client\src\test\java\org\apache\hadoop\hdfs\protocol\TestReadOnly.java,75,6,0,1,0,7
hadoop-trunk\hadoop-trunk\hadoop-mapreduce-project\hadoop-mapreduce-client\hadoop-mapreduce-client-jobclient\src\test\java\org\apache\hadoop\fs\slive\DataWriter.java,0,73,3,1,0,77
hadoop-trunk\hadoop-trunk\hadoop-tools\hadoop-openstack\src\main\java\org\apache\hadoop\fs\swift\auth\entities\User.java,100,19,3,1,0,23
hadoop-trunk\hadoop-trunk\hadoop-common-project\hadoop-common\src\main\java\org\apache\hadoop\tracing\SpanContext.java,8,2,3,1,0,6
hadoop-trunk\hadoop-trunk\hadoop-yarn-project\hadoop-yarn\hadoop-yarn-applications\hadoop-yarn-applications-distributedshell\src\test\java\org\apache\hadoop\yarn\applications\distributedshell\TestDSSleepingAppMaster.java,0,7,1,1,0,9
hadoop-trunk\hadoop-trunk\hadoop-common-project\hadoop-common\src\test\java\org\apache\hadoop\fs\TestFsShellList.java,62,9,0,1,0,10
hadoop-trunk\hadoop-trunk\hadoop-tools\hadoop-resourceestimator\src\main\java\org\apache\hadoop\resourceestimator\translator\impl\RmSingleLineParser.java,165,23,1,2,0,26
hadoop-trunk\hadoop-trunk\hadoop-yarn-project\hadoop-yarn\hadoop-yarn-server\hadoop-yarn-server-resourcemanager\src\main\java\org\apache\hadoop\yarn\server\resourcemanager\ClusterMetrics.java,331,191,5,3,0,199
hadoop-trunk\hadoop-trunk\hadoop-hdfs-project\hadoop-hdfs-rbf\src\main\java\org\apache\hadoop\hdfs\server\federation\store\protocol\DisableNameserviceResponse.java,22,5,0,2,0,7
hadoop-trunk\hadoop-trunk\hadoop-mapreduce-project\hadoop-mapreduce-client\hadoop-mapreduce-client-jobclient\src\main\java\org\apache\hadoop\mapred\YARNRunner.java,914,172,17,8,0,197
hadoop-trunk\hadoop-trunk\hadoop-hdfs-project\hadoop-hdfs\src\main\java\org\apache\hadoop\hdfs\server\protocol\DatanodeCommand.java,7,1,0,1,0,2
hadoop-trunk\hadoop-trunk\hadoop-common-project\hadoop-auth\src\main\java\org\apache\hadoop\security\authentication\server\AuthenticationHandler.java,0,17,5,11,0,33
hadoop-trunk\hadoop-trunk\hadoop-mapreduce-project\hadoop-mapreduce-client\hadoop-mapreduce-client-core\src\main\java\org\apache\hadoop\mapred\StatisticsCollector.java,0,84,13,1,0,98
hadoop-trunk\hadoop-trunk\hadoop-mapreduce-project\hadoop-mapreduce-client\hadoop-mapreduce-client-core\src\main\java\org\apache\hadoop\mapreduce\lib\input\DelegatingInputFormat.java,0,14,15,1,0,30
hadoop-trunk\hadoop-trunk\hadoop-yarn-project\hadoop-yarn\hadoop-yarn-server\hadoop-yarn-server-resourcemanager\src\main\java\org\apache\hadoop\yarn\server\resourcemanager\RMContext.java,0,75,3,23,0,101
hadoop-trunk\hadoop-trunk\hadoop-common-project\hadoop-nfs\src\main\java\org\apache\hadoop\nfs\nfs3\request\MKNOD3Request.java,61,27,0,1,0,28
hadoop-trunk\hadoop-trunk\hadoop-hdfs-project\hadoop-hdfs\src\test\java\org\apache\hadoop\hdfs\TestSetrepDecreasing.java,7,6,0,1,0,7
hadoop-trunk\hadoop-trunk\hadoop-mapreduce-project\hadoop-mapreduce-client\hadoop-mapreduce-client-jobclient\src\test\java\org\apache\hadoop\mapreduce\lib\partition\TestMRKeyFieldBasedComparator.java,96,29,5,1,0,35
hadoop-trunk\hadoop-trunk\hadoop-common-project\hadoop-common\src\main\java\org\apache\hadoop\io\compress\zstd\ZStandardCompressor.java,269,54,7,2,0,63
hadoop-trunk\hadoop-trunk\hadoop-common-project\hadoop-common\src\test\java\org\apache\hadoop\test\PlatformAssumptions.java,0,6,0,1,0,7
hadoop-trunk\hadoop-trunk\hadoop-hdfs-project\hadoop-hdfs\src\test\java\org\apache\hadoop\hdfs\server\namenode\startupprogress\TestStartupProgressMetrics.java,86,25,7,2,0,34
hadoop-trunk\hadoop-trunk\hadoop-mapreduce-project\hadoop-mapreduce-client\hadoop-mapreduce-client-app\src\main\java\org\apache\hadoop\mapreduce\v2\app\job\impl\TaskImpl.java,0,249,31,12,0,292
hadoop-trunk\hadoop-trunk\hadoop-tools\hadoop-resourceestimator\src\main\java\org\apache\hadoop\resourceestimator\skylinestore\exceptions\SkylineStoreException.java,8,1,0,1,0,2
hadoop-trunk\hadoop-trunk\hadoop-hdfs-project\hadoop-hdfs\src\test\java\org\apache\hadoop\hdfs\TestStoragePolicyPermissionSettings.java,118,19,4,1,0,24
hadoop-trunk\hadoop-trunk\hadoop-common-project\hadoop-common\src\test\java\org\apache\hadoop\service\launcher\AbstractServiceLauncherTestBase.java,273,45,4,2,0,51
hadoop-trunk\hadoop-trunk\hadoop-hdfs-project\hadoop-hdfs\src\main\java\org\apache\hadoop\hdfs\server\datanode\BPOfferService.java,0,139,23,7,0,169
hadoop-trunk\hadoop-trunk\hadoop-hdfs-project\hadoop-hdfs\src\test\java\org\apache\hadoop\hdfs\TestParallelRead.java,22,4,0,1,0,5
hadoop-trunk\hadoop-trunk\hadoop-mapreduce-project\hadoop-mapreduce-client\hadoop-mapreduce-client-common\src\main\java\org\apache\hadoop\mapreduce\v2\api\protocolrecords\RenewDelegationTokenRequest.java,0,2,0,1,0,3
hadoop-trunk\hadoop-trunk\hadoop-yarn-project\hadoop-yarn\hadoop-yarn-common\src\main\java\org\apache\hadoop\yarn\sharedcache\ChecksumSHA256Impl.java,6,5,0,1,0,6
hadoop-trunk\hadoop-trunk\hadoop-hdfs-project\hadoop-hdfs\src\main\java\org\apache\hadoop\hdfs\server\diskbalancer\planner\PlannerFactory.java,0,6,1,1,0,8
hadoop-trunk\hadoop-trunk\hadoop-hdfs-project\hadoop-hdfs\src\test\java\org\apache\hadoop\hdfs\web\TestHttpsFileSystem.java,64,13,2,2,0,17
hadoop-trunk\hadoop-trunk\hadoop-yarn-project\hadoop-yarn\hadoop-yarn-api\src\main\java\org\apache\hadoop\yarn\api\protocolrecords\ResourceLocalizationResponse.java,11,2,1,1,0,4
hadoop-trunk\hadoop-trunk\hadoop-yarn-project\hadoop-yarn\hadoop-yarn-server\hadoop-yarn-server-resourcemanager\src\test\java\org\apache\hadoop\yarn\server\resourcemanager\scheduler\capacity\conf\TestQueueCapacityConfigParser.java,203,61,0,39,0,100
hadoop-trunk\hadoop-trunk\hadoop-yarn-project\hadoop-yarn\hadoop-yarn-api\src\main\java\org\apache\hadoop\yarn\api\records\ApplicationTimeout.java,64,4,0,1,0,5
hadoop-trunk\hadoop-trunk\hadoop-hdfs-project\hadoop-hdfs-client\src\main\java\org\apache\hadoop\hdfs\protocol\datatransfer\PipelineAck.java,250,100,41,4,0,145
hadoop-trunk\hadoop-trunk\hadoop-yarn-project\hadoop-yarn\hadoop-yarn-server\hadoop-yarn-server-timelineservice\src\test\java\org\apache\hadoop\yarn\server\timelineservice\reader\TestTimelineReaderMetrics.java,28,10,0,2,0,12
hadoop-trunk\hadoop-trunk\hadoop-common-project\hadoop-common\src\main\java\org\apache\hadoop\io\compress\bzip2\package-info.java,0,1,0,1,0,2
hadoop-trunk\hadoop-trunk\hadoop-yarn-project\hadoop-yarn\hadoop-yarn-api\src\main\java\org\apache\hadoop\yarn\api\protocolrecords\FailApplicationAttemptResponse.java,10,3,1,2,0,6
hadoop-trunk\hadoop-trunk\hadoop-yarn-project\hadoop-yarn\hadoop-yarn-server\hadoop-yarn-server-common\src\main\java\org\apache\hadoop\yarn\server\webapp\YarnWebServiceParams.java,0,14,13,1,0,28
hadoop-trunk\hadoop-trunk\hadoop-hdfs-project\hadoop-hdfs-httpfs\src\test\java\org\apache\hadoop\fs\http\server\TestHttpFSWithKerberos.java,235,16,6,2,0,24
hadoop-trunk\hadoop-trunk\hadoop-yarn-project\hadoop-yarn\hadoop-yarn-api\src\main\java\org\apache\hadoop\yarn\api\records\QueueInfo.java,291,89,0,2,0,91
hadoop-trunk\hadoop-trunk\hadoop-common-project\hadoop-common\src\main\java\org\apache\hadoop\fs\FsUrlStreamHandlerFactory.java,70,13,0,1,0,14
hadoop-trunk\hadoop-trunk\hadoop-hdfs-project\hadoop-hdfs-client\src\main\java\org\apache\hadoop\hdfs\util\ByteArrayManager.java,387,63,3,1,0,67
hadoop-trunk\hadoop-trunk\hadoop-yarn-project\hadoop-yarn\hadoop-yarn-api\src\main\java\org\apache\hadoop\yarn\api\records\timeline\TimelineEntities.java,51,15,2,1,0,18
hadoop-trunk\hadoop-trunk\hadoop-yarn-project\hadoop-yarn\hadoop-yarn-server\hadoop-yarn-server-common\src\main\java\org\apache\hadoop\yarn\server\api\impl\pb\service\CollectorNodemanagerProtocolPBServiceImpl.java,44,12,13,11,0,36
hadoop-trunk\hadoop-trunk\hadoop-hdfs-project\hadoop-hdfs\src\main\java\org\apache\hadoop\hdfs\server\namenode\JournalManager.java,109,25,2,1,0,28
hadoop-trunk\hadoop-trunk\hadoop-hdfs-project\hadoop-hdfs\src\test\java\org\apache\hadoop\tools\TestJMXGet.java,122,35,14,8,0,57
hadoop-trunk\hadoop-trunk\hadoop-hdfs-project\hadoop-hdfs-rbf\src\test\java\org\apache\hadoop\fs\contract\router\web\TestRouterWebHDFSContractConcat.java,0,5,0,1,0,6
hadoop-trunk\hadoop-trunk\hadoop-tools\hadoop-azure\src\main\java\org\apache\hadoop\fs\azurebfs\services\AbfsPerfTracker.java,0,85,26,26,0,137
hadoop-trunk\hadoop-trunk\hadoop-yarn-project\hadoop-yarn\hadoop-yarn-server\hadoop-yarn-server-timelineservice-hbase\hadoop-yarn-server-timelineservice-hbase-common\src\main\java\org\apache\hadoop\yarn\server\timelineservice\storage\common\GenericConverter.java,0,5,0,1,0,6
hadoop-trunk\hadoop-trunk\hadoop-tools\hadoop-rumen\src\main\java\org\apache\hadoop\tools\rumen\Outputter.java,0,5,2,1,0,8
hadoop-trunk\hadoop-trunk\hadoop-common-project\hadoop-common\src\main\java\org\apache\hadoop\fs\shell\find\FindOptions.java,243,23,0,1,0,24
hadoop-trunk\hadoop-trunk\hadoop-common-project\hadoop-common\src\main\java\org\apache\hadoop\io\file\tfile\MetaBlockDoesNotExist.java,12,5,1,1,0,7
hadoop-trunk\hadoop-trunk\hadoop-yarn-project\hadoop-yarn\hadoop-yarn-server\hadoop-yarn-server-nodemanager\src\main\java\org\apache\hadoop\yarn\server\nodemanager\webapp\dao\NodeInfo.java,128,75,1,1,0,77
hadoop-trunk\hadoop-trunk\hadoop-common-project\hadoop-common\src\test\java\org\apache\hadoop\io\TestSecureIOUtils.java,115,19,10,1,0,30
hadoop-trunk\hadoop-trunk\hadoop-hdfs-project\hadoop-hdfs\src\test\java\org\apache\hadoop\hdfs\server\namenode\TestFSEditLogLoader.java,772,156,19,4,0,179
hadoop-trunk\hadoop-trunk\hadoop-mapreduce-project\hadoop-mapreduce-client\hadoop-mapreduce-client-jobclient\src\test\java\org\apache\hadoop\mapreduce\TestMapCollection.java,496,271,22,2,0,295
hadoop-trunk\hadoop-trunk\hadoop-yarn-project\hadoop-yarn\hadoop-yarn-server\hadoop-yarn-server-resourcemanager\src\main\java\org\apache\hadoop\yarn\server\resourcemanager\CuratorBasedElectorService.java,0,20,4,1,0,25
hadoop-trunk\hadoop-trunk\hadoop-yarn-project\hadoop-yarn\hadoop-yarn-server\hadoop-yarn-server-resourcemanager\src\test\java\org\apache\hadoop\yarn\server\resourcemanager\metrics\TestCombinedSystemMetricsPublisher.java,0,52,18,8,0,78
hadoop-trunk\hadoop-trunk\hadoop-tools\hadoop-resourceestimator\src\main\java\org\apache\hadoop\resourceestimator\solver\impl\package-info.java,0,1,0,1,0,2
hadoop-trunk\hadoop-trunk\hadoop-yarn-project\hadoop-yarn\hadoop-yarn-common\src\main\java\org\apache\hadoop\yarn\api\protocolrecords\impl\pb\ReleaseSharedCacheResourceResponsePBImpl.java,30,12,18,3,0,33
hadoop-trunk\hadoop-trunk\hadoop-common-project\hadoop-registry\src\main\java\org\apache\hadoop\registry\client\exceptions\InvalidRecordException.java,13,7,0,1,0,8
hadoop-trunk\hadoop-trunk\hadoop-yarn-project\hadoop-yarn\hadoop-yarn-api\src\main\java\org\apache\hadoop\yarn\server\api\AuxiliaryLocalPathHandler.java,0,0,0,1,0,1
hadoop-trunk\hadoop-trunk\hadoop-tools\hadoop-azure\src\test\java\org\apache\hadoop\fs\azurebfs\utils\ServiceSASGenerator.java,70,18,1,4,0,23
hadoop-trunk\hadoop-trunk\hadoop-mapreduce-project\hadoop-mapreduce-client\hadoop-mapreduce-client-app\src\main\java\org\apache\hadoop\mapreduce\v2\app\job\event\JobEvent.java,15,7,0,1,0,8
hadoop-trunk\hadoop-trunk\hadoop-mapreduce-project\hadoop-mapreduce-client\hadoop-mapreduce-client-app\src\main\java\org\apache\hadoop\mapreduce\v2\app\rm\ContainerAllocator.java,0,6,0,2,0,8
hadoop-trunk\hadoop-trunk\hadoop-yarn-project\hadoop-yarn\hadoop-yarn-server\hadoop-yarn-server-nodemanager\src\test\java\org\apache\hadoop\yarn\server\nodemanager\containermanager\resourceplugin\deviceframework\FakeTestDevicePlugin2.java,4,0,0,2,0,2
hadoop-trunk\hadoop-trunk\hadoop-tools\hadoop-aliyun\src\test\java\org\apache\hadoop\fs\aliyun\oss\fileContext\TestOSSFileContextUtil.java,10,1,1,1,0,3
hadoop-trunk\hadoop-trunk\hadoop-hdfs-project\hadoop-hdfs\src\main\java\org\apache\hadoop\hdfs\server\namenode\FSDirTruncateOp.java,0,46,5,3,0,54
hadoop-trunk\hadoop-trunk\hadoop-hdfs-project\hadoop-hdfs\src\test\java\org\apache\hadoop\hdfs\server\namenode\top\window\TestRollingWindow.java,63,24,2,1,0,27
hadoop-trunk\hadoop-trunk\hadoop-hdfs-project\hadoop-hdfs\src\test\java\org\apache\hadoop\fs\contract\hdfs\TestHDFSContractMultipartUploader.java,40,8,0,1,0,9
hadoop-trunk\hadoop-trunk\hadoop-tools\hadoop-azure\src\main\java\org\apache\hadoop\fs\azurebfs\contracts\exceptions\InvalidUriException.java,0,2,0,1,0,3
hadoop-trunk\hadoop-trunk\hadoop-yarn-project\hadoop-yarn\hadoop-yarn-server\hadoop-yarn-server-resourcemanager\src\main\java\org\apache\hadoop\yarn\server\resourcemanager\scheduler\capacity\CapacitySchedulerConfiguration.java,2876,822,78,62,0,962
hadoop-trunk\hadoop-trunk\hadoop-yarn-project\hadoop-yarn\hadoop-yarn-server\hadoop-yarn-server-nodemanager\src\test\java\org\apache\hadoop\yarn\server\nodemanager\logaggregation\tracker\TestNMLogAggregationStatusTracker.java,110,14,2,2,0,18
hadoop-trunk\hadoop-trunk\hadoop-common-project\hadoop-common\src\main\java\org\apache\hadoop\ha\ServiceFailedException.java,12,5,0,1,0,6
hadoop-trunk\hadoop-trunk\hadoop-common-project\hadoop-common\src\test\java\org\apache\hadoop\fs\contract\localfs\TestLocalFSContractOpen.java,8,2,0,1,0,3
hadoop-trunk\hadoop-trunk\hadoop-tools\hadoop-azure\src\main\java\org\apache\hadoop\fs\azurebfs\contracts\exceptions\ConcurrentWriteOperationDetectedException.java,0,2,0,1,0,3
hadoop-trunk\hadoop-trunk\hadoop-yarn-project\hadoop-yarn\hadoop-yarn-server\hadoop-yarn-server-nodemanager\src\main\java\org\apache\hadoop\yarn\server\nodemanager\containermanager\linux\resources\numa\NumaResourceHandlerImpl.java,84,21,6,7,0,34
hadoop-trunk\hadoop-trunk\hadoop-tools\hadoop-rumen\src\main\java\org\apache\hadoop\tools\rumen\ParsedConfigFile.java,0,44,6,1,0,51
hadoop-trunk\hadoop-trunk\hadoop-mapreduce-project\hadoop-mapreduce-client\hadoop-mapreduce-client-core\src\main\java\org\apache\hadoop\mapred\RecordReader.java,0,21,1,2,0,24
hadoop-trunk\hadoop-trunk\hadoop-tools\hadoop-azure\src\test\java\org\apache\hadoop\fs\azurebfs\services\TestAbfsClient.java,0,39,7,26,0,72
hadoop-trunk\hadoop-trunk\hadoop-mapreduce-project\hadoop-mapreduce-client\hadoop-mapreduce-client-common\src\main\java\org\apache\hadoop\mapreduce\v2\api\protocolrecords\KillTaskAttemptRequest.java,0,7,2,1,0,10
hadoop-trunk\hadoop-trunk\hadoop-mapreduce-project\hadoop-mapreduce-client\hadoop-mapreduce-client-hs\src\test\java\org\apache\hadoop\mapreduce\v2\hs\MockHistoryContext.java,80,52,1,6,0,59
hadoop-trunk\hadoop-trunk\hadoop-tools\hadoop-rumen\src\test\java\org\apache\hadoop\tools\rumen\HistogramRawTestData.java,0,12,0,1,0,13
hadoop-trunk\hadoop-trunk\hadoop-yarn-project\hadoop-yarn\hadoop-yarn-common\src\main\java\org\apache\hadoop\yarn\nodelabels\NonAppendableFSNodeLabelStore.java,79,13,3,1,0,17
hadoop-trunk\hadoop-trunk\hadoop-common-project\hadoop-common\src\main\java\org\apache\hadoop\metrics2\sink\ganglia\GangliaSink31.java,76,17,2,2,0,21
hadoop-trunk\hadoop-trunk\hadoop-yarn-project\hadoop-yarn\hadoop-yarn-server\hadoop-yarn-server-nodemanager\src\test\java\org\apache\hadoop\yarn\server\nodemanager\TestDefaultContainerExecutor.java,0,75,28,13,0,116
hadoop-trunk\hadoop-trunk\hadoop-yarn-project\hadoop-yarn\hadoop-yarn-server\hadoop-yarn-server-resourcemanager\src\main\java\org\apache\hadoop\yarn\server\resourcemanager\rmapp\RMAppState.java,0,11,0,1,0,12
hadoop-trunk\hadoop-trunk\hadoop-common-project\hadoop-common\src\main\java\org\apache\hadoop\ha\HAServiceProtocolHelper.java,41,13,5,1,0,19
hadoop-trunk\hadoop-trunk\hadoop-common-project\hadoop-common\src\main\java\org\apache\hadoop\io\file\tfile\Utils.java,0,123,23,23,0,169
hadoop-trunk\hadoop-trunk\hadoop-mapreduce-project\hadoop-mapreduce-client\hadoop-mapreduce-client-core\src\main\java\org\apache\hadoop\mapreduce\security\TokenCache.java,225,86,5,2,0,93
hadoop-trunk\hadoop-trunk\hadoop-common-project\hadoop-auth\src\main\java\org\apache\hadoop\security\authentication\server\JWTRedirectAuthenticationHandler.java,286,24,8,1,0,33
hadoop-trunk\hadoop-trunk\hadoop-yarn-project\hadoop-yarn\hadoop-yarn-server\hadoop-yarn-server-resourcemanager\src\test\java\org\apache\hadoop\yarn\server\resourcemanager\webapp\TestRMWebServicesApps.java,0,210,53,13,0,276
hadoop-trunk\hadoop-trunk\hadoop-hdfs-project\hadoop-hdfs-client\src\main\java\org\apache\hadoop\hdfs\protocol\DatanodeInfoWithStorage.java,42,17,2,1,0,20
hadoop-trunk\hadoop-trunk\hadoop-common-project\hadoop-common\src\test\java\org\apache\hadoop\service\launcher\testservices\RunningService.java,60,19,0,1,0,20
hadoop-trunk\hadoop-trunk\hadoop-hdfs-project\hadoop-hdfs\src\main\java\org\apache\hadoop\hdfs\tools\offlineImageViewer\PBImageCorruptionDetector.java,292,50,10,1,0,61
hadoop-trunk\hadoop-trunk\hadoop-hdfs-project\hadoop-hdfs\src\test\java\org\apache\hadoop\hdfs\server\datanode\SimpleBlocksMovementsStatusHandler.java,0,3,1,1,0,5
hadoop-trunk\hadoop-trunk\hadoop-mapreduce-project\hadoop-mapreduce-client\hadoop-mapreduce-client-core\src\main\java\org\apache\hadoop\mapreduce\lib\join\OverrideRecordReader.java,0,27,1,2,0,30
hadoop-trunk\hadoop-trunk\hadoop-yarn-project\hadoop-yarn\hadoop-yarn-server\hadoop-yarn-server-resourcemanager\src\test\java\org\apache\hadoop\yarn\server\resourcemanager\webapp\helper\ResourceRequestsXmlVerifications.java,169,30,1,3,0,34
hadoop-trunk\hadoop-trunk\hadoop-yarn-project\hadoop-yarn\hadoop-yarn-common\src\main\java\org\apache\hadoop\yarn\server\metrics\ApplicationMetricsConstants.java,101,34,0,1,0,35
hadoop-trunk\hadoop-trunk\hadoop-tools\hadoop-dynamometer\hadoop-dynamometer-workload\src\main\java\org\apache\hadoop\tools\dynamometer\workloadgenerator\audit\AuditCommandParser.java,0,0,0,1,0,1
hadoop-trunk\hadoop-trunk\hadoop-mapreduce-project\hadoop-mapreduce-client\hadoop-mapreduce-client-core\src\main\java\org\apache\hadoop\mapreduce\lib\output\committer\manifest\ManifestCommitterConfig.java,0,34,1,12,0,47
hadoop-trunk\hadoop-trunk\hadoop-mapreduce-project\hadoop-mapreduce-client\hadoop-mapreduce-client-core\src\main\java\org\apache\hadoop\mapred\lib\aggregate\ValueAggregatorCombiner.java,0,26,7,2,0,35
hadoop-trunk\hadoop-trunk\hadoop-yarn-project\hadoop-yarn\hadoop-yarn-applications\hadoop-yarn-applications-mawo\hadoop-yarn-applications-mawo-core\src\main\java\org\apache\hadoop\applications\mawo\server\common\WorkAssignmentProtocol.java,0,0,0,1,0,1
hadoop-trunk\hadoop-trunk\hadoop-yarn-project\hadoop-yarn\hadoop-yarn-server\hadoop-yarn-server-resourcemanager\src\test\java\org\apache\hadoop\yarn\server\resourcemanager\scheduler\fair\policies\TestEmptyQueues.java,29,9,0,2,0,11
hadoop-trunk\hadoop-trunk\hadoop-yarn-project\hadoop-yarn\hadoop-yarn-api\src\main\java\org\apache\hadoop\yarn\api\records\ApplicationId.java,122,35,7,1,0,43
hadoop-trunk\hadoop-trunk\hadoop-yarn-project\hadoop-yarn\hadoop-yarn-server\hadoop-yarn-server-resourcemanager\src\test\java\org\apache\hadoop\yarn\server\resourcemanager\scheduler\fair\TestFSAppStarvation.java,224,28,3,2,0,33
hadoop-trunk\hadoop-trunk\hadoop-hdfs-project\hadoop-hdfs-rbf\src\main\java\org\apache\hadoop\hdfs\server\federation\store\protocol\impl\pb\UpdateNamenodeRegistrationRequestPBImpl.java,0,17,40,5,0,62
hadoop-trunk\hadoop-trunk\hadoop-yarn-project\hadoop-yarn\hadoop-yarn-server\hadoop-yarn-server-common\src\main\java\org\apache\hadoop\yarn\server\federation\store\impl\ZookeeperFederationStateStore.java,545,55,14,39,0,108
hadoop-trunk\hadoop-trunk\hadoop-tools\hadoop-rumen\src\main\java\org\apache\hadoop\tools\rumen\HadoopLogsAnalyzer.java,1783,226,30,19,0,275
hadoop-trunk\hadoop-trunk\hadoop-hdfs-project\hadoop-hdfs-client\src\main\java\org\apache\hadoop\hdfs\web\resources\SnapshotDiffIndexParam.java,30,2,0,1,0,3
hadoop-trunk\hadoop-trunk\hadoop-common-project\hadoop-common\src\test\java\org\apache\hadoop\fs\TestFcLocalFsUtil.java,0,0,0,1,0,1
hadoop-trunk\hadoop-trunk\hadoop-yarn-project\hadoop-yarn\hadoop-yarn-server\hadoop-yarn-server-resourcemanager\src\main\java\org\apache\hadoop\yarn\server\resourcemanager\scheduler\policy\RecoveryComparator.java,9,3,0,1,0,4
hadoop-trunk\hadoop-trunk\hadoop-yarn-project\hadoop-yarn\hadoop-yarn-server\hadoop-yarn-server-nodemanager\src\main\java\org\apache\hadoop\yarn\server\nodemanager\containermanager\resourceplugin\fpga\FpgaResourcePlugin.java,78,19,2,12,0,33
hadoop-trunk\hadoop-trunk\hadoop-yarn-project\hadoop-yarn\hadoop-yarn-server\hadoop-yarn-server-resourcemanager\src\main\java\org\apache\hadoop\yarn\server\resourcemanager\scheduler\capacity\allocator\RegularContainerAllocator.java,886,130,13,27,0,170
hadoop-trunk\hadoop-trunk\hadoop-yarn-project\hadoop-yarn\hadoop-yarn-server\hadoop-yarn-server-common\src\main\java\org\apache\hadoop\yarn\server\webapp\LogWebServiceUtils.java,0,36,5,2,0,43
hadoop-trunk\hadoop-trunk\hadoop-common-project\hadoop-common\src\test\java\org\apache\hadoop\fs\contract\AbstractContractAppendTest.java,133,26,2,4,0,32
hadoop-trunk\hadoop-trunk\hadoop-mapreduce-project\hadoop-mapreduce-client\hadoop-mapreduce-client-app\src\test\java\org\apache\hadoop\mapreduce\jobhistory\TestEvents.java,382,55,16,9,0,80
hadoop-trunk\hadoop-trunk\hadoop-mapreduce-project\hadoop-mapreduce-client\hadoop-mapreduce-client-hs\src\main\java\org\apache\hadoop\mapreduce\v2\hs\JobHistory.java,362,83,5,5,0,93
hadoop-trunk\hadoop-trunk\hadoop-yarn-project\hadoop-yarn\hadoop-yarn-common\src\main\java\org\apache\hadoop\yarn\metrics\GenericEventTypeMetrics.java,0,63,10,1,0,74
hadoop-trunk\hadoop-trunk\hadoop-mapreduce-project\hadoop-mapreduce-client\hadoop-mapreduce-client-jobclient\src\test\java\org\apache\hadoop\fs\slive\DummyInputFormat.java,0,11,3,1,0,15
hadoop-trunk\hadoop-trunk\hadoop-yarn-project\hadoop-yarn\hadoop-yarn-server\hadoop-yarn-server-resourcemanager\src\main\java\org\apache\hadoop\yarn\server\resourcemanager\reservation\CapacitySchedulerPlanFollower.java,101,35,3,9,0,47
hadoop-trunk\hadoop-trunk\hadoop-common-project\hadoop-common\src\test\java\org\apache\hadoop\cli\util\RegexpComparator.java,19,9,0,1,0,10
hadoop-trunk\hadoop-trunk\hadoop-yarn-project\hadoop-yarn\hadoop-yarn-server\hadoop-yarn-server-nodemanager\src\main\java\org\apache\hadoop\yarn\server\nodemanager\webapp\dao\AuxiliaryServiceInfo.java,30,17,0,1,0,18
hadoop-trunk\hadoop-trunk\hadoop-mapreduce-project\hadoop-mapreduce-client\hadoop-mapreduce-client-jobclient\src\test\java\org\apache\hadoop\hdfs\TestNNBench.java,71,16,0,1,0,17
hadoop-trunk\hadoop-trunk\hadoop-common-project\hadoop-common\src\main\java\org\apache\hadoop\fs\statistics\StreamStatisticNames.java,0,1,0,1,0,2
hadoop-trunk\hadoop-trunk\hadoop-hdfs-project\hadoop-hdfs\src\main\java\org\apache\hadoop\hdfs\server\datanode\fsdataset\impl\RamDiskReplicaTracker.java,239,70,11,2,0,83
hadoop-trunk\hadoop-trunk\hadoop-mapreduce-project\hadoop-mapreduce-client\hadoop-mapreduce-client-hs\src\main\java\org\apache\hadoop\mapreduce\v2\hs\CompletedTask.java,135,29,0,2,0,31
hadoop-trunk\hadoop-trunk\hadoop-common-project\hadoop-common\src\main\java\org\apache\hadoop\util\functional\FunctionRaisingIOE.java,0,0,0,1,0,1
hadoop-trunk\hadoop-trunk\hadoop-hdfs-project\hadoop-hdfs\src\main\java\org\apache\hadoop\hdfs\server\sps\package-info.java,0,1,0,1,0,2
hadoop-trunk\hadoop-trunk\hadoop-hdfs-project\hadoop-hdfs\src\test\java\org\apache\hadoop\hdfs\server\namenode\metrics\TestNNMetricFilesInGetListingOps.java,0,36,0,4,0,40
hadoop-trunk\hadoop-trunk\hadoop-mapreduce-project\hadoop-mapreduce-client\hadoop-mapreduce-client-nativetask\src\test\java\org\apache\hadoop\mapred\nativetask\buffer\TestBufferPushPull.java,233,64,7,7,0,78
hadoop-trunk\hadoop-trunk\hadoop-yarn-project\hadoop-yarn\hadoop-yarn-server\hadoop-yarn-server-common\src\main\java\org\apache\hadoop\yarn\server\federation\store\records\GetApplicationsHomeSubClusterResponse.java,35,2,0,1,0,3
hadoop-trunk\hadoop-trunk\hadoop-yarn-project\hadoop-yarn\hadoop-yarn-server\hadoop-yarn-server-nodemanager\src\main\java\org\apache\hadoop\yarn\server\nodemanager\webapp\dao\gpu\GpuDeviceInformation.java,38,16,0,1,0,17
hadoop-trunk\hadoop-trunk\hadoop-yarn-project\hadoop-yarn\hadoop-yarn-applications\hadoop-yarn-applications-mawo\hadoop-yarn-applications-mawo-core\src\main\java\org\apache\hadoop\applications\mawo\server\common\Task.java,0,0,0,1,0,1
hadoop-trunk\hadoop-trunk\hadoop-yarn-project\hadoop-yarn\hadoop-yarn-server\hadoop-yarn-server-resourcemanager\src\main\java\org\apache\hadoop\yarn\server\resourcemanager\recovery\records\ApplicationAttemptStateData.java,264,47,2,3,0,52
hadoop-trunk\hadoop-trunk\hadoop-hdfs-project\hadoop-hdfs\src\test\java\org\apache\hadoop\hdfs\server\datanode\TestNNHandlesCombinedBlockReport.java,11,5,1,2,0,8
hadoop-trunk\hadoop-trunk\hadoop-hdfs-project\hadoop-hdfs-rbf\src\main\java\org\apache\hadoop\hdfs\server\federation\router\RouterMetricsService.java,107,6,0,1,0,7
hadoop-trunk\hadoop-trunk\hadoop-hdfs-project\hadoop-hdfs-httpfs\src\main\java\org\apache\hadoop\lib\server\ServiceException.java,17,2,0,1,0,3
hadoop-trunk\hadoop-trunk\hadoop-yarn-project\hadoop-yarn\hadoop-yarn-server\hadoop-yarn-server-resourcemanager\src\main\java\org\apache\hadoop\yarn\server\resourcemanager\scheduler\AbstractUsersManager.java,0,0,0,1,0,1
hadoop-trunk\hadoop-trunk\hadoop-common-project\hadoop-common\src\main\java\org\apache\hadoop\security\alias\CredentialProviderFactory.java,72,15,0,5,0,20
hadoop-trunk\hadoop-trunk\hadoop-tools\hadoop-azure\src\main\java\org\apache\hadoop\fs\azurebfs\utils\UriUtils.java,0,26,0,11,0,37
hadoop-trunk\hadoop-trunk\hadoop-mapreduce-project\hadoop-mapreduce-client\hadoop-mapreduce-client-nativetask\src\main\java\org\apache\hadoop\mapred\nativetask\util\ConfigUtil.java,19,5,1,1,0,7
hadoop-trunk\hadoop-trunk\hadoop-common-project\hadoop-nfs\src\main\java\org\apache\hadoop\portmap\Portmap.java,0,22,4,3,0,29
hadoop-trunk\hadoop-trunk\hadoop-yarn-project\hadoop-yarn\hadoop-yarn-server\hadoop-yarn-server-common\src\test\java\org\apache\hadoop\yarn\server\webapp\TestAppsBlock.java,44,4,3,1,0,8
hadoop-trunk\hadoop-trunk\hadoop-common-project\hadoop-common\src\main\java\org\apache\hadoop\io\compress\zlib\ZlibCompressor.java,451,155,14,3,0,172
hadoop-trunk\hadoop-trunk\hadoop-yarn-project\hadoop-yarn\hadoop-yarn-server\hadoop-yarn-server-nodemanager\src\main\java\org\apache\hadoop\yarn\server\nodemanager\api\protocolrecords\impl\pb\LocalResourceStatusPBImpl.java,0,55,76,7,0,138
hadoop-trunk\hadoop-trunk\hadoop-yarn-project\hadoop-yarn\hadoop-yarn-server\hadoop-yarn-server-resourcemanager\src\main\java\org\apache\hadoop\yarn\server\resourcemanager\rmcontainer\ContainerAllocationExpirer.java,26,11,0,2,0,13
hadoop-trunk\hadoop-trunk\hadoop-mapreduce-project\hadoop-mapreduce-client\hadoop-mapreduce-client-core\src\main\java\org\apache\hadoop\mapreduce\jobhistory\JobInitedEvent.java,62,38,22,1,0,61
hadoop-trunk\hadoop-trunk\hadoop-tools\hadoop-aws\src\test\java\org\apache\hadoop\mapreduce\MockJob.java,77,19,0,1,0,20
hadoop-trunk\hadoop-trunk\hadoop-tools\hadoop-azure\src\main\java\org\apache\hadoop\fs\azure\AzureNativeFileSystemStore.java,3007,446,44,124,0,614
hadoop-trunk\hadoop-trunk\hadoop-hdfs-project\hadoop-hdfs\src\test\java\org\apache\hadoop\hdfs\tools\offlineImageViewer\TestOfflineImageViewerForContentSummary.java,204,28,3,1,0,32
hadoop-trunk\hadoop-trunk\hadoop-common-project\hadoop-common\src\main\java\org\apache\hadoop\util\ShutdownHookManager.java,0,46,6,4,0,56
hadoop-trunk\hadoop-trunk\hadoop-tools\hadoop-aliyun\src\main\java\org\apache\hadoop\fs\aliyun\oss\FileStatusAcceptor.java,0,15,0,2,0,17
hadoop-trunk\hadoop-trunk\hadoop-hdfs-project\hadoop-hdfs\src\test\java\org\apache\hadoop\hdfs\server\namenode\ha\TestHAConfiguration.java,127,16,14,6,0,36
hadoop-trunk\hadoop-trunk\hadoop-mapreduce-project\hadoop-mapreduce-client\hadoop-mapreduce-client-core\src\test\java\org\apache\hadoop\mapred\TestClock.java,12,15,1,1,0,17
hadoop-trunk\hadoop-trunk\hadoop-mapreduce-project\hadoop-mapreduce-client\hadoop-mapreduce-client-core\src\main\java\org\apache\hadoop\mapreduce\jobhistory\TaskStartedEvent.java,59,30,18,1,0,49
hadoop-trunk\hadoop-trunk\hadoop-yarn-project\hadoop-yarn\hadoop-yarn-server\hadoop-yarn-server-resourcemanager\src\main\java\org\apache\hadoop\yarn\server\resourcemanager\placement\CSMappingPlacementRule.java,491,77,20,8,0,105
hadoop-trunk\hadoop-trunk\hadoop-common-project\hadoop-common\src\main\java\org\apache\hadoop\io\compress\CompressorStream.java,92,38,5,2,0,45
hadoop-trunk\hadoop-trunk\hadoop-mapreduce-project\hadoop-mapreduce-client\hadoop-mapreduce-client-app\src\test\java\org\apache\hadoop\mapreduce\v2\app\job\impl\TestTaskImpl.java,821,274,15,5,0,294
hadoop-trunk\hadoop-trunk\hadoop-hdfs-project\hadoop-hdfs-rbf\src\main\java\org\apache\hadoop\hdfs\server\federation\resolver\RemoteLocation.java,77,14,0,1,0,15
hadoop-trunk\hadoop-trunk\hadoop-hdfs-project\hadoop-hdfs\src\test\java\org\apache\hadoop\hdfs\TestReconstructStripedFileWithRandomECPolicy.java,22,4,1,1,0,6
hadoop-trunk\hadoop-trunk\hadoop-common-project\hadoop-common\src\test\java\org\apache\hadoop\fs\statistics\TestIOStatisticsSnapshot.java,110,10,5,2,0,17
hadoop-trunk\hadoop-trunk\hadoop-mapreduce-project\hadoop-mapreduce-client\hadoop-mapreduce-client-core\src\main\java\org\apache\hadoop\mapreduce\filecache\DistributedCache.java,360,60,9,7,0,76
hadoop-trunk\hadoop-trunk\hadoop-mapreduce-project\hadoop-mapreduce-client\hadoop-mapreduce-client-jobclient\src\test\java\org\apache\hadoop\mapreduce\GrowingSleepJob.java,39,19,2,1,0,22
hadoop-trunk\hadoop-trunk\hadoop-tools\hadoop-sls\src\main\java\org\apache\hadoop\yarn\sls\SLSRunner.java,452,132,17,14,0,163
hadoop-trunk\hadoop-trunk\hadoop-tools\hadoop-aws\src\test\java\org\apache\hadoop\fs\s3a\ITestS3AEncryptionSSES3.java,18,2,0,1,0,3
hadoop-trunk\hadoop-trunk\hadoop-yarn-project\hadoop-yarn\hadoop-yarn-api\src\main\java\org\apache\hadoop\yarn\api\protocolrecords\ReservationListResponse.java,38,2,0,1,0,3
hadoop-trunk\hadoop-trunk\hadoop-yarn-project\hadoop-yarn\hadoop-yarn-applications\hadoop-yarn-applications-catalog\hadoop-yarn-applications-catalog-webapp\src\main\java\org\apache\hadoop\yarn\appcatalog\application\YarnServiceClient.java,152,27,2,1,0,30
hadoop-trunk\hadoop-trunk\hadoop-yarn-project\hadoop-yarn\hadoop-yarn-server\hadoop-yarn-server-resourcemanager\src\test\java\org\apache\hadoop\yarn\server\resourcemanager\scheduler\fair\TestFSLeafQueue.java,298,59,4,7,0,70
hadoop-trunk\hadoop-trunk\hadoop-mapreduce-project\hadoop-mapreduce-client\hadoop-mapreduce-client-core\src\main\java\org\apache\hadoop\mapred\join\ResetableIterator.java,0,4,2,1,0,7
hadoop-trunk\hadoop-trunk\hadoop-yarn-project\hadoop-yarn\hadoop-yarn-server\hadoop-yarn-server-router\src\test\java\org\apache\hadoop\yarn\server\router\TestRouterMetrics.java,368,45,0,4,0,49
hadoop-trunk\hadoop-trunk\hadoop-common-project\hadoop-common\src\test\java\org\apache\hadoop\io\file\tfile\TestTFileStreams.java,398,116,57,2,0,175
hadoop-trunk\hadoop-trunk\hadoop-hdfs-project\hadoop-hdfs-client\src\test\java\org\apache\hadoop\hdfs\TestPeerCache.java,0,64,20,1,0,85
hadoop-trunk\hadoop-trunk\hadoop-common-project\hadoop-common\src\test\java\org\apache\hadoop\io\erasurecode\rawcoder\TestCoderUtil.java,95,31,2,1,0,34
hadoop-trunk\hadoop-trunk\hadoop-common-project\hadoop-nfs\src\main\java\org\apache\hadoop\nfs\nfs3\FileHandle.java,155,83,2,1,0,86
hadoop-trunk\hadoop-trunk\hadoop-tools\hadoop-aws\src\main\java\org\apache\hadoop\fs\s3a\auth\AbstractAWSCredentialProvider.java,0,5,1,1,0,7
hadoop-trunk\hadoop-trunk\hadoop-yarn-project\hadoop-yarn\hadoop-yarn-server\hadoop-yarn-server-resourcemanager\src\main\java\org\apache\hadoop\yarn\server\resourcemanager\scheduler\placement\package-info.java,0,0,0,1,0,1
hadoop-trunk\hadoop-trunk\hadoop-mapreduce-project\hadoop-mapreduce-client\hadoop-mapreduce-client-hs\src\main\java\org\apache\hadoop\mapreduce\v2\hs\UnparsedJob.java,0,59,1,1,0,61
hadoop-trunk\hadoop-trunk\hadoop-tools\hadoop-aws\src\test\java\org\apache\hadoop\fs\s3a\scale\ITestS3ADeleteFilesOneByOne.java,11,1,0,1,0,2
hadoop-trunk\hadoop-trunk\hadoop-mapreduce-project\hadoop-mapreduce-client\hadoop-mapreduce-client-jobclient\src\test\java\org\apache\hadoop\mapred\lib\aggregate\AggregatorTests.java,65,19,1,2,0,22
hadoop-trunk\hadoop-trunk\hadoop-hdfs-project\hadoop-hdfs-client\src\main\java\org\apache\hadoop\hdfs\protocol\ClientProtocol.java,0,69,1,4,0,74
hadoop-trunk\hadoop-trunk\hadoop-tools\hadoop-streaming\src\main\java\org\apache\hadoop\typedbytes\TypedBytesRecordOutput.java,108,74,18,1,0,93
hadoop-trunk\hadoop-trunk\hadoop-common-project\hadoop-common\src\main\java\org\apache\hadoop\fs\permission\package-info.java,0,0,0,1,0,1
hadoop-trunk\hadoop-trunk\hadoop-yarn-project\hadoop-yarn\hadoop-yarn-common\src\main\java\org\apache\hadoop\yarn\api\records\impl\pb\NodeLabelPBImpl.java,84,30,35,1,0,66
hadoop-trunk\hadoop-trunk\hadoop-yarn-project\hadoop-yarn\hadoop-yarn-server\hadoop-yarn-server-resourcemanager\src\main\java\org\apache\hadoop\yarn\server\resourcemanager\scheduler\constraint\PlacementConstraintManagerService.java,0,10,5,1,0,16
hadoop-trunk\hadoop-trunk\hadoop-yarn-project\hadoop-yarn\hadoop-yarn-server\hadoop-yarn-server-resourcemanager\src\main\java\org\apache\hadoop\yarn\server\resourcemanager\scheduler\fair\FSOpDurations.java,71,27,2,1,0,30
hadoop-trunk\hadoop-trunk\hadoop-hdfs-project\hadoop-hdfs\src\test\java\org\apache\hadoop\hdfs\server\namenode\ha\TestSeveralNameNodes.java,143,26,4,2,0,32
hadoop-trunk\hadoop-trunk\hadoop-hdfs-project\hadoop-hdfs\src\main\java\org\apache\hadoop\hdfs\protocolPB\JournalProtocolTranslatorPB.java,0,25,15,5,0,45
hadoop-trunk\hadoop-trunk\hadoop-common-project\hadoop-common\src\test\java\org\apache\hadoop\fs\sftp\TestSFTPFileSystem.java,338,41,28,1,0,70
hadoop-trunk\hadoop-trunk\hadoop-tools\hadoop-rumen\src\main\java\org\apache\hadoop\tools\rumen\LoggedSingleRelativeRanking.java,70,33,1,1,0,35
hadoop-trunk\hadoop-trunk\hadoop-common-project\hadoop-common\src\main\java\org\apache\hadoop\fs\PositionedReadable.java,0,3,0,1,0,4
hadoop-trunk\hadoop-trunk\hadoop-yarn-project\hadoop-yarn\hadoop-yarn-server\hadoop-yarn-server-nodemanager\src\main\java\org\apache\hadoop\yarn\server\nodemanager\CMgrSignalContainersEvent.java,14,7,0,2,0,9
hadoop-trunk\hadoop-trunk\hadoop-tools\hadoop-aws\src\main\java\org\apache\hadoop\fs\s3a\auth\IAMInstanceCredentialsProvider.java,0,5,2,3,0,10
hadoop-trunk\hadoop-trunk\hadoop-mapreduce-project\hadoop-mapreduce-client\hadoop-mapreduce-client-hs\src\main\java\org\apache\hadoop\mapreduce\v2\hs\webapp\HsController.java,202,39,10,4,0,53
hadoop-trunk\hadoop-trunk\hadoop-cloud-storage-project\hadoop-cos\src\main\java\org\apache\hadoop\fs\cosn\ByteBufferInputStream.java,62,13,1,1,0,15
hadoop-trunk\hadoop-trunk\hadoop-common-project\hadoop-common\src\main\java\org\apache\hadoop\crypto\key\KeyProviderFactory.java,65,12,0,1,0,13
hadoop-trunk\hadoop-trunk\hadoop-mapreduce-project\hadoop-mapreduce-client\hadoop-mapreduce-client-jobclient\src\test\java\org\apache\hadoop\fs\slive\SliveMapper.java,0,31,1,1,0,33
hadoop-trunk\hadoop-trunk\hadoop-yarn-project\hadoop-yarn\hadoop-yarn-api\src\main\java\org\apache\hadoop\yarn\api\protocolrecords\ValidateVolumeCapabilitiesResponse.java,22,7,0,1,0,8
hadoop-trunk\hadoop-trunk\hadoop-yarn-project\hadoop-yarn\hadoop-yarn-server\hadoop-yarn-server-nodemanager\src\main\java\org\apache\hadoop\yarn\server\nodemanager\containermanager\localizer\event\LocalizationEvent.java,8,4,0,3,0,7
hadoop-trunk\hadoop-trunk\hadoop-yarn-project\hadoop-yarn\hadoop-yarn-server\hadoop-yarn-server-resourcemanager\src\main\java\org\apache\hadoop\yarn\server\resourcemanager\webapp\DefaultSchedulerPage.java,0,42,1,11,0,54
hadoop-trunk\hadoop-trunk\hadoop-mapreduce-project\hadoop-mapreduce-client\hadoop-mapreduce-client-core\src\test\java\org\apache\hadoop\mapred\TestTaskProgressReporter.java,293,85,13,2,0,100
hadoop-trunk\hadoop-trunk\hadoop-hdfs-project\hadoop-hdfs-rbf\src\test\java\org\apache\hadoop\fs\contract\router\TestRouterHDFSContractMkdirSecure.java,0,4,0,1,0,5
hadoop-trunk\hadoop-trunk\hadoop-common-project\hadoop-common\src\main\java\org\apache\hadoop\service\ServiceStateChangeListener.java,0,0,0,1,0,1
hadoop-trunk\hadoop-trunk\hadoop-mapreduce-project\hadoop-mapreduce-client\hadoop-mapreduce-client-core\src\main\java\org\apache\hadoop\mapred\lib\db\DBWritable.java,0,3,0,1,0,4
hadoop-trunk\hadoop-trunk\hadoop-common-project\hadoop-common\src\main\java\org\apache\hadoop\io\erasurecode\rawcoder\ByteArrayDecodingState.java,0,32,1,1,0,34
hadoop-trunk\hadoop-trunk\hadoop-hdfs-project\hadoop-hdfs\src\main\java\org\apache\hadoop\hdfs\server\namenode\AclTransformation.java,0,45,3,15,0,63
hadoop-trunk\hadoop-trunk\hadoop-mapreduce-project\hadoop-mapreduce-client\hadoop-mapreduce-client-hs\src\main\java\org\apache\hadoop\mapreduce\v2\hs\HistoryServerLeveldbStateStoreService.java,317,41,10,1,0,52
hadoop-trunk\hadoop-trunk\hadoop-mapreduce-project\hadoop-mapreduce-client\hadoop-mapreduce-client-core\src\main\java\org\apache\hadoop\mapreduce\tools\CLI.java,741,167,15,3,0,185
hadoop-trunk\hadoop-trunk\hadoop-common-project\hadoop-auth\src\test\java\org\apache\hadoop\security\authentication\util\TestJaasConfiguration.java,36,2,0,1,0,3
hadoop-trunk\hadoop-trunk\hadoop-yarn-project\hadoop-yarn\hadoop-yarn-server\hadoop-yarn-server-common\src\main\java\org\apache\hadoop\yarn\server\federation\store\exception\FederationStateStoreRetriableException.java,18,7,0,1,0,8
hadoop-trunk\hadoop-trunk\hadoop-yarn-project\hadoop-yarn\hadoop-yarn-common\src\main\java\org\apache\hadoop\yarn\security\client\BaseClientToAMTokenSecretManager.java,33,6,0,1,0,7
hadoop-trunk\hadoop-trunk\hadoop-tools\hadoop-extras\src\main\java\org\apache\hadoop\tools\DistCh.java,456,143,29,3,0,175
hadoop-trunk\hadoop-trunk\hadoop-common-project\hadoop-common\src\main\java\org\apache\hadoop\util\JvmPauseMonitor.java,187,55,4,3,0,62
hadoop-trunk\hadoop-trunk\hadoop-yarn-project\hadoop-yarn\hadoop-yarn-api\src\main\java\org\apache\hadoop\yarn\api\protocolrecords\StopContainersResponse.java,49,11,0,1,0,12
hadoop-trunk\hadoop-trunk\hadoop-tools\hadoop-streaming\src\test\java\org\apache\hadoop\streaming\StderrApp.java,0,32,3,5,0,40
hadoop-trunk\hadoop-trunk\hadoop-common-project\hadoop-common\src\main\java\org\apache\hadoop\metrics2\lib\UniqueNames.java,36,16,1,1,0,18
hadoop-trunk\hadoop-trunk\hadoop-hdfs-project\hadoop-hdfs\src\main\java\org\apache\hadoop\hdfs\tools\AdminHelper.java,186,35,6,2,0,43
hadoop-trunk\hadoop-trunk\hadoop-hdfs-project\hadoop-hdfs\src\main\java\org\apache\hadoop\hdfs\server\datanode\DataSetLockManager.java,264,66,10,9,0,85
hadoop-trunk\hadoop-trunk\hadoop-tools\hadoop-gridmix\src\main\java\org\apache\hadoop\mapred\gridmix\emulators\resourceusage\CumulativeCpuUsageEmulatorPlugin.java,0,138,7,1,0,146
hadoop-trunk\hadoop-trunk\hadoop-yarn-project\hadoop-yarn\hadoop-yarn-csi\src\main\java\org\apache\hadoop\yarn\csi\adaptor\CsiAdaptorProtocolService.java,0,18,1,3,0,22
hadoop-trunk\hadoop-trunk\hadoop-mapreduce-project\hadoop-mapreduce-client\hadoop-mapreduce-client-core\src\test\java\org\apache\hadoop\mapred\TestFileOutputCommitter.java,584,96,45,2,0,143
hadoop-trunk\hadoop-trunk\hadoop-hdfs-project\hadoop-hdfs-nfs\src\main\java\org\apache\hadoop\hdfs\nfs\nfs3\AsyncDataService.java,109,19,3,1,0,23
hadoop-trunk\hadoop-trunk\hadoop-hdfs-project\hadoop-hdfs-rbf\src\main\java\org\apache\hadoop\hdfs\server\federation\store\protocol\impl\pb\FederationProtocolPBTranslator.java,0,8,1,1,0,10
hadoop-trunk\hadoop-trunk\hadoop-yarn-project\hadoop-yarn\hadoop-yarn-server\hadoop-yarn-server-resourcemanager\src\main\java\org\apache\hadoop\yarn\server\resourcemanager\webapp\dao\SchedulerInfo.java,54,22,5,5,0,32
hadoop-trunk\hadoop-trunk\hadoop-yarn-project\hadoop-yarn\hadoop-yarn-api\src\main\java\org\apache\hadoop\yarn\api\resource\PlacementConstraint.java,888,214,3,1,0,218
hadoop-trunk\hadoop-trunk\hadoop-mapreduce-project\hadoop-mapreduce-examples\src\main\java\org\apache\hadoop\examples\AggregateWordHistogram.java,46,15,2,1,0,18
hadoop-trunk\hadoop-trunk\hadoop-hdfs-project\hadoop-hdfs\src\main\java\org\apache\hadoop\hdfs\tools\StoragePolicyAdmin.java,304,36,0,1,0,37
hadoop-trunk\hadoop-trunk\hadoop-yarn-project\hadoop-yarn\hadoop-yarn-server\hadoop-yarn-server-common\src\main\java\org\apache\hadoop\yarn\server\webapp\BasicAppInfo.java,0,7,0,1,0,8
hadoop-trunk\hadoop-trunk\hadoop-common-project\hadoop-common\src\main\java\org\apache\hadoop\fs\shell\find\Expression.java,0,15,11,1,0,27
hadoop-trunk\hadoop-trunk\hadoop-hdfs-project\hadoop-hdfs\src\test\java\org\apache\hadoop\hdfs\server\namenode\ha\TestEditLogTailer.java,431,83,11,1,0,95
hadoop-trunk\hadoop-trunk\hadoop-yarn-project\hadoop-yarn\hadoop-yarn-server\hadoop-yarn-server-common\src\main\java\org\apache\hadoop\yarn\server\federation\failover\FederationRMFailoverProxyProvider.java,0,26,4,4,0,34
hadoop-trunk\hadoop-trunk\hadoop-tools\hadoop-dynamometer\hadoop-dynamometer-workload\src\main\java\org\apache\hadoop\tools\dynamometer\workloadgenerator\audit\AuditReplayMapper.java,0,71,7,3,0,81
hadoop-trunk\hadoop-trunk\hadoop-hdfs-project\hadoop-hdfs\src\main\java\org\apache\hadoop\hdfs\server\datanode\LocalReplicaInPipeline.java,0,102,14,1,0,117
hadoop-trunk\hadoop-trunk\hadoop-mapreduce-project\hadoop-mapreduce-client\hadoop-mapreduce-client-core\src\main\java\org\apache\hadoop\mapreduce\lib\chain\ChainMapContextImpl.java,0,22,7,1,0,30
hadoop-trunk\hadoop-trunk\hadoop-hdfs-project\hadoop-hdfs\src\test\java\org\apache\hadoop\hdfs\server\blockmanagement\TestBlockUnderConstructionFeature.java,53,30,3,8,0,41
hadoop-trunk\hadoop-trunk\hadoop-common-project\hadoop-common\src\main\java\org\apache\hadoop\security\ssl\ReloadingX509TrustManager.java,0,24,3,4,0,31
hadoop-trunk\hadoop-trunk\hadoop-hdfs-project\hadoop-hdfs-rbf\src\main\java\org\apache\hadoop\hdfs\server\federation\store\driver\impl\StateStoreZooKeeperImpl.java,280,33,6,3,0,42
hadoop-trunk\hadoop-trunk\hadoop-yarn-project\hadoop-yarn\hadoop-yarn-server\hadoop-yarn-server-common\src\main\java\org\apache\hadoop\yarn\server\federation\resolver\AbstractSubClusterResolver.java,37,10,0,1,0,11
hadoop-trunk\hadoop-trunk\hadoop-common-project\hadoop-common\src\test\java\org\apache\hadoop\http\TestIsActiveServlet.java,51,7,0,1,0,8
hadoop-trunk\hadoop-trunk\hadoop-common-project\hadoop-kms\src\main\java\org\apache\hadoop\crypto\key\kms\server\KMSAuthenticationFilter.java,0,31,3,7,0,41
hadoop-trunk\hadoop-trunk\hadoop-tools\hadoop-aws\src\test\java\org\apache\hadoop\fs\contract\s3a\ITestS3AContractDistCp.java,54,8,1,2,0,11
hadoop-trunk\hadoop-trunk\hadoop-yarn-project\hadoop-yarn\hadoop-yarn-common\src\test\java\org\apache\hadoop\yarn\TestContainerLaunchRPC.java,181,44,5,7,0,56
hadoop-trunk\hadoop-trunk\hadoop-yarn-project\hadoop-yarn\hadoop-yarn-server\hadoop-yarn-server-nodemanager\src\main\java\org\apache\hadoop\yarn\server\nodemanager\containermanager\resourceplugin\deviceframework\AssignedDevice.java,0,14,1,2,0,17
hadoop-trunk\hadoop-trunk\hadoop-yarn-project\hadoop-yarn\hadoop-yarn-server\hadoop-yarn-server-timelineservice-documentstore\src\main\java\org\apache\hadoop\yarn\server\timelineservice\documentstore\DocumentStoreTimelineWriterImpl.java,0,52,6,9,0,67
hadoop-trunk\hadoop-trunk\hadoop-yarn-project\hadoop-yarn\hadoop-yarn-applications\hadoop-yarn-services\hadoop-yarn-services-core\src\main\java\org\apache\hadoop\yarn\service\api\records\ContainerState.java,0,8,0,1,0,9
hadoop-trunk\hadoop-trunk\hadoop-yarn-project\hadoop-yarn\hadoop-yarn-server\hadoop-yarn-server-resourcemanager\src\main\java\org\apache\hadoop\yarn\server\resourcemanager\reservation\exceptions\ResourceOverCommitException.java,18,8,0,1,0,9
hadoop-trunk\hadoop-trunk\hadoop-yarn-project\hadoop-yarn\hadoop-yarn-client\src\main\java\org\apache\hadoop\yarn\client\api\impl\ContainerManagementProtocolProxy.java,226,64,3,2,0,69
hadoop-trunk\hadoop-trunk\hadoop-mapreduce-project\hadoop-mapreduce-client\hadoop-mapreduce-client-jobclient\src\test\java\org\apache\hadoop\mapreduce\lib\join\TestWrappedRRClassloader.java,60,19,6,1,0,26
hadoop-trunk\hadoop-trunk\hadoop-tools\hadoop-openstack\src\main\java\org\apache\hadoop\fs\swift\auth\AuthenticationWrapper.java,22,3,0,1,0,4
hadoop-trunk\hadoop-trunk\hadoop-hdfs-project\hadoop-hdfs\src\test\java\org\apache\hadoop\hdfs\TestFileAppend4.java,0,83,8,3,0,94
hadoop-trunk\hadoop-trunk\hadoop-yarn-project\hadoop-yarn\hadoop-yarn-server\hadoop-yarn-server-nodemanager\src\test\java\org\apache\hadoop\yarn\server\nodemanager\amrmproxy\MockRequestInterceptor.java,34,11,2,5,0,18
hadoop-trunk\hadoop-trunk\hadoop-common-project\hadoop-common\src\test\java\org\apache\hadoop\io\retry\UnreliableImplementation.java,0,44,10,3,0,57
hadoop-trunk\hadoop-trunk\hadoop-tools\hadoop-azure\src\main\java\org\apache\hadoop\fs\azure\BlobMaterialization.java,0,0,0,1,0,1
hadoop-trunk\hadoop-trunk\hadoop-tools\hadoop-azure\src\main\java\org\apache\hadoop\fs\azure\ClientThrottlingIntercept.java,0,13,5,1,0,19
hadoop-trunk\hadoop-trunk\hadoop-common-project\hadoop-common\src\test\java\org\apache\hadoop\security\TestLdapGroupsMapping.java,412,39,5,5,0,49
hadoop-trunk\hadoop-trunk\hadoop-maven-plugins\src\main\java\org\apache\hadoop\maven\plugin\util\FileSetUtils.java,34,7,2,3,0,12
hadoop-trunk\hadoop-trunk\hadoop-hdfs-project\hadoop-hdfs-client\src\main\java\org\apache\hadoop\hdfs\protocol\CacheDirectiveInfo.java,323,47,1,1,0,49
hadoop-trunk\hadoop-trunk\hadoop-mapreduce-project\hadoop-mapreduce-client\hadoop-mapreduce-client-nativetask\src\main\java\org\apache\hadoop\mapred\nativetask\util\SizedWritable.java,29,13,0,1,0,14
hadoop-trunk\hadoop-trunk\hadoop-hdfs-project\hadoop-hdfs\src\test\java\org\apache\hadoop\hdfs\LogVerificationAppender.java,47,10,1,1,0,12
hadoop-trunk\hadoop-trunk\hadoop-yarn-project\hadoop-yarn\hadoop-yarn-server\hadoop-yarn-server-resourcemanager\src\main\java\org\apache\hadoop\yarn\server\resourcemanager\placement\csmappingrule\MappingRuleConditionalVariables.java,101,12,0,2,0,14
hadoop-trunk\hadoop-trunk\hadoop-tools\hadoop-azure-datalake\src\main\java\org\apache\hadoop\fs\adl\AdlFsOutputStream.java,0,13,0,1,0,14
hadoop-trunk\hadoop-trunk\hadoop-tools\hadoop-openstack\src\main\java\org\apache\hadoop\fs\swift\snative\SwiftNativeFileSystemStore.java,922,112,8,19,0,139
hadoop-trunk\hadoop-trunk\hadoop-yarn-project\hadoop-yarn\hadoop-yarn-server\hadoop-yarn-server-nodemanager\src\main\java\org\apache\hadoop\yarn\server\nodemanager\NodeManagerEventType.java,0,2,0,1,0,3
hadoop-trunk\hadoop-trunk\hadoop-common-project\hadoop-common\src\main\java\org\apache\hadoop\ipc\VersionedProtocol.java,0,5,2,1,0,8
hadoop-trunk\hadoop-trunk\hadoop-tools\hadoop-streaming\src\test\java\org\apache\hadoop\streaming\UniqApp.java,0,15,4,1,0,20
hadoop-trunk\hadoop-trunk\hadoop-yarn-project\hadoop-yarn\hadoop-yarn-server\hadoop-yarn-server-resourcemanager\src\main\java\org\apache\hadoop\yarn\server\resourcemanager\scheduler\capacity\AutoCreatedQueueTemplate.java,190,27,4,6,0,37
hadoop-trunk\hadoop-trunk\hadoop-common-project\hadoop-common\src\main\java\org\apache\hadoop\fs\statistics\impl\EmptyIOStatistics.java,0,0,0,1,0,1
hadoop-trunk\hadoop-trunk\hadoop-yarn-project\hadoop-yarn\hadoop-yarn-server\hadoop-yarn-server-applicationhistoryservice\src\main\java\org\apache\hadoop\yarn\server\applicationhistoryservice\records\impl\pb\ApplicationAttemptStartDataPBImpl.java,176,41,58,5,0,104
hadoop-trunk\hadoop-trunk\hadoop-hdfs-project\hadoop-hdfs-rbf\src\main\java\org\apache\hadoop\hdfs\server\federation\store\protocol\RefreshSuperUserGroupsConfigurationRequest.java,8,2,0,2,0,4
hadoop-trunk\hadoop-trunk\hadoop-hdfs-project\hadoop-hdfs\src\main\java\org\apache\hadoop\hdfs\tools\offlineEditsViewer\OfflineEditsVisitor.java,0,9,5,1,0,15
hadoop-trunk\hadoop-trunk\hadoop-hdfs-project\hadoop-hdfs\src\test\java\org\apache\hadoop\cli\TestCryptoAdminCLI.java,123,25,1,1,0,27
hadoop-trunk\hadoop-trunk\hadoop-hdfs-project\hadoop-hdfs-rbf\src\main\java\org\apache\hadoop\hdfs\server\federation\router\RemoteMethod.java,199,13,2,1,0,16
hadoop-trunk\hadoop-trunk\hadoop-tools\hadoop-azure\src\main\java\org\apache\hadoop\fs\azure\AzureFileSystemThreadTask.java,0,1,0,1,0,2
hadoop-trunk\hadoop-trunk\hadoop-mapreduce-project\hadoop-mapreduce-client\hadoop-mapreduce-client-core\src\test\java\org\apache\hadoop\mapred\TestLocatedFileStatusFetcher.java,78,12,1,1,0,14
hadoop-trunk\hadoop-trunk\hadoop-hdfs-project\hadoop-hdfs-rbf\src\main\java\org\apache\hadoop\hdfs\server\federation\router\RouterQuotaUsage.java,0,19,0,1,0,20
hadoop-trunk\hadoop-trunk\hadoop-yarn-project\hadoop-yarn\hadoop-yarn-server\hadoop-yarn-server-timelineservice\src\main\java\org\apache\hadoop\yarn\server\timelineservice\collector\NodeTimelineCollectorManager.java,410,66,19,6,0,91
hadoop-trunk\hadoop-trunk\hadoop-hdfs-project\hadoop-hdfs-rbf\src\main\java\org\apache\hadoop\hdfs\server\federation\resolver\order\DestinationOrder.java,0,6,0,1,0,7
hadoop-trunk\hadoop-trunk\hadoop-yarn-project\hadoop-yarn\hadoop-yarn-common\src\main\java\org\apache\hadoop\yarn\webapp\util\WebAppUtils.java,568,145,8,8,0,161
hadoop-trunk\hadoop-trunk\hadoop-mapreduce-project\hadoop-mapreduce-client\hadoop-mapreduce-client-jobclient\src\test\java\org\apache\hadoop\fs\slive\TruncateOp.java,0,24,6,1,0,31
hadoop-trunk\hadoop-trunk\hadoop-mapreduce-project\hadoop-mapreduce-client\hadoop-mapreduce-client-core\src\main\java\org\apache\hadoop\mapred\lib\db\DBInputFormat.java,0,88,4,8,0,100
hadoop-trunk\hadoop-trunk\hadoop-yarn-project\hadoop-yarn\hadoop-yarn-server\hadoop-yarn-server-resourcemanager\src\main\java\org\apache\hadoop\yarn\server\resourcemanager\preprocessor\SubmissionContextPreProcessor.java,178,26,8,1,0,35
hadoop-trunk\hadoop-trunk\hadoop-common-project\hadoop-common\src\main\java\org\apache\hadoop\fs\statistics\DurationStatisticSummary.java,0,23,0,2,0,25
hadoop-trunk\hadoop-trunk\hadoop-yarn-project\hadoop-yarn\hadoop-yarn-server\hadoop-yarn-server-resourcemanager\src\main\java\org\apache\hadoop\yarn\server\resourcemanager\scheduler\placement\MultiNodePolicySpec.java,35,21,0,1,0,22
hadoop-trunk\hadoop-trunk\hadoop-hdfs-project\hadoop-hdfs\src\test\java\org\apache\hadoop\hdfs\tools\TestDFSAdmin.java,1058,110,42,13,0,165
hadoop-trunk\hadoop-trunk\hadoop-tools\hadoop-aws\src\test\java\org\apache\hadoop\fs\s3a\auth\ITestJceksIO.java,137,17,4,5,0,26
hadoop-trunk\hadoop-trunk\hadoop-hdfs-project\hadoop-hdfs-rbf\src\test\java\org\apache\hadoop\hdfs\server\federation\router\TestDisableNameservices.java,184,13,2,7,0,22
hadoop-trunk\hadoop-trunk\hadoop-common-project\hadoop-common\src\main\java\org\apache\hadoop\metrics2\sink\package-info.java,0,2,0,1,0,3
hadoop-trunk\hadoop-trunk\hadoop-yarn-project\hadoop-yarn\hadoop-yarn-server\hadoop-yarn-server-sharedcachemanager\src\test\java\org\apache\hadoop\yarn\server\sharedcachemanager\store\TestInMemorySCMStore.java,264,27,2,8,0,37
hadoop-trunk\hadoop-trunk\hadoop-yarn-project\hadoop-yarn\hadoop-yarn-server\hadoop-yarn-server-nodemanager\src\test\java\org\apache\hadoop\yarn\server\nodemanager\containermanager\resourceplugin\com\nec\TestNECVEPlugin.java,384,54,0,3,0,57
hadoop-trunk\hadoop-trunk\hadoop-common-project\hadoop-auth\src\test\java\org\apache\hadoop\security\authentication\util\TestRolloverSignerSecretProvider.java,62,11,0,1,0,12
hadoop-trunk\hadoop-trunk\hadoop-yarn-project\hadoop-yarn\hadoop-yarn-server\hadoop-yarn-server-resourcemanager\src\test\java\org\apache\hadoop\yarn\server\resourcemanager\placement\TestUserGroupMappingPlacementRule.java,695,75,2,12,0,89
hadoop-trunk\hadoop-trunk\hadoop-tools\hadoop-rumen\src\main\java\org\apache\hadoop\tools\rumen\PossiblyDecompressedInputStream.java,0,8,0,1,0,9
hadoop-trunk\hadoop-trunk\hadoop-hdfs-project\hadoop-hdfs\src\test\java\org\apache\hadoop\hdfs\server\namenode\TestValidateConfigurationSettings.java,112,21,0,3,0,24
hadoop-trunk\hadoop-trunk\hadoop-yarn-project\hadoop-yarn\hadoop-yarn-server\hadoop-yarn-server-router\src\test\java\org\apache\hadoop\yarn\server\router\webapp\PassThroughRESTRequestInterceptor.java,0,173,0,14,0,187
hadoop-trunk\hadoop-trunk\hadoop-hdfs-project\hadoop-hdfs\src\test\java\org\apache\hadoop\fs\viewfs\TestViewFileSystemOverloadSchemeWithHdfsScheme.java,660,50,23,3,0,76
hadoop-trunk\hadoop-trunk\hadoop-yarn-project\hadoop-yarn\hadoop-yarn-server\hadoop-yarn-server-nodemanager\src\main\java\org\apache\hadoop\yarn\server\nodemanager\api\LocalizationProtocol.java,0,3,1,3,0,7
hadoop-trunk\hadoop-trunk\hadoop-yarn-project\hadoop-yarn\hadoop-yarn-server\hadoop-yarn-server-resourcemanager\src\main\java\org\apache\hadoop\yarn\server\resourcemanager\ResourceManagerMXBean.java,0,0,0,1,0,1
hadoop-trunk\hadoop-trunk\hadoop-hdfs-project\hadoop-hdfs\src\test\java\org\apache\hadoop\hdfs\server\datanode\TestDatanodeRegister.java,0,29,2,4,0,35
hadoop-trunk\hadoop-trunk\hadoop-tools\hadoop-aws\src\test\java\org\apache\hadoop\fs\s3a\performance\ITestS3ADeleteCost.java,231,9,6,1,0,16
hadoop-trunk\hadoop-trunk\hadoop-tools\hadoop-streaming\src\main\java\org\apache\hadoop\record\Utils.java,0,280,17,1,0,298
hadoop-trunk\hadoop-trunk\hadoop-yarn-project\hadoop-yarn\hadoop-yarn-api\src\main\java\org\apache\hadoop\yarn\api\protocolrecords\UpdateApplicationTimeoutsResponse.java,27,1,1,1,0,3
hadoop-trunk\hadoop-trunk\hadoop-hdfs-project\hadoop-hdfs\src\main\java\org\apache\hadoop\hdfs\server\datanode\erasurecode\StripedBlockReader.java,0,31,4,1,0,36
hadoop-trunk\hadoop-trunk\hadoop-hdfs-project\hadoop-hdfs-client\src\main\java\org\apache\hadoop\hdfs\protocol\CorruptFileBlocks.java,50,17,0,1,0,18
hadoop-trunk\hadoop-trunk\hadoop-hdfs-project\hadoop-hdfs\src\test\java\org\apache\hadoop\hdfs\util\TestReferenceCountMap.java,88,14,0,1,0,15
hadoop-trunk\hadoop-trunk\hadoop-hdfs-project\hadoop-hdfs-client\src\main\java\org\apache\hadoop\hdfs\web\resources\ShortParam.java,0,8,0,1,0,9
hadoop-trunk\hadoop-trunk\hadoop-hdfs-project\hadoop-hdfs-client\src\main\java\org\apache\hadoop\hdfs\protocol\CachePoolIterator.java,0,11,0,1,0,12
hadoop-trunk\hadoop-trunk\hadoop-hdfs-project\hadoop-hdfs-client\src\test\java\org\apache\hadoop\hdfs\protocol\TestErasureCodingPolicyInfo.java,41,2,0,2,0,4
hadoop-trunk\hadoop-trunk\hadoop-common-project\hadoop-common\src\test\java\org\apache\hadoop\fs\viewfs\ViewFileSystemTestSetup.java,97,56,5,7,0,68
hadoop-trunk\hadoop-trunk\hadoop-common-project\hadoop-common\src\test\java\org\apache\hadoop\fs\contract\rawlocal\TestRawlocalContractGetFileStatus.java,9,2,0,1,0,3
hadoop-trunk\hadoop-trunk\hadoop-hdfs-project\hadoop-hdfs\src\main\java\org\apache\hadoop\hdfs\server\datanode\metrics\DataNodeMetricHelper.java,54,11,3,1,0,15
hadoop-trunk\hadoop-trunk\hadoop-tools\hadoop-azure\src\main\java\org\apache\hadoop\fs\azurebfs\contracts\exceptions\package-info.java,0,2,0,1,0,3
hadoop-trunk\hadoop-trunk\hadoop-tools\hadoop-resourceestimator\src\main\java\org\apache\hadoop\resourceestimator\translator\impl\package-info.java,0,1,0,1,0,2
hadoop-trunk\hadoop-trunk\hadoop-tools\hadoop-aliyun\src\test\java\org\apache\hadoop\fs\aliyun\oss\fileContext\TestOSSFileContextStatistics.java,36,7,1,1,0,9
hadoop-trunk\hadoop-trunk\hadoop-yarn-project\hadoop-yarn\hadoop-yarn-server\hadoop-yarn-server-resourcemanager\src\test\java\org\apache\hadoop\yarn\server\resourcemanager\scheduler\capacity\TestCapacitySchedulerOvercommit.java,24,6,0,3,0,9
hadoop-trunk\hadoop-trunk\hadoop-tools\hadoop-distcp\src\test\java\org\apache\hadoop\tools\mapred\TestCopyCommitter.java,643,68,35,13,0,116
hadoop-trunk\hadoop-trunk\hadoop-tools\hadoop-aws\src\main\java\org\apache\hadoop\fs\s3a\auth\RoleModel.java,357,61,2,2,0,65
hadoop-trunk\hadoop-trunk\hadoop-hdfs-project\hadoop-hdfs\src\test\java\org\apache\hadoop\hdfs\server\datanode\TestDataNodeHotSwapVolumes.java,1062,175,33,3,0,211
hadoop-trunk\hadoop-trunk\hadoop-hdfs-project\hadoop-hdfs-client\src\main\java\org\apache\hadoop\hdfs\security\token\block\InvalidBlockTokenException.java,12,3,0,1,0,4
hadoop-trunk\hadoop-trunk\hadoop-hdfs-project\hadoop-hdfs-rbf\src\main\java\org\apache\hadoop\hdfs\server\federation\resolver\FederationNamenodeContext.java,0,0,0,1,0,1
hadoop-trunk\hadoop-trunk\hadoop-yarn-project\hadoop-yarn\hadoop-yarn-server\hadoop-yarn-server-resourcemanager\src\main\java\org\apache\hadoop\yarn\server\resourcemanager\scheduler\capacity\allocator\AllocationState.java,0,7,0,2,0,9
hadoop-trunk\hadoop-trunk\hadoop-yarn-project\hadoop-yarn\hadoop-yarn-api\src\main\java\org\apache\hadoop\yarn\api\protocolrecords\SubmitApplicationResponse.java,10,4,1,1,0,6
hadoop-trunk\hadoop-trunk\hadoop-yarn-project\hadoop-yarn\hadoop-yarn-applications\hadoop-yarn-services\hadoop-yarn-services-core\src\test\java\org\apache\hadoop\yarn\service\component\TestComponentRestartPolicy.java,102,10,12,1,0,23
hadoop-trunk\hadoop-trunk\hadoop-mapreduce-project\hadoop-mapreduce-client\hadoop-mapreduce-client-core\src\main\java\org\apache\hadoop\mapred\OutputFormat.java,0,11,0,1,0,12
hadoop-trunk\hadoop-trunk\hadoop-hdfs-project\hadoop-hdfs\src\main\java\org\apache\hadoop\hdfs\server\common\StorageInfo.java,237,113,4,3,0,120
hadoop-trunk\hadoop-trunk\hadoop-mapreduce-project\hadoop-mapreduce-client\hadoop-mapreduce-client-app\src\main\java\org\apache\hadoop\mapred\ReduceTaskAttemptImpl.java,30,18,0,2,0,20
hadoop-trunk\hadoop-trunk\hadoop-yarn-project\hadoop-yarn\hadoop-yarn-server\hadoop-yarn-server-common\src\main\java\org\apache\hadoop\yarn\server\federation\utils\FederationRegistryClient.java,291,33,14,1,0,48
hadoop-trunk\hadoop-trunk\hadoop-hdfs-project\hadoop-hdfs\src\main\java\org\apache\hadoop\hdfs\qjournal\protocolPB\InterQJournalProtocolTranslatorPB.java,0,16,10,3,0,29
hadoop-trunk\hadoop-trunk\hadoop-yarn-project\hadoop-yarn\hadoop-yarn-common\src\main\java\org\apache\hadoop\yarn\api\records\impl\pb\ReservationDefinitionPBImpl.java,210,42,64,2,0,108
hadoop-trunk\hadoop-trunk\hadoop-yarn-project\hadoop-yarn\hadoop-yarn-server\hadoop-yarn-server-common\src\test\java\org\apache\hadoop\yarn\server\federation\policies\BaseFederationPoliciesTest.java,139,59,0,7,0,66
hadoop-trunk\hadoop-trunk\hadoop-tools\hadoop-azure\src\test\java\org\apache\hadoop\fs\azurebfs\extensions\WrappingTokenProvider.java,73,18,3,3,0,24
hadoop-trunk\hadoop-trunk\hadoop-yarn-project\hadoop-yarn\hadoop-yarn-common\src\main\java\org\apache\hadoop\yarn\security\DockerCredentialTokenIdentifier.java,127,13,20,2,0,35
hadoop-trunk\hadoop-trunk\hadoop-tools\hadoop-azure\src\test\java\org\apache\hadoop\fs\azurebfs\commit\ITestAbfsManifestCommitProtocol.java,31,6,0,3,0,9
hadoop-trunk\hadoop-trunk\hadoop-yarn-project\hadoop-yarn\hadoop-yarn-server\hadoop-yarn-server-nodemanager\src\main\java\org\apache\hadoop\yarn\server\nodemanager\containermanager\localizer\security\LocalizerTokenSecretManager.java,26,9,1,2,0,12
hadoop-trunk\hadoop-trunk\hadoop-yarn-project\hadoop-yarn\hadoop-yarn-server\hadoop-yarn-server-nodemanager\src\main\java\org\apache\hadoop\yarn\server\nodemanager\webapp\dao\NMResourceInfo.java,3,0,0,1,0,1
hadoop-trunk\hadoop-trunk\hadoop-yarn-project\hadoop-yarn\hadoop-yarn-server\hadoop-yarn-server-resourcemanager\src\test\java\org\apache\hadoop\yarn\server\resourcemanager\webapp\TestRMWebServicesForCSWithPartitions.java,669,226,19,14,0,259
hadoop-trunk\hadoop-trunk\hadoop-common-project\hadoop-common\src\main\java\org\apache\hadoop\ipc\ProtobufRpcEngineCallback2.java,0,5,2,1,0,8
hadoop-trunk\hadoop-trunk\hadoop-common-project\hadoop-common\src\test\java\org\apache\hadoop\fs\TestChecksumFs.java,99,17,4,1,0,22
hadoop-trunk\hadoop-trunk\hadoop-tools\hadoop-azure-datalake\src\main\java\org\apache\hadoop\fs\adl\Adl.java,22,3,0,1,0,4
hadoop-trunk\hadoop-trunk\hadoop-common-project\hadoop-common\src\test\java\org\apache\hadoop\security\TestNetgroupCache.java,101,9,0,1,0,10
hadoop-trunk\hadoop-trunk\hadoop-tools\hadoop-aws\src\main\java\org\apache\hadoop\fs\s3a\auth\delegation\DelegationConstants.java,0,1,0,2,0,3
hadoop-trunk\hadoop-trunk\hadoop-yarn-project\hadoop-yarn\hadoop-yarn-server\hadoop-yarn-server-resourcemanager\src\main\java\org\apache\hadoop\yarn\server\resourcemanager\scheduler\ClusterNodeTracker.java,459,70,11,1,0,82
hadoop-trunk\hadoop-trunk\hadoop-hdfs-project\hadoop-hdfs\src\test\java\org\apache\hadoop\fs\viewfs\TestViewFileSystemHdfs.java,441,51,10,4,0,65
hadoop-trunk\hadoop-trunk\hadoop-yarn-project\hadoop-yarn\hadoop-yarn-server\hadoop-yarn-server-applicationhistoryservice\src\main\java\org\apache\hadoop\yarn\server\timeline\recovery\records\TimelineDelegationTokenIdentifierData.java,36,16,11,2,0,29
hadoop-trunk\hadoop-trunk\hadoop-hdfs-project\hadoop-hdfs\src\main\java\org\apache\hadoop\hdfs\server\namenode\SerialNumberManager.java,0,44,1,2,0,47
hadoop-trunk\hadoop-trunk\hadoop-mapreduce-project\hadoop-mapreduce-client\hadoop-mapreduce-client-jobclient\src\test\java\org\apache\hadoop\mapreduce\lib\input\TestMRSequenceFileAsBinaryInputFormat.java,82,14,3,1,0,18
hadoop-trunk\hadoop-trunk\hadoop-common-project\hadoop-common\src\main\java\org\apache\hadoop\io\erasurecode\rawcoder\NativeXORRawEncoder.java,43,9,0,1,0,10
hadoop-trunk\hadoop-trunk\hadoop-yarn-project\hadoop-yarn\hadoop-yarn-common\src\main\java\org\apache\hadoop\yarn\security\ContainerTokenIdentifier.java,416,159,69,3,0,231
hadoop-trunk\hadoop-trunk\hadoop-hdfs-project\hadoop-hdfs-rbf\src\main\java\org\apache\hadoop\hdfs\server\federation\router\RouterFederationRename.java,219,30,9,11,0,50
hadoop-trunk\hadoop-trunk\hadoop-hdfs-project\hadoop-hdfs\src\test\java\org\apache\hadoop\hdfs\server\namenode\snapshot\TestFileWithSnapshotFeature.java,128,11,13,1,0,25
hadoop-trunk\hadoop-trunk\hadoop-common-project\hadoop-common\src\test\java\org\apache\hadoop\io\TestDataByteBuffers.java,94,34,1,11,0,46
hadoop-trunk\hadoop-trunk\hadoop-common-project\hadoop-common\src\main\java\org\apache\hadoop\fs\shell\CommandWithDestination.java,497,88,7,4,0,99
hadoop-trunk\hadoop-trunk\hadoop-hdfs-project\hadoop-hdfs\src\test\java\org\apache\hadoop\hdfs\server\namenode\snapshot\TestOpenFilesWithSnapshot.java,963,78,7,1,0,86
hadoop-trunk\hadoop-trunk\hadoop-common-project\hadoop-common\src\main\java\org\apache\hadoop\fs\shell\SnapshotCommands.java,0,47,3,1,0,51
hadoop-trunk\hadoop-trunk\hadoop-tools\hadoop-aliyun\src\main\java\org\apache\hadoop\fs\aliyun\oss\OSS.java,13,4,0,1,0,5
hadoop-trunk\hadoop-trunk\hadoop-tools\hadoop-aws\src\test\java\org\apache\hadoop\fs\s3a\select\ITestS3Select.java,0,64,11,2,0,77
hadoop-trunk\hadoop-trunk\hadoop-yarn-project\hadoop-yarn\hadoop-yarn-server\hadoop-yarn-server-nodemanager\src\test\java\org\apache\hadoop\yarn\server\nodemanager\containermanager\deletion\task\DockerContainerDeletionMatcher.java,0,11,3,2,0,16
hadoop-trunk\hadoop-trunk\hadoop-hdfs-project\hadoop-hdfs\src\main\java\org\apache\hadoop\hdfs\server\balancer\MovedBlocks.java,93,45,0,1,0,46
hadoop-trunk\hadoop-trunk\hadoop-yarn-project\hadoop-yarn\hadoop-yarn-server\hadoop-yarn-server-nodemanager\src\main\java\org\apache\hadoop\yarn\server\nodemanager\executor\ContainerReacquisitionContext.java,0,22,2,2,0,26
hadoop-trunk\hadoop-trunk\hadoop-tools\hadoop-openstack\src\main\java\org\apache\hadoop\fs\swift\snative\SwiftObjectFileStatus.java,0,40,9,1,0,50
hadoop-trunk\hadoop-trunk\hadoop-hdfs-project\hadoop-hdfs\src\test\java\org\apache\hadoop\hdfs\server\namenode\TestDecommissioningStatusWithBackoffMonitor.java,0,17,5,1,0,23
hadoop-trunk\hadoop-trunk\hadoop-tools\hadoop-aws\src\main\java\org\apache\hadoop\fs\s3a\impl\MkdirOperation.java,140,6,1,1,0,8
hadoop-trunk\hadoop-trunk\hadoop-mapreduce-project\hadoop-mapreduce-client\hadoop-mapreduce-client-app\src\main\java\org\apache\hadoop\mapreduce\v2\app\job\event\TaskTAttemptFailedEvent.java,18,9,0,1,0,10
hadoop-trunk\hadoop-trunk\hadoop-common-project\hadoop-common\src\main\java\org\apache\hadoop\io\erasurecode\rawcoder\RSRawDecoder.java,142,19,4,1,0,24
hadoop-trunk\hadoop-trunk\hadoop-common-project\hadoop-common\src\test\java\org\apache\hadoop\util\TestProgress.java,22,11,0,1,0,12
hadoop-trunk\hadoop-trunk\hadoop-hdfs-project\hadoop-hdfs\src\main\java\org\apache\hadoop\hdfs\net\DFSTopologyNodeImpl.java,397,52,7,1,0,60
hadoop-trunk\hadoop-trunk\hadoop-yarn-project\hadoop-yarn\hadoop-yarn-server\hadoop-yarn-server-timelineservice-hbase\hadoop-yarn-server-timelineservice-hbase-common\src\main\java\org\apache\hadoop\yarn\server\timelineservice\storage\application\ApplicationRowKey.java,219,41,1,5,0,47
hadoop-trunk\hadoop-trunk\hadoop-hdfs-project\hadoop-hdfs\src\test\java\org\apache\hadoop\hdfs\server\namenode\snapshot\TestFSImageWithOrderedSnapshotDeletion.java,453,64,3,2,0,69
hadoop-trunk\hadoop-trunk\hadoop-mapreduce-project\hadoop-mapreduce-client\hadoop-mapreduce-client-core\src\main\java\org\apache\hadoop\mapreduce\lib\input\SequenceFileRecordReader.java,0,27,3,1,0,31
hadoop-trunk\hadoop-trunk\hadoop-mapreduce-project\hadoop-mapreduce-client\hadoop-mapreduce-client-nativetask\src\test\java\org\apache\hadoop\mapred\nativetask\testutil\EnforceNativeOutputCollectorDelegator.java,0,11,1,3,0,15
hadoop-trunk\hadoop-trunk\hadoop-yarn-project\hadoop-yarn\hadoop-yarn-server\hadoop-yarn-server-resourcemanager\src\test\java\org\apache\hadoop\yarn\server\resourcemanager\scheduler\capacity\TestAbsoluteResourceConfiguration.java,893,271,7,120,0,398
hadoop-trunk\hadoop-trunk\hadoop-tools\hadoop-rumen\src\main\java\org\apache\hadoop\tools\rumen\TaskAttempt20LineEventEmitter.java,141,30,7,4,0,41
hadoop-trunk\hadoop-trunk\hadoop-common-project\hadoop-common\src\main\java\org\apache\hadoop\tools\protocolPB\GetUserMappingsProtocolServerSideTranslatorPB.java,28,8,8,4,0,20
hadoop-trunk\hadoop-trunk\hadoop-yarn-project\hadoop-yarn\hadoop-yarn-server\hadoop-yarn-server-nodemanager\src\main\java\org\apache\hadoop\yarn\server\nodemanager\containermanager\application\ApplicationEventType.java,0,9,0,1,0,10
hadoop-trunk\hadoop-trunk\hadoop-common-project\hadoop-common\src\main\java\org\apache\hadoop\crypto\key\KeyShell.java,517,92,9,1,0,102
hadoop-trunk\hadoop-trunk\hadoop-common-project\hadoop-common\src\main\java\org\apache\hadoop\fs\shell\CommandFormat.java,225,75,7,2,0,84
hadoop-trunk\hadoop-trunk\hadoop-hdfs-project\hadoop-hdfs-httpfs\src\main\java\org\apache\hadoop\lib\servlet\HostnameFilter.java,72,10,3,4,0,17
hadoop-trunk\hadoop-trunk\hadoop-hdfs-project\hadoop-hdfs-rbf\src\main\java\org\apache\hadoop\hdfs\server\federation\store\protocol\GetNamenodeRegistrationsResponse.java,26,6,0,2,0,8
hadoop-trunk\hadoop-trunk\hadoop-common-project\hadoop-common\src\main\java\org\apache\hadoop\ipc\metrics\RetryCacheMetrics.java,60,31,0,1,0,32
hadoop-trunk\hadoop-trunk\hadoop-tools\hadoop-streaming\src\test\java\org\apache\hadoop\streaming\mapreduce\TestStreamXmlRecordReader.java,97,22,2,1,0,25
hadoop-trunk\hadoop-trunk\hadoop-mapreduce-project\hadoop-mapreduce-client\hadoop-mapreduce-client-jobclient\src\test\java\org\apache\hadoop\mapred\lib\TestMultipleInputs.java,50,9,6,3,0,18
hadoop-trunk\hadoop-trunk\hadoop-yarn-project\hadoop-yarn\hadoop-yarn-server\hadoop-yarn-server-resourcemanager\src\main\java\org\apache\hadoop\yarn\server\resourcemanager\scheduler\placement\MultiNodeLookupPolicy.java,0,2,0,1,0,3
hadoop-trunk\hadoop-trunk\hadoop-hdfs-project\hadoop-hdfs\src\main\java\org\apache\hadoop\hdfs\protocol\LayoutFlags.java,28,7,1,1,0,9
hadoop-trunk\hadoop-trunk\hadoop-hdfs-project\hadoop-hdfs\src\test\java\org\apache\hadoop\hdfs\server\namenode\TestAclConfigFlag.java,142,21,5,1,0,27
hadoop-trunk\hadoop-trunk\hadoop-common-project\hadoop-common\src\main\java\org\apache\hadoop\io\erasurecode\rawcoder\ByteBufferDecodingState.java,0,26,1,1,0,28
hadoop-trunk\hadoop-trunk\hadoop-hdfs-project\hadoop-hdfs-client\src\main\java\org\apache\hadoop\hdfs\protocol\RollingUpgradeInfo.java,113,49,0,1,0,50
hadoop-trunk\hadoop-trunk\hadoop-mapreduce-project\hadoop-mapreduce-client\hadoop-mapreduce-client-jobclient\src\test\java\org\apache\hadoop\mapred\TestSequenceFileInputFormat.java,88,26,6,2,0,34
hadoop-trunk\hadoop-trunk\hadoop-common-project\hadoop-common\src\test\java\org\apache\hadoop\ha\TestSshFenceByTcpPort.java,99,29,6,1,0,36
hadoop-trunk\hadoop-trunk\hadoop-hdfs-project\hadoop-hdfs\src\test\java\org\apache\hadoop\fs\contract\hdfs\TestHDFSContractMkdir.java,18,4,0,1,0,5
hadoop-trunk\hadoop-trunk\hadoop-mapreduce-project\hadoop-mapreduce-client\hadoop-mapreduce-client-app\src\main\java\org\apache\hadoop\mapreduce\v2\app\client\package-info.java,0,1,0,1,0,2
hadoop-trunk\hadoop-trunk\hadoop-hdfs-project\hadoop-hdfs-client\src\main\java\org\apache\hadoop\hdfs\util\LongBitFormat.java,56,33,1,1,0,35
hadoop-trunk\hadoop-trunk\hadoop-tools\hadoop-streaming\src\test\java\ClassWithNoPackage.java,3,1,1,1,0,3
hadoop-trunk\hadoop-trunk\hadoop-yarn-project\hadoop-yarn\hadoop-yarn-common\src\test\java\org\apache\hadoop\yarn\TestContainerLogAppender.java,24,2,0,1,0,3
hadoop-trunk\hadoop-trunk\hadoop-tools\hadoop-openstack\src\test\java\org\apache\hadoop\fs\swift\http\TestRestClientBindings.java,0,39,2,14,0,55
hadoop-trunk\hadoop-trunk\hadoop-hdfs-project\hadoop-hdfs\src\test\java\org\apache\hadoop\hdfs\shortcircuit\TestShortCircuitLocalRead.java,578,249,11,1,0,261
hadoop-trunk\hadoop-trunk\hadoop-mapreduce-project\hadoop-mapreduce-client\hadoop-mapreduce-client-core\src\test\java\org\apache\hadoop\mapreduce\lib\output\committer\manifest\TestManifestCommitProtocol.java,0,133,15,27,0,175
hadoop-trunk\hadoop-trunk\hadoop-yarn-project\hadoop-yarn\hadoop-yarn-server\hadoop-yarn-server-sharedcachemanager\src\main\java\org\apache\hadoop\yarn\server\sharedcachemanager\webapp\SCMOverviewPage.java,53,15,0,5,0,20
hadoop-trunk\hadoop-trunk\hadoop-hdfs-project\hadoop-hdfs\src\test\java\org\apache\hadoop\hdfs\TestLocalDFS.java,95,26,4,1,0,31
hadoop-trunk\hadoop-trunk\hadoop-mapreduce-project\hadoop-mapreduce-client\hadoop-mapreduce-client-core\src\test\java\org\apache\hadoop\mapreduce\TestJobResourceUploader.java,771,154,13,1,0,168
hadoop-trunk\hadoop-trunk\hadoop-common-project\hadoop-common\src\main\java\org\apache\hadoop\fs\permission\AclUtil.java,0,6,0,5,0,11
hadoop-trunk\hadoop-trunk\hadoop-tools\hadoop-aws\src\main\java\org\apache\hadoop\fs\s3a\impl\RenameOperation.java,550,25,3,3,0,31
hadoop-trunk\hadoop-trunk\hadoop-yarn-project\hadoop-yarn\hadoop-yarn-common\src\main\java\org\apache\hadoop\yarn\webapp\package-info.java,0,1,0,1,0,2
hadoop-trunk\hadoop-trunk\hadoop-yarn-project\hadoop-yarn\hadoop-yarn-server\hadoop-yarn-server-resourcemanager\src\main\java\org\apache\hadoop\yarn\server\resourcemanager\scheduler\ResourceUsage.java,268,183,1,1,0,185
hadoop-trunk\hadoop-trunk\hadoop-hdfs-project\hadoop-hdfs-rbf\src\test\java\org\apache\hadoop\hdfs\server\federation\router\TestDisableRouterQuota.java,75,9,0,1,0,10
hadoop-trunk\hadoop-trunk\hadoop-common-project\hadoop-common\src\test\java\org\apache\hadoop\fs\FSTestWrapper.java,112,66,1,1,0,68
hadoop-trunk\hadoop-trunk\hadoop-hdfs-project\hadoop-hdfs\src\main\java\org\apache\hadoop\hdfs\server\namenode\sps\Context.java,0,4,0,3,0,7
hadoop-trunk\hadoop-trunk\hadoop-hdfs-project\hadoop-hdfs\src\test\java\org\apache\hadoop\fs\viewfs\TestViewFileSystemWithTruncate.java,80,20,2,1,0,23
hadoop-trunk\hadoop-trunk\hadoop-mapreduce-project\hadoop-mapreduce-client\hadoop-mapreduce-client-core\src\main\java\org\apache\hadoop\mapreduce\lib\join\CompositeInputFormat.java,0,52,8,4,0,64
hadoop-trunk\hadoop-trunk\hadoop-yarn-project\hadoop-yarn\hadoop-yarn-server\hadoop-yarn-server-resourcemanager\src\test\java\org\apache\hadoop\yarn\server\resourcemanager\monitor\capacity\TestProportionalCapacityPreemptionPolicyPreemptToBalance.java,0,69,3,10,0,82
hadoop-trunk\hadoop-trunk\hadoop-tools\hadoop-aws\src\main\java\org\apache\hadoop\fs\s3a\commit\staging\StagingCommitter.java,789,85,26,3,0,114
hadoop-trunk\hadoop-trunk\hadoop-mapreduce-project\hadoop-mapreduce-client\hadoop-mapreduce-client-jobclient\src\test\java\org\apache\hadoop\mapred\TestJavaSerialization.java,153,29,6,2,0,37
hadoop-trunk\hadoop-trunk\hadoop-yarn-project\hadoop-yarn\hadoop-yarn-applications\hadoop-yarn-services\hadoop-yarn-services-core\src\main\java\org\apache\hadoop\yarn\service\utils\ServiceApiUtil.java,715,134,17,7,0,158
hadoop-trunk\hadoop-trunk\hadoop-hdfs-project\hadoop-hdfs\src\main\java\org\apache\hadoop\hdfs\server\protocol\BlockCommand.java,88,66,0,2,0,68
hadoop-trunk\hadoop-trunk\hadoop-yarn-project\hadoop-yarn\hadoop-yarn-server\hadoop-yarn-server-nodemanager\src\test\java\org\apache\hadoop\yarn\server\nodemanager\util\TestNodeManagerHardwareUtils.java,170,37,0,1,0,38
hadoop-trunk\hadoop-trunk\hadoop-common-project\hadoop-common\src\main\java\org\apache\hadoop\fs\statistics\impl\WrappedIOStatistics.java,77,7,1,2,0,10
hadoop-trunk\hadoop-trunk\hadoop-hdfs-project\hadoop-hdfs\src\main\java\org\apache\hadoop\hdfs\server\datanode\VolumeScannerCBInjector.java,22,7,3,1,0,11
hadoop-trunk\hadoop-trunk\hadoop-common-project\hadoop-kms\src\main\java\org\apache\hadoop\crypto\key\kms\server\KeyAuthorizationKeyProvider.java,358,80,4,1,0,85
hadoop-trunk\hadoop-trunk\hadoop-hdfs-project\hadoop-hdfs-rbf\src\test\java\org\apache\hadoop\hdfs\server\federation\router\TestRouterSafemode.java,227,23,3,8,0,34
hadoop-trunk\hadoop-trunk\hadoop-common-project\hadoop-common\src\main\java\org\apache\hadoop\service\ServiceStateModel.java,135,26,2,1,0,29
hadoop-trunk\hadoop-trunk\hadoop-hdfs-project\hadoop-hdfs-client\src\main\java\org\apache\hadoop\hdfs\DFSInotifyEventInputStream.java,182,27,0,4,0,31
hadoop-trunk\hadoop-trunk\hadoop-yarn-project\hadoop-yarn\hadoop-yarn-api\src\main\java\org\apache\hadoop\yarn\factories\RecordFactory.java,0,2,1,1,0,4
hadoop-trunk\hadoop-trunk\hadoop-yarn-project\hadoop-yarn\hadoop-yarn-applications\hadoop-yarn-services\hadoop-yarn-services-core\src\test\java\org\apache\hadoop\yarn\service\provider\TestAbstractProviderService.java,104,14,0,1,0,15
hadoop-trunk\hadoop-trunk\hadoop-yarn-project\hadoop-yarn\hadoop-yarn-server\hadoop-yarn-server-resourcemanager\src\main\java\org\apache\hadoop\yarn\server\resourcemanager\NMLivelinessMonitor.java,24,14,1,1,0,16
hadoop-trunk\hadoop-trunk\hadoop-mapreduce-project\hadoop-mapreduce-client\hadoop-mapreduce-client-core\src\main\java\org\apache\hadoop\mapred\lib\TaggedInputSplit.java,0,24,8,1,0,33
hadoop-trunk\hadoop-trunk\hadoop-tools\hadoop-gridmix\src\main\java\org\apache\hadoop\mapred\gridmix\StatListener.java,0,3,0,1,0,4
hadoop-trunk\hadoop-trunk\hadoop-mapreduce-project\hadoop-mapreduce-client\hadoop-mapreduce-client-jobclient\src\test\java\org\apache\hadoop\mapreduce\v2\TestUberAM.java,127,24,4,2,0,30
hadoop-trunk\hadoop-trunk\hadoop-yarn-project\hadoop-yarn\hadoop-yarn-common\src\main\java\org\apache\hadoop\yarn\client\ConfiguredRMFailoverProxyProvider.java,0,28,3,4,0,35
hadoop-trunk\hadoop-trunk\hadoop-tools\hadoop-federation-balance\src\test\java\org\apache\hadoop\tools\fedbalance\procedure\RecordProcedure.java,21,9,1,1,0,11
hadoop-trunk\hadoop-trunk\hadoop-common-project\hadoop-common\src\test\java\org\apache\hadoop\crypto\key\TestKeyProviderCryptoExtension.java,473,89,17,2,0,108
hadoop-trunk\hadoop-trunk\hadoop-tools\hadoop-aws\src\test\java\org\apache\hadoop\fs\s3a\auth\ITestAssumedRoleCommitOperations.java,79,8,4,1,0,13
hadoop-trunk\hadoop-trunk\hadoop-yarn-project\hadoop-yarn\hadoop-yarn-server\hadoop-yarn-server-nodemanager\src\main\java\org\apache\hadoop\yarn\server\nodemanager\api\ResourceLocalizationSpec.java,0,9,4,1,0,14
hadoop-trunk\hadoop-trunk\hadoop-tools\hadoop-aliyun\src\main\java\org\apache\hadoop\fs\aliyun\oss\AliyunOSSUtils.java,0,35,5,1,0,41
hadoop-trunk\hadoop-trunk\hadoop-mapreduce-project\hadoop-mapreduce-client\hadoop-mapreduce-client-hs\src\test\java\org\apache\hadoop\mapreduce\v2\hs\TestJobHistoryEvents.java,225,69,4,5,0,78
hadoop-trunk\hadoop-trunk\hadoop-yarn-project\hadoop-yarn\hadoop-yarn-common\src\main\java\org\apache\hadoop\yarn\nodelabels\AttributeValue.java,0,0,0,1,0,1
hadoop-trunk\hadoop-trunk\hadoop-common-project\hadoop-nfs\src\main\java\org\apache\hadoop\nfs\nfs3\request\ACCESS3Request.java,16,10,0,1,0,11
hadoop-trunk\hadoop-trunk\hadoop-common-project\hadoop-registry\src\main\java\org\apache\hadoop\registry\client\impl\zk\PathListener.java,0,2,0,1,0,3
hadoop-trunk\hadoop-trunk\hadoop-hdfs-project\hadoop-hdfs\src\main\java\org\apache\hadoop\hdfs\qjournal\server\JournalNode.java,0,118,7,4,0,129
hadoop-trunk\hadoop-trunk\hadoop-mapreduce-project\hadoop-mapreduce-client\hadoop-mapreduce-client-app\src\main\java\org\apache\hadoop\mapred\YarnOutputFiles.java,198,49,3,1,0,53
hadoop-trunk\hadoop-trunk\hadoop-hdfs-project\hadoop-hdfs\src\main\java\org\apache\hadoop\hdfs\server\datanode\IncrementalBlockReportManager.java,0,37,6,2,0,45
hadoop-trunk\hadoop-trunk\hadoop-hdfs-project\hadoop-hdfs\src\main\java\org\apache\hadoop\hdfs\server\namenode\FsckServlet.java,44,6,2,1,0,9
hadoop-trunk\hadoop-trunk\hadoop-tools\hadoop-azure\src\main\java\org\apache\hadoop\fs\azurebfs\services\AbfsRestOperationType.java,0,20,0,1,0,21
hadoop-trunk\hadoop-trunk\hadoop-yarn-project\hadoop-yarn\hadoop-yarn-server\hadoop-yarn-server-resourcemanager\src\main\java\org\apache\hadoop\yarn\server\resourcemanager\rmapp\RMAppKillByClientEvent.java,38,7,0,1,0,8
hadoop-trunk\hadoop-trunk\hadoop-yarn-project\hadoop-yarn\hadoop-yarn-api\src\main\java\org\apache\hadoop\yarn\server\api\protocolrecords\RefreshClusterMaxPriorityRequest.java,10,1,1,1,0,3
hadoop-trunk\hadoop-trunk\hadoop-tools\hadoop-aws\src\main\java\org\apache\hadoop\fs\s3a\commit\staging\PartitionedStagingCommitterFactory.java,0,5,0,1,0,6
hadoop-trunk\hadoop-trunk\hadoop-common-project\hadoop-auth\src\test\java\org\apache\hadoop\security\authentication\util\TestCertificateUtil.java,69,33,0,31,0,64
hadoop-trunk\hadoop-trunk\hadoop-hdfs-project\hadoop-hdfs\src\main\java\org\apache\hadoop\hdfs\tools\offlineImageViewer\LsImageVisitor.java,0,72,12,2,0,86
hadoop-trunk\hadoop-trunk\hadoop-hdfs-project\hadoop-hdfs-httpfs\src\test\java\org\apache\hadoop\fs\http\client\BaseTestHttpFSWith.java,1954,185,91,29,0,305
hadoop-trunk\hadoop-trunk\hadoop-mapreduce-project\hadoop-mapreduce-client\hadoop-mapreduce-client-app\src\main\java\org\apache\hadoop\mapreduce\jobhistory\JobHistoryEventHandler.java,0,294,49,12,0,355
hadoop-trunk\hadoop-trunk\hadoop-yarn-project\hadoop-yarn\hadoop-yarn-server\hadoop-yarn-server-common\src\main\java\org\apache\hadoop\yarn\server\federation\store\records\impl\pb\GetSubClusterInfoRequestPBImpl.java,92,18,35,5,0,58
hadoop-trunk\hadoop-trunk\hadoop-hdfs-project\hadoop-hdfs\src\test\java\org\apache\hadoop\hdfs\server\datanode\TestDataNodeVolumeMetrics.java,192,15,31,1,0,47
hadoop-trunk\hadoop-trunk\hadoop-mapreduce-project\hadoop-mapreduce-client\hadoop-mapreduce-client-common\src\main\java\org\apache\hadoop\mapreduce\v2\api\records\Counters.java,0,27,8,2,0,37
hadoop-trunk\hadoop-trunk\hadoop-mapreduce-project\hadoop-mapreduce-client\hadoop-mapreduce-client-jobclient\src\test\java\org\apache\hadoop\mapred\TestCollect.java,0,51,10,1,0,62
hadoop-trunk\hadoop-trunk\hadoop-yarn-project\hadoop-yarn\hadoop-yarn-common\src\main\java\org\apache\hadoop\yarn\api\records\impl\pb\NodeToAttributeValuePBImpl.java,110,21,29,2,0,52
hadoop-trunk\hadoop-trunk\hadoop-yarn-project\hadoop-yarn\hadoop-yarn-server\hadoop-yarn-server-timelineservice-hbase\hadoop-yarn-server-timelineservice-hbase-common\src\main\java\org\apache\hadoop\yarn\server\timelineservice\storage\common\Column.java,0,3,0,1,0,4
hadoop-trunk\hadoop-trunk\hadoop-common-project\hadoop-common\src\main\java\org\apache\hadoop\fs\FSOutputSummer.java,228,102,1,1,0,104
hadoop-trunk\hadoop-trunk\hadoop-mapreduce-project\hadoop-mapreduce-client\hadoop-mapreduce-client-common\src\test\java\org\apache\hadoop\mapreduce\v2\jobhistory\TestJobHistoryUtils.java,128,148,38,2,0,188
hadoop-trunk\hadoop-trunk\hadoop-hdfs-project\hadoop-hdfs-httpfs\src\test\java\org\apache\hadoop\lib\service\scheduler\TestSchedulerService.java,17,4,0,3,0,7
hadoop-trunk\hadoop-trunk\hadoop-common-project\hadoop-auth\src\test\java\org\apache\hadoop\security\authentication\server\TestPseudoAuthenticationHandler.java,92,11,3,3,0,17
hadoop-trunk\hadoop-trunk\hadoop-common-project\hadoop-common\src\main\java\org\apache\hadoop\ipc\RpcScheduler.java,0,8,2,1,0,11
hadoop-trunk\hadoop-trunk\hadoop-common-project\hadoop-common\src\main\java\org\apache\hadoop\ipc\RpcClientUtil.java,196,58,11,5,0,74
hadoop-trunk\hadoop-trunk\hadoop-common-project\hadoop-common\src\test\java\org\apache\hadoop\io\erasurecode\coder\TestHHXORErasureCoder.java,96,43,9,1,0,53
hadoop-trunk\hadoop-trunk\hadoop-tools\hadoop-rumen\src\main\java\org\apache\hadoop\tools\rumen\state\StatePool.java,282,111,8,3,0,122
hadoop-trunk\hadoop-trunk\hadoop-yarn-project\hadoop-yarn\hadoop-yarn-server\hadoop-yarn-server-resourcemanager\src\main\java\org\apache\hadoop\yarn\server\resourcemanager\recovery\StoreFencedException.java,8,1,0,1,0,2
hadoop-trunk\hadoop-trunk\hadoop-hdfs-project\hadoop-hdfs\src\main\java\org\apache\hadoop\hdfs\server\namenode\INodeSymlink.java,122,52,0,6,0,58
hadoop-trunk\hadoop-trunk\hadoop-yarn-project\hadoop-yarn\hadoop-yarn-common\src\main\java\org\apache\hadoop\yarn\api\records\impl\pb\SerializedExceptionPBImpl.java,170,41,50,2,0,93
hadoop-trunk\hadoop-trunk\hadoop-cloud-storage-project\hadoop-cos\src\main\java\org\apache\hadoop\fs\cosn\CosNInputStream.java,327,78,0,1,0,79
hadoop-trunk\hadoop-trunk\hadoop-common-project\hadoop-common\src\test\java\org\apache\hadoop\io\erasurecode\rawcoder\TestXORRawCoderInteroperable1.java,11,1,0,1,0,2
hadoop-trunk\hadoop-trunk\hadoop-hdfs-project\hadoop-hdfs-httpfs\src\main\java\org\apache\hadoop\lib\service\security\GroupsService.java,37,9,1,1,0,11
hadoop-trunk\hadoop-trunk\hadoop-hdfs-project\hadoop-hdfs-client\src\main\java\org\apache\hadoop\hdfs\web\resources\DoAsParam.java,22,4,1,1,0,6
hadoop-trunk\hadoop-trunk\hadoop-mapreduce-project\hadoop-mapreduce-client\hadoop-mapreduce-client-jobclient\src\test\java\org\apache\hadoop\mapreduce\FailJob.java,88,45,15,3,0,63
hadoop-trunk\hadoop-trunk\hadoop-mapreduce-project\hadoop-mapreduce-examples\src\main\java\org\apache\hadoop\examples\terasort\Unsigned16.java,0,108,7,1,0,116
hadoop-trunk\hadoop-trunk\hadoop-yarn-project\hadoop-yarn\hadoop-yarn-api\src\main\java\org\apache\hadoop\yarn\api\protocolrecords\ReservationUpdateRequest.java,62,14,0,2,0,16
hadoop-trunk\hadoop-trunk\hadoop-hdfs-project\hadoop-hdfs\src\main\java\org\apache\hadoop\hdfs\tools\offlineImageViewer\ImageLoader.java,0,8,6,1,0,15
hadoop-trunk\hadoop-trunk\hadoop-yarn-project\hadoop-yarn\hadoop-yarn-server\hadoop-yarn-server-resourcemanager\src\main\java\org\apache\hadoop\yarn\server\resourcemanager\volume\csi\provisioner\VolumeProvisioningResults.java,59,16,0,2,0,18
hadoop-trunk\hadoop-trunk\hadoop-common-project\hadoop-common\src\test\java\org\apache\hadoop\fs\shell\TestFsShellConcat.java,120,23,3,1,0,27
hadoop-trunk\hadoop-trunk\hadoop-hdfs-project\hadoop-hdfs\src\test\java\org\apache\hadoop\hdfs\web\TestWebHdfsUrl.java,475,61,12,7,0,80
hadoop-trunk\hadoop-trunk\hadoop-common-project\hadoop-common\src\main\java\org\apache\hadoop\fs\BatchedRemoteIterator.java,0,34,6,1,0,41
hadoop-trunk\hadoop-trunk\hadoop-common-project\hadoop-common\src\main\java\org\apache\hadoop\metrics2\impl\MetricsConfigException.java,0,5,0,1,0,6
hadoop-trunk\hadoop-trunk\hadoop-hdfs-project\hadoop-hdfs-client\src\main\java\org\apache\hadoop\hdfs\client\impl\BlockReaderUtil.java,0,11,3,1,0,15
hadoop-trunk\hadoop-trunk\hadoop-common-project\hadoop-common\src\test\java\org\apache\hadoop\io\erasurecode\TestCoderBase.java,501,121,6,2,0,129
hadoop-trunk\hadoop-trunk\hadoop-common-project\hadoop-common\src\test\java\org\apache\hadoop\fs\viewfs\TestViewfsFileStatus.java,141,9,5,1,0,15
hadoop-trunk\hadoop-trunk\hadoop-hdfs-project\hadoop-hdfs\src\main\java\org\apache\hadoop\hdfs\qjournal\protocol\JournalNotFormattedException.java,9,3,0,1,0,4
hadoop-trunk\hadoop-trunk\hadoop-yarn-project\hadoop-yarn\hadoop-yarn-server\hadoop-yarn-server-nodemanager\src\test\java\org\apache\hadoop\yarn\server\nodemanager\TestNodeManagerReboot.java,259,52,6,12,0,70
hadoop-trunk\hadoop-trunk\hadoop-yarn-project\hadoop-yarn\hadoop-yarn-common\src\main\java\org\apache\hadoop\yarn\server\api\protocolrecords\impl\pb\RefreshUserToGroupsMappingsRequestPBImpl.java,0,22,18,5,0,45
hadoop-trunk\hadoop-trunk\hadoop-common-project\hadoop-common\src\main\java\org\apache\hadoop\service\launcher\package-info.java,0,38,0,18,0,56
hadoop-trunk\hadoop-trunk\hadoop-common-project\hadoop-nfs\src\test\java\org\apache\hadoop\oncrpc\TestXDR.java,31,14,5,1,0,20
hadoop-trunk\hadoop-trunk\hadoop-hdfs-project\hadoop-hdfs-client\src\main\java\org\apache\hadoop\hdfs\protocol\EncryptionZone.java,78,36,0,1,0,37
hadoop-trunk\hadoop-trunk\hadoop-hdfs-project\hadoop-hdfs-rbf\src\main\java\org\apache\hadoop\hdfs\server\federation\store\records\BaseRecord.java,236,10,0,1,0,11
hadoop-trunk\hadoop-trunk\hadoop-yarn-project\hadoop-yarn\hadoop-yarn-server\hadoop-yarn-server-resourcemanager\src\main\java\org\apache\hadoop\yarn\server\resourcemanager\rmcontainer\AllocationExpirationInfo.java,52,23,1,1,0,25
hadoop-trunk\hadoop-trunk\hadoop-yarn-project\hadoop-yarn\hadoop-yarn-server\hadoop-yarn-server-timelineservice-hbase\hadoop-yarn-server-timelineservice-hbase-client\src\main\java\org\apache\hadoop\yarn\server\timelineservice\storage\HBaseTimelineWriterImpl.java,590,111,11,39,0,161
hadoop-trunk\hadoop-trunk\hadoop-tools\hadoop-openstack\src\main\java\org\apache\hadoop\fs\swift\exceptions\SwiftInvalidResponseException.java,89,32,0,1,0,33
hadoop-trunk\hadoop-trunk\hadoop-cloud-storage-project\hadoop-cos\src\main\java\org\apache\hadoop\fs\cosn\CosNFileReadTask.java,86,15,2,1,0,18
hadoop-trunk\hadoop-trunk\hadoop-hdfs-project\hadoop-hdfs\src\test\java\org\apache\hadoop\hdfs\TestLeaseRecovery2.java,579,156,28,2,0,186
hadoop-trunk\hadoop-trunk\hadoop-mapreduce-project\hadoop-mapreduce-client\hadoop-mapreduce-client-core\src\main\java\org\apache\hadoop\mapreduce\server\tasktracker\TTConfig.java,0,17,6,1,0,24
hadoop-trunk\hadoop-trunk\hadoop-hdfs-project\hadoop-hdfs-rbf\src\main\java\org\apache\hadoop\hdfs\server\federation\store\protocol\GetSafeModeRequest.java,6,2,0,2,0,4
hadoop-trunk\hadoop-trunk\hadoop-common-project\hadoop-common\src\test\java\org\apache\hadoop\util\ClassLoaderCheckMain.java,12,4,1,1,0,6
hadoop-trunk\hadoop-trunk\hadoop-tools\hadoop-sls\src\main\java\org\apache\hadoop\yarn\sls\scheduler\TaskRunner.java,156,66,6,1,0,73
hadoop-trunk\hadoop-trunk\hadoop-yarn-project\hadoop-yarn\hadoop-yarn-server\hadoop-yarn-server-nodemanager\src\test\java\org\apache\hadoop\yarn\server\nodemanager\containermanager\TestNMProxy.java,139,29,0,1,0,30
hadoop-trunk\hadoop-trunk\hadoop-yarn-project\hadoop-yarn\hadoop-yarn-api\src\main\java\org\apache\hadoop\yarn\exceptions\NMNotYetReadyException.java,9,5,0,2,0,7
hadoop-trunk\hadoop-trunk\hadoop-cloud-storage-project\hadoop-cos\src\main\java\org\apache\hadoop\fs\cosn\NativeFileSystemStore.java,0,1,0,1,0,2
hadoop-trunk\hadoop-trunk\hadoop-hdfs-project\hadoop-hdfs\src\test\java\org\apache\hadoop\hdfs\server\balancer\TestBalancerRPCDelay.java,31,8,0,1,0,9
hadoop-trunk\hadoop-trunk\hadoop-tools\hadoop-openstack\src\main\java\org\apache\hadoop\fs\swift\exceptions\SwiftUnsupportedFeatureException.java,7,3,0,1,0,4
hadoop-trunk\hadoop-trunk\hadoop-mapreduce-project\hadoop-mapreduce-client\hadoop-mapreduce-client-core\src\main\java\org\apache\hadoop\mapreduce\lib\db\BooleanSplitter.java,37,6,0,2,0,8
hadoop-trunk\hadoop-trunk\hadoop-yarn-project\hadoop-yarn\hadoop-yarn-server\hadoop-yarn-server-nodemanager\src\test\java\org\apache\hadoop\yarn\server\nodemanager\amrmproxy\TestAMRMProxyService.java,687,65,26,13,0,104
hadoop-trunk\hadoop-trunk\hadoop-yarn-project\hadoop-yarn\hadoop-yarn-server\hadoop-yarn-server-resourcemanager\src\main\java\org\apache\hadoop\yarn\server\resourcemanager\nodelabels\NodeAttributesStoreEventType.java,0,1,0,1,0,2
hadoop-trunk\hadoop-trunk\hadoop-yarn-project\hadoop-yarn\hadoop-yarn-server\hadoop-yarn-server-resourcemanager\src\test\java\org\apache\hadoop\yarn\server\resourcemanager\scheduler\capacity\TestCapacitySchedulerQueueMappingFactory.java,476,25,6,9,0,40
hadoop-trunk\hadoop-trunk\hadoop-hdfs-project\hadoop-hdfs\src\test\java\org\apache\hadoop\hdfs\server\namenode\TestFsckWithMultipleNameNodes.java,0,35,8,2,0,45
hadoop-trunk\hadoop-trunk\hadoop-yarn-project\hadoop-yarn\hadoop-yarn-applications\hadoop-yarn-services\hadoop-yarn-services-core\src\main\java\org\apache\hadoop\yarn\service\conf\YarnServiceConstants.java,0,32,31,1,0,64
hadoop-trunk\hadoop-trunk\hadoop-tools\hadoop-azure\src\main\java\org\apache\hadoop\fs\azurebfs\utils\IdentityHandler.java,0,1,0,2,0,3
hadoop-trunk\hadoop-trunk\hadoop-common-project\hadoop-common\src\main\java\org\apache\hadoop\util\concurrent\ExecutorHelper.java,0,6,4,2,0,12
hadoop-trunk\hadoop-trunk\hadoop-hdfs-project\hadoop-hdfs\src\test\java\org\apache\hadoop\hdfs\server\blockmanagement\TestBlockReportLease.java,148,9,0,3,0,12
hadoop-trunk\hadoop-trunk\hadoop-yarn-project\hadoop-yarn\hadoop-yarn-csi\src\test\java\org\apache\hadoop\yarn\csi\client\ICsiClientTest.java,0,0,8,1,0,9
hadoop-trunk\hadoop-trunk\hadoop-hdfs-project\hadoop-hdfs\src\main\java\org\apache\hadoop\hdfs\util\ConstEnumCounters.java,0,7,0,1,0,8
hadoop-trunk\hadoop-trunk\hadoop-yarn-project\hadoop-yarn\hadoop-yarn-server\hadoop-yarn-server-resourcemanager\src\main\java\org\apache\hadoop\yarn\server\resourcemanager\webapp\AppPage.java,26,5,0,1,0,6
hadoop-trunk\hadoop-trunk\hadoop-hdfs-project\hadoop-hdfs\src\test\java\org\apache\hadoop\hdfs\server\datanode\TestDataXceiverBackwardsCompat.java,164,23,9,2,0,34
hadoop-trunk\hadoop-trunk\hadoop-hdfs-project\hadoop-hdfs\src\test\java\org\apache\hadoop\hdfs\server\namenode\TestAllowFormat.java,132,39,3,9,0,51
hadoop-trunk\hadoop-trunk\hadoop-mapreduce-project\hadoop-mapreduce-client\hadoop-mapreduce-client-core\src\main\java\org\apache\hadoop\mapreduce\lib\output\committer\manifest\stages\TaskAttemptScanDirectoryStage.java,0,7,4,11,0,22
hadoop-trunk\hadoop-trunk\hadoop-hdfs-project\hadoop-hdfs\src\test\java\org\apache\hadoop\hdfs\server\namenode\TestQuotaByStorageType.java,901,135,17,24,0,176
hadoop-trunk\hadoop-trunk\hadoop-hdfs-project\hadoop-hdfs-client\src\main\java\org\apache\hadoop\hdfs\DFSOpsCountStatistics.java,172,95,0,1,0,96
hadoop-trunk\hadoop-trunk\hadoop-tools\hadoop-aws\src\test\java\org\apache\hadoop\fs\s3a\ITestS3ACannedACLs.java,60,6,1,3,0,10
hadoop-trunk\hadoop-trunk\hadoop-common-project\hadoop-common\src\main\java\org\apache\hadoop\security\token\delegation\web\PseudoDelegationTokenAuthenticator.java,0,1,0,1,0,2
hadoop-trunk\hadoop-trunk\hadoop-mapreduce-project\hadoop-mapreduce-client\hadoop-mapreduce-client-app\src\main\java\org\apache\hadoop\mapreduce\v2\app\webapp\AppView.java,35,7,1,1,0,9
hadoop-trunk\hadoop-trunk\hadoop-hdfs-project\hadoop-hdfs-nfs\src\main\java\org\apache\hadoop\hdfs\nfs\nfs3\Nfs3Metrics.java,179,142,0,1,0,143
hadoop-trunk\hadoop-trunk\hadoop-yarn-project\hadoop-yarn\hadoop-yarn-common\src\test\java\org\apache\hadoop\yarn\util\TestRackResolver.java,130,17,9,2,0,28
hadoop-trunk\hadoop-trunk\hadoop-hdfs-project\hadoop-hdfs-rbf\src\test\java\org\apache\hadoop\hdfs\server\federation\router\TestRouterFederationRenamePermission.java,0,25,3,2,0,30
hadoop-trunk\hadoop-trunk\hadoop-tools\hadoop-azure\src\test\java\org\apache\hadoop\fs\azure\TestSyncableDataOutputStream.java,43,7,1,3,0,11
hadoop-trunk\hadoop-trunk\hadoop-yarn-project\hadoop-yarn\hadoop-yarn-api\src\main\java\org\apache\hadoop\yarn\api\records\timelineservice\FlowActivityEntity.java,157,55,2,1,0,58
hadoop-trunk\hadoop-trunk\hadoop-hdfs-project\hadoop-hdfs\src\main\java\org\apache\hadoop\hdfs\server\blockmanagement\BlockManagerFaultInjector.java,29,13,4,1,0,18
hadoop-trunk\hadoop-trunk\hadoop-tools\hadoop-azure\src\main\java\org\apache\hadoop\fs\azurebfs\extensions\CustomTokenProviderAdaptee.java,0,3,0,4,0,7
hadoop-trunk\hadoop-trunk\hadoop-tools\hadoop-azure\src\test\java\org\apache\hadoop\fs\azurebfs\contract\ITestAbfsFileSystemContractDistCp.java,31,8,0,3,0,11
hadoop-trunk\hadoop-trunk\hadoop-yarn-project\hadoop-yarn\hadoop-yarn-api\src\main\java\org\apache\hadoop\yarn\api\records\timelineservice\UserEntity.java,14,3,0,1,0,4
hadoop-trunk\hadoop-trunk\hadoop-common-project\hadoop-common\src\test\java\org\apache\hadoop\io\erasurecode\rawcoder\TestXORRawCoder.java,9,1,0,1,0,2
hadoop-trunk\hadoop-trunk\hadoop-tools\hadoop-fs2img\src\main\java\org\apache\hadoop\hdfs\server\namenode\FixedBlockResolver.java,65,23,1,1,0,25
hadoop-trunk\hadoop-trunk\hadoop-hdfs-project\hadoop-hdfs\src\main\java\org\apache\hadoop\hdfs\server\blockmanagement\DatanodeAdminDefaultMonitor.java,0,30,10,6,0,46
hadoop-trunk\hadoop-trunk\hadoop-yarn-project\hadoop-yarn\hadoop-yarn-server\hadoop-yarn-server-resourcemanager\src\main\java\org\apache\hadoop\yarn\server\resourcemanager\scheduler\capacity\queuemanagement\GuaranteedOrZeroCapacityOverTimePolicy.java,0,139,17,40,0,196
hadoop-trunk\hadoop-trunk\hadoop-hdfs-project\hadoop-hdfs\src\test\java\org\apache\hadoop\hdfs\server\namenode\TestNNThroughputBenchmark.java,155,21,0,1,0,22
hadoop-trunk\hadoop-trunk\hadoop-mapreduce-project\hadoop-mapreduce-client\hadoop-mapreduce-client-core\src\main\java\org\apache\hadoop\mapreduce\lib\chain\Chain.java,858,267,63,3,0,333
hadoop-trunk\hadoop-trunk\hadoop-hdfs-project\hadoop-hdfs\src\main\java\org\apache\hadoop\hdfs\server\datanode\BlockScanner.java,360,65,7,10,0,82
hadoop-trunk\hadoop-trunk\hadoop-yarn-project\hadoop-yarn\hadoop-yarn-server\hadoop-yarn-server-timelineservice-hbase\hadoop-yarn-server-timelineservice-hbase-common\src\main\java\org\apache\hadoop\yarn\server\timelineservice\storage\subapplication\SubApplicationRowKeyPrefix.java,0,8,0,2,0,10
hadoop-trunk\hadoop-trunk\hadoop-tools\hadoop-aws\src\test\java\org\apache\hadoop\fs\s3a\TestS3AAWSCredentialsProvider.java,426,39,23,1,0,63
hadoop-trunk\hadoop-trunk\hadoop-mapreduce-project\hadoop-mapreduce-client\hadoop-mapreduce-client-jobclient\src\test\java\org\apache\hadoop\mapreduce\lib\partition\TestTotalOrderPartitioner.java,215,70,6,2,0,78
hadoop-trunk\hadoop-trunk\hadoop-yarn-project\hadoop-yarn\hadoop-yarn-common\src\main\java\org\apache\hadoop\yarn\nodelabels\store\op\package-info.java,0,1,0,1,0,2
hadoop-trunk\hadoop-trunk\hadoop-mapreduce-project\hadoop-mapreduce-client\hadoop-mapreduce-client-uploader\src\test\java\org\apache\hadoop\mapred\uploader\TestFrameworkUploader.java,475,23,3,2,0,28
hadoop-trunk\hadoop-trunk\hadoop-yarn-project\hadoop-yarn\hadoop-yarn-server\hadoop-yarn-server-common\src\main\java\org\apache\hadoop\yarn\server\webapp\LogServlet.java,483,66,2,3,0,71
hadoop-trunk\hadoop-trunk\hadoop-tools\hadoop-azure\src\test\java\org\apache\hadoop\fs\azure\TestNativeAzureFileSystemOperationsMocked.java,61,19,0,2,0,21
hadoop-trunk\hadoop-trunk\hadoop-tools\hadoop-resourceestimator\src\main\java\org\apache\hadoop\resourceestimator\solver\preprocess\package-info.java,0,1,0,1,0,2
hadoop-trunk\hadoop-trunk\hadoop-common-project\hadoop-common\src\test\java\org\apache\hadoop\test\TimedOutTestsListener.java,139,34,1,2,0,37
hadoop-trunk\hadoop-trunk\hadoop-mapreduce-project\hadoop-mapreduce-client\hadoop-mapreduce-client-core\src\main\java\org\apache\hadoop\mapred\MapTaskStatus.java,0,34,1,3,0,38
hadoop-trunk\hadoop-trunk\hadoop-mapreduce-project\hadoop-mapreduce-client\hadoop-mapreduce-client-jobclient\src\test\java\org\apache\hadoop\mapred\TestSequenceFileInputFilter.java,145,103,10,8,0,121
hadoop-trunk\hadoop-trunk\hadoop-hdfs-project\hadoop-hdfs\src\test\java\org\apache\hadoop\hdfs\MiniDFSCluster.java,0,1107,60,100,0,1267
hadoop-trunk\hadoop-trunk\hadoop-tools\hadoop-aws\src\main\java\org\apache\hadoop\fs\s3a\audit\OperationAuditor.java,0,1,1,1,0,3
hadoop-trunk\hadoop-trunk\hadoop-tools\hadoop-aws\src\main\java\org\apache\hadoop\fs\s3a\audit\OperationAuditorOptions.java,0,4,0,1,0,5
hadoop-trunk\hadoop-trunk\hadoop-hdfs-project\hadoop-hdfs\src\main\java\org\apache\hadoop\hdfs\server\blockmanagement\ReplicaUnderConstruction.java,0,18,2,1,0,21
hadoop-trunk\hadoop-trunk\hadoop-hdfs-project\hadoop-hdfs\src\test\java\org\apache\hadoop\hdfs\server\datanode\fsdataset\TestAvailableSpaceVolumeChoosingPolicy.java,290,190,0,12,0,202
hadoop-trunk\hadoop-trunk\hadoop-mapreduce-project\hadoop-mapreduce-client\hadoop-mapreduce-client-core\src\main\java\org\apache\hadoop\mapreduce\lib\output\committer\manifest\ManifestCommitter.java,0,27,12,38,0,77
hadoop-trunk\hadoop-trunk\hadoop-yarn-project\hadoop-yarn\hadoop-yarn-common\src\test\java\org\apache\hadoop\yarn\webapp\view\TestTwoColumnCssPage.java,42,12,0,1,0,13
hadoop-trunk\hadoop-trunk\hadoop-yarn-project\hadoop-yarn\hadoop-yarn-server\hadoop-yarn-server-resourcemanager\src\test\java\org\apache\hadoop\yarn\server\resourcemanager\scheduler\capacity\TestQueueCapacities.java,0,44,3,1,0,48
hadoop-trunk\hadoop-trunk\hadoop-yarn-project\hadoop-yarn\hadoop-yarn-server\hadoop-yarn-server-resourcemanager\src\main\java\org\apache\hadoop\yarn\server\resourcemanager\webapp\dao\ResourceOptionInfo.java,35,9,1,1,0,11
hadoop-trunk\hadoop-trunk\hadoop-yarn-project\hadoop-yarn\hadoop-yarn-common\src\main\java\org\apache\hadoop\yarn\api\ApplicationClientProtocolPB.java,0,3,2,4,0,9
hadoop-trunk\hadoop-trunk\hadoop-yarn-project\hadoop-yarn\hadoop-yarn-applications\hadoop-yarn-services\hadoop-yarn-services-core\src\test\java\org\apache\hadoop\yarn\service\timelineservice\TestServiceTimelinePublisher.java,235,38,3,3,0,44
hadoop-trunk\hadoop-trunk\hadoop-yarn-project\hadoop-yarn\hadoop-yarn-server\hadoop-yarn-server-nodemanager\src\main\java\org\apache\hadoop\yarn\server\nodemanager\webapp\ApplicationPage.java,0,13,1,2,0,16
hadoop-trunk\hadoop-trunk\hadoop-hdfs-project\hadoop-hdfs\src\test\java\org\apache\hadoop\hdfs\qjournal\TestSecureNNWithQJM.java,171,23,3,17,0,43
hadoop-trunk\hadoop-trunk\hadoop-hdfs-project\hadoop-hdfs\src\main\java\org\apache\hadoop\hdfs\server\blockmanagement\BlockPlacementPolicyDefault.java,0,380,23,22,0,425
hadoop-trunk\hadoop-trunk\hadoop-hdfs-project\hadoop-hdfs\src\main\java\org\apache\hadoop\hdfs\server\namenode\TransferFsImage.java,392,121,11,7,0,139
hadoop-trunk\hadoop-trunk\hadoop-hdfs-project\hadoop-hdfs\src\test\java\org\apache\hadoop\fs\viewfs\TestViewFileSystemLinkRegex.java,411,49,6,2,0,57
hadoop-trunk\hadoop-trunk\hadoop-common-project\hadoop-common\src\test\java\org\apache\hadoop\io\file\tfile\TestVLong.java,137,44,3,1,0,48
hadoop-trunk\hadoop-trunk\hadoop-yarn-project\hadoop-yarn\hadoop-yarn-csi\src\main\java\org\apache\hadoop\yarn\csi\client\CsiGrpcClient.java,0,14,10,1,0,25
hadoop-trunk\hadoop-trunk\hadoop-hdfs-project\hadoop-hdfs\src\test\java\org\apache\hadoop\hdfs\TestDFSStripedOutputStreamUpdatePipeline.java,73,17,1,1,0,19
hadoop-trunk\hadoop-trunk\hadoop-yarn-project\hadoop-yarn\hadoop-yarn-server\hadoop-yarn-server-resourcemanager\src\test\java\org\apache\hadoop\yarn\server\resourcemanager\scheduler\fair\converter\TestFSConfigToCSConfigRuleHandler.java,155,14,1,10,0,25
hadoop-trunk\hadoop-trunk\hadoop-yarn-project\hadoop-yarn\hadoop-yarn-api\src\main\java\org\apache\hadoop\yarn\api\records\ResourceBlacklistRequest.java,58,26,0,4,0,30
hadoop-trunk\hadoop-trunk\hadoop-yarn-project\hadoop-yarn\hadoop-yarn-server\hadoop-yarn-server-applicationhistoryservice\src\test\java\org\apache\hadoop\yarn\server\timeline\TestLeveldbTimelineStore.java,448,76,15,7,0,98
hadoop-trunk\hadoop-trunk\hadoop-yarn-project\hadoop-yarn\hadoop-yarn-server\hadoop-yarn-server-common\src\main\java\org\apache\hadoop\yarn\server\federation\policies\router\AbstractRouterPolicy.java,32,5,1,4,0,10
hadoop-trunk\hadoop-trunk\hadoop-yarn-project\hadoop-yarn\hadoop-yarn-applications\hadoop-yarn-services\hadoop-yarn-services-core\src\main\java\org\apache\hadoop\yarn\service\component\instance\ComponentInstanceId.java,70,32,3,3,0,38
hadoop-trunk\hadoop-trunk\hadoop-tools\hadoop-gridmix\src\main\java\org\apache\hadoop\mapred\gridmix\SerialJobFactory.java,150,19,3,3,0,25
hadoop-trunk\hadoop-trunk\hadoop-mapreduce-project\hadoop-mapreduce-client\hadoop-mapreduce-client-core\src\main\java\org\apache\hadoop\mapreduce\jobhistory\MapAttemptFinishedEvent.java,239,123,42,1,0,166
hadoop-trunk\hadoop-trunk\hadoop-mapreduce-project\hadoop-mapreduce-client\hadoop-mapreduce-client-core\src\test\java\org\apache\hadoop\mapred\TestJobAclsManager.java,108,9,0,5,0,14
hadoop-trunk\hadoop-trunk\hadoop-tools\hadoop-aws\src\main\java\org\apache\hadoop\fs\s3a\commit\Tasks.java,0,46,2,1,0,49
hadoop-trunk\hadoop-trunk\hadoop-yarn-project\hadoop-yarn\hadoop-yarn-server\hadoop-yarn-server-resourcemanager\src\test\java\org\apache\hadoop\yarn\server\resourcemanager\scheduler\fair\TestSchedulingPolicy.java,451,64,10,4,0,78
hadoop-trunk\hadoop-trunk\hadoop-yarn-project\hadoop-yarn\hadoop-yarn-server\hadoop-yarn-server-resourcemanager\src\main\java\org\apache\hadoop\yarn\server\resourcemanager\security\RMContainerTokenSecretManager.java,177,46,4,3,0,53
hadoop-trunk\hadoop-trunk\hadoop-hdfs-project\hadoop-hdfs\src\test\java\org\apache\hadoop\hdfs\server\common\blockaliasmap\impl\TestLevelDBFileRegionAliasMap.java,83,39,0,1,0,40
hadoop-trunk\hadoop-trunk\hadoop-hdfs-project\hadoop-hdfs\src\test\java\org\apache\hadoop\hdfs\server\diskbalancer\TestPlanner.java,469,83,14,3,0,100
hadoop-trunk\hadoop-trunk\hadoop-mapreduce-project\hadoop-mapreduce-client\hadoop-mapreduce-client-app\src\test\java\org\apache\hadoop\mapreduce\v2\app\webapp\TestAppController.java,282,31,3,16,0,50
hadoop-trunk\hadoop-trunk\hadoop-yarn-project\hadoop-yarn\hadoop-yarn-common\src\main\java\org\apache\hadoop\yarn\api\protocolrecords\impl\pb\SubmitApplicationRequestPBImpl.java,99,45,37,11,0,93
hadoop-trunk\hadoop-trunk\hadoop-yarn-project\hadoop-yarn\hadoop-yarn-server\hadoop-yarn-server-common\src\main\java\org\apache\hadoop\yarn\server\api\records\impl\pb\ContainerQueuingLimitPBImpl.java,54,15,26,3,0,44
hadoop-trunk\hadoop-trunk\hadoop-common-project\hadoop-common\src\test\java\org\apache\hadoop\util\JarFinder.java,167,30,10,1,0,41
hadoop-trunk\hadoop-trunk\hadoop-mapreduce-project\hadoop-mapreduce-client\hadoop-mapreduce-client-app\src\main\java\org\apache\hadoop\mapreduce\v2\app\speculate\package-info.java,0,1,0,1,0,2
hadoop-trunk\hadoop-trunk\hadoop-yarn-project\hadoop-yarn\hadoop-yarn-server\hadoop-yarn-server-applicationhistoryservice\src\main\java\org\apache\hadoop\yarn\server\applicationhistoryservice\records\ApplicationAttemptStartData.java,51,13,0,1,0,14
hadoop-trunk\hadoop-trunk\hadoop-yarn-project\hadoop-yarn\hadoop-yarn-server\hadoop-yarn-server-common\src\main\java\org\apache\hadoop\yarn\server\federation\store\records\SubClusterDeregisterResponse.java,12,1,1,1,0,3
hadoop-trunk\hadoop-trunk\hadoop-yarn-project\hadoop-yarn\hadoop-yarn-server\hadoop-yarn-server-resourcemanager\src\main\java\org\apache\hadoop\yarn\server\resourcemanager\scheduler\fair\FSQueueMetrics.java,348,87,0,7,0,94
hadoop-trunk\hadoop-trunk\hadoop-mapreduce-project\hadoop-mapreduce-client\hadoop-mapreduce-client-core\src\test\java\org\apache\hadoop\mapreduce\task\reduce\TestEventFetcher.java,78,28,4,1,0,33
hadoop-trunk\hadoop-trunk\hadoop-hdfs-project\hadoop-hdfs-httpfs\src\test\java\org\apache\hadoop\test\TestExceptionHelper.java,40,8,2,7,0,17
hadoop-trunk\hadoop-trunk\hadoop-hdfs-project\hadoop-hdfs\src\test\java\org\apache\hadoop\hdfs\server\blockmanagement\TestBlockReportRateLimiting.java,175,47,9,6,0,62
hadoop-trunk\hadoop-trunk\hadoop-hdfs-project\hadoop-hdfs\src\test\java\org\apache\hadoop\hdfs\server\namenode\TestFileContextXAttr.java,59,27,4,1,0,32
hadoop-trunk\hadoop-trunk\hadoop-tools\hadoop-aws\src\test\java\org\apache\hadoop\fs\s3native\TestS3xLoginHelper.java,0,43,0,1,0,44
hadoop-trunk\hadoop-trunk\hadoop-mapreduce-project\hadoop-mapreduce-client\hadoop-mapreduce-client-core\src\main\java\org\apache\hadoop\filecache\package-info.java,0,3,0,1,0,4
hadoop-trunk\hadoop-trunk\hadoop-hdfs-project\hadoop-hdfs\src\test\java\org\apache\hadoop\hdfs\TestFileAppendRestart.java,172,55,0,3,0,58
hadoop-trunk\hadoop-trunk\hadoop-hdfs-project\hadoop-hdfs-client\src\main\java\org\apache\hadoop\hdfs\protocol\datatransfer\sasl\DataTransferSaslUtil.java,0,89,45,14,0,148
hadoop-trunk\hadoop-trunk\hadoop-yarn-project\hadoop-yarn\hadoop-yarn-server\hadoop-yarn-server-nodemanager\src\main\java\org\apache\hadoop\yarn\server\nodemanager\containermanager\container\ContainerExitEvent.java,20,13,0,1,0,14
hadoop-trunk\hadoop-trunk\hadoop-mapreduce-project\hadoop-mapreduce-client\hadoop-mapreduce-client-jobclient\src\test\java\org\apache\hadoop\fs\slive\SlivePartitioner.java,0,8,1,2,0,11
hadoop-trunk\hadoop-trunk\hadoop-common-project\hadoop-common\src\test\java\org\apache\hadoop\fs\TestGlobExpander.java,41,7,1,2,0,10
hadoop-trunk\hadoop-trunk\hadoop-hdfs-project\hadoop-hdfs-httpfs\src\test\java\org\apache\hadoop\test\HTestCase.java,0,28,3,9,0,40
hadoop-trunk\hadoop-trunk\hadoop-common-project\hadoop-annotations\src\main\java\org\apache\hadoop\classification\tools\IncludePublicAnnotationsStandardDoclet.java,29,14,1,2,0,17
hadoop-trunk\hadoop-trunk\hadoop-hdfs-project\hadoop-hdfs-httpfs\src\main\java\org\apache\hadoop\lib\server\Server.java,691,118,28,42,0,188
hadoop-trunk\hadoop-trunk\hadoop-yarn-project\hadoop-yarn\hadoop-yarn-common\src\main\java\org\apache\hadoop\yarn\security\AccessRequest.java,52,37,0,2,0,39
hadoop-trunk\hadoop-trunk\hadoop-yarn-project\hadoop-yarn\hadoop-yarn-server\hadoop-yarn-server-router\src\test\java\org\apache\hadoop\yarn\server\router\TestRouter.java,58,8,3,2,0,13
hadoop-trunk\hadoop-trunk\hadoop-mapreduce-project\hadoop-mapreduce-examples\src\main\java\org\apache\hadoop\examples\pi\math\Summation.java,0,147,17,9,0,173
hadoop-trunk\hadoop-trunk\hadoop-common-project\hadoop-common\src\test\java\org\apache\hadoop\http\resource\JerseyResource.java,23,6,1,1,0,8
hadoop-trunk\hadoop-trunk\hadoop-tools\hadoop-aws\src\main\java\org\apache\hadoop\fs\s3a\Statistic.java,0,130,0,5,0,135
hadoop-trunk\hadoop-trunk\hadoop-tools\hadoop-aws\src\test\java\org\apache\hadoop\fs\s3a\commit\TestTasks.java,520,66,4,2,0,72
hadoop-trunk\hadoop-trunk\hadoop-mapreduce-project\hadoop-mapreduce-client\hadoop-mapreduce-client-app\src\main\java\org\apache\hadoop\mapreduce\v2\app\commit\CommitterJobCommitEvent.java,20,11,0,1,0,12
hadoop-trunk\hadoop-trunk\hadoop-yarn-project\hadoop-yarn\hadoop-yarn-server\hadoop-yarn-server-common\src\main\java\org\apache\hadoop\yarn\server\api\protocolrecords\RegisterNodeManagerResponse.java,40,18,0,1,0,19
hadoop-trunk\hadoop-trunk\hadoop-yarn-project\hadoop-yarn\hadoop-yarn-server\hadoop-yarn-server-resourcemanager\src\main\java\org\apache\hadoop\yarn\server\resourcemanager\webapp\dao\ResourceRequestInfo.java,140,75,1,1,0,77
hadoop-trunk\hadoop-trunk\hadoop-hdfs-project\hadoop-hdfs\src\test\java\org\apache\hadoop\hdfs\tools\TestGetConf.java,530,151,12,8,0,171
hadoop-trunk\hadoop-trunk\hadoop-mapreduce-project\hadoop-mapreduce-client\hadoop-mapreduce-client-core\src\main\java\org\apache\hadoop\mapreduce\lib\output\SequenceFileOutputFormat.java,0,34,1,1,0,36
hadoop-trunk\hadoop-trunk\hadoop-yarn-project\hadoop-yarn\hadoop-yarn-common\src\main\java\org\apache\hadoop\yarn\api\protocolrecords\impl\pb\GetLocalizationStatusesRequestPBImpl.java,118,20,39,4,0,63
hadoop-trunk\hadoop-trunk\hadoop-hdfs-project\hadoop-hdfs\src\test\java\org\apache\hadoop\hdfs\server\namenode\TestRefreshBlockPlacementPolicy.java,84,24,3,4,0,31
hadoop-trunk\hadoop-trunk\hadoop-hdfs-project\hadoop-hdfs-client\src\main\java\org\apache\hadoop\hdfs\protocol\NSQuotaExceededException.java,0,19,3,1,0,23
hadoop-trunk\hadoop-trunk\hadoop-yarn-project\hadoop-yarn\hadoop-yarn-server\hadoop-yarn-server-resourcemanager\src\main\java\org\apache\hadoop\yarn\server\resourcemanager\scheduler\constraint\processor\NodeCandidateSelector.java,0,0,0,2,0,2
hadoop-trunk\hadoop-trunk\hadoop-tools\hadoop-azure\src\main\java\org\apache\hadoop\fs\azurebfs\AzureBlobFileSystem.java,0,131,27,70,0,228
hadoop-trunk\hadoop-trunk\hadoop-tools\hadoop-azure\src\test\java\org\apache\hadoop\fs\azurebfs\ITestAbfsHugeFiles.java,89,18,0,6,0,24
hadoop-trunk\hadoop-trunk\hadoop-yarn-project\hadoop-yarn\hadoop-yarn-common\src\main\java\org\apache\hadoop\yarn\client\api\impl\TimelineReaderClientImpl.java,188,42,4,4,0,50
hadoop-trunk\hadoop-trunk\hadoop-yarn-project\hadoop-yarn\hadoop-yarn-common\src\main\java\org\apache\hadoop\yarn\api\protocolrecords\impl\pb\GetClusterNodesResponsePBImpl.java,139,35,45,3,0,83
hadoop-trunk\hadoop-trunk\hadoop-yarn-project\hadoop-yarn\hadoop-yarn-api\src\main\java\org\apache\hadoop\yarn\api\records\ContainerState.java,0,7,0,1,0,8
hadoop-trunk\hadoop-trunk\hadoop-yarn-project\hadoop-yarn\hadoop-yarn-common\src\main\java\org\apache\hadoop\yarn\server\api\protocolrecords\impl\pb\RefreshNodesResourcesRequestPBImpl.java,44,18,18,4,0,40
hadoop-trunk\hadoop-trunk\hadoop-mapreduce-project\hadoop-mapreduce-client\hadoop-mapreduce-client-core\src\main\java\org\apache\hadoop\mapred\lib\HashPartitioner.java,0,15,3,1,0,19
hadoop-trunk\hadoop-trunk\hadoop-hdfs-project\hadoop-hdfs\src\main\java\org\apache\hadoop\hdfs\server\datanode\fsdataset\impl\FsDatasetCache.java,567,115,17,10,0,142
hadoop-trunk\hadoop-trunk\hadoop-tools\hadoop-aws\src\main\java\org\apache\hadoop\fs\s3a\impl\CallableSupplier.java,0,5,2,1,0,8
hadoop-trunk\hadoop-trunk\hadoop-tools\hadoop-aws\src\main\java\org\apache\hadoop\fs\s3a\auth\delegation\FullCredentialsTokenBinding.java,134,5,1,2,0,8
hadoop-trunk\hadoop-trunk\hadoop-common-project\hadoop-common\src\main\java\org\apache\hadoop\io\nativeio\Errno.java,0,39,0,1,0,40
hadoop-trunk\hadoop-trunk\hadoop-common-project\hadoop-common\src\main\java\org\apache\hadoop\util\ComparableVersion.java,0,369,8,36,0,413
hadoop-trunk\hadoop-trunk\hadoop-mapreduce-project\hadoop-mapreduce-client\hadoop-mapreduce-client-jobclient\src\test\java\org\apache\hadoop\fs\slive\SliveReducer.java,0,18,1,2,0,21
hadoop-trunk\hadoop-trunk\hadoop-mapreduce-project\hadoop-mapreduce-client\hadoop-mapreduce-client-core\src\main\java\org\apache\hadoop\mapreduce\lib\join\InnerJoinRecordReader.java,0,10,0,1,0,11
hadoop-trunk\hadoop-trunk\hadoop-yarn-project\hadoop-yarn\hadoop-yarn-server\hadoop-yarn-server-resourcemanager\src\test\java\org\apache\hadoop\yarn\server\resourcemanager\rmapp\attempt\TestRMAppAttemptTransitions.java,1865,359,63,30,0,452
hadoop-trunk\hadoop-trunk\hadoop-tools\hadoop-aliyun\src\test\java\org\apache\hadoop\fs\aliyun\oss\contract\TestAliyunOSSContractCreate.java,9,2,0,1,0,3
hadoop-trunk\hadoop-trunk\hadoop-common-project\hadoop-common\src\main\java\org\apache\hadoop\io\serializer\avro\AvroSpecificSerialization.java,0,12,5,1,0,18
hadoop-trunk\hadoop-trunk\hadoop-hdfs-project\hadoop-hdfs-client\src\main\java\org\apache\hadoop\hdfs\web\resources\ExcludeDatanodesParam.java,22,5,1,1,0,7
hadoop-trunk\hadoop-trunk\hadoop-hdfs-project\hadoop-hdfs\src\main\java\org\apache\hadoop\hdfs\tools\DFSHAAdmin.java,287,61,0,2,0,63
hadoop-trunk\hadoop-trunk\hadoop-mapreduce-project\hadoop-mapreduce-client\hadoop-mapreduce-client-core\src\main\java\org\apache\hadoop\mapreduce\lib\output\FileOutputCommitter.java,706,167,14,10,0,191
hadoop-trunk\hadoop-trunk\hadoop-yarn-project\hadoop-yarn\hadoop-yarn-api\src\main\java\org\apache\hadoop\yarn\server\api\ContainerContext.java,83,32,0,1,0,33
hadoop-trunk\hadoop-trunk\hadoop-hdfs-project\hadoop-hdfs\src\main\java\org\apache\hadoop\hdfs\server\namenode\CacheManager.java,1200,170,59,20,0,249
hadoop-trunk\hadoop-trunk\hadoop-yarn-project\hadoop-yarn\hadoop-yarn-server\hadoop-yarn-server-applicationhistoryservice\src\main\java\org\apache\hadoop\yarn\server\applicationhistoryservice\ApplicationHistoryManagerImpl.java,211,40,0,7,0,47
hadoop-trunk\hadoop-trunk\hadoop-mapreduce-project\hadoop-mapreduce-client\hadoop-mapreduce-client-common\src\main\java\org\apache\hadoop\mapreduce\v2\util\LocalResourceBuilder.java,0,24,6,1,0,31
hadoop-trunk\hadoop-trunk\hadoop-yarn-project\hadoop-yarn\hadoop-yarn-server\hadoop-yarn-server-web-proxy\src\test\java\org\apache\hadoop\yarn\server\webproxy\TestWebAppProxyServer.java,60,10,3,2,0,15
hadoop-trunk\hadoop-trunk\hadoop-tools\hadoop-aws\src\main\java\org\apache\hadoop\fs\s3a\statistics\impl\AbstractS3AStatisticsSource.java,0,14,1,1,0,16
hadoop-trunk\hadoop-trunk\hadoop-common-project\hadoop-common\src\main\java\org\apache\hadoop\security\FastSaslClientFactory.java,44,13,0,1,0,14
hadoop-trunk\hadoop-trunk\hadoop-tools\hadoop-aws\src\main\java\org\apache\hadoop\fs\s3a\auth\delegation\AbstractDelegationTokenBinding.java,237,13,2,4,0,19
hadoop-trunk\hadoop-trunk\hadoop-common-project\hadoop-nfs\src\main\java\org\apache\hadoop\nfs\nfs3\request\GETATTR3Request.java,16,10,0,1,0,11
hadoop-trunk\hadoop-trunk\hadoop-hdfs-project\hadoop-hdfs\src\main\java\org\apache\hadoop\hdfs\server\namenode\QuotaByStorageTypeEntry.java,64,25,1,2,0,28
hadoop-trunk\hadoop-trunk\hadoop-yarn-project\hadoop-yarn\hadoop-yarn-common\src\main\java\org\apache\hadoop\yarn\api\ApplicationHistoryProtocolPB.java,0,1,2,2,0,5
hadoop-trunk\hadoop-trunk\hadoop-hdfs-project\hadoop-hdfs\src\main\java\org\apache\hadoop\hdfs\server\sps\ExternalSPSContext.java,158,36,3,4,0,43
hadoop-trunk\hadoop-trunk\hadoop-mapreduce-project\hadoop-mapreduce-client\hadoop-mapreduce-client-core\src\test\java\org\apache\hadoop\mapreduce\filecache\TestDistributedCache.java,104,1,29,1,0,31
hadoop-trunk\hadoop-trunk\hadoop-yarn-project\hadoop-yarn\hadoop-yarn-server\hadoop-yarn-server-nodemanager\src\test\java\org\apache\hadoop\yarn\server\nodemanager\containermanager\linux\runtime\docker\TestDockerLoadCommand.java,26,5,0,2,0,7
hadoop-trunk\hadoop-trunk\hadoop-yarn-project\hadoop-yarn\hadoop-yarn-server\hadoop-yarn-server-resourcemanager\src\main\java\org\apache\hadoop\yarn\server\resourcemanager\webapp\RmView.java,37,10,2,1,0,13
hadoop-trunk\hadoop-trunk\hadoop-common-project\hadoop-auth\src\test\java\org\apache\hadoop\security\authentication\util\TestKerberosUtil.java,215,79,15,5,0,99
hadoop-trunk\hadoop-trunk\hadoop-common-project\hadoop-common\src\test\java\org\apache\hadoop\io\erasurecode\rawcoder\TestXORRawCoderBase.java,36,17,5,1,0,23
hadoop-trunk\hadoop-trunk\hadoop-common-project\hadoop-common\src\test\java\org\apache\hadoop\cli\util\ExactComparator.java,8,5,0,1,0,6
hadoop-trunk\hadoop-trunk\hadoop-hdfs-project\hadoop-hdfs-rbf\src\main\java\org\apache\hadoop\hdfs\server\federation\store\protocol\GetNamespaceInfoRequest.java,7,1,0,2,0,3
hadoop-trunk\hadoop-trunk\hadoop-yarn-project\hadoop-yarn\hadoop-yarn-server\hadoop-yarn-server-timelineservice-hbase\hadoop-yarn-server-timelineservice-hbase-common\src\main\java\org\apache\hadoop\yarn\server\timelineservice\storage\subapplication\SubApplicationTable.java,0,0,0,1,0,1
hadoop-trunk\hadoop-trunk\hadoop-yarn-project\hadoop-yarn\hadoop-yarn-server\hadoop-yarn-server-nodemanager\src\main\java\org\apache\hadoop\yarn\server\nodemanager\recovery\NMLeveldbStateStoreService.java,1732,267,101,12,0,380
hadoop-trunk\hadoop-trunk\hadoop-hdfs-project\hadoop-hdfs-rbf\src\main\java\org\apache\hadoop\hdfs\server\federation\router\RouterServiceState.java,0,7,0,1,0,8
hadoop-trunk\hadoop-trunk\hadoop-mapreduce-project\hadoop-mapreduce-client\hadoop-mapreduce-client-jobclient\src\test\java\org\apache\hadoop\fi\ProbabilityModel.java,65,26,6,2,0,34
hadoop-trunk\hadoop-trunk\hadoop-yarn-project\hadoop-yarn\hadoop-yarn-server\hadoop-yarn-server-resourcemanager\src\main\java\org\apache\hadoop\yarn\server\resourcemanager\scheduler\common\SchedulerContainer.java,51,31,0,3,0,34
hadoop-trunk\hadoop-trunk\hadoop-tools\hadoop-sls\src\main\java\org\apache\hadoop\yarn\sls\appmaster\AMSimulator.java,0,111,5,4,0,120
hadoop-trunk\hadoop-trunk\hadoop-yarn-project\hadoop-yarn\hadoop-yarn-api\src\main\java\org\apache\hadoop\yarn\api\records\ContainerRetryPolicy.java,0,0,0,1,0,1
hadoop-trunk\hadoop-trunk\hadoop-yarn-project\hadoop-yarn\hadoop-yarn-server\hadoop-yarn-server-resourcemanager\src\test\java\org\apache\hadoop\yarn\server\resourcemanager\scheduler\capacity\TestAbsoluteResourceWithAutoQueue.java,0,66,8,15,0,89
hadoop-trunk\hadoop-trunk\hadoop-common-project\hadoop-common\src\main\java\org\apache\hadoop\security\authentication\server\ProxyUserAuthenticationFilter.java,0,17,3,1,0,21
hadoop-trunk\hadoop-trunk\hadoop-common-project\hadoop-common\src\main\java\org\apache\hadoop\util\PureJavaCrc32C.java,604,630,1,8,0,639
hadoop-trunk\hadoop-trunk\hadoop-common-project\hadoop-common\src\main\java\org\apache\hadoop\fs\shell\CopyCommandWithMultiThread.java,0,17,2,1,0,20
hadoop-trunk\hadoop-trunk\hadoop-common-project\hadoop-common\src\test\java\org\apache\hadoop\util\TestClassUtil.java,14,5,0,1,0,6
hadoop-trunk\hadoop-trunk\hadoop-mapreduce-project\hadoop-mapreduce-client\hadoop-mapreduce-client-core\src\main\java\org\apache\hadoop\mapred\MergeSorter.java,0,24,1,2,0,27
hadoop-trunk\hadoop-trunk\hadoop-yarn-project\hadoop-yarn\hadoop-yarn-common\src\main\java\org\apache\hadoop\yarn\event\AsyncDispatcher.java,360,71,17,2,0,90
hadoop-trunk\hadoop-trunk\hadoop-yarn-project\hadoop-yarn\hadoop-yarn-server\hadoop-yarn-server-nodemanager\src\main\java\org\apache\hadoop\yarn\server\nodemanager\containermanager\resourceplugin\com\nec\VEDeviceDiscoverer.java,0,22,0,2,0,24
hadoop-trunk\hadoop-trunk\hadoop-common-project\hadoop-nfs\src\main\java\org\apache\hadoop\oncrpc\RpcCall.java,101,57,1,1,0,59
hadoop-trunk\hadoop-trunk\hadoop-hdfs-project\hadoop-hdfs-client\src\main\java\org\apache\hadoop\hdfs\protocolPB\ClientNamenodeProtocolTranslatorPB.java,0,361,113,141,0,615
hadoop-trunk\hadoop-trunk\hadoop-maven-plugins\src\main\java\org\apache\hadoop\maven\plugin\protoc\ProtocMojo.java,32,23,0,1,0,24
hadoop-trunk\hadoop-trunk\hadoop-yarn-project\hadoop-yarn\hadoop-yarn-server\hadoop-yarn-server-nodemanager\src\main\java\org\apache\hadoop\yarn\server\nodemanager\api\protocolrecords\LocalResourceStatus.java,0,20,10,1,0,31
hadoop-trunk\hadoop-trunk\hadoop-yarn-project\hadoop-yarn\hadoop-yarn-server\hadoop-yarn-server-resourcemanager\src\test\java\org\apache\hadoop\yarn\server\resourcemanager\webapp\fairscheduler\TestRMWebServicesFairScheduler.java,109,7,0,4,0,11
hadoop-trunk\hadoop-trunk\hadoop-tools\hadoop-extras\src\main\java\org\apache\hadoop\mapred\tools\package-info.java,0,0,0,1,0,1
hadoop-trunk\hadoop-trunk\hadoop-tools\hadoop-federation-balance\src\main\java\org\apache\hadoop\tools\fedbalance\FedBalance.java,289,46,14,4,0,64
hadoop-trunk\hadoop-trunk\hadoop-tools\hadoop-streaming\src\main\java\org\apache\hadoop\streaming\io\TypedBytesOutputReader.java,0,16,1,1,0,18
hadoop-trunk\hadoop-trunk\hadoop-tools\hadoop-streaming\src\test\java\org\apache\hadoop\streaming\TestStreamingCombiner.java,28,8,3,1,0,12
hadoop-trunk\hadoop-trunk\hadoop-hdfs-project\hadoop-hdfs\src\main\java\org\apache\hadoop\hdfs\server\blockmanagement\SlowDiskTracker.java,249,61,12,1,0,74
hadoop-trunk\hadoop-trunk\hadoop-yarn-project\hadoop-yarn\hadoop-yarn-server\hadoop-yarn-server-common\src\main\java\org\apache\hadoop\yarn\server\federation\store\records\impl\pb\SubClusterPolicyConfigurationPBImpl.java,0,23,37,4,0,64
hadoop-trunk\hadoop-trunk\hadoop-yarn-project\hadoop-yarn\hadoop-yarn-server\hadoop-yarn-server-resourcemanager\src\main\java\org\apache\hadoop\yarn\server\resourcemanager\reservation\planning\PlanningAlgorithm.java,200,33,2,8,0,43
hadoop-trunk\hadoop-trunk\hadoop-yarn-project\hadoop-yarn\hadoop-yarn-server\hadoop-yarn-server-resourcemanager\src\main\java\org\apache\hadoop\yarn\server\resourcemanager\monitor\invariants\InvariantsChecker.java,67,27,1,3,0,31
hadoop-trunk\hadoop-trunk\hadoop-mapreduce-project\hadoop-mapreduce-client\hadoop-mapreduce-client-core\src\main\java\org\apache\hadoop\mapreduce\security\token\delegation\package-info.java,0,1,0,1,0,2
hadoop-trunk\hadoop-trunk\hadoop-common-project\hadoop-common\src\test\java\org\apache\hadoop\fs\viewfs\TestHCFSMountTableConfigLoader.java,0,23,0,1,0,24
hadoop-trunk\hadoop-trunk\hadoop-common-project\hadoop-common\src\main\java\org\apache\hadoop\io\serializer\Deserializer.java,0,6,0,1,0,7
hadoop-trunk\hadoop-trunk\hadoop-yarn-project\hadoop-yarn\hadoop-yarn-common\src\main\java\org\apache\hadoop\yarn\api\protocolrecords\impl\pb\UseSharedCacheResourceRequestPBImpl.java,93,23,38,3,0,64
hadoop-trunk\hadoop-trunk\hadoop-yarn-project\hadoop-yarn\hadoop-yarn-server\hadoop-yarn-server-common\src\test\java\org\apache\hadoop\yarn\server\federation\policies\manager\TestUniformBroadcastPolicyManager.java,15,1,0,3,0,4
hadoop-trunk\hadoop-trunk\hadoop-hdfs-project\hadoop-hdfs-rbf\src\test\java\org\apache\hadoop\hdfs\server\federation\store\TestStateStoreMountTable.java,201,13,1,13,0,27
hadoop-trunk\hadoop-trunk\hadoop-tools\hadoop-openstack\src\main\java\org\apache\hadoop\fs\swift\auth\PasswordAuthenticationRequest.java,37,9,0,2,0,11
hadoop-trunk\hadoop-trunk\hadoop-yarn-project\hadoop-yarn\hadoop-yarn-server\hadoop-yarn-server-resourcemanager\src\main\java\org\apache\hadoop\yarn\server\resourcemanager\scheduler\policy\PriorityComparator.java,17,3,0,1,0,4
hadoop-trunk\hadoop-trunk\hadoop-common-project\hadoop-common\src\main\java\org\apache\hadoop\fs\shell\AclCommands.java,0,47,3,2,0,52
hadoop-trunk\hadoop-trunk\hadoop-tools\hadoop-azure\src\test\java\org\apache\hadoop\fs\azurebfs\utils\DelegationSASGenerator.java,163,46,2,7,0,55
hadoop-trunk\hadoop-trunk\hadoop-hdfs-project\hadoop-hdfs-client\src\main\java\org\apache\hadoop\hdfs\web\resources\PutOpParam.java,0,43,1,1,0,45
hadoop-trunk\hadoop-trunk\hadoop-yarn-project\hadoop-yarn\hadoop-yarn-server\hadoop-yarn-server-resourcemanager\src\test\java\org\apache\hadoop\yarn\server\resourcemanager\reservation\TestReservationSystem.java,169,37,5,11,0,53
hadoop-trunk\hadoop-trunk\hadoop-hdfs-project\hadoop-hdfs\src\test\java\org\apache\hadoop\hdfs\server\namenode\TestFSImage.java,1144,161,39,3,0,203
hadoop-trunk\hadoop-trunk\hadoop-hdfs-project\hadoop-hdfs\src\test\java\org\apache\hadoop\hdfs\server\namenode\FileNameGenerator.java,63,39,5,2,0,46
hadoop-trunk\hadoop-trunk\hadoop-yarn-project\hadoop-yarn\hadoop-yarn-server\hadoop-yarn-server-resourcemanager\src\test\java\org\apache\hadoop\yarn\server\resourcemanager\TestLeaderElectorService.java,232,42,5,6,0,53
hadoop-trunk\hadoop-trunk\hadoop-yarn-project\hadoop-yarn\hadoop-yarn-server\hadoop-yarn-server-sharedcachemanager\src\main\java\org\apache\hadoop\yarn\server\sharedcachemanager\metrics\ClientSCMMetrics.java,55,24,1,1,0,26
hadoop-trunk\hadoop-trunk\hadoop-common-project\hadoop-common\src\test\java\org\apache\hadoop\util\TestChunkedArrayList.java,143,33,29,1,0,63
hadoop-trunk\hadoop-trunk\hadoop-hdfs-project\hadoop-hdfs-rbf\src\test\java\org\apache\hadoop\hdfs\server\federation\router\TestRouterClientRejectOverload.java,364,31,4,6,0,41
hadoop-trunk\hadoop-trunk\hadoop-common-project\hadoop-common\src\test\java\org\apache\hadoop\ha\TestFailoverController.java,393,73,14,19,0,106
hadoop-trunk\hadoop-trunk\hadoop-hdfs-project\hadoop-hdfs\src\main\java\org\apache\hadoop\hdfs\security\token\block\BlockTokenSecretManager.java,525,202,6,9,0,217
hadoop-trunk\hadoop-trunk\hadoop-yarn-project\hadoop-yarn\hadoop-yarn-common\src\main\java\org\apache\hadoop\yarn\api\protocolrecords\impl\pb\MoveApplicationAcrossQueuesRequestPBImpl.java,127,46,39,9,0,94
hadoop-trunk\hadoop-trunk\hadoop-common-project\hadoop-auth\src\main\java\org\apache\hadoop\security\authentication\client\AuthenticatedURL.java,0,64,7,19,0,90
hadoop-trunk\hadoop-trunk\hadoop-mapreduce-project\hadoop-mapreduce-client\hadoop-mapreduce-client-nativetask\src\test\java\org\apache\hadoop\mapred\nativetask\combinertest\WordCount.java,56,23,3,6,0,32
hadoop-trunk\hadoop-trunk\hadoop-common-project\hadoop-common\src\main\java\org\apache\hadoop\conf\ConfigurationWithLogging.java,85,19,3,1,0,23
hadoop-trunk\hadoop-trunk\hadoop-hdfs-project\hadoop-hdfs-client\src\main\java\org\apache\hadoop\hdfs\protocol\RollingUpgradeStatus.java,40,16,0,1,0,17
hadoop-trunk\hadoop-trunk\hadoop-yarn-project\hadoop-yarn\hadoop-yarn-server\hadoop-yarn-server-nodemanager\src\main\java\org\apache\hadoop\yarn\server\nodemanager\containermanager\linux\resources\ResourceHandlerChain.java,128,21,0,4,0,25
hadoop-trunk\hadoop-trunk\hadoop-yarn-project\hadoop-yarn\hadoop-yarn-server\hadoop-yarn-server-resourcemanager\src\test\java\org\apache\hadoop\yarn\server\resourcemanager\scheduler\capacity\conf\TestInMemoryConfigurationStore.java,17,2,0,1,0,3
hadoop-trunk\hadoop-trunk\hadoop-yarn-project\hadoop-yarn\hadoop-yarn-client\src\test\java\org\apache\hadoop\yarn\client\TestApplicationMasterServiceProtocolOnHA.java,0,7,0,5,0,12
hadoop-trunk\hadoop-trunk\hadoop-yarn-project\hadoop-yarn\hadoop-yarn-server\hadoop-yarn-server-applicationhistoryservice\src\main\java\org\apache\hadoop\yarn\server\applicationhistoryservice\records\ContainerStartData.java,59,16,0,1,0,17
hadoop-trunk\hadoop-trunk\hadoop-common-project\hadoop-common\src\main\java\org\apache\hadoop\crypto\JceCtrCryptoCodec.java,134,56,2,4,0,62
hadoop-trunk\hadoop-trunk\hadoop-yarn-project\hadoop-yarn\hadoop-yarn-server\hadoop-yarn-server-sharedcachemanager\src\test\java\org\apache\hadoop\yarn\server\sharedcachemanager\TestRemoteAppChecker.java,71,6,0,1,0,7
hadoop-trunk\hadoop-trunk\hadoop-hdfs-project\hadoop-hdfs-httpfs\src\main\java\org\apache\hadoop\lib\service\Groups.java,0,3,1,1,0,5
hadoop-trunk\hadoop-trunk\hadoop-tools\hadoop-azure\src\main\java\org\apache\hadoop\fs\azurebfs\oauth2\AzureADToken.java,22,16,0,2,0,18
hadoop-trunk\hadoop-trunk\hadoop-hdfs-project\hadoop-hdfs\src\test\java\org\apache\hadoop\hdfs\server\namenode\TestAddStripedBlockInFBR.java,84,15,4,1,0,20
hadoop-trunk\hadoop-trunk\hadoop-tools\hadoop-aws\src\main\java\org\apache\hadoop\fs\s3a\tools\MarkerToolOperations.java,0,1,0,1,0,2
hadoop-trunk\hadoop-trunk\hadoop-common-project\hadoop-common\src\main\java\org\apache\hadoop\metrics2\lib\MutableMetric.java,34,10,1,1,0,12
hadoop-trunk\hadoop-trunk\hadoop-mapreduce-project\hadoop-mapreduce-client\hadoop-mapreduce-client-core\src\main\java\org\apache\hadoop\mapreduce\lib\aggregate\StringValueMin.java,60,14,1,1,0,16
hadoop-trunk\hadoop-trunk\hadoop-common-project\hadoop-common\src\main\java\org\apache\hadoop\net\NodeBase.java,191,108,2,6,0,116
hadoop-trunk\hadoop-trunk\hadoop-yarn-project\hadoop-yarn\hadoop-yarn-server\hadoop-yarn-server-nodemanager\src\main\java\org\apache\hadoop\yarn\server\nodemanager\containermanager\container\ContainerResourceLocalizedEvent.java,29,16,0,3,0,19
hadoop-trunk\hadoop-trunk\hadoop-common-project\hadoop-common\src\main\java\org\apache\hadoop\fs\FilterFileSystem.java,689,281,8,5,0,294
hadoop-trunk\hadoop-trunk\hadoop-common-project\hadoop-registry\src\test\java\org\apache\hadoop\registry\secure\KerberosConfiguration.java,0,13,0,1,0,14
hadoop-trunk\hadoop-trunk\hadoop-hdfs-project\hadoop-hdfs-client\src\main\java\org\apache\hadoop\hdfs\protocol\AlreadyBeingCreatedException.java,7,2,0,1,0,3
hadoop-trunk\hadoop-trunk\hadoop-common-project\hadoop-common\src\test\java\org\apache\hadoop\fs\contract\AbstractContractUnbufferTest.java,122,24,0,2,0,26
hadoop-trunk\hadoop-trunk\hadoop-tools\hadoop-azure\src\main\java\org\apache\hadoop\fs\azurebfs\services\AbfsClient.java,1165,293,51,145,0,489
hadoop-trunk\hadoop-trunk\hadoop-hdfs-project\hadoop-hdfs\src\test\java\org\apache\hadoop\hdfs\server\namenode\CreateEditsLog.java,161,82,9,3,0,94
hadoop-trunk\hadoop-trunk\hadoop-yarn-project\hadoop-yarn\hadoop-yarn-server\hadoop-yarn-server-common\src\main\java\org\apache\hadoop\yarn\server\federation\policies\router\package-info.java,0,0,0,1,0,1
hadoop-trunk\hadoop-trunk\hadoop-common-project\hadoop-common\src\main\java\org\apache\hadoop\metrics2\MetricStringBuilder.java,109,48,1,1,0,50
hadoop-trunk\hadoop-trunk\hadoop-hdfs-project\hadoop-hdfs\src\test\java\org\apache\hadoop\fs\TestSWebHdfsFileContextMainOperations.java,0,19,4,2,0,25
hadoop-trunk\hadoop-trunk\hadoop-hdfs-project\hadoop-hdfs-rbf\src\main\java\org\apache\hadoop\hdfs\server\federation\store\driver\StateStoreSerializer.java,91,7,0,1,0,8
hadoop-trunk\hadoop-trunk\hadoop-yarn-project\hadoop-yarn\hadoop-yarn-applications\hadoop-yarn-services\hadoop-yarn-services-core\src\main\java\org\apache\hadoop\yarn\service\UpgradeComponentsFinder.java,0,13,0,1,0,14
hadoop-trunk\hadoop-trunk\hadoop-yarn-project\hadoop-yarn\hadoop-yarn-common\src\main\java\org\apache\hadoop\yarn\client\AMRMClientUtils.java,0,26,2,1,0,29
hadoop-trunk\hadoop-trunk\hadoop-hdfs-project\hadoop-hdfs\src\main\java\org\apache\hadoop\hdfs\server\diskbalancer\connectors\ClusterConnector.java,0,0,0,2,0,2
hadoop-trunk\hadoop-trunk\hadoop-mapreduce-project\hadoop-mapreduce-client\hadoop-mapreduce-client-core\src\main\java\org\apache\hadoop\mapred\QueueRefresher.java,35,3,0,1,0,4
hadoop-trunk\hadoop-trunk\hadoop-yarn-project\hadoop-yarn\hadoop-yarn-server\hadoop-yarn-server-common\src\test\java\org\apache\hadoop\yarn\TestYSCRecordFactory.java,17,4,0,3,0,7
hadoop-trunk\hadoop-trunk\hadoop-yarn-project\hadoop-yarn\hadoop-yarn-server\hadoop-yarn-server-timelineservice-documentstore\src\test\java\org\apache\hadoop\yarn\server\timelineservice\documentstore\writer\cosmosdb\MockedCosmosDBDocumentStoreWriter.java,0,7,2,5,0,14
hadoop-trunk\hadoop-trunk\hadoop-tools\hadoop-aws\src\test\java\org\apache\hadoop\fs\s3a\commit\staging\TestStagingCommitter.java,0,98,21,2,0,121
hadoop-trunk\hadoop-trunk\hadoop-hdfs-project\hadoop-hdfs-client\src\main\java\org\apache\hadoop\hdfs\FileChecksumHelper.java,0,109,22,4,0,135
hadoop-trunk\hadoop-trunk\hadoop-yarn-project\hadoop-yarn\hadoop-yarn-common\src\main\java\org\apache\hadoop\yarn\metrics\EventTypeMetrics.java,0,4,0,1,0,5
hadoop-trunk\hadoop-trunk\hadoop-common-project\hadoop-common\src\main\java\org\apache\hadoop\ipc\ProtocolSignature.java,223,89,3,2,0,94
hadoop-trunk\hadoop-trunk\hadoop-hdfs-project\hadoop-hdfs-client\src\main\java\org\apache\hadoop\hdfs\util\ByteBufferOutputStream.java,19,11,0,1,0,12
hadoop-trunk\hadoop-trunk\hadoop-yarn-project\hadoop-yarn\hadoop-yarn-server\hadoop-yarn-server-resourcemanager\src\test\java\org\apache\hadoop\yarn\server\resourcemanager\webapp\TestRMWebServicesAppsModification.java,1364,156,13,15,0,184
hadoop-trunk\hadoop-trunk\hadoop-common-project\hadoop-common\src\main\java\org\apache\hadoop\metrics2\annotation\package-info.java,0,1,0,1,0,2
hadoop-trunk\hadoop-trunk\hadoop-common-project\hadoop-common\src\main\java\org\apache\hadoop\io\compress\bzip2\Bzip2Compressor.java,266,85,8,1,0,94
hadoop-trunk\hadoop-trunk\hadoop-yarn-project\hadoop-yarn\hadoop-yarn-server\hadoop-yarn-server-nodemanager\src\test\java\org\apache\hadoop\yarn\server\nodemanager\containermanager\resourceplugin\fpga\TestIntelFpgaOpenclPlugin.java,50,6,0,2,0,8
hadoop-trunk\hadoop-trunk\hadoop-hdfs-project\hadoop-hdfs-httpfs\src\main\java\org\apache\hadoop\lib\wsrs\ExceptionProvider.java,31,14,1,2,0,17
hadoop-trunk\hadoop-trunk\hadoop-hdfs-project\hadoop-hdfs\src\test\java\org\apache\hadoop\hdfs\server\datanode\TestDatanodeStartupOptions.java,65,12,2,1,0,15
hadoop-trunk\hadoop-trunk\hadoop-mapreduce-project\hadoop-mapreduce-client\hadoop-mapreduce-client-app\src\main\java\org\apache\hadoop\mapreduce\v2\app\rm\preemption\CheckpointAMPreemptionPolicy.java,228,52,7,2,0,61
hadoop-trunk\hadoop-trunk\hadoop-yarn-project\hadoop-yarn\hadoop-yarn-applications\hadoop-yarn-services\hadoop-yarn-services-core\src\main\java\org\apache\hadoop\yarn\service\ServiceManager.java,467,62,16,2,0,80
hadoop-trunk\hadoop-trunk\hadoop-yarn-project\hadoop-yarn\hadoop-yarn-applications\hadoop-yarn-services\hadoop-yarn-services-core\src\test\java\org\apache\hadoop\yarn\service\utils\TestServiceApiUtil.java,714,44,55,2,0,101
hadoop-trunk\hadoop-trunk\hadoop-yarn-project\hadoop-yarn\hadoop-yarn-common\src\test\java\org\apache\hadoop\yarn\api\records\timeline\TestTimelineRecords.java,284,20,9,5,0,34
hadoop-trunk\hadoop-trunk\hadoop-yarn-project\hadoop-yarn\hadoop-yarn-server\hadoop-yarn-server-resourcemanager\src\main\java\org\apache\hadoop\yarn\server\resourcemanager\scheduler\capacity\LeafQueue.java,18,12,2,1,0,15
hadoop-trunk\hadoop-trunk\hadoop-yarn-project\hadoop-yarn\hadoop-yarn-server\hadoop-yarn-server-resourcemanager\src\main\java\org\apache\hadoop\yarn\server\resourcemanager\monitor\invariants\package-info.java,0,1,0,1,0,2
hadoop-trunk\hadoop-trunk\hadoop-common-project\hadoop-auth\src\test\java\org\apache\hadoop\security\authentication\server\TestLdapAuthenticationHandler.java,96,17,3,2,0,22
hadoop-trunk\hadoop-trunk\hadoop-common-project\hadoop-common\src\main\java\org\apache\hadoop\util\CrcUtil.java,0,79,4,1,0,84
hadoop-trunk\hadoop-trunk\hadoop-mapreduce-project\hadoop-mapreduce-examples\src\main\java\org\apache\hadoop\examples\terasort\TeraSortConfigKeys.java,0,21,0,1,0,22
hadoop-trunk\hadoop-trunk\hadoop-tools\hadoop-streaming\src\test\java\org\apache\hadoop\streaming\TestMultipleArchiveFiles.java,0,34,15,2,0,51
hadoop-trunk\hadoop-trunk\hadoop-yarn-project\hadoop-yarn\hadoop-yarn-server\hadoop-yarn-server-nodemanager\src\main\java\org\apache\hadoop\yarn\server\nodemanager\containermanager\localizer\LocalResourcesTracker.java,0,3,0,2,0,5
hadoop-trunk\hadoop-trunk\hadoop-common-project\hadoop-common\src\main\java\org\apache\hadoop\io\compress\SplitCompressionInputStream.java,0,14,0,1,0,15
hadoop-trunk\hadoop-trunk\hadoop-tools\hadoop-aws\src\test\java\org\apache\hadoop\fs\s3a\s3guard\TestMetastoreChecking.java,57,12,2,2,0,16
hadoop-trunk\hadoop-trunk\hadoop-yarn-project\hadoop-yarn\hadoop-yarn-server\hadoop-yarn-server-applicationhistoryservice\src\main\java\org\apache\hadoop\yarn\server\applicationhistoryservice\records\ApplicationAttemptHistoryData.java,139,66,0,1,0,67
hadoop-trunk\hadoop-trunk\hadoop-common-project\hadoop-common\src\main\java\org\apache\hadoop\io\serializer\Serialization.java,0,6,0,1,0,7
hadoop-trunk\hadoop-trunk\hadoop-common-project\hadoop-common\src\main\java\org\apache\hadoop\service\launcher\AbstractLaunchableService.java,0,6,0,1,0,7
hadoop-trunk\hadoop-trunk\hadoop-tools\hadoop-streaming\src\main\java\org\apache\hadoop\typedbytes\TypedBytesWritableInput.java,336,99,0,1,0,100
hadoop-trunk\hadoop-trunk\hadoop-hdfs-project\hadoop-hdfs\src\main\java\org\apache\hadoop\hdfs\tools\offlineImageViewer\NameDistributionVisitor.java,84,32,7,1,0,40
hadoop-trunk\hadoop-trunk\hadoop-yarn-project\hadoop-yarn\hadoop-yarn-server\hadoop-yarn-server-resourcemanager\src\test\java\org\apache\hadoop\yarn\server\resourcemanager\scheduler\fair\TestFSQueueMetrics.java,275,106,0,1,0,107
hadoop-trunk\hadoop-trunk\hadoop-common-project\hadoop-common\src\main\java\org\apache\hadoop\util\Progressable.java,0,2,1,1,0,4
hadoop-trunk\hadoop-trunk\hadoop-yarn-project\hadoop-yarn\hadoop-yarn-server\hadoop-yarn-server-resourcemanager\src\test\java\org\apache\hadoop\yarn\server\resourcemanager\reservation\TestFairSchedulerPlanFollower.java,140,37,5,9,0,51
hadoop-trunk\hadoop-trunk\hadoop-hdfs-project\hadoop-hdfs\src\test\java\org\apache\hadoop\fs\viewfs\TestViewFsLinkFallback.java,540,17,1,1,0,19
hadoop-trunk\hadoop-trunk\hadoop-yarn-project\hadoop-yarn\hadoop-yarn-applications\hadoop-yarn-applications-catalog\hadoop-yarn-applications-catalog-webapp\src\main\java\org\apache\hadoop\yarn\appcatalog\utils\WordLengthException.java,8,3,0,1,0,4
hadoop-trunk\hadoop-trunk\hadoop-yarn-project\hadoop-yarn\hadoop-yarn-applications\hadoop-yarn-services\hadoop-yarn-services-core\src\main\java\org\apache\hadoop\yarn\service\monitor\ServiceMonitor.java,105,16,3,11,0,30
hadoop-trunk\hadoop-trunk\hadoop-yarn-project\hadoop-yarn\hadoop-yarn-common\src\main\java\org\apache\hadoop\yarn\webapp\ForbiddenException.java,17,5,1,1,0,7
hadoop-trunk\hadoop-trunk\hadoop-yarn-project\hadoop-yarn\hadoop-yarn-server\hadoop-yarn-server-resourcemanager\src\main\java\org\apache\hadoop\yarn\server\resourcemanager\scheduler\event\ContainerPreemptEvent.java,30,14,0,1,0,15
hadoop-trunk\hadoop-trunk\hadoop-hdfs-project\hadoop-hdfs\src\test\java\org\apache\hadoop\hdfs\qjournal\client\TestEpochsAreUnique.java,105,30,9,3,0,42
hadoop-trunk\hadoop-trunk\hadoop-yarn-project\hadoop-yarn\hadoop-yarn-server\hadoop-yarn-server-resourcemanager\src\main\java\org\apache\hadoop\yarn\server\resourcemanager\volume\csi\VolumeBuilder.java,0,23,0,4,0,27
hadoop-trunk\hadoop-trunk\hadoop-common-project\hadoop-common\src\test\java\org\apache\hadoop\test\MetricsAsserts.java,381,131,8,1,0,140
hadoop-trunk\hadoop-trunk\hadoop-tools\hadoop-azure\src\main\java\org\apache\hadoop\fs\azure\security\package-info.java,0,2,0,1,0,3
hadoop-trunk\hadoop-trunk\hadoop-common-project\hadoop-common\src\main\java\org\apache\hadoop\fs\FileUtil.java,0,326,40,29,0,395
hadoop-trunk\hadoop-trunk\hadoop-tools\hadoop-azure\src\test\java\org\apache\hadoop\fs\azurebfs\services\ITestAbfsInputStreamSmallFileReads.java,288,69,8,7,0,84
hadoop-trunk\hadoop-trunk\hadoop-hdfs-project\hadoop-hdfs\src\main\java\org\apache\hadoop\hdfs\server\namenode\ReencryptionHandler.java,761,65,23,13,0,101
hadoop-trunk\hadoop-trunk\hadoop-mapreduce-project\hadoop-mapreduce-client\hadoop-mapreduce-client-core\src\main\java\org\apache\hadoop\mapreduce\lib\output\committer\manifest\stages\LoadManifestsStage.java,0,18,3,8,0,29
hadoop-trunk\hadoop-trunk\hadoop-common-project\hadoop-common\src\test\java\org\apache\hadoop\fs\shell\find\MockFileSystem.java,0,9,3,1,0,13
hadoop-trunk\hadoop-trunk\hadoop-hdfs-project\hadoop-hdfs\src\test\java\org\apache\hadoop\hdfs\server\namenode\TestGenericJournalConf.java,197,78,14,2,0,94
hadoop-trunk\hadoop-trunk\hadoop-common-project\hadoop-common\src\main\java\org\apache\hadoop\net\DNS.java,410,59,4,2,0,65
hadoop-trunk\hadoop-trunk\hadoop-hdfs-project\hadoop-hdfs-rbf\src\main\java\org\apache\hadoop\hdfs\server\federation\metrics\FederationRPCMetrics.java,277,83,1,8,0,92
hadoop-trunk\hadoop-trunk\hadoop-common-project\hadoop-common\src\main\java\org\apache\hadoop\io\file\tfile\BoundedRangeFileInputStream.java,112,33,4,1,0,38
hadoop-trunk\hadoop-trunk\hadoop-tools\hadoop-rumen\src\main\java\org\apache\hadoop\tools\rumen\DeskewedJobTraceReader.java,170,32,5,2,0,39
hadoop-trunk\hadoop-trunk\hadoop-yarn-project\hadoop-yarn\hadoop-yarn-server\hadoop-yarn-server-nodemanager\src\main\java\org\apache\hadoop\yarn\server\nodemanager\executor\ContainerPrepareContext.java,0,35,3,2,0,40
hadoop-trunk\hadoop-trunk\hadoop-hdfs-project\hadoop-hdfs\src\main\java\org\apache\hadoop\hdfs\server\datanode\fsdataset\impl\VolumeFailureInfo.java,0,17,0,2,0,19
hadoop-trunk\hadoop-trunk\hadoop-yarn-project\hadoop-yarn\hadoop-yarn-server\hadoop-yarn-server-resourcemanager\src\test\java\org\apache\hadoop\yarn\server\resourcemanager\recovery\RMStateStoreTestBase.java,899,156,94,19,0,269
hadoop-trunk\hadoop-trunk\hadoop-yarn-project\hadoop-yarn\hadoop-yarn-common\src\main\java\org\apache\hadoop\yarn\api\protocolrecords\impl\pb\GetQueueInfoResponsePBImpl.java,99,34,36,2,0,72
hadoop-trunk\hadoop-trunk\hadoop-common-project\hadoop-common\src\test\java\org\apache\hadoop\security\SecurityUtilTestHelper.java,26,10,2,1,0,13
hadoop-trunk\hadoop-trunk\hadoop-common-project\hadoop-common\src\main\java\org\apache\hadoop\metrics2\impl\MBeanInfoBuilder.java,0,34,1,1,0,36
hadoop-trunk\hadoop-trunk\hadoop-tools\hadoop-azure\src\main\java\org\apache\hadoop\fs\azurebfs\services\AbfsListResult.java,27,8,1,1,0,10
hadoop-trunk\hadoop-trunk\hadoop-hdfs-project\hadoop-hdfs-rbf\src\main\java\org\apache\hadoop\hdfs\server\federation\store\protocol\impl\pb\UpdateMountTableEntryResponsePBImpl.java,0,12,28,4,0,44
hadoop-trunk\hadoop-trunk\hadoop-yarn-project\hadoop-yarn\hadoop-yarn-common\src\test\java\org\apache\hadoop\yarn\util\TestApps.java,167,6,2,1,0,9
hadoop-trunk\hadoop-trunk\hadoop-common-project\hadoop-common\src\main\java\org\apache\hadoop\fs\CommonConfigurationKeysPublic.java,0,116,0,10,0,126
hadoop-trunk\hadoop-trunk\hadoop-yarn-project\hadoop-yarn\hadoop-yarn-server\hadoop-yarn-server-applicationhistoryservice\src\main\java\org\apache\hadoop\yarn\server\timeline\EntityIdentifier.java,73,23,8,1,0,32
hadoop-trunk\hadoop-trunk\hadoop-mapreduce-project\hadoop-mapreduce-client\hadoop-mapreduce-client-jobclient\src\test\java\org\apache\hadoop\fs\slive\SleepOp.java,0,14,1,1,0,16
hadoop-trunk\hadoop-trunk\hadoop-common-project\hadoop-common\src\main\java\org\apache\hadoop\ipc\Client.java,1874,466,63,38,0,567
hadoop-trunk\hadoop-trunk\hadoop-yarn-project\hadoop-yarn\hadoop-yarn-server\hadoop-yarn-server-resourcemanager\src\test\java\org\apache\hadoop\yarn\server\resourcemanager\scheduler\QueueMetricsTestData.java,0,44,0,1,0,45
hadoop-trunk\hadoop-trunk\hadoop-common-project\hadoop-common\src\main\java\org\apache\hadoop\io\erasurecode\rawcoder\util\GF256.java,0,82,7,1,0,90
hadoop-trunk\hadoop-trunk\hadoop-common-project\hadoop-common\src\main\java\org\apache\hadoop\fs\FileAlreadyExistsException.java,0,5,0,1,0,6
hadoop-trunk\hadoop-trunk\hadoop-yarn-project\hadoop-yarn\hadoop-yarn-server\hadoop-yarn-server-resourcemanager\src\main\java\org\apache\hadoop\yarn\server\resourcemanager\placement\csmappingrule\MappingRuleMatcher.java,0,0,0,1,0,1
hadoop-trunk\hadoop-trunk\hadoop-hdfs-project\hadoop-hdfs\src\test\java\org\apache\hadoop\hdfs\server\blockmanagement\TestBlockTokenWithDFSStriped.java,111,35,7,2,0,44
hadoop-trunk\hadoop-trunk\hadoop-tools\hadoop-azure\src\main\java\org\apache\hadoop\fs\azurebfs\services\AbfsHttpOperation.java,0,97,3,14,0,114
hadoop-trunk\hadoop-trunk\hadoop-common-project\hadoop-common\src\main\java\org\apache\hadoop\util\InvalidChecksumSizeException.java,9,2,0,1,0,3
hadoop-trunk\hadoop-trunk\hadoop-common-project\hadoop-common\src\test\java\org\apache\hadoop\io\compress\TestBlockDecompressorStream.java,74,24,3,1,0,28
hadoop-trunk\hadoop-trunk\hadoop-hdfs-project\hadoop-hdfs-rbf\src\main\java\org\apache\hadoop\hdfs\server\federation\resolver\RouterGenericManager.java,0,0,0,1,0,1
hadoop-trunk\hadoop-trunk\hadoop-common-project\hadoop-common\src\test\java\org\apache\hadoop\io\erasurecode\coder\TestXORCoder.java,43,14,2,1,0,17
hadoop-trunk\hadoop-trunk\hadoop-common-project\hadoop-common\src\test\java\org\apache\hadoop\security\TestLdapGroupsMappingWithPosixGroup.java,0,4,0,1,0,5
hadoop-trunk\hadoop-trunk\hadoop-mapreduce-project\hadoop-mapreduce-client\hadoop-mapreduce-client-jobclient\src\test\java\org\apache\hadoop\conf\TestNoDefaultsJobConf.java,69,3,6,1,0,10
hadoop-trunk\hadoop-trunk\hadoop-yarn-project\hadoop-yarn\hadoop-yarn-server\hadoop-yarn-server-resourcemanager\src\test\java\org\apache\hadoop\yarn\server\resourcemanager\MockRMAppSubmitter.java,136,17,2,3,0,22
hadoop-trunk\hadoop-trunk\hadoop-common-project\hadoop-common\src\main\java\org\apache\hadoop\io\file\tfile\Compression.java,0,65,9,5,0,79
hadoop-trunk\hadoop-trunk\hadoop-mapreduce-project\hadoop-mapreduce-client\hadoop-mapreduce-client-common\src\main\java\org\apache\hadoop\mapreduce\v2\api\protocolrecords\impl\pb\package-info.java,0,1,0,1,0,2
hadoop-trunk\hadoop-trunk\hadoop-yarn-project\hadoop-yarn\hadoop-yarn-server\hadoop-yarn-server-timeline-pluginstorage\src\main\java\org\apache\hadoop\yarn\server\timeline\package-info.java,0,2,0,1,0,3
hadoop-trunk\hadoop-trunk\hadoop-hdfs-project\hadoop-hdfs\src\test\java\org\apache\hadoop\hdfs\server\namenode\TestNameNodeStatusMXBean.java,110,17,1,1,0,19
hadoop-trunk\hadoop-trunk\hadoop-hdfs-project\hadoop-hdfs-client\src\main\java\org\apache\hadoop\hdfs\web\resources\OverwriteParam.java,30,2,0,1,0,3
hadoop-trunk\hadoop-trunk\hadoop-common-project\hadoop-common\src\main\java\org\apache\hadoop\ipc\ClientId.java,60,31,2,1,0,34
hadoop-trunk\hadoop-trunk\hadoop-common-project\hadoop-common\src\main\java\org\apache\hadoop\util\Preconditions.java,0,20,0,16,0,36
hadoop-trunk\hadoop-trunk\hadoop-mapreduce-project\hadoop-mapreduce-client\hadoop-mapreduce-client-jobclient\src\test\java\org\apache\hadoop\mapred\MiniMRCluster.java,233,164,15,1,0,180
hadoop-trunk\hadoop-trunk\hadoop-tools\hadoop-distcp\src\main\java\org\apache\hadoop\tools\CopyListingFileStatus.java,0,115,3,2,0,120
hadoop-trunk\hadoop-trunk\hadoop-common-project\hadoop-common\src\main\java\org\apache\hadoop\metrics2\MetricsException.java,29,8,0,1,0,9
hadoop-trunk\hadoop-trunk\hadoop-yarn-project\hadoop-yarn\hadoop-yarn-csi\src\main\java\org\apache\hadoop\yarn\csi\translator\ProtoTranslator.java,0,0,0,1,0,1
hadoop-trunk\hadoop-trunk\hadoop-yarn-project\hadoop-yarn\hadoop-yarn-server\hadoop-yarn-server-resourcemanager\src\main\java\org\apache\hadoop\yarn\server\resourcemanager\webapp\dao\AppAttemptsInfo.java,0,8,4,1,0,13
hadoop-trunk\hadoop-trunk\hadoop-mapreduce-project\hadoop-mapreduce-client\hadoop-mapreduce-client-common\src\main\java\org\apache\hadoop\mapreduce\v2\api\protocolrecords\impl\pb\GetTaskAttemptCompletionEventsRequestPBImpl.java,101,44,45,10,0,99
hadoop-trunk\hadoop-trunk\hadoop-mapreduce-project\hadoop-mapreduce-client\hadoop-mapreduce-client-core\src\main\java\org\apache\hadoop\mapred\MapFileOutputFormat.java,0,39,7,4,0,50
hadoop-trunk\hadoop-trunk\hadoop-common-project\hadoop-common\src\main\java\org\apache\hadoop\util\MergeSort.java,62,48,3,1,0,52
hadoop-trunk\hadoop-trunk\hadoop-hdfs-project\hadoop-hdfs\src\main\java\org\apache\hadoop\hdfs\server\namenode\INodeId.java,14,3,0,1,0,4
hadoop-trunk\hadoop-trunk\hadoop-tools\hadoop-openstack\src\test\java\org\apache\hadoop\fs\swift\SwiftTestConstants.java,0,4,2,1,0,7
hadoop-trunk\hadoop-trunk\hadoop-common-project\hadoop-common\src\main\java\org\apache\hadoop\ipc\CallerContext.java,0,38,1,5,0,44
hadoop-trunk\hadoop-trunk\hadoop-hdfs-project\hadoop-hdfs\src\test\java\org\apache\hadoop\hdfs\DFSTestUtil.java,0,932,72,29,0,1033
hadoop-trunk\hadoop-trunk\hadoop-yarn-project\hadoop-yarn\hadoop-yarn-server\hadoop-yarn-server-resourcemanager\src\test\java\org\apache\hadoop\yarn\server\resourcemanager\TestCapacitySchedulerMetrics.java,88,21,0,7,0,28
hadoop-trunk\hadoop-trunk\hadoop-mapreduce-project\hadoop-mapreduce-client\hadoop-mapreduce-client-core\src\main\java\org\apache\hadoop\mapreduce\lib\partition\KeyFieldBasedComparator.java,0,129,21,5,0,155
hadoop-trunk\hadoop-trunk\hadoop-mapreduce-project\hadoop-mapreduce-client\hadoop-mapreduce-client-common\src\test\java\org\apache\hadoop\mapreduce\v2\jobhistory\TestFileNameIndexUtils.java,480,61,0,1,0,62
hadoop-trunk\hadoop-trunk\hadoop-tools\hadoop-distcp\src\main\java\org\apache\hadoop\tools\util\ThrottledInputStream.java,140,32,0,3,0,35
hadoop-trunk\hadoop-trunk\hadoop-tools\hadoop-gridmix\src\main\java\org\apache\hadoop\mapred\gridmix\SubmitterUserResolver.java,31,13,0,2,0,15
hadoop-trunk\hadoop-trunk\hadoop-mapreduce-project\hadoop-mapreduce-client\hadoop-mapreduce-client-jobclient\src\test\java\org\apache\hadoop\mapreduce\lib\input\TestMultipleInputs.java,166,29,15,3,0,47
hadoop-trunk\hadoop-trunk\hadoop-yarn-project\hadoop-yarn\hadoop-yarn-server\hadoop-yarn-server-common\src\main\java\org\apache\hadoop\yarn\server\scheduler\ResourceRequestSetKey.java,102,23,3,1,0,27
hadoop-trunk\hadoop-trunk\hadoop-hdfs-project\hadoop-hdfs\src\main\java\org\apache\hadoop\hdfs\server\protocol\ReplicaRecoveryInfo.java,29,14,2,2,0,18
hadoop-trunk\hadoop-trunk\hadoop-yarn-project\hadoop-yarn\hadoop-yarn-server\hadoop-yarn-server-nodemanager\src\main\java\org\apache\hadoop\yarn\server\nodemanager\NMAuditLogger.java,175,102,1,6,0,109
hadoop-trunk\hadoop-trunk\hadoop-yarn-project\hadoop-yarn\hadoop-yarn-server\hadoop-yarn-server-resourcemanager\src\test\java\org\apache\hadoop\yarn\server\resourcemanager\scheduler\capacity\TestReservationQueue.java,89,31,3,4,0,38
hadoop-trunk\hadoop-trunk\hadoop-hdfs-project\hadoop-hdfs\src\test\java\org\apache\hadoop\hdfs\server\diskbalancer\command\TestDiskBalancerCommand.java,889,110,50,3,0,163
hadoop-trunk\hadoop-trunk\hadoop-tools\hadoop-datajoin\src\test\java\org\apache\hadoop\contrib\utils\join\SampleTaggedMapOutput.java,27,14,2,1,0,17
hadoop-trunk\hadoop-trunk\hadoop-common-project\hadoop-common\src\main\java\org\apache\hadoop\security\authorize\PolicyProvider.java,26,4,1,1,0,6
hadoop-trunk\hadoop-trunk\hadoop-yarn-project\hadoop-yarn\hadoop-yarn-api\src\main\java\org\apache\hadoop\yarn\api\records\NodeReport.java,228,67,2,2,0,71
hadoop-trunk\hadoop-trunk\hadoop-yarn-project\hadoop-yarn\hadoop-yarn-server\hadoop-yarn-server-common\src\main\java\org\apache\hadoop\yarn\server\federation\store\records\impl\pb\GetApplicationHomeSubClusterResponsePBImpl.java,0,18,35,6,0,59
hadoop-trunk\hadoop-trunk\hadoop-common-project\hadoop-auth\src\main\java\org\apache\hadoop\security\authentication\server\AuthenticationFilter.java,637,94,10,33,0,137
hadoop-trunk\hadoop-trunk\hadoop-mapreduce-project\hadoop-mapreduce-client\hadoop-mapreduce-client-jobclient\src\test\java\org\apache\hadoop\fs\slive\DataHasher.java,0,8,0,1,0,9
hadoop-trunk\hadoop-trunk\hadoop-hdfs-project\hadoop-hdfs\src\test\java\org\apache\hadoop\hdfs\TestBlockStoragePolicy.java,0,402,15,83,0,500
hadoop-trunk\hadoop-trunk\hadoop-common-project\hadoop-common\src\main\java\org\apache\hadoop\fs\ZeroCopyUnavailableException.java,16,7,0,1,0,8
hadoop-trunk\hadoop-trunk\hadoop-common-project\hadoop-common\src\test\java\org\apache\hadoop\fs\loadGenerator\LoadGenerator.java,619,301,35,8,0,344
hadoop-trunk\hadoop-trunk\hadoop-tools\hadoop-resourceestimator\src\main\java\org\apache\hadoop\resourceestimator\service\ResourceEstimatorServer.java,0,10,3,2,0,15
hadoop-trunk\hadoop-trunk\hadoop-common-project\hadoop-common\src\test\java\org\apache\hadoop\fs\TestFsShellTouch.java,179,28,8,1,0,37
hadoop-trunk\hadoop-trunk\hadoop-yarn-project\hadoop-yarn\hadoop-yarn-server\hadoop-yarn-server-resourcemanager\src\main\java\org\apache\hadoop\yarn\server\resourcemanager\webapp\dao\ReservationRequestsInfo.java,39,18,4,1,0,23
hadoop-trunk\hadoop-trunk\hadoop-common-project\hadoop-common\src\main\java\org\apache\hadoop\io\nativeio\SharedFileDescriptorFactory.java,100,26,2,1,0,29
hadoop-trunk\hadoop-trunk\hadoop-tools\hadoop-aws\src\main\java\org\apache\hadoop\fs\s3a\commit\staging\package-info.java,0,0,0,1,0,1
hadoop-trunk\hadoop-trunk\hadoop-yarn-project\hadoop-yarn\hadoop-yarn-server\hadoop-yarn-server-resourcemanager\src\main\java\org\apache\hadoop\yarn\server\resourcemanager\scheduler\fair\FSLeafQueue.java,645,95,9,4,0,108
hadoop-trunk\hadoop-trunk\hadoop-hdfs-project\hadoop-hdfs\src\main\java\org\apache\hadoop\hdfs\server\datanode\metrics\FSDatasetMBean.java,0,34,11,1,0,46
hadoop-trunk\hadoop-trunk\hadoop-tools\hadoop-openstack\src\main\java\org\apache\hadoop\fs\swift\auth\Roles.java,73,31,0,1,0,32
hadoop-trunk\hadoop-trunk\hadoop-yarn-project\hadoop-yarn\hadoop-yarn-server\hadoop-yarn-server-nodemanager\src\main\java\org\apache\hadoop\yarn\server\nodemanager\containermanager\launcher\RecoveredContainerLaunch.java,94,16,8,8,0,32
hadoop-trunk\hadoop-trunk\hadoop-yarn-project\hadoop-yarn\hadoop-yarn-server\hadoop-yarn-server-resourcemanager\src\main\java\org\apache\hadoop\yarn\server\resourcemanager\preprocessor\package-info.java,0,1,0,1,0,2
hadoop-trunk\hadoop-trunk\hadoop-common-project\hadoop-auth\src\test\java\org\apache\hadoop\security\authentication\server\TestMultiSchemeAuthenticationHandler.java,0,20,3,9,0,32
hadoop-trunk\hadoop-trunk\hadoop-common-project\hadoop-nfs\src\main\java\org\apache\hadoop\portmap\RpcProgramPortmap.java,0,57,6,3,0,66
hadoop-trunk\hadoop-trunk\hadoop-tools\hadoop-rumen\src\main\java\org\apache\hadoop\tools\rumen\Hadoop20JHParser.java,178,34,3,1,0,38
hadoop-trunk\hadoop-trunk\hadoop-maven-plugins\src\main\java\org\apache\hadoop\maven\plugin\protoc\ProtocRunner.java,243,41,2,1,0,44
hadoop-trunk\hadoop-trunk\hadoop-hdfs-project\hadoop-hdfs\src\main\java\org\apache\hadoop\hdfs\server\namenode\snapshot\DirectoryWithSnapshotFeature.java,0,189,5,7,0,201
hadoop-trunk\hadoop-trunk\hadoop-yarn-project\hadoop-yarn\hadoop-yarn-server\hadoop-yarn-server-nodemanager\src\main\java\org\apache\hadoop\yarn\server\nodemanager\amrmproxy\AMRMProxyMetrics.java,0,33,2,1,0,36
hadoop-trunk\hadoop-trunk\hadoop-yarn-project\hadoop-yarn\hadoop-yarn-server\hadoop-yarn-server-resourcemanager\src\main\java\org\apache\hadoop\yarn\server\resourcemanager\webapp\RMWebServices.java,2718,328,63,60,0,451
hadoop-trunk\hadoop-trunk\hadoop-yarn-project\hadoop-yarn\hadoop-yarn-server\hadoop-yarn-server-resourcemanager\src\test\java\org\apache\hadoop\yarn\server\resourcemanager\scheduler\capacity\TestCapacitySchedulerApps.java,1385,158,61,65,0,284
hadoop-trunk\hadoop-trunk\hadoop-mapreduce-project\hadoop-mapreduce-client\hadoop-mapreduce-client-core\src\main\java\org\apache\hadoop\mapred\lib\CombineFileRecordReaderWrapper.java,0,28,0,1,0,29
hadoop-trunk\hadoop-trunk\hadoop-yarn-project\hadoop-yarn\hadoop-yarn-server\hadoop-yarn-server-resourcemanager\src\main\java\org\apache\hadoop\yarn\server\resourcemanager\volume\csi\event\VolumeEvent.java,18,9,0,2,0,11
hadoop-trunk\hadoop-trunk\hadoop-hdfs-project\hadoop-hdfs\src\main\java\org\apache\hadoop\hdfs\server\blockmanagement\BlockPlacementPolicyRackFaultTolerant.java,224,57,4,3,0,64
hadoop-trunk\hadoop-trunk\hadoop-mapreduce-project\hadoop-mapreduce-client\hadoop-mapreduce-client-jobclient\src\test\java\org\apache\hadoop\mapreduce\lib\output\TestJobOutputCommitter.java,248,67,4,5,0,76
hadoop-trunk\hadoop-trunk\hadoop-common-project\hadoop-common\src\test\java\org\apache\hadoop\test\TestMultithreadedTestUtil.java,110,18,1,1,0,20
hadoop-trunk\hadoop-trunk\hadoop-tools\hadoop-streaming\src\main\java\org\apache\hadoop\streaming\StreamBaseRecordReader.java,0,83,7,9,0,99
hadoop-trunk\hadoop-trunk\hadoop-tools\hadoop-aws\src\test\java\org\apache\hadoop\fs\s3a\scale\ITestS3AInputStreamPerformance.java,580,89,22,9,0,120
hadoop-trunk\hadoop-trunk\hadoop-yarn-project\hadoop-yarn\hadoop-yarn-server\hadoop-yarn-server-resourcemanager\src\main\java\org\apache\hadoop\yarn\server\resourcemanager\AdminService.java,0,106,13,38,0,157
hadoop-trunk\hadoop-trunk\hadoop-yarn-project\hadoop-yarn\hadoop-yarn-server\hadoop-yarn-server-sharedcachemanager\src\main\java\org\apache\hadoop\yarn\server\sharedcachemanager\store\SharedCacheResourceReference.java,58,23,7,2,0,32
hadoop-trunk\hadoop-trunk\hadoop-yarn-project\hadoop-yarn\hadoop-yarn-server\hadoop-yarn-server-timelineservice\src\main\java\org\apache\hadoop\yarn\server\timelineservice\reader\TimelineUIDConverter.java,0,42,0,1,0,43
hadoop-trunk\hadoop-trunk\hadoop-hdfs-project\hadoop-hdfs\src\test\java\org\apache\hadoop\hdfs\TestReconstructStripedFileWithValidator.java,0,7,1,1,0,9
hadoop-trunk\hadoop-trunk\hadoop-common-project\hadoop-common\src\main\java\org\apache\hadoop\util\functional\CallableRaisingIOE.java,0,0,0,1,0,1
hadoop-trunk\hadoop-trunk\hadoop-tools\hadoop-dynamometer\hadoop-dynamometer-infra\src\main\java\org\apache\hadoop\tools\dynamometer\DynoResource.java,0,12,0,1,0,13
hadoop-trunk\hadoop-trunk\hadoop-hdfs-project\hadoop-hdfs\src\main\java\org\apache\hadoop\hdfs\server\namenode\ha\StandbyState.java,0,26,4,3,0,33
hadoop-trunk\hadoop-trunk\hadoop-yarn-project\hadoop-yarn\hadoop-yarn-server\hadoop-yarn-server-resourcemanager\src\main\java\org\apache\hadoop\yarn\server\resourcemanager\security\CapacityReservationsACLsManager.java,17,3,0,4,0,7
hadoop-trunk\hadoop-trunk\hadoop-mapreduce-project\hadoop-mapreduce-examples\src\main\java\org\apache\hadoop\examples\terasort\TeraOutputFormat.java,0,29,0,1,0,30
hadoop-trunk\hadoop-trunk\hadoop-common-project\hadoop-common\src\main\java\org\apache\hadoop\util\PerformanceAdvisory.java,5,2,0,1,0,3
hadoop-trunk\hadoop-trunk\hadoop-yarn-project\hadoop-yarn\hadoop-yarn-server\hadoop-yarn-server-common\src\test\java\org\apache\hadoop\yarn\TestResourceTrackerPBClientImpl.java,130,32,2,7,0,41
hadoop-trunk\hadoop-trunk\hadoop-common-project\hadoop-common\src\test\java\org\apache\hadoop\io\erasurecode\rawcoder\TestDecodingValidator.java,196,31,2,1,0,34
hadoop-trunk\hadoop-trunk\hadoop-tools\hadoop-azure\src\main\java\org\apache\hadoop\fs\azurebfs\utils\TracingContext.java,135,58,4,3,0,65
hadoop-trunk\hadoop-trunk\hadoop-tools\hadoop-resourceestimator\src\main\java\org\apache\hadoop\resourceestimator\common\serialization\package-info.java,0,0,0,1,0,1
hadoop-trunk\hadoop-trunk\hadoop-common-project\hadoop-nfs\src\main\java\org\apache\hadoop\nfs\nfs3\response\FSINFO3Response.java,0,50,2,1,0,53
hadoop-trunk\hadoop-trunk\hadoop-common-project\hadoop-common\src\main\java\org\apache\hadoop\metrics2\impl\SinkQueue.java,0,23,4,1,0,28
hadoop-trunk\hadoop-trunk\hadoop-mapreduce-project\hadoop-mapreduce-client\hadoop-mapreduce-client-jobclient\src\test\java\org\apache\hadoop\mapred\pipes\CommonStub.java,118,21,2,3,0,26
hadoop-trunk\hadoop-trunk\hadoop-common-project\hadoop-common\src\test\java\org\apache\hadoop\security\TestLdapGroupsMappingBase.java,198,39,3,3,0,45
hadoop-trunk\hadoop-trunk\hadoop-hdfs-project\hadoop-hdfs\src\main\java\org\apache\hadoop\hdfs\server\common\ECTopologyVerifier.java,0,9,0,1,0,10
hadoop-trunk\hadoop-trunk\hadoop-common-project\hadoop-nfs\src\main\java\org\apache\hadoop\nfs\nfs3\request\SYMLINK3Request.java,45,24,0,1,0,25
hadoop-trunk\hadoop-trunk\hadoop-hdfs-project\hadoop-hdfs\src\main\java\org\apache\hadoop\hdfs\server\namenode\FSDirRenameOp.java,0,181,20,5,0,206
hadoop-trunk\hadoop-trunk\hadoop-hdfs-project\hadoop-hdfs\src\main\java\org\apache\hadoop\hdfs\qjournal\client\AsyncLoggerSet.java,0,66,26,8,0,100
hadoop-trunk\hadoop-trunk\hadoop-yarn-project\hadoop-yarn\hadoop-yarn-common\src\main\java\org\apache\hadoop\yarn\logaggregation\filecontroller\ifile\LogAggregationIndexedFileController.java,0,279,33,3,0,315
hadoop-trunk\hadoop-trunk\hadoop-yarn-project\hadoop-yarn\hadoop-yarn-server\hadoop-yarn-server-nodemanager\src\main\java\org\apache\hadoop\yarn\server\nodemanager\containermanager\records\AuxServiceConfiguration.java,98,38,2,1,0,41
hadoop-trunk\hadoop-trunk\hadoop-common-project\hadoop-common\src\test\java\org\apache\hadoop\security\TestCompositeGroupMapping.java,179,82,17,14,0,113
hadoop-trunk\hadoop-trunk\hadoop-yarn-project\hadoop-yarn\hadoop-yarn-common\src\main\java\org\apache\hadoop\yarn\package-info.java,0,1,0,1,0,2
hadoop-trunk\hadoop-trunk\hadoop-hdfs-project\hadoop-hdfs\src\test\java\org\apache\hadoop\hdfs\server\datanode\TestDeleteBlockPool.java,157,35,1,2,0,38
hadoop-trunk\hadoop-trunk\hadoop-yarn-project\hadoop-yarn\hadoop-yarn-server\hadoop-yarn-server-common\src\main\java\org\apache\hadoop\yarn\server\volume\csi\exception\package-info.java,0,1,0,1,0,2
hadoop-trunk\hadoop-trunk\hadoop-yarn-project\hadoop-yarn\hadoop-yarn-server\hadoop-yarn-server-router\src\main\java\org\apache\hadoop\yarn\server\router\webapp\RouterWebApp.java,26,5,0,1,0,6
hadoop-trunk\hadoop-trunk\hadoop-mapreduce-project\hadoop-mapreduce-client\hadoop-mapreduce-client-core\src\main\java\org\apache\hadoop\mapred\lib\NullOutputFormat.java,0,19,3,1,0,23
hadoop-trunk\hadoop-trunk\hadoop-yarn-project\hadoop-yarn\hadoop-yarn-applications\hadoop-yarn-services\hadoop-yarn-services-core\src\main\java\org\apache\hadoop\yarn\service\monitor\probe\PortProbe.java,62,15,2,1,0,18
hadoop-trunk\hadoop-trunk\hadoop-tools\hadoop-azure\src\test\java\org\apache\hadoop\fs\azure\ITestNativeAzureFileSystemConcurrencyLive.java,0,16,1,4,0,21
hadoop-trunk\hadoop-trunk\hadoop-yarn-project\hadoop-yarn\hadoop-yarn-server\hadoop-yarn-server-timelineservice\src\test\java\org\apache\hadoop\yarn\server\timelineservice\storage\DummyTimelineSchemaCreator.java,7,2,1,1,0,4
hadoop-trunk\hadoop-trunk\hadoop-hdfs-project\hadoop-hdfs-client\src\main\java\org\apache\hadoop\hdfs\security\token\block\DataEncryptionKey.java,25,27,0,1,0,28
hadoop-trunk\hadoop-trunk\hadoop-yarn-project\hadoop-yarn\hadoop-yarn-applications\hadoop-yarn-services\hadoop-yarn-services-core\src\main\java\org\apache\hadoop\yarn\service\api\records\LocalizationStatus.java,95,16,0,1,0,17
hadoop-trunk\hadoop-trunk\hadoop-common-project\hadoop-common\src\main\java\org\apache\hadoop\io\erasurecode\coder\HHXORErasureEncoder.java,50,6,0,1,0,7
hadoop-trunk\hadoop-trunk\hadoop-common-project\hadoop-common\src\main\java\org\apache\hadoop\security\LdapGroupsMapping.java,0,222,22,16,0,260
hadoop-trunk\hadoop-trunk\hadoop-yarn-project\hadoop-yarn\hadoop-yarn-server\hadoop-yarn-server-common\src\main\java\org\apache\hadoop\yarn\server\webapp\WebPageUtils.java,0,16,1,2,0,19
hadoop-trunk\hadoop-trunk\hadoop-common-project\hadoop-common\src\test\java\org\apache\hadoop\util\TestZKUtil.java,110,28,1,1,0,30
hadoop-trunk\hadoop-trunk\hadoop-common-project\hadoop-common\src\main\java\org\apache\hadoop\security\ShellBasedUnixGroupsMapping.java,0,37,5,1,0,43
hadoop-trunk\hadoop-trunk\hadoop-hdfs-project\hadoop-hdfs\src\test\java\org\apache\hadoop\hdfs\server\balancer\TestBalancerWithHANameNodes.java,338,33,3,3,0,39
hadoop-trunk\hadoop-trunk\hadoop-yarn-project\hadoop-yarn\hadoop-yarn-applications\hadoop-yarn-services\hadoop-yarn-services-core\src\main\java\org\apache\hadoop\yarn\service\component\ComponentEvent.java,100,67,0,1,0,68
hadoop-trunk\hadoop-trunk\hadoop-mapreduce-project\hadoop-mapreduce-client\hadoop-mapreduce-client-app\src\main\java\org\apache\hadoop\mapred\YarnChild.java,0,39,20,5,0,64
hadoop-trunk\hadoop-trunk\hadoop-hdfs-project\hadoop-hdfs\src\test\java\org\apache\hadoop\hdfs\server\datanode\TestDataStorage.java,222,38,0,2,0,40
hadoop-trunk\hadoop-trunk\hadoop-tools\hadoop-aws\src\main\java\org\apache\hadoop\fs\s3a\S3AReadOpContext.java,115,16,0,1,0,17
hadoop-trunk\hadoop-trunk\hadoop-tools\hadoop-openstack\src\test\java\org\apache\hadoop\fs\swift\scale\TestWriteManySmallFiles.java,69,5,5,1,0,11
hadoop-trunk\hadoop-trunk\hadoop-yarn-project\hadoop-yarn\hadoop-yarn-server\hadoop-yarn-server-nodemanager\src\main\java\org\apache\hadoop\yarn\server\nodemanager\containermanager\linux\runtime\runc\package-info.java,0,0,0,2,0,2
hadoop-trunk\hadoop-trunk\hadoop-hdfs-project\hadoop-hdfs\src\test\java\org\apache\hadoop\hdfs\server\datanode\checker\TestDatasetVolumeCheckerTimeout.java,78,14,7,1,0,22
hadoop-trunk\hadoop-trunk\hadoop-yarn-project\hadoop-yarn\hadoop-yarn-common\src\main\java\org\apache\hadoop\yarn\api\records\impl\pb\NodeReportPBImpl.java,428,91,105,1,0,197
hadoop-trunk\hadoop-trunk\hadoop-common-project\hadoop-common\src\main\java\org\apache\hadoop\fs\InvalidPathException.java,24,2,0,1,0,3
hadoop-trunk\hadoop-trunk\hadoop-yarn-project\hadoop-yarn\hadoop-yarn-server\hadoop-yarn-server-nodemanager\src\main\java\org\apache\hadoop\yarn\server\nodemanager\api\impl\pb\client\LocalizationProtocolPBClientImpl.java,33,14,3,8,0,25
hadoop-trunk\hadoop-trunk\hadoop-yarn-project\hadoop-yarn\hadoop-yarn-server\hadoop-yarn-server-resourcemanager\src\main\java\org\apache\hadoop\yarn\server\resourcemanager\scheduler\event\AppRemovedSchedulerEvent.java,21,11,0,1,0,12
hadoop-trunk\hadoop-trunk\hadoop-tools\hadoop-aws\src\test\java\org\apache\hadoop\fs\s3a\commit\TestMagicCommitPaths.java,210,55,3,1,0,59
hadoop-trunk\hadoop-trunk\hadoop-tools\hadoop-azure\src\test\java\org\apache\hadoop\fs\azurebfs\ITestAzureBlobFileSystemFileStatus.java,113,20,0,7,0,27
hadoop-trunk\hadoop-trunk\hadoop-yarn-project\hadoop-yarn\hadoop-yarn-server\hadoop-yarn-server-nodemanager\src\main\java\org\apache\hadoop\yarn\server\nodemanager\scheduler\DistributedScheduler.java,0,37,1,11,0,49
hadoop-trunk\hadoop-trunk\hadoop-yarn-project\hadoop-yarn\hadoop-yarn-server\hadoop-yarn-server-nodemanager\src\main\java\org\apache\hadoop\yarn\server\nodemanager\recovery\NMStateStoreService.java,753,220,31,10,0,261
hadoop-trunk\hadoop-trunk\hadoop-yarn-project\hadoop-yarn\hadoop-yarn-server\hadoop-yarn-server-nodemanager\src\test\java\org\apache\hadoop\yarn\server\nodemanager\containermanager\localizer\TestResourceLocalizationService.java,3077,277,96,57,0,430
hadoop-trunk\hadoop-trunk\hadoop-yarn-project\hadoop-yarn\hadoop-yarn-server\hadoop-yarn-server-common\src\main\java\org\apache\hadoop\yarn\server\timeline\security\package-info.java,0,1,0,1,0,2
hadoop-trunk\hadoop-trunk\hadoop-cloud-storage-project\hadoop-huaweicloud\src\test\java\org\apache\hadoop\fs\obs\TestOBSFileContextCreateMkdir.java,38,3,3,1,0,7
hadoop-trunk\hadoop-trunk\hadoop-tools\hadoop-aws\src\main\java\org\apache\hadoop\fs\s3a\impl\ChangeTracker.java,265,17,1,1,0,19
hadoop-trunk\hadoop-trunk\hadoop-yarn-project\hadoop-yarn\hadoop-yarn-server\hadoop-yarn-server-resourcemanager\src\test\java\org\apache\hadoop\yarn\server\resourcemanager\MockAM.java,428,213,5,7,0,225
hadoop-trunk\hadoop-trunk\hadoop-tools\hadoop-azure\src\main\java\org\apache\hadoop\fs\azure\security\WasbDelegationTokenManager.java,0,3,0,2,0,5
hadoop-trunk\hadoop-trunk\hadoop-yarn-project\hadoop-yarn\hadoop-yarn-server\hadoop-yarn-server-nodemanager\src\main\java\org\apache\hadoop\yarn\server\nodemanager\security\NMContainerTokenSecretManager.java,218,36,6,4,0,46
hadoop-trunk\hadoop-trunk\hadoop-yarn-project\hadoop-yarn\hadoop-yarn-server\hadoop-yarn-server-nodemanager\src\main\java\org\apache\hadoop\yarn\server\nodemanager\containermanager\monitor\ContainerMetrics.java,324,129,1,1,0,131
hadoop-trunk\hadoop-trunk\hadoop-hdfs-project\hadoop-hdfs\src\test\java\org\apache\hadoop\hdfs\TestDatanodeLayoutUpgrade.java,48,6,0,1,0,7
hadoop-trunk\hadoop-trunk\hadoop-common-project\hadoop-common\src\main\java\org\apache\hadoop\io\VersionMismatchException.java,18,8,0,1,0,9
hadoop-trunk\hadoop-trunk\hadoop-common-project\hadoop-registry\src\test\java\org\apache\hadoop\registry\secure\TestSecureLogins.java,182,19,3,7,0,29
hadoop-trunk\hadoop-trunk\hadoop-common-project\hadoop-common\src\main\java\org\apache\hadoop\fs\viewfs\ViewFs.java,1321,265,19,5,0,289
hadoop-trunk\hadoop-trunk\hadoop-yarn-project\hadoop-yarn\hadoop-yarn-applications\hadoop-yarn-applications-distributedshell\src\test\java\org\apache\hadoop\yarn\applications\distributedshell\DistributedShellBaseTest.java,528,100,8,1,0,109
hadoop-trunk\hadoop-trunk\hadoop-yarn-project\hadoop-yarn\hadoop-yarn-server\hadoop-yarn-server-nodemanager\src\main\java\org\apache\hadoop\yarn\server\nodemanager\containermanager\deletion\task\DeletionTask.java,226,35,6,3,0,44
hadoop-trunk\hadoop-trunk\hadoop-hdfs-project\hadoop-hdfs\src\test\java\org\apache\hadoop\hdfs\util\TestLightWeightLinkedSet.java,401,70,7,1,0,78
hadoop-trunk\hadoop-trunk\hadoop-hdfs-project\hadoop-hdfs-rbf\src\main\java\org\apache\hadoop\hdfs\tools\federation\RouterAdmin.java,1249,90,46,30,0,166
hadoop-trunk\hadoop-trunk\hadoop-yarn-project\hadoop-yarn\hadoop-yarn-common\src\main\java\org\apache\hadoop\yarn\api\records\impl\pb\ContainerStatusPBImpl.java,346,70,98,1,0,169
hadoop-trunk\hadoop-trunk\hadoop-hdfs-project\hadoop-hdfs-client\src\main\java\org\apache\hadoop\hdfs\client\CreateEncryptionZoneFlag.java,0,6,0,1,0,7
hadoop-trunk\hadoop-trunk\hadoop-mapreduce-project\hadoop-mapreduce-client\hadoop-mapreduce-client-hs\src\main\java\org\apache\hadoop\mapreduce\v2\hs\webapp\HsTasksPage.java,0,48,0,2,0,50
hadoop-trunk\hadoop-trunk\hadoop-hdfs-project\hadoop-hdfs-rbf\src\test\java\org\apache\hadoop\hdfs\server\federation\store\records\TestMembershipState.java,136,38,0,3,0,41
hadoop-trunk\hadoop-trunk\hadoop-mapreduce-project\hadoop-mapreduce-client\hadoop-mapreduce-client-jobclient\src\test\java\org\apache\hadoop\RandomTextWriterJob.java,715,126,6,3,0,135
hadoop-trunk\hadoop-trunk\hadoop-common-project\hadoop-common\src\test\java\org\apache\hadoop\service\launcher\testservices\FailingStopInStartService.java,25,6,1,2,0,9
hadoop-trunk\hadoop-trunk\hadoop-yarn-project\hadoop-yarn\hadoop-yarn-server\hadoop-yarn-server-resourcemanager\src\main\java\org\apache\hadoop\yarn\server\resourcemanager\rmapp\monitor\package-info.java,0,0,0,1,0,1
hadoop-trunk\hadoop-trunk\hadoop-yarn-project\hadoop-yarn\hadoop-yarn-api\src\main\java\org\apache\hadoop\yarn\api\protocolrecords\FinishApplicationMasterRequest.java,80,9,0,4,0,13
hadoop-trunk\hadoop-trunk\hadoop-common-project\hadoop-nfs\src\main\java\org\apache\hadoop\oncrpc\SimpleUdpClient.java,63,53,1,1,0,55
hadoop-trunk\hadoop-trunk\hadoop-yarn-project\hadoop-yarn\hadoop-yarn-api\src\main\java\org\apache\hadoop\yarn\exceptions\ResourceProfilesNotEnabledException.java,17,7,0,1,0,8
hadoop-trunk\hadoop-trunk\hadoop-mapreduce-project\hadoop-mapreduce-examples\src\main\java\org\apache\hadoop\examples\WordMean.java,159,33,3,2,0,38
hadoop-trunk\hadoop-trunk\hadoop-tools\hadoop-azure\src\test\java\org\apache\hadoop\fs\azurebfs\services\ITestAbfsInputStreamReadFooter.java,317,43,1,6,0,50
hadoop-trunk\hadoop-trunk\hadoop-yarn-project\hadoop-yarn\hadoop-yarn-common\src\main\java\org\apache\hadoop\yarn\server\api\protocolrecords\impl\pb\UpdateNodeResourceResponsePBImpl.java,45,22,18,5,0,45
hadoop-trunk\hadoop-trunk\hadoop-tools\hadoop-azure\src\test\java\org\apache\hadoop\fs\azurebfs\extensions\StubDelegationTokenManager.java,0,3,4,4,0,11
hadoop-trunk\hadoop-trunk\hadoop-yarn-project\hadoop-yarn\hadoop-yarn-api\src\main\java\org\apache\hadoop\yarn\api\protocolrecords\ReleaseSharedCacheResourceResponse.java,3,0,1,1,0,2
hadoop-trunk\hadoop-trunk\hadoop-yarn-project\hadoop-yarn\hadoop-yarn-applications\hadoop-yarn-services\hadoop-yarn-services-core\src\main\java\org\apache\hadoop\yarn\service\api\records\Artifact.java,126,50,2,4,0,56
hadoop-trunk\hadoop-trunk\hadoop-yarn-project\hadoop-yarn\hadoop-yarn-common\src\main\java\org\apache\hadoop\yarn\util\BoundedAppender.java,75,8,1,1,0,10
hadoop-trunk\hadoop-trunk\hadoop-yarn-project\hadoop-yarn\hadoop-yarn-server\hadoop-yarn-server-common\src\test\java\org\apache\hadoop\yarn\server\federation\policies\router\TestPriorityRouterPolicy.java,74,11,0,3,0,14
hadoop-trunk\hadoop-trunk\hadoop-common-project\hadoop-common\src\test\java\org\apache\hadoop\util\ClassLoaderCheckThird.java,0,3,0,1,0,4
hadoop-trunk\hadoop-trunk\hadoop-hdfs-project\hadoop-hdfs\src\main\java\org\apache\hadoop\hdfs\tools\offlineImageViewer\IgnoreSnapshotException.java,5,1,3,1,0,5
hadoop-trunk\hadoop-trunk\hadoop-hdfs-project\hadoop-hdfs-rbf\src\test\java\org\apache\hadoop\fs\contract\router\TestRouterHDFSContractSetTimesSecure.java,0,4,0,1,0,5
hadoop-trunk\hadoop-trunk\hadoop-tools\hadoop-resourceestimator\src\main\java\org\apache\hadoop\resourceestimator\skylinestore\exceptions\NullPipelineIdException.java,8,1,0,1,0,2
hadoop-trunk\hadoop-trunk\hadoop-tools\hadoop-sls\src\main\java\org\apache\hadoop\yarn\sls\resourcemanager\MockAMLauncher.java,0,11,2,5,0,18
hadoop-trunk\hadoop-trunk\hadoop-mapreduce-project\hadoop-mapreduce-client\hadoop-mapreduce-client-core\src\main\java\org\apache\hadoop\mapred\FileOutputCommitter.java,174,88,11,7,0,106
hadoop-trunk\hadoop-trunk\hadoop-common-project\hadoop-kms\src\main\java\org\apache\hadoop\crypto\key\kms\server\KMS.java,667,83,13,3,0,99
hadoop-trunk\hadoop-trunk\hadoop-hdfs-project\hadoop-hdfs\src\test\java\org\apache\hadoop\hdfs\server\namenode\TestFavoredNodesEndToEnd.java,236,83,8,3,0,94
hadoop-trunk\hadoop-trunk\hadoop-mapreduce-project\hadoop-mapreduce-client\hadoop-mapreduce-client-core\src\main\java\org\apache\hadoop\mapreduce\lib\aggregate\ValueAggregatorJobBase.java,0,21,9,3,0,33
hadoop-trunk\hadoop-trunk\hadoop-hdfs-project\hadoop-hdfs\src\main\java\org\apache\hadoop\hdfs\server\namenode\sps\StoragePolicySatisfier.java,0,165,20,2,0,187
hadoop-trunk\hadoop-trunk\hadoop-mapreduce-project\hadoop-mapreduce-client\hadoop-mapreduce-client-hs\src\main\java\org\apache\hadoop\mapreduce\v2\hs\CompletedJob.java,0,108,7,10,0,125
hadoop-trunk\hadoop-trunk\hadoop-tools\hadoop-aws\src\main\java\org\apache\hadoop\fs\s3a\select\InternalSelectConstants.java,0,1,1,1,0,3
hadoop-trunk\hadoop-trunk\hadoop-tools\hadoop-rumen\src\main\java\org\apache\hadoop\tools\rumen\JobHistoryUtils.java,134,11,8,1,0,20
hadoop-trunk\hadoop-trunk\hadoop-yarn-project\hadoop-yarn\hadoop-yarn-server\hadoop-yarn-server-resourcemanager\src\test\java\org\apache\hadoop\yarn\server\resourcemanager\scheduler\fair\TestFairSchedulerWithMultiResourceTypes.java,0,18,0,2,0,20
hadoop-trunk\hadoop-trunk\hadoop-common-project\hadoop-common\src\test\java\org\apache\hadoop\service\launcher\TestServiceInterruptHandling.java,0,14,0,1,0,15
hadoop-trunk\hadoop-trunk\hadoop-common-project\hadoop-common\src\main\java\org\apache\hadoop\io\EnumSetWritable.java,0,47,13,3,0,63
hadoop-trunk\hadoop-trunk\hadoop-yarn-project\hadoop-yarn\hadoop-yarn-server\hadoop-yarn-server-common\src\main\java\org\apache\hadoop\yarn\server\api\protocolrecords\ReportNewCollectorInfoRequest.java,26,8,0,1,0,9
hadoop-trunk\hadoop-trunk\hadoop-tools\hadoop-azure\src\main\java\org\apache\hadoop\fs\azurebfs\services\AbfsOutputStream.java,0,81,14,30,0,125
hadoop-trunk\hadoop-trunk\hadoop-yarn-project\hadoop-yarn\hadoop-yarn-server\hadoop-yarn-server-nodemanager\src\main\java\org\apache\hadoop\yarn\server\nodemanager\containermanager\resourceplugin\deviceframework\DeviceMappingManager.java,355,70,4,5,0,79
hadoop-trunk\hadoop-trunk\hadoop-common-project\hadoop-common\src\main\java\org\apache\hadoop\fs\shell\find\Name.java,0,16,0,1,0,17
hadoop-trunk\hadoop-trunk\hadoop-mapreduce-project\hadoop-mapreduce-client\hadoop-mapreduce-client-core\src\main\java\org\apache\hadoop\mapreduce\util\JobHistoryEventUtils.java,0,10,0,1,0,11
hadoop-trunk\hadoop-trunk\hadoop-hdfs-project\hadoop-hdfs\src\main\java\org\apache\hadoop\hdfs\server\diskbalancer\DiskBalancerConstants.java,0,3,0,1,0,4
hadoop-trunk\hadoop-trunk\hadoop-yarn-project\hadoop-yarn\hadoop-yarn-server\hadoop-yarn-server-nodemanager\src\main\java\org\apache\hadoop\yarn\server\nodemanager\containermanager\container\ContainerPauseEvent.java,0,7,0,1,0,8
hadoop-trunk\hadoop-trunk\hadoop-yarn-project\hadoop-yarn\hadoop-yarn-server\hadoop-yarn-server-nodemanager\src\main\java\org\apache\hadoop\yarn\server\nodemanager\containermanager\resourceplugin\deviceframework\DeviceResourceUpdaterImpl.java,35,11,3,3,0,17
hadoop-trunk\hadoop-trunk\hadoop-tools\hadoop-azure\src\main\java\org\apache\hadoop\fs\azurebfs\contracts\services\AppendRequestParameters.java,53,29,0,1,0,30
hadoop-trunk\hadoop-trunk\hadoop-yarn-project\hadoop-yarn\hadoop-yarn-server\hadoop-yarn-server-resourcemanager\src\main\java\org\apache\hadoop\yarn\server\resourcemanager\scheduler\capacity\conf\LeveldbConfigurationStore.java,264,51,11,1,0,63
hadoop-trunk\hadoop-trunk\hadoop-hdfs-project\hadoop-hdfs-client\src\main\java\org\apache\hadoop\hdfs\PeerCache.java,244,47,3,2,0,52
hadoop-trunk\hadoop-trunk\hadoop-yarn-project\hadoop-yarn\hadoop-yarn-api\src\main\java\org\apache\hadoop\yarn\api\records\SerializedException.java,86,11,0,1,0,12
hadoop-trunk\hadoop-trunk\hadoop-common-project\hadoop-common\src\test\java\org\apache\hadoop\util\TestApplicationClassLoader.java,107,18,3,2,0,23
hadoop-trunk\hadoop-trunk\hadoop-common-project\hadoop-common\src\test\java\org\apache\hadoop\ipc\TestCallQueueManager.java,479,137,11,7,0,155
hadoop-trunk\hadoop-trunk\hadoop-mapreduce-project\hadoop-mapreduce-client\hadoop-mapreduce-client-jobclient\src\test\java\testjar\ExternalWritable.java,0,35,3,1,0,39
hadoop-trunk\hadoop-trunk\hadoop-tools\hadoop-datajoin\src\test\java\org\apache\hadoop\contrib\utils\join\SampleDataJoinMapper.java,24,11,6,2,0,19
hadoop-trunk\hadoop-trunk\hadoop-common-project\hadoop-common\src\test\java\org\apache\hadoop\ipc\metrics\TestDecayRpcSchedulerDetailedMetrics.java,18,3,0,1,0,4
hadoop-trunk\hadoop-trunk\hadoop-yarn-project\hadoop-yarn\hadoop-yarn-common\src\main\java\org\apache\hadoop\yarn\util\StringHelper.java,0,48,3,1,0,52
hadoop-trunk\hadoop-trunk\hadoop-mapreduce-project\hadoop-mapreduce-client\hadoop-mapreduce-client-core\src\main\java\org\apache\hadoop\mapred\lib\MultipleSequenceFileOutputFormat.java,0,17,0,2,0,19
hadoop-trunk\hadoop-trunk\hadoop-yarn-project\hadoop-yarn\hadoop-yarn-common\src\main\java\org\apache\hadoop\yarn\factories\RpcServerFactory.java,0,4,1,1,0,6
hadoop-trunk\hadoop-trunk\hadoop-yarn-project\hadoop-yarn\hadoop-yarn-server\hadoop-yarn-server-timelineservice-hbase\hadoop-yarn-server-timelineservice-hbase-common\src\main\java\org\apache\hadoop\yarn\server\timelineservice\storage\application\ApplicationTable.java,0,0,0,1,0,1
hadoop-trunk\hadoop-trunk\hadoop-yarn-project\hadoop-yarn\hadoop-yarn-server\hadoop-yarn-server-common\src\test\java\org\apache\hadoop\yarn\server\federation\store\impl\TestMemoryFederationStateStore.java,0,2,0,1,0,3
hadoop-trunk\hadoop-trunk\hadoop-common-project\hadoop-common\src\test\java\org\apache\hadoop\security\TestKDiagNoKDC.java,81,30,21,4,0,55
hadoop-trunk\hadoop-trunk\hadoop-yarn-project\hadoop-yarn\hadoop-yarn-server\hadoop-yarn-server-resourcemanager\src\main\java\org\apache\hadoop\yarn\server\resourcemanager\scheduler\capacity\PlanQueue.java,161,27,1,4,0,32
hadoop-trunk\hadoop-trunk\hadoop-hdfs-project\hadoop-hdfs\src\test\java\org\apache\hadoop\hdfs\tools\TestDebugAdmin.java,226,49,3,8,0,60
hadoop-trunk\hadoop-trunk\hadoop-tools\hadoop-aws\src\test\java\org\apache\hadoop\fs\s3a\ITestS3AContractGetFileStatusV1List.java,0,4,0,1,0,5
hadoop-trunk\hadoop-trunk\hadoop-hdfs-project\hadoop-hdfs\src\test\java\org\apache\hadoop\hdfs\web\WebHdfsTestUtil.java,75,20,3,2,0,25
hadoop-trunk\hadoop-trunk\hadoop-common-project\hadoop-common\src\main\java\org\apache\hadoop\security\SecurityUtil.java,0,160,16,9,0,185
hadoop-trunk\hadoop-trunk\hadoop-common-project\hadoop-registry\src\main\java\org\apache\hadoop\registry\server\integration\SelectByYarnPersistence.java,0,13,1,1,0,15
hadoop-trunk\hadoop-trunk\hadoop-common-project\hadoop-common\src\main\java\org\apache\hadoop\metrics2\lib\MutableRates.java,43,17,3,1,0,21
hadoop-trunk\hadoop-trunk\hadoop-yarn-project\hadoop-yarn\hadoop-yarn-server\hadoop-yarn-server-resourcemanager\src\main\java\org\apache\hadoop\yarn\server\resourcemanager\webapp\dao\ActivityNodeInfo.java,113,52,1,4,0,57
hadoop-trunk\hadoop-trunk\hadoop-hdfs-project\hadoop-hdfs\src\test\java\org\apache\hadoop\hdfs\TestAppendDifferentChecksum.java,124,36,1,1,0,38
hadoop-trunk\hadoop-trunk\hadoop-mapreduce-project\hadoop-mapreduce-client\hadoop-mapreduce-client-core\src\main\java\org\apache\hadoop\mapreduce\task\reduce\MergeManagerImpl.java,0,363,39,10,0,412
hadoop-trunk\hadoop-trunk\hadoop-hdfs-project\hadoop-hdfs\src\test\java\org\apache\hadoop\hdfs\TestFileStatusWithDefaultECPolicy.java,69,11,3,1,0,15
hadoop-trunk\hadoop-trunk\hadoop-hdfs-project\hadoop-hdfs-client\src\main\java\org\apache\hadoop\hdfs\BlockMissingException.java,36,9,0,1,0,10
hadoop-trunk\hadoop-trunk\hadoop-hdfs-project\hadoop-hdfs-client\src\main\java\org\apache\hadoop\hdfs\protocol\DatanodeID.java,285,92,1,1,0,94
hadoop-trunk\hadoop-trunk\hadoop-tools\hadoop-openstack\src\main\java\org\apache\hadoop\fs\swift\util\SwiftUtils.java,0,39,1,4,0,44
hadoop-trunk\hadoop-trunk\hadoop-yarn-project\hadoop-yarn\hadoop-yarn-server\hadoop-yarn-server-timelineservice-documentstore\src\test\java\org\apache\hadoop\yarn\server\timelineservice\documentstore\collection\TestDocumentOperations.java,142,8,0,7,0,15
hadoop-trunk\hadoop-trunk\hadoop-yarn-project\hadoop-yarn\hadoop-yarn-server\hadoop-yarn-server-common\src\main\java\org\apache\hadoop\yarn\server\volume\csi\exception\InvalidVolumeException.java,7,2,0,1,0,3
hadoop-trunk\hadoop-trunk\hadoop-common-project\hadoop-common\src\main\java\org\apache\hadoop\fs\impl\WeakReferenceThreadMap.java,0,11,0,2,0,13
hadoop-trunk\hadoop-trunk\hadoop-hdfs-project\hadoop-hdfs\src\main\java\org\apache\hadoop\hdfs\tools\offlineImageViewer\ImageLoaderCurrent.java,0,236,7,16,0,259
hadoop-trunk\hadoop-trunk\hadoop-yarn-project\hadoop-yarn\hadoop-yarn-common\src\main\java\org\apache\hadoop\yarn\security\ContainerManagerSecurityInfo.java,31,7,0,1,0,8
hadoop-trunk\hadoop-trunk\hadoop-tools\hadoop-azure\src\test\java\org\apache\hadoop\fs\azure\contract\ITestAzureNativeContractGetFileStatus.java,0,2,0,1,0,3
hadoop-trunk\hadoop-trunk\hadoop-yarn-project\hadoop-yarn\hadoop-yarn-server\hadoop-yarn-server-timelineservice\src\main\java\org\apache\hadoop\yarn\server\timelineservice\reader\TimelineParserForCompareExpr.java,248,34,1,8,0,43
hadoop-trunk\hadoop-trunk\hadoop-mapreduce-project\hadoop-mapreduce-client\hadoop-mapreduce-client-core\src\main\java\org\apache\hadoop\mapred\ID.java,0,5,2,1,0,8
hadoop-trunk\hadoop-trunk\hadoop-tools\hadoop-dynamometer\hadoop-dynamometer-workload\src\main\java\org\apache\hadoop\tools\dynamometer\workloadgenerator\audit\UserCommandKey.java,79,36,1,1,0,38
hadoop-trunk\hadoop-trunk\hadoop-mapreduce-project\hadoop-mapreduce-client\hadoop-mapreduce-client-core\src\main\java\org\apache\hadoop\mapreduce\RecordWriter.java,0,11,0,2,0,13
hadoop-trunk\hadoop-trunk\hadoop-yarn-project\hadoop-yarn\hadoop-yarn-server\hadoop-yarn-server-resourcemanager\src\main\java\org\apache\hadoop\yarn\server\resourcemanager\webapp\RedirectionErrorPage.java,21,3,0,1,0,4
hadoop-trunk\hadoop-trunk\hadoop-tools\hadoop-azure\src\test\java\org\apache\hadoop\fs\azurebfs\ITestAbfsInputStreamStatistics.java,0,11,7,5,0,23
hadoop-trunk\hadoop-trunk\hadoop-yarn-project\hadoop-yarn\hadoop-yarn-server\hadoop-yarn-server-resourcemanager\src\main\java\org\apache\hadoop\yarn\server\resourcemanager\scheduler\QueueStateManager.java,64,12,3,2,0,17
hadoop-trunk\hadoop-trunk\hadoop-hdfs-project\hadoop-hdfs\src\test\java\org\apache\hadoop\fs\viewfs\TestViewFsWithAcls.java,141,28,8,6,0,42
hadoop-trunk\hadoop-trunk\hadoop-yarn-project\hadoop-yarn\hadoop-yarn-server\hadoop-yarn-server-resourcemanager\src\main\java\org\apache\hadoop\yarn\server\resourcemanager\scheduler\capacity\AbstractAutoCreatedLeafQueue.java,88,28,1,3,0,32
hadoop-trunk\hadoop-trunk\hadoop-common-project\hadoop-common\src\main\java\org\apache\hadoop\crypto\key\kms\KMSClientProvider.java,0,182,37,8,0,227
hadoop-trunk\hadoop-trunk\hadoop-hdfs-project\hadoop-hdfs\src\test\java\org\apache\hadoop\hdfs\server\datanode\TestDataNodeTransferSocketSize.java,42,8,0,3,0,11
hadoop-trunk\hadoop-trunk\hadoop-hdfs-project\hadoop-hdfs\src\main\java\org\apache\hadoop\hdfs\server\datanode\web\URLDispatcher.java,0,11,1,2,0,14
hadoop-trunk\hadoop-trunk\hadoop-yarn-project\hadoop-yarn\hadoop-yarn-applications\hadoop-yarn-services\hadoop-yarn-services-core\src\main\java\org\apache\hadoop\yarn\service\api\records\PlacementPolicy.java,63,18,2,1,0,21
hadoop-trunk\hadoop-trunk\hadoop-tools\hadoop-rumen\src\main\java\org\apache\hadoop\tools\rumen\Pre21JobHistoryConstants.java,63,62,2,2,0,66
hadoop-trunk\hadoop-trunk\hadoop-tools\hadoop-aws\src\test\java\org\apache\hadoop\fs\s3a\scale\ITestS3AHugeFilesByteBufferBlocks.java,0,2,0,1,0,3
hadoop-trunk\hadoop-trunk\hadoop-common-project\hadoop-auth\src\main\java\org\apache\hadoop\security\authentication\server\CompositeAuthenticationHandler.java,0,0,0,1,0,1
hadoop-trunk\hadoop-trunk\hadoop-hdfs-project\hadoop-hdfs\src\test\java\org\apache\hadoop\hdfs\server\namenode\TestNameNodeOptionParsing.java,138,21,1,5,0,27
hadoop-trunk\hadoop-trunk\hadoop-yarn-project\hadoop-yarn\hadoop-yarn-server\hadoop-yarn-server-resourcemanager\src\main\java\org\apache\hadoop\yarn\server\resourcemanager\blacklist\SimpleBlacklistManager.java,51,17,3,1,0,21
hadoop-trunk\hadoop-trunk\hadoop-mapreduce-project\hadoop-mapreduce-client\hadoop-mapreduce-client-core\src\main\java\org\apache\hadoop\mapred\TIPStatus.java,0,6,0,1,0,7
hadoop-trunk\hadoop-trunk\hadoop-tools\hadoop-distcp\src\test\java\org\apache\hadoop\tools\TestCopyFilter.java,68,7,1,1,0,9
hadoop-trunk\hadoop-trunk\hadoop-common-project\hadoop-common\src\main\java\org\apache\hadoop\io\MapWritable.java,0,47,0,1,0,48
hadoop-trunk\hadoop-trunk\hadoop-common-project\hadoop-common\src\test\java\org\apache\hadoop\fs\TestSymlinkLocalFSFileContext.java,15,2,0,1,0,3
hadoop-trunk\hadoop-trunk\hadoop-yarn-project\hadoop-yarn\hadoop-yarn-common\src\main\java\org\apache\hadoop\yarn\util\DockerClientConfigHandler.java,0,10,5,1,0,16
hadoop-trunk\hadoop-trunk\hadoop-cloud-storage-project\hadoop-cos\src\main\java\org\apache\hadoop\fs\cosn\auth\COSCredentialsProviderList.java,0,26,3,1,0,30
hadoop-trunk\hadoop-trunk\hadoop-yarn-project\hadoop-yarn\hadoop-yarn-server\hadoop-yarn-server-applicationhistoryservice\src\main\java\org\apache\hadoop\yarn\server\applicationhistoryservice\ApplicationHistoryReader.java,0,10,0,4,0,14
hadoop-trunk\hadoop-trunk\hadoop-common-project\hadoop-nfs\src\main\java\org\apache\hadoop\oncrpc\SimpleTcpClient.java,70,35,0,1,0,36
hadoop-trunk\hadoop-trunk\hadoop-hdfs-project\hadoop-hdfs\src\main\java\org\apache\hadoop\hdfs\server\namenode\Namesystem.java,0,7,0,1,0,8
hadoop-trunk\hadoop-trunk\hadoop-hdfs-project\hadoop-hdfs\src\test\java\org\apache\hadoop\fs\TestWebHdfsFileContextMainOperations.java,0,28,5,2,0,35
hadoop-trunk\hadoop-trunk\hadoop-yarn-project\hadoop-yarn\hadoop-yarn-server\hadoop-yarn-server-resourcemanager\src\main\java\org\apache\hadoop\yarn\server\resourcemanager\webapp\dao\ClusterMetricsInfo.java,404,237,2,4,0,243
hadoop-trunk\hadoop-trunk\hadoop-mapreduce-project\hadoop-mapreduce-client\hadoop-mapreduce-client-common\src\main\java\org\apache\hadoop\mapreduce\v2\api\impl\pb\service\HSClientProtocolPBServiceImpl.java,0,5,1,2,0,8
hadoop-trunk\hadoop-trunk\hadoop-common-project\hadoop-common\src\main\java\org\apache\hadoop\ha\protocolPB\HAServiceProtocolClientSideTranslatorPB.java,0,39,37,11,0,87
hadoop-trunk\hadoop-trunk\hadoop-common-project\hadoop-common\src\main\java\org\apache\hadoop\service\Service.java,0,17,4,1,0,22
hadoop-trunk\hadoop-trunk\hadoop-yarn-project\hadoop-yarn\hadoop-yarn-csi\src\test\java\org\apache\hadoop\yarn\csi\adaptor\TestGetPluginInfoRequestResponse.java,38,3,9,3,0,15
hadoop-trunk\hadoop-trunk\hadoop-hdfs-project\hadoop-hdfs\src\main\java\org\apache\hadoop\hdfs\server\datanode\DataNodeFaultInjector.java,128,63,26,1,0,90
hadoop-trunk\hadoop-trunk\hadoop-hdfs-project\hadoop-hdfs\src\test\java\org\apache\hadoop\hdfs\protocol\TestLayoutVersion.java,201,42,2,7,0,51
hadoop-trunk\hadoop-trunk\hadoop-yarn-project\hadoop-yarn\hadoop-yarn-server\hadoop-yarn-server-common\src\main\java\org\apache\hadoop\yarn\server\api\records\impl\pb\NodeHealthStatusPBImpl.java,106,24,43,3,0,70
hadoop-trunk\hadoop-trunk\hadoop-common-project\hadoop-common\src\main\java\org\apache\hadoop\io\ShortWritable.java,82,27,7,1,0,35
hadoop-trunk\hadoop-trunk\hadoop-yarn-project\hadoop-yarn\hadoop-yarn-common\src\main\java\org\apache\hadoop\yarn\webapp\Dispatcher.java,216,55,13,1,0,69
hadoop-trunk\hadoop-trunk\hadoop-cloud-storage-project\hadoop-cos\src\main\java\org\apache\hadoop\fs\cosn\CosNFileSystem.java,755,81,13,1,0,95
hadoop-trunk\hadoop-trunk\hadoop-mapreduce-project\hadoop-mapreduce-client\hadoop-mapreduce-client-hs\src\main\java\org\apache\hadoop\mapreduce\v2\hs\CachedHistoryStorage.java,266,71,11,3,0,85
hadoop-trunk\hadoop-trunk\hadoop-tools\hadoop-azure\src\test\java\org\apache\hadoop\fs\azurebfs\ITestAzureBlobFileSystemListStatus.java,199,19,0,2,0,21
hadoop-trunk\hadoop-trunk\hadoop-tools\hadoop-distcp\src\main\java\org\apache\hadoop\tools\mapred\lib\DynamicRecordReader.java,0,42,8,4,0,54
hadoop-trunk\hadoop-trunk\hadoop-hdfs-project\hadoop-hdfs\src\test\java\org\apache\hadoop\fs\TestFcHdfsPermission.java,51,21,1,2,0,24
hadoop-trunk\hadoop-trunk\hadoop-mapreduce-project\hadoop-mapreduce-client\hadoop-mapreduce-client-core\src\test\java\org\apache\hadoop\mapreduce\TestJobMonitorAndPrint.java,74,19,6,3,0,28
hadoop-trunk\hadoop-trunk\hadoop-yarn-project\hadoop-yarn\hadoop-yarn-api\src\main\java\org\apache\hadoop\yarn\api\protocolrecords\FinishApplicationMasterResponse.java,33,5,0,2,0,7
hadoop-trunk\hadoop-trunk\hadoop-hdfs-project\hadoop-hdfs\src\test\java\org\apache\hadoop\hdfs\server\namenode\TestEditLogFileInputStream.java,136,35,19,4,0,58
hadoop-trunk\hadoop-trunk\hadoop-common-project\hadoop-common\src\main\java\org\apache\hadoop\security\IdMappingConstant.java,15,18,0,4,0,22
hadoop-trunk\hadoop-trunk\hadoop-yarn-project\hadoop-yarn\hadoop-yarn-server\hadoop-yarn-server-nodemanager\src\main\java\org\apache\hadoop\yarn\server\nodemanager\containermanager\logaggregation\FailedContainerLogAggregationPolicy.java,8,4,0,2,0,6
hadoop-trunk\hadoop-trunk\hadoop-hdfs-project\hadoop-hdfs\src\test\java\org\apache\hadoop\hdfs\server\namenode\TestFSNamesystemMBean.java,185,17,2,3,0,22
hadoop-trunk\hadoop-trunk\hadoop-yarn-project\hadoop-yarn\hadoop-yarn-server\hadoop-yarn-server-nodemanager\src\main\java\org\apache\hadoop\yarn\server\nodemanager\containermanager\resourceplugin\fpga\discovery\ScriptBasedFPGADiscoveryStrategy.java,0,10,0,4,0,14
hadoop-trunk\hadoop-trunk\hadoop-common-project\hadoop-common\src\main\java\org\apache\hadoop\fs\shell\Ls.java,0,103,12,4,0,119
hadoop-trunk\hadoop-trunk\hadoop-tools\hadoop-azure\src\main\java\org\apache\hadoop\fs\azurebfs\diagnostics\Base64StringConfigurationBasicValidator.java,19,8,3,6,0,17
hadoop-trunk\hadoop-trunk\hadoop-common-project\hadoop-nfs\src\main\java\org\apache\hadoop\nfs\nfs3\response\ACCESS3Response.java,44,23,0,2,0,25
hadoop-trunk\hadoop-trunk\hadoop-hdfs-project\hadoop-hdfs\src\test\java\org\apache\hadoop\hdfs\server\namenode\TestReconstructStripedBlocks.java,374,45,2,5,0,52
hadoop-trunk\hadoop-trunk\hadoop-common-project\hadoop-common\src\main\java\org\apache\hadoop\util\functional\RemoteIterators.java,0,43,2,3,0,48
hadoop-trunk\hadoop-trunk\hadoop-mapreduce-project\hadoop-mapreduce-client\hadoop-mapreduce-client-hs\src\test\java\org\apache\hadoop\mapreduce\v2\hs\webapp\TestHsWebServicesJobsQuery.java,637,66,3,10,0,79
hadoop-trunk\hadoop-trunk\hadoop-yarn-project\hadoop-yarn\hadoop-yarn-server\hadoop-yarn-server-common\src\main\java\org\apache\hadoop\yarn\server\federation\store\records\impl\pb\SubClusterDeregisterRequestPBImpl.java,0,23,45,6,0,74
hadoop-trunk\hadoop-trunk\hadoop-yarn-project\hadoop-yarn\hadoop-yarn-server\hadoop-yarn-server-resourcemanager\src\main\java\org\apache\hadoop\yarn\server\resourcemanager\scheduler\SchedulerQueue.java,0,1,0,1,0,2
hadoop-trunk\hadoop-trunk\hadoop-yarn-project\hadoop-yarn\hadoop-yarn-server\hadoop-yarn-server-resourcemanager\src\main\java\org\apache\hadoop\yarn\server\resourcemanager\webapp\ErrorBlock.java,12,3,0,1,0,4
hadoop-trunk\hadoop-trunk\hadoop-yarn-project\hadoop-yarn\hadoop-yarn-common\src\main\java\org\apache\hadoop\yarn\api\records\impl\pb\UpdatedContainerPBImpl.java,90,17,31,1,0,49
hadoop-trunk\hadoop-trunk\hadoop-common-project\hadoop-common\src\test\java\org\apache\hadoop\fs\contract\rawlocal\TestRawlocalContractDelete.java,9,2,0,1,0,3
hadoop-trunk\hadoop-trunk\hadoop-common-project\hadoop-registry\src\main\java\org\apache\hadoop\registry\server\services\MicroZookeeperService.java,228,34,4,5,0,43
hadoop-trunk\hadoop-trunk\hadoop-common-project\hadoop-registry\src\main\java\org\apache\hadoop\registry\server\package-info.java,0,0,0,1,0,1
hadoop-trunk\hadoop-trunk\hadoop-yarn-project\hadoop-yarn\hadoop-yarn-applications\hadoop-yarn-services\hadoop-yarn-services-core\src\main\java\org\apache\hadoop\yarn\service\utils\JsonSerDeser.java,190,41,1,2,0,44
hadoop-trunk\hadoop-trunk\hadoop-hdfs-project\hadoop-hdfs-client\src\main\java\org\apache\hadoop\hdfs\protocol\LastBlockWithStatus.java,21,12,0,1,0,13
hadoop-trunk\hadoop-trunk\hadoop-yarn-project\hadoop-yarn\hadoop-yarn-applications\hadoop-yarn-services\hadoop-yarn-services-core\src\main\java\org\apache\hadoop\yarn\service\utils\PortScanner.java,80,17,3,2,0,22
hadoop-trunk\hadoop-trunk\hadoop-mapreduce-project\hadoop-mapreduce-client\hadoop-mapreduce-client-core\src\main\java\org\apache\hadoop\mapred\Queue.java,0,86,10,1,0,97
hadoop-trunk\hadoop-trunk\hadoop-hdfs-project\hadoop-hdfs\src\test\java\org\apache\hadoop\hdfs\server\namenode\TestNameNodeResourceChecker.java,207,37,3,9,0,49
hadoop-trunk\hadoop-trunk\hadoop-common-project\hadoop-common\src\main\java\org\apache\hadoop\security\ssl\KeyStoresFactory.java,0,5,4,2,0,11
hadoop-trunk\hadoop-trunk\hadoop-yarn-project\hadoop-yarn\hadoop-yarn-common\src\main\java\org\apache\hadoop\yarn\client\api\impl\FileSystemTimelineWriter.java,938,198,13,1,0,212
hadoop-trunk\hadoop-trunk\hadoop-yarn-project\hadoop-yarn\hadoop-yarn-server\hadoop-yarn-server-timelineservice-documentstore\src\main\java\org\apache\hadoop\yarn\server\timelineservice\documentstore\collection\document\entity\TimelineEntityDocument.java,213,91,0,3,0,94
hadoop-trunk\hadoop-trunk\hadoop-tools\hadoop-aws\src\main\java\org\apache\hadoop\fs\s3a\commit\LocalTempDir.java,0,9,0,1,0,10
hadoop-trunk\hadoop-trunk\hadoop-common-project\hadoop-common\src\main\java\org\apache\hadoop\io\erasurecode\coder\ErasureEncodingStep.java,40,14,0,1,0,15
hadoop-trunk\hadoop-trunk\hadoop-common-project\hadoop-common\src\main\java\org\apache\hadoop\net\AbstractDNSToSwitchMapping.java,0,12,2,2,0,16
hadoop-trunk\hadoop-trunk\hadoop-yarn-project\hadoop-yarn\hadoop-yarn-server\hadoop-yarn-server-common\src\test\java\org\apache\hadoop\yarn\server\federation\policies\amrmproxy\TestLocalityMulticastAMRMProxyPolicy.java,0,153,6,7,0,166
hadoop-trunk\hadoop-trunk\hadoop-tools\hadoop-aliyun\src\test\java\org\apache\hadoop\fs\aliyun\oss\contract\TestAliyunOSSContractOpen.java,8,2,0,1,0,3
hadoop-trunk\hadoop-trunk\hadoop-common-project\hadoop-common\src\test\java\org\apache\hadoop\fs\shell\find\TestAnd.java,237,14,2,1,0,17
hadoop-trunk\hadoop-trunk\hadoop-tools\hadoop-aws\src\test\java\org\apache\hadoop\fs\s3a\auth\delegation\TestS3ADelegationTokenSupport.java,169,13,2,3,0,18
hadoop-trunk\hadoop-trunk\hadoop-common-project\hadoop-common\src\main\java\org\apache\hadoop\crypto\random\OpensslSecureRandom.java,79,33,1,1,0,35
hadoop-trunk\hadoop-trunk\hadoop-mapreduce-project\hadoop-mapreduce-client\hadoop-mapreduce-client-nativetask\src\test\java\org\apache\hadoop\mapred\nativetask\utils\TestSizedWritable.java,10,1,0,1,0,2
hadoop-trunk\hadoop-trunk\hadoop-yarn-project\hadoop-yarn\hadoop-yarn-csi\src\main\java\org\apache\hadoop\yarn\csi\client\package-info.java,0,1,0,1,0,2
hadoop-trunk\hadoop-trunk\hadoop-common-project\hadoop-common\src\main\java\org\apache\hadoop\fs\BufferedFSInputStream.java,0,50,0,4,0,54
hadoop-trunk\hadoop-trunk\hadoop-hdfs-project\hadoop-hdfs\src\main\java\org\apache\hadoop\hdfs\server\datanode\metrics\DataNodeMetrics.java,698,427,0,1,0,428
hadoop-trunk\hadoop-trunk\hadoop-yarn-project\hadoop-yarn\hadoop-yarn-server\hadoop-yarn-server-resourcemanager\src\main\java\org\apache\hadoop\yarn\server\resourcemanager\scheduler\placement\AppPlacementAllocator.java,195,31,5,8,0,44
hadoop-trunk\hadoop-trunk\hadoop-common-project\hadoop-common\src\main\java\org\apache\hadoop\fs\shell\find\Find.java,408,65,3,2,0,70
hadoop-trunk\hadoop-trunk\hadoop-common-project\hadoop-common\src\main\java\org\apache\hadoop\security\SaslOutputStream.java,177,37,1,1,0,39
hadoop-trunk\hadoop-trunk\hadoop-tools\hadoop-azure-datalake\src\test\java\org\apache\hadoop\fs\adl\live\TestMetadata.java,0,17,7,1,0,25
hadoop-trunk\hadoop-trunk\hadoop-yarn-project\hadoop-yarn\hadoop-yarn-api\src\main\java\org\apache\hadoop\yarn\api\protocolrecords\GetContainerStatusesResponse.java,49,11,0,2,0,13
hadoop-trunk\hadoop-trunk\hadoop-common-project\hadoop-common\src\test\java\org\apache\hadoop\http\TestHttpServerLogs.java,48,10,2,1,0,13
hadoop-trunk\hadoop-trunk\hadoop-common-project\hadoop-nfs\src\main\java\org\apache\hadoop\oncrpc\RpcInfo.java,0,18,1,1,0,20
hadoop-trunk\hadoop-trunk\hadoop-hdfs-project\hadoop-hdfs\src\main\java\org\apache\hadoop\hdfs\server\namenode\ha\NameNodeHAProxyFactory.java,25,18,0,1,0,19
hadoop-trunk\hadoop-trunk\hadoop-hdfs-project\hadoop-hdfs\src\test\java\org\apache\hadoop\hdfs\server\namenode\ha\TestHarFileSystemWithHA.java,49,10,1,2,0,13
hadoop-trunk\hadoop-trunk\hadoop-common-project\hadoop-common\src\test\java\org\apache\hadoop\fs\contract\AbstractBondedFSContract.java,78,16,3,1,0,20
hadoop-trunk\hadoop-trunk\hadoop-yarn-project\hadoop-yarn\hadoop-yarn-server\hadoop-yarn-server-router\src\main\java\org\apache\hadoop\yarn\server\router\security\authorize\RouterPolicyProvider.java,35,6,3,4,0,13
hadoop-trunk\hadoop-trunk\hadoop-tools\hadoop-aws\src\main\java\org\apache\hadoop\fs\s3a\audit\S3LogVerbs.java,0,20,0,2,0,22
hadoop-trunk\hadoop-trunk\hadoop-common-project\hadoop-common\src\test\java\org\apache\hadoop\io\retry\TestRetryProxy.java,341,64,13,9,0,86
hadoop-trunk\hadoop-trunk\hadoop-yarn-project\hadoop-yarn\hadoop-yarn-server\hadoop-yarn-server-nodemanager\src\main\java\org\apache\hadoop\yarn\server\nodemanager\webapp\dao\NMDeviceResourceInfo.java,29,19,0,2,0,21
hadoop-trunk\hadoop-trunk\hadoop-common-project\hadoop-common\src\main\java\org\apache\hadoop\fs\shell\Concat.java,56,10,1,1,0,12
hadoop-trunk\hadoop-trunk\hadoop-yarn-project\hadoop-yarn\hadoop-yarn-common\src\main\java\org\apache\hadoop\yarn\api\protocolrecords\impl\pb\GetContainerReportResponsePBImpl.java,98,26,36,4,0,66
hadoop-trunk\hadoop-trunk\hadoop-hdfs-project\hadoop-hdfs\src\main\java\org\apache\hadoop\hdfs\server\datanode\metrics\DataNodePeerMetrics.java,146,40,3,9,0,52
hadoop-trunk\hadoop-trunk\hadoop-yarn-project\hadoop-yarn\hadoop-yarn-server\hadoop-yarn-server-nodemanager\src\main\java\org\apache\hadoop\yarn\server\nodemanager\containermanager\localizer\event\ResourceEvent.java,15,7,0,3,0,10
hadoop-trunk\hadoop-trunk\hadoop-yarn-project\hadoop-yarn\hadoop-yarn-server\hadoop-yarn-server-timelineservice-hbase\hadoop-yarn-server-timelineservice-hbase-common\src\main\java\org\apache\hadoop\yarn\server\timelineservice\storage\subapplication\SubApplicationColumnPrefix.java,0,27,0,7,0,34
hadoop-trunk\hadoop-trunk\hadoop-hdfs-project\hadoop-hdfs-client\src\main\java\org\apache\hadoop\hdfs\PositionStripeReader.java,0,12,0,1,0,13
hadoop-trunk\hadoop-trunk\hadoop-hdfs-project\hadoop-hdfs-rbf\src\main\java\org\apache\hadoop\hdfs\server\federation\store\protocol\impl\pb\NamenodeHeartbeatRequestPBImpl.java,0,14,34,8,0,56
hadoop-trunk\hadoop-trunk\hadoop-hdfs-project\hadoop-hdfs\src\main\java\org\apache\hadoop\hdfs\server\diskbalancer\planner\Step.java,0,1,0,1,0,2
hadoop-trunk\hadoop-trunk\hadoop-common-project\hadoop-common\src\main\java\org\apache\hadoop\net\NetworkTopology.java,972,270,19,9,0,298
hadoop-trunk\hadoop-trunk\hadoop-hdfs-project\hadoop-hdfs\src\main\java\org\apache\hadoop\hdfs\server\datanode\DataXceiver.java,0,209,157,38,0,404
hadoop-trunk\hadoop-trunk\hadoop-yarn-project\hadoop-yarn\hadoop-yarn-server\hadoop-yarn-server-tests\src\test\java\org\apache\hadoop\yarn\server\TestDiskFailures.java,219,34,7,2,0,43
hadoop-trunk\hadoop-trunk\hadoop-mapreduce-project\hadoop-mapreduce-client\hadoop-mapreduce-client-jobclient\src\test\java\org\apache\hadoop\mapreduce\SimpleEntityWriterV1.java,0,13,4,1,0,18
hadoop-trunk\hadoop-trunk\hadoop-yarn-project\hadoop-yarn\hadoop-yarn-server\hadoop-yarn-server-resourcemanager\src\test\java\org\apache\hadoop\yarn\server\resourcemanager\scheduler\fair\FakeSchedulable.java,140,100,1,1,0,102
hadoop-trunk\hadoop-trunk\hadoop-tools\hadoop-aws\src\main\java\org\apache\hadoop\fs\s3a\api\RequestFactory.java,0,0,0,1,0,1
hadoop-trunk\hadoop-trunk\hadoop-mapreduce-project\hadoop-mapreduce-client\hadoop-mapreduce-client-app\src\main\java\org\apache\hadoop\mapreduce\v2\app\local\LocalContainerAllocator.java,0,30,3,4,0,37
hadoop-trunk\hadoop-trunk\hadoop-tools\hadoop-sls\src\main\java\org\apache\hadoop\yarn\sls\JobDefinition.java,67,30,0,1,0,31
hadoop-trunk\hadoop-trunk\hadoop-common-project\hadoop-common\src\main\java\org\apache\hadoop\io\DefaultStringifier.java,160,42,3,1,0,46
hadoop-trunk\hadoop-trunk\hadoop-tools\hadoop-azure-datalake\src\test\java\org\apache\hadoop\fs\adl\live\AdlStorageContract.java,0,2,0,1,0,3
hadoop-trunk\hadoop-trunk\hadoop-yarn-project\hadoop-yarn\hadoop-yarn-api\src\main\java\org\apache\hadoop\yarn\api\protocolrecords\GetClusterNodesResponse.java,25,8,0,1,0,9
hadoop-trunk\hadoop-trunk\hadoop-hdfs-project\hadoop-hdfs\src\test\java\org\apache\hadoop\hdfs\util\TestAtomicFileOutputStream.java,120,24,7,2,0,33
hadoop-trunk\hadoop-trunk\hadoop-hdfs-project\hadoop-hdfs-client\src\main\java\org\apache\hadoop\hdfs\web\resources\OwnerParam.java,22,4,1,1,0,6
hadoop-trunk\hadoop-trunk\hadoop-hdfs-project\hadoop-hdfs\src\main\java\org\apache\hadoop\hdfs\server\datanode\DataXceiverServer.java,0,45,13,5,0,63
hadoop-trunk\hadoop-trunk\hadoop-mapreduce-project\hadoop-mapreduce-client\hadoop-mapreduce-client-core\src\test\java\org\apache\hadoop\mapred\TestQueue.java,0,38,4,8,0,50
hadoop-trunk\hadoop-trunk\hadoop-hdfs-project\hadoop-hdfs-client\src\main\java\org\apache\hadoop\hdfs\LocatedBlocksRefresher.java,160,47,5,17,0,69
hadoop-trunk\hadoop-trunk\hadoop-common-project\hadoop-common\src\main\java\org\apache\hadoop\io\compress\DirectDecompressionCodec.java,0,2,0,2,0,4
hadoop-trunk\hadoop-trunk\hadoop-yarn-project\hadoop-yarn\hadoop-yarn-server\hadoop-yarn-server-resourcemanager\src\main\java\org\apache\hadoop\yarn\server\resourcemanager\scheduler\capacity\CSQueueMetrics.java,266,123,0,3,0,126
hadoop-trunk\hadoop-trunk\hadoop-mapreduce-project\hadoop-mapreduce-client\hadoop-mapreduce-client-jobclient\src\test\java\org\apache\hadoop\mapred\TestTextInputFormat.java,550,250,44,8,0,302
hadoop-trunk\hadoop-trunk\hadoop-yarn-project\hadoop-yarn\hadoop-yarn-server\hadoop-yarn-server-resourcemanager\src\main\java\org\apache\hadoop\yarn\server\resourcemanager\RMActiveServiceContext.java,538,243,5,26,0,274
hadoop-trunk\hadoop-trunk\hadoop-yarn-project\hadoop-yarn\hadoop-yarn-common\src\main\java\org\apache\hadoop\yarn\state\Graph.java,0,82,2,1,0,85
hadoop-trunk\hadoop-trunk\hadoop-hdfs-project\hadoop-hdfs\src\main\java\org\apache\hadoop\hdfs\server\diskbalancer\datamodel\DiskBalancerVolumeSet.java,302,38,4,1,0,43
hadoop-trunk\hadoop-trunk\hadoop-yarn-project\hadoop-yarn\hadoop-yarn-server\hadoop-yarn-server-nodemanager\src\main\java\org\apache\hadoop\yarn\server\nodemanager\containermanager\logaggregation\AMOrFailedContainerLogAggregationPolicy.java,9,5,1,2,0,8
hadoop-trunk\hadoop-trunk\hadoop-yarn-project\hadoop-yarn\hadoop-yarn-api\src\main\java\org\apache\hadoop\yarn\exceptions\YarnRuntimeException.java,10,7,0,1,0,8
hadoop-trunk\hadoop-trunk\hadoop-common-project\hadoop-common\src\main\java\org\apache\hadoop\fs\statistics\IOStatisticsSnapshot.java,0,6,8,4,0,18
hadoop-trunk\hadoop-trunk\hadoop-mapreduce-project\hadoop-mapreduce-client\hadoop-mapreduce-client-jobclient\src\test\java\org\apache\hadoop\mapreduce\TestValueIterReset.java,523,113,30,2,0,145
hadoop-trunk\hadoop-trunk\hadoop-yarn-project\hadoop-yarn\hadoop-yarn-api\src\main\java\org\apache\hadoop\yarn\server\api\protocolrecords\RefreshAdminAclsResponse.java,10,1,1,1,0,3
hadoop-trunk\hadoop-trunk\hadoop-common-project\hadoop-common\src\main\java\org\apache\hadoop\io\SortedMapWritable.java,0,58,0,2,0,60
hadoop-trunk\hadoop-trunk\hadoop-common-project\hadoop-common\src\test\java\org\apache\hadoop\io\compress\TestCompressionStreamReuse.java,133,17,7,1,0,25
hadoop-trunk\hadoop-trunk\hadoop-yarn-project\hadoop-yarn\hadoop-yarn-server\hadoop-yarn-server-router\src\main\java\org\apache\hadoop\yarn\server\router\webapp\AboutPage.java,13,3,0,1,0,4
hadoop-trunk\hadoop-trunk\hadoop-tools\hadoop-fs2img\src\test\java\org\apache\hadoop\hdfs\server\namenode\TestRandomTreeWalk.java,93,20,2,1,0,23
hadoop-trunk\hadoop-trunk\hadoop-mapreduce-project\hadoop-mapreduce-client\hadoop-mapreduce-client-jobclient\src\test\java\org\apache\hadoop\mapred\jobcontrol\TestJobControl.java,246,87,24,13,0,124
hadoop-trunk\hadoop-trunk\hadoop-tools\hadoop-azure\src\main\java\org\apache\hadoop\fs\azurebfs\services\AbfsCounters.java,0,1,0,2,0,3
hadoop-trunk\hadoop-trunk\hadoop-tools\hadoop-rumen\src\main\java\org\apache\hadoop\tools\rumen\ParsedTaskAttempt.java,88,27,4,2,0,33
hadoop-trunk\hadoop-trunk\hadoop-common-project\hadoop-common\src\main\java\org\apache\hadoop\metrics2\lib\package-info.java,0,2,0,1,0,3
hadoop-trunk\hadoop-trunk\hadoop-yarn-project\hadoop-yarn\hadoop-yarn-server\hadoop-yarn-server-nodemanager\src\main\java\org\apache\hadoop\yarn\server\nodemanager\NodeStatusUpdater.java,0,9,3,2,0,14
hadoop-trunk\hadoop-trunk\hadoop-yarn-project\hadoop-yarn\hadoop-yarn-server\hadoop-yarn-server-nodemanager\src\test\java\org\apache\hadoop\yarn\server\nodemanager\containermanager\linux\runtime\docker\TestDockerPullCommand.java,28,5,0,2,0,7
hadoop-trunk\hadoop-trunk\hadoop-mapreduce-project\hadoop-mapreduce-client\hadoop-mapreduce-client-jobclient\src\test\java\org\apache\hadoop\mapred\TestMRCJCJobConf.java,53,12,3,1,0,16
hadoop-trunk\hadoop-trunk\hadoop-yarn-project\hadoop-yarn\hadoop-yarn-server\hadoop-yarn-server-resourcemanager\src\main\java\org\apache\hadoop\yarn\server\resourcemanager\scheduler\QueueResourceQuotas.java,85,50,1,1,0,52
hadoop-trunk\hadoop-trunk\hadoop-mapreduce-project\hadoop-mapreduce-client\hadoop-mapreduce-client-common\src\main\java\org\apache\hadoop\mapreduce\v2\api\records\Locality.java,0,3,0,1,0,4
hadoop-trunk\hadoop-trunk\hadoop-yarn-project\hadoop-yarn\hadoop-yarn-server\hadoop-yarn-server-resourcemanager\src\main\java\org\apache\hadoop\yarn\server\resourcemanager\webapp\AboutPage.java,11,3,0,1,0,4
hadoop-trunk\hadoop-trunk\hadoop-yarn-project\hadoop-yarn\hadoop-yarn-server\hadoop-yarn-server-nodemanager\src\main\java\org\apache\hadoop\yarn\server\nodemanager\containermanager\linux\resources\CGroupsResourceCalculator.java,296,58,8,2,0,68
hadoop-trunk\hadoop-trunk\hadoop-yarn-project\hadoop-yarn\hadoop-yarn-server\hadoop-yarn-server-resourcemanager\src\main\java\org\apache\hadoop\yarn\server\resourcemanager\monitor\capacity\CapacitySchedulerPreemptionUtils.java,229,35,1,1,0,37
hadoop-trunk\hadoop-trunk\hadoop-mapreduce-project\hadoop-mapreduce-client\hadoop-mapreduce-client-common\src\main\java\org\apache\hadoop\mapreduce\v2\api\records\TaskType.java,0,2,0,1,0,3
hadoop-trunk\hadoop-trunk\hadoop-tools\hadoop-azure\src\main\java\org\apache\hadoop\fs\azurebfs\oauth2\RefreshTokenBasedTokenProvider.java,34,13,0,3,0,16
hadoop-trunk\hadoop-trunk\hadoop-hdfs-project\hadoop-hdfs\src\test\java\org\apache\hadoop\hdfs\TestFileCreationClient.java,112,38,6,3,0,47
hadoop-trunk\hadoop-trunk\hadoop-yarn-project\hadoop-yarn\hadoop-yarn-server\hadoop-yarn-server-resourcemanager\src\test\java\org\apache\hadoop\yarn\server\resourcemanager\scheduler\fair\converter\FSConfigConverterTestCommons.java,136,38,5,4,0,47
hadoop-trunk\hadoop-trunk\hadoop-hdfs-project\hadoop-hdfs-rbf\src\test\java\org\apache\hadoop\hdfs\server\federation\router\TestRouterFederationRenameBase.java,159,24,1,7,0,32
hadoop-trunk\hadoop-trunk\hadoop-mapreduce-project\hadoop-mapreduce-client\hadoop-mapreduce-client-app\src\main\java\org\apache\hadoop\mapreduce\v2\app\webapp\AMWebServices.java,459,112,13,10,0,135
hadoop-trunk\hadoop-trunk\hadoop-hdfs-project\hadoop-hdfs\src\test\java\org\apache\hadoop\hdfs\server\datanode\extdataset\ExternalVolumeImpl.java,107,31,7,1,0,39
hadoop-trunk\hadoop-trunk\hadoop-tools\hadoop-rumen\src\main\java\org\apache\hadoop\tools\rumen\ParsedHost.java,109,33,4,1,0,38
hadoop-trunk\hadoop-trunk\hadoop-yarn-project\hadoop-yarn\hadoop-yarn-server\hadoop-yarn-server-resourcemanager\src\test\java\org\apache\hadoop\yarn\server\resourcemanager\webapp\helper\XmlCustomResourceTypeTestCase.java,72,24,3,1,0,28
hadoop-trunk\hadoop-trunk\hadoop-yarn-project\hadoop-yarn\hadoop-yarn-server\hadoop-yarn-server-nodemanager\src\test\java\org\apache\hadoop\yarn\server\nodemanager\containermanager\monitor\TestContainersMonitorResourceChange.java,301,82,7,9,0,98
hadoop-trunk\hadoop-trunk\hadoop-hdfs-project\hadoop-hdfs\src\main\java\org\apache\hadoop\hdfs\server\namenode\XAttrPermissionFilter.java,72,19,2,3,0,24
hadoop-trunk\hadoop-trunk\hadoop-yarn-project\hadoop-yarn\hadoop-yarn-common\src\test\java\org\apache\hadoop\yarn\TestRpcFactoryProvider.java,46,7,3,3,0,13
hadoop-trunk\hadoop-trunk\hadoop-tools\hadoop-azure\src\test\java\org\apache\hadoop\fs\azure\TestNativeAzureFileSystemConcurrency.java,147,13,2,4,0,19
hadoop-trunk\hadoop-trunk\hadoop-common-project\hadoop-common\src\test\java\org\apache\hadoop\security\ssl\KeyStoreTestUtil.java,614,158,10,4,0,172
hadoop-trunk\hadoop-trunk\hadoop-yarn-project\hadoop-yarn\hadoop-yarn-server\hadoop-yarn-server-timelineservice\src\main\java\org\apache\hadoop\yarn\server\timelineservice\reader\TimelineDataToRetrieve.java,111,45,0,4,0,49
hadoop-trunk\hadoop-trunk\hadoop-hdfs-project\hadoop-hdfs\src\test\java\org\apache\hadoop\hdfs\server\balancer\TestBalancerService.java,168,22,0,4,0,26
hadoop-trunk\hadoop-trunk\hadoop-tools\hadoop-aws\src\test\java\org\apache\hadoop\fs\s3a\commit\staging\StagingTestBase.java,724,181,10,1,0,192
hadoop-trunk\hadoop-trunk\hadoop-yarn-project\hadoop-yarn\hadoop-yarn-api\src\main\java\org\apache\hadoop\yarn\api\protocolrecords\RegisterApplicationMasterResponse.java,194,27,3,4,0,34
hadoop-trunk\hadoop-trunk\hadoop-common-project\hadoop-common\src\main\java\org\apache\hadoop\fs\DF.java,180,39,8,1,0,48
hadoop-trunk\hadoop-trunk\hadoop-mapreduce-project\hadoop-mapreduce-client\hadoop-mapreduce-client-core\src\main\java\org\apache\hadoop\mapreduce\lib\partition\KeyFieldHelper.java,0,86,16,1,0,103
hadoop-trunk\hadoop-trunk\hadoop-common-project\hadoop-common\src\main\java\org\apache\hadoop\ha\protocolPB\ZKFCProtocolServerSideTranslatorPB.java,52,20,12,3,0,35
hadoop-trunk\hadoop-trunk\hadoop-common-project\hadoop-nfs\src\main\java\org\apache\hadoop\oncrpc\RpcProgram.java,220,96,10,2,0,108
hadoop-trunk\hadoop-trunk\hadoop-hdfs-project\hadoop-hdfs\src\test\java\org\apache\hadoop\hdfs\server\blockmanagement\TestSortLocatedStripedBlock.java,512,57,13,2,0,72
hadoop-trunk\hadoop-trunk\hadoop-mapreduce-project\hadoop-mapreduce-client\hadoop-mapreduce-client-jobclient\src\test\java\org\apache\hadoop\fs\DFSCIOTest.java,484,240,43,27,0,310
hadoop-trunk\hadoop-trunk\hadoop-yarn-project\hadoop-yarn\hadoop-yarn-common\src\main\java\org\apache\hadoop\yarn\ContainerLogAppender.java,0,29,0,1,0,30
hadoop-trunk\hadoop-trunk\hadoop-yarn-project\hadoop-yarn\hadoop-yarn-server\hadoop-yarn-server-timelineservice\src\main\java\org\apache\hadoop\yarn\server\timelineservice\storage\common\TimelineStorageUtils.java,0,44,3,9,0,56
hadoop-trunk\hadoop-trunk\hadoop-yarn-project\hadoop-yarn\hadoop-yarn-common\src\main\java\org\apache\hadoop\yarn\api\records\impl\pb\PriorityPBImpl.java,47,22,24,1,0,47
hadoop-trunk\hadoop-trunk\hadoop-hdfs-project\hadoop-hdfs-rbf\src\main\java\org\apache\hadoop\hdfs\server\federation\store\protocol\impl\pb\GetRouterRegistrationsResponsePBImpl.java,0,14,42,7,0,63
hadoop-trunk\hadoop-trunk\hadoop-hdfs-project\hadoop-hdfs\src\test\java\org\apache\hadoop\hdfs\server\namenode\TestNamenodeRetryCache.java,394,93,32,6,0,131
hadoop-trunk\hadoop-trunk\hadoop-mapreduce-project\hadoop-mapreduce-client\hadoop-mapreduce-client-core\src\main\java\org\apache\hadoop\mapreduce\counters\FrameworkCounterGroup.java,262,78,8,2,0,88
hadoop-trunk\hadoop-trunk\hadoop-common-project\hadoop-common\src\main\java\org\apache\hadoop\util\RateLimitingFactory.java,0,8,0,3,0,11
hadoop-trunk\hadoop-trunk\hadoop-tools\hadoop-fs2img\src\main\java\org\apache\hadoop\hdfs\server\namenode\FixedBlockMultiReplicaResolver.java,19,7,0,1,0,8
hadoop-trunk\hadoop-trunk\hadoop-yarn-project\hadoop-yarn\hadoop-yarn-applications\hadoop-yarn-services\hadoop-yarn-services-core\src\main\java\org\apache\hadoop\yarn\service\component\OnFailureRestartPolicy.java,0,10,5,1,0,16
hadoop-trunk\hadoop-trunk\hadoop-hdfs-project\hadoop-hdfs\src\main\java\org\apache\hadoop\hdfs\server\namenode\NameNodeResourceChecker.java,162,44,2,3,0,49
hadoop-trunk\hadoop-trunk\hadoop-hdfs-project\hadoop-hdfs\src\test\java\org\apache\hadoop\hdfs\TestErasureCodeBenchmarkThroughput.java,87,22,1,1,0,24
hadoop-trunk\hadoop-trunk\hadoop-tools\hadoop-resourceestimator\src\main\java\org\apache\hadoop\resourceestimator\service\ResourceEstimatorService.java,0,18,7,6,0,31
hadoop-trunk\hadoop-trunk\hadoop-common-project\hadoop-common\src\main\java\org\apache\hadoop\util\FastNumberFormat.java,22,8,1,2,0,11
hadoop-trunk\hadoop-trunk\hadoop-tools\hadoop-openstack\src\main\java\org\apache\hadoop\fs\swift\exceptions\SwiftConnectionException.java,13,7,1,1,0,9
hadoop-trunk\hadoop-trunk\hadoop-yarn-project\hadoop-yarn\hadoop-yarn-server\hadoop-yarn-server-timelineservice-documentstore\src\main\java\org\apache\hadoop\yarn\server\timelineservice\documentstore\package-info.java,0,0,0,1,0,1
hadoop-trunk\hadoop-trunk\hadoop-tools\hadoop-aws\src\test\java\org\apache\hadoop\fs\s3a\performance\OperationCost.java,0,8,0,1,0,9
hadoop-trunk\hadoop-trunk\hadoop-common-project\hadoop-common\src\main\java\org\apache\hadoop\fs\store\audit\AuditingFunctions.java,0,10,0,1,0,11
hadoop-trunk\hadoop-trunk\hadoop-yarn-project\hadoop-yarn\hadoop-yarn-server\hadoop-yarn-server-common\src\main\java\org\apache\hadoop\yarn\server\service\SystemServiceManager.java,0,0,0,1,0,1
hadoop-trunk\hadoop-trunk\hadoop-tools\hadoop-aws\src\main\java\org\apache\hadoop\fs\s3a\commit\CommitUtils.java,0,13,3,1,0,17
hadoop-trunk\hadoop-trunk\hadoop-tools\hadoop-sls\src\main\java\org\apache\hadoop\yarn\sls\appmaster\package-info.java,0,1,0,1,0,2
hadoop-trunk\hadoop-trunk\hadoop-yarn-project\hadoop-yarn\hadoop-yarn-server\hadoop-yarn-server-resourcemanager\src\main\java\org\apache\hadoop\yarn\server\resourcemanager\webapp\dao\PartitionResourcesInfo.java,89,58,1,1,0,60
hadoop-trunk\hadoop-trunk\hadoop-yarn-project\hadoop-yarn\hadoop-yarn-common\src\main\java\org\apache\hadoop\yarn\webapp\util\YarnWebServiceUtils.java,0,9,6,1,0,16
hadoop-trunk\hadoop-trunk\hadoop-hdfs-project\hadoop-hdfs-rbf\src\test\java\org\apache\hadoop\hdfs\rbfbalance\TestRouterDistCpProcedure.java,69,8,2,4,0,14
hadoop-trunk\hadoop-trunk\hadoop-yarn-project\hadoop-yarn\hadoop-yarn-server\hadoop-yarn-server-common\src\test\java\org\apache\hadoop\yarn\server\timeline\security\TestTimelineAuthenticationFilterInitializer.java,47,3,0,2,0,5
hadoop-trunk\hadoop-trunk\hadoop-common-project\hadoop-annotations\src\main\java\org\apache\hadoop\classification\tools\StabilityOptions.java,0,12,15,1,0,28
hadoop-trunk\hadoop-trunk\hadoop-mapreduce-project\hadoop-mapreduce-client\hadoop-mapreduce-client-hs\src\main\java\org\apache\hadoop\mapreduce\v2\hs\HistoryServerStateStoreServiceFactory.java,26,4,1,1,0,6
hadoop-trunk\hadoop-trunk\hadoop-mapreduce-project\hadoop-mapreduce-client\hadoop-mapreduce-client-common\src\main\java\org\apache\hadoop\mapreduce\v2\api\protocolrecords\impl\pb\RenewDelegationTokenRequestPBImpl.java,75,23,33,4,0,60
hadoop-trunk\hadoop-trunk\hadoop-common-project\hadoop-common\src\main\java\org\apache\hadoop\ha\NodeFencer.java,157,52,8,3,0,63
hadoop-trunk\hadoop-trunk\hadoop-mapreduce-project\hadoop-mapreduce-client\hadoop-mapreduce-client-core\src\main\java\org\apache\hadoop\mapreduce\lib\db\DBRecordReader.java,0,96,27,3,0,126
hadoop-trunk\hadoop-trunk\hadoop-hdfs-project\hadoop-hdfs\src\test\java\org\apache\hadoop\hdfs\server\namenode\ha\HAStressTestHarness.java,122,29,0,5,0,34
hadoop-trunk\hadoop-trunk\hadoop-tools\hadoop-aws\src\test\java\org\apache\hadoop\fs\s3a\test\ExtraAssertions.java,0,17,2,1,0,20
hadoop-trunk\hadoop-trunk\hadoop-tools\hadoop-sls\src\test\java\org\apache\hadoop\yarn\sls\TestDagAMSimulator.java,59,12,0,1,0,13
hadoop-trunk\hadoop-trunk\hadoop-yarn-project\hadoop-yarn\hadoop-yarn-api\src\main\java\org\apache\hadoop\yarn\api\records\DecommissionType.java,0,1,0,1,0,2
hadoop-trunk\hadoop-trunk\hadoop-common-project\hadoop-common\src\main\java\org\apache\hadoop\net\Node.java,0,11,7,1,0,19
hadoop-trunk\hadoop-trunk\hadoop-yarn-project\hadoop-yarn\hadoop-yarn-server\hadoop-yarn-server-resourcemanager\src\test\java\org\apache\hadoop\yarn\server\resourcemanager\scheduler\capacity\TestCapacitySchedulerAsyncScheduling.java,1177,189,63,25,0,277
hadoop-trunk\hadoop-trunk\hadoop-tools\hadoop-azure\src\test\java\org\apache\hadoop\fs\azure\ITestPageBlobOutputStream.java,55,5,0,1,0,6
hadoop-trunk\hadoop-trunk\hadoop-tools\hadoop-aliyun\src\test\java\org\apache\hadoop\fs\aliyun\oss\fileContext\TestOSSFileContextMainOperations.java,0,7,1,1,0,9
hadoop-trunk\hadoop-trunk\hadoop-tools\hadoop-aws\src\test\java\org\apache\hadoop\fs\s3a\commit\staging\TestStagingPartitionedFileListing.java,0,16,5,1,0,22
hadoop-trunk\hadoop-trunk\hadoop-tools\hadoop-rumen\src\main\java\org\apache\hadoop\tools\rumen\TaskAttemptInfo.java,52,26,0,2,0,28
hadoop-trunk\hadoop-trunk\hadoop-common-project\hadoop-common\src\test\java\org\apache\hadoop\http\TestServletFilter.java,163,58,12,3,0,73
hadoop-trunk\hadoop-trunk\hadoop-common-project\hadoop-common\src\test\java\org\apache\hadoop\metrics2\util\TestMetricsCache.java,116,31,5,1,0,37
hadoop-trunk\hadoop-trunk\hadoop-mapreduce-project\hadoop-mapreduce-client\hadoop-mapreduce-client-app\src\test\java\org\apache\hadoop\mapreduce\v2\app\TestRecovery.java,2052,276,75,25,0,376
hadoop-trunk\hadoop-trunk\hadoop-common-project\hadoop-common\src\main\java\org\apache\hadoop\fs\store\BlockUploadStatistics.java,0,0,0,1,0,1
hadoop-trunk\hadoop-trunk\hadoop-yarn-project\hadoop-yarn\hadoop-yarn-server\hadoop-yarn-server-resourcemanager\src\test\java\org\apache\hadoop\yarn\server\resourcemanager\TestClientRMService.java,0,330,189,36,0,555
hadoop-trunk\hadoop-trunk\hadoop-hdfs-project\hadoop-hdfs\src\test\java\org\apache\hadoop\hdfs\MiniDFSNNTopology.java,246,88,4,4,0,96
hadoop-trunk\hadoop-trunk\hadoop-common-project\hadoop-common\src\main\java\org\apache\hadoop\fs\FSError.java,8,1,1,1,0,3
hadoop-trunk\hadoop-trunk\hadoop-mapreduce-project\hadoop-mapreduce-client\hadoop-mapreduce-client-nativetask\src\main\java\org\apache\hadoop\mapred\nativetask\serde\VIntWritableSerializer.java,3,1,0,1,0,2
hadoop-trunk\hadoop-trunk\hadoop-hdfs-project\hadoop-hdfs\src\main\java\org\apache\hadoop\hdfs\tools\DFSZKFailoverController.java,237,41,12,7,0,60
hadoop-trunk\hadoop-trunk\hadoop-mapreduce-project\hadoop-mapreduce-client\hadoop-mapreduce-client-jobclient\src\test\java\org\apache\hadoop\mapred\MiniMRClientCluster.java,0,7,4,1,0,12
hadoop-trunk\hadoop-trunk\hadoop-common-project\hadoop-common\src\test\java\org\apache\hadoop\util\TestSysInfoLinux.java,546,348,9,22,0,379
hadoop-trunk\hadoop-trunk\hadoop-hdfs-project\hadoop-hdfs\src\main\java\org\apache\hadoop\hdfs\server\namenode\EncryptionZoneManager.java,743,104,14,5,0,123
hadoop-trunk\hadoop-trunk\hadoop-yarn-project\hadoop-yarn\hadoop-yarn-common\src\main\java\org\apache\hadoop\yarn\api\records\impl\pb\TokenPBImpl.java,161,40,51,1,0,92
hadoop-trunk\hadoop-trunk\hadoop-tools\hadoop-gridmix\src\main\java\org\apache\hadoop\mapred\gridmix\emulators\resourceusage\TotalHeapUsageEmulatorPlugin.java,0,122,4,1,0,127
hadoop-trunk\hadoop-trunk\hadoop-hdfs-project\hadoop-hdfs-rbf\src\main\java\org\apache\hadoop\hdfs\server\federation\store\MembershipStore.java,0,2,0,9,0,11
hadoop-trunk\hadoop-trunk\hadoop-yarn-project\hadoop-yarn\hadoop-yarn-applications\hadoop-yarn-services\hadoop-yarn-services-core\src\test\java\org\apache\hadoop\yarn\service\utils\TestFilterUtils.java,78,5,9,2,0,16
hadoop-trunk\hadoop-trunk\hadoop-cloud-storage-project\hadoop-cos\src\test\java\org\apache\hadoop\fs\cosn\contract\TestCosNContractCreate.java,7,2,0,1,0,3
hadoop-trunk\hadoop-trunk\hadoop-mapreduce-project\hadoop-mapreduce-client\hadoop-mapreduce-client-app\src\main\java\org\apache\hadoop\mapreduce\v2\app\webapp\dao\TaskInfo.java,95,47,1,1,0,49
hadoop-trunk\hadoop-trunk\hadoop-mapreduce-project\hadoop-mapreduce-client\hadoop-mapreduce-client-core\src\main\java\org\apache\hadoop\mapreduce\jobhistory\TaskAttemptFinishedEvent.java,146,78,31,1,0,110
hadoop-trunk\hadoop-trunk\hadoop-tools\hadoop-dynamometer\hadoop-dynamometer-infra\src\main\java\org\apache\hadoop\tools\dynamometer\package-info.java,0,0,0,1,0,1
hadoop-trunk\hadoop-trunk\hadoop-yarn-project\hadoop-yarn\hadoop-yarn-client\src\main\java\org\apache\hadoop\yarn\client\api\impl\AMRMClientImpl.java,0,215,23,8,0,246
hadoop-trunk\hadoop-trunk\hadoop-hdfs-project\hadoop-hdfs\src\test\java\org\apache\hadoop\hdfs\qjournal\server\TestJournal.java,480,170,35,5,0,210
hadoop-trunk\hadoop-trunk\hadoop-yarn-project\hadoop-yarn\hadoop-yarn-server\hadoop-yarn-server-applicationhistoryservice\src\main\java\org\apache\hadoop\yarn\server\applicationhistoryservice\webapp\AHSLogsPage.java,31,5,0,1,0,6
hadoop-trunk\hadoop-trunk\hadoop-hdfs-project\hadoop-hdfs-client\src\main\java\org\apache\hadoop\hdfs\protocol\datatransfer\DataTransferProtoUtil.java,88,18,31,5,0,54
hadoop-trunk\hadoop-trunk\hadoop-yarn-project\hadoop-yarn\hadoop-yarn-api\src\main\java\org\apache\hadoop\yarn\api\records\NodeLabel.java,86,18,0,2,0,20
hadoop-trunk\hadoop-trunk\hadoop-yarn-project\hadoop-yarn\hadoop-yarn-common\src\main\java\org\apache\hadoop\yarn\server\security\package-info.java,0,1,0,1,0,2
hadoop-trunk\hadoop-trunk\hadoop-yarn-project\hadoop-yarn\hadoop-yarn-server\hadoop-yarn-server-nodemanager\src\test\java\org\apache\hadoop\yarn\server\nodemanager\TestContainerExecutor.java,238,67,17,15,0,99
hadoop-trunk\hadoop-trunk\hadoop-common-project\hadoop-common\src\main\java\org\apache\hadoop\fs\shell\FsCommand.java,0,16,1,5,0,22
hadoop-trunk\hadoop-trunk\hadoop-mapreduce-project\hadoop-mapreduce-client\hadoop-mapreduce-client-core\src\main\java\org\apache\hadoop\mapreduce\checkpoint\CheckpointID.java,0,1,0,1,0,2
hadoop-trunk\hadoop-trunk\hadoop-yarn-project\hadoop-yarn\hadoop-yarn-server\hadoop-yarn-server-common\src\main\java\org\apache\hadoop\yarn\server\federation\resolver\package-info.java,0,0,0,1,0,1
hadoop-trunk\hadoop-trunk\hadoop-tools\hadoop-azure\src\main\java\org\apache\hadoop\fs\azurebfs\contracts\exceptions\InvalidFileSystemPropertyException.java,0,4,0,2,0,6
hadoop-trunk\hadoop-trunk\hadoop-hdfs-project\hadoop-hdfs\src\test\java\org\apache\hadoop\hdfs\server\datanode\TestDnRespectsBlockReportSplitThreshold.java,157,35,3,5,0,43
hadoop-trunk\hadoop-trunk\hadoop-yarn-project\hadoop-yarn\hadoop-yarn-common\src\test\java\org\apache\hadoop\yarn\util\ControlledClock.java,38,22,0,1,0,23
hadoop-trunk\hadoop-trunk\hadoop-yarn-project\hadoop-yarn\hadoop-yarn-common\src\main\java\org\apache\hadoop\yarn\webapp\View.java,206,89,6,2,0,97
hadoop-trunk\hadoop-trunk\hadoop-yarn-project\hadoop-yarn\hadoop-yarn-server\hadoop-yarn-server-common\src\main\java\org\apache\hadoop\yarn\server\api\protocolrecords\SCMUploaderCanUploadResponse.java,20,0,0,1,0,1
hadoop-trunk\hadoop-trunk\hadoop-common-project\hadoop-common\src\test\java\org\apache\hadoop\crypto\TestCryptoStreamsWithJceAesCtrCryptoCodec.java,14,3,0,2,0,5
hadoop-trunk\hadoop-trunk\hadoop-yarn-project\hadoop-yarn\hadoop-yarn-server\hadoop-yarn-server-resourcemanager\src\test\java\org\apache\hadoop\yarn\server\resourcemanager\webapp\TestRMWebApp.java,341,100,16,13,0,129
hadoop-trunk\hadoop-trunk\hadoop-common-project\hadoop-common\src\main\java\org\apache\hadoop\io\retry\package-info.java,0,0,0,1,0,1
hadoop-trunk\hadoop-trunk\hadoop-hdfs-project\hadoop-hdfs\src\main\java\org\apache\hadoop\hdfs\server\namenode\NameNodeUtils.java,0,6,0,2,0,8
hadoop-trunk\hadoop-trunk\hadoop-tools\hadoop-aws\src\main\java\org\apache\hadoop\fs\s3a\statistics\S3AStatisticsContext.java,0,0,0,1,0,1
hadoop-trunk\hadoop-trunk\hadoop-yarn-project\hadoop-yarn\hadoop-yarn-applications\hadoop-yarn-applications-unmanaged-am-launcher\src\main\java\org\apache\hadoop\yarn\applications\unmanagedamlauncher\UnmanagedAMLauncher.java,0,74,18,4,0,96
hadoop-trunk\hadoop-trunk\hadoop-yarn-project\hadoop-yarn\hadoop-yarn-server\hadoop-yarn-server-resourcemanager\src\test\java\org\apache\hadoop\yarn\server\resourcemanager\scheduler\fair\TestAppRunnability.java,232,36,0,8,0,44
hadoop-trunk\hadoop-trunk\hadoop-common-project\hadoop-common\src\test\java\org\apache\hadoop\util\TestPureJavaCrc32.java,359,111,6,6,0,123
hadoop-trunk\hadoop-trunk\hadoop-common-project\hadoop-nfs\src\main\java\org\apache\hadoop\oncrpc\RpcReply.java,49,27,1,1,0,29
hadoop-trunk\hadoop-trunk\hadoop-hdfs-project\hadoop-hdfs\src\main\java\org\apache\hadoop\hdfs\server\namenode\NameNodeFormatException.java,13,6,0,1,0,7
hadoop-trunk\hadoop-trunk\hadoop-yarn-project\hadoop-yarn\hadoop-yarn-server\hadoop-yarn-server-common\src\main\java\org\apache\hadoop\yarn\server\federation\failover\package-info.java,0,0,0,1,0,1
hadoop-trunk\hadoop-trunk\hadoop-yarn-project\hadoop-yarn\hadoop-yarn-server\hadoop-yarn-server-nodemanager\src\test\java\org\apache\hadoop\yarn\server\nodemanager\containermanager\linux\resources\TestCGroupElasticMemoryController.java,272,23,1,6,0,30
hadoop-trunk\hadoop-trunk\hadoop-yarn-project\hadoop-yarn\hadoop-yarn-server\hadoop-yarn-server-resourcemanager\src\main\java\org\apache\hadoop\yarn\server\resourcemanager\amlauncher\AMLauncherEvent.java,15,7,0,1,0,8
hadoop-trunk\hadoop-trunk\hadoop-mapreduce-project\hadoop-mapreduce-client\hadoop-mapreduce-client-core\src\main\java\org\apache\hadoop\mapreduce\task\reduce\Shuffle.java,160,49,6,1,0,56
hadoop-trunk\hadoop-trunk\hadoop-yarn-project\hadoop-yarn\hadoop-yarn-server\hadoop-yarn-server-applicationhistoryservice\src\main\java\org\apache\hadoop\yarn\server\applicationhistoryservice\records\impl\pb\ContainerFinishDataPBImpl.java,173,40,60,4,0,104
hadoop-trunk\hadoop-trunk\hadoop-yarn-project\hadoop-yarn\hadoop-yarn-server\hadoop-yarn-server-resourcemanager\src\test\java\org\apache\hadoop\yarn\server\resourcemanager\placement\csmappingrule\TestCSMappingPlacementRule.java,0,157,33,37,0,227
hadoop-trunk\hadoop-trunk\hadoop-yarn-project\hadoop-yarn\hadoop-yarn-server\hadoop-yarn-server-resourcemanager\src\test\java\org\apache\hadoop\yarn\server\resourcemanager\scheduler\ResourceMetricsChecker.java,0,59,0,29,0,88
hadoop-trunk\hadoop-trunk\hadoop-hdfs-project\hadoop-hdfs\src\main\java\org\apache\hadoop\hdfs\server\balancer\BalancerMetrics.java,0,20,0,1,0,21
hadoop-trunk\hadoop-trunk\hadoop-yarn-project\hadoop-yarn\hadoop-yarn-client\src\test\java\org\apache\hadoop\yarn\client\util\TestYarnClientUtils.java,288,9,10,1,0,20
hadoop-trunk\hadoop-trunk\hadoop-yarn-project\hadoop-yarn\hadoop-yarn-server\hadoop-yarn-server-resourcemanager\src\main\java\org\apache\hadoop\yarn\server\resourcemanager\scheduler\policy\FifoOrderingPolicy.java,0,20,4,3,0,27
hadoop-trunk\hadoop-trunk\hadoop-yarn-project\hadoop-yarn\hadoop-yarn-server\hadoop-yarn-server-resourcemanager\src\main\java\org\apache\hadoop\yarn\server\resourcemanager\volume\csi\lifecycle\VolumeState.java,0,5,0,1,0,6
hadoop-trunk\hadoop-trunk\hadoop-yarn-project\hadoop-yarn\hadoop-yarn-server\hadoop-yarn-server-resourcemanager\src\main\java\org\apache\hadoop\yarn\server\resourcemanager\ActiveStandbyElectorBasedElectorService.java,0,35,8,1,0,44
hadoop-trunk\hadoop-trunk\hadoop-tools\hadoop-aws\src\test\java\org\apache\hadoop\fs\s3a\scale\ITestS3AMultipartUploadSizeLimits.java,156,10,0,8,0,18
hadoop-trunk\hadoop-trunk\hadoop-yarn-project\hadoop-yarn\hadoop-yarn-common\src\main\java\org\apache\hadoop\yarn\security\PrivilegedEntity.java,56,30,7,1,0,38
hadoop-trunk\hadoop-trunk\hadoop-hdfs-project\hadoop-hdfs\src\main\java\org\apache\hadoop\hdfs\util\LightWeightHashSet.java,613,87,9,3,0,99
hadoop-trunk\hadoop-trunk\hadoop-tools\hadoop-openstack\src\main\java\org\apache\hadoop\fs\swift\auth\AuthenticationRequest.java,32,8,2,1,0,11
hadoop-trunk\hadoop-trunk\hadoop-common-project\hadoop-annotations\src\main\java\org\apache\hadoop\classification\InterfaceAudience.java,28,16,2,1,0,19
hadoop-trunk\hadoop-trunk\hadoop-common-project\hadoop-common\src\main\java\org\apache\hadoop\fs\store\DataBlocks.java,0,141,18,3,0,162
hadoop-trunk\hadoop-trunk\hadoop-yarn-project\hadoop-yarn\hadoop-yarn-server\hadoop-yarn-server-router\src\main\java\org\apache\hadoop\yarn\server\router\RouterServerUtil.java,0,4,0,1,0,5
hadoop-trunk\hadoop-trunk\hadoop-mapreduce-project\hadoop-mapreduce-client\hadoop-mapreduce-client-core\src\main\java\org\apache\hadoop\mapreduce\jobhistory\JobUnsuccessfulCompletionEvent.java,147,68,33,1,0,102
hadoop-trunk\hadoop-trunk\hadoop-mapreduce-project\hadoop-mapreduce-client\hadoop-mapreduce-client-core\src\main\java\org\apache\hadoop\mapreduce\lib\input\FixedLengthInputFormat.java,0,15,1,1,0,17
hadoop-trunk\hadoop-trunk\hadoop-yarn-project\hadoop-yarn\hadoop-yarn-server\hadoop-yarn-server-resourcemanager\src\test\java\org\apache\hadoop\yarn\server\resourcemanager\scheduler\capacity\TestConfigurationProperties.java,99,10,2,2,0,14
hadoop-trunk\hadoop-trunk\hadoop-yarn-project\hadoop-yarn\hadoop-yarn-server\hadoop-yarn-server-resourcemanager\src\main\java\org\apache\hadoop\yarn\server\resourcemanager\webapp\dao\ReservationUpdateResponseInfo.java,8,1,2,1,0,4
hadoop-trunk\hadoop-trunk\hadoop-hdfs-project\hadoop-hdfs-httpfs\src\main\java\org\apache\hadoop\lib\util\ConfigurationUtils.java,63,14,0,6,0,20
hadoop-trunk\hadoop-trunk\hadoop-yarn-project\hadoop-yarn\hadoop-yarn-server\hadoop-yarn-server-resourcemanager\src\main\java\org\apache\hadoop\yarn\server\resourcemanager\webapp\dao\RMQueueAclInfo.java,40,33,1,1,0,35
hadoop-trunk\hadoop-trunk\hadoop-mapreduce-project\hadoop-mapreduce-client\hadoop-mapreduce-client-app\src\main\java\org\apache\hadoop\mapreduce\v2\app\job\event\JobAbortCompletedEvent.java,14,7,0,1,0,8
hadoop-trunk\hadoop-trunk\hadoop-tools\hadoop-openstack\src\test\java\org\apache\hadoop\fs\swift\contract\SwiftContract.java,18,7,0,2,0,9
hadoop-trunk\hadoop-trunk\hadoop-hdfs-project\hadoop-hdfs-httpfs\src\main\java\org\apache\hadoop\lib\wsrs\BooleanParam.java,22,8,2,2,0,12
hadoop-trunk\hadoop-trunk\hadoop-mapreduce-project\hadoop-mapreduce-client\hadoop-mapreduce-client-core\src\main\java\org\apache\hadoop\mapred\InputSplit.java,0,7,0,1,0,8
hadoop-trunk\hadoop-trunk\hadoop-common-project\hadoop-common\src\test\java\org\apache\hadoop\metrics2\lib\TestMutableMetrics.java,398,73,5,1,0,79
hadoop-trunk\hadoop-trunk\hadoop-hdfs-project\hadoop-hdfs-httpfs\src\test\java\org\apache\hadoop\lib\server\TestServerConstructor.java,0,22,2,2,0,26
hadoop-trunk\hadoop-trunk\hadoop-yarn-project\hadoop-yarn\hadoop-yarn-server\hadoop-yarn-server-timelineservice\src\main\java\org\apache\hadoop\yarn\server\timelineservice\storage\TimelineSchemaCreator.java,45,9,0,1,0,10
hadoop-trunk\hadoop-trunk\hadoop-common-project\hadoop-common\src\main\java\org\apache\hadoop\util\bloom\Key.java,120,56,2,2,0,60
hadoop-trunk\hadoop-trunk\hadoop-tools\hadoop-openstack\src\test\java\org\apache\hadoop\fs\swift\TestSwiftFileSystemLsOperations.java,136,14,1,2,0,17
hadoop-trunk\hadoop-trunk\hadoop-common-project\hadoop-common\src\main\java\org\apache\hadoop\ha\HealthCheckFailedException.java,12,5,0,1,0,6
hadoop-trunk\hadoop-trunk\hadoop-hdfs-project\hadoop-hdfs\src\main\java\org\apache\hadoop\hdfs\server\blockmanagement\NumberReplicas.java,0,32,0,12,0,44
hadoop-trunk\hadoop-trunk\hadoop-yarn-project\hadoop-yarn\hadoop-yarn-api\src\main\java\org\apache\hadoop\yarn\api\records\StrictPreemptionContract.java,27,4,0,2,0,6
hadoop-trunk\hadoop-trunk\hadoop-hdfs-project\hadoop-hdfs\src\main\java\org\apache\hadoop\hdfs\server\datanode\web\webhdfs\ExceptionHandler.java,0,11,6,6,0,23
hadoop-trunk\hadoop-trunk\hadoop-common-project\hadoop-auth\src\main\java\org\apache\hadoop\security\authentication\server\AuthenticationToken.java,77,13,1,5,0,19
hadoop-trunk\hadoop-trunk\hadoop-hdfs-project\hadoop-hdfs\src\main\java\org\apache\hadoop\hdfs\DeprecatedUTF8.java,0,18,0,1,0,19
hadoop-trunk\hadoop-trunk\hadoop-mapreduce-project\hadoop-mapreduce-client\hadoop-mapreduce-client-core\src\main\java\org\apache\hadoop\mapreduce\lib\input\SequenceFileInputFormat.java,0,13,0,1,0,14
hadoop-trunk\hadoop-trunk\hadoop-yarn-project\hadoop-yarn\hadoop-yarn-server\hadoop-yarn-server-resourcemanager\src\test\java\org\apache\hadoop\yarn\server\resourcemanager\scheduler\TestAbstractYarnScheduler.java,1180,155,85,19,0,259
hadoop-trunk\hadoop-trunk\hadoop-mapreduce-project\hadoop-mapreduce-client\hadoop-mapreduce-client-common\src\main\java\org\apache\hadoop\mapreduce\v2\api\protocolrecords\GetJobReportResponse.java,0,7,2,1,0,10
hadoop-trunk\hadoop-trunk\hadoop-common-project\hadoop-common\src\test\java\org\apache\hadoop\io\file\tfile\Timer.java,0,25,0,1,0,26
hadoop-trunk\hadoop-trunk\hadoop-mapreduce-project\hadoop-mapreduce-client\hadoop-mapreduce-client-app\src\main\java\org\apache\hadoop\mapreduce\v2\app\webapp\dao\TaskCounterInfo.java,22,14,1,1,0,16
hadoop-trunk\hadoop-trunk\hadoop-yarn-project\hadoop-yarn\hadoop-yarn-server\hadoop-yarn-server-resourcemanager\src\main\java\org\apache\hadoop\yarn\server\resourcemanager\monitor\capacity\TempUserPerPartition.java,59,27,1,2,0,30
hadoop-trunk\hadoop-trunk\hadoop-yarn-project\hadoop-yarn\hadoop-yarn-server\hadoop-yarn-server-applicationhistoryservice\src\test\java\org\apache\hadoop\yarn\server\applicationhistoryservice\TestApplicationHistoryManagerOnTimelineStore.java,632,103,7,11,0,121
hadoop-trunk\hadoop-trunk\hadoop-yarn-project\hadoop-yarn\hadoop-yarn-common\src\main\java\org\apache\hadoop\yarn\api\impl\pb\client\CsiAdaptorProtocolPBClientImpl.java,0,15,9,11,0,35
hadoop-trunk\hadoop-trunk\hadoop-mapreduce-project\hadoop-mapreduce-client\hadoop-mapreduce-client-core\src\test\java\org\apache\hadoop\mapred\TestClusterStatus.java,19,5,0,1,0,6
hadoop-trunk\hadoop-trunk\hadoop-yarn-project\hadoop-yarn\hadoop-yarn-server\hadoop-yarn-server-resourcemanager\src\main\java\org\apache\hadoop\yarn\server\resourcemanager\preprocessor\NodeLabelProcessor.java,0,4,0,1,0,5
hadoop-trunk\hadoop-trunk\hadoop-mapreduce-project\hadoop-mapreduce-client\hadoop-mapreduce-client-core\src\main\java\org\apache\hadoop\mapred\lib\CombineFileRecordReader.java,0,70,4,1,0,75
hadoop-trunk\hadoop-trunk\hadoop-mapreduce-project\hadoop-mapreduce-client\hadoop-mapreduce-client-jobclient\src\test\java\org\apache\hadoop\fs\slive\AppendOp.java,0,10,4,1,0,15
hadoop-trunk\hadoop-trunk\hadoop-mapreduce-project\hadoop-mapreduce-client\hadoop-mapreduce-client-jobclient\src\test\java\org\apache\hadoop\mapred\TestJobSysDirWithDFS.java,103,41,9,3,0,53
hadoop-trunk\hadoop-trunk\hadoop-tools\hadoop-azure\src\main\java\org\apache\hadoop\fs\azure\ClientThrottlingAnalyzer.java,0,37,5,1,0,43
hadoop-trunk\hadoop-trunk\hadoop-yarn-project\hadoop-yarn\hadoop-yarn-server\hadoop-yarn-server-common\src\main\java\org\apache\hadoop\yarn\server\webapp\AppInfoProvider.java,0,0,0,1,0,1
hadoop-trunk\hadoop-trunk\hadoop-common-project\hadoop-common\src\main\java\org\apache\hadoop\fs\shell\Command.java,0,121,13,2,0,136
hadoop-trunk\hadoop-trunk\hadoop-mapreduce-project\hadoop-mapreduce-client\hadoop-mapreduce-client-core\src\main\java\org\apache\hadoop\mapreduce\lib\output\FileOutputFormat.java,0,110,3,5,0,118
hadoop-trunk\hadoop-trunk\hadoop-yarn-project\hadoop-yarn\hadoop-yarn-server\hadoop-yarn-server-resourcemanager\src\main\java\org\apache\hadoop\yarn\server\resourcemanager\monitor\invariants\ReservationInvariantsChecker.java,34,3,2,1,0,6
hadoop-trunk\hadoop-trunk\hadoop-yarn-project\hadoop-yarn\hadoop-yarn-server\hadoop-yarn-server-nodemanager\src\main\java\org\apache\hadoop\yarn\server\nodemanager\containermanager\localizer\event\ContainerLocalizationCleanupEvent.java,23,8,0,4,0,12
hadoop-trunk\hadoop-trunk\hadoop-mapreduce-project\hadoop-mapreduce-client\hadoop-mapreduce-client-hs\src\main\java\org\apache\hadoop\mapreduce\v2\hs\HSAuditLogger.java,126,61,1,1,0,63
hadoop-trunk\hadoop-trunk\hadoop-yarn-project\hadoop-yarn\hadoop-yarn-server\hadoop-yarn-server-common\src\main\java\org\apache\hadoop\yarn\server\api\ResourceManagerConstants.java,0,4,2,1,0,7
hadoop-trunk\hadoop-trunk\hadoop-mapreduce-project\hadoop-mapreduce-client\hadoop-mapreduce-client-nativetask\src\main\java\org\apache\hadoop\mapred\nativetask\INativeHandler.java,0,18,5,3,0,26
hadoop-trunk\hadoop-trunk\hadoop-yarn-project\hadoop-yarn\hadoop-yarn-server\hadoop-yarn-server-applicationhistoryservice\src\main\java\org\apache\hadoop\yarn\server\timeline\recovery\TimelineStateStore.java,154,20,0,1,0,21
hadoop-trunk\hadoop-trunk\hadoop-yarn-project\hadoop-yarn\hadoop-yarn-common\src\main\java\org\apache\hadoop\yarn\api\impl\pb\client\ClientSCMProtocolPBClientImpl.java,49,10,6,10,0,26
hadoop-trunk\hadoop-trunk\hadoop-tools\hadoop-archive-logs\src\test\java\org\apache\hadoop\tools\TestHadoopArchiveLogsRunner.java,144,27,13,1,0,41
hadoop-trunk\hadoop-trunk\hadoop-tools\hadoop-resourceestimator\src\main\java\org\apache\hadoop\resourceestimator\common\exception\package-info.java,0,1,0,1,0,2
hadoop-trunk\hadoop-trunk\hadoop-yarn-project\hadoop-yarn\hadoop-yarn-server\hadoop-yarn-server-nodemanager\src\main\java\org\apache\hadoop\yarn\server\nodemanager\containermanager\records\package-info.java,0,1,0,1,0,2
hadoop-trunk\hadoop-trunk\hadoop-yarn-project\hadoop-yarn\hadoop-yarn-server\hadoop-yarn-server-nodemanager\src\test\java\org\apache\hadoop\yarn\server\nodemanager\containermanager\container\TestResourceMappings.java,83,11,0,1,0,12
hadoop-trunk\hadoop-trunk\hadoop-yarn-project\hadoop-yarn\hadoop-yarn-server\hadoop-yarn-server-common\src\main\java\org\apache\hadoop\yarn\server\api\impl\pb\client\CollectorNodemanagerProtocolPBClientImpl.java,0,12,6,11,0,29
hadoop-trunk\hadoop-trunk\hadoop-yarn-project\hadoop-yarn\hadoop-yarn-server\hadoop-yarn-server-common\src\test\java\org\apache\hadoop\yarn\server\federation\policies\amrmproxy\TestHomeAMRMProxyPolicy.java,65,13,0,5,0,18
hadoop-trunk\hadoop-trunk\hadoop-common-project\hadoop-common\src\main\java\org\apache\hadoop\io\compress\DirectDecompressor.java,0,11,1,1,0,13
hadoop-trunk\hadoop-trunk\hadoop-yarn-project\hadoop-yarn\hadoop-yarn-common\src\main\java\org\apache\hadoop\yarn\api\protocolrecords\impl\pb\GetClusterMetricsResponsePBImpl.java,99,37,37,5,0,79
hadoop-trunk\hadoop-trunk\hadoop-common-project\hadoop-common\src\test\java\org\apache\hadoop\crypto\TestCryptoStreamsWithJceSm4CtrCryptoCodec.java,18,1,0,2,0,3
hadoop-trunk\hadoop-trunk\hadoop-mapreduce-project\hadoop-mapreduce-client\hadoop-mapreduce-client-core\src\main\java\org\apache\hadoop\mapred\SequenceFileInputFilter.java,0,94,17,5,0,116
hadoop-trunk\hadoop-trunk\hadoop-yarn-project\hadoop-yarn\hadoop-yarn-applications\hadoop-yarn-services\hadoop-yarn-services-core\src\main\java\org\apache\hadoop\yarn\service\ServiceEvent.java,56,33,0,1,0,34
hadoop-trunk\hadoop-trunk\hadoop-tools\hadoop-gridmix\src\main\java\org\apache\hadoop\mapred\gridmix\InputStriper.java,0,31,2,1,0,34
hadoop-trunk\hadoop-trunk\hadoop-common-project\hadoop-common\src\main\java\org\apache\hadoop\io\compress\zstd\ZStandardDecompressor.java,304,63,7,1,0,71
hadoop-trunk\hadoop-trunk\hadoop-tools\hadoop-aws\src\main\java\org\apache\hadoop\fs\s3a\commit\CommitConstants.java,0,1,1,2,0,4
hadoop-trunk\hadoop-trunk\hadoop-tools\hadoop-azure\src\test\java\org\apache\hadoop\fs\azure\NativeAzureFileSystemBaseTest.java,0,277,53,56,0,386
hadoop-trunk\hadoop-trunk\hadoop-yarn-project\hadoop-yarn\hadoop-yarn-server\hadoop-yarn-server-resourcemanager\src\main\java\org\apache\hadoop\yarn\server\resourcemanager\scheduler\distributed\NodeQueueLoadMonitor.java,561,106,13,5,0,124
hadoop-trunk\hadoop-trunk\hadoop-mapreduce-project\hadoop-mapreduce-client\hadoop-mapreduce-client-core\src\main\java\org\apache\hadoop\mapreduce\jobhistory\TaskAttemptStartedEvent.java,122,67,35,1,0,103
hadoop-trunk\hadoop-trunk\hadoop-hdfs-project\hadoop-hdfs-client\src\main\java\org\apache\hadoop\fs\Hdfs.java,540,178,3,5,0,186
hadoop-trunk\hadoop-trunk\hadoop-yarn-project\hadoop-yarn\hadoop-yarn-server\hadoop-yarn-server-resourcemanager\src\test\java\org\apache\hadoop\yarn\server\resourcemanager\scheduler\fair\converter\TestFSConfigToCSConfigArgumentHandler.java,700,58,10,3,0,71
hadoop-trunk\hadoop-trunk\hadoop-hdfs-project\hadoop-hdfs\src\main\java\org\apache\hadoop\hdfs\server\namenode\EditLogBackupOutputStream.java,0,33,1,6,0,40
hadoop-trunk\hadoop-trunk\hadoop-yarn-project\hadoop-yarn\hadoop-yarn-server\hadoop-yarn-server-resourcemanager\src\main\java\org\apache\hadoop\yarn\server\resourcemanager\scheduler\capacity\QueueCapacities.java,318,199,2,4,0,205
hadoop-trunk\hadoop-trunk\hadoop-yarn-project\hadoop-yarn\hadoop-yarn-server\hadoop-yarn-server-nodemanager\src\main\java\org\apache\hadoop\yarn\server\nodemanager\containermanager\linux\runtime\docker\DockerRunCommand.java,216,100,3,2,0,105
hadoop-trunk\hadoop-trunk\hadoop-mapreduce-project\hadoop-mapreduce-client\hadoop-mapreduce-client-jobclient\src\test\java\org\apache\hadoop\mapred\TestIFileStreams.java,90,21,4,1,0,26
hadoop-trunk\hadoop-trunk\hadoop-tools\hadoop-federation-balance\src\test\java\org\apache\hadoop\tools\fedbalance\TestFedBalance.java,9,2,0,3,0,5
hadoop-trunk\hadoop-trunk\hadoop-common-project\hadoop-kms\src\test\java\org\apache\hadoop\crypto\key\kms\server\MiniKMS.java,139,50,2,2,0,54
hadoop-trunk\hadoop-trunk\hadoop-hdfs-project\hadoop-hdfs\src\test\java\org\apache\hadoop\hdfs\server\namenode\TestFSNamesystem.java,272,58,23,4,0,85
hadoop-trunk\hadoop-trunk\hadoop-yarn-project\hadoop-yarn\hadoop-yarn-server\hadoop-yarn-server-common\src\main\java\org\apache\hadoop\yarn\server\util\timeline\TimelineServerUtils.java,0,9,1,5,0,15
hadoop-trunk\hadoop-trunk\hadoop-hdfs-project\hadoop-hdfs\src\main\java\org\apache\hadoop\hdfs\server\blockmanagement\DatanodeAdminManager.java,0,57,13,2,0,72
hadoop-trunk\hadoop-trunk\hadoop-hdfs-project\hadoop-hdfs\src\test\java\org\apache\hadoop\hdfs\util\TestCyclicIteration.java,37,21,0,2,0,23
hadoop-trunk\hadoop-trunk\hadoop-tools\hadoop-azure\src\main\java\org\apache\hadoop\fs\azurebfs\oauth2\package-info.java,0,1,0,1,0,2
hadoop-trunk\hadoop-trunk\hadoop-yarn-project\hadoop-yarn\hadoop-yarn-applications\hadoop-yarn-services\hadoop-yarn-services-core\src\test\java\org\apache\hadoop\yarn\service\utils\TestCoreFileSystem.java,17,3,0,1,0,4
hadoop-trunk\hadoop-trunk\hadoop-common-project\hadoop-common\src\main\java\org\apache\hadoop\http\JettyUtils.java,0,2,0,1,0,3
hadoop-trunk\hadoop-trunk\hadoop-hdfs-project\hadoop-hdfs\src\main\java\org\apache\hadoop\hdfs\server\namenode\snapshot\DirectoryDiffListFactory.java,44,11,5,2,0,18
hadoop-trunk\hadoop-trunk\hadoop-yarn-project\hadoop-yarn\hadoop-yarn-server\hadoop-yarn-server-resourcemanager\src\main\java\org\apache\hadoop\yarn\server\resourcemanager\scheduler\ResourceScheduler.java,0,3,0,1,0,4
hadoop-trunk\hadoop-trunk\hadoop-yarn-project\hadoop-yarn\hadoop-yarn-server\hadoop-yarn-server-common\src\main\java\org\apache\hadoop\yarn\server\webapp\package-info.java,0,1,0,1,0,2
hadoop-trunk\hadoop-trunk\hadoop-yarn-project\hadoop-yarn\hadoop-yarn-api\src\main\java\org\apache\hadoop\yarn\api\records\NodeAttribute.java,48,17,0,1,0,18
hadoop-trunk\hadoop-trunk\hadoop-yarn-project\hadoop-yarn\hadoop-yarn-server\hadoop-yarn-server-nodemanager\src\test\java\org\apache\hadoop\yarn\server\nodemanager\containermanager\linux\resources\TestTrafficControlBandwidthHandlerImpl.java,182,28,3,6,0,37
hadoop-trunk\hadoop-trunk\hadoop-mapreduce-project\hadoop-mapreduce-client\hadoop-mapreduce-client-core\src\main\java\org\apache\hadoop\mapred\SequenceFileAsTextInputFormat.java,0,9,1,1,0,11
hadoop-trunk\hadoop-trunk\hadoop-yarn-project\hadoop-yarn\hadoop-yarn-server\hadoop-yarn-server-common\src\test\java\org\apache\hadoop\yarn\server\federation\policies\amrmproxy\TestBroadcastAMRMProxyFederationPolicy.java,0,9,2,3,0,14
hadoop-trunk\hadoop-trunk\hadoop-yarn-project\hadoop-yarn\hadoop-yarn-server\hadoop-yarn-server-router\src\test\java\org\apache\hadoop\yarn\server\router\webapp\TestRouterWebServiceUtil.java,542,65,2,3,0,70
hadoop-trunk\hadoop-trunk\hadoop-hdfs-project\hadoop-hdfs-rbf\src\main\java\org\apache\hadoop\hdfs\server\federation\metrics\StateStoreMBean.java,0,8,0,1,0,9
hadoop-trunk\hadoop-trunk\hadoop-hdfs-project\hadoop-hdfs\src\test\java\org\apache\hadoop\hdfs\web\TestWebHdfsTimeouts.java,339,61,12,10,0,83
hadoop-trunk\hadoop-trunk\hadoop-mapreduce-project\hadoop-mapreduce-client\hadoop-mapreduce-client-core\src\main\java\org\apache\hadoop\mapreduce\lib\input\CompressedSplitLineReader.java,64,19,2,1,0,22
hadoop-trunk\hadoop-trunk\hadoop-hdfs-project\hadoop-hdfs\src\test\java\org\apache\hadoop\fs\viewfs\TestViewFSOverloadSchemeWithMountTableConfigInHDFS.java,0,7,1,1,0,9
hadoop-trunk\hadoop-trunk\hadoop-common-project\hadoop-common\src\main\java\org\apache\hadoop\ha\StreamPumper.java,0,21,6,1,0,28
hadoop-trunk\hadoop-trunk\hadoop-hdfs-project\hadoop-hdfs\src\test\java\org\apache\hadoop\hdfs\server\namenode\ha\TestHASafeMode.java,900,266,13,12,0,291
hadoop-trunk\hadoop-trunk\hadoop-mapreduce-project\hadoop-mapreduce-client\hadoop-mapreduce-client-app\src\main\java\org\apache\hadoop\mapreduce\v2\app\webapp\dao\MapTaskAttemptInfo.java,14,7,1,1,0,9
hadoop-trunk\hadoop-trunk\hadoop-yarn-project\hadoop-yarn\hadoop-yarn-csi\src\test\java\org\apache\hadoop\yarn\csi\client\package-info.java,0,0,1,1,0,2
hadoop-trunk\hadoop-trunk\hadoop-common-project\hadoop-common\src\main\java\org\apache\hadoop\metrics2\impl\MetricGaugeInt.java,0,6,0,1,0,7
hadoop-trunk\hadoop-trunk\hadoop-yarn-project\hadoop-yarn\hadoop-yarn-applications\hadoop-yarn-services\hadoop-yarn-services-core\src\main\java\org\apache\hadoop\yarn\service\utils\ConfigHelper.java,120,24,1,4,0,29
hadoop-trunk\hadoop-trunk\hadoop-common-project\hadoop-common\src\main\java\org\apache\hadoop\io\compress\Decompressor.java,0,29,9,3,0,41
hadoop-trunk\hadoop-trunk\hadoop-mapreduce-project\hadoop-mapreduce-client\hadoop-mapreduce-client-core\src\main\java\org\apache\hadoop\mapreduce\jobhistory\TaskFinishedEvent.java,123,54,26,1,0,81
hadoop-trunk\hadoop-trunk\hadoop-mapreduce-project\hadoop-mapreduce-client\hadoop-mapreduce-client-hs\src\main\java\org\apache\hadoop\mapreduce\v2\hs\HistoryServerNullStateStoreService.java,0,9,0,1,0,10
hadoop-trunk\hadoop-trunk\hadoop-tools\hadoop-azure\src\main\java\org\apache\hadoop\fs\azurebfs\services\SharedKeyCredentials.java,470,66,5,51,0,122
hadoop-trunk\hadoop-trunk\hadoop-cloud-storage-project\hadoop-cos\src\test\java\org\apache\hadoop\fs\cosn\CosNTestConfigKey.java,0,4,0,1,0,5
hadoop-trunk\hadoop-trunk\hadoop-hdfs-project\hadoop-hdfs\src\test\java\org\apache\hadoop\hdfs\server\blockmanagement\TestSequentialBlockGroupId.java,179,27,17,6,0,50
hadoop-trunk\hadoop-trunk\hadoop-hdfs-project\hadoop-hdfs\src\main\java\org\apache\hadoop\hdfs\server\protocol\DatanodeLifelineProtocol.java,0,2,0,1,0,3
hadoop-trunk\hadoop-trunk\hadoop-mapreduce-project\hadoop-mapreduce-client\hadoop-mapreduce-client-core\src\main\java\org\apache\hadoop\mapred\lib\aggregate\ValueAggregatorBaseDescriptor.java,0,38,10,2,0,50
hadoop-trunk\hadoop-trunk\hadoop-tools\hadoop-rumen\src\main\java\org\apache\hadoop\tools\rumen\ZombieJobProducer.java,106,43,1,1,0,45
hadoop-trunk\hadoop-trunk\hadoop-hdfs-project\hadoop-hdfs\src\test\java\org\apache\hadoop\hdfs\server\namenode\TestDeadDatanode.java,172,38,5,3,0,46
hadoop-trunk\hadoop-trunk\hadoop-hdfs-project\hadoop-hdfs-rbf\src\main\java\org\apache\hadoop\hdfs\server\federation\store\driver\impl\package-info.java,0,2,0,1,0,3
hadoop-trunk\hadoop-trunk\hadoop-mapreduce-project\hadoop-mapreduce-client\hadoop-mapreduce-client-core\src\main\java\org\apache\hadoop\mapred\join\ComposableRecordReader.java,0,12,2,1,0,15
hadoop-trunk\hadoop-trunk\hadoop-yarn-project\hadoop-yarn\hadoop-yarn-server\hadoop-yarn-server-common\src\main\java\org\apache\hadoop\yarn\server\timeline\security\TimelineAuthenticationFilter.java,0,5,0,3,0,8
hadoop-trunk\hadoop-trunk\hadoop-yarn-project\hadoop-yarn\hadoop-yarn-server\hadoop-yarn-server-resourcemanager\src\main\java\org\apache\hadoop\yarn\server\resourcemanager\security\QueueACLsManager.java,58,15,1,4,0,20
hadoop-trunk\hadoop-trunk\hadoop-yarn-project\hadoop-yarn\hadoop-yarn-server\hadoop-yarn-server-resourcemanager\src\test\java\org\apache\hadoop\yarn\server\resourcemanager\webapp\TestRMWebServices.java,981,130,16,16,0,162
hadoop-trunk\hadoop-trunk\hadoop-tools\hadoop-azure\src\test\java\org\apache\hadoop\fs\azure\ITestNativeAzureFSAuthorizationCaching.java,0,7,0,4,0,11
hadoop-trunk\hadoop-trunk\hadoop-mapreduce-project\hadoop-mapreduce-examples\src\main\java\org\apache\hadoop\examples\ExampleDriver.java,0,34,2,16,0,52
hadoop-trunk\hadoop-trunk\hadoop-hdfs-project\hadoop-hdfs\src\main\java\org\apache\hadoop\hdfs\server\blockmanagement\DatanodeAdminBackoffMonitor.java,0,60,17,14,0,91
hadoop-trunk\hadoop-trunk\hadoop-tools\hadoop-sls\src\main\java\org\apache\hadoop\yarn\sls\scheduler\SchedulerWrapper.java,0,7,0,2,0,9
hadoop-trunk\hadoop-trunk\hadoop-yarn-project\hadoop-yarn\hadoop-yarn-common\src\main\java\org\apache\hadoop\yarn\server\api\protocolrecords\impl\pb\RunSharedCacheCleanerTaskRequestPBImpl.java,30,12,18,3,0,33
hadoop-trunk\hadoop-trunk\hadoop-mapreduce-project\hadoop-mapreduce-client\hadoop-mapreduce-client-core\src\main\java\org\apache\hadoop\mapreduce\lib\input\CombineFileRecordReader.java,0,68,4,1,0,73
hadoop-trunk\hadoop-trunk\hadoop-yarn-project\hadoop-yarn\hadoop-yarn-server\hadoop-yarn-server-resourcemanager\src\test\java\org\apache\hadoop\yarn\server\resourcemanager\TestRMHA.java,826,80,26,12,0,118
hadoop-trunk\hadoop-trunk\hadoop-tools\hadoop-distcp\src\test\java\org\apache\hadoop\tools\TestExternalCall.java,157,26,7,4,0,37
hadoop-trunk\hadoop-trunk\hadoop-yarn-project\hadoop-yarn\hadoop-yarn-server\hadoop-yarn-server-nodemanager\src\main\java\org\apache\hadoop\yarn\server\nodemanager\containermanager\linux\runtime\docker\DockerPullCommand.java,10,3,0,2,0,5
hadoop-trunk\hadoop-trunk\hadoop-hdfs-project\hadoop-hdfs\src\test\java\org\apache\hadoop\hdfs\server\namenode\TestFSNamesystemLockReport.java,153,33,0,5,0,38
hadoop-trunk\hadoop-trunk\hadoop-hdfs-project\hadoop-hdfs\src\test\java\org\apache\hadoop\hdfs\web\TestWebHdfsWithAuthenticationFilter.java,77,18,5,1,0,24
hadoop-trunk\hadoop-trunk\hadoop-mapreduce-project\hadoop-mapreduce-client\hadoop-mapreduce-client-core\src\main\java\org\apache\hadoop\mapreduce\ID.java,56,31,4,1,0,36
hadoop-trunk\hadoop-trunk\hadoop-common-project\hadoop-common\src\test\java\org\apache\hadoop\fs\contract\ftp\TestFTPContractDelete.java,9,2,0,1,0,3
hadoop-trunk\hadoop-trunk\hadoop-hdfs-project\hadoop-hdfs\src\test\java\org\apache\hadoop\hdfs\server\namenode\TestNNStorageRetentionManager.java,435,188,3,7,0,198
hadoop-trunk\hadoop-trunk\hadoop-yarn-project\hadoop-yarn\hadoop-yarn-server\hadoop-yarn-server-resourcemanager\src\main\java\org\apache\hadoop\yarn\server\resourcemanager\nodelabels\FileSystemNodeAttributeStore.java,0,17,0,1,0,18
hadoop-trunk\hadoop-trunk\hadoop-tools\hadoop-azure\src\main\java\org\apache\hadoop\fs\azurebfs\services\AbfsInputStreamStatisticsImpl.java,0,59,0,26,0,85
hadoop-trunk\hadoop-trunk\hadoop-yarn-project\hadoop-yarn\hadoop-yarn-server\hadoop-yarn-server-nodemanager\src\main\java\org\apache\hadoop\yarn\server\nodemanager\containermanager\linux\resources\OutboundBandwidthResourceHandler.java,0,0,0,2,0,2
hadoop-trunk\hadoop-trunk\hadoop-common-project\hadoop-nfs\src\main\java\org\apache\hadoop\nfs\nfs3\response\READ3Response.java,71,33,1,1,0,35
hadoop-trunk\hadoop-trunk\hadoop-tools\hadoop-aws\src\main\java\org\apache\hadoop\fs\s3a\impl\ActiveOperationContext.java,49,9,0,1,0,10
hadoop-trunk\hadoop-trunk\hadoop-tools\hadoop-sls\src\main\java\org\apache\hadoop\yarn\sls\ReservationClientUtil.java,0,14,1,1,0,16
hadoop-trunk\hadoop-trunk\hadoop-hdfs-project\hadoop-hdfs\src\test\java\org\apache\hadoop\hdfs\server\namenode\ha\TestDFSUpgradeWithHA.java,713,108,4,7,0,119
hadoop-trunk\hadoop-trunk\hadoop-yarn-project\hadoop-yarn\hadoop-yarn-server\hadoop-yarn-server-nodemanager\src\test\java\org\apache\hadoop\yarn\server\nodemanager\timelineservice\TestNMTimelinePublisher.java,325,42,25,7,0,74
hadoop-trunk\hadoop-trunk\hadoop-yarn-project\hadoop-yarn\hadoop-yarn-server\hadoop-yarn-server-timelineservice\src\main\java\org\apache\hadoop\yarn\server\timelineservice\collector\TimelineCollectorWebService.java,266,33,4,3,0,40
hadoop-trunk\hadoop-trunk\hadoop-yarn-project\hadoop-yarn\hadoop-yarn-server\hadoop-yarn-server-timelineservice-hbase\hadoop-yarn-server-timelineservice-hbase-common\src\main\java\org\apache\hadoop\yarn\server\timelineservice\storage\entity\EntityTable.java,0,0,0,1,0,1
hadoop-trunk\hadoop-trunk\hadoop-yarn-project\hadoop-yarn\hadoop-yarn-server\hadoop-yarn-server-resourcemanager\src\main\java\org\apache\hadoop\yarn\server\resourcemanager\webapp\dao\LocalResourceInfo.java,65,48,0,1,0,49
hadoop-trunk\hadoop-trunk\hadoop-common-project\hadoop-common\src\main\java\org\apache\hadoop\util\ExitUtil.java,0,52,6,1,0,59
hadoop-trunk\hadoop-trunk\hadoop-tools\hadoop-aliyun\src\test\java\org\apache\hadoop\fs\aliyun\oss\TestAliyunOSSBlockOutputStream.java,162,77,8,4,0,89
hadoop-trunk\hadoop-trunk\hadoop-yarn-project\hadoop-yarn\hadoop-yarn-applications\hadoop-yarn-applications-mawo\hadoop-yarn-applications-mawo-core\src\main\java\org\apache\hadoop\applications\mawo\server\common\NullTask.java,11,0,0,1,0,1
hadoop-trunk\hadoop-trunk\hadoop-yarn-project\hadoop-yarn\hadoop-yarn-common\src\test\java\org\apache\hadoop\yarn\event\InlineDispatcher.java,33,13,7,1,0,21
hadoop-trunk\hadoop-trunk\hadoop-common-project\hadoop-common\src\main\java\org\apache\hadoop\tracing\Span.java,24,12,4,1,0,17
hadoop-trunk\hadoop-trunk\hadoop-mapreduce-project\hadoop-mapreduce-client\hadoop-mapreduce-client-core\src\test\java\org\apache\hadoop\mapred\TestMaster.java,26,4,1,1,0,6
hadoop-trunk\hadoop-trunk\hadoop-common-project\hadoop-common\src\main\java\org\apache\hadoop\security\protocolPB\RefreshAuthorizationPolicyProtocolPB.java,0,5,3,4,0,12
hadoop-trunk\hadoop-trunk\hadoop-tools\hadoop-distcp\src\main\java\org\apache\hadoop\tools\mapred\UniformSizeInputFormat.java,0,19,4,4,0,27
hadoop-trunk\hadoop-trunk\hadoop-hdfs-project\hadoop-hdfs-client\src\main\java\org\apache\hadoop\hdfs\web\resources\IntegerParam.java,0,10,0,1,0,11
hadoop-trunk\hadoop-trunk\hadoop-common-project\hadoop-annotations\src\main\java\org\apache\hadoop\classification\tools\RootDocProcessor.java,0,26,22,4,0,52
hadoop-trunk\hadoop-trunk\hadoop-yarn-project\hadoop-yarn\hadoop-yarn-common\src\main\java\org\apache\hadoop\yarn\util\UTCClock.java,9,4,0,1,0,5
hadoop-trunk\hadoop-trunk\hadoop-yarn-project\hadoop-yarn\hadoop-yarn-applications\hadoop-yarn-services\hadoop-yarn-services-core\src\main\java\org\apache\hadoop\yarn\service\api\records\BaseResource.java,28,7,0,1,0,8
hadoop-trunk\hadoop-trunk\hadoop-common-project\hadoop-common\src\test\java\org\apache\hadoop\metrics2\sink\TestFileSink.java,106,82,3,7,0,92
hadoop-trunk\hadoop-trunk\hadoop-common-project\hadoop-common\src\test\java\org\apache\hadoop\fs\TestHardLink.java,271,91,24,1,0,116
hadoop-trunk\hadoop-trunk\hadoop-tools\hadoop-azure\src\main\java\org\apache\hadoop\fs\azure\Wasb.java,13,1,0,1,0,2
hadoop-trunk\hadoop-trunk\hadoop-common-project\hadoop-common\src\main\java\org\apache\hadoop\fs\statistics\impl\StubDurationTrackerFactory.java,0,0,0,1,0,1
hadoop-trunk\hadoop-trunk\hadoop-yarn-project\hadoop-yarn\hadoop-yarn-api\src\main\java\org\apache\hadoop\yarn\api\CsiAdaptorProtocol.java,0,0,0,3,0,3
hadoop-trunk\hadoop-trunk\hadoop-yarn-project\hadoop-yarn\hadoop-yarn-server\hadoop-yarn-server-timeline-pluginstorage\src\test\java\org\apache\hadoop\yarn\server\timeline\TestOverrideTimelineStoreYarnClient.java,28,4,0,1,0,5
hadoop-trunk\hadoop-trunk\hadoop-common-project\hadoop-common\src\main\java\org\apache\hadoop\ipc\IdentityProvider.java,0,2,1,1,0,4
hadoop-trunk\hadoop-trunk\hadoop-yarn-project\hadoop-yarn\hadoop-yarn-server\hadoop-yarn-server-nodemanager\src\main\java\org\apache\hadoop\yarn\server\nodemanager\api\protocolrecords\ResourceStatusType.java,0,3,0,1,0,4
hadoop-trunk\hadoop-trunk\hadoop-hdfs-project\hadoop-hdfs\src\main\java\org\apache\hadoop\hdfs\server\datanode\fsdataset\FsVolumeSpi.java,0,54,7,2,0,63
hadoop-trunk\hadoop-trunk\hadoop-yarn-project\hadoop-yarn\hadoop-yarn-server\hadoop-yarn-server-applicationhistoryservice\src\main\java\org\apache\hadoop\yarn\server\applicationhistoryservice\webapp\JAXBContextResolver.java,23,7,1,1,0,9
hadoop-trunk\hadoop-trunk\hadoop-hdfs-project\hadoop-hdfs\src\test\java\org\apache\hadoop\hdfs\server\namenode\TestRefreshNamenodeReplicationConfig.java,107,31,0,1,0,32
hadoop-trunk\hadoop-trunk\hadoop-yarn-project\hadoop-yarn\hadoop-yarn-server\hadoop-yarn-server-timelineservice-hbase\hadoop-yarn-server-timelineservice-hbase-common\src\main\java\org\apache\hadoop\yarn\server\timelineservice\storage\apptoflow\package-info.java,0,1,0,1,0,2
hadoop-trunk\hadoop-trunk\hadoop-hdfs-project\hadoop-hdfs\src\main\java\org\apache\hadoop\hdfs\server\namenode\NamenodeFsck.java,1379,311,79,29,0,419
hadoop-trunk\hadoop-trunk\hadoop-mapreduce-project\hadoop-mapreduce-examples\src\main\java\org\apache\hadoop\examples\WordStandardDeviation.java,173,38,5,2,0,45
hadoop-trunk\hadoop-trunk\hadoop-tools\hadoop-azure\src\test\java\org\apache\hadoop\fs\azurebfs\services\package-info.java,0,2,1,1,0,4
hadoop-trunk\hadoop-trunk\hadoop-yarn-project\hadoop-yarn\hadoop-yarn-server\hadoop-yarn-server-nodemanager\src\main\java\org\apache\hadoop\yarn\server\nodemanager\containermanager\logaggregation\NoneContainerLogAggregationPolicy.java,6,4,0,2,0,6
hadoop-trunk\hadoop-trunk\hadoop-tools\hadoop-azure\src\main\java\org\apache\hadoop\fs\azurebfs\extensions\CustomDelegationTokenManager.java,0,0,0,2,0,2
hadoop-trunk\hadoop-trunk\hadoop-tools\hadoop-aws\src\test\java\org\apache\hadoop\fs\s3a\S3ATestUtils.java,0,141,17,16,0,174
hadoop-trunk\hadoop-trunk\hadoop-yarn-project\hadoop-yarn\hadoop-yarn-server\hadoop-yarn-server-applicationhistoryservice\src\main\java\org\apache\hadoop\yarn\server\applicationhistoryservice\NullApplicationHistoryStore.java,80,22,6,10,0,38
hadoop-trunk\hadoop-trunk\hadoop-yarn-project\hadoop-yarn\hadoop-yarn-server\hadoop-yarn-server-common\src\main\java\org\apache\hadoop\yarn\server\federation\store\impl\package-info.java,0,0,0,1,0,1
hadoop-trunk\hadoop-trunk\hadoop-common-project\hadoop-common\src\test\java\org\apache\hadoop\service\TestGlobalStateChangeListener.java,189,20,9,3,0,32
hadoop-trunk\hadoop-trunk\hadoop-common-project\hadoop-common\src\test\java\org\apache\hadoop\io\serializer\TestSerializationFactory.java,72,19,6,2,0,27
hadoop-trunk\hadoop-trunk\hadoop-mapreduce-project\hadoop-mapreduce-client\hadoop-mapreduce-client-core\src\main\java\org\apache\hadoop\mapreduce\split\SplitMetaInfoReader.java,44,17,2,2,0,21
hadoop-trunk\hadoop-trunk\hadoop-mapreduce-project\hadoop-mapreduce-client\hadoop-mapreduce-client-jobclient\src\test\java\org\apache\hadoop\mapreduce\lib\input\TestMRKeyValueTextInputFormat.java,321,95,26,4,0,125
hadoop-trunk\hadoop-trunk\hadoop-hdfs-project\hadoop-hdfs\src\main\java\org\apache\hadoop\hdfs\server\datanode\DiskBalancer.java,1100,115,33,1,0,149
hadoop-trunk\hadoop-trunk\hadoop-yarn-project\hadoop-yarn\hadoop-yarn-api\src\main\java\org\apache\hadoop\yarn\api\records\NodeUpdateType.java,0,3,0,1,0,4
hadoop-trunk\hadoop-trunk\hadoop-yarn-project\hadoop-yarn\hadoop-yarn-server\hadoop-yarn-server-nodemanager\src\main\java\org\apache\hadoop\yarn\server\nodemanager\containermanager\linux\runtime\docker\DockerCommand.java,95,16,0,4,0,20
hadoop-trunk\hadoop-trunk\hadoop-tools\hadoop-azure\src\main\java\org\apache\hadoop\fs\azure\LocalSASKeyGeneratorImpl.java,240,22,0,4,0,26
hadoop-trunk\hadoop-trunk\hadoop-tools\hadoop-gridmix\src\test\java\org\apache\hadoop\mapred\gridmix\TestFileQueue.java,108,22,4,1,0,27
hadoop-trunk\hadoop-trunk\hadoop-hdfs-project\hadoop-hdfs\src\test\java\org\apache\hadoop\hdfs\TestSetrepIncreasing.java,114,35,2,4,0,41
hadoop-trunk\hadoop-trunk\hadoop-yarn-project\hadoop-yarn\hadoop-yarn-api\src\main\java\org\apache\hadoop\yarn\api\records\YarnClusterMetrics.java,90,15,0,1,0,16
hadoop-trunk\hadoop-trunk\hadoop-common-project\hadoop-common\src\main\java\org\apache\hadoop\fs\ChecksumException.java,13,8,0,1,0,9
hadoop-trunk\hadoop-trunk\hadoop-common-project\hadoop-common\src\main\java\org\apache\hadoop\fs\FutureDataInputStreamBuilder.java,0,1,0,2,0,3
hadoop-trunk\hadoop-trunk\hadoop-yarn-project\hadoop-yarn\hadoop-yarn-server\hadoop-yarn-server-resourcemanager\src\test\java\org\apache\hadoop\yarn\server\resourcemanager\webapp\TestRMWebAppFairScheduler.java,165,16,1,9,0,26
hadoop-trunk\hadoop-trunk\hadoop-hdfs-project\hadoop-hdfs\src\main\java\org\apache\hadoop\hdfs\server\datanode\fsdataset\impl\NativePmemMappedBlock.java,57,15,0,1,0,16
hadoop-trunk\hadoop-trunk\hadoop-yarn-project\hadoop-yarn\hadoop-yarn-server\hadoop-yarn-server-resourcemanager\src\test\java\org\apache\hadoop\yarn\server\resourcemanager\scheduler\TestSchedulingWithAllocationRequestId.java,0,49,5,4,0,58
hadoop-trunk\hadoop-trunk\hadoop-common-project\hadoop-common\src\main\java\org\apache\hadoop\io\MultipleIOException.java,62,23,0,1,0,24
hadoop-trunk\hadoop-trunk\hadoop-yarn-project\hadoop-yarn\hadoop-yarn-applications\hadoop-yarn-applications-distributedshell\src\test\java\org\apache\hadoop\yarn\applications\distributedshell\TestDSTimelineV20.java,422,54,4,5,0,63
hadoop-trunk\hadoop-trunk\hadoop-yarn-project\hadoop-yarn\hadoop-yarn-common\src\main\java\org\apache\hadoop\yarn\api\records\impl\pb\ProtoUtils.java,0,200,101,17,0,318
hadoop-trunk\hadoop-trunk\hadoop-mapreduce-project\hadoop-mapreduce-client\hadoop-mapreduce-client-jobclient\src\test\java\org\apache\hadoop\mapreduce\TestYarnClientProtocolProvider.java,86,11,3,3,0,17
hadoop-trunk\hadoop-trunk\hadoop-tools\hadoop-rumen\src\main\java\org\apache\hadoop\tools\rumen\datatypes\util\DefaultJobPropertiesParser.java,7,5,0,1,0,6
hadoop-trunk\hadoop-trunk\hadoop-yarn-project\hadoop-yarn\hadoop-yarn-server\hadoop-yarn-server-nodemanager\src\main\java\org\apache\hadoop\yarn\server\nodemanager\api\deviceplugin\MountDeviceSpec.java,0,28,2,1,0,31
hadoop-trunk\hadoop-trunk\hadoop-yarn-project\hadoop-yarn\hadoop-yarn-server\hadoop-yarn-server-resourcemanager\src\main\java\org\apache\hadoop\yarn\server\resourcemanager\volume\csi\processor\package-info.java,0,1,0,1,0,2
hadoop-trunk\hadoop-trunk\hadoop-hdfs-project\hadoop-hdfs\src\test\java\org\apache\hadoop\hdfs\server\namenode\TestSnapshotPathINodes.java,409,115,2,8,0,125
hadoop-trunk\hadoop-trunk\hadoop-common-project\hadoop-common\src\main\java\org\apache\hadoop\http\NoCacheFilter.java,25,5,2,1,0,8
hadoop-trunk\hadoop-trunk\hadoop-yarn-project\hadoop-yarn\hadoop-yarn-server\hadoop-yarn-server-router\src\main\java\org\apache\hadoop\yarn\server\router\clientrm\FederationClientInterceptor.java,0,96,17,20,0,133
hadoop-trunk\hadoop-trunk\hadoop-mapreduce-project\hadoop-mapreduce-client\hadoop-mapreduce-client-core\src\main\java\org\apache\hadoop\mapreduce\lib\aggregate\ValueAggregator.java,0,10,5,1,0,16
hadoop-trunk\hadoop-trunk\hadoop-yarn-project\hadoop-yarn\hadoop-yarn-common\src\main\java\org\apache\hadoop\yarn\api\records\impl\pb\ResourceBlacklistRequestPBImpl.java,142,37,33,2,0,72
hadoop-trunk\hadoop-trunk\hadoop-common-project\hadoop-common\src\test\java\org\apache\hadoop\ipc\TestRPCServerShutdown.java,66,7,2,1,0,10
hadoop-trunk\hadoop-trunk\hadoop-mapreduce-project\hadoop-mapreduce-client\hadoop-mapreduce-client-app\src\main\java\org\apache\hadoop\CustomOutputCommitter.java,56,27,0,1,0,28
hadoop-trunk\hadoop-trunk\hadoop-yarn-project\hadoop-yarn\hadoop-yarn-server\hadoop-yarn-server-resourcemanager\src\main\java\org\apache\hadoop\yarn\server\resourcemanager\volume\csi\VolumeManager.java,0,1,0,4,0,5
hadoop-trunk\hadoop-trunk\hadoop-yarn-project\hadoop-yarn\hadoop-yarn-server\hadoop-yarn-server-applicationhistoryservice\src\main\java\org\apache\hadoop\yarn\server\applicationhistoryservice\webapp\AboutBlock.java,19,6,0,1,0,7
hadoop-trunk\hadoop-trunk\hadoop-yarn-project\hadoop-yarn\hadoop-yarn-server\hadoop-yarn-server-resourcemanager\src\main\java\org\apache\hadoop\yarn\server\resourcemanager\webapp\RMAppLogAggregationStatusBlock.java,116,14,4,1,0,19
hadoop-trunk\hadoop-trunk\hadoop-tools\hadoop-aws\src\test\java\org\apache\hadoop\fs\s3a\audit\MemoryHungryAuditor.java,98,14,5,2,0,21
hadoop-trunk\hadoop-trunk\hadoop-yarn-project\hadoop-yarn\hadoop-yarn-server\hadoop-yarn-server-applicationhistoryservice\src\main\java\org\apache\hadoop\yarn\server\timeline\MemoryTimelineStore.java,86,12,1,1,0,14
hadoop-trunk\hadoop-trunk\hadoop-yarn-project\hadoop-yarn\hadoop-yarn-server\hadoop-yarn-server-resourcemanager\src\test\java\org\apache\hadoop\yarn\server\resourcemanager\webapp\TestRMWebServicesNodeLabels.java,605,138,1,48,0,187
hadoop-trunk\hadoop-trunk\hadoop-mapreduce-project\hadoop-mapreduce-client\hadoop-mapreduce-client-core\src\main\java\org\apache\hadoop\mapred\Reporter.java,0,49,12,1,0,62
hadoop-trunk\hadoop-trunk\hadoop-common-project\hadoop-registry\src\main\java\org\apache\hadoop\registry\conf\RegistryConfiguration.java,16,0,1,1,0,2
hadoop-trunk\hadoop-trunk\hadoop-yarn-project\hadoop-yarn\hadoop-yarn-common\src\test\java\org\apache\hadoop\yarn\webapp\hamlet2\TestParseSelector.java,31,9,1,1,0,11
hadoop-trunk\hadoop-trunk\hadoop-common-project\hadoop-common\src\main\java\org\apache\hadoop\ipc\UnexpectedServerException.java,26,8,0,1,0,9
hadoop-trunk\hadoop-trunk\hadoop-mapreduce-project\hadoop-mapreduce-client\hadoop-mapreduce-client-app\src\main\java\org\apache\hadoop\mapreduce\v2\app\webapp\ConfBlock.java,77,14,2,5,0,21
hadoop-trunk\hadoop-trunk\hadoop-tools\hadoop-azure\src\main\java\org\apache\hadoop\fs\azure\StorageInterface.java,736,156,12,68,0,236
hadoop-trunk\hadoop-trunk\hadoop-yarn-project\hadoop-yarn\hadoop-yarn-applications\hadoop-yarn-services\hadoop-yarn-services-core\src\test\java\org\apache\hadoop\yarn\service\conf\TestValidateServiceNames.java,95,19,1,1,0,21
hadoop-trunk\hadoop-trunk\hadoop-yarn-project\hadoop-yarn\hadoop-yarn-server\hadoop-yarn-server-timelineservice-hbase\hadoop-yarn-server-timelineservice-hbase-client\src\main\java\org\apache\hadoop\yarn\server\timelineservice\storage\application\package-info.java,0,0,0,1,0,1
hadoop-trunk\hadoop-trunk\hadoop-tools\hadoop-aliyun\src\test\java\org\apache\hadoop\fs\aliyun\oss\yarn\TestOSSMiniYarnCluster.java,112,21,1,1,0,23
hadoop-trunk\hadoop-trunk\hadoop-yarn-project\hadoop-yarn\hadoop-yarn-server\hadoop-yarn-server-resourcemanager\src\test\java\org\apache\hadoop\yarn\server\resourcemanager\TestApplicationMasterServiceFair.java,81,11,0,7,0,18
hadoop-trunk\hadoop-trunk\hadoop-cloud-storage-project\hadoop-huaweicloud\src\main\java\org\apache\hadoop\fs\obs\OBSConstants.java,0,0,0,1,0,1
hadoop-trunk\hadoop-trunk\hadoop-hdfs-project\hadoop-hdfs-rbf\src\main\java\org\apache\hadoop\hdfs\server\federation\store\protocol\UpdateMountTableEntryResponse.java,15,4,0,2,0,6
hadoop-trunk\hadoop-trunk\hadoop-mapreduce-project\hadoop-mapreduce-examples\src\main\java\org\apache\hadoop\examples\dancing\DancingLinks.java,402,114,5,3,0,122
hadoop-trunk\hadoop-trunk\hadoop-common-project\hadoop-common\src\test\java\org\apache\hadoop\fs\TestLocalDirAllocator.java,489,113,13,7,0,133
hadoop-trunk\hadoop-trunk\hadoop-hdfs-project\hadoop-hdfs\src\test\java\org\apache\hadoop\hdfs\TestDFSShell.java,0,488,165,34,0,687
hadoop-trunk\hadoop-trunk\hadoop-hdfs-project\hadoop-hdfs-client\src\main\java\org\apache\hadoop\hdfs\web\WebHdfsFileSystem.java,0,470,24,19,0,513
hadoop-trunk\hadoop-trunk\hadoop-tools\hadoop-azure\src\test\java\org\apache\hadoop\fs\azure\ITestNativeAzureFileSystemAtomicRenameDirList.java,0,4,0,1,0,5
hadoop-trunk\hadoop-trunk\hadoop-yarn-project\hadoop-yarn\hadoop-yarn-api\src\main\java\org\apache\hadoop\yarn\api\protocolrecords\KillApplicationResponse.java,27,7,0,3,0,10
hadoop-trunk\hadoop-trunk\hadoop-yarn-project\hadoop-yarn\hadoop-yarn-server\hadoop-yarn-server-resourcemanager\src\main\java\org\apache\hadoop\yarn\server\resourcemanager\security\ProxyCAManager.java,45,16,1,2,0,19
hadoop-trunk\hadoop-trunk\hadoop-common-project\hadoop-common\src\main\java\org\apache\hadoop\fs\Abortable.java,0,1,0,1,0,2
hadoop-trunk\hadoop-trunk\hadoop-tools\hadoop-azure\src\test\java\org\apache\hadoop\fs\azurebfs\contract\ITestAbfsFileSystemContractGetFileStatus.java,26,7,0,2,0,9
hadoop-trunk\hadoop-trunk\hadoop-common-project\hadoop-common\src\main\java\org\apache\hadoop\crypto\OpensslCtrCryptoCodec.java,151,61,2,2,0,65
hadoop-trunk\hadoop-trunk\hadoop-yarn-project\hadoop-yarn\hadoop-yarn-server\hadoop-yarn-server-resourcemanager\src\main\java\org\apache\hadoop\yarn\server\resourcemanager\webapp\dao\AppsInfo.java,21,11,5,1,0,17
hadoop-trunk\hadoop-trunk\hadoop-common-project\hadoop-common\src\main\java\org\apache\hadoop\fs\viewfs\NotInMountpointException.java,17,9,1,1,0,11
hadoop-trunk\hadoop-trunk\hadoop-yarn-project\hadoop-yarn\hadoop-yarn-server\hadoop-yarn-server-resourcemanager\src\test\java\org\apache\hadoop\yarn\server\resourcemanager\TestOpportunisticContainerAllocatorAMService.java,1222,161,17,35,0,213
hadoop-trunk\hadoop-trunk\hadoop-hdfs-project\hadoop-hdfs\src\main\java\org\apache\hadoop\hdfs\server\namenode\INodeMap.java,108,37,3,1,0,41
hadoop-trunk\hadoop-trunk\hadoop-yarn-project\hadoop-yarn\hadoop-yarn-client\src\test\java\org\apache\hadoop\yarn\client\TestApplicationClientProtocolOnHA.java,171,24,0,1,0,25
hadoop-trunk\hadoop-trunk\hadoop-yarn-project\hadoop-yarn\hadoop-yarn-server\hadoop-yarn-server-resourcemanager\src\main\java\org\apache\hadoop\yarn\server\resourcemanager\rmapp\RMAppEventType.java,0,17,0,1,0,18
hadoop-trunk\hadoop-trunk\hadoop-tools\hadoop-gridmix\src\main\java\org\apache\hadoop\mapred\gridmix\CompressionEmulationUtil.java,0,383,14,2,0,399
hadoop-trunk\hadoop-trunk\hadoop-common-project\hadoop-common\src\main\java\org\apache\hadoop\util\ChunkedArrayList.java,159,32,0,1,0,33
hadoop-trunk\hadoop-trunk\hadoop-hdfs-project\hadoop-hdfs-client\src\main\java\org\apache\hadoop\hdfs\web\resources\StorageSpaceQuotaParam.java,0,4,0,1,0,5
hadoop-trunk\hadoop-trunk\hadoop-yarn-project\hadoop-yarn\hadoop-yarn-server\hadoop-yarn-server-resourcemanager\src\main\java\org\apache\hadoop\yarn\server\resourcemanager\EmbeddedElector.java,0,1,0,1,0,2
hadoop-trunk\hadoop-trunk\hadoop-yarn-project\hadoop-yarn\hadoop-yarn-server\hadoop-yarn-server-resourcemanager\src\main\java\org\apache\hadoop\yarn\server\resourcemanager\recovery\RMStateStore.java,1284,294,43,16,0,353
hadoop-trunk\hadoop-trunk\hadoop-yarn-project\hadoop-yarn\hadoop-yarn-server\hadoop-yarn-server-timelineservice\src\test\java\org\apache\hadoop\yarn\server\timelineservice\reader\TestTimelineReaderWebServicesBasicAcl.java,131,16,3,1,0,20
hadoop-trunk\hadoop-trunk\hadoop-yarn-project\hadoop-yarn\hadoop-yarn-server\hadoop-yarn-server-resourcemanager\src\main\java\org\apache\hadoop\yarn\server\resourcemanager\recovery\records\impl\pb\AMRMTokenSecretManagerStatePBImpl.java,100,31,39,6,0,76
hadoop-trunk\hadoop-trunk\hadoop-common-project\hadoop-common\src\main\java\org\apache\hadoop\net\ScriptBasedMappingWithDependency.java,0,36,2,2,0,40
hadoop-trunk\hadoop-trunk\hadoop-yarn-project\hadoop-yarn\hadoop-yarn-server\hadoop-yarn-server-nodemanager\src\main\java\org\apache\hadoop\yarn\server\nodemanager\containermanager\linux\runtime\runc\ImageTagToManifestPlugin.java,0,49,3,12,0,64
hadoop-trunk\hadoop-trunk\hadoop-tools\hadoop-distcp\src\test\java\org\apache\hadoop\tools\TestDistCpSyncReverseFromSource.java,0,1,0,1,0,2
hadoop-trunk\hadoop-trunk\hadoop-yarn-project\hadoop-yarn\hadoop-yarn-server\hadoop-yarn-server-nodemanager\src\main\java\org\apache\hadoop\yarn\server\nodemanager\containermanager\logaggregation\AbstractContainerLogAggregationPolicy.java,5,4,1,2,0,7
hadoop-trunk\hadoop-trunk\hadoop-hdfs-project\hadoop-hdfs\src\main\java\org\apache\hadoop\hdfs\server\blockmanagement\HostSet.java,75,13,0,2,0,15
hadoop-trunk\hadoop-trunk\hadoop-yarn-project\hadoop-yarn\hadoop-yarn-applications\hadoop-yarn-services\hadoop-yarn-services-core\src\test\java\org\apache\hadoop\yarn\service\conf\TestAppJsonResolve.java,190,18,5,1,0,24
hadoop-trunk\hadoop-trunk\hadoop-mapreduce-project\hadoop-mapreduce-client\hadoop-mapreduce-client-core\src\main\java\org\apache\hadoop\mapreduce\jobhistory\JobInfoChangeEvent.java,48,28,16,1,0,45
hadoop-trunk\hadoop-trunk\hadoop-yarn-project\hadoop-yarn\hadoop-yarn-common\src\main\java\org\apache\hadoop\yarn\state\StateMachineFactory.java,0,149,11,10,0,170
hadoop-trunk\hadoop-trunk\hadoop-hdfs-project\hadoop-hdfs\src\test\java\org\apache\hadoop\TestRefreshCallQueue.java,133,30,8,2,0,40
hadoop-trunk\hadoop-trunk\hadoop-yarn-project\hadoop-yarn\hadoop-yarn-server\hadoop-yarn-server-applicationhistoryservice\src\main\java\org\apache\hadoop\yarn\server\timeline\security\TimelineV1DelegationTokenSecretManagerService.java,173,38,11,4,0,53
hadoop-trunk\hadoop-trunk\hadoop-tools\hadoop-gridmix\src\test\java\org\apache\hadoop\mapred\gridmix\TestGridmixMemoryEmulation.java,419,172,1,5,0,178
hadoop-trunk\hadoop-trunk\hadoop-hdfs-project\hadoop-hdfs-httpfs\src\test\java\org\apache\hadoop\lib\service\instrumentation\TestInstrumentationService.java,367,95,2,33,0,130
hadoop-trunk\hadoop-trunk\hadoop-tools\hadoop-rumen\src\main\java\org\apache\hadoop\tools\rumen\LoggedTaskAttempt.java,726,322,14,2,0,338
hadoop-trunk\hadoop-trunk\hadoop-common-project\hadoop-common\src\test\java\org\apache\hadoop\fs\TestFsUrlConnectionPath.java,80,40,4,1,0,45
hadoop-trunk\hadoop-trunk\hadoop-common-project\hadoop-registry\src\test\java\org\apache\hadoop\registry\secure\AbstractSecureRegistryTest.java,309,78,5,2,0,85
hadoop-trunk\hadoop-trunk\hadoop-common-project\hadoop-common\src\test\java\org\apache\hadoop\fs\contract\ContractTestUtils.java,1939,288,9,4,0,301
hadoop-trunk\hadoop-trunk\hadoop-yarn-project\hadoop-yarn\hadoop-yarn-client\src\test\java\org\apache\hadoop\yarn\client\api\impl\TestYarnClientImpl.java,312,21,3,8,0,32
hadoop-trunk\hadoop-trunk\hadoop-mapreduce-project\hadoop-mapreduce-examples\src\main\java\org\apache\hadoop\examples\terasort\TeraScheduler.java,0,67,2,1,0,70
hadoop-trunk\hadoop-trunk\hadoop-common-project\hadoop-common\src\test\java\org\apache\hadoop\io\file\tfile\TestTFile.java,395,100,38,1,0,139
hadoop-trunk\hadoop-trunk\hadoop-mapreduce-project\hadoop-mapreduce-client\hadoop-mapreduce-client-core\src\main\java\org\apache\hadoop\mapred\BackupStore.java,0,172,23,1,0,196
hadoop-trunk\hadoop-trunk\hadoop-tools\hadoop-aws\src\main\java\org\apache\hadoop\fs\s3a\S3AOpContext.java,46,18,0,1,0,19
hadoop-trunk\hadoop-trunk\hadoop-mapreduce-project\hadoop-mapreduce-client\hadoop-mapreduce-client-core\src\main\java\org\apache\hadoop\mapreduce\security\token\JobTokenSecretManager.java,103,22,1,1,0,24
hadoop-trunk\hadoop-trunk\hadoop-common-project\hadoop-common\src\main\java\org\apache\hadoop\fs\PathPermissionException.java,22,12,0,1,0,13
hadoop-trunk\hadoop-trunk\hadoop-common-project\hadoop-common\src\test\java\org\apache\hadoop\io\retry\TestFailoverProxy.java,332,103,5,10,0,118
hadoop-trunk\hadoop-trunk\hadoop-hdfs-project\hadoop-hdfs\src\test\java\org\apache\hadoop\hdfs\server\namenode\TestDiskspaceQuotaUpdate.java,487,110,11,2,0,123
hadoop-trunk\hadoop-trunk\hadoop-yarn-project\hadoop-yarn\hadoop-yarn-server\hadoop-yarn-server-resourcemanager\src\main\java\org\apache\hadoop\yarn\server\resourcemanager\placement\PlacementFactory.java,0,6,2,1,0,9
hadoop-trunk\hadoop-trunk\hadoop-hdfs-project\hadoop-hdfs-nfs\src\main\java\org\apache\hadoop\hdfs\nfs\nfs3\RpcProgramNfs3.java,2196,258,65,13,0,336
hadoop-trunk\hadoop-trunk\hadoop-yarn-project\hadoop-yarn\hadoop-yarn-applications\hadoop-yarn-services\hadoop-yarn-services-core\src\main\java\org\apache\hadoop\yarn\service\provider\tarball\TarballClientProvider.java,0,10,2,1,0,13
hadoop-trunk\hadoop-trunk\hadoop-tools\hadoop-aws\src\test\java\org\apache\hadoop\fs\s3a\commit\staging\integration\ITestDirectoryCommitProtocol.java,125,22,0,3,0,25
hadoop-trunk\hadoop-trunk\hadoop-yarn-project\hadoop-yarn\hadoop-yarn-server\hadoop-yarn-server-resourcemanager\src\main\java\org\apache\hadoop\yarn\server\resourcemanager\scheduler\constraint\api\PlacedSchedulingRequest.java,46,18,0,1,0,19
hadoop-trunk\hadoop-trunk\hadoop-common-project\hadoop-common\src\test\java\org\apache\hadoop\fs\contract\ftp\TestFTPContractMkdir.java,8,2,0,1,0,3
hadoop-trunk\hadoop-trunk\hadoop-yarn-project\hadoop-yarn\hadoop-yarn-server\hadoop-yarn-server-nodemanager\src\test\java\org\apache\hadoop\yarn\server\nodemanager\containermanager\resourceplugin\com\nvidia\TestNvidiaGPUPluginForRuntimeV2.java,795,148,19,4,0,171
hadoop-trunk\hadoop-trunk\hadoop-tools\hadoop-streaming\src\test\java\org\apache\hadoop\streaming\TestFileArgs.java,0,14,10,1,0,25
hadoop-trunk\hadoop-trunk\hadoop-mapreduce-project\hadoop-mapreduce-client\hadoop-mapreduce-client-core\src\main\java\org\apache\hadoop\mapreduce\lib\partition\InputSampler.java,0,138,12,1,0,151
hadoop-trunk\hadoop-trunk\hadoop-yarn-project\hadoop-yarn\hadoop-yarn-applications\hadoop-yarn-applications-catalog\hadoop-yarn-applications-catalog-webapp\src\main\java\org\apache\hadoop\yarn\appcatalog\model\AppEntry.java,40,32,0,1,0,33
hadoop-trunk\hadoop-trunk\hadoop-yarn-project\hadoop-yarn\hadoop-yarn-server\hadoop-yarn-server-timeline-pluginstorage\src\test\java\org\apache\hadoop\yarn\server\timeline\TestLogInfo.java,201,38,4,7,0,49
hadoop-trunk\hadoop-trunk\hadoop-yarn-project\hadoop-yarn\hadoop-yarn-server\hadoop-yarn-server-timelineservice-hbase\hadoop-yarn-server-timelineservice-hbase-client\src\main\java\org\apache\hadoop\yarn\server\timelineservice\storage\HBaseTimelineSchemaCreator.java,0,31,12,9,0,52
hadoop-trunk\hadoop-trunk\hadoop-yarn-project\hadoop-yarn\hadoop-yarn-server\hadoop-yarn-server-nodemanager\src\main\java\org\apache\hadoop\yarn\server\nodemanager\WindowsSecureContainerExecutor.java,0,266,12,12,0,290
hadoop-trunk\hadoop-trunk\hadoop-hdfs-project\hadoop-hdfs\src\test\java\org\apache\hadoop\hdfs\server\datanode\fsdataset\impl\TestFsDatasetImpl.java,0,229,41,6,0,276
hadoop-trunk\hadoop-trunk\hadoop-yarn-project\hadoop-yarn\hadoop-yarn-server\hadoop-yarn-server-resourcemanager\src\test\java\org\apache\hadoop\yarn\server\resourcemanager\scheduler\capacity\CapacitySchedulerPreemptionTestBase.java,125,41,7,8,0,56
hadoop-trunk\hadoop-trunk\hadoop-yarn-project\hadoop-yarn\hadoop-yarn-applications\hadoop-yarn-services\hadoop-yarn-services-core\src\main\java\org\apache\hadoop\yarn\service\utils\SliderFileSystem.java,102,24,0,1,0,25
hadoop-trunk\hadoop-trunk\hadoop-yarn-project\hadoop-yarn\hadoop-yarn-server\hadoop-yarn-server-common\src\main\java\org\apache\hadoop\yarn\server\api\protocolrecords\GetTimelineCollectorContextRequest.java,15,4,0,1,0,5
hadoop-trunk\hadoop-trunk\hadoop-common-project\hadoop-common\src\test\java\org\apache\hadoop\metrics2\source\TestJvmMetrics.java,266,42,17,1,0,60
hadoop-trunk\hadoop-trunk\hadoop-yarn-project\hadoop-yarn\hadoop-yarn-server\hadoop-yarn-server-resourcemanager\src\main\java\org\apache\hadoop\yarn\server\resourcemanager\webapp\dao\AppRequestAllocationInfo.java,45,17,1,3,0,21
hadoop-trunk\hadoop-trunk\hadoop-common-project\hadoop-common\src\main\java\org\apache\hadoop\ipc\ProxyCombiner.java,0,14,2,1,0,17
hadoop-trunk\hadoop-trunk\hadoop-mapreduce-project\hadoop-mapreduce-client\hadoop-mapreduce-client-core\src\main\java\org\apache\hadoop\mapreduce\lib\input\TextInputFormat.java,0,9,1,1,0,11
hadoop-trunk\hadoop-trunk\hadoop-hdfs-project\hadoop-hdfs-nfs\src\main\java\org\apache\hadoop\hdfs\nfs\conf\NfsConfiguration.java,46,1,0,1,0,2
hadoop-trunk\hadoop-trunk\hadoop-tools\hadoop-aws\src\main\java\org\apache\hadoop\fs\s3a\commit\magic\MagicS3GuardCommitterFactory.java,0,5,0,1,0,6
hadoop-trunk\hadoop-trunk\hadoop-tools\hadoop-streaming\src\test\java\org\apache\hadoop\streaming\TestMRFramework.java,23,7,1,1,0,9
hadoop-trunk\hadoop-trunk\hadoop-yarn-project\hadoop-yarn\hadoop-yarn-server\hadoop-yarn-server-timelineservice-hbase\hadoop-yarn-server-timelineservice-hbase-client\src\main\java\org\apache\hadoop\yarn\server\timelineservice\storage\common\package-info.java,0,0,0,1,0,1
hadoop-trunk\hadoop-trunk\hadoop-yarn-project\hadoop-yarn\hadoop-yarn-server\hadoop-yarn-server-nodemanager\src\main\java\org\apache\hadoop\yarn\server\nodemanager\webapp\NMController.java,46,22,1,1,0,24
hadoop-trunk\hadoop-trunk\hadoop-mapreduce-project\hadoop-mapreduce-client\hadoop-mapreduce-client-jobclient\src\test\java\testjar\JobKillCommitter.java,90,37,4,3,0,44
hadoop-trunk\hadoop-trunk\hadoop-common-project\hadoop-common\src\test\java\org\apache\hadoop\test\LambdaTestUtils.java,0,121,12,1,0,134
hadoop-trunk\hadoop-trunk\hadoop-common-project\hadoop-common\src\main\java\org\apache\hadoop\util\GcTimeMonitor.java,257,71,4,2,0,77
hadoop-trunk\hadoop-trunk\hadoop-mapreduce-project\hadoop-mapreduce-client\hadoop-mapreduce-client-core\src\main\java\org\apache\hadoop\mapreduce\jobhistory\package-info.java,0,1,0,1,0,2
hadoop-trunk\hadoop-trunk\hadoop-yarn-project\hadoop-yarn\hadoop-yarn-server\hadoop-yarn-server-applicationhistoryservice\src\main\java\org\apache\hadoop\yarn\server\applicationhistoryservice\ApplicationHistoryClientService.java,171,33,11,6,0,50
hadoop-trunk\hadoop-trunk\hadoop-yarn-project\hadoop-yarn\hadoop-yarn-common\src\main\java\org\apache\hadoop\yarn\logaggregation\AggregatedLogDeletionService.java,256,70,5,7,0,82
hadoop-trunk\hadoop-trunk\hadoop-hdfs-project\hadoop-hdfs\src\main\java\org\apache\hadoop\hdfs\server\namenode\startupprogress\StepType.java,0,13,2,2,0,17
hadoop-trunk\hadoop-trunk\hadoop-common-project\hadoop-common\src\test\java\org\apache\hadoop\io\compress\FakeDecompressor.java,0,19,2,1,0,22
hadoop-trunk\hadoop-trunk\hadoop-hdfs-project\hadoop-hdfs-rbf\src\main\java\org\apache\hadoop\hdfs\server\federation\resolver\NamenodePriorityComparator.java,0,5,0,1,0,6
hadoop-trunk\hadoop-trunk\hadoop-common-project\hadoop-common\src\main\java\org\apache\hadoop\util\Timer.java,31,1,0,1,0,2
hadoop-trunk\hadoop-trunk\hadoop-common-project\hadoop-common\src\test\java\org\apache\hadoop\ipc\TestIPC.java,0,681,78,16,0,775
hadoop-trunk\hadoop-trunk\hadoop-yarn-project\hadoop-yarn\hadoop-yarn-api\src\main\java\org\apache\hadoop\yarn\server\api\protocolrecords\CheckForDecommissioningNodesResponse.java,16,6,0,2,0,8
hadoop-trunk\hadoop-trunk\hadoop-mapreduce-project\hadoop-mapreduce-client\hadoop-mapreduce-client-uploader\src\main\java\org\apache\hadoop\mapred\uploader\package-info.java,0,0,0,1,0,1
hadoop-trunk\hadoop-trunk\hadoop-yarn-project\hadoop-yarn\hadoop-yarn-server\hadoop-yarn-server-timelineservice-documentstore\src\main\java\org\apache\hadoop\yarn\server\timelineservice\documentstore\writer\package-info.java,0,0,0,1,0,1
hadoop-trunk\hadoop-trunk\hadoop-yarn-project\hadoop-yarn\hadoop-yarn-server\hadoop-yarn-server-nodemanager\src\main\java\org\apache\hadoop\yarn\server\nodemanager\containermanager\localizer\LocalizedResource.java,262,77,12,12,0,101
hadoop-trunk\hadoop-trunk\hadoop-common-project\hadoop-auth-examples\src\main\java\org\apache\hadoop\security\authentication\examples\RequestLoggerFilter.java,157,41,5,8,0,54
hadoop-trunk\hadoop-trunk\hadoop-hdfs-project\hadoop-hdfs\src\main\java\org\apache\hadoop\hdfs\util\EnumCounters.java,154,40,1,1,0,42
hadoop-trunk\hadoop-trunk\hadoop-hdfs-project\hadoop-hdfs\src\test\java\org\apache\hadoop\fs\TestResolveHdfsSymlink.java,129,13,5,5,0,23
hadoop-trunk\hadoop-trunk\hadoop-yarn-project\hadoop-yarn\hadoop-yarn-server\hadoop-yarn-server-resourcemanager\src\main\java\org\apache\hadoop\yarn\server\resourcemanager\scheduler\event\AppAddedSchedulerEvent.java,92,85,0,1,0,86
hadoop-trunk\hadoop-trunk\hadoop-common-project\hadoop-common\src\main\java\org\apache\hadoop\metrics2\lib\MutableStat.java,155,83,1,1,0,85
hadoop-trunk\hadoop-trunk\hadoop-yarn-project\hadoop-yarn\hadoop-yarn-server\hadoop-yarn-server-nodemanager\src\main\java\org\apache\hadoop\yarn\server\nodemanager\api\impl\pb\package-info.java,0,1,0,1,0,2
hadoop-trunk\hadoop-trunk\hadoop-hdfs-project\hadoop-hdfs-httpfs\src\test\java\org\apache\hadoop\test\HadoopUsersConfTestHelper.java,151,31,3,20,0,54
hadoop-trunk\hadoop-trunk\hadoop-mapreduce-project\hadoop-mapreduce-client\hadoop-mapreduce-client-hs\src\test\java\org\apache\hadoop\mapreduce\v2\hs\TestUnnecessaryBlockingOnHistoryFileInfo.java,273,45,1,1,0,47
hadoop-trunk\hadoop-trunk\hadoop-mapreduce-project\hadoop-mapreduce-client\hadoop-mapreduce-client-core\src\main\java\org\apache\hadoop\mapreduce\lib\output\committer\manifest\files\DirEntry.java,0,30,1,4,0,35
hadoop-trunk\hadoop-trunk\hadoop-hdfs-project\hadoop-hdfs-rbf\src\main\java\org\apache\hadoop\hdfs\server\federation\router\ErasureCoding.java,172,35,1,4,0,40
hadoop-trunk\hadoop-trunk\hadoop-cloud-storage-project\hadoop-cos\src\main\java\org\apache\hadoop\fs\cosn\auth\AbstractCOSCredentialsProvider.java,0,12,0,1,0,13
hadoop-trunk\hadoop-trunk\hadoop-yarn-project\hadoop-yarn\hadoop-yarn-server\hadoop-yarn-server-nodemanager\src\main\java\org\apache\hadoop\yarn\server\nodemanager\containermanager\application\ApplicationImpl.java,622,139,23,18,0,180
hadoop-trunk\hadoop-trunk\hadoop-common-project\hadoop-common\src\main\java\org\apache\hadoop\fs\impl\OpenFileParameters.java,62,17,2,1,0,20
hadoop-trunk\hadoop-trunk\hadoop-mapreduce-project\hadoop-mapreduce-client\hadoop-mapreduce-client-app\src\test\java\org\apache\hadoop\mapreduce\v2\api\records\TestTaskReport.java,108,9,0,1,0,10
hadoop-trunk\hadoop-trunk\hadoop-mapreduce-project\hadoop-mapreduce-client\hadoop-mapreduce-client-jobclient\src\test\java\org\apache\hadoop\mapreduce\SimpleEntityWriterConstants.java,0,6,6,1,0,13
hadoop-trunk\hadoop-trunk\hadoop-yarn-project\hadoop-yarn\hadoop-yarn-common\src\main\java\org\apache\hadoop\yarn\security\NMTokenSelector.java,25,7,0,1,0,8
hadoop-trunk\hadoop-trunk\hadoop-common-project\hadoop-common\src\main\java\org\apache\hadoop\io\erasurecode\rawcoder\DummyRawDecoder.java,17,4,0,1,0,5
hadoop-trunk\hadoop-trunk\hadoop-common-project\hadoop-common\src\main\java\org\apache\hadoop\service\LoggingStateChangeListener.java,35,9,1,1,0,11
hadoop-trunk\hadoop-trunk\hadoop-yarn-project\hadoop-yarn\hadoop-yarn-common\src\test\java\org\apache\hadoop\yarn\webapp\TestParseRoute.java,57,15,5,1,0,21
hadoop-trunk\hadoop-trunk\hadoop-mapreduce-project\hadoop-mapreduce-client\hadoop-mapreduce-client-jobclient\src\test\java\org\apache\hadoop\mapred\MRBench.java,287,160,20,11,0,191
hadoop-trunk\hadoop-trunk\hadoop-yarn-project\hadoop-yarn\hadoop-yarn-server\hadoop-yarn-server-resourcemanager\src\main\java\org\apache\hadoop\yarn\server\resourcemanager\scheduler\MutableConfScheduler.java,0,0,0,1,0,1
hadoop-trunk\hadoop-trunk\hadoop-yarn-project\hadoop-yarn\hadoop-yarn-applications\hadoop-yarn-services\hadoop-yarn-services-core\src\main\java\org\apache\hadoop\yarn\service\component\instance\ComponentInstanceEventType.java,0,6,0,1,0,7
hadoop-trunk\hadoop-trunk\hadoop-hdfs-project\hadoop-hdfs\src\main\java\org\apache\hadoop\hdfs\server\datanode\fsdataset\ReplicaInputStreams.java,119,58,2,1,0,61
hadoop-trunk\hadoop-trunk\hadoop-hdfs-project\hadoop-hdfs-client\src\main\java\org\apache\hadoop\hdfs\client\HdfsAdmin.java,591,60,1,2,0,63
hadoop-trunk\hadoop-trunk\hadoop-hdfs-project\hadoop-hdfs\src\test\java\org\apache\hadoop\hdfs\TestDeadNodeDetection.java,418,47,10,8,0,65
hadoop-trunk\hadoop-trunk\hadoop-mapreduce-project\hadoop-mapreduce-client\hadoop-mapreduce-client-core\src\main\java\org\apache\hadoop\mapreduce\lib\partition\RehashPartitioner.java,0,14,0,1,0,15
hadoop-trunk\hadoop-trunk\hadoop-yarn-project\hadoop-yarn\hadoop-yarn-client\src\main\java\org\apache\hadoop\yarn\client\api\NMTokenCache.java,111,36,0,5,0,41
hadoop-trunk\hadoop-trunk\hadoop-hdfs-project\hadoop-hdfs\src\test\java\org\apache\hadoop\hdfs\server\common\TestJspHelper.java,0,81,61,11,0,153
hadoop-trunk\hadoop-trunk\hadoop-yarn-project\hadoop-yarn\hadoop-yarn-server\hadoop-yarn-server-resourcemanager\src\test\java\org\apache\hadoop\yarn\server\resourcemanager\scheduler\capacity\TestApplicationPriorityACLConfiguration.java,95,26,4,3,0,33
hadoop-trunk\hadoop-trunk\hadoop-hdfs-project\hadoop-hdfs\src\test\java\org\apache\hadoop\hdfs\server\datanode\BlockReportTestBase.java,0,168,67,11,0,246
hadoop-trunk\hadoop-trunk\hadoop-tools\hadoop-federation-balance\src\test\java\org\apache\hadoop\tools\fedbalance\TestTrashProcedure.java,60,11,2,1,0,14
hadoop-trunk\hadoop-trunk\hadoop-yarn-project\hadoop-yarn\hadoop-yarn-server\hadoop-yarn-server-nodemanager\src\main\java\org\apache\hadoop\yarn\server\nodemanager\containermanager\logaggregation\SampleContainerLogAggregationPolicy.java,83,34,5,2,0,41
hadoop-trunk\hadoop-trunk\hadoop-yarn-project\hadoop-yarn\hadoop-yarn-server\hadoop-yarn-server-resourcemanager\src\test\java\org\apache\hadoop\yarn\server\resourcemanager\TestRMServerUtils.java,360,66,43,5,0,114
hadoop-trunk\hadoop-trunk\hadoop-tools\hadoop-azure\src\test\java\org\apache\hadoop\fs\azure\InMemoryBlockBlobStore.java,165,82,15,2,0,99
hadoop-trunk\hadoop-trunk\hadoop-mapreduce-project\hadoop-mapreduce-client\hadoop-mapreduce-client-common\src\main\java\org\apache\hadoop\mapreduce\v2\api\protocolrecords\impl\pb\KillJobRequestPBImpl.java,79,33,33,3,0,69
hadoop-trunk\hadoop-trunk\hadoop-yarn-project\hadoop-yarn\hadoop-yarn-applications\hadoop-yarn-services\hadoop-yarn-services-core\src\test\java\org\apache\hadoop\yarn\service\MockServiceAM.java,390,119,16,3,0,138
hadoop-trunk\hadoop-trunk\hadoop-mapreduce-project\hadoop-mapreduce-client\hadoop-mapreduce-client-core\src\main\java\org\apache\hadoop\mapreduce\lib\db\DBOutputFormat.java,0,77,8,3,0,88
hadoop-trunk\hadoop-trunk\hadoop-common-project\hadoop-common\src\main\java\org\apache\hadoop\fs\store\package-info.java,0,0,0,1,0,1
hadoop-trunk\hadoop-trunk\hadoop-hdfs-project\hadoop-hdfs\src\test\java\org\apache\hadoop\fs\contract\hdfs\TestHDFSContractConcat.java,20,4,0,1,0,5
hadoop-trunk\hadoop-trunk\hadoop-common-project\hadoop-common\src\test\java\org\apache\hadoop\crypto\TestCryptoStreamsWithOpensslSm4CtrCryptoCodec.java,0,5,0,1,0,6
hadoop-trunk\hadoop-trunk\hadoop-yarn-project\hadoop-yarn\hadoop-yarn-server\hadoop-yarn-server-nodemanager\src\test\java\org\apache\hadoop\yarn\server\nodemanager\containermanager\resourceplugin\fpga\TestAoclOutputParser.java,72,40,0,7,0,47
hadoop-trunk\hadoop-trunk\hadoop-hdfs-project\hadoop-hdfs\src\main\java\org\apache\hadoop\hdfs\server\namenode\sps\BlockStorageMovementAttemptedItems.java,259,42,4,7,0,53
hadoop-trunk\hadoop-trunk\hadoop-mapreduce-project\hadoop-mapreduce-client\hadoop-mapreduce-client-nativetask\src\main\java\org\apache\hadoop\mapred\nativetask\DataChannel.java,0,4,0,1,0,5
hadoop-trunk\hadoop-trunk\hadoop-yarn-project\hadoop-yarn\hadoop-yarn-server\hadoop-yarn-server-resourcemanager\src\main\java\org\apache\hadoop\yarn\server\resourcemanager\webapp\dao\ReservationRequestInfo.java,56,31,1,1,0,33
hadoop-trunk\hadoop-trunk\hadoop-common-project\hadoop-common\src\main\java\org\apache\hadoop\security\SaslPlainServer.java,125,51,3,2,0,56
hadoop-trunk\hadoop-trunk\hadoop-common-project\hadoop-nfs\src\test\java\org\apache\hadoop\oncrpc\TestRpcCallCache.java,99,41,2,1,0,44
hadoop-trunk\hadoop-trunk\hadoop-yarn-project\hadoop-yarn\hadoop-yarn-server\hadoop-yarn-server-resourcemanager\src\main\java\org\apache\hadoop\yarn\server\resourcemanager\scheduler\capacity\CSQueue.java,0,105,43,14,0,162
hadoop-trunk\hadoop-trunk\hadoop-yarn-project\hadoop-yarn\hadoop-yarn-server\hadoop-yarn-server-nodemanager\src\main\java\org\apache\hadoop\yarn\server\nodemanager\containermanager\container\ResourceMappings.java,69,15,1,1,0,17
hadoop-trunk\hadoop-trunk\hadoop-common-project\hadoop-common\src\main\java\org\apache\hadoop\fs\permission\ScopedAclEntries.java,0,8,4,4,0,16
hadoop-trunk\hadoop-trunk\hadoop-tools\hadoop-azure\src\test\java\org\apache\hadoop\fs\azurebfs\TestAbfsConfigurationFieldsValidation.java,139,61,10,49,0,120
hadoop-trunk\hadoop-trunk\hadoop-mapreduce-project\hadoop-mapreduce-client\hadoop-mapreduce-client-jobclient\src\test\java\org\apache\hadoop\mapred\TestClusterMapReduceTestCase.java,104,13,9,2,0,24
hadoop-trunk\hadoop-trunk\hadoop-common-project\hadoop-common\src\main\java\org\apache\hadoop\io\compress\bzip2\BZip2DummyDecompressor.java,49,17,0,1,0,18
hadoop-trunk\hadoop-trunk\hadoop-hdfs-project\hadoop-hdfs-rbf\src\test\java\org\apache\hadoop\hdfs\server\federation\router\TestRouterFederationRename.java,293,30,2,4,0,36
hadoop-trunk\hadoop-trunk\hadoop-yarn-project\hadoop-yarn\hadoop-yarn-server\hadoop-yarn-server-resourcemanager\src\main\java\org\apache\hadoop\yarn\server\resourcemanager\volume\csi\event\ControllerPublishVolumeEvent.java,7,2,0,2,0,4
hadoop-trunk\hadoop-trunk\hadoop-yarn-project\hadoop-yarn\hadoop-yarn-server\hadoop-yarn-server-timelineservice-hbase\hadoop-yarn-server-timelineservice-hbase-common\src\main\java\org\apache\hadoop\yarn\server\timelineservice\storage\flow\FlowRunColumnPrefix.java,0,26,2,7,0,35
hadoop-trunk\hadoop-trunk\hadoop-hdfs-project\hadoop-hdfs\src\main\java\org\apache\hadoop\hdfs\server\namenode\startupprogress\PhaseTracking.java,0,8,1,1,0,10
hadoop-trunk\hadoop-trunk\hadoop-hdfs-project\hadoop-hdfs-nfs\src\main\java\org\apache\hadoop\hdfs\nfs\nfs3\PrivilegedNfsGatewayStarter.java,53,15,1,1,0,17
hadoop-trunk\hadoop-trunk\hadoop-tools\hadoop-azure\src\test\java\org\apache\hadoop\fs\azurebfs\ITestAbfsReadWriteAndSeek.java,104,21,4,11,0,36
hadoop-trunk\hadoop-trunk\hadoop-yarn-project\hadoop-yarn\hadoop-yarn-server\hadoop-yarn-server-common\src\main\java\org\apache\hadoop\yarn\server\federation\policies\router\PriorityRouterPolicy.java,42,4,0,2,0,6
hadoop-trunk\hadoop-trunk\hadoop-common-project\hadoop-common\src\main\java\org\apache\hadoop\net\CachedDNSToSwitchMapping.java,127,28,1,2,0,31
hadoop-trunk\hadoop-trunk\hadoop-hdfs-project\hadoop-hdfs\src\test\java\org\apache\hadoop\hdfs\server\balancer\TestBalancer.java,0,569,50,58,0,677
hadoop-trunk\hadoop-trunk\hadoop-tools\hadoop-aws\src\test\java\org\apache\hadoop\fs\s3a\auth\delegation\ITestDelegatedMRJob.java,225,27,5,4,0,36
hadoop-trunk\hadoop-trunk\hadoop-hdfs-project\hadoop-hdfs\src\main\java\org\apache\hadoop\hdfs\server\datanode\erasurecode\StripedWriter.java,0,36,2,1,0,39
hadoop-trunk\hadoop-trunk\hadoop-tools\hadoop-aws\src\test\java\org\apache\hadoop\fs\s3a\auth\delegation\ILoadTestSessionCredentials.java,218,25,5,5,0,35
hadoop-trunk\hadoop-trunk\hadoop-yarn-project\hadoop-yarn\hadoop-yarn-applications\hadoop-yarn-applications-mawo\hadoop-yarn-applications-mawo-core\src\main\java\org\apache\hadoop\applications\mawo\server\common\MawoConfiguration.java,0,0,2,1,0,3
hadoop-trunk\hadoop-trunk\hadoop-yarn-project\hadoop-yarn\hadoop-yarn-server\hadoop-yarn-server-nodemanager\src\test\java\org\apache\hadoop\yarn\server\nodemanager\nodelabels\TestScriptBasedNodeLabelsProvider.java,173,22,0,1,0,23
hadoop-trunk\hadoop-trunk\hadoop-mapreduce-project\hadoop-mapreduce-client\hadoop-mapreduce-client-nativetask\src\main\java\org\apache\hadoop\mapred\nativetask\util\BytesUtil.java,0,44,7,1,0,52
hadoop-trunk\hadoop-trunk\hadoop-hdfs-project\hadoop-hdfs\src\main\java\org\apache\hadoop\hdfs\server\datanode\fsdataset\impl\MemoryMappableBlockLoader.java,90,23,0,1,0,24
hadoop-trunk\hadoop-trunk\hadoop-tools\hadoop-openstack\src\main\java\org\apache\hadoop\fs\swift\auth\AuthenticationRequestWrapper.java,34,6,1,1,0,8
hadoop-trunk\hadoop-trunk\hadoop-common-project\hadoop-nfs\src\main\java\org\apache\hadoop\nfs\nfs3\request\RequestWithHandle.java,12,7,0,1,0,8
hadoop-trunk\hadoop-trunk\hadoop-hdfs-project\hadoop-hdfs\src\test\java\org\apache\hadoop\hdfs\TestParallelShortCircuitReadUnCached.java,46,14,2,1,0,17
hadoop-trunk\hadoop-trunk\hadoop-yarn-project\hadoop-yarn\hadoop-yarn-server\hadoop-yarn-server-resourcemanager\src\main\java\org\apache\hadoop\yarn\server\resourcemanager\webapp\RMErrorsAndWarningsPage.java,0,5,1,1,0,7
hadoop-trunk\hadoop-trunk\hadoop-yarn-project\hadoop-yarn\hadoop-yarn-server\hadoop-yarn-server-resourcemanager\src\main\java\org\apache\hadoop\yarn\server\resourcemanager\scheduler\PreemptableResourceScheduler.java,0,4,0,2,0,6
hadoop-trunk\hadoop-trunk\hadoop-hdfs-project\hadoop-hdfs\src\test\java\org\apache\hadoop\hdfs\TestDFSPermission.java,1248,375,38,8,0,421
hadoop-trunk\hadoop-trunk\hadoop-yarn-project\hadoop-yarn\hadoop-yarn-server\hadoop-yarn-server-timelineservice-hbase\hadoop-yarn-server-timelineservice-hbase-common\src\main\java\org\apache\hadoop\yarn\server\timelineservice\storage\flow\FlowActivityColumnPrefix.java,0,26,2,7,0,35
hadoop-trunk\hadoop-trunk\hadoop-mapreduce-project\hadoop-mapreduce-client\hadoop-mapreduce-client-core\src\main\java\org\apache\hadoop\mapreduce\lib\input\CombineFileRecordReaderWrapper.java,0,27,1,1,0,29
hadoop-trunk\hadoop-trunk\hadoop-hdfs-project\hadoop-hdfs\src\main\java\org\apache\hadoop\hdfs\util\EnumDoubles.java,101,24,0,1,0,25
hadoop-trunk\hadoop-trunk\hadoop-hdfs-project\hadoop-hdfs\src\test\java\org\apache\hadoop\cli\CLITestCmdErasureCoding.java,13,8,1,2,0,11
hadoop-trunk\hadoop-trunk\hadoop-tools\hadoop-azure\src\main\java\org\apache\hadoop\fs\azurebfs\services\AbfsInputStream.java,0,135,5,45,0,185
hadoop-trunk\hadoop-trunk\hadoop-hdfs-project\hadoop-hdfs\src\test\java\org\apache\hadoop\fs\viewfs\TestViewFsHdfs.java,122,16,2,1,0,19
hadoop-trunk\hadoop-trunk\hadoop-mapreduce-project\hadoop-mapreduce-client\hadoop-mapreduce-client-core\src\main\java\org\apache\hadoop\mapred\MapOutputCollector.java,0,28,6,1,0,35
hadoop-trunk\hadoop-trunk\hadoop-hdfs-project\hadoop-hdfs\src\test\java\org\apache\hadoop\fs\TestHDFSFileContextMainOperations.java,0,69,6,3,0,78
hadoop-trunk\hadoop-trunk\hadoop-common-project\hadoop-common\src\main\java\org\apache\hadoop\fs\InternalOperations.java,9,4,0,1,0,5
hadoop-trunk\hadoop-trunk\hadoop-yarn-project\hadoop-yarn\hadoop-yarn-common\src\main\java\org\apache\hadoop\yarn\api\impl\pb\service\ApplicationClientProtocolPBServiceImpl.java,559,148,135,164,0,447
hadoop-trunk\hadoop-trunk\hadoop-hdfs-project\hadoop-hdfs\src\main\java\org\apache\hadoop\hdfs\server\namenode\FSDirSnapshotOp.java,0,85,1,2,0,88
hadoop-trunk\hadoop-trunk\hadoop-common-project\hadoop-common\src\main\java\org\apache\hadoop\fs\HasEnhancedByteBufferAccess.java,0,5,2,1,0,8
hadoop-trunk\hadoop-trunk\hadoop-common-project\hadoop-common\src\main\java\org\apache\hadoop\metrics2\sink\FileSink.java,0,10,0,1,0,11
hadoop-trunk\hadoop-trunk\hadoop-hdfs-project\hadoop-hdfs-client\src\main\java\org\apache\hadoop\hdfs\StripeReader.java,431,71,7,2,0,80
hadoop-trunk\hadoop-trunk\hadoop-yarn-project\hadoop-yarn\hadoop-yarn-server\hadoop-yarn-server-resourcemanager\src\main\java\org\apache\hadoop\yarn\server\resourcemanager\scheduler\capacity\QueueManagementDynamicEditPolicy.java,211,50,15,4,0,69
hadoop-trunk\hadoop-trunk\hadoop-common-project\hadoop-common\src\main\java\org\apache\hadoop\fs\ftp\FtpConfigKeys.java,0,29,0,1,0,30
hadoop-trunk\hadoop-trunk\hadoop-tools\hadoop-aws\src\main\java\org\apache\hadoop\fs\s3a\impl\CopyOutcome.java,0,11,0,1,0,12
hadoop-trunk\hadoop-trunk\hadoop-mapreduce-project\hadoop-mapreduce-client\hadoop-mapreduce-client-app\src\main\java\org\apache\hadoop\mapreduce\v2\app\webapp\TaskPage.java,0,24,0,5,0,29
hadoop-trunk\hadoop-trunk\hadoop-yarn-project\hadoop-yarn\hadoop-yarn-api\src\main\java\org\apache\hadoop\yarn\api\records\timelineservice\ApplicationAttemptEntity.java,15,3,0,1,0,4
hadoop-trunk\hadoop-trunk\hadoop-yarn-project\hadoop-yarn\hadoop-yarn-server\hadoop-yarn-server-common\src\main\java\org\apache\hadoop\yarn\server\api\protocolrecords\RegisterNodeManagerRequest.java,121,59,0,1,0,60
hadoop-trunk\hadoop-trunk\hadoop-yarn-project\hadoop-yarn\hadoop-yarn-server\hadoop-yarn-server-resourcemanager\src\main\java\org\apache\hadoop\yarn\server\resourcemanager\webapp\dao\ReservationDefinitionInfo.java,84,45,1,1,0,47
hadoop-trunk\hadoop-trunk\hadoop-yarn-project\hadoop-yarn\hadoop-yarn-applications\hadoop-yarn-applications-mawo\hadoop-yarn-applications-mawo-core\src\main\java\org\apache\hadoop\applications\mawo\server\common\package-info.java,0,1,0,1,0,2
hadoop-trunk\hadoop-trunk\hadoop-hdfs-project\hadoop-hdfs\src\test\java\org\apache\hadoop\hdfs\TestErasureCodingExerciseAPIs.java,483,23,10,1,0,34
hadoop-trunk\hadoop-trunk\hadoop-common-project\hadoop-common\src\test\java\org\apache\hadoop\ipc\TestRetryCache.java,178,40,0,1,0,41
hadoop-trunk\hadoop-trunk\hadoop-hdfs-project\hadoop-hdfs\src\test\java\org\apache\hadoop\hdfs\server\namenode\snapshot\TestSnapshotListing.java,87,28,0,1,0,29
hadoop-trunk\hadoop-trunk\hadoop-common-project\hadoop-common\src\main\java\org\apache\hadoop\io\IOUtils.java,484,96,19,6,0,121
hadoop-trunk\hadoop-trunk\hadoop-yarn-project\hadoop-yarn\hadoop-yarn-server\hadoop-yarn-server-resourcemanager\src\main\java\org\apache\hadoop\yarn\server\resourcemanager\scheduler\fair\policies\DominantResourceFairnessPolicy.java,467,69,1,4,0,74
hadoop-trunk\hadoop-trunk\hadoop-hdfs-project\hadoop-hdfs\src\main\java\org\apache\hadoop\hdfs\server\namenode\INodeDirectoryAttributes.java,0,40,6,3,0,49
hadoop-trunk\hadoop-trunk\hadoop-yarn-project\hadoop-yarn\hadoop-yarn-server\hadoop-yarn-server-common\src\test\java\org\apache\hadoop\yarn\server\federation\store\impl\FederationStateStoreBaseTest.java,536,50,1,27,0,78
hadoop-trunk\hadoop-trunk\hadoop-hdfs-project\hadoop-hdfs-client\src\main\java\org\apache\hadoop\hdfs\web\oauth2\ConfCredentialBasedAccessTokenProvider.java,0,9,1,1,0,11
hadoop-trunk\hadoop-trunk\hadoop-yarn-project\hadoop-yarn\hadoop-yarn-server\hadoop-yarn-server-common\src\main\java\org\apache\hadoop\yarn\server\api\protocolrecords\impl\pb\RemoteNodePBImpl.java,144,26,49,3,0,78
hadoop-trunk\hadoop-trunk\hadoop-hdfs-project\hadoop-hdfs\src\test\java\org\apache\hadoop\hdfs\server\diskbalancer\TestDiskBalancerRPC.java,267,30,11,5,0,46
hadoop-trunk\hadoop-trunk\hadoop-mapreduce-project\hadoop-mapreduce-client\hadoop-mapreduce-client-app\src\main\java\org\apache\hadoop\mapreduce\v2\app\TaskAttemptFinishingMonitor.java,29,9,0,1,0,10
hadoop-trunk\hadoop-trunk\hadoop-yarn-project\hadoop-yarn\hadoop-yarn-server\hadoop-yarn-server-timelineservice-hbase\hadoop-yarn-server-timelineservice-hbase-common\src\main\java\org\apache\hadoop\yarn\server\timelineservice\storage\subapplication\package-info.java,0,0,0,1,0,1
hadoop-trunk\hadoop-trunk\hadoop-mapreduce-project\hadoop-mapreduce-client\hadoop-mapreduce-client-jobclient\src\test\java\org\apache\hadoop\mapred\WordCount.java,107,58,19,1,0,78
hadoop-trunk\hadoop-trunk\hadoop-hdfs-project\hadoop-hdfs\src\test\java\org\apache\hadoop\hdfs\server\datanode\TestBlockCountersInPendingIBR.java,103,15,0,2,0,17
hadoop-trunk\hadoop-trunk\hadoop-yarn-project\hadoop-yarn\hadoop-yarn-common\src\main\java\org\apache\hadoop\yarn\webapp\view\HeaderBlock.java,17,3,0,1,0,4
hadoop-trunk\hadoop-trunk\hadoop-hdfs-project\hadoop-hdfs\src\test\java\org\apache\hadoop\hdfs\util\TestLightWeightHashSet.java,463,55,9,2,0,66
hadoop-trunk\hadoop-trunk\hadoop-common-project\hadoop-common\src\main\java\org\apache\hadoop\fs\viewfs\ViewFileSystemOverloadScheme.java,292,50,10,4,0,64
hadoop-trunk\hadoop-trunk\hadoop-yarn-project\hadoop-yarn\hadoop-yarn-server\hadoop-yarn-server-common\src\main\java\org\apache\hadoop\yarn\server\federation\store\records\impl\pb\SubClusterIdPBImpl.java,46,12,23,3,0,38
hadoop-trunk\hadoop-trunk\hadoop-hdfs-project\hadoop-hdfs-client\src\main\java\org\apache\hadoop\hdfs\protocol\ReencryptionStatus.java,0,22,4,1,0,27
hadoop-trunk\hadoop-trunk\hadoop-mapreduce-project\hadoop-mapreduce-client\hadoop-mapreduce-client-core\src\main\java\org\apache\hadoop\mapreduce\lib\map\InverseMapper.java,0,10,0,1,0,11
hadoop-trunk\hadoop-trunk\hadoop-yarn-project\hadoop-yarn\hadoop-yarn-server\hadoop-yarn-server-router\src\main\java\org\apache\hadoop\yarn\server\router\rmadmin\RMAdminRequestInterceptor.java,0,0,0,1,0,1
hadoop-trunk\hadoop-trunk\hadoop-hdfs-project\hadoop-hdfs\src\main\java\org\apache\hadoop\hdfs\server\namenode\ReencryptionUpdater.java,0,31,27,5,0,63
hadoop-trunk\hadoop-trunk\hadoop-common-project\hadoop-common\src\main\java\org\apache\hadoop\fs\protocolPB\package-info.java,0,0,1,1,0,2
hadoop-trunk\hadoop-trunk\hadoop-yarn-project\hadoop-yarn\hadoop-yarn-server\hadoop-yarn-server-resourcemanager\src\test\java\org\apache\hadoop\yarn\server\resourcemanager\monitor\capacity\mockframework\MockContainer.java,0,18,0,7,0,25
hadoop-trunk\hadoop-trunk\hadoop-common-project\hadoop-common\src\main\java\org\apache\hadoop\util\Tool.java,0,17,0,2,0,19
hadoop-trunk\hadoop-trunk\hadoop-yarn-project\hadoop-yarn\hadoop-yarn-common\src\main\java\org\apache\hadoop\yarn\server\api\protocolrecords\impl\pb\RefreshClusterMaxPriorityResponsePBImpl.java,44,22,18,3,0,43
hadoop-trunk\hadoop-trunk\hadoop-hdfs-project\hadoop-hdfs\src\test\java\org\apache\hadoop\hdfs\tools\TestDFSZKFailoverController.java,319,76,5,3,0,84
hadoop-trunk\hadoop-trunk\hadoop-mapreduce-project\hadoop-mapreduce-client\hadoop-mapreduce-client-jobclient\src\test\java\org\apache\hadoop\mapreduce\lib\aggregate\AggregatorTests.java,65,19,1,2,0,22
hadoop-trunk\hadoop-trunk\hadoop-mapreduce-project\hadoop-mapreduce-client\hadoop-mapreduce-client-app\src\main\java\org\apache\hadoop\mapreduce\v2\app\security\authorize\ClientHSPolicyProvider.java,24,7,0,3,0,10
hadoop-trunk\hadoop-trunk\hadoop-yarn-project\hadoop-yarn\hadoop-yarn-server\hadoop-yarn-server-nodemanager\src\main\java\org\apache\hadoop\yarn\server\nodemanager\containermanager\application\ApplicationContainerInitEvent.java,14,13,0,6,0,19
hadoop-trunk\hadoop-trunk\hadoop-hdfs-project\hadoop-hdfs\src\main\java\org\apache\hadoop\hdfs\server\sps\ExternalSPSBlockMoveTaskHandler.java,156,29,6,2,0,37
hadoop-trunk\hadoop-trunk\hadoop-hdfs-project\hadoop-hdfs-rbf\src\test\java\org\apache\hadoop\hdfs\server\federation\router\TestRouter.java,257,18,7,4,0,29
hadoop-trunk\hadoop-trunk\hadoop-hdfs-project\hadoop-hdfs-rbf\src\main\java\org\apache\hadoop\hdfs\server\federation\router\RouterCacheAdmin.java,130,31,6,2,0,39
hadoop-trunk\hadoop-trunk\hadoop-hdfs-project\hadoop-hdfs-client\src\main\java\org\apache\hadoop\hdfs\web\resources\SnapshotDiffStartPathParam.java,19,3,0,1,0,4
hadoop-trunk\hadoop-trunk\hadoop-mapreduce-project\hadoop-mapreduce-client\hadoop-mapreduce-client-core\src\main\java\org\apache\hadoop\mapreduce\lib\input\FixedLengthRecordReader.java,0,38,2,1,0,41
hadoop-trunk\hadoop-trunk\hadoop-yarn-project\hadoop-yarn\hadoop-yarn-common\src\main\java\org\apache\hadoop\yarn\webapp\log\AggregatedLogsBlock.java,107,13,0,3,0,16
hadoop-trunk\hadoop-trunk\hadoop-tools\hadoop-azure\src\main\java\org\apache\hadoop\fs\azurebfs\services\AbfsPermission.java,88,21,2,6,0,29
hadoop-trunk\hadoop-trunk\hadoop-hdfs-project\hadoop-hdfs-httpfs\src\main\java\org\apache\hadoop\fs\http\server\HttpFSServerWebServer.java,167,33,1,9,0,43
hadoop-trunk\hadoop-trunk\hadoop-mapreduce-project\hadoop-mapreduce-client\hadoop-mapreduce-client-jobclient\src\test\java\org\apache\hadoop\mapreduce\lib\output\TestMRCJCFileOutputCommitter.java,212,32,14,4,0,50
hadoop-trunk\hadoop-trunk\hadoop-tools\hadoop-distcp\src\test\java\org\apache\hadoop\tools\TestDistCpWithAcls.java,276,88,14,1,0,103
hadoop-trunk\hadoop-trunk\hadoop-tools\hadoop-distcp\src\test\java\org\apache\hadoop\tools\contract\AbstractContractDistCpTest.java,0,123,25,4,0,152
hadoop-trunk\hadoop-trunk\hadoop-hdfs-project\hadoop-hdfs\src\main\java\org\apache\hadoop\hdfs\server\balancer\KeyManager.java,0,36,4,3,0,43
hadoop-trunk\hadoop-trunk\hadoop-yarn-project\hadoop-yarn\hadoop-yarn-server\hadoop-yarn-server-resourcemanager\src\test\java\org\apache\hadoop\yarn\server\resourcemanager\scheduler\capacity\TestAutoCreatedQueueDeletionPolicy.java,0,36,0,4,0,40
hadoop-trunk\hadoop-trunk\hadoop-yarn-project\hadoop-yarn\hadoop-yarn-server\hadoop-yarn-server-resourcemanager\src\main\java\org\apache\hadoop\yarn\server\resourcemanager\scheduler\policy\SchedulableEntity.java,0,19,5,1,0,25
hadoop-trunk\hadoop-trunk\hadoop-tools\hadoop-streaming\src\test\java\org\apache\hadoop\streaming\io\TestKeyOnlyTextOutputReader.java,36,10,0,1,0,11
hadoop-trunk\hadoop-trunk\hadoop-yarn-project\hadoop-yarn\hadoop-yarn-api\src\main\java\org\apache\hadoop\yarn\api\protocolrecords\GetLocalizationStatusesResponse.java,47,5,0,1,0,6
hadoop-trunk\hadoop-trunk\hadoop-common-project\hadoop-common\src\main\java\org\apache\hadoop\ipc\ProtocolMetaInfoPB.java,0,2,2,1,0,5
hadoop-trunk\hadoop-trunk\hadoop-hdfs-project\hadoop-hdfs\src\test\java\org\apache\hadoop\hdfs\protocol\TestLocatedBlock.java,21,7,1,1,0,9
hadoop-trunk\hadoop-trunk\hadoop-tools\hadoop-azure\src\main\java\org\apache\hadoop\fs\azurebfs\extensions\package-info.java,0,1,0,1,0,2
hadoop-trunk\hadoop-trunk\hadoop-tools\hadoop-streaming\src\main\java\org\apache\hadoop\typedbytes\TypedBytesWritable.java,58,7,1,1,0,9
hadoop-trunk\hadoop-trunk\hadoop-yarn-project\hadoop-yarn\hadoop-yarn-server\hadoop-yarn-server-resourcemanager\src\main\java\org\apache\hadoop\yarn\server\resourcemanager\rmapp\RMAppNodeUpdateEvent.java,33,18,0,1,0,19
hadoop-trunk\hadoop-trunk\hadoop-mapreduce-project\hadoop-mapreduce-client\hadoop-mapreduce-client-core\src\main\java\org\apache\hadoop\mapred\join\OverrideRecordReader.java,0,20,2,2,0,24
hadoop-trunk\hadoop-trunk\hadoop-common-project\hadoop-common\src\main\java\org\apache\hadoop\io\serializer\avro\AvroSerialization.java,0,29,0,1,0,30
hadoop-trunk\hadoop-trunk\hadoop-yarn-project\hadoop-yarn\hadoop-yarn-common\src\main\java\org\apache\hadoop\yarn\client\api\TimelineClient.java,146,7,1,1,0,9
hadoop-trunk\hadoop-trunk\hadoop-tools\hadoop-resourceestimator\src\main\java\org\apache\hadoop\resourceestimator\skylinestore\api\PredictionSkylineStore.java,0,0,0,3,0,3
hadoop-trunk\hadoop-trunk\hadoop-common-project\hadoop-common\src\main\java\org\apache\hadoop\ipc\RpcServerException.java,38,9,6,3,0,18
hadoop-trunk\hadoop-trunk\hadoop-mapreduce-project\hadoop-mapreduce-client\hadoop-mapreduce-client-core\src\main\java\org\apache\hadoop\mapreduce\lib\jobcontrol\JobControl.java,301,115,17,4,0,136
hadoop-trunk\hadoop-trunk\hadoop-tools\hadoop-azure\src\main\java\org\apache\hadoop\fs\azure\KeyProviderException.java,16,7,0,1,0,8
hadoop-trunk\hadoop-trunk\hadoop-hdfs-project\hadoop-hdfs-httpfs\src\main\java\org\apache\hadoop\lib\wsrs\StringParam.java,46,15,1,2,0,18
hadoop-trunk\hadoop-trunk\hadoop-yarn-project\hadoop-yarn\hadoop-yarn-server\hadoop-yarn-server-resourcemanager\src\test\java\org\apache\hadoop\yarn\server\resourcemanager\scheduler\capacity\TestCapacitySchedulerPerf.java,405,88,6,16,0,110
hadoop-trunk\hadoop-trunk\hadoop-common-project\hadoop-common\src\test\java\org\apache\hadoop\io\file\tfile\TestTFileComparators.java,88,27,6,1,0,34
hadoop-trunk\hadoop-trunk\hadoop-hdfs-project\hadoop-hdfs\src\test\java\org\apache\hadoop\hdfs\protocol\datatransfer\sasl\SaslDataTransferTestCase.java,96,21,1,12,0,34
hadoop-trunk\hadoop-trunk\hadoop-yarn-project\hadoop-yarn\hadoop-yarn-server\hadoop-yarn-server-timelineservice-hbase\hadoop-yarn-server-timelineservice-hbase-common\src\main\java\org\apache\hadoop\yarn\server\timelineservice\storage\domain\DomainColumn.java,0,9,1,4,0,14
hadoop-trunk\hadoop-trunk\hadoop-yarn-project\hadoop-yarn\hadoop-yarn-api\src\main\java\org\apache\hadoop\yarn\server\api\protocolrecords\RefreshSuperUserGroupsConfigurationRequest.java,10,1,1,1,0,3
hadoop-trunk\hadoop-trunk\hadoop-tools\hadoop-datajoin\src\test\java\org\apache\hadoop\contrib\utils\join\SampleDataJoinReducer.java,29,16,6,3,0,25
hadoop-trunk\hadoop-trunk\hadoop-hdfs-project\hadoop-hdfs\src\main\java\org\apache\hadoop\hdfs\server\namenode\ha\BootstrapStandby.java,0,94,13,13,0,120
hadoop-trunk\hadoop-trunk\hadoop-yarn-project\hadoop-yarn\hadoop-yarn-server\hadoop-yarn-server-router\src\main\java\org\apache\hadoop\yarn\server\router\RouterMetrics.java,0,80,3,1,0,84
hadoop-trunk\hadoop-trunk\hadoop-tools\hadoop-aws\src\main\java\org\apache\hadoop\fs\s3a\select\SelectConstants.java,0,3,0,2,0,5
hadoop-trunk\hadoop-trunk\hadoop-mapreduce-project\hadoop-mapreduce-client\hadoop-mapreduce-client-nativetask\src\main\java\org\apache\hadoop\mapred\nativetask\util\ReadWriteBuffer.java,137,113,4,1,0,118
hadoop-trunk\hadoop-trunk\hadoop-yarn-project\hadoop-yarn\hadoop-yarn-common\src\main\java\org\apache\hadoop\yarn\api\protocolrecords\impl\pb\UpdateApplicationPriorityRequestPBImpl.java,135,34,48,5,0,87
hadoop-trunk\hadoop-trunk\hadoop-yarn-project\hadoop-yarn\hadoop-yarn-common\src\main\java\org\apache\hadoop\yarn\logaggregation\ContainerLogsRequest.java,135,97,1,1,0,99
hadoop-trunk\hadoop-trunk\hadoop-common-project\hadoop-common\src\test\java\org\apache\hadoop\ipc\TestProtoBufRpcServerHandoff.java,129,35,17,3,0,55
hadoop-trunk\hadoop-trunk\hadoop-tools\hadoop-azure\src\main\java\org\apache\hadoop\fs\azure\metrics\AzureFileSystemInstrumentation.java,0,82,0,14,0,96
hadoop-trunk\hadoop-trunk\hadoop-hdfs-project\hadoop-hdfs-rbf\src\main\java\org\apache\hadoop\hdfs\server\federation\router\package-info.java,0,2,0,1,0,3
hadoop-trunk\hadoop-trunk\hadoop-common-project\hadoop-auth\src\main\java\org\apache\hadoop\security\authentication\util\KerberosUtil.java,420,77,8,2,0,87
hadoop-trunk\hadoop-trunk\hadoop-mapreduce-project\hadoop-mapreduce-client\hadoop-mapreduce-client-core\src\main\java\org\apache\hadoop\mapred\InvalidJobConfException.java,0,10,0,1,0,11
hadoop-trunk\hadoop-trunk\hadoop-tools\hadoop-azure\src\main\java\org\apache\hadoop\fs\azurebfs\SecureAzureBlobFileSystem.java,12,4,0,2,0,6
hadoop-trunk\hadoop-trunk\hadoop-hdfs-project\hadoop-hdfs\src\main\java\org\apache\hadoop\hdfs\qjournal\server\GetJournalEditServlet.java,203,38,9,2,0,49
hadoop-trunk\hadoop-trunk\hadoop-tools\hadoop-gridmix\src\main\java\org\apache\hadoop\mapred\gridmix\RandomAlgorithms.java,184,80,10,1,0,91
hadoop-trunk\hadoop-trunk\hadoop-hdfs-project\hadoop-hdfs-client\src\main\java\org\apache\hadoop\hdfs\web\resources\ECPolicyParam.java,23,2,1,1,0,4
hadoop-trunk\hadoop-trunk\hadoop-yarn-project\hadoop-yarn\hadoop-yarn-common\src\test\java\org\apache\hadoop\yarn\TestRecordFactory.java,27,4,0,2,0,6
hadoop-trunk\hadoop-trunk\hadoop-hdfs-project\hadoop-hdfs\src\test\java\org\apache\hadoop\hdfs\TestStripedFileAppend.java,102,20,1,1,0,22
hadoop-trunk\hadoop-trunk\hadoop-common-project\hadoop-common\src\main\java\org\apache\hadoop\util\SemaphoredDelegatingExecutor.java,200,47,0,5,0,52
hadoop-trunk\hadoop-trunk\hadoop-hdfs-project\hadoop-hdfs\src\test\java\org\apache\hadoop\hdfs\server\datanode\TestSimulatedFSDataset.java,381,115,11,6,0,132
hadoop-trunk\hadoop-trunk\hadoop-yarn-project\hadoop-yarn\hadoop-yarn-server\hadoop-yarn-server-nodemanager\src\main\java\org\apache\hadoop\yarn\server\nodemanager\containermanager\resourceplugin\fpga\AoclDiagnosticOutputParser.java,0,16,4,18,0,38
hadoop-trunk\hadoop-trunk\hadoop-hdfs-project\hadoop-hdfs-rbf\src\test\java\org\apache\hadoop\hdfs\server\federation\FederationTestUtils.java,0,81,16,8,0,105
hadoop-trunk\hadoop-trunk\hadoop-yarn-project\hadoop-yarn\hadoop-yarn-server\hadoop-yarn-server-common\src\main\java\org\apache\hadoop\yarn\server\federation\policies\amrmproxy\BroadcastAMRMProxyPolicy.java,33,5,0,4,0,9
hadoop-trunk\hadoop-trunk\hadoop-yarn-project\hadoop-yarn\hadoop-yarn-server\hadoop-yarn-server-resourcemanager\src\main\java\org\apache\hadoop\yarn\server\resourcemanager\placement\csmappingrule\MappingRuleResult.java,0,13,0,1,0,14
hadoop-trunk\hadoop-trunk\hadoop-common-project\hadoop-common\src\test\java\org\apache\hadoop\fs\viewfs\TestViewFileSystemWithAuthorityLocalFileSystem.java,48,9,2,2,0,13
hadoop-trunk\hadoop-trunk\hadoop-common-project\hadoop-common\src\test\java\org\apache\hadoop\security\ManualTestKeytabLogins.java,23,10,5,2,0,17
hadoop-trunk\hadoop-trunk\hadoop-yarn-project\hadoop-yarn\hadoop-yarn-server\hadoop-yarn-server-resourcemanager\src\test\java\org\apache\hadoop\yarn\server\resourcemanager\scheduler\capacity\TestCapacitySchedulerWeightMode.java,563,133,3,18,0,154
hadoop-trunk\hadoop-trunk\hadoop-tools\hadoop-aws\src\main\java\org\apache\hadoop\fs\s3a\auth\delegation\RoleTokenBinding.java,131,10,2,5,0,17
hadoop-trunk\hadoop-trunk\hadoop-common-project\hadoop-nfs\src\main\java\org\apache\hadoop\nfs\nfs3\request\PATHCONF3Request.java,16,9,0,1,0,10
hadoop-trunk\hadoop-trunk\hadoop-yarn-project\hadoop-yarn\hadoop-yarn-server\hadoop-yarn-server-resourcemanager\src\main\java\org\apache\hadoop\yarn\server\resourcemanager\webapp\dao\FifoSchedulerInfo.java,97,50,1,5,0,56
hadoop-trunk\hadoop-trunk\hadoop-hdfs-project\hadoop-hdfs\src\main\java\org\apache\hadoop\hdfs\qjournal\server\JournalFaultInjector.java,11,10,2,1,0,13
hadoop-trunk\hadoop-trunk\hadoop-common-project\hadoop-auth\src\test\java\org\apache\hadoop\security\authentication\util\TestZKSignerSecretProvider.java,343,19,13,1,0,33
hadoop-trunk\hadoop-trunk\hadoop-mapreduce-project\hadoop-mapreduce-client\hadoop-mapreduce-client-jobclient\src\test\java\org\apache\hadoop\mapred\TestSequenceFileAsBinaryInputFormat.java,74,13,6,1,0,20
hadoop-trunk\hadoop-trunk\hadoop-mapreduce-project\hadoop-mapreduce-client\hadoop-mapreduce-client-app\src\main\java\org\apache\hadoop\mapreduce\v2\app\job\event\JobCounterUpdateEvent.java,36,29,0,2,0,31
hadoop-trunk\hadoop-trunk\hadoop-common-project\hadoop-common\src\main\java\org\apache\hadoop\security\token\delegation\web\ServletUtils.java,0,4,2,1,0,7
hadoop-trunk\hadoop-trunk\hadoop-mapreduce-project\hadoop-mapreduce-client\hadoop-mapreduce-client-app\src\test\java\org\apache\hadoop\mapreduce\v2\app\launcher\TestContainerLauncher.java,432,111,9,12,0,132
hadoop-trunk\hadoop-trunk\hadoop-yarn-project\hadoop-yarn\hadoop-yarn-server\hadoop-yarn-server-common\src\main\java\org\apache\hadoop\yarn\lib\package-info.java,0,1,0,1,0,2
hadoop-trunk\hadoop-trunk\hadoop-hdfs-project\hadoop-hdfs\src\main\java\org\apache\hadoop\hdfs\server\namenode\AuditLogger.java,0,0,0,1,0,1
hadoop-trunk\hadoop-trunk\hadoop-yarn-project\hadoop-yarn\hadoop-yarn-server\hadoop-yarn-server-resourcemanager\src\main\java\org\apache\hadoop\yarn\server\resourcemanager\volume\csi\VolumeManagerImpl.java,0,22,5,4,0,31
hadoop-trunk\hadoop-trunk\hadoop-yarn-project\hadoop-yarn\hadoop-yarn-server\hadoop-yarn-server-resourcemanager\src\main\java\org\apache\hadoop\yarn\server\resourcemanager\scheduler\NodeResponse.java,22,18,0,1,0,19
hadoop-trunk\hadoop-trunk\hadoop-hdfs-project\hadoop-hdfs\src\test\java\org\apache\hadoop\hdfs\ReadStripedFileWithDecodingHelper.java,0,55,4,1,0,60
hadoop-trunk\hadoop-trunk\hadoop-hdfs-project\hadoop-hdfs\src\test\java\org\apache\hadoop\hdfs\server\namenode\ha\TestFailureOfSharedDir.java,149,16,0,6,0,22
hadoop-trunk\hadoop-trunk\hadoop-yarn-project\hadoop-yarn\hadoop-yarn-common\src\main\java\org\apache\hadoop\yarn\security\client\TimelineAuthenticationConsts.java,15,10,0,1,0,11
hadoop-trunk\hadoop-trunk\hadoop-yarn-project\hadoop-yarn\hadoop-yarn-server\hadoop-yarn-server-resourcemanager\src\test\java\org\apache\hadoop\yarn\server\resourcemanager\TestApplicationACLs.java,432,44,4,8,0,56
hadoop-trunk\hadoop-trunk\hadoop-tools\hadoop-aws\src\main\java\org\apache\hadoop\fs\s3a\auth\SignerManager.java,109,23,6,1,0,30
hadoop-trunk\hadoop-trunk\hadoop-hdfs-project\hadoop-hdfs\src\test\java\org\apache\hadoop\hdfs\TestEncryptionZonesWithKMS.java,115,17,8,1,0,26
hadoop-trunk\hadoop-trunk\hadoop-yarn-project\hadoop-yarn\hadoop-yarn-server\hadoop-yarn-server-nodemanager\src\test\java\org\apache\hadoop\yarn\server\nodemanager\containermanager\BaseContainerSchedulerTest.java,148,35,1,12,0,48
hadoop-trunk\hadoop-trunk\hadoop-yarn-project\hadoop-yarn\hadoop-yarn-common\src\main\java\org\apache\hadoop\yarn\webapp\util\WebServiceClient.java,93,12,2,1,0,15
hadoop-trunk\hadoop-trunk\hadoop-mapreduce-project\hadoop-mapreduce-client\hadoop-mapreduce-client-jobclient\src\test\java\org\apache\hadoop\fs\loadGenerator\LoadGeneratorMR.java,420,190,6,10,0,206
hadoop-trunk\hadoop-trunk\hadoop-mapreduce-project\hadoop-mapreduce-client\hadoop-mapreduce-client-core\src\main\java\org\apache\hadoop\mapreduce\security\token\JobTokenIdentifier.java,63,15,0,1,0,16
hadoop-trunk\hadoop-trunk\hadoop-tools\hadoop-azure\src\test\java\org\apache\hadoop\fs\azure\TestNativeAzureFileSystemAuthorization.java,0,236,76,137,0,449
hadoop-trunk\hadoop-trunk\hadoop-yarn-project\hadoop-yarn\hadoop-yarn-server\hadoop-yarn-server-resourcemanager\src\main\java\org\apache\hadoop\yarn\server\resourcemanager\webapp\dao\StatisticsItemInfo.java,30,21,1,1,0,23
hadoop-trunk\hadoop-trunk\hadoop-hdfs-project\hadoop-hdfs-rbf\src\main\java\org\apache\hadoop\hdfs\server\federation\router\DFSRouter.java,0,3,1,1,0,5
hadoop-trunk\hadoop-trunk\hadoop-tools\hadoop-azure\src\test\java\org\apache\hadoop\fs\azurebfs\utils\TestUriUtils.java,0,8,0,6,0,14
hadoop-trunk\hadoop-trunk\hadoop-yarn-project\hadoop-yarn\hadoop-yarn-server\hadoop-yarn-server-common\src\main\java\org\apache\hadoop\yarn\server\security\http\RMAuthenticationFilter.java,51,14,2,4,0,20
hadoop-trunk\hadoop-trunk\hadoop-common-project\hadoop-common\src\main\java\org\apache\hadoop\fs\UnsupportedFileSystemException.java,12,2,0,1,0,3
hadoop-trunk\hadoop-trunk\hadoop-tools\hadoop-streaming\src\main\java\org\apache\hadoop\streaming\HadoopStreaming.java,45,10,4,1,0,15
hadoop-trunk\hadoop-trunk\hadoop-yarn-project\hadoop-yarn\hadoop-yarn-server\hadoop-yarn-server-resourcemanager\src\main\java\org\apache\hadoop\yarn\server\resourcemanager\scheduler\event\AppAttemptAddedSchedulerEvent.java,35,21,0,1,0,22
hadoop-trunk\hadoop-trunk\hadoop-tools\hadoop-aws\src\main\java\org\apache\hadoop\fs\s3a\impl\ChangeDetectionPolicy.java,477,65,8,2,0,75
hadoop-trunk\hadoop-trunk\hadoop-yarn-project\hadoop-yarn\hadoop-yarn-api\src\main\java\org\apache\hadoop\yarn\api\records\PreemptionMessage.java,37,5,0,1,0,6
hadoop-trunk\hadoop-trunk\hadoop-hdfs-project\hadoop-hdfs-rbf\src\test\java\org\apache\hadoop\fs\contract\router\SecurityConfUtil.java,0,12,1,16,0,29
hadoop-trunk\hadoop-trunk\hadoop-tools\hadoop-aws\src\test\java\org\apache\hadoop\fs\s3a\scale\ITestS3ACreatePerformance.java,54,10,2,1,0,13
hadoop-trunk\hadoop-trunk\hadoop-tools\hadoop-openstack\src\main\java\org\apache\hadoop\fs\swift\exceptions\SwiftConnectionClosedException.java,15,5,0,1,0,6
hadoop-trunk\hadoop-trunk\hadoop-yarn-project\hadoop-yarn\hadoop-yarn-server\hadoop-yarn-server-common\src\main\java\org\apache\hadoop\yarn\server\federation\policies\package-info.java,0,0,0,1,0,1
hadoop-trunk\hadoop-trunk\hadoop-hdfs-project\hadoop-hdfs\src\main\java\org\apache\hadoop\hdfs\server\datanode\fsdataset\VolumeChoosingPolicy.java,0,4,0,1,0,5
hadoop-trunk\hadoop-trunk\hadoop-mapreduce-project\hadoop-mapreduce-client\hadoop-mapreduce-client-app\src\test\java\org\apache\hadoop\mapreduce\v2\app\TestJobEndNotifier.java,398,66,7,1,0,74
hadoop-trunk\hadoop-trunk\hadoop-mapreduce-project\hadoop-mapreduce-client\hadoop-mapreduce-client-nativetask\src\main\java\org\apache\hadoop\mapred\nativetask\serde\KVSerializer.java,0,32,3,5,0,40
hadoop-trunk\hadoop-trunk\hadoop-tools\hadoop-federation-balance\src\main\java\org\apache\hadoop\tools\fedbalance\FedBalanceContext.java,295,71,2,1,0,74
hadoop-trunk\hadoop-trunk\hadoop-tools\hadoop-aws\src\main\java\org\apache\hadoop\fs\s3a\tools\MarkerToolOperationsImpl.java,30,3,0,1,0,4
hadoop-trunk\hadoop-trunk\hadoop-tools\hadoop-openstack\src\test\java\org\apache\hadoop\fs\swift\TestSwiftFileSystemDirectories.java,109,10,1,2,0,13
hadoop-trunk\hadoop-trunk\hadoop-yarn-project\hadoop-yarn\hadoop-yarn-server\hadoop-yarn-server-resourcemanager\src\main\java\org\apache\hadoop\yarn\server\resourcemanager\scheduler\Allocation.java,125,117,0,1,0,118
hadoop-trunk\hadoop-trunk\hadoop-common-project\hadoop-common\src\main\java\org\apache\hadoop\io\serializer\JavaSerialization.java,81,13,1,1,0,15
hadoop-trunk\hadoop-trunk\hadoop-common-project\hadoop-common\src\test\java\org\apache\hadoop\fs\protocolPB\TestFSSerialization.java,54,21,7,1,0,29
hadoop-trunk\hadoop-trunk\hadoop-hdfs-project\hadoop-hdfs-client\src\test\java\org\apache\hadoop\hdfs\TestDFSOpsCountStatistics.java,162,12,3,2,0,17
hadoop-trunk\hadoop-trunk\hadoop-mapreduce-project\hadoop-mapreduce-client\hadoop-mapreduce-client-jobclient\src\test\java\org\apache\hadoop\fs\slive\RenameOp.java,0,15,3,1,0,19
hadoop-trunk\hadoop-trunk\hadoop-hdfs-project\hadoop-hdfs\src\test\java\org\apache\hadoop\hdfs\server\blockmanagement\TestPendingDataNodeMessages.java,74,17,0,4,0,21
hadoop-trunk\hadoop-trunk\hadoop-yarn-project\hadoop-yarn\hadoop-yarn-server\hadoop-yarn-server-timelineservice-hbase\hadoop-yarn-server-timelineservice-hbase-common\src\main\java\org\apache\hadoop\yarn\server\timelineservice\storage\common\LongKeyConverter.java,0,3,3,1,0,7
hadoop-trunk\hadoop-trunk\hadoop-common-project\hadoop-common\src\main\java\org\apache\hadoop\service\launcher\IrqHandler.java,0,22,13,1,0,36
hadoop-trunk\hadoop-trunk\hadoop-tools\hadoop-azure\src\main\java\org\apache\hadoop\fs\azure\WasbAuthorizerInterface.java,0,3,1,1,0,5
hadoop-trunk\hadoop-trunk\hadoop-yarn-project\hadoop-yarn\hadoop-yarn-server\hadoop-yarn-server-common\src\main\java\org\apache\hadoop\yarn\server\api\DistributedSchedulingAMProtocol.java,0,0,0,5,0,5
hadoop-trunk\hadoop-trunk\hadoop-tools\hadoop-gridmix\src\test\java\org\apache\hadoop\mapred\gridmix\GridmixTestUtils.java,85,32,4,4,0,40
hadoop-trunk\hadoop-trunk\hadoop-tools\hadoop-rumen\src\main\java\org\apache\hadoop\tools\rumen\JobHistoryParser.java,0,3,0,1,0,4
hadoop-trunk\hadoop-trunk\hadoop-common-project\hadoop-common\src\main\java\org\apache\hadoop\fs\permission\AclEntryScope.java,0,0,0,1,0,1
hadoop-trunk\hadoop-trunk\hadoop-yarn-project\hadoop-yarn\hadoop-yarn-server\hadoop-yarn-server-resourcemanager\src\main\java\org\apache\hadoop\yarn\server\resourcemanager\metrics\TimelineServiceV1Publisher.java,524,81,18,14,0,113
hadoop-trunk\hadoop-trunk\hadoop-yarn-project\hadoop-yarn\hadoop-yarn-server\hadoop-yarn-server-resourcemanager\src\main\java\org\apache\hadoop\yarn\server\resourcemanager\scheduler\SchedulerUtils.java,535,126,9,7,0,142
hadoop-trunk\hadoop-trunk\hadoop-common-project\hadoop-common\src\main\java\org\apache\hadoop\ipc\RpcClientException.java,26,7,0,1,0,8
hadoop-trunk\hadoop-trunk\hadoop-hdfs-project\hadoop-hdfs\src\main\java\org\apache\hadoop\hdfs\server\namenode\NameCache.java,0,32,2,1,0,35
hadoop-trunk\hadoop-trunk\hadoop-mapreduce-project\hadoop-mapreduce-client\hadoop-mapreduce-client-jobclient\src\test\java\org\apache\hadoop\mapreduce\lib\jobcontrol\TestControlledJob.java,20,4,0,1,0,5
hadoop-trunk\hadoop-trunk\hadoop-common-project\hadoop-common\src\test\java\org\apache\hadoop\io\file\tfile\KeySampler.java,0,34,1,1,0,36
hadoop-trunk\hadoop-trunk\hadoop-yarn-project\hadoop-yarn\hadoop-yarn-common\src\main\java\org\apache\hadoop\yarn\security\client\RMDelegationTokenIdentifier.java,125,42,1,4,0,47
hadoop-trunk\hadoop-trunk\hadoop-common-project\hadoop-common\src\main\java\org\apache\hadoop\fs\FSLinkResolver.java,80,10,5,2,0,17
hadoop-trunk\hadoop-trunk\hadoop-yarn-project\hadoop-yarn\hadoop-yarn-server\hadoop-yarn-server-nodemanager\src\main\java\org\apache\hadoop\yarn\server\nodemanager\nodelabels\ScriptBasedNodeAttributesProvider.java,113,15,2,1,0,18
hadoop-trunk\hadoop-trunk\hadoop-yarn-project\hadoop-yarn\hadoop-yarn-server\hadoop-yarn-server-timelineservice-hbase\hadoop-yarn-server-timelineservice-hbase-client\src\main\java\org\apache\hadoop\yarn\server\timelineservice\storage\domain\package-info.java,0,0,0,1,0,1
hadoop-trunk\hadoop-trunk\hadoop-hdfs-project\hadoop-hdfs\src\test\java\org\apache\hadoop\hdfs\client\impl\BlockReaderTestUtil.java,198,76,5,6,0,87
hadoop-trunk\hadoop-trunk\hadoop-yarn-project\hadoop-yarn\hadoop-yarn-common\src\main\java\org\apache\hadoop\yarn\security\AdminACLsManager.java,80,11,1,1,0,13
hadoop-trunk\hadoop-trunk\hadoop-yarn-project\hadoop-yarn\hadoop-yarn-server\hadoop-yarn-server-resourcemanager\src\main\java\org\apache\hadoop\yarn\server\resourcemanager\recovery\records\RMDelegationTokenIdentifierData.java,41,23,14,2,0,39
hadoop-trunk\hadoop-trunk\hadoop-yarn-project\hadoop-yarn\hadoop-yarn-server\hadoop-yarn-server-resourcemanager\src\main\java\org\apache\hadoop\yarn\server\resourcemanager\RMAppManager.java,962,136,24,19,0,179
hadoop-trunk\hadoop-trunk\hadoop-hdfs-project\hadoop-hdfs\src\main\java\org\apache\hadoop\hdfs\server\protocol\FenceResponse.java,24,15,0,1,0,16
hadoop-trunk\hadoop-trunk\hadoop-tools\hadoop-azure\src\test\java\org\apache\hadoop\fs\azurebfs\contract\ITestAbfsFileSystemContractAppend.java,32,7,0,2,0,9
hadoop-trunk\hadoop-trunk\hadoop-tools\hadoop-azure\src\test\java\org\apache\hadoop\fs\azurebfs\ITestAzureBlobFileSystemMainOperation.java,50,13,1,7,0,21
hadoop-trunk\hadoop-trunk\hadoop-tools\hadoop-aws\src\test\java\org\apache\hadoop\fs\contract\s3a\S3AContract.java,47,5,0,1,0,6
hadoop-trunk\hadoop-trunk\hadoop-hdfs-project\hadoop-hdfs\src\test\java\org\apache\hadoop\hdfs\server\blockmanagement\TestAvailableSpaceBlockPlacementPolicy.java,187,62,8,12,0,82
hadoop-trunk\hadoop-trunk\hadoop-tools\hadoop-streaming\src\main\java\org\apache\hadoop\streaming\StreamInputFormat.java,49,17,4,5,0,26
hadoop-trunk\hadoop-trunk\hadoop-yarn-project\hadoop-yarn\hadoop-yarn-server\hadoop-yarn-server-resourcemanager\src\main\java\org\apache\hadoop\yarn\server\resourcemanager\webapp\dao\AppAllocationInfo.java,69,27,1,3,0,31
hadoop-trunk\hadoop-trunk\hadoop-mapreduce-project\hadoop-mapreduce-client\hadoop-mapreduce-client-core\src\test\java\org\apache\hadoop\mapred\TestCounters.java,0,92,21,5,0,118
hadoop-trunk\hadoop-trunk\hadoop-common-project\hadoop-common\src\test\java\org\apache\hadoop\test\HadoopTestBase.java,74,0,0,1,0,1
hadoop-trunk\hadoop-trunk\hadoop-yarn-project\hadoop-yarn\hadoop-yarn-server\hadoop-yarn-server-common\src\main\java\org\apache\hadoop\yarn\server\federation\store\records\GetSubClusterPolicyConfigurationRequest.java,33,3,0,1,0,4
hadoop-trunk\hadoop-trunk\hadoop-mapreduce-project\hadoop-mapreduce-client\hadoop-mapreduce-client-nativetask\src\test\java\org\apache\hadoop\mapred\nativetask\buffer\TestOutputBuffer.java,25,2,0,2,0,4
hadoop-trunk\hadoop-trunk\hadoop-tools\hadoop-distcp\src\test\java\org\apache\hadoop\tools\mapred\TestCopyMapperCompositeCrc.java,23,3,0,1,0,4
hadoop-trunk\hadoop-trunk\hadoop-common-project\hadoop-auth\src\test\java\org\apache\hadoop\security\authentication\client\TestPseudoAuthenticator.java,83,12,0,6,0,18
hadoop-trunk\hadoop-trunk\hadoop-hdfs-project\hadoop-hdfs\src\main\java\org\apache\hadoop\hdfs\server\namenode\SerialNumberMap.java,69,26,2,1,0,29
hadoop-trunk\hadoop-trunk\hadoop-mapreduce-project\hadoop-mapreduce-client\hadoop-mapreduce-client-core\src\main\java\org\apache\hadoop\mapreduce\task\reduce\LocalFetcher.java,0,30,5,1,0,36
hadoop-trunk\hadoop-trunk\hadoop-yarn-project\hadoop-yarn\hadoop-yarn-client\src\test\java\org\apache\hadoop\yarn\client\ProtocolHATestBase.java,682,163,35,15,0,213
hadoop-trunk\hadoop-trunk\hadoop-hdfs-project\hadoop-hdfs\src\test\java\org\apache\hadoop\hdfs\server\namenode\snapshot\TestRandomOpsWithSnapshots.java,635,99,39,1,0,139
hadoop-trunk\hadoop-trunk\hadoop-hdfs-project\hadoop-hdfs\src\test\java\org\apache\hadoop\hdfs\server\blockmanagement\TestNameNodePrunesMissingStorages.java,375,62,13,6,0,81
hadoop-trunk\hadoop-trunk\hadoop-tools\hadoop-azure\src\main\java\org\apache\hadoop\fs\azurebfs\contracts\exceptions\AbfsRestOperationException.java,72,23,1,6,0,30
hadoop-trunk\hadoop-trunk\hadoop-tools\hadoop-distcp\src\test\java\org\apache\hadoop\tools\TestDistCpSyncReverseBase.java,819,73,23,2,0,98
hadoop-trunk\hadoop-trunk\hadoop-tools\hadoop-dynamometer\hadoop-dynamometer-workload\src\main\java\org\apache\hadoop\tools\dynamometer\workloadgenerator\VirtualInputSplit.java,24,4,0,1,0,5
hadoop-trunk\hadoop-trunk\hadoop-yarn-project\hadoop-yarn\hadoop-yarn-server\hadoop-yarn-server-applicationhistoryservice\src\main\java\org\apache\hadoop\yarn\server\timeline\TimelineDataManagerMetrics.java,152,97,1,1,0,99
hadoop-trunk\hadoop-trunk\hadoop-common-project\hadoop-common\src\main\java\org\apache\hadoop\security\token\delegation\web\DelegationTokenAuthenticationFilter.java,0,28,10,6,0,44
hadoop-trunk\hadoop-trunk\hadoop-tools\hadoop-openstack\src\main\java\org\apache\hadoop\fs\swift\util\HttpResponseUtils.java,88,11,1,3,0,15
hadoop-trunk\hadoop-trunk\hadoop-yarn-project\hadoop-yarn\hadoop-yarn-server\hadoop-yarn-server-nodemanager\src\main\java\org\apache\hadoop\yarn\server\nodemanager\containermanager\launcher\ContainersLauncher.java,0,46,7,9,0,62
hadoop-trunk\hadoop-trunk\hadoop-hdfs-project\hadoop-hdfs-rbf\src\main\java\org\apache\hadoop\hdfs\server\federation\resolver\MembershipNamenodeResolver.java,0,21,5,11,0,37
hadoop-trunk\hadoop-trunk\hadoop-cloud-storage-project\hadoop-huaweicloud\src\test\java\org\apache\hadoop\fs\obs\TestOBSFileSystemContract.java,25,5,0,1,0,6
hadoop-trunk\hadoop-trunk\hadoop-tools\hadoop-azure\src\test\java\org\apache\hadoop\fs\azurebfs\ITestAzureBlobFileSystemCLI.java,30,1,0,4,0,5
hadoop-trunk\hadoop-trunk\hadoop-mapreduce-project\hadoop-mapreduce-client\hadoop-mapreduce-client-core\src\main\java\org\apache\hadoop\mapred\SequenceFileInputFormat.java,0,13,0,1,0,14
hadoop-trunk\hadoop-trunk\hadoop-yarn-project\hadoop-yarn\hadoop-yarn-common\src\test\java\org\apache\hadoop\yarn\conf\TestYarnConfiguration.java,218,14,19,6,0,39
hadoop-trunk\hadoop-trunk\hadoop-yarn-project\hadoop-yarn\hadoop-yarn-common\src\test\java\org\apache\hadoop\yarn\nodelabels\NodeLabelTestBase.java,129,33,3,1,0,37
hadoop-trunk\hadoop-trunk\hadoop-yarn-project\hadoop-yarn\hadoop-yarn-server\hadoop-yarn-server-resourcemanager\src\main\java\org\apache\hadoop\yarn\server\resourcemanager\reservation\PlanView.java,0,12,0,2,0,14
hadoop-trunk\hadoop-trunk\hadoop-yarn-project\hadoop-yarn\hadoop-yarn-api\src\main\java\org\apache\hadoop\yarn\api\CsiAdaptorPB.java,0,0,2,1,0,3
hadoop-trunk\hadoop-trunk\hadoop-yarn-project\hadoop-yarn\hadoop-yarn-server\hadoop-yarn-server-common\src\test\java\org\apache\hadoop\yarn\server\federation\store\impl\TestSQLFederationStateStore.java,45,7,0,3,0,10
hadoop-trunk\hadoop-trunk\hadoop-yarn-project\hadoop-yarn\hadoop-yarn-server\hadoop-yarn-server-tests\src\test\java\org\apache\hadoop\yarn\server\TestRMNMSecretKeys.java,160,39,1,5,0,45
hadoop-trunk\hadoop-trunk\hadoop-common-project\hadoop-common\src\main\java\org\apache\hadoop\ipc\DefaultCostProvider.java,19,3,0,1,0,4
hadoop-trunk\hadoop-trunk\hadoop-hdfs-project\hadoop-hdfs\src\main\java\org\apache\hadoop\hdfs\server\blockmanagement\BlockReconstructionWork.java,117,27,0,1,0,28
hadoop-trunk\hadoop-trunk\hadoop-hdfs-project\hadoop-hdfs\src\test\java\org\apache\hadoop\hdfs\server\namenode\TestProtectedDirectories.java,567,50,22,3,0,75
hadoop-trunk\hadoop-trunk\hadoop-yarn-project\hadoop-yarn\hadoop-yarn-server\hadoop-yarn-server-nodemanager\src\test\java\org\apache\hadoop\yarn\server\nodemanager\containermanager\resourceplugin\gpu\TestGpuResourcePlugin.java,135,10,0,6,0,16
hadoop-trunk\hadoop-trunk\hadoop-hdfs-project\hadoop-hdfs-rbf\src\main\java\org\apache\hadoop\hdfs\server\federation\store\protocol\impl\pb\GetSafeModeResponsePBImpl.java,0,12,29,5,0,46
hadoop-trunk\hadoop-trunk\hadoop-hdfs-project\hadoop-hdfs\src\test\java\org\apache\hadoop\hdfs\server\datanode\fsdataset\impl\TestLazyWriter.java,221,20,18,3,0,41
hadoop-trunk\hadoop-trunk\hadoop-yarn-project\hadoop-yarn\hadoop-yarn-common\src\main\java\org\apache\hadoop\yarn\api\records\impl\pb\ProtoBase.java,0,14,2,1,0,17
hadoop-trunk\hadoop-trunk\hadoop-mapreduce-project\hadoop-mapreduce-client\hadoop-mapreduce-client-core\src\main\java\org\apache\hadoop\mapreduce\lib\aggregate\LongValueMax.java,72,23,3,2,0,28
hadoop-trunk\hadoop-trunk\hadoop-common-project\hadoop-common\src\main\java\org\apache\hadoop\fs\statistics\impl\IOStatisticsStoreImpl.java,0,12,1,7,0,20
hadoop-trunk\hadoop-trunk\hadoop-common-project\hadoop-nfs\src\main\java\org\apache\hadoop\mount\MountdBase.java,0,17,3,1,0,21
hadoop-trunk\hadoop-trunk\hadoop-hdfs-project\hadoop-hdfs-client\src\main\java\org\apache\hadoop\hdfs\KeyProviderCache.java,97,14,4,2,0,20
hadoop-trunk\hadoop-trunk\hadoop-yarn-project\hadoop-yarn\hadoop-yarn-server\hadoop-yarn-server-resourcemanager\src\test\java\org\apache\hadoop\yarn\server\resourcemanager\scheduler\capacity\TestContainerResizing.java,1087,159,10,12,0,181
hadoop-trunk\hadoop-trunk\hadoop-hdfs-project\hadoop-hdfs-httpfs\src\test\java\org\apache\hadoop\fs\http\server\TestCheckUploadContentTypeFilter.java,63,22,0,11,0,33
hadoop-trunk\hadoop-trunk\hadoop-tools\hadoop-streaming\src\test\java\org\apache\hadoop\streaming\TestSymLink.java,0,63,17,2,0,82
hadoop-trunk\hadoop-trunk\hadoop-common-project\hadoop-common\src\main\java\org\apache\hadoop\security\NullGroupsMapping.java,40,3,2,1,0,6
hadoop-trunk\hadoop-trunk\hadoop-hdfs-project\hadoop-hdfs\src\main\java\org\apache\hadoop\hdfs\server\blockmanagement\InvalidateBlocks.java,0,37,11,1,0,49
hadoop-trunk\hadoop-trunk\hadoop-mapreduce-project\hadoop-mapreduce-client\hadoop-mapreduce-client-core\src\test\java\org\apache\hadoop\mapreduce\lib\output\committer\manifest\TestRenameStageFailure.java,318,20,3,15,0,38
hadoop-trunk\hadoop-trunk\hadoop-common-project\hadoop-nfs\src\main\java\org\apache\hadoop\nfs\nfs3\request\READDIRPLUS3Request.java,51,29,0,1,0,30
hadoop-trunk\hadoop-trunk\hadoop-hdfs-project\hadoop-hdfs\src\main\java\org\apache\hadoop\hdfs\server\namenode\INodeFileAttributes.java,0,32,1,1,0,34
hadoop-trunk\hadoop-trunk\hadoop-common-project\hadoop-common\src\main\java\org\apache\hadoop\util\LightWeightGSet.java,0,87,8,1,0,96
hadoop-trunk\hadoop-trunk\hadoop-tools\hadoop-azure\src\test\java\org\apache\hadoop\fs\azurebfs\TestAbfsCrc64.java,13,4,0,4,0,8
hadoop-trunk\hadoop-trunk\hadoop-mapreduce-project\hadoop-mapreduce-client\hadoop-mapreduce-client-jobclient\src\test\java\org\apache\hadoop\mapred\BigMapOutput.java,133,74,5,4,0,83
hadoop-trunk\hadoop-trunk\hadoop-hdfs-project\hadoop-hdfs\src\test\java\org\apache\hadoop\hdfs\server\namenode\TestFSNamesystemLock.java,397,39,3,1,0,43
hadoop-trunk\hadoop-trunk\hadoop-yarn-project\hadoop-yarn\hadoop-yarn-server\hadoop-yarn-server-resourcemanager\src\main\java\org\apache\hadoop\yarn\server\resourcemanager\ClusterMonitor.java,0,4,0,1,0,5
hadoop-trunk\hadoop-trunk\hadoop-hdfs-project\hadoop-hdfs\src\main\java\org\apache\hadoop\hdfs\protocolPB\DatanodeLifelineProtocolPB.java,0,0,3,2,0,5
hadoop-trunk\hadoop-trunk\hadoop-hdfs-project\hadoop-hdfs\src\main\java\org\apache\hadoop\hdfs\server\common\TokenVerifier.java,0,2,0,2,0,4
hadoop-trunk\hadoop-trunk\hadoop-yarn-project\hadoop-yarn\hadoop-yarn-applications\hadoop-yarn-services\hadoop-yarn-services-core\src\main\java\org\apache\hadoop\yarn\service\api\records\Container.java,303,138,2,11,0,151
hadoop-trunk\hadoop-trunk\hadoop-hdfs-project\hadoop-hdfs\src\test\java\org\apache\hadoop\hdfs\server\blockmanagement\TestBlockStatsMXBean.java,238,65,4,2,0,71
hadoop-trunk\hadoop-trunk\hadoop-yarn-project\hadoop-yarn\hadoop-yarn-server\hadoop-yarn-server-resourcemanager\src\main\java\org\apache\hadoop\yarn\server\resourcemanager\scheduler\fair\FairSchedulerConfiguration.java,728,149,5,11,0,165
hadoop-trunk\hadoop-trunk\hadoop-mapreduce-project\hadoop-mapreduce-client\hadoop-mapreduce-client-jobclient\src\test\java\org\apache\hadoop\mapreduce\JobHistoryFileParser.java,0,7,3,1,0,11
hadoop-trunk\hadoop-trunk\hadoop-mapreduce-project\hadoop-mapreduce-client\hadoop-mapreduce-client-hs\src\main\java\org\apache\hadoop\mapreduce\v2\hs\webapp\HsJobBlock.java,169,39,0,6,0,45
hadoop-trunk\hadoop-trunk\hadoop-yarn-project\hadoop-yarn\hadoop-yarn-csi\src\main\java\org\apache\hadoop\yarn\csi\adaptor\CsiAdaptorFactory.java,0,3,1,1,0,5
hadoop-trunk\hadoop-trunk\hadoop-yarn-project\hadoop-yarn\hadoop-yarn-server\hadoop-yarn-server-nodemanager\src\main\java\org\apache\hadoop\yarn\server\nodemanager\containermanager\resourceplugin\fpga\discovery\AoclOutputBasedDiscoveryStrategy.java,0,5,0,6,0,11
hadoop-trunk\hadoop-trunk\hadoop-mapreduce-project\hadoop-mapreduce-client\hadoop-mapreduce-client-core\src\main\java\org\apache\hadoop\mapreduce\checkpoint\CheckpointService.java,0,8,7,2,0,17
hadoop-trunk\hadoop-trunk\hadoop-tools\hadoop-dynamometer\hadoop-dynamometer-blockgen\src\main\java\org\apache\hadoop\tools\dynamometer\blockgenerator\XMLParserMapper.java,0,10,2,1,0,13
hadoop-trunk\hadoop-trunk\hadoop-yarn-project\hadoop-yarn\hadoop-yarn-common\src\main\java\org\apache\hadoop\yarn\metrics\DisableEventTypeMetrics.java,18,10,5,1,0,16
hadoop-trunk\hadoop-trunk\hadoop-hdfs-project\hadoop-hdfs\src\main\java\org\apache\hadoop\hdfs\server\aliasmap\InMemoryLevelDBAliasMapServer.java,0,27,4,7,0,38
hadoop-trunk\hadoop-trunk\hadoop-yarn-project\hadoop-yarn\hadoop-yarn-server\hadoop-yarn-server-resourcemanager\src\test\java\org\apache\hadoop\yarn\server\resourcemanager\scheduler\fair\TestAllocationFileLoaderService.java,887,171,20,24,0,215
hadoop-trunk\hadoop-trunk\hadoop-tools\hadoop-streaming\src\main\java\org\apache\hadoop\streaming\PipeMapper.java,122,43,8,8,0,59
hadoop-trunk\hadoop-trunk\hadoop-hdfs-project\hadoop-hdfs\src\test\java\org\apache\hadoop\hdfs\server\datanode\extdataset\ExternalDatasetImpl.java,427,179,30,4,0,213
hadoop-trunk\hadoop-trunk\hadoop-hdfs-project\hadoop-hdfs\src\main\java\org\apache\hadoop\hdfs\util\AtomicFileOutputStream.java,79,20,5,5,0,30
hadoop-trunk\hadoop-trunk\hadoop-common-project\hadoop-common\src\test\java\org\apache\hadoop\io\file\tfile\NanoTimer.java,0,44,4,2,0,50
hadoop-trunk\hadoop-trunk\hadoop-tools\hadoop-aws\src\main\java\org\apache\hadoop\fs\s3a\auth\delegation\SessionTokenBinding.java,367,15,6,3,0,24
hadoop-trunk\hadoop-trunk\hadoop-yarn-project\hadoop-yarn\hadoop-yarn-server\hadoop-yarn-server-nodemanager\src\test\java\org\apache\hadoop\yarn\server\nodemanager\containermanager\localizer\TestContainerLocalizer.java,608,94,16,5,0,115
hadoop-trunk\hadoop-trunk\hadoop-yarn-project\hadoop-yarn\hadoop-yarn-server\hadoop-yarn-server-nodemanager\src\main\java\org\apache\hadoop\yarn\server\nodemanager\webapp\dao\gpu\PerGpuDeviceInformation.java,131,46,0,1,0,47
hadoop-trunk\hadoop-trunk\hadoop-yarn-project\hadoop-yarn\hadoop-yarn-server\hadoop-yarn-server-resourcemanager\src\main\java\org\apache\hadoop\yarn\server\resourcemanager\scheduler\capacity\ResourceVector.java,0,18,0,2,0,20
hadoop-trunk\hadoop-trunk\hadoop-hdfs-project\hadoop-hdfs-client\src\main\java\org\apache\hadoop\hdfs\web\KerberosUgiAuthenticator.java,16,1,0,1,0,2
hadoop-trunk\hadoop-trunk\hadoop-yarn-project\hadoop-yarn\hadoop-yarn-server\hadoop-yarn-server-common\src\test\java\org\apache\hadoop\yarn\server\TestAMRMClientRelayer.java,290,61,6,7,0,74
hadoop-trunk\hadoop-trunk\hadoop-mapreduce-project\hadoop-mapreduce-examples\src\main\java\org\apache\hadoop\examples\pi\Combinable.java,0,5,1,1,0,7
hadoop-trunk\hadoop-trunk\hadoop-tools\hadoop-aws\src\test\java\org\apache\hadoop\fs\s3a\audit\TestAuditIntegration.java,165,5,2,6,0,13
hadoop-trunk\hadoop-trunk\hadoop-hdfs-project\hadoop-hdfs\src\test\java\org\apache\hadoop\hdfs\server\namenode\TestLargeDirectoryDelete.java,189,48,7,3,0,58
hadoop-trunk\hadoop-trunk\hadoop-hdfs-project\hadoop-hdfs\src\test\java\org\apache\hadoop\hdfs\server\namenode\TestEditLogAutoroll.java,103,33,3,8,0,44
hadoop-trunk\hadoop-trunk\hadoop-common-project\hadoop-common\src\test\java\org\apache\hadoop\fs\shell\TestTextCommand.java,0,378,14,1,0,393
hadoop-trunk\hadoop-trunk\hadoop-yarn-project\hadoop-yarn\hadoop-yarn-server\hadoop-yarn-server-nodemanager\src\main\java\org\apache\hadoop\yarn\server\nodemanager\containermanager\records\AuxServiceRecords.java,15,6,0,1,0,7
hadoop-trunk\hadoop-trunk\hadoop-yarn-project\hadoop-yarn\hadoop-yarn-server\hadoop-yarn-server-resourcemanager\src\main\java\org\apache\hadoop\yarn\server\resourcemanager\RMSecretManagerService.java,111,39,1,8,0,48
hadoop-trunk\hadoop-trunk\hadoop-yarn-project\hadoop-yarn\hadoop-yarn-server\hadoop-yarn-server-timelineservice-hbase\hadoop-yarn-server-timelineservice-hbase-client\src\main\java\org\apache\hadoop\yarn\server\timelineservice\storage\common\ColumnRWHelper.java,0,76,6,2,0,84
hadoop-trunk\hadoop-trunk\hadoop-tools\hadoop-azure\src\test\java\org\apache\hadoop\fs\azure\ITestAzureConcurrentOutOfBandIo.java,144,27,4,3,0,34
hadoop-trunk\hadoop-trunk\hadoop-yarn-project\hadoop-yarn\hadoop-yarn-server\hadoop-yarn-server-resourcemanager\src\test\java\org\apache\hadoop\yarn\server\resourcemanager\reservation\BaseSharingPolicyTest.java,147,38,10,4,0,52
hadoop-trunk\hadoop-trunk\hadoop-mapreduce-project\hadoop-mapreduce-client\hadoop-mapreduce-client-core\src\main\java\org\apache\hadoop\mapred\MultiFileSplit.java,0,24,3,1,0,28
hadoop-trunk\hadoop-trunk\hadoop-tools\hadoop-aws\src\test\java\org\apache\hadoop\fs\s3a\fileContext\ITestS3AFileContextCreateMkdir.java,0,2,1,1,0,4
hadoop-trunk\hadoop-trunk\hadoop-yarn-project\hadoop-yarn\hadoop-yarn-server\hadoop-yarn-server-resourcemanager\src\test\java\org\apache\hadoop\yarn\server\resourcemanager\monitor\TestSchedulingMonitor.java,99,9,0,6,0,15
hadoop-trunk\hadoop-trunk\hadoop-hdfs-project\hadoop-hdfs-client\src\main\java\org\apache\hadoop\hdfs\shortcircuit\DomainSocketFactory.java,164,52,5,4,0,61
hadoop-trunk\hadoop-trunk\hadoop-yarn-project\hadoop-yarn\hadoop-yarn-applications\hadoop-yarn-services\hadoop-yarn-services-core\src\test\java\org\apache\hadoop\yarn\service\ServiceTestUtils.java,501,98,12,8,0,118
hadoop-trunk\hadoop-trunk\hadoop-hdfs-project\hadoop-hdfs\src\main\java\org\apache\hadoop\hdfs\net\TcpPeerServer.java,75,17,2,2,0,21
hadoop-trunk\hadoop-trunk\hadoop-common-project\hadoop-common\src\test\java\org\apache\hadoop\fs\viewfs\TestRegexMountPoint.java,131,13,12,1,0,26
hadoop-trunk\hadoop-trunk\hadoop-tools\hadoop-streaming\src\test\java\org\apache\hadoop\streaming\TestStreamAggregate.java,0,35,6,5,0,46
hadoop-trunk\hadoop-trunk\hadoop-tools\hadoop-aws\src\main\java\org\apache\hadoop\fs\s3a\statistics\StatisticTypeEnum.java,0,0,0,1,0,1
hadoop-trunk\hadoop-trunk\hadoop-yarn-project\hadoop-yarn\hadoop-yarn-server\hadoop-yarn-server-resourcemanager\src\main\java\org\apache\hadoop\yarn\server\resourcemanager\ahs\WritingApplicationFinishEvent.java,27,13,1,2,0,16
hadoop-trunk\hadoop-trunk\hadoop-common-project\hadoop-common\src\test\java\org\apache\hadoop\fs\TestFileSystemStorageStatistics.java,97,23,1,1,0,25
hadoop-trunk\hadoop-trunk\hadoop-common-project\hadoop-common\src\main\java\org\apache\hadoop\io\erasurecode\rawcoder\AbstractNativeRawDecoder.java,77,11,0,1,0,12
hadoop-trunk\hadoop-trunk\hadoop-hdfs-project\hadoop-hdfs-client\src\test\java\org\apache\hadoop\hdfs\web\TestWebHDFSOAuth2.java,159,65,1,14,0,80
hadoop-trunk\hadoop-trunk\hadoop-hdfs-project\hadoop-hdfs-rbf\src\test\java\org\apache\hadoop\fs\contract\router\RouterHDFSContract.java,87,18,1,2,0,21
hadoop-trunk\hadoop-trunk\hadoop-tools\hadoop-azure\src\test\java\org\apache\hadoop\fs\azure\contract\NativeAzureFileSystemContract.java,21,5,0,1,0,6
hadoop-trunk\hadoop-trunk\hadoop-hdfs-project\hadoop-hdfs\src\main\java\org\apache\hadoop\hdfs\server\datanode\ReplicaHandler.java,22,9,0,1,0,10
hadoop-trunk\hadoop-trunk\hadoop-yarn-project\hadoop-yarn\hadoop-yarn-server\hadoop-yarn-server-nodemanager\src\main\java\org\apache\hadoop\yarn\server\nodemanager\containermanager\localizer\sharedcache\SharedCacheUploadService.java,76,19,0,4,0,23
hadoop-trunk\hadoop-trunk\hadoop-common-project\hadoop-common\src\main\java\org\apache\hadoop\service\launcher\ServiceShutdownHook.java,75,4,2,1,0,7
hadoop-trunk\hadoop-trunk\hadoop-hdfs-project\hadoop-hdfs\src\test\java\org\apache\hadoop\hdfs\server\blockmanagement\TestBlockTokenWithDFS.java,566,85,5,8,0,98
hadoop-trunk\hadoop-trunk\hadoop-yarn-project\hadoop-yarn\hadoop-yarn-server\hadoop-yarn-server-sharedcachemanager\src\main\java\org\apache\hadoop\yarn\server\sharedcachemanager\ClientProtocolService.java,139,24,1,6,0,31
hadoop-trunk\hadoop-trunk\hadoop-common-project\hadoop-common\src\main\java\org\apache\hadoop\fs\statistics\DurationTrackerFactory.java,0,0,0,2,0,2
hadoop-trunk\hadoop-trunk\hadoop-hdfs-project\hadoop-hdfs-client\src\main\java\org\apache\hadoop\hdfs\client\impl\BlockReaderFactory.java,798,129,40,7,0,176
hadoop-trunk\hadoop-trunk\hadoop-mapreduce-project\hadoop-mapreduce-client\hadoop-mapreduce-client-jobclient\src\test\java\org\apache\hadoop\mapred\TestComparators.java,442,226,38,1,0,265
hadoop-trunk\hadoop-trunk\hadoop-yarn-project\hadoop-yarn\hadoop-yarn-common\src\main\java\org\apache\hadoop\yarn\state\VisualizeStateMachine.java,51,17,5,4,0,26
hadoop-trunk\hadoop-trunk\hadoop-hdfs-project\hadoop-hdfs\src\test\java\org\apache\hadoop\hdfs\net\TestDFSNetworkTopologyPerformance.java,473,82,4,1,0,87
hadoop-trunk\hadoop-trunk\hadoop-mapreduce-project\hadoop-mapreduce-client\hadoop-mapreduce-client-common\src\test\java\org\apache\hadoop\mapred\TestMRWithDistributedCache.java,248,38,56,2,0,96
hadoop-trunk\hadoop-trunk\hadoop-tools\hadoop-azure\src\main\java\org\apache\hadoop\fs\azurebfs\security\AbfsTokenRenewer.java,64,6,1,1,0,8
hadoop-trunk\hadoop-trunk\hadoop-mapreduce-project\hadoop-mapreduce-client\hadoop-mapreduce-client-core\src\test\java\org\apache\hadoop\mapred\TestJobConf.java,393,122,28,3,0,153
hadoop-trunk\hadoop-trunk\hadoop-yarn-project\hadoop-yarn\hadoop-yarn-server\hadoop-yarn-server-resourcemanager\src\main\java\org\apache\hadoop\yarn\server\resourcemanager\scheduler\capacity\AppPriorityACLGroup.java,82,34,2,1,0,37
hadoop-trunk\hadoop-trunk\hadoop-hdfs-project\hadoop-hdfs\src\test\java\org\apache\hadoop\hdfs\server\datanode\TestDataSetLockManager.java,66,15,0,7,0,22
hadoop-trunk\hadoop-trunk\hadoop-hdfs-project\hadoop-hdfs-rbf\src\test\java\org\apache\hadoop\hdfs\server\federation\store\TestStateStoreMembershipState.java,547,39,4,17,0,60
hadoop-trunk\hadoop-trunk\hadoop-mapreduce-project\hadoop-mapreduce-client\hadoop-mapreduce-client-core\src\main\java\org\apache\hadoop\mapred\QueueConfigurationParser.java,0,66,10,3,0,79
hadoop-trunk\hadoop-trunk\hadoop-mapreduce-project\hadoop-mapreduce-client\hadoop-mapreduce-client-core\src\main\java\org\apache\hadoop\mapreduce\jobhistory\JobQueueChangeEvent.java,53,20,15,1,0,36
hadoop-trunk\hadoop-trunk\hadoop-hdfs-project\hadoop-hdfs-client\src\main\java\org\apache\hadoop\hdfs\DFSClient.java,0,889,89,18,0,996
hadoop-trunk\hadoop-trunk\hadoop-yarn-project\hadoop-yarn\hadoop-yarn-server\hadoop-yarn-server-nodemanager\src\main\java\org\apache\hadoop\yarn\server\nodemanager\containermanager\localizer\event\ApplicationLocalizationEvent.java,15,10,0,4,0,14
hadoop-trunk\hadoop-trunk\hadoop-mapreduce-project\hadoop-mapreduce-client\hadoop-mapreduce-client-app\src\main\java\org\apache\hadoop\mapreduce\v2\app\metrics\MRAppMetrics.java,154,101,9,1,0,111
hadoop-trunk\hadoop-trunk\hadoop-hdfs-project\hadoop-hdfs\src\main\java\org\apache\hadoop\hdfs\server\blockmanagement\HeartbeatManager.java,0,56,7,2,0,65
hadoop-trunk\hadoop-trunk\hadoop-tools\hadoop-rumen\src\main\java\org\apache\hadoop\tools\rumen\LoggedLocation.java,95,36,1,1,0,38
hadoop-trunk\hadoop-trunk\hadoop-common-project\hadoop-common\src\main\java\org\apache\hadoop\util\XMLUtils.java,29,14,1,3,0,18
hadoop-trunk\hadoop-trunk\hadoop-yarn-project\hadoop-yarn\hadoop-yarn-server\hadoop-yarn-server-resourcemanager\src\test\java\org\apache\hadoop\yarn\server\resourcemanager\scheduler\fair\TestVisitedResourceRequestTracker.java,81,26,10,2,0,38
hadoop-trunk\hadoop-trunk\hadoop-cloud-storage-project\hadoop-huaweicloud\src\main\java\org\apache\hadoop\fs\obs\package-info.java,0,0,0,1,0,1
hadoop-trunk\hadoop-trunk\hadoop-yarn-project\hadoop-yarn\hadoop-yarn-common\src\test\java\org\apache\hadoop\yarn\api\protocolrecords\impl\pb\TestGetApplicationsRequestPBImpl.java,39,7,5,2,0,14
hadoop-trunk\hadoop-trunk\hadoop-yarn-project\hadoop-yarn\hadoop-yarn-common\src\main\java\org\apache\hadoop\yarn\api\protocolrecords\impl\pb\ValidateVolumeCapabilitiesResponsePBImpl.java,0,15,20,2,0,37
hadoop-trunk\hadoop-trunk\hadoop-yarn-project\hadoop-yarn\hadoop-yarn-server\hadoop-yarn-server-nodemanager\src\test\java\org\apache\hadoop\yarn\server\nodemanager\containermanager\linux\resources\TestCGroupsCpuResourceHandlerImpl.java,281,30,5,4,0,39
hadoop-trunk\hadoop-trunk\hadoop-hdfs-project\hadoop-hdfs-client\src\main\java\org\apache\hadoop\hdfs\protocol\datatransfer\PacketReceiver.java,275,43,1,3,0,47
hadoop-trunk\hadoop-trunk\hadoop-tools\hadoop-azure\src\main\java\org\apache\hadoop\fs\azurebfs\contracts\diagnostics\package-info.java,0,2,0,1,0,3
hadoop-trunk\hadoop-trunk\hadoop-mapreduce-project\hadoop-mapreduce-client\hadoop-mapreduce-client-core\src\main\java\org\apache\hadoop\mapreduce\OutputFormat.java,0,15,0,1,0,16
hadoop-trunk\hadoop-trunk\hadoop-mapreduce-project\hadoop-mapreduce-client\hadoop-mapreduce-client-core\src\main\java\org\apache\hadoop\mapreduce\security\SpillCallBackInjector.java,53,26,0,1,0,27
hadoop-trunk\hadoop-trunk\hadoop-yarn-project\hadoop-yarn\hadoop-yarn-applications\hadoop-yarn-services\hadoop-yarn-services-core\src\main\java\org\apache\hadoop\yarn\service\utils\HttpUtil.java,74,7,2,1,0,10
hadoop-trunk\hadoop-trunk\hadoop-tools\hadoop-aws\src\main\java\org\apache\hadoop\fs\s3a\S3AEncryptionMethods.java,0,13,0,1,0,14
hadoop-trunk\hadoop-trunk\hadoop-common-project\hadoop-common\src\test\java\org\apache\hadoop\metrics2\sink\TestRollingFileSystemSinkWithLocal.java,0,1,0,1,0,2
hadoop-trunk\hadoop-trunk\hadoop-mapreduce-project\hadoop-mapreduce-client\hadoop-mapreduce-client-common\src\main\java\org\apache\hadoop\mapreduce\v2\api\records\Counter.java,0,19,6,1,0,26
hadoop-trunk\hadoop-trunk\hadoop-hdfs-project\hadoop-hdfs\src\main\java\org\apache\hadoop\hdfs\server\namenode\ha\HAState.java,0,24,5,4,0,33
hadoop-trunk\hadoop-trunk\hadoop-yarn-project\hadoop-yarn\hadoop-yarn-server\hadoop-yarn-server-resourcemanager\src\main\java\org\apache\hadoop\yarn\server\resourcemanager\recovery\package-info.java,0,1,0,1,0,2
hadoop-trunk\hadoop-trunk\hadoop-common-project\hadoop-common\src\main\java\org\apache\hadoop\security\alias\package-info.java,0,1,0,1,0,2
hadoop-trunk\hadoop-trunk\hadoop-common-project\hadoop-common\src\main\java\org\apache\hadoop\conf\StorageUnit.java,0,95,4,1,0,100
hadoop-trunk\hadoop-trunk\hadoop-yarn-project\hadoop-yarn\hadoop-yarn-common\src\main\java\org\apache\hadoop\yarn\webapp\view\RobotsTextPage.java,14,5,0,1,0,6
hadoop-trunk\hadoop-trunk\hadoop-mapreduce-project\hadoop-mapreduce-client\hadoop-mapreduce-client-core\src\main\java\org\apache\hadoop\mapreduce\lib\db\IntegerSplitter.java,97,14,0,3,0,17
hadoop-trunk\hadoop-trunk\hadoop-yarn-project\hadoop-yarn\hadoop-yarn-common\src\main\java\org\apache\hadoop\yarn\webapp\log\AggregatedLogsPage.java,30,6,0,2,0,8
hadoop-trunk\hadoop-trunk\hadoop-common-project\hadoop-common\src\main\java\org\apache\hadoop\fs\statistics\impl\IOStatisticsStoreBuilderImpl.java,68,5,0,2,0,7
hadoop-trunk\hadoop-trunk\hadoop-tools\hadoop-aws\src\main\java\org\apache\hadoop\fs\s3a\RenameFailedException.java,42,15,0,1,0,16
hadoop-trunk\hadoop-trunk\hadoop-mapreduce-project\hadoop-mapreduce-client\hadoop-mapreduce-client-core\src\main\java\org\apache\hadoop\mapred\FileAlreadyExistsException.java,0,5,0,1,0,6
hadoop-trunk\hadoop-trunk\hadoop-yarn-project\hadoop-yarn\hadoop-yarn-server\hadoop-yarn-server-common\src\test\java\org\apache\hadoop\yarn\server\federation\utils\FederationStateStoreTestUtil.java,136,46,0,13,0,59
hadoop-trunk\hadoop-trunk\hadoop-common-project\hadoop-common\src\test\java\org\apache\hadoop\io\file\tfile\TestTFileNoneCodecsStreams.java,11,0,0,1,0,1
hadoop-trunk\hadoop-trunk\hadoop-tools\hadoop-rumen\src\main\java\org\apache\hadoop\tools\rumen\datatypes\UserName.java,19,10,0,1,0,11
hadoop-trunk\hadoop-trunk\hadoop-hdfs-project\hadoop-hdfs\src\main\java\org\apache\hadoop\hdfs\server\datanode\web\webhdfs\ParameterParser.java,0,11,2,3,0,16
hadoop-trunk\hadoop-trunk\hadoop-hdfs-project\hadoop-hdfs\src\test\java\org\apache\hadoop\hdfs\server\namenode\ha\TestLossyRetryInvocationHandler.java,26,8,0,3,0,11
hadoop-trunk\hadoop-trunk\hadoop-hdfs-project\hadoop-hdfs\src\test\java\org\apache\hadoop\hdfs\server\datanode\fsdataset\impl\TestLazyPersistPolicy.java,59,8,8,1,0,17
hadoop-trunk\hadoop-trunk\hadoop-mapreduce-project\hadoop-mapreduce-client\hadoop-mapreduce-client-core\src\main\java\org\apache\hadoop\mapreduce\util\HostUtil.java,42,22,2,1,0,25
hadoop-trunk\hadoop-trunk\hadoop-yarn-project\hadoop-yarn\hadoop-yarn-server\hadoop-yarn-server-resourcemanager\src\main\java\org\apache\hadoop\yarn\server\resourcemanager\rmapp\monitor\RMAppLifetimeMonitor.java,0,27,2,1,0,30
hadoop-trunk\hadoop-trunk\hadoop-yarn-project\hadoop-yarn\hadoop-yarn-server\hadoop-yarn-server-common\src\main\java\org\apache\hadoop\yarn\server\api\protocolrecords\impl\pb\NodeHeartbeatRequestPBImpl.java,415,86,105,8,0,199
hadoop-trunk\hadoop-trunk\hadoop-common-project\hadoop-common\src\test\java\org\apache\hadoop\metrics2\filter\TestPatternFilter.java,216,66,7,6,0,79
hadoop-trunk\hadoop-trunk\hadoop-yarn-project\hadoop-yarn\hadoop-yarn-client\src\main\java\org\apache\hadoop\yarn\client\cli\NodeCLI.java,314,25,8,2,0,35
hadoop-trunk\hadoop-trunk\hadoop-common-project\hadoop-common\src\main\java\org\apache\hadoop\util\AutoCloseableLock.java,118,4,0,1,0,5
hadoop-trunk\hadoop-trunk\hadoop-mapreduce-project\hadoop-mapreduce-client\hadoop-mapreduce-client-hs\src\test\java\org\apache\hadoop\mapreduce\v2\hs\TestCompletedTask.java,59,49,4,1,0,54
hadoop-trunk\hadoop-trunk\hadoop-hdfs-project\hadoop-hdfs\src\test\java\org\apache\hadoop\hdfs\tools\TestViewFSStoragePolicyCommands.java,74,6,0,1,0,7
hadoop-trunk\hadoop-trunk\hadoop-yarn-project\hadoop-yarn\hadoop-yarn-api\src\main\java\org\apache\hadoop\yarn\api\records\ReservationRequest.java,175,34,8,1,0,43
hadoop-trunk\hadoop-trunk\hadoop-mapreduce-project\hadoop-mapreduce-client\hadoop-mapreduce-client-core\src\main\java\org\apache\hadoop\mapred\Master.java,32,8,1,1,0,10
hadoop-trunk\hadoop-trunk\hadoop-yarn-project\hadoop-yarn\hadoop-yarn-server\hadoop-yarn-server-common\src\main\java\org\apache\hadoop\yarn\server\federation\store\exception\package-info.java,0,1,0,1,0,2
hadoop-trunk\hadoop-trunk\hadoop-yarn-project\hadoop-yarn\hadoop-yarn-api\src\main\java\org\apache\hadoop\yarn\api\protocolrecords\StopContainersRequest.java,28,7,0,3,0,10
hadoop-trunk\hadoop-trunk\hadoop-yarn-project\hadoop-yarn\hadoop-yarn-api\src\main\java\org\apache\hadoop\yarn\api\protocolrecords\SignalContainerRequest.java,44,5,0,1,0,6
hadoop-trunk\hadoop-trunk\hadoop-hdfs-project\hadoop-hdfs\src\main\java\org\apache\hadoop\hdfs\server\namenode\FSDirWriteFileOp.java,0,272,12,3,0,287
hadoop-trunk\hadoop-trunk\hadoop-tools\hadoop-gridmix\src\test\java\org\apache\hadoop\mapred\gridmix\TestGridmixRecord.java,0,46,11,3,0,60
hadoop-trunk\hadoop-trunk\hadoop-yarn-project\hadoop-yarn\hadoop-yarn-server\hadoop-yarn-server-resourcemanager\src\main\java\org\apache\hadoop\yarn\server\resourcemanager\RMNMInfo.java,73,12,0,3,0,15
hadoop-trunk\hadoop-trunk\hadoop-common-project\hadoop-common\src\main\java\org\apache\hadoop\metrics2\lib\DefaultMetricsFactory.java,0,9,0,1,0,10
hadoop-trunk\hadoop-trunk\hadoop-hdfs-project\hadoop-hdfs\src\test\java\org\apache\hadoop\hdfs\TestLargeBlock.java,181,37,9,2,0,48
hadoop-trunk\hadoop-trunk\hadoop-yarn-project\hadoop-yarn\hadoop-yarn-server\hadoop-yarn-server-resourcemanager\src\main\java\org\apache\hadoop\yarn\server\resourcemanager\rmapp\attempt\RMAppAttemptEventType.java,0,18,0,1,0,19
hadoop-trunk\hadoop-trunk\hadoop-yarn-project\hadoop-yarn\hadoop-yarn-api\src\main\java\org\apache\hadoop\yarn\api\protocolrecords\GetQueueUserAclsInfoResponse.java,27,8,0,1,0,9
hadoop-trunk\hadoop-trunk\hadoop-common-project\hadoop-common\src\test\java\org\apache\hadoop\net\TestNetUtils.java,0,214,38,6,0,258
hadoop-trunk\hadoop-trunk\hadoop-common-project\hadoop-common\src\main\java\org\apache\hadoop\fs\viewfs\RegexMountPointInterceptor.java,0,5,0,1,0,6
hadoop-trunk\hadoop-trunk\hadoop-yarn-project\hadoop-yarn\hadoop-yarn-server\hadoop-yarn-server-resourcemanager\src\main\java\org\apache\hadoop\yarn\server\resourcemanager\federation\FederationStateStoreService.java,0,52,0,32,0,84
hadoop-trunk\hadoop-trunk\hadoop-yarn-project\hadoop-yarn\hadoop-yarn-server\hadoop-yarn-server-resourcemanager\src\main\java\org\apache\hadoop\yarn\server\resourcemanager\reservation\CapacityReservationSystem.java,0,18,2,3,0,23
hadoop-trunk\hadoop-trunk\hadoop-common-project\hadoop-kms\src\main\java\org\apache\hadoop\crypto\key\kms\server\KMSAuditLogger.java,0,28,1,1,0,30
hadoop-trunk\hadoop-trunk\hadoop-mapreduce-project\hadoop-mapreduce-client\hadoop-mapreduce-client-jobclient\src\test\java\org\apache\hadoop\mapred\TestMiniMRWithDFSWithDistinctUsers.java,113,52,12,2,0,66
hadoop-trunk\hadoop-trunk\hadoop-yarn-project\hadoop-yarn\hadoop-yarn-api\src\main\java\org\apache\hadoop\yarn\api\protocolrecords\ReservationUpdateResponse.java,12,4,1,1,0,6
hadoop-trunk\hadoop-trunk\hadoop-yarn-project\hadoop-yarn\hadoop-yarn-csi\src\main\java\org\apache\hadoop\yarn\csi\translator\ValidateVolumeCapabilitiesRequestProtoTranslator.java,0,10,14,4,0,28
hadoop-trunk\hadoop-trunk\hadoop-common-project\hadoop-common\src\main\java\org\apache\hadoop\io\compress\bzip2\Bzip2Decompressor.java,214,70,6,1,0,77
hadoop-trunk\hadoop-trunk\hadoop-yarn-project\hadoop-yarn\hadoop-yarn-api\src\main\java\org\apache\hadoop\yarn\api\records\ResourceUtilization.java,255,46,1,1,0,48
hadoop-trunk\hadoop-trunk\hadoop-hdfs-project\hadoop-hdfs\src\main\java\org\apache\hadoop\hdfs\server\blockmanagement\CombinedHostFileManager.java,187,32,2,2,0,36
hadoop-trunk\hadoop-trunk\hadoop-hdfs-project\hadoop-hdfs-nfs\src\main\java\org\apache\hadoop\hdfs\nfs\nfs3\OpenFileCtx.java,0,285,53,9,0,347
hadoop-trunk\hadoop-trunk\hadoop-yarn-project\hadoop-yarn\hadoop-yarn-server\hadoop-yarn-server-resourcemanager\src\test\java\org\apache\hadoop\yarn\server\resourcemanager\webapp\TestRMWebServiceAppsNodelabel.java,178,33,2,5,0,40
hadoop-trunk\hadoop-trunk\hadoop-common-project\hadoop-common\src\main\java\org\apache\hadoop\security\authorize\ImpersonationProvider.java,0,2,1,1,0,4
hadoop-trunk\hadoop-trunk\hadoop-yarn-project\hadoop-yarn\hadoop-yarn-server\hadoop-yarn-server-resourcemanager\src\main\java\org\apache\hadoop\yarn\server\resourcemanager\webapp\dao\CapacitySchedulerInfo.java,170,86,5,9,0,100
hadoop-trunk\hadoop-trunk\hadoop-yarn-project\hadoop-yarn\hadoop-yarn-server\hadoop-yarn-server-timelineservice-documentstore\src\main\java\org\apache\hadoop\yarn\server\timelineservice\documentstore\lib\DocumentStoreVendor.java,0,6,1,1,0,8
hadoop-trunk\hadoop-trunk\hadoop-yarn-project\hadoop-yarn\hadoop-yarn-server\hadoop-yarn-server-nodemanager\src\main\java\org\apache\hadoop\yarn\server\nodemanager\containermanager\linux\runtime\runc\RuncContainerExecutorConfig.java,1469,1013,5,3,0,1021
hadoop-trunk\hadoop-trunk\hadoop-yarn-project\hadoop-yarn\hadoop-yarn-server\hadoop-yarn-server-nodemanager\src\main\java\org\apache\hadoop\yarn\server\nodemanager\webapp\ContainerLogsUtils.java,140,53,4,14,0,71
hadoop-trunk\hadoop-trunk\hadoop-hdfs-project\hadoop-hdfs\src\main\java\org\apache\hadoop\hdfs\server\namenode\EditLogBackupInputStream.java,0,16,0,1,0,17
hadoop-trunk\hadoop-trunk\hadoop-common-project\hadoop-common\src\main\java\org\apache\hadoop\ipc\CostProvider.java,0,0,0,1,0,1
hadoop-trunk\hadoop-trunk\hadoop-tools\hadoop-fs2img\src\main\java\org\apache\hadoop\hdfs\server\namenode\TreePath.java,163,63,20,5,0,88
hadoop-trunk\hadoop-trunk\hadoop-tools\hadoop-azure\src\main\java\org\apache\hadoop\fs\azurebfs\contracts\services\ReadBufferStatus.java,0,6,0,2,0,8
hadoop-trunk\hadoop-trunk\hadoop-yarn-project\hadoop-yarn\hadoop-yarn-server\hadoop-yarn-server-applicationhistoryservice\src\test\java\org\apache\hadoop\yarn\server\timeline\recovery\TestLeveldbTimelineStateStore.java,171,17,7,4,0,28
hadoop-trunk\hadoop-trunk\hadoop-yarn-project\hadoop-yarn\hadoop-yarn-server\hadoop-yarn-server-resourcemanager\src\main\java\org\apache\hadoop\yarn\server\resourcemanager\volume\csi\lifecycle\VolumeImpl.java,168,27,5,8,0,40
hadoop-trunk\hadoop-trunk\hadoop-common-project\hadoop-common\src\main\java\org\apache\hadoop\fs\GetSpaceUsed.java,0,55,1,2,0,58
hadoop-trunk\hadoop-trunk\hadoop-common-project\hadoop-nfs\src\main\java\org\apache\hadoop\nfs\nfs3\request\SETATTR3Request.java,58,26,0,1,0,27
hadoop-trunk\hadoop-trunk\hadoop-hdfs-project\hadoop-hdfs-rbf\src\main\java\org\apache\hadoop\hdfs\server\federation\router\ConnectionContext.java,121,9,0,1,0,10
hadoop-trunk\hadoop-trunk\hadoop-common-project\hadoop-common\src\main\java\org\apache\hadoop\security\alias\BouncyCastleFipsKeyStoreProvider.java,0,8,0,1,0,9
hadoop-trunk\hadoop-trunk\hadoop-yarn-project\hadoop-yarn\hadoop-yarn-server\hadoop-yarn-server-resourcemanager\src\test\java\org\apache\hadoop\yarn\server\resourcemanager\webapp\TestRMWebServicesCapacitySched.java,329,79,0,21,0,100
hadoop-trunk\hadoop-trunk\hadoop-yarn-project\hadoop-yarn\hadoop-yarn-server\hadoop-yarn-server-common\src\main\java\org\apache\hadoop\yarn\server\federation\store\records\impl\pb\GetSubClusterPoliciesConfigurationsResponsePBImpl.java,0,19,42,6,0,67
hadoop-trunk\hadoop-trunk\hadoop-common-project\hadoop-common\src\main\java\org\apache\hadoop\fs\viewfs\RegexMountPointResolvedDstPathReplaceInterceptor.java,0,12,0,2,0,14
hadoop-trunk\hadoop-trunk\hadoop-hdfs-project\hadoop-hdfs\src\test\java\org\apache\hadoop\hdfs\server\namenode\TestSecureNameNode.java,127,10,6,4,0,20
hadoop-trunk\hadoop-trunk\hadoop-yarn-project\hadoop-yarn\hadoop-yarn-applications\hadoop-yarn-services\hadoop-yarn-services-core\src\main\java\org\apache\hadoop\yarn\service\monitor\probe\MonitorUtils.java,0,11,5,1,0,17
hadoop-trunk\hadoop-trunk\hadoop-mapreduce-project\hadoop-mapreduce-client\hadoop-mapreduce-client-jobclient\src\test\java\org\apache\hadoop\mapreduce\lib\input\TestCombineTextInputFormat.java,214,75,7,2,0,84
hadoop-trunk\hadoop-trunk\hadoop-yarn-project\hadoop-yarn\hadoop-yarn-common\src\main\java\org\apache\hadoop\yarn\util\resource\ResourceCalculator.java,280,56,0,1,0,57
hadoop-trunk\hadoop-trunk\hadoop-mapreduce-project\hadoop-mapreduce-examples\src\test\java\org\apache\hadoop\examples\terasort\TestTeraSort.java,87,21,0,1,0,22
hadoop-trunk\hadoop-trunk\hadoop-yarn-project\hadoop-yarn\hadoop-yarn-common\src\main\java\org\apache\hadoop\yarn\client\api\impl\DirectTimelineWriter.java,25,13,2,1,0,16
hadoop-trunk\hadoop-trunk\hadoop-yarn-project\hadoop-yarn\hadoop-yarn-common\src\test\java\org\apache\hadoop\yarn\webapp\MyTestJAXBContextResolver.java,21,8,4,1,0,13
hadoop-trunk\hadoop-trunk\hadoop-yarn-project\hadoop-yarn\hadoop-yarn-applications\hadoop-yarn-services\hadoop-yarn-services-core\src\test\java\org\apache\hadoop\yarn\service\component\TestComponentDecommissionInstances.java,98,21,2,1,0,24
hadoop-trunk\hadoop-trunk\hadoop-common-project\hadoop-common\src\main\java\org\apache\hadoop\crypto\key\UserProvider.java,143,28,0,2,0,30
hadoop-trunk\hadoop-trunk\hadoop-mapreduce-project\hadoop-mapreduce-client\hadoop-mapreduce-client-app\src\test\java\org\apache\hadoop\mapreduce\v2\app\TestRuntimeEstimators.java,854,157,5,19,0,181
hadoop-trunk\hadoop-trunk\hadoop-hdfs-project\hadoop-hdfs-client\src\main\java\org\apache\hadoop\hdfs\BlockReader.java,0,14,0,1,0,15
hadoop-trunk\hadoop-trunk\hadoop-hdfs-project\hadoop-hdfs-httpfs\src\main\java\org\apache\hadoop\lib\wsrs\ShortParam.java,24,13,0,1,0,14
hadoop-trunk\hadoop-trunk\hadoop-hdfs-project\hadoop-hdfs-client\src\main\java\org\apache\hadoop\hdfs\protocol\datatransfer\sasl\SaslDataTransferClient.java,543,112,5,8,0,125
hadoop-trunk\hadoop-trunk\hadoop-tools\hadoop-azure\src\main\java\org\apache\hadoop\fs\azure\security\RemoteWasbDelegationTokenManager.java,0,19,1,5,0,25
hadoop-trunk\hadoop-trunk\hadoop-yarn-project\hadoop-yarn\hadoop-yarn-server\hadoop-yarn-server-common\src\main\java\org\apache\hadoop\yarn\server\api\records\NodeStatus.java,95,27,0,1,0,28
hadoop-trunk\hadoop-trunk\hadoop-yarn-project\hadoop-yarn\hadoop-yarn-server\hadoop-yarn-server-resourcemanager\src\main\java\org\apache\hadoop\yarn\server\resourcemanager\webapp\RMContainerBlock.java,19,6,0,1,0,7
hadoop-trunk\hadoop-trunk\hadoop-yarn-project\hadoop-yarn\hadoop-yarn-common\src\main\java\org\apache\hadoop\yarn\api\protocolrecords\impl\pb\StartContainersResponsePBImpl.java,273,45,79,5,0,129
hadoop-trunk\hadoop-trunk\hadoop-yarn-project\hadoop-yarn\hadoop-yarn-server\hadoop-yarn-server-resourcemanager\src\test\java\org\apache\hadoop\yarn\server\resourcemanager\scheduler\capacity\TestCapacitySchedulerMultiNodesWithPreemption.java,218,25,6,10,0,41
hadoop-trunk\hadoop-trunk\hadoop-hdfs-project\hadoop-hdfs\src\test\java\org\apache\hadoop\hdfs\TestUnsetAndChangeDirectoryEcPolicy.java,347,26,5,2,0,33
hadoop-trunk\hadoop-trunk\hadoop-tools\hadoop-federation-balance\src\main\java\org\apache\hadoop\tools\fedbalance\package-info.java,0,1,0,1,0,2
hadoop-trunk\hadoop-trunk\hadoop-yarn-project\hadoop-yarn\hadoop-yarn-server\hadoop-yarn-server-resourcemanager\src\main\java\org\apache\hadoop\yarn\server\resourcemanager\webapp\dao\ExecutionTypeRequestInfo.java,31,17,1,1,0,19
hadoop-trunk\hadoop-trunk\hadoop-common-project\hadoop-common\src\test\java\org\apache\hadoop\util\TestWeakReferenceMap.java,166,11,0,1,0,12
hadoop-trunk\hadoop-trunk\hadoop-hdfs-project\hadoop-hdfs\src\main\java\org\apache\hadoop\hdfs\server\common\StorageErrorReporter.java,0,3,1,1,0,5
hadoop-trunk\hadoop-trunk\hadoop-common-project\hadoop-common\src\main\java\org\apache\hadoop\fs\FileContext.java,2815,388,17,12,0,417
hadoop-trunk\hadoop-trunk\hadoop-yarn-project\hadoop-yarn\hadoop-yarn-server\hadoop-yarn-server-resourcemanager\src\main\java\org\apache\hadoop\yarn\server\resourcemanager\rmapp\attempt\AggregateAppResourceUsage.java,29,7,0,1,0,8
hadoop-trunk\hadoop-trunk\hadoop-tools\hadoop-aws\src\test\java\org\apache\hadoop\fs\s3a\impl\ITestXAttrCost.java,169,8,0,6,0,14
hadoop-trunk\hadoop-trunk\hadoop-yarn-project\hadoop-yarn\hadoop-yarn-server\hadoop-yarn-server-resourcemanager\src\test\java\org\apache\hadoop\yarn\server\resourcemanager\MockMemoryRMStateStore.java,98,16,0,3,0,19
hadoop-trunk\hadoop-trunk\hadoop-hdfs-project\hadoop-hdfs\src\test\java\org\apache\hadoop\hdfs\DFSClientAdapter.java,40,27,1,3,0,31
hadoop-trunk\hadoop-trunk\hadoop-hdfs-project\hadoop-hdfs\src\test\java\org\apache\hadoop\hdfs\server\blockmanagement\TestBlocksWithNotEnoughRacks.java,612,95,11,2,0,108
hadoop-trunk\hadoop-trunk\hadoop-yarn-project\hadoop-yarn\hadoop-yarn-api\src\main\java\org\apache\hadoop\yarn\exceptions\SchedulerInvalidResoureRequestException.java,17,8,0,2,0,10
hadoop-trunk\hadoop-trunk\hadoop-tools\hadoop-dynamometer\hadoop-dynamometer-workload\src\main\java\org\apache\hadoop\tools\dynamometer\workloadgenerator\audit\AuditReplayReducer.java,0,4,0,1,0,5
hadoop-trunk\hadoop-trunk\hadoop-mapreduce-project\hadoop-mapreduce-client\hadoop-mapreduce-client-core\src\test\java\org\apache\hadoop\mapreduce\lib\output\committer\manifest\TestCommitTaskStage.java,86,4,2,11,0,17
hadoop-trunk\hadoop-trunk\hadoop-mapreduce-project\hadoop-mapreduce-client\hadoop-mapreduce-client-app\src\main\java\org\apache\hadoop\mapreduce\v2\app\webapp\dao\BlacklistedNodesInfo.java,14,9,1,1,0,11
hadoop-trunk\hadoop-trunk\hadoop-common-project\hadoop-common\src\main\java\org\apache\hadoop\io\erasurecode\codec\XORErasureCodec.java,18,6,1,1,0,8
hadoop-trunk\hadoop-trunk\hadoop-mapreduce-project\hadoop-mapreduce-client\hadoop-mapreduce-client-jobclient\src\test\java\org\apache\hadoop\fs\slive\ConfigMerger.java,0,51,7,8,0,66
hadoop-trunk\hadoop-trunk\hadoop-yarn-project\hadoop-yarn\hadoop-yarn-client\src\test\java\org\apache\hadoop\yarn\client\api\impl\TestAMRMClientOnRMRestart.java,618,126,13,10,0,149
hadoop-trunk\hadoop-trunk\hadoop-common-project\hadoop-common\src\test\java\org\apache\hadoop\io\serializer\SerializationTestUtil.java,34,10,1,1,0,12
hadoop-trunk\hadoop-trunk\hadoop-hdfs-project\hadoop-hdfs-client\src\main\java\org\apache\hadoop\hdfs\server\namenode\RetryStartFileException.java,13,4,0,1,0,5
hadoop-trunk\hadoop-trunk\hadoop-tools\hadoop-aws\src\main\java\org\apache\hadoop\fs\s3a\auth\AssumedRoleCredentialProvider.java,192,19,1,3,0,23
hadoop-trunk\hadoop-trunk\hadoop-hdfs-project\hadoop-hdfs\src\test\java\org\apache\hadoop\security\TestPermission.java,410,121,48,3,0,172
hadoop-trunk\hadoop-trunk\hadoop-hdfs-project\hadoop-hdfs\src\test\java\org\apache\hadoop\hdfs\server\balancer\TestBalancerWithNodeGroup.java,375,109,3,14,0,126
hadoop-trunk\hadoop-trunk\hadoop-yarn-project\hadoop-yarn\hadoop-yarn-server\hadoop-yarn-server-common\src\main\java\org\apache\hadoop\yarn\server\federation\store\records\GetSubClustersInfoRequest.java,36,2,0,1,0,3
hadoop-trunk\hadoop-trunk\hadoop-hdfs-project\hadoop-hdfs-client\src\main\java\org\apache\hadoop\hdfs\net\EncryptedPeer.java,110,24,0,1,0,25
hadoop-trunk\hadoop-trunk\hadoop-common-project\hadoop-common\src\main\java\org\apache\hadoop\ha\ZKFCRpcServer.java,65,19,2,1,0,22
hadoop-trunk\hadoop-trunk\hadoop-common-project\hadoop-common\src\test\java\org\apache\hadoop\util\bloom\BloomFilterCommonTester.java,496,123,31,7,0,161
hadoop-trunk\hadoop-trunk\hadoop-mapreduce-project\hadoop-mapreduce-client\hadoop-mapreduce-client-nativetask\src\main\java\org\apache\hadoop\mapred\nativetask\Platforms.java,43,15,3,2,0,20
hadoop-trunk\hadoop-trunk\hadoop-yarn-project\hadoop-yarn\hadoop-yarn-api\src\main\java\org\apache\hadoop\yarn\api\records\YarnApplicationAttemptState.java,0,5,0,1,0,6
hadoop-trunk\hadoop-trunk\hadoop-mapreduce-project\hadoop-mapreduce-client\hadoop-mapreduce-client-core\src\main\java\org\apache\hadoop\mapred\pipes\PipesMapRunner.java,0,23,8,1,0,32
hadoop-trunk\hadoop-trunk\hadoop-yarn-project\hadoop-yarn\hadoop-yarn-common\src\main\java\org\apache\hadoop\yarn\ContainerRollingLogAppender.java,0,15,0,1,0,16
hadoop-trunk\hadoop-trunk\hadoop-yarn-project\hadoop-yarn\hadoop-yarn-server\hadoop-yarn-server-timelineservice\src\main\java\org\apache\hadoop\yarn\server\timelineservice\reader\filter\TimelineCompareFilter.java,119,42,1,1,0,44
hadoop-trunk\hadoop-trunk\hadoop-yarn-project\hadoop-yarn\hadoop-yarn-server\hadoop-yarn-server-timelineservice-hbase\hadoop-yarn-server-timelineservice-hbase-client\src\main\java\org\apache\hadoop\yarn\server\timelineservice\storage\reader\SubApplicationEntityReader.java,0,24,1,17,0,42
hadoop-trunk\hadoop-trunk\hadoop-mapreduce-project\hadoop-mapreduce-client\hadoop-mapreduce-client-common\src\main\java\org\apache\hadoop\mapreduce\v2\api\protocolrecords\GetTaskAttemptCompletionEventsRequest.java,0,19,6,1,0,26
hadoop-trunk\hadoop-trunk\hadoop-hdfs-project\hadoop-hdfs\src\main\java\org\apache\hadoop\hdfs\protocol\datatransfer\sasl\InvalidMagicNumberException.java,27,8,0,2,0,10
hadoop-trunk\hadoop-trunk\hadoop-common-project\hadoop-common\src\main\java\org\apache\hadoop\metrics2\lib\MutableGaugeLong.java,66,18,0,1,0,19
hadoop-trunk\hadoop-trunk\hadoop-tools\hadoop-aws\src\test\java\org\apache\hadoop\fs\s3a\commit\ITestS3ACommitterFactory.java,154,12,7,1,0,20
hadoop-trunk\hadoop-trunk\hadoop-hdfs-project\hadoop-hdfs\src\test\java\org\apache\hadoop\hdfs\server\aliasmap\TestSecureAliasMap.java,99,13,4,1,0,18
hadoop-trunk\hadoop-trunk\hadoop-common-project\hadoop-common\src\test\java\org\apache\hadoop\net\TestScriptBasedMappingWithDependency.java,60,11,3,1,0,15
hadoop-trunk\hadoop-trunk\hadoop-tools\hadoop-azure\src\main\java\org\apache\hadoop\fs\azurebfs\services\ShellDecryptionKeyProvider.java,37,9,2,5,0,16
hadoop-trunk\hadoop-trunk\hadoop-tools\hadoop-sls\src\main\java\org\apache\hadoop\yarn\sls\AMDefinitionFactory.java,0,21,1,1,0,23
hadoop-trunk\hadoop-trunk\hadoop-yarn-project\hadoop-yarn\hadoop-yarn-server\hadoop-yarn-server-resourcemanager\src\test\java\org\apache\hadoop\yarn\server\resourcemanager\TestWorkPreservingRMRestart.java,1776,327,65,50,0,442
hadoop-trunk\hadoop-trunk\hadoop-hdfs-project\hadoop-hdfs\src\test\java\org\apache\hadoop\hdfs\TestFileCreation.java,1344,233,31,32,0,296
hadoop-trunk\hadoop-trunk\hadoop-hdfs-project\hadoop-hdfs\src\main\java\org\apache\hadoop\hdfs\qjournal\server\JournaledEditsCache.java,0,42,9,1,0,52
hadoop-trunk\hadoop-trunk\hadoop-mapreduce-project\hadoop-mapreduce-client\hadoop-mapreduce-client-jobclient\src\test\java\org\apache\hadoop\mapreduce\v2\TestSpeculativeExecution.java,366,91,17,7,0,115
hadoop-trunk\hadoop-trunk\hadoop-mapreduce-project\hadoop-mapreduce-client\hadoop-mapreduce-client-common\src\main\java\org\apache\hadoop\mapreduce\v2\api\protocolrecords\KillJobResponse.java,0,0,0,1,0,1
hadoop-trunk\hadoop-trunk\hadoop-yarn-project\hadoop-yarn\hadoop-yarn-common\src\main\java\org\apache\hadoop\yarn\logaggregation\LogCLIHelpers.java,398,69,3,3,0,75
hadoop-trunk\hadoop-trunk\hadoop-yarn-project\hadoop-yarn\hadoop-yarn-server\hadoop-yarn-server-resourcemanager\src\main\java\org\apache\hadoop\yarn\server\resourcemanager\webapp\dao\UserMetricsInfo.java,119,67,3,2,0,72
hadoop-trunk\hadoop-trunk\hadoop-yarn-project\hadoop-yarn\hadoop-yarn-server\hadoop-yarn-server-common\src\main\java\org\apache\hadoop\yarn\server\uam\UnmanagedAMPoolManager.java,389,57,6,5,0,68
hadoop-trunk\hadoop-trunk\hadoop-common-project\hadoop-common\src\test\java\org\apache\hadoop\security\TestUserFromEnv.java,10,3,0,1,0,4
hadoop-trunk\hadoop-trunk\hadoop-hdfs-project\hadoop-hdfs-rbf\src\main\java\org\apache\hadoop\hdfs\server\federation\router\RouterRpcClient.java,1520,98,26,12,0,136
hadoop-trunk\hadoop-trunk\hadoop-yarn-project\hadoop-yarn\hadoop-yarn-server\hadoop-yarn-server-common\src\main\java\org\apache\hadoop\yarn\server\federation\policies\ConfigurableFederationPolicy.java,0,0,0,2,0,2
hadoop-trunk\hadoop-trunk\hadoop-common-project\hadoop-nfs\src\test\java\org\apache\hadoop\oncrpc\TestRpcReply.java,27,9,0,1,0,10
hadoop-trunk\hadoop-trunk\hadoop-mapreduce-project\hadoop-mapreduce-client\hadoop-mapreduce-client-core\src\test\java\org\apache\hadoop\mapred\TestTask.java,55,11,0,1,0,12
hadoop-trunk\hadoop-trunk\hadoop-yarn-project\hadoop-yarn\hadoop-yarn-api\src\main\java\org\apache\hadoop\yarn\api\protocolrecords\ResourceLocalizationRequest.java,51,3,0,1,0,4
hadoop-trunk\hadoop-trunk\hadoop-yarn-project\hadoop-yarn\hadoop-yarn-server\hadoop-yarn-server-resourcemanager\src\main\java\org\apache\hadoop\yarn\server\resourcemanager\security\RMDelegationTokenSecretManager.java,173,33,5,3,0,41
hadoop-trunk\hadoop-trunk\hadoop-yarn-project\hadoop-yarn\hadoop-yarn-server\hadoop-yarn-server-resourcemanager\src\main\java\org\apache\hadoop\yarn\server\resourcemanager\scheduler\constraint\processor\package-info.java,0,0,0,2,0,2
hadoop-trunk\hadoop-trunk\hadoop-hdfs-project\hadoop-hdfs\src\main\java\org\apache\hadoop\hdfs\util\ReferenceCountMap.java,0,23,4,1,0,28
hadoop-trunk\hadoop-trunk\hadoop-yarn-project\hadoop-yarn\hadoop-yarn-common\src\main\java\org\apache\hadoop\yarn\client\ServerProxy.java,61,9,2,1,0,12
hadoop-trunk\hadoop-trunk\hadoop-hdfs-project\hadoop-hdfs\src\main\java\org\apache\hadoop\hdfs\server\blockmanagement\LocatedBlockBuilder.java,0,29,1,1,0,31
hadoop-trunk\hadoop-trunk\hadoop-yarn-project\hadoop-yarn\hadoop-yarn-server\hadoop-yarn-server-common\src\main\java\org\apache\hadoop\yarn\server\sharedcache\SharedCacheUtil.java,58,12,1,2,0,15
hadoop-trunk\hadoop-trunk\hadoop-common-project\hadoop-common\src\main\java\org\apache\hadoop\io\erasurecode\rawcoder\package-info.java,0,2,0,1,0,3
hadoop-trunk\hadoop-trunk\hadoop-hdfs-project\hadoop-hdfs\src\main\java\org\apache\hadoop\hdfs\server\datanode\fsdataset\impl\ReservedSpaceCalculator.java,192,60,1,6,0,67
hadoop-trunk\hadoop-trunk\hadoop-yarn-project\hadoop-yarn\hadoop-yarn-applications\hadoop-yarn-services\hadoop-yarn-services-core\src\test\java\org\apache\hadoop\yarn\service\providers\TestDefaultClientProvider.java,35,3,0,2,0,5
hadoop-trunk\hadoop-trunk\hadoop-hdfs-project\hadoop-hdfs\src\test\java\org\apache\hadoop\hdfs\TestParallelShortCircuitReadNoChecksum.java,31,10,2,3,0,15
hadoop-trunk\hadoop-trunk\hadoop-hdfs-project\hadoop-hdfs\src\main\java\org\apache\hadoop\hdfs\server\blockmanagement\BlockIdManager.java,290,67,0,2,0,69
hadoop-trunk\hadoop-trunk\hadoop-hdfs-project\hadoop-hdfs\src\main\java\org\apache\hadoop\hdfs\server\namenode\startupprogress\Status.java,0,2,0,1,0,3
hadoop-trunk\hadoop-trunk\hadoop-hdfs-project\hadoop-hdfs\src\main\java\org\apache\hadoop\hdfs\server\protocol\FencedException.java,8,3,0,1,0,4
hadoop-trunk\hadoop-trunk\hadoop-yarn-project\hadoop-yarn\hadoop-yarn-api\src\main\java\org\apache\hadoop\yarn\api\records\LocalResource.java,171,55,0,3,0,58
hadoop-trunk\hadoop-trunk\hadoop-yarn-project\hadoop-yarn\hadoop-yarn-server\hadoop-yarn-server-resourcemanager\src\main\java\org\apache\hadoop\yarn\server\resourcemanager\scheduler\fair\converter\FSConfigToCSConfigArgumentHandler.java,387,96,1,3,0,100
hadoop-trunk\hadoop-trunk\hadoop-yarn-project\hadoop-yarn\hadoop-yarn-client\src\test\java\org\apache\hadoop\yarn\client\api\impl\TestOpportunisticContainerAllocationE2E.java,692,88,14,2,0,104
hadoop-trunk\hadoop-trunk\hadoop-yarn-project\hadoop-yarn\hadoop-yarn-server\hadoop-yarn-server-nodemanager\src\test\java\org\apache\hadoop\yarn\server\nodemanager\containermanager\linux\resources\gpu\TestGpuResourceHandlerImpl.java,509,91,2,16,0,109
hadoop-trunk\hadoop-trunk\hadoop-hdfs-project\hadoop-hdfs-rbf\src\main\java\org\apache\hadoop\hdfs\server\federation\resolver\order\package-info.java,0,1,0,1,0,2
hadoop-trunk\hadoop-trunk\hadoop-hdfs-project\hadoop-hdfs-rbf\src\main\java\org\apache\hadoop\hdfs\server\federation\store\driver\StateStoreDriver.java,167,5,2,2,0,9
hadoop-trunk\hadoop-trunk\hadoop-mapreduce-project\hadoop-mapreduce-client\hadoop-mapreduce-client-core\src\test\java\org\apache\hadoop\mapreduce\lib\output\committer\manifest\package-info.java,0,1,1,1,0,3
hadoop-trunk\hadoop-trunk\hadoop-cloud-storage-project\hadoop-cos\src\test\java\org\apache\hadoop\fs\cosn\contract\TestCosNContractRename.java,7,2,0,1,0,3
hadoop-trunk\hadoop-trunk\hadoop-hdfs-project\hadoop-hdfs\src\test\java\org\apache\hadoop\hdfs\server\namenode\TestSecureNameNodeWithExternalKdc.java,74,9,2,3,0,14
hadoop-trunk\hadoop-trunk\hadoop-tools\hadoop-azure\src\main\java\org\apache\hadoop\fs\azurebfs\AzureBlobFileSystemStore.java,0,338,48,168,0,554
hadoop-trunk\hadoop-trunk\hadoop-hdfs-project\hadoop-hdfs\src\main\java\org\apache\hadoop\hdfs\server\namenode\Content.java,0,0,0,1,0,1
hadoop-trunk\hadoop-trunk\hadoop-hdfs-project\hadoop-hdfs-rbf\src\test\java\org\apache\hadoop\hdfs\server\federation\store\TestStateStoreDisabledNameservice.java,38,4,0,3,0,7
hadoop-trunk\hadoop-trunk\hadoop-tools\hadoop-azure\src\main\java\org\apache\hadoop\fs\azure\security\SpnegoToken.java,25,13,1,2,0,16
hadoop-trunk\hadoop-trunk\hadoop-yarn-project\hadoop-yarn\hadoop-yarn-server\hadoop-yarn-server-resourcemanager\src\main\java\org\apache\hadoop\yarn\server\resourcemanager\recovery\RMStateStoreProxyCAEvent.java,24,14,0,1,0,15
hadoop-trunk\hadoop-trunk\hadoop-common-project\hadoop-registry\src\main\java\org\apache\hadoop\registry\server\dns\RegistryDNS.java,1660,188,36,1,0,225
hadoop-trunk\hadoop-trunk\hadoop-common-project\hadoop-common\src\main\java\org\apache\hadoop\tracing\TraceUtils.java,21,9,1,1,0,11
hadoop-trunk\hadoop-trunk\hadoop-common-project\hadoop-common\src\main\java\org\apache\hadoop\util\PureJavaCrc32.java,587,606,4,12,0,622
hadoop-trunk\hadoop-trunk\hadoop-yarn-project\hadoop-yarn\hadoop-yarn-common\src\main\java\org\apache\hadoop\yarn\api\records\impl\pb\NMTokenPBImpl.java,111,42,40,1,0,83
hadoop-trunk\hadoop-trunk\hadoop-common-project\hadoop-common\src\main\java\org\apache\hadoop\fs\permission\AclStatus.java,243,45,2,2,0,49
hadoop-trunk\hadoop-trunk\hadoop-tools\hadoop-azure\src\test\java\org\apache\hadoop\fs\azure\ITestBlockBlobInputStream.java,874,103,35,6,0,144
hadoop-trunk\hadoop-trunk\hadoop-mapreduce-project\hadoop-mapreduce-client\hadoop-mapreduce-client-core\src\main\java\org\apache\hadoop\mapreduce\lib\input\CombineFileInputFormat.java,0,192,22,8,0,222
hadoop-trunk\hadoop-trunk\hadoop-mapreduce-project\hadoop-mapreduce-client\hadoop-mapreduce-client-hs\src\test\java\org\apache\hadoop\mapreduce\v2\hs\TestJobIdHistoryFileInfoMap.java,47,8,2,2,0,12
hadoop-trunk\hadoop-trunk\hadoop-hdfs-project\hadoop-hdfs\src\test\java\org\apache\hadoop\hdfs\server\namenode\TestReencryptionHandler.java,152,21,30,2,0,53
hadoop-trunk\hadoop-trunk\hadoop-mapreduce-project\hadoop-mapreduce-client\hadoop-mapreduce-client-common\src\main\java\org\apache\hadoop\mapreduce\v2\api\HSClientProtocolPB.java,0,3,1,3,0,7
hadoop-trunk\hadoop-trunk\hadoop-yarn-project\hadoop-yarn\hadoop-yarn-server\hadoop-yarn-server-resourcemanager\src\main\java\org\apache\hadoop\yarn\server\resourcemanager\monitor\capacity\IntraQueueCandidatesSelector.java,276,37,4,9,0,50
hadoop-trunk\hadoop-trunk\hadoop-common-project\hadoop-common\src\test\java\org\apache\hadoop\fs\contract\localfs\TestLocalFSContractDelete.java,9,2,0,1,0,3
hadoop-trunk\hadoop-trunk\hadoop-hdfs-project\hadoop-hdfs\src\main\java\org\apache\hadoop\hdfs\server\datanode\web\DatanodeHttpServer.java,343,39,17,5,0,61
hadoop-trunk\hadoop-trunk\hadoop-hdfs-project\hadoop-hdfs\src\test\java\org\apache\hadoop\hdfs\server\blockmanagement\TestReplicationPolicyWithNodeGroup.java,889,365,22,25,0,412
hadoop-trunk\hadoop-trunk\hadoop-tools\hadoop-gridmix\src\test\java\org\apache\hadoop\mapred\gridmix\TestGridMixClasses.java,904,230,23,16,0,269
hadoop-trunk\hadoop-trunk\hadoop-yarn-project\hadoop-yarn\hadoop-yarn-server\hadoop-yarn-server-resourcemanager\src\test\java\org\apache\hadoop\yarn\server\resourcemanager\NodeAttributeTestUtils.java,0,2,0,1,0,3
hadoop-trunk\hadoop-trunk\hadoop-common-project\hadoop-common\src\test\java\org\apache\hadoop\io\TestBooleanWritable.java,54,30,5,10,0,45
hadoop-trunk\hadoop-trunk\hadoop-common-project\hadoop-common\src\test\java\org\apache\hadoop\util\TestFileBasedIPList.java,190,33,27,1,0,61
hadoop-trunk\hadoop-trunk\hadoop-hdfs-project\hadoop-hdfs-rbf\src\main\java\org\apache\hadoop\hdfs\server\federation\router\RouterNamenodeProtocol.java,143,28,0,1,0,29
hadoop-trunk\hadoop-trunk\hadoop-mapreduce-project\hadoop-mapreduce-client\hadoop-mapreduce-client-core\src\main\java\org\apache\hadoop\mapred\lib\FilterOutputFormat.java,0,47,0,1,0,48
hadoop-trunk\hadoop-trunk\hadoop-hdfs-project\hadoop-hdfs-client\src\main\java\org\apache\hadoop\hdfs\shortcircuit\ShortCircuitCache.java,982,111,33,6,0,150
hadoop-trunk\hadoop-trunk\hadoop-yarn-project\hadoop-yarn\hadoop-yarn-server\hadoop-yarn-server-timelineservice-hbase\hadoop-yarn-server-timelineservice-hbase-server\hadoop-yarn-server-timelineservice-hbase-server-2\src\main\java\org\apache\hadoop\yarn\server\timelineservice\storage\flow\FlowScanner.java,0,64,23,6,0,93
hadoop-trunk\hadoop-trunk\hadoop-yarn-project\hadoop-yarn\hadoop-yarn-api\src\main\java\org\apache\hadoop\yarn\api\protocolrecords\ReservationDeleteResponse.java,12,4,1,1,0,6
hadoop-trunk\hadoop-trunk\hadoop-yarn-project\hadoop-yarn\hadoop-yarn-server\hadoop-yarn-server-timelineservice\src\main\java\org\apache\hadoop\yarn\server\timelineservice\reader\package-info.java,0,1,0,1,0,2
hadoop-trunk\hadoop-trunk\hadoop-mapreduce-project\hadoop-mapreduce-client\hadoop-mapreduce-client-core\src\main\java\org\apache\hadoop\mapred\join\ComposableInputFormat.java,0,5,1,1,0,7
hadoop-trunk\hadoop-trunk\hadoop-common-project\hadoop-common\src\main\java\org\apache\hadoop\io\compress\zlib\BuiltInGzipDecompressor.java,0,106,16,2,0,124
hadoop-trunk\hadoop-trunk\hadoop-mapreduce-project\hadoop-mapreduce-client\hadoop-mapreduce-client-jobclient\src\test\java\org\apache\hadoop\mapred\TestMultipleTextOutputFormat.java,122,74,10,12,0,96
hadoop-trunk\hadoop-trunk\hadoop-mapreduce-project\hadoop-mapreduce-client\hadoop-mapreduce-client-hs\src\main\java\org\apache\hadoop\mapreduce\v2\hs\webapp\HsSingleCounterPage.java,0,8,1,2,0,11
hadoop-trunk\hadoop-trunk\hadoop-yarn-project\hadoop-yarn\hadoop-yarn-common\src\main\java\org\apache\hadoop\yarn\webapp\view\JQueryUI.java,0,71,0,3,0,74
hadoop-trunk\hadoop-trunk\hadoop-yarn-project\hadoop-yarn\hadoop-yarn-server\hadoop-yarn-server-common\src\main\java\org\apache\hadoop\yarn\server\scheduler\OpportunisticContainerContext.java,160,35,8,5,0,48
hadoop-trunk\hadoop-trunk\hadoop-yarn-project\hadoop-yarn\hadoop-yarn-server\hadoop-yarn-server-resourcemanager\src\test\java\org\apache\hadoop\yarn\server\resourcemanager\scheduler\capacity\CapacitySchedulerTestUtilities.java,0,57,0,20,0,77
hadoop-trunk\hadoop-trunk\hadoop-hdfs-project\hadoop-hdfs\src\test\java\org\apache\hadoop\hdfs\security\token\block\SecurityTestUtil.java,21,10,1,1,0,12
hadoop-trunk\hadoop-trunk\hadoop-yarn-project\hadoop-yarn\hadoop-yarn-server\hadoop-yarn-server-resourcemanager\src\test\java\org\apache\hadoop\yarn\server\resourcemanager\scheduler\capacity\TestApplicationLimitsByPartition.java,954,119,61,14,0,194
hadoop-trunk\hadoop-trunk\hadoop-mapreduce-project\hadoop-mapreduce-client\hadoop-mapreduce-client-common\src\main\java\org\apache\hadoop\mapreduce\v2\api\protocolrecords\GetTaskAttemptCompletionEventsResponse.java,0,24,7,2,0,33
hadoop-trunk\hadoop-trunk\hadoop-tools\hadoop-resourceestimator\src\test\java\org\apache\hadoop\resourceestimator\solver\impl\TestSolver.java,32,5,0,4,0,9
hadoop-trunk\hadoop-trunk\hadoop-yarn-project\hadoop-yarn\hadoop-yarn-server\hadoop-yarn-server-common\src\test\java\org\apache\hadoop\yarn\TestRPC.java,413,60,3,9,0,72
hadoop-trunk\hadoop-trunk\hadoop-mapreduce-project\hadoop-mapreduce-client\hadoop-mapreduce-client-common\src\test\java\org\apache\hadoop\mapreduce\v2\TestRecordFactory.java,25,7,0,4,0,11
hadoop-trunk\hadoop-trunk\hadoop-yarn-project\hadoop-yarn\hadoop-yarn-server\hadoop-yarn-server-nodemanager\src\main\java\org\apache\hadoop\yarn\server\nodemanager\CMgrCompletedContainersEvent.java,40,13,0,1,0,14
hadoop-trunk\hadoop-trunk\hadoop-hdfs-project\hadoop-hdfs\src\test\java\org\apache\hadoop\hdfs\server\blockmanagement\TestCachedBlocksList.java,121,46,7,4,0,57
hadoop-trunk\hadoop-trunk\hadoop-yarn-project\hadoop-yarn\hadoop-yarn-server\hadoop-yarn-server-nodemanager\src\main\java\org\apache\hadoop\yarn\server\nodemanager\containermanager\resourceplugin\com\nvidia\package-info.java,0,1,0,2,0,3
hadoop-trunk\hadoop-trunk\hadoop-common-project\hadoop-common\src\main\java\org\apache\hadoop\fs\shell\Count.java,216,68,1,1,0,70
hadoop-trunk\hadoop-trunk\hadoop-hdfs-project\hadoop-hdfs-client\src\main\java\org\apache\hadoop\hdfs\protocol\CacheDirectiveStats.java,139,31,2,1,0,34
hadoop-trunk\hadoop-trunk\hadoop-tools\hadoop-azure\src\main\java\org\apache\hadoop\fs\azurebfs\services\ReadBufferWorker.java,0,8,0,5,0,13
hadoop-trunk\hadoop-trunk\hadoop-tools\hadoop-aws\src\main\java\org\apache\hadoop\fs\s3a\impl\OperationCallbacks.java,0,3,0,1,0,4
hadoop-trunk\hadoop-trunk\hadoop-common-project\hadoop-nfs\src\main\java\org\apache\hadoop\nfs\NfsFileType.java,0,14,0,1,0,15
hadoop-trunk\hadoop-trunk\hadoop-tools\hadoop-azure\src\test\java\org\apache\hadoop\fs\azurebfs\ITestFileSystemInitialization.java,45,7,0,4,0,11
hadoop-trunk\hadoop-trunk\hadoop-yarn-project\hadoop-yarn\hadoop-yarn-server\hadoop-yarn-server-common\src\test\java\org\apache\hadoop\yarn\server\federation\policies\manager\BasePolicyManagerTest.java,69,17,8,7,0,32
hadoop-trunk\hadoop-trunk\hadoop-hdfs-project\hadoop-hdfs-rbf\src\test\java\org\apache\hadoop\hdfs\server\federation\StateStoreDFSCluster.java,128,32,0,6,0,38
hadoop-trunk\hadoop-trunk\hadoop-yarn-project\hadoop-yarn\hadoop-yarn-common\src\test\java\org\apache\hadoop\yarn\api\records\impl\pb\TestSerializedExceptionPBImpl.java,64,5,6,1,0,12
hadoop-trunk\hadoop-trunk\hadoop-mapreduce-project\hadoop-mapreduce-client\hadoop-mapreduce-client-nativetask\src\main\java\org\apache\hadoop\mapred\nativetask\handlers\BufferPuller.java,0,41,2,3,0,46
hadoop-trunk\hadoop-trunk\hadoop-common-project\hadoop-auth\src\main\java\org\apache\hadoop\security\authentication\server\AltKerberosAuthenticationHandler.java,0,9,0,1,0,10
hadoop-trunk\hadoop-trunk\hadoop-hdfs-project\hadoop-hdfs-client\src\main\java\org\apache\hadoop\hdfs\protocol\datatransfer\ReplaceDatanodeOnFailure.java,158,48,0,6,0,54
hadoop-trunk\hadoop-trunk\hadoop-mapreduce-project\hadoop-mapreduce-client\hadoop-mapreduce-client-app\src\test\java\org\apache\hadoop\mapreduce\v2\app\TestFetchFailure.java,421,82,43,7,0,132
hadoop-trunk\hadoop-trunk\hadoop-tools\hadoop-azure\src\main\java\org\apache\hadoop\fs\azurebfs\commit\AzureManifestCommitterFactory.java,18,2,0,5,0,7
hadoop-trunk\hadoop-trunk\hadoop-tools\hadoop-aws\src\test\java\org\apache\hadoop\fs\s3a\performance\ITestDirectoryMarkerListing.java,730,31,5,2,0,38
hadoop-trunk\hadoop-trunk\hadoop-tools\hadoop-gridmix\src\main\java\org\apache\hadoop\mapred\gridmix\Progressive.java,0,3,1,1,0,5
hadoop-trunk\hadoop-trunk\hadoop-mapreduce-project\hadoop-mapreduce-client\hadoop-mapreduce-client-app\src\main\java\org\apache\hadoop\mapreduce\v2\app\speculate\forecast\SimpleExponentialSmoothing.java,209,35,1,2,0,38
hadoop-trunk\hadoop-trunk\hadoop-tools\hadoop-aws\src\test\java\org\apache\hadoop\fs\s3a\auth\RoleTestUtils.java,0,7,5,3,0,15
hadoop-trunk\hadoop-trunk\hadoop-common-project\hadoop-common\src\main\java\org\apache\hadoop\crypto\CryptoCodec.java,0,32,6,4,0,42
hadoop-trunk\hadoop-trunk\hadoop-hdfs-project\hadoop-hdfs\src\main\java\org\apache\hadoop\hdfs\tools\offlineEditsViewer\OfflineEditsVisitorFactory.java,45,15,4,1,0,20
hadoop-trunk\hadoop-trunk\hadoop-yarn-project\hadoop-yarn\hadoop-yarn-server\hadoop-yarn-server-nodemanager\src\main\java\org\apache\hadoop\yarn\server\nodemanager\containermanager\linux\resources\NetworkPacketTaggingHandlerImpl.java,0,20,8,5,0,33
hadoop-trunk\hadoop-trunk\hadoop-hdfs-project\hadoop-hdfs\src\main\java\org\apache\hadoop\hdfs\protocol\RollingUpgradeException.java,8,3,0,1,0,4
hadoop-trunk\hadoop-trunk\hadoop-yarn-project\hadoop-yarn\hadoop-yarn-server\hadoop-yarn-server-nodemanager\src\main\java\org\apache\hadoop\yarn\server\nodemanager\containermanager\linux\runtime\runc\RuncManifestToResourcesPlugin.java,0,3,0,3,0,6
hadoop-trunk\hadoop-trunk\hadoop-yarn-project\hadoop-yarn\hadoop-yarn-server\hadoop-yarn-server-resourcemanager\src\main\java\org\apache\hadoop\yarn\server\resourcemanager\scheduler\constraint\TargetApplications.java,60,18,0,1,0,19
hadoop-trunk\hadoop-trunk\hadoop-yarn-project\hadoop-yarn\hadoop-yarn-applications\hadoop-yarn-services\hadoop-yarn-services-core\src\main\java\org\apache\hadoop\yarn\service\api\records\ConfigFormat.java,0,12,0,1,0,13
hadoop-trunk\hadoop-trunk\hadoop-yarn-project\hadoop-yarn\hadoop-yarn-server\hadoop-yarn-server-resourcemanager\src\main\java\org\apache\hadoop\yarn\server\resourcemanager\RMContextImpl.java,599,188,4,26,0,218
hadoop-trunk\hadoop-trunk\hadoop-common-project\hadoop-nfs\src\main\java\org\apache\hadoop\oncrpc\RpcResponse.java,0,11,0,1,0,12
hadoop-trunk\hadoop-trunk\hadoop-common-project\hadoop-common\src\main\java\org\apache\hadoop\ipc\protocolPB\RefreshCallQueueProtocolServerSideTranslatorPB.java,26,9,9,3,0,21
hadoop-trunk\hadoop-trunk\hadoop-yarn-project\hadoop-yarn\hadoop-yarn-server\hadoop-yarn-server-resourcemanager\src\main\java\org\apache\hadoop\yarn\server\resourcemanager\rmcontainer\RMContainerNMDoneChangeResourceEvent.java,15,7,0,1,0,8
hadoop-trunk\hadoop-trunk\hadoop-common-project\hadoop-registry\src\main\java\org\apache\hadoop\registry\client\types\ServiceRecord.java,0,33,4,1,0,38
hadoop-trunk\hadoop-trunk\hadoop-yarn-project\hadoop-yarn\hadoop-yarn-server\hadoop-yarn-server-resourcemanager\src\main\java\org\apache\hadoop\yarn\server\resourcemanager\placement\PlacementManager.java,0,25,2,1,0,28
hadoop-trunk\hadoop-trunk\hadoop-mapreduce-project\hadoop-mapreduce-client\hadoop-mapreduce-client-core\src\main\java\org\apache\hadoop\mapred\FixedLengthInputFormat.java,0,20,1,1,0,22
hadoop-trunk\hadoop-trunk\hadoop-mapreduce-project\hadoop-mapreduce-client\hadoop-mapreduce-client-core\src\main\java\org\apache\hadoop\mapreduce\Mapper.java,0,58,7,3,0,68
hadoop-trunk\hadoop-trunk\hadoop-common-project\hadoop-kms\src\test\java\org\apache\hadoop\crypto\key\kms\server\TestKeyAuthorizationKeyProvider.java,230,24,5,8,0,37
hadoop-trunk\hadoop-trunk\hadoop-common-project\hadoop-common\src\main\java\org\apache\hadoop\ipc\FairCallQueueMXBean.java,0,4,0,1,0,5
hadoop-trunk\hadoop-trunk\hadoop-hdfs-project\hadoop-hdfs-client\src\main\java\org\apache\hadoop\hdfs\security\token\block\BlockTokenSelector.java,18,4,0,1,0,5
hadoop-trunk\hadoop-trunk\hadoop-tools\hadoop-aws\src\main\java\org\apache\hadoop\fs\s3a\commit\InternalCommitterConstants.java,0,0,0,3,0,3
hadoop-trunk\hadoop-trunk\hadoop-tools\hadoop-azure\src\test\java\org\apache\hadoop\fs\azurebfs\ITestAzureBlobFileSystemBackCompat.java,61,8,0,4,0,12
hadoop-trunk\hadoop-trunk\hadoop-tools\hadoop-azure\src\main\java\org\apache\hadoop\fs\azurebfs\services\package-info.java,0,2,0,1,0,3
hadoop-trunk\hadoop-trunk\hadoop-common-project\hadoop-common\src\main\java\org\apache\hadoop\service\launcher\ServiceLaunchException.java,0,12,2,1,0,15
hadoop-trunk\hadoop-trunk\hadoop-common-project\hadoop-common\src\main\java\org\apache\hadoop\fs\shell\find\FilterExpression.java,0,24,2,1,0,27
hadoop-trunk\hadoop-trunk\hadoop-hdfs-project\hadoop-hdfs\src\main\java\org\apache\hadoop\hdfs\protocolPB\JournalProtocolPB.java,0,2,3,2,0,7
hadoop-trunk\hadoop-trunk\hadoop-tools\hadoop-distcp\src\test\java\org\apache\hadoop\tools\mapred\TestDeletedDirTracker.java,211,33,3,1,0,37
hadoop-trunk\hadoop-trunk\hadoop-mapreduce-project\hadoop-mapreduce-client\hadoop-mapreduce-client-app\src\main\java\org\apache\hadoop\mapreduce\v2\app\webapp\CountersBlock.java,162,34,1,5,0,40
hadoop-trunk\hadoop-trunk\hadoop-yarn-project\hadoop-yarn\hadoop-yarn-server\hadoop-yarn-server-resourcemanager\src\test\java\org\apache\hadoop\yarn\server\resourcemanager\monitor\capacity\mockframework\ProportionalCapacityPreemptionPolicyMockFramework.java,252,87,3,16,0,106
hadoop-trunk\hadoop-trunk\hadoop-tools\hadoop-azure\src\test\java\org\apache\hadoop\fs\azurebfs\ITestAzureBlobFileSystemStoreListStatusWithRange.java,117,39,0,18,0,57
hadoop-trunk\hadoop-trunk\hadoop-yarn-project\hadoop-yarn\hadoop-yarn-api\src\main\java\org\apache\hadoop\yarn\server\api\ApplicationTerminationContext.java,20,7,0,1,0,8
hadoop-trunk\hadoop-trunk\hadoop-hdfs-project\hadoop-hdfs\src\main\java\org\apache\hadoop\hdfs\qjournal\client\QuorumCall.java,0,51,7,6,0,64
hadoop-trunk\hadoop-trunk\hadoop-yarn-project\hadoop-yarn\hadoop-yarn-api\src\main\java\org\apache\hadoop\yarn\api\records\timeline\TimelineEntityGroupId.java,127,22,4,1,0,27
hadoop-trunk\hadoop-trunk\hadoop-yarn-project\hadoop-yarn\hadoop-yarn-server\hadoop-yarn-server-resourcemanager\src\test\java\org\apache\hadoop\yarn\server\resourcemanager\security\ClientToAMTokenIdentifierForTest.java,75,32,25,4,0,61
hadoop-trunk\hadoop-trunk\hadoop-hdfs-project\hadoop-hdfs\src\test\java\org\apache\hadoop\cli\CLITestHelperDFS.java,26,4,1,1,0,6
hadoop-trunk\hadoop-trunk\hadoop-yarn-project\hadoop-yarn\hadoop-yarn-server\hadoop-yarn-server-common\src\main\java\org\apache\hadoop\yarn\server\webapp\ContainerBlock.java,138,19,0,1,0,20
hadoop-trunk\hadoop-trunk\hadoop-yarn-project\hadoop-yarn\hadoop-yarn-common\src\main\java\org\apache\hadoop\yarn\api\records\impl\pb\LogAggregationContextPBImpl.java,174,44,56,3,0,103
hadoop-trunk\hadoop-trunk\hadoop-hdfs-project\hadoop-hdfs\src\test\java\org\apache\hadoop\hdfs\server\namenode\ha\TestDelegationTokensWithHA.java,0,83,13,11,0,107
hadoop-trunk\hadoop-trunk\hadoop-tools\hadoop-resourceestimator\src\main\java\org\apache\hadoop\resourceestimator\solver\api\package-info.java,0,1,0,1,0,2
hadoop-trunk\hadoop-trunk\hadoop-tools\hadoop-azure\src\main\java\org\apache\hadoop\fs\azure\WasbRemoteCallHelper.java,244,30,9,4,0,43
hadoop-trunk\hadoop-trunk\hadoop-mapreduce-project\hadoop-mapreduce-client\hadoop-mapreduce-client-app\src\main\java\org\apache\hadoop\mapreduce\v2\app\job\event\JobSetupCompletedEvent.java,7,2,0,1,0,3
hadoop-trunk\hadoop-trunk\hadoop-yarn-project\hadoop-yarn\hadoop-yarn-api\src\main\java\org\apache\hadoop\yarn\ams\ApplicationMasterServiceUtils.java,0,10,1,1,0,12
hadoop-trunk\hadoop-trunk\hadoop-hdfs-project\hadoop-hdfs\src\main\java\org\apache\hadoop\hdfs\server\blockmanagement\BlockStatsMXBean.java,0,0,0,1,0,1
hadoop-trunk\hadoop-trunk\hadoop-yarn-project\hadoop-yarn\hadoop-yarn-server\hadoop-yarn-server-resourcemanager\src\main\java\org\apache\hadoop\yarn\server\resourcemanager\scheduler\capacity\conf\package-info.java,0,1,0,1,0,2
hadoop-trunk\hadoop-trunk\hadoop-yarn-project\hadoop-yarn\hadoop-yarn-server\hadoop-yarn-server-timelineservice-hbase\hadoop-yarn-server-timelineservice-hbase-server\hadoop-yarn-server-timelineservice-hbase-server-1\src\main\java\org\apache\hadoop\yarn\server\timelineservice\storage\flow\FlowRunCoprocessor.java,223,37,8,3,0,48
hadoop-trunk\hadoop-trunk\hadoop-yarn-project\hadoop-yarn\hadoop-yarn-common\src\main\java\org\apache\hadoop\yarn\api\protocolrecords\impl\pb\GetClusterMetricsRequestPBImpl.java,41,21,18,3,0,42
hadoop-trunk\hadoop-trunk\hadoop-mapreduce-project\hadoop-mapreduce-client\hadoop-mapreduce-client-jobclient\src\test\java\org\apache\hadoop\mapred\TestQueueConfigurationParser.java,38,13,1,2,0,16
hadoop-trunk\hadoop-trunk\hadoop-hdfs-project\hadoop-hdfs-httpfs\src\main\java\org\apache\hadoop\lib\service\Scheduler.java,0,8,2,3,0,13
hadoop-trunk\hadoop-trunk\hadoop-hdfs-project\hadoop-hdfs\src\test\java\org\apache\hadoop\hdfs\server\mover\TestStorageMover.java,695,156,7,3,0,166
hadoop-trunk\hadoop-trunk\hadoop-tools\hadoop-rumen\src\main\java\org\apache\hadoop\tools\rumen\TreePath.java,31,20,1,1,0,22
hadoop-trunk\hadoop-trunk\hadoop-yarn-project\hadoop-yarn\hadoop-yarn-server\hadoop-yarn-server-nodemanager\src\main\java\org\apache\hadoop\yarn\server\nodemanager\containermanager\launcher\package-info.java,0,0,0,1,0,1
hadoop-trunk\hadoop-trunk\hadoop-yarn-project\hadoop-yarn\hadoop-yarn-server\hadoop-yarn-server-common\src\test\java\org\apache\hadoop\yarn\server\federation\policies\TestFederationPolicyUtils.java,32,18,0,1,0,19
hadoop-trunk\hadoop-trunk\hadoop-hdfs-project\hadoop-hdfs-httpfs\src\main\java\org\apache\hadoop\lib\server\ServerException.java,71,25,1,3,0,29
hadoop-trunk\hadoop-trunk\hadoop-hdfs-project\hadoop-hdfs-rbf\src\main\java\org\apache\hadoop\hdfs\server\federation\store\protocol\UpdateNamenodeRegistrationRequest.java,43,12,0,3,0,15
hadoop-trunk\hadoop-trunk\hadoop-hdfs-project\hadoop-hdfs\src\main\java\org\apache\hadoop\hdfs\server\datanode\fsdataset\impl\PmemVolumeManager.java,0,74,9,2,0,85
hadoop-trunk\hadoop-trunk\hadoop-yarn-project\hadoop-yarn\hadoop-yarn-server\hadoop-yarn-server-resourcemanager\src\main\java\org\apache\hadoop\yarn\server\resourcemanager\rmcontainer\RMContainerState.java,0,17,0,1,0,18
hadoop-trunk\hadoop-trunk\hadoop-mapreduce-project\hadoop-mapreduce-client\hadoop-mapreduce-client-core\src\main\java\org\apache\hadoop\mapreduce\ClusterMetrics.java,202,103,1,1,0,105
hadoop-trunk\hadoop-trunk\hadoop-mapreduce-project\hadoop-mapreduce-client\hadoop-mapreduce-client-core\src\main\java\org\apache\hadoop\mapreduce\lib\partition\BinaryPartitioner.java,0,54,1,1,0,56
hadoop-trunk\hadoop-trunk\hadoop-hdfs-project\hadoop-hdfs\src\main\java\org\apache\hadoop\hdfs\server\blockmanagement\DatanodeManager.java,0,406,46,27,0,479
hadoop-trunk\hadoop-trunk\hadoop-tools\hadoop-federation-balance\src\main\java\org\apache\hadoop\tools\fedbalance\DistCpProcedure.java,602,69,13,3,0,85
hadoop-trunk\hadoop-trunk\hadoop-tools\hadoop-aws\src\test\java\org\apache\hadoop\fs\s3a\scale\ITestS3ADeleteManyFiles.java,112,4,3,2,0,9
hadoop-trunk\hadoop-trunk\hadoop-yarn-project\hadoop-yarn\hadoop-yarn-server\hadoop-yarn-server-common\src\main\java\org\apache\hadoop\yarn\server\federation\store\records\GetSubClustersInfoResponse.java,34,2,0,1,0,3
hadoop-trunk\hadoop-trunk\hadoop-yarn-project\hadoop-yarn\hadoop-yarn-server\hadoop-yarn-server-sharedcachemanager\src\main\java\org\apache\hadoop\yarn\server\sharedcachemanager\SharedCacheUploaderService.java,0,19,3,6,0,28
hadoop-trunk\hadoop-trunk\hadoop-hdfs-project\hadoop-hdfs\src\test\java\org\apache\hadoop\hdfs\server\namenode\MockNameNodeResourceChecker.java,23,5,1,1,0,7
hadoop-trunk\hadoop-trunk\hadoop-yarn-project\hadoop-yarn\hadoop-yarn-api\src\main\java\org\apache\hadoop\yarn\util\TimelineServiceHelper.java,0,3,1,1,0,5
hadoop-trunk\hadoop-trunk\hadoop-mapreduce-project\hadoop-mapreduce-client\hadoop-mapreduce-client-core\src\main\java\org\apache\hadoop\mapreduce\lib\fieldsel\FieldSelectionReducer.java,0,33,2,2,0,37
hadoop-trunk\hadoop-trunk\hadoop-cloud-storage-project\hadoop-huaweicloud\src\test\java\org\apache\hadoop\fs\obs\TestOBSContractMkdir.java,8,1,0,1,0,2
hadoop-trunk\hadoop-trunk\hadoop-tools\hadoop-resourceestimator\src\test\java\org\apache\hadoop\resourceestimator\common\serialization\TestHistorySkylineSerDe.java,89,20,1,3,0,24
hadoop-trunk\hadoop-trunk\hadoop-yarn-project\hadoop-yarn\hadoop-yarn-server\hadoop-yarn-server-applicationhistoryservice\src\main\java\org\apache\hadoop\yarn\server\applicationhistoryservice\webapp\ContainerPage.java,17,4,0,1,0,5
hadoop-trunk\hadoop-trunk\hadoop-yarn-project\hadoop-yarn\hadoop-yarn-server\hadoop-yarn-server-resourcemanager\src\main\java\org\apache\hadoop\yarn\server\resourcemanager\reservation\FairReservationSystem.java,73,16,0,3,0,19
hadoop-trunk\hadoop-trunk\hadoop-yarn-project\hadoop-yarn\hadoop-yarn-server\hadoop-yarn-server-resourcemanager\src\test\java\org\apache\hadoop\yarn\server\resourcemanager\scheduler\TestClusterNodeTracker.java,163,35,1,2,0,38
hadoop-trunk\hadoop-trunk\hadoop-common-project\hadoop-common\src\main\java\org\apache\hadoop\metrics2\impl\MetricsSystemImpl.java,0,160,48,1,0,209
hadoop-trunk\hadoop-trunk\hadoop-mapreduce-project\hadoop-mapreduce-client\hadoop-mapreduce-client-core\src\main\java\org\apache\hadoop\mapred\jobcontrol\Job.java,156,39,3,2,0,44
hadoop-trunk\hadoop-trunk\hadoop-yarn-project\hadoop-yarn\hadoop-yarn-server\hadoop-yarn-server-resourcemanager\src\main\java\org\apache\hadoop\yarn\server\resourcemanager\scheduler\capacity\AbstractManagedParentQueue.java,166,30,1,4,0,35
hadoop-trunk\hadoop-trunk\hadoop-yarn-project\hadoop-yarn\hadoop-yarn-server\hadoop-yarn-server-resourcemanager\src\main\java\org\apache\hadoop\yarn\server\resourcemanager\reservation\RLESparseResourceAllocation.java,561,61,12,2,0,75
hadoop-trunk\hadoop-trunk\hadoop-mapreduce-project\hadoop-mapreduce-client\hadoop-mapreduce-client-core\src\test\java\org\apache\hadoop\mapreduce\split\TestJobSplitWriter.java,54,12,0,1,0,13
hadoop-trunk\hadoop-trunk\hadoop-common-project\hadoop-common\src\main\java\org\apache\hadoop\io\erasurecode\CodecUtil.java,0,43,2,1,0,46
hadoop-trunk\hadoop-trunk\hadoop-tools\hadoop-resourceestimator\src\main\java\org\apache\hadoop\resourceestimator\common\exception\ResourceEstimatorException.java,11,5,0,1,0,6
hadoop-trunk\hadoop-trunk\hadoop-common-project\hadoop-common\src\main\java\org\apache\hadoop\util\GSet.java,0,5,0,1,0,6
hadoop-trunk\hadoop-trunk\hadoop-yarn-project\hadoop-yarn\hadoop-yarn-server\hadoop-yarn-server-common\src\main\java\org\apache\hadoop\yarn\server\volume\csi\package-info.java,0,1,0,1,0,2
hadoop-trunk\hadoop-trunk\hadoop-mapreduce-project\hadoop-mapreduce-client\hadoop-mapreduce-client-app\src\main\java\org\apache\hadoop\mapreduce\v2\app\webapp\dao\AMAttemptInfo.java,63,32,2,1,0,35
hadoop-trunk\hadoop-trunk\hadoop-common-project\hadoop-common\src\main\java\org\apache\hadoop\fs\ByteBufferPositionedReadable.java,0,1,0,1,0,2
hadoop-trunk\hadoop-trunk\hadoop-yarn-project\hadoop-yarn\hadoop-yarn-server\hadoop-yarn-server-common\src\main\java\org\apache\hadoop\yarn\server\federation\policies\AbstractConfigurableFederationPolicy.java,0,11,3,3,0,17
hadoop-trunk\hadoop-trunk\hadoop-mapreduce-project\hadoop-mapreduce-client\hadoop-mapreduce-client-core\src\main\java\org\apache\hadoop\mapreduce\lib\db\DBConfiguration.java,0,138,1,2,0,141
hadoop-trunk\hadoop-trunk\hadoop-common-project\hadoop-common\src\main\java\org\apache\hadoop\metrics2\filter\RegexFilter.java,8,3,0,1,0,4
hadoop-trunk\hadoop-trunk\hadoop-hdfs-project\hadoop-hdfs-rbf\src\main\java\org\apache\hadoop\hdfs\server\federation\router\RouterAdminServer.java,0,71,14,33,0,118
hadoop-trunk\hadoop-trunk\hadoop-yarn-project\hadoop-yarn\hadoop-yarn-server\hadoop-yarn-server-nodemanager\src\test\java\org\apache\hadoop\yarn\server\nodemanager\containermanager\resourceplugin\deviceframework\FakeTestDevicePlugin5.java,25,6,2,5,0,13
hadoop-trunk\hadoop-trunk\hadoop-yarn-project\hadoop-yarn\hadoop-yarn-server\hadoop-yarn-server-timelineservice\src\test\java\org\apache\hadoop\yarn\server\timelineservice\collector\TestTimelineCollector.java,295,48,7,3,0,58
hadoop-trunk\hadoop-trunk\hadoop-common-project\hadoop-common\src\main\java\org\apache\hadoop\metrics2\impl\MetricsBuffer.java,0,8,0,1,0,9
hadoop-trunk\hadoop-trunk\hadoop-tools\hadoop-azure\src\test\java\org\apache\hadoop\fs\azure\AbstractWasbTestWithTimeout.java,41,0,1,1,0,2
hadoop-trunk\hadoop-trunk\hadoop-common-project\hadoop-common\src\main\java\org\apache\hadoop\security\SaslPropertiesResolver.java,113,31,0,2,0,33
hadoop-trunk\hadoop-trunk\hadoop-yarn-project\hadoop-yarn\hadoop-yarn-common\src\main\java\org\apache\hadoop\yarn\api\records\impl\pb\ApplicationSubmissionContextPBImpl.java,0,130,114,6,0,250
hadoop-trunk\hadoop-trunk\hadoop-yarn-project\hadoop-yarn\hadoop-yarn-applications\hadoop-yarn-services\hadoop-yarn-services-core\src\main\java\org\apache\hadoop\yarn\service\utils\ClientRegistryBinder.java,158,26,2,6,0,34
hadoop-trunk\hadoop-trunk\hadoop-yarn-project\hadoop-yarn\hadoop-yarn-server\hadoop-yarn-server-resourcemanager\src\main\java\org\apache\hadoop\yarn\server\resourcemanager\monitor\capacity\PreemptableResourceCalculator.java,212,28,1,8,0,37
hadoop-trunk\hadoop-trunk\hadoop-common-project\hadoop-registry\src\main\java\org\apache\hadoop\registry\cli\RegistryCli.java,0,54,23,2,0,79
hadoop-trunk\hadoop-trunk\hadoop-common-project\hadoop-common\src\test\java\org\apache\hadoop\http\lib\TestStaticUserWebFilter.java,47,13,2,1,0,16
hadoop-trunk\hadoop-trunk\hadoop-yarn-project\hadoop-yarn\hadoop-yarn-common\src\main\java\org\apache\hadoop\yarn\ipc\package-info.java,0,1,0,1,0,2
hadoop-trunk\hadoop-trunk\hadoop-yarn-project\hadoop-yarn\hadoop-yarn-server\hadoop-yarn-server-resourcemanager\src\test\java\org\apache\hadoop\yarn\server\resourcemanager\webapp\helper\BufferedClientResponse.java,31,13,0,1,0,14
hadoop-trunk\hadoop-trunk\hadoop-common-project\hadoop-common\src\main\java\org\apache\hadoop\metrics2\lib\MutableRatesWithAggregation.java,145,24,0,2,0,26
hadoop-trunk\hadoop-trunk\hadoop-tools\hadoop-aws\src\main\java\org\apache\hadoop\fs\s3a\Invoker.java,525,85,4,3,0,92
hadoop-trunk\hadoop-trunk\hadoop-hdfs-project\hadoop-hdfs\src\test\java\org\apache\hadoop\hdfs\server\datanode\checker\TestThrottledAsyncCheckerTimeout.java,170,29,8,4,0,41
hadoop-trunk\hadoop-trunk\hadoop-tools\hadoop-openstack\src\main\java\org\apache\hadoop\fs\swift\snative\StrictBufferedFSInputStream.java,19,8,0,2,0,10
hadoop-trunk\hadoop-trunk\hadoop-tools\hadoop-azure-datalake\src\test\java\org\apache\hadoop\fs\adl\live\TestAdlContractCreateLive.java,8,3,0,1,0,4
hadoop-trunk\hadoop-trunk\hadoop-common-project\hadoop-common\src\main\java\org\apache\hadoop\io\compress\lz4\Lz4Decompressor.java,253,26,4,1,0,31
hadoop-trunk\hadoop-trunk\hadoop-tools\hadoop-streaming\src\test\java\org\apache\hadoop\streaming\TestStreamingOutputKeyValueTypes.java,159,27,0,1,0,28
hadoop-trunk\hadoop-trunk\hadoop-hdfs-project\hadoop-hdfs\src\test\java\org\apache\hadoop\hdfs\server\datanode\fsdataset\impl\TestProvidedImpl.java,572,90,16,5,0,111
hadoop-trunk\hadoop-trunk\hadoop-yarn-project\hadoop-yarn\hadoop-yarn-client\src\test\java\org\apache\hadoop\yarn\client\TestNoHaRMFailoverProxyProvider.java,225,18,24,1,0,43
hadoop-trunk\hadoop-trunk\hadoop-mapreduce-project\hadoop-mapreduce-client\hadoop-mapreduce-client-jobclient\src\test\java\org\apache\hadoop\mapred\TestSequenceFileAsTextInputFormat.java,87,27,7,3,0,37
hadoop-trunk\hadoop-trunk\hadoop-yarn-project\hadoop-yarn\hadoop-yarn-server\hadoop-yarn-server-common\src\main\java\org\apache\hadoop\yarn\server\federation\store\records\GetSubClusterInfoRequest.java,33,2,0,1,0,3
hadoop-trunk\hadoop-trunk\hadoop-common-project\hadoop-common\src\test\java\org\apache\hadoop\metrics2\impl\MetricsLists.java,0,3,1,1,0,5
hadoop-trunk\hadoop-trunk\hadoop-common-project\hadoop-common\src\main\java\org\apache\hadoop\fs\FileChecksum.java,35,12,0,1,0,13
hadoop-trunk\hadoop-trunk\hadoop-yarn-project\hadoop-yarn\hadoop-yarn-server\hadoop-yarn-server-resourcemanager\src\main\java\org\apache\hadoop\yarn\server\resourcemanager\scheduler\activities\ActivitiesUtils.java,0,7,1,2,0,10
hadoop-trunk\hadoop-trunk\hadoop-common-project\hadoop-common\src\main\java\org\apache\hadoop\util\functional\ConsumerRaisingIOE.java,0,0,0,1,0,1
hadoop-trunk\hadoop-trunk\hadoop-yarn-project\hadoop-yarn\hadoop-yarn-server\hadoop-yarn-server-timeline-pluginstorage\src\main\java\org\apache\hadoop\yarn\server\timeline\LevelDBCacheTimelineStore.java,270,36,8,1,0,45
hadoop-trunk\hadoop-trunk\hadoop-common-project\hadoop-common\src\test\java\org\apache\hadoop\crypto\TestCryptoStreamsWithOpensslAesCtrCryptoCodec.java,0,6,0,3,0,9
hadoop-trunk\hadoop-trunk\hadoop-hdfs-project\hadoop-hdfs\src\test\java\org\apache\hadoop\net\TestNetworkTopology.java,586,203,75,2,0,280
hadoop-trunk\hadoop-trunk\hadoop-mapreduce-project\hadoop-mapreduce-client\hadoop-mapreduce-client-app\src\main\java\org\apache\hadoop\mapred\WrappedJvmID.java,8,4,0,1,0,5
hadoop-trunk\hadoop-trunk\hadoop-yarn-project\hadoop-yarn\hadoop-yarn-common\src\test\java\org\apache\hadoop\yarn\api\TestPlacementConstraintPBConversion.java,147,13,17,8,0,38
hadoop-trunk\hadoop-trunk\hadoop-hdfs-project\hadoop-hdfs-client\src\main\java\org\apache\hadoop\hdfs\web\resources\ReplicationParam.java,36,6,0,3,0,9
hadoop-trunk\hadoop-trunk\hadoop-hdfs-project\hadoop-hdfs-httpfs\src\test\java\org\apache\hadoop\test\TestDirHelper.java,119,26,1,15,0,42
hadoop-trunk\hadoop-trunk\hadoop-yarn-project\hadoop-yarn\hadoop-yarn-common\src\main\java\org\apache\hadoop\yarn\webapp\DefaultWrapperServlet.java,20,4,0,1,0,5
hadoop-trunk\hadoop-trunk\hadoop-hdfs-project\hadoop-hdfs-rbf\src\test\java\org\apache\hadoop\hdfs\server\federation\router\TestRouterRefreshSuperUserGroupsConfiguration.java,143,17,7,2,0,26
hadoop-trunk\hadoop-trunk\hadoop-hdfs-project\hadoop-hdfs\src\test\java\org\apache\hadoop\hdfs\server\namenode\TestCheckpoint.java,0,376,44,40,0,460
hadoop-trunk\hadoop-trunk\hadoop-yarn-project\hadoop-yarn\hadoop-yarn-server\hadoop-yarn-server-common\src\main\java\org\apache\hadoop\yarn\server\federation\store\records\GetSubClusterPolicyConfigurationResponse.java,34,3,0,1,0,4
hadoop-trunk\hadoop-trunk\hadoop-common-project\hadoop-common\src\test\java\org\apache\hadoop\tools\TestCommandShell.java,98,26,6,1,0,33
hadoop-trunk\hadoop-trunk\hadoop-tools\hadoop-aliyun\src\test\java\org\apache\hadoop\fs\aliyun\oss\contract\TestAliyunOSSContractRename.java,9,2,0,1,0,3
hadoop-trunk\hadoop-trunk\hadoop-yarn-project\hadoop-yarn\hadoop-yarn-applications\hadoop-yarn-services\hadoop-yarn-services-core\src\main\java\org\apache\hadoop\yarn\service\impl\pb\service\ClientAMProtocolPBServiceImpl.java,103,30,35,10,0,75
hadoop-trunk\hadoop-trunk\hadoop-yarn-project\hadoop-yarn\hadoop-yarn-server\hadoop-yarn-server-resourcemanager\src\main\java\org\apache\hadoop\yarn\server\resourcemanager\recovery\RMStateUpdateAppEvent.java,40,23,0,3,0,26
hadoop-trunk\hadoop-trunk\hadoop-tools\hadoop-fs2img\src\main\java\org\apache\hadoop\hdfs\server\namenode\NullBlockAliasMap.java,63,8,3,1,0,12
hadoop-trunk\hadoop-trunk\hadoop-yarn-project\hadoop-yarn\hadoop-yarn-server\hadoop-yarn-server-sharedcachemanager\src\test\java\org\apache\hadoop\yarn\server\sharedcachemanager\TestClientSCMProtocolService.java,225,25,7,4,0,36
hadoop-trunk\hadoop-trunk\hadoop-mapreduce-project\hadoop-mapreduce-examples\src\main\java\org\apache\hadoop\examples\pi\Parser.java,0,76,12,8,0,96
hadoop-trunk\hadoop-trunk\hadoop-mapreduce-project\hadoop-mapreduce-client\hadoop-mapreduce-client-jobclient\src\test\java\org\apache\hadoop\fs\slive\Timer.java,0,7,1,1,0,9
hadoop-trunk\hadoop-trunk\hadoop-tools\hadoop-streaming\src\main\java\org\apache\hadoop\streaming\io\TextOutputReader.java,0,35,2,1,0,38
hadoop-trunk\hadoop-trunk\hadoop-yarn-project\hadoop-yarn\hadoop-yarn-common\src\main\java\org\apache\hadoop\yarn\api\protocolrecords\impl\pb\UpdateApplicationTimeoutsRequestPBImpl.java,0,28,50,4,0,82
hadoop-trunk\hadoop-trunk\hadoop-yarn-project\hadoop-yarn\hadoop-yarn-common\src\main\java\org\apache\hadoop\yarn\webapp\hamlet2\HamletImpl.java,339,139,14,1,0,154
hadoop-trunk\hadoop-trunk\hadoop-yarn-project\hadoop-yarn\hadoop-yarn-server\hadoop-yarn-server-timelineservice-hbase\hadoop-yarn-server-timelineservice-hbase-common\src\main\java\org\apache\hadoop\yarn\server\timelineservice\storage\common\BaseTable.java,3,1,1,1,0,3
hadoop-trunk\hadoop-trunk\hadoop-mapreduce-project\hadoop-mapreduce-client\hadoop-mapreduce-client-app\src\main\java\org\apache\hadoop\mapreduce\v2\app\job\event\JobUpdatedNodesEvent.java,14,7,0,1,0,8
hadoop-trunk\hadoop-trunk\hadoop-yarn-project\hadoop-yarn\hadoop-yarn-server\hadoop-yarn-server-nodemanager\src\main\java\org\apache\hadoop\yarn\server\nodemanager\containermanager\container\ContainerResourceEvent.java,16,8,0,2,0,10
hadoop-trunk\hadoop-trunk\hadoop-yarn-project\hadoop-yarn\hadoop-yarn-applications\hadoop-yarn-applications-distributedshell\src\main\java\org\apache\hadoop\yarn\applications\distributedshell\PlacementSpec.java,84,17,2,2,0,21
hadoop-trunk\hadoop-trunk\hadoop-common-project\hadoop-common\src\main\java\org\apache\hadoop\metrics2\MetricsRecordBuilder.java,90,12,0,1,0,13
hadoop-trunk\hadoop-trunk\hadoop-common-project\hadoop-kms\src\main\java\org\apache\hadoop\crypto\key\kms\server\KMSConfiguration.java,160,57,3,2,0,62
hadoop-trunk\hadoop-trunk\hadoop-common-project\hadoop-common\src\main\java\org\apache\hadoop\fs\sftp\SFTPInputStream.java,0,16,1,1,0,18
hadoop-trunk\hadoop-trunk\hadoop-hdfs-project\hadoop-hdfs\src\test\java\org\apache\hadoop\hdfs\qjournal\MiniQJMHACluster.java,156,56,2,8,0,66
hadoop-trunk\hadoop-trunk\hadoop-yarn-project\hadoop-yarn\hadoop-yarn-applications\hadoop-yarn-applications-distributedshell\src\test\java\org\apache\hadoop\yarn\applications\distributedshell\TestClient.java,16,3,0,2,0,5
hadoop-trunk\hadoop-trunk\hadoop-tools\hadoop-aws\src\test\java\org\apache\hadoop\fs\s3a\performance\AbstractS3ACostTest.java,473,59,6,3,0,68
hadoop-trunk\hadoop-trunk\hadoop-yarn-project\hadoop-yarn\hadoop-yarn-api\src\main\java\org\apache\hadoop\yarn\api\protocolrecords\GetNewApplicationRequest.java,10,5,1,1,0,7
hadoop-trunk\hadoop-trunk\hadoop-mapreduce-project\hadoop-mapreduce-client\hadoop-mapreduce-client-app\src\test\java\org\apache\hadoop\mapreduce\v2\app\job\impl\TestTaskAttempt.java,1936,237,53,19,0,309
hadoop-trunk\hadoop-trunk\hadoop-common-project\hadoop-common\src\main\java\org\apache\hadoop\ha\BadFencingConfigurationException.java,12,5,0,1,0,6
hadoop-trunk\hadoop-trunk\hadoop-hdfs-project\hadoop-hdfs-rbf\src\main\java\org\apache\hadoop\hdfs\server\federation\router\RouterWebHdfsMethods.java,480,46,13,3,0,62
hadoop-trunk\hadoop-trunk\hadoop-yarn-project\hadoop-yarn\hadoop-yarn-server\hadoop-yarn-server-resourcemanager\src\main\java\org\apache\hadoop\yarn\server\resourcemanager\scheduler\fair\AllocationFileLoaderService.java,302,47,9,6,0,62
hadoop-trunk\hadoop-trunk\hadoop-hdfs-project\hadoop-hdfs\src\main\java\org\apache\hadoop\hdfs\server\datanode\fsdataset\impl\FsDatasetFactory.java,0,4,0,1,0,5
hadoop-trunk\hadoop-trunk\hadoop-yarn-project\hadoop-yarn\hadoop-yarn-server\hadoop-yarn-server-common\src\main\java\org\apache\hadoop\yarn\server\federation\policies\FederationPolicyUtils.java,0,18,6,7,0,31
hadoop-trunk\hadoop-trunk\hadoop-common-project\hadoop-common\src\test\java\org\apache\hadoop\fs\contract\AbstractContractDeleteTest.java,92,12,2,1,0,15
hadoop-trunk\hadoop-trunk\hadoop-common-project\hadoop-auth\src\main\java\org\apache\hadoop\security\authentication\server\package-info.java,0,0,0,1,0,1
hadoop-trunk\hadoop-trunk\hadoop-common-project\hadoop-common\src\main\java\org\apache\hadoop\conf\ReconfigurableBase.java,0,29,4,3,0,36
hadoop-trunk\hadoop-trunk\hadoop-yarn-project\hadoop-yarn\hadoop-yarn-server\hadoop-yarn-server-applicationhistoryservice\src\main\java\org\apache\hadoop\yarn\server\timeline\NameValuePair.java,32,10,0,1,0,11
hadoop-trunk\hadoop-trunk\hadoop-tools\hadoop-aws\src\main\java\org\apache\hadoop\fs\s3native\NativeS3FileSystem.java,0,28,3,1,0,32
hadoop-trunk\hadoop-trunk\hadoop-yarn-project\hadoop-yarn\hadoop-yarn-server\hadoop-yarn-server-resourcemanager\src\test\java\org\apache\hadoop\yarn\server\resourcemanager\scheduler\capacity\TestCapacitySchedulerNodes.java,304,37,21,26,0,84
hadoop-trunk\hadoop-trunk\hadoop-common-project\hadoop-common\src\main\java\org\apache\hadoop\log\LogThrottlingHelper.java,324,39,0,1,0,40
hadoop-trunk\hadoop-trunk\hadoop-mapreduce-project\hadoop-mapreduce-client\hadoop-mapreduce-client-core\src\main\java\org\apache\hadoop\mapred\FileSplit.java,0,47,7,1,0,55
hadoop-trunk\hadoop-trunk\hadoop-yarn-project\hadoop-yarn\hadoop-yarn-server\hadoop-yarn-server-timelineservice-hbase\hadoop-yarn-server-timelineservice-hbase-client\src\main\java\org\apache\hadoop\yarn\server\timelineservice\storage\common\TypedBufferedMutator.java,42,19,0,1,0,20
hadoop-trunk\hadoop-trunk\hadoop-hdfs-project\hadoop-hdfs\src\main\java\org\apache\hadoop\hdfs\server\namenode\sps\StoragePolicySatisfyManager.java,247,16,1,1,0,18
hadoop-trunk\hadoop-trunk\hadoop-tools\hadoop-rumen\src\main\java\org\apache\hadoop\tools\rumen\HistoryEventEmitter.java,67,10,1,3,0,14
hadoop-trunk\hadoop-trunk\hadoop-common-project\hadoop-registry\src\test\java\org\apache\hadoop\registry\server\dns\TestReverseZoneUtils.java,63,21,10,1,0,32
hadoop-trunk\hadoop-trunk\hadoop-tools\hadoop-azure-datalake\src\main\java\org\apache\hadoop\fs\adl\AdlPermission.java,0,4,0,1,0,5
hadoop-trunk\hadoop-trunk\hadoop-yarn-project\hadoop-yarn\hadoop-yarn-common\src\main\java\org\apache\hadoop\yarn\server\api\protocolrecords\impl\pb\NodesToAttributesMappingResponsePBImpl.java,0,9,13,3,0,25
hadoop-trunk\hadoop-trunk\hadoop-common-project\hadoop-common\src\main\java\org\apache\hadoop\fs\shell\Mkdir.java,0,15,0,2,0,17
hadoop-trunk\hadoop-trunk\hadoop-hdfs-project\hadoop-hdfs\src\test\java\org\apache\hadoop\hdfs\TestPersistBlocks.java,315,71,3,5,0,79
hadoop-trunk\hadoop-trunk\hadoop-yarn-project\hadoop-yarn\hadoop-yarn-server\hadoop-yarn-server-nodemanager\src\main\java\org\apache\hadoop\yarn\server\nodemanager\ContainerManagerEventType.java,0,4,0,1,0,5
hadoop-trunk\hadoop-trunk\hadoop-yarn-project\hadoop-yarn\hadoop-yarn-common\src\main\java\org\apache\hadoop\yarn\security\client\ClientToAMTokenSecretManager.java,48,14,2,1,0,17
hadoop-trunk\hadoop-trunk\hadoop-yarn-project\hadoop-yarn\hadoop-yarn-server\hadoop-yarn-server-timelineservice\src\main\java\org\apache\hadoop\yarn\server\timelineservice\reader\filter\TimelineFilterList.java,106,26,0,1,0,27
hadoop-trunk\hadoop-trunk\hadoop-common-project\hadoop-common\src\test\java\org\apache\hadoop\fs\shell\TestCommandFactory.java,81,39,4,1,0,44
hadoop-trunk\hadoop-trunk\hadoop-mapreduce-project\hadoop-mapreduce-client\hadoop-mapreduce-client-core\src\main\java\org\apache\hadoop\mapreduce\lib\output\committer\manifest\stages\AbortTaskStage.java,0,2,1,2,0,5
hadoop-trunk\hadoop-trunk\hadoop-common-project\hadoop-common\src\test\java\org\apache\hadoop\cli\util\CLITestCmd.java,34,16,1,1,0,18
hadoop-trunk\hadoop-trunk\hadoop-yarn-project\hadoop-yarn\hadoop-yarn-server\hadoop-yarn-server-applicationhistoryservice\src\main\java\org\apache\hadoop\yarn\server\timeline\webapp\CrossOriginFilterInitializer.java,26,8,0,2,0,10
hadoop-trunk\hadoop-trunk\hadoop-yarn-project\hadoop-yarn\hadoop-yarn-server\hadoop-yarn-server-nodemanager\src\main\java\org\apache\hadoop\yarn\server\nodemanager\containermanager\resourceplugin\com\nec\package-info.java,0,1,0,2,0,3
hadoop-trunk\hadoop-trunk\hadoop-yarn-project\hadoop-yarn\hadoop-yarn-server\hadoop-yarn-server-resourcemanager\src\test\java\org\apache\hadoop\yarn\server\resourcemanager\webapp\dao\TestFairSchedulerQueueInfo.java,33,2,0,5,0,7
hadoop-trunk\hadoop-trunk\hadoop-yarn-project\hadoop-yarn\hadoop-yarn-server\hadoop-yarn-server-resourcemanager\src\main\java\org\apache\hadoop\yarn\server\resourcemanager\scheduler\fair\converter\VerificationException.java,11,4,1,1,0,6
hadoop-trunk\hadoop-trunk\hadoop-common-project\hadoop-common\src\main\java\org\apache\hadoop\fs\viewfs\Constants.java,0,28,29,1,0,58
hadoop-trunk\hadoop-trunk\hadoop-hdfs-project\hadoop-hdfs-client\src\main\java\org\apache\hadoop\hdfs\web\WebHdfsConstants.java,21,10,0,2,0,12
hadoop-trunk\hadoop-trunk\hadoop-tools\hadoop-azure\src\test\java\org\apache\hadoop\fs\azure\TestKeyPageBlobDirectories.java,141,17,0,6,0,23
hadoop-trunk\hadoop-trunk\hadoop-yarn-project\hadoop-yarn\hadoop-yarn-applications\hadoop-yarn-services\hadoop-yarn-services-core\src\main\java\org\apache\hadoop\yarn\service\exceptions\ExitCodeProvider.java,0,1,0,1,0,2
hadoop-trunk\hadoop-trunk\hadoop-hdfs-project\hadoop-hdfs\src\test\java\org\apache\hadoop\hdfs\server\namenode\ha\TestStandbyCheckpoints.java,616,155,5,7,0,167
hadoop-trunk\hadoop-trunk\hadoop-yarn-project\hadoop-yarn\hadoop-yarn-api\src\main\java\org\apache\hadoop\yarn\api\records\ReservationRequestInterpreter.java,0,3,0,1,0,4
hadoop-trunk\hadoop-trunk\hadoop-yarn-project\hadoop-yarn\hadoop-yarn-server\hadoop-yarn-server-nodemanager\src\main\java\org\apache\hadoop\yarn\server\nodemanager\api\deviceplugin\YarnRuntimeType.java,0,5,0,1,0,6
hadoop-trunk\hadoop-trunk\hadoop-yarn-project\hadoop-yarn\hadoop-yarn-server\hadoop-yarn-server-applicationhistoryservice\src\main\java\org\apache\hadoop\yarn\server\applicationhistoryservice\webapp\ContextFactory.java,0,20,11,1,0,32
hadoop-trunk\hadoop-trunk\hadoop-hdfs-project\hadoop-hdfs\src\main\java\org\apache\hadoop\hdfs\protocol\SnapshotInfo.java,86,55,8,1,0,64
hadoop-trunk\hadoop-trunk\hadoop-mapreduce-project\hadoop-mapreduce-client\hadoop-mapreduce-client-core\src\main\java\org\apache\hadoop\mapreduce\lib\input\SequenceFileAsBinaryInputFormat.java,0,41,4,1,0,46
hadoop-trunk\hadoop-trunk\hadoop-common-project\hadoop-auth-examples\src\main\java\org\apache\hadoop\security\authentication\examples\WhoClient.java,35,6,3,3,0,12
hadoop-trunk\hadoop-trunk\hadoop-yarn-project\hadoop-yarn\hadoop-yarn-server\hadoop-yarn-server-nodemanager\src\main\java\org\apache\hadoop\yarn\server\nodemanager\containermanager\AuxServicesEventType.java,0,4,0,1,0,5
hadoop-trunk\hadoop-trunk\hadoop-hdfs-project\hadoop-hdfs-rbf\src\main\java\org\apache\hadoop\hdfs\server\federation\store\protocol\impl\pb\GetRouterRegistrationResponsePBImpl.java,0,12,33,7,0,52
hadoop-trunk\hadoop-trunk\hadoop-common-project\hadoop-common\src\main\java\org\apache\hadoop\security\token\DtUtilShell.java,362,66,31,1,0,98
hadoop-trunk\hadoop-trunk\hadoop-tools\hadoop-azure\src\test\java\org\apache\hadoop\fs\azurebfs\ITestAzureBlobFileSystemE2EScale.java,81,10,1,1,0,12
hadoop-trunk\hadoop-trunk\hadoop-mapreduce-project\hadoop-mapreduce-client\hadoop-mapreduce-client-app\src\main\java\org\apache\hadoop\mapreduce\v2\app\webapp\dao\AppInfo.java,41,24,2,1,0,27
hadoop-trunk\hadoop-trunk\hadoop-hdfs-project\hadoop-hdfs-client\src\main\java\org\apache\hadoop\hdfs\web\resources\OffsetParam.java,35,4,0,1,0,5
hadoop-trunk\hadoop-trunk\hadoop-hdfs-project\hadoop-hdfs-client\src\main\java\org\apache\hadoop\hdfs\web\oauth2\CredentialBasedAccessTokenProvider.java,0,14,0,4,0,18
hadoop-trunk\hadoop-trunk\hadoop-mapreduce-project\hadoop-mapreduce-client\hadoop-mapreduce-client-common\src\main\java\org\apache\hadoop\mapreduce\v2\api\records\TaskAttemptCompletionEventStatus.java,0,5,0,1,0,6
hadoop-trunk\hadoop-trunk\hadoop-mapreduce-project\hadoop-mapreduce-client\hadoop-mapreduce-client-app\src\test\java\org\apache\hadoop\mapreduce\v2\app\TestMRClientService.java,244,32,6,11,0,49
hadoop-trunk\hadoop-trunk\hadoop-yarn-project\hadoop-yarn\hadoop-yarn-server\hadoop-yarn-server-nodemanager\src\main\java\org\apache\hadoop\yarn\server\nodemanager\DefaultContainerExecutor.java,970,140,13,9,0,162
hadoop-trunk\hadoop-trunk\hadoop-hdfs-project\hadoop-hdfs-rbf\src\main\java\org\apache\hadoop\hdfs\server\federation\store\records\impl\pb\PBRecord.java,0,0,0,1,0,1
hadoop-trunk\hadoop-trunk\hadoop-yarn-project\hadoop-yarn\hadoop-yarn-server\hadoop-yarn-server-nodemanager\src\main\java\org\apache\hadoop\yarn\server\nodemanager\containermanager\resourceplugin\ResourcePlugin.java,0,6,0,10,0,16
hadoop-trunk\hadoop-trunk\hadoop-yarn-project\hadoop-yarn\hadoop-yarn-server\hadoop-yarn-server-resourcemanager\src\main\java\org\apache\hadoop\yarn\server\resourcemanager\scheduler\fair\policies\ComputeFairShares.java,0,54,3,1,0,58
hadoop-trunk\hadoop-trunk\hadoop-common-project\hadoop-common\src\main\java\org\apache\hadoop\fs\shell\Tail.java,0,20,2,1,0,23
hadoop-trunk\hadoop-trunk\hadoop-common-project\hadoop-common\src\main\java\org\apache\hadoop\fs\sftp\SFTPConnectionPool.java,0,27,6,1,0,34
hadoop-trunk\hadoop-trunk\hadoop-tools\hadoop-streaming\src\main\java\org\apache\hadoop\record\Record.java,0,19,5,1,0,25
hadoop-trunk\hadoop-trunk\hadoop-yarn-project\hadoop-yarn\hadoop-yarn-applications\hadoop-yarn-services\hadoop-yarn-services-api\src\test\java\org\apache\hadoop\yarn\service\ServiceClientTest.java,179,34,7,1,0,42
hadoop-trunk\hadoop-trunk\hadoop-yarn-project\hadoop-yarn\hadoop-yarn-server\hadoop-yarn-server-resourcemanager\src\main\java\org\apache\hadoop\yarn\server\resourcemanager\scheduler\constraint\Evaluable.java,0,0,0,1,0,1
hadoop-trunk\hadoop-trunk\hadoop-yarn-project\hadoop-yarn\hadoop-yarn-server\hadoop-yarn-server-timelineservice-hbase\hadoop-yarn-server-timelineservice-hbase-client\src\main\java\org\apache\hadoop\yarn\server\timelineservice\storage\HBaseTimelineReaderImpl.java,0,21,0,8,0,29
hadoop-trunk\hadoop-trunk\hadoop-yarn-project\hadoop-yarn\hadoop-yarn-server\hadoop-yarn-server-nodemanager\src\test\java\org\apache\hadoop\yarn\server\nodemanager\TestRecordFactory.java,19,3,0,3,0,6
hadoop-trunk\hadoop-trunk\hadoop-common-project\hadoop-common\src\test\java\org\apache\hadoop\security\TestRaceWhenRelogin.java,117,22,4,1,0,27
hadoop-trunk\hadoop-trunk\hadoop-mapreduce-project\hadoop-mapreduce-client\hadoop-mapreduce-client-nativetask\src\test\java\org\apache\hadoop\mapred\nativetask\buffer\TestInputBuffer.java,31,1,3,1,0,5
hadoop-trunk\hadoop-trunk\hadoop-common-project\hadoop-common\src\main\java\org\apache\hadoop\io\compress\Compressor.java,0,34,11,1,0,46
hadoop-trunk\hadoop-trunk\hadoop-mapreduce-project\hadoop-mapreduce-client\hadoop-mapreduce-client-jobclient\src\test\java\org\apache\hadoop\mapred\pipes\PipeReducerStub.java,52,8,0,2,0,10
hadoop-trunk\hadoop-trunk\hadoop-mapreduce-project\hadoop-mapreduce-client\hadoop-mapreduce-client-jobclient\src\test\java\org\apache\hadoop\mapred\TestUserDefinedCounters.java,95,27,4,1,0,32
hadoop-trunk\hadoop-trunk\hadoop-mapreduce-project\hadoop-mapreduce-client\hadoop-mapreduce-client-common\src\main\java\org\apache\hadoop\mapreduce\v2\api\protocolrecords\impl\pb\KillJobResponsePBImpl.java,33,19,19,3,0,41
hadoop-trunk\hadoop-trunk\hadoop-hdfs-project\hadoop-hdfs\src\test\java\org\apache\hadoop\hdfs\TestSetTimes.java,304,82,30,7,0,119
hadoop-trunk\hadoop-trunk\hadoop-common-project\hadoop-common\src\main\java\org\apache\hadoop\metrics2\lib\MutableGaugeInt.java,66,18,0,1,0,19
hadoop-trunk\hadoop-trunk\hadoop-tools\hadoop-aws\src\test\java\org\apache\hadoop\fs\s3a\ITestDowngradeSyncable.java,76,5,2,3,0,10
hadoop-trunk\hadoop-trunk\hadoop-tools\hadoop-extras\src\main\java\org\apache\hadoop\mapred\tools\GetGroups.java,27,9,0,1,0,10
hadoop-trunk\hadoop-trunk\hadoop-common-project\hadoop-common\src\main\java\org\apache\hadoop\ipc\AlignmentContext.java,0,0,6,1,0,7
hadoop-trunk\hadoop-trunk\hadoop-tools\hadoop-rumen\src\main\java\org\apache\hadoop\tools\rumen\Histogram.java,0,21,2,1,0,24
hadoop-trunk\hadoop-trunk\hadoop-mapreduce-project\hadoop-mapreduce-client\hadoop-mapreduce-client-jobclient\src\test\java\org\apache\hadoop\mapred\TestClusterMRNotification.java,8,1,0,1,0,2
hadoop-trunk\hadoop-trunk\hadoop-common-project\hadoop-common\src\main\java\org\apache\hadoop\fs\DFCachingGetSpaceUsed.java,14,4,0,1,0,5
hadoop-trunk\hadoop-trunk\hadoop-tools\hadoop-openstack\src\test\java\org\apache\hadoop\fs\swift\TestSeek.java,0,48,7,2,0,57
hadoop-trunk\hadoop-trunk\hadoop-yarn-project\hadoop-yarn\hadoop-yarn-server\hadoop-yarn-server-nodemanager\src\main\java\org\apache\hadoop\yarn\server\nodemanager\webapp\NodePage.java,60,15,0,1,0,16
hadoop-trunk\hadoop-trunk\hadoop-hdfs-project\hadoop-hdfs\src\test\java\org\apache\hadoop\hdfs\server\blockmanagement\TestCorruptReplicaInfo.java,146,35,7,1,0,43
hadoop-trunk\hadoop-trunk\hadoop-tools\hadoop-azure\src\main\java\org\apache\hadoop\fs\azure\PageBlobFormatHelpers.java,0,14,0,1,0,15
hadoop-trunk\hadoop-trunk\hadoop-tools\hadoop-dynamometer\hadoop-dynamometer-infra\src\main\java\org\apache\hadoop\tools\dynamometer\DynoConstants.java,0,28,1,1,0,30
hadoop-trunk\hadoop-trunk\hadoop-common-project\hadoop-common\src\main\java\org\apache\hadoop\ipc\RpcWritable.java,203,49,2,1,0,52
hadoop-trunk\hadoop-trunk\hadoop-yarn-project\hadoop-yarn\hadoop-yarn-server\hadoop-yarn-server-common\src\main\java\org\apache\hadoop\yarn\server\federation\store\records\GetSubClusterInfoResponse.java,34,2,0,1,0,3
hadoop-trunk\hadoop-trunk\hadoop-yarn-project\hadoop-yarn\hadoop-yarn-applications\hadoop-yarn-applications-unmanaged-am-launcher\src\test\java\org\apache\hadoop\yarn\applications\unmanagedamlauncher\TestUnmanagedAMLauncher.java,170,27,16,6,0,49
hadoop-trunk\hadoop-trunk\hadoop-hdfs-project\hadoop-hdfs\src\test\java\org\apache\hadoop\hdfs\server\namenode\snapshot\TestSnapshotManager.java,153,16,0,1,0,17
hadoop-trunk\hadoop-trunk\hadoop-common-project\hadoop-common\src\main\java\org\apache\hadoop\fs\statistics\impl\IOStatisticsStore.java,236,0,0,1,0,1
hadoop-trunk\hadoop-trunk\hadoop-hdfs-project\hadoop-hdfs\src\test\java\org\apache\hadoop\hdfs\server\namenode\TestRedudantBlocks.java,104,21,2,1,0,24
hadoop-trunk\hadoop-trunk\hadoop-hdfs-project\hadoop-hdfs-client\src\main\java\org\apache\hadoop\hdfs\web\resources\DestinationParam.java,33,2,0,1,0,3
hadoop-trunk\hadoop-trunk\hadoop-hdfs-project\hadoop-hdfs-rbf\src\test\java\org\apache\hadoop\fs\contract\router\TestRouterHDFSContractCreateSecure.java,0,5,0,1,0,6
hadoop-trunk\hadoop-trunk\hadoop-hdfs-project\hadoop-hdfs\src\test\java\org\apache\hadoop\hdfs\server\namenode\TestPathComponents.java,84,16,0,1,0,17
hadoop-trunk\hadoop-trunk\hadoop-yarn-project\hadoop-yarn\hadoop-yarn-server\hadoop-yarn-server-nodemanager\src\main\java\org\apache\hadoop\yarn\server\nodemanager\containermanager\linux\runtime\runc\ImageManifest.java,0,67,6,2,0,75
hadoop-trunk\hadoop-trunk\hadoop-common-project\hadoop-common\src\main\java\org\apache\hadoop\io\compress\Lz4Codec.java,0,15,0,2,0,17
hadoop-trunk\hadoop-trunk\hadoop-tools\hadoop-streaming\src\test\java\org\apache\hadoop\streaming\TestStreamingExitStatus.java,0,45,14,6,0,65
hadoop-trunk\hadoop-trunk\hadoop-mapreduce-project\hadoop-mapreduce-client\hadoop-mapreduce-client-hs\src\test\java\org\apache\hadoop\mapreduce\v2\hs\webapp\TestHsJobBlock.java,211,16,4,1,0,21
hadoop-trunk\hadoop-trunk\hadoop-yarn-project\hadoop-yarn\hadoop-yarn-server\hadoop-yarn-server-common\src\main\java\org\apache\hadoop\yarn\server\federation\store\records\GetSubClusterPoliciesConfigurationsResponse.java,33,3,0,1,0,4
hadoop-trunk\hadoop-trunk\hadoop-yarn-project\hadoop-yarn\hadoop-yarn-server\hadoop-yarn-server-resourcemanager\src\main\java\org\apache\hadoop\yarn\server\resourcemanager\scheduler\constraint\algorithm\DefaultPlacementAlgorithm.java,231,30,6,14,0,50
hadoop-trunk\hadoop-trunk\hadoop-common-project\hadoop-common\src\main\java\org\apache\hadoop\fs\CanSetDropBehind.java,0,0,0,1,0,1
hadoop-trunk\hadoop-trunk\hadoop-common-project\hadoop-common\src\main\java\org\apache\hadoop\util\Lists.java,0,46,10,2,0,58
hadoop-trunk\hadoop-trunk\hadoop-yarn-project\hadoop-yarn\hadoop-yarn-api\src\main\java\org\apache\hadoop\yarn\api\protocolrecords\GetAllResourceTypeInfoResponse.java,29,7,0,2,0,9
hadoop-trunk\hadoop-trunk\hadoop-common-project\hadoop-common\src\test\java\org\apache\hadoop\cli\util\SubstringComparator.java,14,3,1,1,0,5
hadoop-trunk\hadoop-trunk\hadoop-yarn-project\hadoop-yarn\hadoop-yarn-server\hadoop-yarn-server-tests\src\test\java\org\apache\hadoop\yarn\server\timeline\TimelineVersionWatcher.java,21,5,0,1,0,6
hadoop-trunk\hadoop-trunk\hadoop-yarn-project\hadoop-yarn\hadoop-yarn-common\src\main\java\org\apache\hadoop\yarn\nodelabels\store\op\NodeToLabelOp.java,0,15,3,1,0,19
hadoop-trunk\hadoop-trunk\hadoop-hdfs-project\hadoop-hdfs\src\test\java\org\apache\hadoop\hdfs\server\common\blockaliasmap\impl\TestLevelDbMockAliasMapClient.java,81,20,2,2,0,24
hadoop-trunk\hadoop-trunk\hadoop-mapreduce-project\hadoop-mapreduce-client\hadoop-mapreduce-client-common\src\main\java\org\apache\hadoop\mapreduce\v2\api\protocolrecords\impl\pb\GetDiagnosticsResponsePBImpl.java,108,43,29,6,0,78
hadoop-trunk\hadoop-trunk\hadoop-yarn-project\hadoop-yarn\hadoop-yarn-api\src\main\java\org\apache\hadoop\yarn\api\records\ContainerId.java,215,37,7,2,0,46
hadoop-trunk\hadoop-trunk\hadoop-yarn-project\hadoop-yarn\hadoop-yarn-server\hadoop-yarn-server-timelineservice-hbase\hadoop-yarn-server-timelineservice-hbase-common\src\main\java\org\apache\hadoop\yarn\server\timelineservice\storage\subapplication\SubApplicationColumn.java,0,14,2,5,0,21
hadoop-trunk\hadoop-trunk\hadoop-mapreduce-project\hadoop-mapreduce-client\hadoop-mapreduce-client-core\src\test\java\org\apache\hadoop\mapreduce\tools\TestCLI.java,181,37,17,2,0,56
hadoop-trunk\hadoop-trunk\hadoop-cloud-storage-project\hadoop-huaweicloud\src\test\java\org\apache\hadoop\fs\obs\TestOBSContractRename.java,18,3,0,1,0,4
hadoop-trunk\hadoop-trunk\hadoop-common-project\hadoop-common\src\test\java\org\apache\hadoop\fs\TestFileSystemInitialization.java,146,21,3,1,0,25
hadoop-trunk\hadoop-trunk\hadoop-tools\hadoop-rumen\src\main\java\org\apache\hadoop\tools\rumen\JsonObjectMapperWriter.java,34,13,0,2,0,15
hadoop-trunk\hadoop-trunk\hadoop-yarn-project\hadoop-yarn\hadoop-yarn-server\hadoop-yarn-server-nodemanager\src\main\java\org\apache\hadoop\yarn\server\nodemanager\health\ExceptionReporter.java,35,8,0,1,0,9
hadoop-trunk\hadoop-trunk\hadoop-yarn-project\hadoop-yarn\hadoop-yarn-server\hadoop-yarn-server-timelineservice\src\main\java\org\apache\hadoop\yarn\server\timelineservice\reader\filter\TimelineKeyValueFilter.java,33,16,1,1,0,18
hadoop-trunk\hadoop-trunk\hadoop-tools\hadoop-aws\src\test\java\org\apache\hadoop\fs\contract\s3a\ITestS3AContractMkdir.java,8,2,0,1,0,3
hadoop-trunk\hadoop-trunk\hadoop-yarn-project\hadoop-yarn\hadoop-yarn-server\hadoop-yarn-server-nodemanager\src\main\java\org\apache\hadoop\yarn\server\nodemanager\containermanager\launcher\ContainerCleanup.java,165,32,7,9,0,48
hadoop-trunk\hadoop-trunk\hadoop-tools\hadoop-aws\src\main\java\org\apache\hadoop\fs\s3a\DefaultS3ClientFactory.java,0,10,5,3,0,18
hadoop-trunk\hadoop-trunk\hadoop-hdfs-project\hadoop-hdfs-rbf\src\main\java\org\apache\hadoop\hdfs\server\federation\store\protocol\impl\pb\GetDisabledNameservicesResponsePBImpl.java,0,13,36,5,0,54
hadoop-trunk\hadoop-trunk\hadoop-mapreduce-project\hadoop-mapreduce-client\hadoop-mapreduce-client-core\src\main\java\org\apache\hadoop\mapred\lib\DelegatingMapper.java,0,21,4,2,0,27
hadoop-trunk\hadoop-trunk\hadoop-yarn-project\hadoop-yarn\hadoop-yarn-server\hadoop-yarn-server-resourcemanager\src\main\java\org\apache\hadoop\yarn\server\resourcemanager\scheduler\event\ReleaseContainerEvent.java,22,2,0,1,0,3
hadoop-trunk\hadoop-trunk\hadoop-hdfs-project\hadoop-hdfs\src\test\java\org\apache\hadoop\hdfs\util\TestBestEffortLongFile.java,57,17,1,1,0,19
hadoop-trunk\hadoop-trunk\hadoop-common-project\hadoop-common\src\main\java\org\apache\hadoop\security\NetgroupCache.java,79,17,1,3,0,21
hadoop-trunk\hadoop-trunk\hadoop-common-project\hadoop-common\src\test\java\org\apache\hadoop\crypto\key\TestKeyShell.java,316,41,0,3,0,44
hadoop-trunk\hadoop-trunk\hadoop-hdfs-project\hadoop-hdfs-client\src\main\java\org\apache\hadoop\hdfs\web\oauth2\AccessTokenProvider.java,34,2,0,1,0,3
hadoop-trunk\hadoop-trunk\hadoop-common-project\hadoop-common\src\main\java\org\apache\hadoop\util\functional\FutureIO.java,0,2,0,1,0,3
hadoop-trunk\hadoop-trunk\hadoop-hdfs-project\hadoop-hdfs\src\test\java\org\apache\hadoop\hdfs\web\TestAuthFilter.java,39,4,2,2,0,8
hadoop-trunk\hadoop-trunk\hadoop-common-project\hadoop-auth\src\main\java\org\apache\hadoop\security\authentication\util\AuthToken.java,227,52,2,14,0,68
hadoop-trunk\hadoop-trunk\hadoop-common-project\hadoop-common\src\main\java\org\apache\hadoop\metrics2\impl\MetricCounterLong.java,0,6,0,1,0,7
hadoop-trunk\hadoop-trunk\hadoop-tools\hadoop-rumen\src\main\java\org\apache\hadoop\tools\rumen\datatypes\AnonymizableDataType.java,0,4,1,1,0,6
hadoop-trunk\hadoop-trunk\hadoop-yarn-project\hadoop-yarn\hadoop-yarn-applications\hadoop-yarn-applications-distributedshell\src\test\java\org\apache\hadoop\yarn\applications\distributedshell\TestDSFailedAppMaster.java,0,9,2,1,0,12
hadoop-trunk\hadoop-trunk\hadoop-yarn-project\hadoop-yarn\hadoop-yarn-server\hadoop-yarn-server-resourcemanager\src\main\java\org\apache\hadoop\yarn\server\resourcemanager\webapp\dao\CredentialsInfo.java,31,17,6,1,0,24
hadoop-trunk\hadoop-trunk\hadoop-common-project\hadoop-common\src\main\java\org\apache\hadoop\fs\BatchListingOperations.java,0,1,0,2,0,3
hadoop-trunk\hadoop-trunk\hadoop-yarn-project\hadoop-yarn\hadoop-yarn-server\hadoop-yarn-server-resourcemanager\src\main\java\org\apache\hadoop\yarn\server\resourcemanager\scheduler\constraint\api\ConstraintPlacementAlgorithmInput.java,0,1,0,1,0,2
hadoop-trunk\hadoop-trunk\hadoop-mapreduce-project\hadoop-mapreduce-client\hadoop-mapreduce-client-core\src\main\java\org\apache\hadoop\mapred\JobTracker.java,12,2,0,1,0,3
hadoop-trunk\hadoop-trunk\hadoop-tools\hadoop-azure\src\main\java\org\apache\hadoop\fs\azurebfs\constants\package-info.java,0,2,0,1,0,3
hadoop-trunk\hadoop-trunk\hadoop-yarn-project\hadoop-yarn\hadoop-yarn-server\hadoop-yarn-server-nodemanager\src\main\java\org\apache\hadoop\yarn\server\nodemanager\containermanager\linux\resources\gpu\GpuResourceHandlerImpl.java,157,38,6,17,0,61
hadoop-trunk\hadoop-trunk\hadoop-yarn-project\hadoop-yarn\hadoop-yarn-server\hadoop-yarn-server-common\src\main\java\org\apache\hadoop\yarn\server\api\protocolrecords\DistributedSchedulingAllocateResponse.java,30,6,0,1,0,7
hadoop-trunk\hadoop-trunk\hadoop-hdfs-project\hadoop-hdfs\src\test\java\org\apache\hadoop\hdfs\util\HostsFileWriter.java,131,38,1,1,0,40
hadoop-trunk\hadoop-trunk\hadoop-yarn-project\hadoop-yarn\hadoop-yarn-server\hadoop-yarn-server-nodemanager\src\test\java\org\apache\hadoop\yarn\server\nodemanager\containermanager\monitor\MockResourceCalculatorProcessTree.java,47,14,1,2,0,17
hadoop-trunk\hadoop-trunk\hadoop-mapreduce-project\hadoop-mapreduce-client\hadoop-mapreduce-client-hs\src\test\java\org\apache\hadoop\mapreduce\v2\hs\webapp\TestHsWebServices.java,237,30,0,2,0,32
hadoop-trunk\hadoop-trunk\hadoop-hdfs-project\hadoop-hdfs-nfs\src\test\java\org\apache\hadoop\hdfs\nfs\nfs3\TestOpenFileCtxCache.java,107,21,10,1,0,32
hadoop-trunk\hadoop-trunk\hadoop-hdfs-project\hadoop-hdfs-client\src\main\java\org\apache\hadoop\hdfs\web\resources\StringParam.java,0,4,2,1,0,7
hadoop-trunk\hadoop-trunk\hadoop-yarn-project\hadoop-yarn\hadoop-yarn-server\hadoop-yarn-server-resourcemanager\src\main\java\org\apache\hadoop\yarn\server\resourcemanager\scheduler\fair\AllocationConfigurationException.java,12,6,0,1,0,7
hadoop-trunk\hadoop-trunk\hadoop-common-project\hadoop-common\src\test\java\org\apache\hadoop\ipc\TestWeightedTimeCostProvider.java,55,13,0,4,0,17
hadoop-trunk\hadoop-trunk\hadoop-hdfs-project\hadoop-hdfs\src\main\java\org\apache\hadoop\hdfs\server\datanode\checker\ThrottledAsyncChecker.java,0,29,3,5,0,37
hadoop-trunk\hadoop-trunk\hadoop-common-project\hadoop-common\src\test\java\org\apache\hadoop\http\TestHttpServerWebapps.java,38,4,1,1,0,6
hadoop-trunk\hadoop-trunk\hadoop-mapreduce-project\hadoop-mapreduce-client\hadoop-mapreduce-client-app\src\main\java\org\apache\hadoop\mapreduce\v2\app\job\event\JobTaskAttemptFetchFailureEvent.java,28,16,0,1,0,17
hadoop-trunk\hadoop-trunk\hadoop-tools\hadoop-azure\src\test\java\org\apache\hadoop\fs\azurebfs\TestTracingContext.java,150,12,1,5,0,18
hadoop-trunk\hadoop-trunk\hadoop-yarn-project\hadoop-yarn\hadoop-yarn-common\src\main\java\org\apache\hadoop\yarn\logaggregation\filecontroller\tfile\package-info.java,0,2,0,1,0,3
hadoop-trunk\hadoop-trunk\hadoop-yarn-project\hadoop-yarn\hadoop-yarn-server\hadoop-yarn-server-common\src\main\java\org\apache\hadoop\yarn\server\federation\policies\manager\WeightedLocalityPolicyManager.java,0,9,0,5,0,14
hadoop-trunk\hadoop-trunk\hadoop-mapreduce-project\hadoop-mapreduce-client\hadoop-mapreduce-client-nativetask\src\main\java\org\apache\hadoop\mapred\nativetask\HadoopPlatform.java,46,13,3,2,0,18
hadoop-trunk\hadoop-trunk\hadoop-mapreduce-project\hadoop-mapreduce-client\hadoop-mapreduce-client-core\src\main\java\org\apache\hadoop\mapreduce\lib\output\committer\manifest\stages\SetupTaskStage.java,0,1,0,2,0,3
hadoop-trunk\hadoop-trunk\hadoop-hdfs-project\hadoop-hdfs-client\src\test\java\org\apache\hadoop\hdfs\TestDFSPacket.java,44,19,0,2,0,21
hadoop-trunk\hadoop-trunk\hadoop-common-project\hadoop-common\src\test\java\org\apache\hadoop\metrics2\sink\ganglia\GangliaMetricsTestHelper.java,15,6,1,1,0,8
hadoop-trunk\hadoop-trunk\hadoop-yarn-project\hadoop-yarn\hadoop-yarn-server\hadoop-yarn-server-resourcemanager\src\main\java\org\apache\hadoop\yarn\server\resourcemanager\webapp\dao\NewApplication.java,28,18,0,1,0,19
hadoop-trunk\hadoop-trunk\hadoop-hdfs-project\hadoop-hdfs-rbf\src\main\java\org\apache\hadoop\hdfs\server\federation\store\protocol\GetRouterRegistrationResponse.java,15,4,0,2,0,6
hadoop-trunk\hadoop-trunk\hadoop-hdfs-project\hadoop-hdfs\src\main\java\org\apache\hadoop\hdfs\tools\offlineEditsViewer\XmlEditsVisitor.java,94,30,7,2,0,39
hadoop-trunk\hadoop-trunk\hadoop-yarn-project\hadoop-yarn\hadoop-yarn-server\hadoop-yarn-server-nodemanager\src\main\java\org\apache\hadoop\yarn\server\nodemanager\containermanager\resourceplugin\fpga\discovery\package-info.java,0,0,0,2,0,2
hadoop-trunk\hadoop-trunk\hadoop-common-project\hadoop-common\src\main\java\org\apache\hadoop\security\IdMappingServiceProvider.java,0,17,10,1,0,28
hadoop-trunk\hadoop-trunk\hadoop-common-project\hadoop-common\src\test\java\org\apache\hadoop\security\token\delegation\web\TestWebDelegationToken.java,955,134,9,18,0,161
hadoop-trunk\hadoop-trunk\hadoop-tools\hadoop-aws\src\main\java\org\apache\hadoop\fs\s3a\MultipartUtils.java,0,25,3,2,0,30
hadoop-trunk\hadoop-trunk\hadoop-tools\hadoop-azure-datalake\src\main\java\org\apache\hadoop\fs\adl\AdlFileSystem.java,975,84,10,2,0,96
hadoop-trunk\hadoop-trunk\hadoop-tools\hadoop-azure-datalake\src\main\java\org\apache\hadoop\fs\adl\oauth2\AzureADTokenProvider.java,37,0,0,1,0,1
hadoop-trunk\hadoop-trunk\hadoop-yarn-project\hadoop-yarn\hadoop-yarn-api\src\main\java\org\apache\hadoop\yarn\server\api\AuxiliaryService.java,109,20,2,2,0,24
hadoop-trunk\hadoop-trunk\hadoop-common-project\hadoop-nfs\src\main\java\org\apache\hadoop\nfs\nfs3\request\READLINK3Request.java,17,11,0,1,0,12
hadoop-trunk\hadoop-trunk\hadoop-yarn-project\hadoop-yarn\hadoop-yarn-server\hadoop-yarn-server-resourcemanager\src\test\java\org\apache\hadoop\yarn\server\resourcemanager\scheduler\fair\TestFSSchedulerNode.java,0,31,2,1,0,34
hadoop-trunk\hadoop-trunk\hadoop-mapreduce-project\hadoop-mapreduce-client\hadoop-mapreduce-client-hs\src\main\java\org\apache\hadoop\mapreduce\v2\hs\CompletedTaskAttempt.java,148,31,1,1,0,33
hadoop-trunk\hadoop-trunk\hadoop-yarn-project\hadoop-yarn\hadoop-yarn-server\hadoop-yarn-server-timelineservice-hbase-tests\src\test\java\org\apache\hadoop\yarn\server\timelineservice\storage\flow\TestHBaseStorageFlowRunCompaction.java,791,66,27,8,0,101
hadoop-trunk\hadoop-trunk\hadoop-hdfs-project\hadoop-hdfs\src\main\java\org\apache\hadoop\hdfs\server\blockmanagement\ProvidedStorageMap.java,482,80,16,2,0,98
hadoop-trunk\hadoop-trunk\hadoop-mapreduce-project\hadoop-mapreduce-client\hadoop-mapreduce-client-core\src\test\java\org\apache\hadoop\mapreduce\lib\output\committer\manifest\CommitterTestBinding.java,109,7,6,5,0,18
hadoop-trunk\hadoop-trunk\hadoop-mapreduce-project\hadoop-mapreduce-client\hadoop-mapreduce-client-core\src\main\java\org\apache\hadoop\mapreduce\lib\join\JoinRecordReader.java,0,25,0,1,0,26
hadoop-trunk\hadoop-trunk\hadoop-common-project\hadoop-common\src\test\java\org\apache\hadoop\fs\TestTrash.java,0,305,37,5,0,347
hadoop-trunk\hadoop-trunk\hadoop-yarn-project\hadoop-yarn\hadoop-yarn-api\src\main\java\org\apache\hadoop\yarn\api\protocolrecords\SignalContainerResponse.java,3,1,1,1,0,3
hadoop-trunk\hadoop-trunk\hadoop-yarn-project\hadoop-yarn\hadoop-yarn-server\hadoop-yarn-server-common\src\main\java\org\apache\hadoop\yarn\server\federation\store\metrics\package-info.java,0,0,0,1,0,1
hadoop-trunk\hadoop-trunk\hadoop-hdfs-project\hadoop-hdfs\src\main\java\org\apache\hadoop\hdfs\server\datanode\erasurecode\StripedReconstructionInfo.java,0,58,0,1,0,59
hadoop-trunk\hadoop-trunk\hadoop-yarn-project\hadoop-yarn\hadoop-yarn-server\hadoop-yarn-server-resourcemanager\src\main\java\org\apache\hadoop\yarn\server\resourcemanager\scheduler\activities\ActivityNode.java,121,56,2,2,0,60
hadoop-trunk\hadoop-trunk\hadoop-tools\hadoop-azure\src\test\java\org\apache\hadoop\fs\azurebfs\services\TestShellDecryptionKeyProvider.java,53,7,3,4,0,14
hadoop-trunk\hadoop-trunk\hadoop-yarn-project\hadoop-yarn\hadoop-yarn-server\hadoop-yarn-server-nodemanager\src\test\java\org\apache\hadoop\yarn\server\nodemanager\security\TestNMTokenSecretManagerInNM.java,113,2,3,2,0,7
hadoop-trunk\hadoop-trunk\hadoop-common-project\hadoop-common\src\main\java\org\apache\hadoop\io\DataInputByteBuffer.java,75,29,1,1,0,31
hadoop-trunk\hadoop-trunk\hadoop-mapreduce-project\hadoop-mapreduce-client\hadoop-mapreduce-client-common\src\main\java\org\apache\hadoop\mapreduce\v2\api\HSAdminProtocol.java,0,1,0,2,0,3
hadoop-trunk\hadoop-trunk\hadoop-yarn-project\hadoop-yarn\hadoop-yarn-server\hadoop-yarn-server-timelineservice\src\main\java\org\apache\hadoop\yarn\server\timelineservice\reader\TimelineParserForEqualityExpr.java,298,38,1,7,0,46
hadoop-trunk\hadoop-trunk\hadoop-tools\hadoop-aws\src\main\java\org\apache\hadoop\fs\s3a\auth\delegation\DelegationOperations.java,0,0,0,1,0,1
hadoop-trunk\hadoop-trunk\hadoop-yarn-project\hadoop-yarn\hadoop-yarn-server\hadoop-yarn-server-nodemanager\src\main\java\org\apache\hadoop\yarn\server\nodemanager\health\HealthReporter.java,0,0,0,1,0,1
hadoop-trunk\hadoop-trunk\hadoop-hdfs-project\hadoop-hdfs-client\src\test\java\org\apache\hadoop\hdfs\web\TestURLConnectionFactory.java,0,7,3,3,0,13
hadoop-trunk\hadoop-trunk\hadoop-mapreduce-project\hadoop-mapreduce-client\hadoop-mapreduce-client-app\src\main\java\org\apache\hadoop\mapreduce\v2\app\speculate\NullTaskRuntimesEngine.java,42,16,0,2,0,18
hadoop-trunk\hadoop-trunk\hadoop-common-project\hadoop-common\src\main\java\org\apache\hadoop\fs\viewfs\ChRootedFileSystem.java,0,103,4,5,0,112
hadoop-trunk\hadoop-trunk\hadoop-yarn-project\hadoop-yarn\hadoop-yarn-server\hadoop-yarn-server-resourcemanager\src\test\java\org\apache\hadoop\yarn\server\resourcemanager\scheduler\capacity\TestCSQueueStore.java,306,41,3,1,0,45
hadoop-trunk\hadoop-trunk\hadoop-mapreduce-project\hadoop-mapreduce-client\hadoop-mapreduce-client-common\src\main\java\org\apache\hadoop\mapreduce\v2\api\records\JobState.java,0,7,0,1,0,8
hadoop-trunk\hadoop-trunk\hadoop-hdfs-project\hadoop-hdfs\src\main\java\org\apache\hadoop\hdfs\server\protocol\NamenodeProtocols.java,3,0,0,1,0,1
hadoop-trunk\hadoop-trunk\hadoop-yarn-project\hadoop-yarn\hadoop-yarn-server\hadoop-yarn-server-resourcemanager\src\main\java\org\apache\hadoop\yarn\server\resourcemanager\scheduler\PartitionQueueMetrics.java,64,9,2,1,0,12
hadoop-trunk\hadoop-trunk\hadoop-yarn-project\hadoop-yarn\hadoop-yarn-common\src\main\java\org\apache\hadoop\yarn\metrics\CustomResourceMetrics.java,101,35,0,1,0,36
hadoop-trunk\hadoop-trunk\hadoop-yarn-project\hadoop-yarn\hadoop-yarn-common\src\main\java\org\apache\hadoop\yarn\api\impl\pb\client\package-info.java,0,1,0,1,0,2
hadoop-trunk\hadoop-trunk\hadoop-mapreduce-project\hadoop-mapreduce-client\hadoop-mapreduce-client-jobclient\src\test\java\org\apache\hadoop\mapreduce\lib\partition\TestKeyFieldHelper.java,407,93,19,1,0,113
hadoop-trunk\hadoop-trunk\hadoop-hdfs-project\hadoop-hdfs\src\test\java\org\apache\hadoop\hdfs\server\datanode\TestHSync.java,168,40,0,7,0,47
hadoop-trunk\hadoop-trunk\hadoop-yarn-project\hadoop-yarn\hadoop-yarn-applications\hadoop-yarn-services\hadoop-yarn-services-core\src\main\java\org\apache\hadoop\yarn\service\package-info.java,0,0,0,1,0,1
hadoop-trunk\hadoop-trunk\hadoop-yarn-project\hadoop-yarn\hadoop-yarn-server\hadoop-yarn-server-resourcemanager\src\main\java\org\apache\hadoop\yarn\server\resourcemanager\webapp\dao\AllocationTagInfo.java,28,11,0,1,0,12
hadoop-trunk\hadoop-trunk\hadoop-yarn-project\hadoop-yarn\hadoop-yarn-server\hadoop-yarn-server-nodemanager\src\test\java\org\apache\hadoop\yarn\server\nodemanager\containermanager\scheduler\TestContainerSchedulerRecovery.java,295,38,3,5,0,46
hadoop-trunk\hadoop-trunk\hadoop-tools\hadoop-aliyun\src\main\java\org\apache\hadoop\fs\aliyun\oss\AliyunCredentialsProvider.java,53,7,1,1,0,9
hadoop-trunk\hadoop-trunk\hadoop-common-project\hadoop-common\src\main\java\org\apache\hadoop\io\erasurecode\rawcoder\RawErasureDecoder.java,177,19,0,2,0,21
hadoop-trunk\hadoop-trunk\hadoop-common-project\hadoop-common\src\test\java\org\apache\hadoop\cli\CLITestHelper.java,421,148,51,1,0,200
hadoop-trunk\hadoop-trunk\hadoop-hdfs-project\hadoop-hdfs-httpfs\src\main\java\org\apache\hadoop\fs\http\server\HttpFSServerWebApp.java,116,20,1,1,0,22
hadoop-trunk\hadoop-trunk\hadoop-tools\hadoop-aws\src\main\java\org\apache\hadoop\fs\s3a\S3ALocatedFileStatus.java,81,15,2,2,0,19
hadoop-trunk\hadoop-trunk\hadoop-tools\hadoop-azure\src\test\java\org\apache\hadoop\fs\azure\contract\ITestAzureNativeContractCreate.java,8,2,0,1,0,3
hadoop-trunk\hadoop-trunk\hadoop-mapreduce-project\hadoop-mapreduce-client\hadoop-mapreduce-client-common\src\main\java\org\apache\hadoop\mapreduce\v2\api\records\impl\pb\TaskAttemptReportPBImpl.java,355,98,116,3,0,217
hadoop-trunk\hadoop-trunk\hadoop-tools\hadoop-azure\src\test\java\org\apache\hadoop\fs\azurebfs\services\TestAbfsClientThrottlingAnalyzer.java,149,24,0,4,0,28
hadoop-trunk\hadoop-trunk\hadoop-yarn-project\hadoop-yarn\hadoop-yarn-client\src\test\java\org\apache\hadoop\yarn\client\api\impl\TestAHSv2ClientImpl.java,197,23,0,1,0,24
hadoop-trunk\hadoop-trunk\hadoop-yarn-project\hadoop-yarn\hadoop-yarn-server\hadoop-yarn-server-resourcemanager\src\main\java\org\apache\hadoop\yarn\server\resourcemanager\placement\csmappingrule\MappingRuleResultType.java,0,0,0,1,0,1
hadoop-trunk\hadoop-trunk\hadoop-mapreduce-project\hadoop-mapreduce-client\hadoop-mapreduce-client-core\src\main\java\org\apache\hadoop\mapreduce\lib\input\SequenceFileAsTextInputFormat.java,0,6,1,1,0,8
hadoop-trunk\hadoop-trunk\hadoop-common-project\hadoop-common\src\main\java\org\apache\hadoop\crypto\key\kms\KMSRESTConstants.java,41,33,0,1,0,34
hadoop-trunk\hadoop-trunk\hadoop-mapreduce-project\hadoop-mapreduce-client\hadoop-mapreduce-client-core\src\main\java\org\apache\hadoop\mapreduce\util\ResourceBundles.java,65,21,2,1,0,24
hadoop-trunk\hadoop-trunk\hadoop-hdfs-project\hadoop-hdfs-rbf\src\test\java\org\apache\hadoop\hdfs\server\federation\router\TestFederationUtil.java,35,1,0,3,0,4
hadoop-trunk\hadoop-trunk\hadoop-yarn-project\hadoop-yarn\hadoop-yarn-server\hadoop-yarn-server-resourcemanager\src\main\java\org\apache\hadoop\yarn\server\resourcemanager\reservation\PeriodicRLESparseResourceAllocation.java,0,21,6,1,0,28
hadoop-trunk\hadoop-trunk\hadoop-mapreduce-project\hadoop-mapreduce-client\hadoop-mapreduce-client-common\src\main\java\org\apache\hadoop\mapreduce\v2\api\records\TaskReport.java,0,102,32,1,0,135
hadoop-trunk\hadoop-trunk\hadoop-tools\hadoop-azure\src\test\java\org\apache\hadoop\fs\azurebfs\commit\ITestAbfsTerasort.java,290,24,9,9,0,42
hadoop-trunk\hadoop-trunk\hadoop-common-project\hadoop-common\src\test\java\org\apache\hadoop\fs\shell\TestCopyPreserveFlag.java,190,61,0,1,0,62
hadoop-trunk\hadoop-trunk\hadoop-mapreduce-project\hadoop-mapreduce-client\hadoop-mapreduce-client-jobclient\src\test\java\org\apache\hadoop\mapred\TestCombineSequenceFileInputFormat.java,131,45,3,1,0,49
hadoop-trunk\hadoop-trunk\hadoop-yarn-project\hadoop-yarn\hadoop-yarn-applications\hadoop-yarn-services\hadoop-yarn-services-core\src\main\java\org\apache\hadoop\yarn\service\component\NeverRestartPolicy.java,0,10,4,1,0,15
hadoop-trunk\hadoop-trunk\hadoop-common-project\hadoop-common\src\main\java\org\apache\hadoop\crypto\key\kms\LoadBalancingKMSClientProvider.java,0,83,23,2,0,108
hadoop-trunk\hadoop-trunk\hadoop-yarn-project\hadoop-yarn\hadoop-yarn-common\src\main\java\org\apache\hadoop\yarn\api\protocolrecords\impl\pb\UpdateApplicationPriorityResponsePBImpl.java,103,23,35,4,0,62
hadoop-trunk\hadoop-trunk\hadoop-yarn-project\hadoop-yarn\hadoop-yarn-server\hadoop-yarn-server-nodemanager\src\main\java\org\apache\hadoop\yarn\server\nodemanager\NodeManager.java,0,261,25,29,0,315
hadoop-trunk\hadoop-trunk\hadoop-tools\hadoop-streaming\src\main\java\org\apache\hadoop\streaming\AutoInputFormat.java,36,14,5,1,0,20
hadoop-trunk\hadoop-trunk\hadoop-mapreduce-project\hadoop-mapreduce-client\hadoop-mapreduce-client-common\src\main\java\org\apache\hadoop\mapreduce\v2\api\protocolrecords\CancelDelegationTokenRequest.java,0,2,0,1,0,3
hadoop-trunk\hadoop-trunk\hadoop-hdfs-project\hadoop-hdfs\src\test\java\org\apache\hadoop\cli\TestAclCLIWithPosixAclInheritance.java,20,2,0,2,0,4
hadoop-trunk\hadoop-trunk\hadoop-yarn-project\hadoop-yarn\hadoop-yarn-server\hadoop-yarn-server-nodemanager\src\main\java\org\apache\hadoop\yarn\server\nodemanager\nodelabels\NodeLabelsProvider.java,0,4,0,1,0,5
hadoop-trunk\hadoop-trunk\hadoop-mapreduce-project\hadoop-mapreduce-client\hadoop-mapreduce-client-core\src\main\java\org\apache\hadoop\mapreduce\task\reduce\package-info.java,0,1,0,1,0,2
hadoop-trunk\hadoop-trunk\hadoop-common-project\hadoop-nfs\src\main\java\org\apache\hadoop\nfs\AccessPrivilege.java,0,5,0,1,0,6
hadoop-trunk\hadoop-trunk\hadoop-yarn-project\hadoop-yarn\hadoop-yarn-server\hadoop-yarn-server-nodemanager\src\main\java\org\apache\hadoop\yarn\server\nodemanager\DeletionService.java,0,31,8,6,0,45
hadoop-trunk\hadoop-trunk\hadoop-hdfs-project\hadoop-hdfs\src\main\java\org\apache\hadoop\hdfs\server\namenode\FSImageUtil.java,0,15,10,1,0,26
hadoop-trunk\hadoop-trunk\hadoop-tools\hadoop-rumen\src\test\java\org\apache\hadoop\tools\rumen\TestRandomSeedGenerator.java,17,6,5,1,0,12
hadoop-trunk\hadoop-trunk\hadoop-hdfs-project\hadoop-hdfs\src\test\java\org\apache\hadoop\hdfs\web\TestWebHdfsWithRestCsrfPreventionFilter.java,0,28,2,5,0,35
hadoop-trunk\hadoop-trunk\hadoop-hdfs-project\hadoop-hdfs-client\src\main\java\org\apache\hadoop\hdfs\protocol\AclException.java,23,3,0,1,0,4
hadoop-trunk\hadoop-trunk\hadoop-mapreduce-project\hadoop-mapreduce-client\hadoop-mapreduce-client-jobclient\src\test\java\org\apache\hadoop\mapred\GenericMRLoadGenerator.java,653,174,29,5,0,208
hadoop-trunk\hadoop-trunk\hadoop-mapreduce-project\hadoop-mapreduce-client\hadoop-mapreduce-client-app\src\main\java\org\apache\hadoop\mapreduce\v2\app\job\event\TaskAttemptKillEvent.java,28,16,0,1,0,17
hadoop-trunk\hadoop-trunk\hadoop-yarn-project\hadoop-yarn\hadoop-yarn-api\src\main\java\org\apache\hadoop\yarn\api\protocolrecords\MoveApplicationAcrossQueuesResponse.java,10,4,1,2,0,7
hadoop-trunk\hadoop-trunk\hadoop-common-project\hadoop-common\src\test\java\org\apache\hadoop\util\TestLists.java,115,20,0,1,0,21
hadoop-trunk\hadoop-trunk\hadoop-hdfs-project\hadoop-hdfs\src\test\java\org\apache\hadoop\hdfs\server\namenode\TestBlockPlacementPolicyRackFaultTolerant.java,167,40,3,5,0,48
hadoop-trunk\hadoop-trunk\hadoop-yarn-project\hadoop-yarn\hadoop-yarn-common\src\main\java\org\apache\hadoop\yarn\server\metrics\ContainerMetricsConstants.java,71,23,0,1,0,24
hadoop-trunk\hadoop-trunk\hadoop-hdfs-project\hadoop-hdfs\src\main\java\org\apache\hadoop\hdfs\server\namenode\StartupProgressServlet.java,100,25,1,2,0,28
hadoop-trunk\hadoop-trunk\hadoop-yarn-project\hadoop-yarn\hadoop-yarn-applications\hadoop-yarn-services\hadoop-yarn-services-core\src\main\java\org\apache\hadoop\yarn\service\utils\ConfigUtils.java,17,6,1,2,0,9
hadoop-trunk\hadoop-trunk\hadoop-tools\hadoop-azure\src\main\java\org\apache\hadoop\fs\azurebfs\oauth2\CustomTokenProviderAdapter.java,0,10,3,5,0,18
hadoop-trunk\hadoop-trunk\hadoop-mapreduce-project\hadoop-mapreduce-client\hadoop-mapreduce-client-common\src\main\java\org\apache\hadoop\mapreduce\v2\api\HSAdminRefreshProtocol.java,0,11,4,2,0,17
hadoop-trunk\hadoop-trunk\hadoop-yarn-project\hadoop-yarn\hadoop-yarn-common\src\main\java\org\apache\hadoop\yarn\logaggregation\filecontroller\LogAggregationFileControllerContext.java,97,65,0,1,0,66
hadoop-trunk\hadoop-trunk\hadoop-yarn-project\hadoop-yarn\hadoop-yarn-common\src\main\java\org\apache\hadoop\yarn\webapp\view\package-info.java,0,1,0,1,0,2
hadoop-trunk\hadoop-trunk\hadoop-hdfs-project\hadoop-hdfs\src\main\java\org\apache\hadoop\hdfs\server\namenode\web\resources\NamenodeWebHdfsMethods.java,1482,388,18,47,0,453
hadoop-trunk\hadoop-trunk\hadoop-hdfs-project\hadoop-hdfs-nfs\src\main\java\org\apache\hadoop\hdfs\nfs\nfs3\Nfs3HttpServer.java,0,12,2,1,0,15
hadoop-trunk\hadoop-trunk\hadoop-mapreduce-project\hadoop-mapreduce-client\hadoop-mapreduce-client-shuffle\src\main\java\org\apache\hadoop\mapred\FadvisedChunkedFile.java,73,28,3,1,0,32
hadoop-trunk\hadoop-trunk\hadoop-hdfs-project\hadoop-hdfs\src\test\java\org\apache\hadoop\fs\viewfs\TestViewFileSystemLinkFallback.java,862,27,12,1,0,40
hadoop-trunk\hadoop-trunk\hadoop-yarn-project\hadoop-yarn\hadoop-yarn-server\hadoop-yarn-server-resourcemanager\src\main\java\org\apache\hadoop\yarn\server\resourcemanager\resource\ResourceProfilesManagerImpl.java,200,30,16,1,0,47
hadoop-trunk\hadoop-trunk\hadoop-common-project\hadoop-common\src\test\java\org\apache\hadoop\fs\viewfs\TestViewFsURIs.java,10,1,0,1,0,2
hadoop-trunk\hadoop-trunk\hadoop-common-project\hadoop-common\src\main\java\org\apache\hadoop\fs\shell\Truncate.java,85,45,2,1,0,48
hadoop-trunk\hadoop-trunk\hadoop-common-project\hadoop-common\src\main\java\org\apache\hadoop\fs\viewfs\InodeTree.java,901,109,14,1,0,124
hadoop-trunk\hadoop-trunk\hadoop-tools\hadoop-streaming\src\test\java\org\apache\hadoop\streaming\TestStreamingKeyValue.java,0,60,6,1,0,67
hadoop-trunk\hadoop-trunk\hadoop-tools\hadoop-azure\src\main\java\org\apache\hadoop\fs\azurebfs\oauth2\ClientCredsTokenProvider.java,33,12,0,4,0,16
hadoop-trunk\hadoop-trunk\hadoop-tools\hadoop-azure\src\test\java\org\apache\hadoop\fs\azure\ITestWasbUriAndConfiguration.java,607,100,17,11,0,128
hadoop-trunk\hadoop-trunk\hadoop-hdfs-project\hadoop-hdfs\src\test\java\org\apache\hadoop\hdfs\TestDFSShellGenericOptions.java,90,46,2,2,0,50
hadoop-trunk\hadoop-trunk\hadoop-common-project\hadoop-common\src\main\java\org\apache\hadoop\security\token\delegation\web\DelegationTokenIdentifier.java,0,11,0,2,0,13
hadoop-trunk\hadoop-trunk\hadoop-tools\hadoop-dynamometer\hadoop-dynamometer-infra\src\test\java\org\apache\hadoop\tools\dynamometer\TestDynamometerInfra.java,0,60,5,7,0,72
hadoop-trunk\hadoop-trunk\hadoop-yarn-project\hadoop-yarn\hadoop-yarn-server\hadoop-yarn-server-applicationhistoryservice\src\test\java\org\apache\hadoop\yarn\server\timeline\TestMemoryTimelineStore.java,68,15,4,1,0,20
hadoop-trunk\hadoop-trunk\hadoop-yarn-project\hadoop-yarn\hadoop-yarn-server\hadoop-yarn-server-nodemanager\src\main\java\org\apache\hadoop\yarn\server\nodemanager\containermanager\localizer\security\LocalizerTokenSelector.java,23,4,1,2,0,7
hadoop-trunk\hadoop-trunk\hadoop-common-project\hadoop-common\src\test\java\org\apache\hadoop\io\erasurecode\rawcoder\TestRawErasureCoderBenchmark.java,40,26,0,1,0,27
hadoop-trunk\hadoop-trunk\hadoop-yarn-project\hadoop-yarn\hadoop-yarn-server\hadoop-yarn-server-nodemanager\src\main\java\org\apache\hadoop\yarn\server\nodemanager\containermanager\linux\runtime\DelegatingLinuxContainerRuntime.java,256,49,3,7,0,59
hadoop-trunk\hadoop-trunk\hadoop-hdfs-project\hadoop-hdfs-rbf\src\main\java\org\apache\hadoop\hdfs\server\federation\resolver\FederationNamespaceInfo.java,95,15,0,1,0,16
hadoop-trunk\hadoop-trunk\hadoop-hdfs-project\hadoop-hdfs-rbf\src\main\java\org\apache\hadoop\hdfs\server\federation\resolver\order\RouterResolver.java,0,5,0,1,0,6
hadoop-trunk\hadoop-trunk\hadoop-yarn-project\hadoop-yarn\hadoop-yarn-server\hadoop-yarn-server-nodemanager\src\main\java\org\apache\hadoop\yarn\server\nodemanager\containermanager\localizer\LocalResourcesTrackerImpl.java,0,90,24,9,0,123
hadoop-trunk\hadoop-trunk\hadoop-common-project\hadoop-common\src\test\java\org\apache\hadoop\util\TestStringUtils.java,0,180,14,12,0,206
hadoop-trunk\hadoop-trunk\hadoop-tools\hadoop-azure\src\test\java\org\apache\hadoop\fs\azurebfs\ITestAzureBlobFileSystemMkDir.java,107,9,1,3,0,13
hadoop-trunk\hadoop-trunk\hadoop-yarn-project\hadoop-yarn\hadoop-yarn-server\hadoop-yarn-server-resourcemanager\src\main\java\org\apache\hadoop\yarn\server\resourcemanager\volume\csi\processor\VolumeAMSProcessor.java,115,21,1,11,0,33
hadoop-trunk\hadoop-trunk\hadoop-common-project\hadoop-common\src\test\java\org\apache\hadoop\metrics2\util\TestSampleStat.java,42,14,1,5,0,20
hadoop-trunk\hadoop-trunk\hadoop-mapreduce-project\hadoop-mapreduce-client\hadoop-mapreduce-client-core\src\main\java\org\apache\hadoop\mapreduce\lib\output\committer\manifest\stages\CommitJobStage.java,0,25,7,11,0,43
hadoop-trunk\hadoop-trunk\hadoop-tools\hadoop-openstack\src\main\java\org\apache\hadoop\fs\swift\util\SwiftTestUtils.java,0,121,7,4,0,132
hadoop-trunk\hadoop-trunk\hadoop-hdfs-project\hadoop-hdfs\src\main\java\org\apache\hadoop\hdfs\server\blockmanagement\SlowPeerTracker.java,243,37,3,1,0,41
hadoop-trunk\hadoop-trunk\hadoop-yarn-project\hadoop-yarn\hadoop-yarn-server\hadoop-yarn-server-resourcemanager\src\test\java\org\apache\hadoop\yarn\server\resourcemanager\placement\TestAppNameMappingPlacementRule.java,183,42,3,7,0,52
hadoop-trunk\hadoop-trunk\hadoop-yarn-project\hadoop-yarn\hadoop-yarn-server\hadoop-yarn-server-common\src\main\java\org\apache\hadoop\yarn\server\federation\store\records\impl\pb\GetSubClusterPolicyConfigurationResponsePBImpl.java,0,19,36,6,0,61
hadoop-trunk\hadoop-trunk\hadoop-yarn-project\hadoop-yarn\hadoop-yarn-server\hadoop-yarn-server-common\src\main\java\org\apache\hadoop\yarn\server\federation\store\records\impl\pb\GetSubClusterPoliciesConfigurationsRequestPBImpl.java,0,13,23,3,0,39
hadoop-trunk\hadoop-trunk\hadoop-common-project\hadoop-common\src\test\java\org\apache\hadoop\io\compress\TestGzipCodec.java,128,24,1,1,0,26
hadoop-trunk\hadoop-trunk\hadoop-hdfs-project\hadoop-hdfs-client\src\main\java\org\apache\hadoop\hdfs\protocol\NoECPolicySetException.java,8,2,0,1,0,3
hadoop-trunk\hadoop-trunk\hadoop-tools\hadoop-aliyun\src\test\java\org\apache\hadoop\fs\aliyun\oss\TestAliyunOSSFileSystemContract.java,0,53,6,1,0,60
hadoop-trunk\hadoop-trunk\hadoop-common-project\hadoop-common\src\main\java\org\apache\hadoop\fs\Stat.java,133,43,4,3,0,50
hadoop-trunk\hadoop-trunk\hadoop-yarn-project\hadoop-yarn\hadoop-yarn-client\src\main\java\org\apache\hadoop\yarn\client\util\package-info.java,0,1,0,1,0,2
hadoop-trunk\hadoop-trunk\hadoop-yarn-project\hadoop-yarn\hadoop-yarn-common\src\main\java\org\apache\hadoop\yarn\webapp\hamlet2\Hamlet.java,0,10779,1002,17,0,11798
hadoop-trunk\hadoop-trunk\hadoop-yarn-project\hadoop-yarn\hadoop-yarn-server\hadoop-yarn-server-resourcemanager\src\test\java\org\apache\hadoop\yarn\server\resourcemanager\monitor\capacity\mockframework\MockContainers.java,0,21,0,7,0,28
hadoop-trunk\hadoop-trunk\hadoop-yarn-project\hadoop-yarn\hadoop-yarn-applications\hadoop-yarn-services\hadoop-yarn-services-core\src\main\java\org\apache\hadoop\yarn\service\timelineservice\ServiceTimelinePublisher.java,351,64,7,3,0,74
hadoop-trunk\hadoop-trunk\hadoop-hdfs-project\hadoop-hdfs-rbf\src\main\java\org\apache\hadoop\hdfs\server\federation\store\protocol\impl\pb\AddMountTableEntryRequestPBImpl.java,0,14,35,6,0,55
hadoop-trunk\hadoop-trunk\hadoop-hdfs-project\hadoop-hdfs\src\main\java\org\apache\hadoop\hdfs\qjournal\protocolPB\QJournalProtocolServerSideTranslatorPB.java,299,82,101,46,0,229
hadoop-trunk\hadoop-trunk\hadoop-mapreduce-project\hadoop-mapreduce-client\hadoop-mapreduce-client-common\src\main\java\org\apache\hadoop\mapreduce\v2\security\client\package-info.java,0,1,0,1,0,2
hadoop-trunk\hadoop-trunk\hadoop-mapreduce-project\hadoop-mapreduce-client\hadoop-mapreduce-client-jobclient\src\test\java\org\apache\hadoop\mapreduce\v2\TestNonExistentJob.java,0,13,13,7,0,33
hadoop-trunk\hadoop-trunk\hadoop-hdfs-project\hadoop-hdfs\src\test\java\org\apache\hadoop\hdfs\server\namenode\snapshot\TestSnapshotStatsMXBean.java,48,2,0,2,0,4
hadoop-trunk\hadoop-trunk\hadoop-hdfs-project\hadoop-hdfs\src\test\java\org\apache\hadoop\hdfs\web\TestJsonUtil.java,0,117,17,7,0,141
hadoop-trunk\hadoop-trunk\hadoop-hdfs-project\hadoop-hdfs-httpfs\src\test\java\org\apache\hadoop\fs\http\client\TestHttpFSFWithSWebhdfsFileSystem.java,0,12,3,2,0,17
hadoop-trunk\hadoop-trunk\hadoop-yarn-project\hadoop-yarn\hadoop-yarn-server\hadoop-yarn-server-timelineservice-documentstore\src\test\java\org\apache\hadoop\yarn\server\timelineservice\documentstore\writer\DummyDocumentStoreWriter.java,0,6,6,3,0,15
hadoop-trunk\hadoop-trunk\hadoop-common-project\hadoop-common\src\test\java\org\apache\hadoop\metrics2\lib\TestInterns.java,53,11,4,1,0,16
hadoop-trunk\hadoop-trunk\hadoop-common-project\hadoop-common\src\main\java\org\apache\hadoop\http\lib\StaticUserWebFilter.java,103,27,1,3,0,31
hadoop-trunk\hadoop-trunk\hadoop-common-project\hadoop-common\src\main\java\org\apache\hadoop\io\erasurecode\ECSchema.java,0,34,4,1,0,39
hadoop-trunk\hadoop-trunk\hadoop-tools\hadoop-resourceestimator\src\main\java\org\apache\hadoop\resourceestimator\solver\exceptions\SolverException.java,9,1,0,1,0,2
hadoop-trunk\hadoop-trunk\hadoop-common-project\hadoop-common\src\main\java\org\apache\hadoop\ipc\metrics\package-info.java,0,0,0,1,0,1
hadoop-trunk\hadoop-trunk\hadoop-hdfs-project\hadoop-hdfs\src\test\java\org\apache\hadoop\hdfs\server\namenode\TestAuthorizationContext.java,133,14,1,1,0,16
hadoop-trunk\hadoop-trunk\hadoop-common-project\hadoop-common\src\main\java\org\apache\hadoop\util\GSetByHashMap.java,0,19,1,1,0,21
hadoop-trunk\hadoop-trunk\hadoop-tools\hadoop-distcp\src\main\java\org\apache\hadoop\tools\CopyFilter.java,61,7,2,1,0,10
hadoop-trunk\hadoop-trunk\hadoop-yarn-project\hadoop-yarn\hadoop-yarn-server\hadoop-yarn-server-resourcemanager\src\test\java\org\apache\hadoop\yarn\server\resourcemanager\scheduler\capacity\TestUsersManager.java,68,14,0,2,0,16
hadoop-trunk\hadoop-trunk\hadoop-hdfs-project\hadoop-hdfs\src\test\java\org\apache\hadoop\hdfs\TestExternalBlockReader.java,294,123,18,3,0,144
hadoop-trunk\hadoop-trunk\hadoop-hdfs-project\hadoop-hdfs\src\main\java\org\apache\hadoop\hdfs\server\namenode\RedundantEditLogInputStream.java,0,43,7,3,0,53
hadoop-trunk\hadoop-trunk\hadoop-common-project\hadoop-annotations\src\main\java\org\apache\hadoop\classification\tools\package-info.java,0,1,0,1,0,2
hadoop-trunk\hadoop-trunk\hadoop-yarn-project\hadoop-yarn\hadoop-yarn-server\hadoop-yarn-server-common\src\main\java\org\apache\hadoop\yarn\server\api\protocolrecords\GetTimelineCollectorContextResponse.java,30,13,0,1,0,14
hadoop-trunk\hadoop-trunk\hadoop-common-project\hadoop-common\src\test\java\org\apache\hadoop\test\GenericTestUtils.java,985,200,11,6,0,217
hadoop-trunk\hadoop-trunk\hadoop-tools\hadoop-distcp\src\test\java\org\apache\hadoop\tools\TestDistCpWithRawXAttrs.java,194,51,0,1,0,52
hadoop-trunk\hadoop-trunk\hadoop-common-project\hadoop-common\src\test\java\org\apache\hadoop\io\file\tfile\TestTFileSeqFileComparison.java,752,218,86,8,0,312
hadoop-trunk\hadoop-trunk\hadoop-yarn-project\hadoop-yarn\hadoop-yarn-common\src\test\java\org\apache\hadoop\yarn\factories\impl\pb\TestRpcServerFactoryPBImpl.java,16,2,1,1,0,4
hadoop-trunk\hadoop-trunk\hadoop-yarn-project\hadoop-yarn\hadoop-yarn-common\src\main\java\org\apache\hadoop\yarn\api\protocolrecords\impl\pb\GetApplicationAttemptsResponsePBImpl.java,149,24,42,5,0,71
hadoop-trunk\hadoop-trunk\hadoop-yarn-project\hadoop-yarn\hadoop-yarn-server\hadoop-yarn-server-resourcemanager\src\main\java\org\apache\hadoop\yarn\server\resourcemanager\reservation\planning\SimpleCapacityReplanner.java,71,13,2,4,0,19
hadoop-trunk\hadoop-trunk\hadoop-common-project\hadoop-common\src\main\java\org\apache\hadoop\metrics2\sink\StatsDSink.java,0,35,1,1,0,37
hadoop-trunk\hadoop-trunk\hadoop-hdfs-project\hadoop-hdfs\src\test\java\org\apache\hadoop\hdfs\server\blockmanagement\TestCorruptionWithFailover.java,0,10,0,2,0,12
hadoop-trunk\hadoop-trunk\hadoop-hdfs-project\hadoop-hdfs\src\main\java\org\apache\hadoop\hdfs\tools\NNHAServiceTarget.java,190,56,2,2,0,60
hadoop-trunk\hadoop-trunk\hadoop-tools\hadoop-azure\src\main\java\org\apache\hadoop\fs\azurebfs\enums\package-info.java,0,1,0,1,0,2
hadoop-trunk\hadoop-trunk\hadoop-yarn-project\hadoop-yarn\hadoop-yarn-server\hadoop-yarn-server-common\src\main\java\org\apache\hadoop\yarn\server\api\protocolrecords\NodeHeartbeatRequest.java,78,37,0,1,0,38
hadoop-trunk\hadoop-trunk\hadoop-yarn-project\hadoop-yarn\hadoop-yarn-server\hadoop-yarn-server-nodemanager\src\main\java\org\apache\hadoop\yarn\server\nodemanager\containermanager\application\ApplicationState.java,0,8,0,2,0,10
hadoop-trunk\hadoop-trunk\hadoop-yarn-project\hadoop-yarn\hadoop-yarn-server\hadoop-yarn-server-resourcemanager\src\main\java\org\apache\hadoop\yarn\server\resourcemanager\webapp\dao\ConfigVersionInfo.java,17,6,1,1,0,8
hadoop-trunk\hadoop-trunk\hadoop-hdfs-project\hadoop-hdfs\src\test\java\org\apache\hadoop\hdfs\server\namenode\startupprogress\TestStartupProgress.java,434,142,11,6,0,159
hadoop-trunk\hadoop-trunk\hadoop-common-project\hadoop-common\src\test\java\org\apache\hadoop\io\compress\TestCodec.java,1179,300,54,38,0,392
hadoop-trunk\hadoop-trunk\hadoop-hdfs-project\hadoop-hdfs\src\test\java\org\apache\hadoop\hdfs\util\TestStripedBlockUtil.java,250,40,6,1,0,47
hadoop-trunk\hadoop-trunk\hadoop-tools\hadoop-streaming\src\main\java\org\apache\hadoop\typedbytes\TypedBytesRecordInput.java,132,64,14,1,0,79
hadoop-trunk\hadoop-trunk\hadoop-hdfs-project\hadoop-hdfs-client\src\main\java\org\apache\hadoop\hdfs\web\resources\LongParam.java,0,9,0,1,0,10
hadoop-trunk\hadoop-trunk\hadoop-yarn-project\hadoop-yarn\hadoop-yarn-server\hadoop-yarn-server-common\src\main\java\org\apache\hadoop\yarn\server\federation\store\FederationStateStore.java,0,0,0,1,0,1
hadoop-trunk\hadoop-trunk\hadoop-yarn-project\hadoop-yarn\hadoop-yarn-common\src\main\java\org\apache\hadoop\yarn\util\ApplicationClassLoader.java,0,8,0,1,0,9
hadoop-trunk\hadoop-trunk\hadoop-hdfs-project\hadoop-hdfs\src\main\java\org\apache\hadoop\hdfs\server\namenode\FSEditLogOp.java,5479,1287,71,54,0,1412
hadoop-trunk\hadoop-trunk\hadoop-mapreduce-project\hadoop-mapreduce-client\hadoop-mapreduce-client-core\src\main\java\org\apache\hadoop\mapreduce\lib\db\OracleDBRecordReader.java,0,33,7,4,0,44
hadoop-trunk\hadoop-trunk\hadoop-yarn-project\hadoop-yarn\hadoop-yarn-server\hadoop-yarn-server-resourcemanager\src\main\java\org\apache\hadoop\yarn\server\resourcemanager\scheduler\fair\policies\FairSharePolicy.java,205,43,6,2,0,51
hadoop-trunk\hadoop-trunk\hadoop-common-project\hadoop-registry\src\main\java\org\apache\hadoop\registry\client\types\ProtocolTypes.java,0,3,13,1,0,17
hadoop-trunk\hadoop-trunk\hadoop-hdfs-project\hadoop-hdfs-client\src\main\java\org\apache\hadoop\hdfs\server\datanode\CorruptMetaHeaderException.java,12,3,0,1,0,4
hadoop-trunk\hadoop-trunk\hadoop-hdfs-project\hadoop-hdfs\src\test\java\org\apache\hadoop\hdfs\TestBalancerBandwidth.java,106,31,3,3,0,37
hadoop-trunk\hadoop-trunk\hadoop-hdfs-project\hadoop-hdfs-client\src\main\java\org\apache\hadoop\hdfs\net\DomainPeer.java,101,25,0,2,0,27
hadoop-trunk\hadoop-trunk\hadoop-hdfs-project\hadoop-hdfs-client\src\main\java\org\apache\hadoop\hdfs\net\Peer.java,0,0,0,1,0,1
hadoop-trunk\hadoop-trunk\hadoop-mapreduce-project\hadoop-mapreduce-client\hadoop-mapreduce-client-jobclient\src\test\java\org\apache\hadoop\cli\util\CLICommandArchive.java,3,1,0,1,0,2
hadoop-trunk\hadoop-trunk\hadoop-yarn-project\hadoop-yarn\hadoop-yarn-common\src\main\java\org\apache\hadoop\yarn\logaggregation\ContainerLogFileInfo.java,64,36,1,1,0,38
hadoop-trunk\hadoop-trunk\hadoop-common-project\hadoop-common\src\test\java\org\apache\hadoop\security\TestIngressPortBasedResolver.java,31,6,1,1,0,8
hadoop-trunk\hadoop-trunk\hadoop-mapreduce-project\hadoop-mapreduce-client\hadoop-mapreduce-client-core\src\main\java\org\apache\hadoop\mapred\MapTask.java,2016,543,95,29,0,667
hadoop-trunk\hadoop-trunk\hadoop-mapreduce-project\hadoop-mapreduce-client\hadoop-mapreduce-client-jobclient\src\test\java\org\apache\hadoop\mapreduce\lib\input\TestDelegatingInputFormat.java,86,11,4,1,0,16
hadoop-trunk\hadoop-trunk\hadoop-mapreduce-project\hadoop-mapreduce-client\hadoop-mapreduce-client-core\src\test\java\org\apache\hadoop\mapred\TestIndexCache.java,294,64,12,1,0,77
hadoop-trunk\hadoop-trunk\hadoop-common-project\hadoop-registry\src\main\java\org\apache\hadoop\registry\client\impl\FSRegistryOperationsService.java,0,34,7,1,0,42
hadoop-trunk\hadoop-trunk\hadoop-common-project\hadoop-common\src\main\java\org\apache\hadoop\metrics2\lib\MutableGaugeFloat.java,60,18,1,1,0,20
hadoop-trunk\hadoop-trunk\hadoop-common-project\hadoop-common\src\test\java\org\apache\hadoop\io\TestMapFile.java,798,130,47,7,0,184
hadoop-trunk\hadoop-trunk\hadoop-common-project\hadoop-nfs\src\main\java\org\apache\hadoop\nfs\nfs3\response\NFS3Response.java,31,14,0,1,0,15
hadoop-trunk\hadoop-trunk\hadoop-common-project\hadoop-common\src\test\java\org\apache\hadoop\fs\shell\TestCopyFromLocal.java,128,34,4,1,0,39
hadoop-trunk\hadoop-trunk\hadoop-common-project\hadoop-nfs\src\main\java\org\apache\hadoop\nfs\nfs3\response\LOOKUP3Response.java,48,21,0,2,0,23
hadoop-trunk\hadoop-trunk\hadoop-tools\hadoop-dynamometer\hadoop-dynamometer-workload\src\main\java\org\apache\hadoop\tools\dynamometer\workloadgenerator\CreateFileMapper.java,97,23,9,1,0,33
hadoop-trunk\hadoop-trunk\hadoop-hdfs-project\hadoop-hdfs\src\main\java\org\apache\hadoop\hdfs\server\namenode\ha\HAContext.java,0,23,7,1,0,31
hadoop-trunk\hadoop-trunk\hadoop-tools\hadoop-rumen\src\main\java\org\apache\hadoop\tools\rumen\anonymization\WordList.java,97,34,0,1,0,35
hadoop-trunk\hadoop-trunk\hadoop-yarn-project\hadoop-yarn\hadoop-yarn-common\src\test\java\org\apache\hadoop\yarn\client\api\impl\TestTimelineClient.java,515,62,6,5,0,73
hadoop-trunk\hadoop-trunk\hadoop-yarn-project\hadoop-yarn\hadoop-yarn-common\src\test\java\org\apache\hadoop\yarn\webapp\MyTestWebService.java,16,4,1,1,0,6
hadoop-trunk\hadoop-trunk\hadoop-hdfs-project\hadoop-hdfs-rbf\src\main\java\org\apache\hadoop\hdfs\server\federation\store\records\MembershipStats.java,145,56,1,2,0,59
hadoop-trunk\hadoop-trunk\hadoop-common-project\hadoop-common\src\test\java\org\apache\hadoop\fs\contract\localfs\TestLocalFSContractSeek.java,8,2,0,1,0,3
hadoop-trunk\hadoop-trunk\hadoop-hdfs-project\hadoop-hdfs\src\main\java\org\apache\hadoop\hdfs\tools\offlineImageViewer\PBImageXmlWriter.java,0,178,93,21,0,292
hadoop-trunk\hadoop-trunk\hadoop-common-project\hadoop-kms\src\main\java\org\apache\hadoop\crypto\key\kms\server\KMSMDCFilter.java,87,27,2,1,0,30
hadoop-trunk\hadoop-trunk\hadoop-yarn-project\hadoop-yarn\hadoop-yarn-common\src\main\java\org\apache\hadoop\yarn\api\protocolrecords\impl\pb\GetAttributesToNodesRequestPBImpl.java,0,19,40,2,0,61
hadoop-trunk\hadoop-trunk\hadoop-yarn-project\hadoop-yarn\hadoop-yarn-common\src\test\java\org\apache\hadoop\yarn\util\TestBoundedAppender.java,87,18,1,1,0,20
hadoop-trunk\hadoop-trunk\hadoop-yarn-project\hadoop-yarn\hadoop-yarn-common\src\main\java\org\apache\hadoop\yarn\api\protocolrecords\impl\pb\ReInitializeContainerResponsePBImpl.java,44,17,17,2,0,36
hadoop-trunk\hadoop-trunk\hadoop-yarn-project\hadoop-yarn\hadoop-yarn-client\src\main\java\org\apache\hadoop\yarn\client\cli\ApplicationCLI.java,1423,175,17,6,0,198
hadoop-trunk\hadoop-trunk\hadoop-yarn-project\hadoop-yarn\hadoop-yarn-server\hadoop-yarn-server-timelineservice\src\main\java\org\apache\hadoop\yarn\server\timelineservice\reader\TimelineParserForNumericFilters.java,0,8,1,5,0,14
hadoop-trunk\hadoop-trunk\hadoop-yarn-project\hadoop-yarn\hadoop-yarn-server\hadoop-yarn-server-common\src\main\java\org\apache\hadoop\yarn\server\federation\policies\exceptions\FederationPolicyException.java,10,4,0,1,0,5
hadoop-trunk\hadoop-trunk\hadoop-common-project\hadoop-common\src\main\java\org\apache\hadoop\fs\ftp\FTPFileSystem.java,678,122,25,3,0,150
hadoop-trunk\hadoop-trunk\hadoop-hdfs-project\hadoop-hdfs\src\test\java\org\apache\hadoop\hdfs\server\datanode\extdataset\TestExternalDataset.java,35,0,8,1,0,9
hadoop-trunk\hadoop-trunk\hadoop-yarn-project\hadoop-yarn\hadoop-yarn-common\src\main\java\org\apache\hadoop\yarn\webapp\WebApp.java,250,99,8,4,0,111
hadoop-trunk\hadoop-trunk\hadoop-mapreduce-project\hadoop-mapreduce-client\hadoop-mapreduce-client-core\src\main\java\org\apache\hadoop\mapred\lib\MultipleInputs.java,99,21,14,6,0,41
hadoop-trunk\hadoop-trunk\hadoop-yarn-project\hadoop-yarn\hadoop-yarn-server\hadoop-yarn-server-applicationhistoryservice\src\test\java\org\apache\hadoop\yarn\server\applicationhistoryservice\webapp\TestAHSWebServices.java,879,90,23,8,0,121
hadoop-trunk\hadoop-trunk\hadoop-yarn-project\hadoop-yarn\hadoop-yarn-server\hadoop-yarn-server-resourcemanager\src\test\java\org\apache\hadoop\yarn\server\resourcemanager\scheduler\fair\converter\TestFSQueueConverter.java,482,57,2,4,0,63
hadoop-trunk\hadoop-trunk\hadoop-hdfs-project\hadoop-hdfs-rbf\src\main\java\org\apache\hadoop\hdfs\server\federation\store\protocol\GetDisabledNameservicesRequest.java,7,1,0,2,0,3
hadoop-trunk\hadoop-trunk\hadoop-mapreduce-project\hadoop-mapreduce-client\hadoop-mapreduce-client-jobclient\src\test\java\org\apache\hadoop\mapred\TestMiniMRChildTask.java,330,99,22,2,0,123
hadoop-trunk\hadoop-trunk\hadoop-yarn-project\hadoop-yarn\hadoop-yarn-server\hadoop-yarn-server-nodemanager\src\test\java\org\apache\hadoop\yarn\server\nodemanager\containermanager\BaseContainerManagerTest.java,445,207,18,11,0,236
hadoop-trunk\hadoop-trunk\hadoop-tools\hadoop-streaming\src\test\java\org\apache\hadoop\streaming\RawBytesReduceApp.java,49,9,0,1,0,10
hadoop-trunk\hadoop-trunk\hadoop-mapreduce-project\hadoop-mapreduce-client\hadoop-mapreduce-client-core\src\main\java\org\apache\hadoop\mapreduce\lib\aggregate\ValueAggregatorDescriptor.java,0,19,5,1,0,25
hadoop-trunk\hadoop-trunk\hadoop-common-project\hadoop-common\src\main\java\org\apache\hadoop\io\erasurecode\coder\DummyErasureEncoder.java,16,4,0,1,0,5
hadoop-trunk\hadoop-trunk\hadoop-hdfs-project\hadoop-hdfs\src\main\java\org\apache\hadoop\hdfs\tools\offlineImageViewer\FileDistributionVisitor.java,0,77,16,1,0,94
hadoop-trunk\hadoop-trunk\hadoop-yarn-project\hadoop-yarn\hadoop-yarn-server\hadoop-yarn-server-nodemanager\src\test\java\org\apache\hadoop\yarn\server\nodemanager\containermanager\monitor\TestContainerMetrics.java,187,36,7,3,0,46
hadoop-trunk\hadoop-trunk\hadoop-hdfs-project\hadoop-hdfs\src\main\java\org\apache\hadoop\hdfs\server\namenode\EditLogFileInputStream.java,485,139,19,7,0,165
hadoop-trunk\hadoop-trunk\hadoop-hdfs-project\hadoop-hdfs\src\main\java\org\apache\hadoop\hdfs\server\common\blockaliasmap\impl\InMemoryLevelDBAliasMapClient.java,0,28,3,2,0,33
hadoop-trunk\hadoop-trunk\hadoop-hdfs-project\hadoop-hdfs\src\main\java\org\apache\hadoop\hdfs\server\protocol\NamenodeRegistration.java,0,26,0,1,0,27
hadoop-trunk\hadoop-trunk\hadoop-yarn-project\hadoop-yarn\hadoop-yarn-applications\hadoop-yarn-services\hadoop-yarn-services-core\src\main\java\org\apache\hadoop\yarn\service\api\records\ConfigFile.java,216,92,2,10,0,104
hadoop-trunk\hadoop-trunk\hadoop-yarn-project\hadoop-yarn\hadoop-yarn-api\src\main\java\org\apache\hadoop\yarn\api\protocolrecords\GetResourceProfileRequest.java,31,7,0,1,0,8
hadoop-trunk\hadoop-trunk\hadoop-mapreduce-project\hadoop-mapreduce-client\hadoop-mapreduce-client-jobclient\src\test\java\org\apache\hadoop\fi\FiConfig.java,26,14,2,2,0,18
hadoop-trunk\hadoop-trunk\hadoop-yarn-project\hadoop-yarn\hadoop-yarn-server\hadoop-yarn-server-resourcemanager\src\test\java\org\apache\hadoop\yarn\server\resourcemanager\scheduler\capacity\TestQueueParsing.java,1239,487,60,42,0,589
hadoop-trunk\hadoop-trunk\hadoop-hdfs-project\hadoop-hdfs-rbf\src\main\java\org\apache\hadoop\hdfs\tools\federation\package-info.java,0,2,0,1,0,3
hadoop-trunk\hadoop-trunk\hadoop-common-project\hadoop-common\src\main\java\org\apache\hadoop\fs\DirectoryListingStartAfterNotFoundException.java,12,4,0,1,0,5
hadoop-trunk\hadoop-trunk\hadoop-common-project\hadoop-common\src\test\java\org\apache\hadoop\security\http\TestCrossOriginFilter.java,369,48,34,28,0,110
hadoop-trunk\hadoop-trunk\hadoop-hdfs-project\hadoop-hdfs\src\main\java\org\apache\hadoop\hdfs\server\common\HdfsServerConstants.java,0,152,2,6,0,160
hadoop-trunk\hadoop-trunk\hadoop-tools\hadoop-resourceestimator\src\main\java\org\apache\hadoop\resourceestimator\solver\api\Solver.java,0,1,0,5,0,6
hadoop-trunk\hadoop-trunk\hadoop-mapreduce-project\hadoop-mapreduce-client\hadoop-mapreduce-client-common\src\main\java\org\apache\hadoop\mapreduce\v2\api\records\CounterGroup.java,0,33,10,1,0,44
hadoop-trunk\hadoop-trunk\hadoop-tools\hadoop-federation-balance\src\main\java\org\apache\hadoop\tools\fedbalance\procedure\BalanceJournal.java,0,4,4,1,0,9
hadoop-trunk\hadoop-trunk\hadoop-yarn-project\hadoop-yarn\hadoop-yarn-server\hadoop-yarn-server-nodemanager\src\main\java\org\apache\hadoop\yarn\server\nodemanager\containermanager\resourceplugin\gpu\GpuDevice.java,0,19,1,2,0,22
hadoop-trunk\hadoop-trunk\hadoop-tools\hadoop-azure\src\main\java\org\apache\hadoop\fs\azurebfs\services\AbfsClientContextBuilder.java,35,13,0,2,0,15
hadoop-trunk\hadoop-trunk\hadoop-cloud-storage-project\hadoop-cos\src\main\java\org\apache\hadoop\fs\cosn\CosNativeFileSystemStore.java,0,80,8,1,0,89
hadoop-trunk\hadoop-trunk\hadoop-yarn-project\hadoop-yarn\hadoop-yarn-server\hadoop-yarn-server-common\src\test\java\org\apache\hadoop\yarn\server\federation\policies\router\TestHashBasedRouterPolicy.java,46,5,0,2,0,7
hadoop-trunk\hadoop-trunk\hadoop-cloud-storage-project\hadoop-huaweicloud\src\main\java\org\apache\hadoop\fs\obs\OBSLoginHelper.java,0,0,1,1,0,2
hadoop-trunk\hadoop-trunk\hadoop-mapreduce-project\hadoop-mapreduce-client\hadoop-mapreduce-client-common\src\main\java\org\apache\hadoop\mapreduce\v2\api\protocolrecords\GetCountersRequest.java,0,7,2,1,0,10
hadoop-trunk\hadoop-trunk\hadoop-yarn-project\hadoop-yarn\hadoop-yarn-common\src\main\java\org\apache\hadoop\yarn\server\api\protocolrecords\impl\pb\package-info.java,0,1,0,1,0,2
hadoop-trunk\hadoop-trunk\hadoop-common-project\hadoop-nfs\src\main\java\org\apache\hadoop\nfs\nfs3\request\READ3Request.java,34,21,0,1,0,22
hadoop-trunk\hadoop-trunk\hadoop-tools\hadoop-azure\src\main\java\org\apache\hadoop\fs\azurebfs\enums\Trilean.java,0,6,0,2,0,8
hadoop-trunk\hadoop-trunk\hadoop-mapreduce-project\hadoop-mapreduce-client\hadoop-mapreduce-client-hs\src\main\java\org\apache\hadoop\mapreduce\v2\hs\HistoryServerStateStoreService.java,145,29,0,1,0,30
hadoop-trunk\hadoop-trunk\hadoop-hdfs-project\hadoop-hdfs-client\src\main\java\org\apache\hadoop\fs\XAttr.java,107,43,0,1,0,44
hadoop-trunk\hadoop-trunk\hadoop-common-project\hadoop-common\src\test\java\org\apache\hadoop\http\TestHttpRequestLog.java,13,1,0,1,0,2
hadoop-trunk\hadoop-trunk\hadoop-common-project\hadoop-common\src\main\java\org\apache\hadoop\fs\statistics\MeanStatistic.java,0,10,1,1,0,12
hadoop-trunk\hadoop-trunk\hadoop-yarn-project\hadoop-yarn\hadoop-yarn-server\hadoop-yarn-server-nodemanager\src\test\java\org\apache\hadoop\yarn\server\nodemanager\containermanager\linux\runtime\TestHdfsManifestToResourcesPlugin.java,131,16,3,5,0,24
hadoop-trunk\hadoop-trunk\hadoop-tools\hadoop-dynamometer\hadoop-dynamometer-workload\src\main\java\org\apache\hadoop\tools\dynamometer\workloadgenerator\audit\AuditLogDirectParser.java,111,12,0,1,0,13
hadoop-trunk\hadoop-trunk\hadoop-yarn-project\hadoop-yarn\hadoop-yarn-server\hadoop-yarn-server-timelineservice-hbase\hadoop-yarn-server-timelineservice-hbase-common\src\main\java\org\apache\hadoop\yarn\server\timelineservice\storage\flow\FlowActivityColumnFamily.java,0,4,1,2,0,7
hadoop-trunk\hadoop-trunk\hadoop-common-project\hadoop-common\src\test\java\org\apache\hadoop\fs\contract\rawlocal\TestRawlocalContractAppend.java,9,2,0,1,0,3
hadoop-trunk\hadoop-trunk\hadoop-common-project\hadoop-common\src\main\java\org\apache\hadoop\io\compress\DefaultCodec.java,0,38,5,4,0,47
hadoop-trunk\hadoop-trunk\hadoop-mapreduce-project\hadoop-mapreduce-client\hadoop-mapreduce-client-common\src\main\java\org\apache\hadoop\mapreduce\v2\api\protocolrecords\GetCountersResponse.java,0,7,2,1,0,10
hadoop-trunk\hadoop-trunk\hadoop-mapreduce-project\hadoop-mapreduce-client\hadoop-mapreduce-client-app\src\main\java\org\apache\hadoop\mapreduce\v2\app\job\event\JobCommitFailedEvent.java,13,7,0,1,0,8
hadoop-trunk\hadoop-trunk\hadoop-yarn-project\hadoop-yarn\hadoop-yarn-api\src\main\java\org\apache\hadoop\yarn\api\records\UpdateContainerRequest.java,176,20,0,2,0,22
hadoop-trunk\hadoop-trunk\hadoop-common-project\hadoop-common\src\main\java\org\apache\hadoop\ipc\RpcConstants.java,47,21,1,1,0,23
hadoop-trunk\hadoop-trunk\hadoop-hdfs-project\hadoop-hdfs\src\test\java\org\apache\hadoop\cli\TestHDFSCLI.java,75,23,0,1,0,24
hadoop-trunk\hadoop-trunk\hadoop-hdfs-project\hadoop-hdfs\src\test\java\org\apache\hadoop\hdfs\server\namenode\ha\TestGetGroupsWithHA.java,28,8,0,1,0,9
hadoop-trunk\hadoop-trunk\hadoop-hdfs-project\hadoop-hdfs\src\main\java\org\apache\hadoop\hdfs\server\blockmanagement\BlockPlacementPolicyWithNodeGroup.java,405,106,6,3,0,115
hadoop-trunk\hadoop-trunk\hadoop-hdfs-project\hadoop-hdfs-rbf\src\main\java\org\apache\hadoop\hdfs\server\federation\metrics\RBFMetrics.java,0,83,18,12,0,113
hadoop-trunk\hadoop-trunk\hadoop-yarn-project\hadoop-yarn\hadoop-yarn-server\hadoop-yarn-server-nodemanager\src\test\java\org\apache\hadoop\yarn\server\nodemanager\containermanager\resourceplugin\deviceframework\TestDevicePluginAdapter.java,919,69,18,22,0,109
hadoop-trunk\hadoop-trunk\hadoop-yarn-project\hadoop-yarn\hadoop-yarn-server\hadoop-yarn-server-timelineservice-hbase\hadoop-yarn-server-timelineservice-hbase-common\src\main\java\org\apache\hadoop\yarn\server\timelineservice\storage\entity\EntityRowKey.java,268,63,1,5,0,69
hadoop-trunk\hadoop-trunk\hadoop-hdfs-project\hadoop-hdfs-client\src\main\java\org\apache\hadoop\hdfs\shortcircuit\ClientMmap.java,45,10,0,1,0,11
hadoop-trunk\hadoop-trunk\hadoop-mapreduce-project\hadoop-mapreduce-client\hadoop-mapreduce-client-core\src\test\java\org\apache\hadoop\mapreduce\checkpoint\TestFSCheckpointService.java,69,14,8,2,0,24
hadoop-trunk\hadoop-trunk\hadoop-hdfs-project\hadoop-hdfs\src\test\java\org\apache\hadoop\hdfs\TestFileAppend2.java,0,143,26,9,0,178
hadoop-trunk\hadoop-trunk\hadoop-hdfs-project\hadoop-hdfs\src\test\java\org\apache\hadoop\cli\util\CLICommandDFSAdmin.java,3,0,0,1,0,1
hadoop-trunk\hadoop-trunk\hadoop-hdfs-project\hadoop-hdfs-rbf\src\main\java\org\apache\hadoop\hdfs\server\federation\router\RouterSafemodeService.java,149,13,4,1,0,18
hadoop-trunk\hadoop-trunk\hadoop-yarn-project\hadoop-yarn\hadoop-yarn-server\hadoop-yarn-server-resourcemanager\src\main\java\org\apache\hadoop\yarn\server\resourcemanager\volume\csi\event\VolumeEventType.java,0,5,0,1,0,6
hadoop-trunk\hadoop-trunk\hadoop-hdfs-project\hadoop-hdfs\src\main\java\org\apache\hadoop\hdfs\server\protocol\InterDatanodeProtocol.java,0,22,1,2,0,25
hadoop-trunk\hadoop-trunk\hadoop-hdfs-project\hadoop-hdfs\src\test\java\org\apache\hadoop\hdfs\server\blockmanagement\TestDatanodeManager.java,994,163,43,3,0,209
hadoop-trunk\hadoop-trunk\hadoop-hdfs-project\hadoop-hdfs\src\main\java\org\apache\hadoop\hdfs\server\aliasmap\InMemoryAliasMap.java,337,58,12,3,0,73
hadoop-trunk\hadoop-trunk\hadoop-hdfs-project\hadoop-hdfs\src\test\java\org\apache\hadoop\hdfs\TestViewDistributedFileSystem.java,157,15,7,3,0,25
hadoop-trunk\hadoop-trunk\hadoop-tools\hadoop-aws\src\test\java\org\apache\hadoop\fs\s3a\yarn\ITestS3A.java,48,9,1,1,0,11
hadoop-trunk\hadoop-trunk\hadoop-common-project\hadoop-common\src\main\java\org\apache\hadoop\metrics2\package-info.java,0,1,0,4,0,5
hadoop-trunk\hadoop-trunk\hadoop-mapreduce-project\hadoop-mapreduce-client\hadoop-mapreduce-client-core\src\main\java\org\apache\hadoop\mapreduce\lib\db\OracleDateSplitter.java,10,2,1,1,0,4
hadoop-trunk\hadoop-trunk\hadoop-tools\hadoop-azure\src\main\java\org\apache\hadoop\fs\azure\security\JsonUtils.java,0,3,3,1,0,7
hadoop-trunk\hadoop-trunk\hadoop-yarn-project\hadoop-yarn\hadoop-yarn-common\src\main\java\org\apache\hadoop\yarn\api\protocolrecords\impl\pb\UpdateApplicationTimeoutsResponsePBImpl.java,0,20,39,4,0,63
hadoop-trunk\hadoop-trunk\hadoop-mapreduce-project\hadoop-mapreduce-client\hadoop-mapreduce-client-jobclient\src\test\java\org\apache\hadoop\mapred\TestMultiFileSplit.java,56,26,2,2,0,30
hadoop-trunk\hadoop-trunk\hadoop-yarn-project\hadoop-yarn\hadoop-yarn-client\src\main\java\org\apache\hadoop\yarn\client\api\async\impl\AMRMClientAsyncImpl.java,0,72,14,3,0,89
hadoop-trunk\hadoop-trunk\hadoop-mapreduce-project\hadoop-mapreduce-client\hadoop-mapreduce-client-core\src\main\java\org\apache\hadoop\mapreduce\lib\db\MySQLDataDrivenDBRecordReader.java,0,19,2,4,0,25
hadoop-trunk\hadoop-trunk\hadoop-tools\hadoop-aws\src\test\java\org\apache\hadoop\fs\s3a\impl\TestRequestFactory.java,169,12,5,2,0,19
hadoop-trunk\hadoop-trunk\hadoop-tools\hadoop-aliyun\src\test\java\org\apache\hadoop\fs\aliyun\oss\contract\TestAliyunOSSContractGetFileStatusV1List.java,0,4,0,1,0,5
hadoop-trunk\hadoop-trunk\hadoop-yarn-project\hadoop-yarn\hadoop-yarn-server\hadoop-yarn-server-resourcemanager\src\main\java\org\apache\hadoop\yarn\server\resourcemanager\reservation\ReservationConstants.java,0,2,1,1,0,4
hadoop-trunk\hadoop-trunk\hadoop-mapreduce-project\hadoop-mapreduce-client\hadoop-mapreduce-client-common\src\main\java\org\apache\hadoop\mapreduce\v2\jobhistory\JobHistoryUtils.java,611,169,24,27,0,220
hadoop-trunk\hadoop-trunk\hadoop-hdfs-project\hadoop-hdfs-client\src\main\java\org\apache\hadoop\hdfs\web\resources\AccessTimeParam.java,30,3,0,1,0,4
hadoop-trunk\hadoop-trunk\hadoop-hdfs-project\hadoop-hdfs-rbf\src\main\java\org\apache\hadoop\hdfs\server\federation\store\protocol\impl\pb\UpdateMountTableEntryRequestPBImpl.java,0,16,36,7,0,59
hadoop-trunk\hadoop-trunk\hadoop-yarn-project\hadoop-yarn\hadoop-yarn-api\src\main\java\org\apache\hadoop\yarn\api\records\YarnApplicationState.java,0,1,0,1,0,2
hadoop-trunk\hadoop-trunk\hadoop-common-project\hadoop-common\src\test\java\org\apache\hadoop\http\TestPathFilter.java,110,46,12,1,0,59
hadoop-trunk\hadoop-trunk\hadoop-yarn-project\hadoop-yarn\hadoop-yarn-server\hadoop-yarn-server-common\src\main\java\org\apache\hadoop\yarn\server\federation\store\records\impl\pb\DeleteApplicationHomeSubClusterRequestPBImpl.java,0,18,35,4,0,57
hadoop-trunk\hadoop-trunk\hadoop-common-project\hadoop-common\src\main\java\org\apache\hadoop\io\SecureIOUtils.java,249,68,4,3,0,75
hadoop-trunk\hadoop-trunk\hadoop-tools\hadoop-streaming\src\test\java\org\apache\hadoop\streaming\TestStreamDataProtocol.java,0,41,14,5,0,60
hadoop-trunk\hadoop-trunk\hadoop-tools\hadoop-aws\src\test\java\org\apache\hadoop\fs\s3a\ITestS3ADelayedFNF.java,44,5,0,3,0,8
hadoop-trunk\hadoop-trunk\hadoop-hdfs-project\hadoop-hdfs\src\main\java\org\apache\hadoop\hdfs\server\blockmanagement\DatanodeAdminMonitorBase.java,0,28,0,8,0,36
hadoop-trunk\hadoop-trunk\hadoop-mapreduce-project\dev-support\jdiff\Null.java,4,2,3,1,0,6
hadoop-trunk\hadoop-trunk\hadoop-mapreduce-project\hadoop-mapreduce-client\hadoop-mapreduce-client-core\src\main\java\org\apache\hadoop\mapreduce\TaskCompletionEvent.java,216,103,2,1,0,106
hadoop-trunk\hadoop-trunk\hadoop-mapreduce-project\hadoop-mapreduce-client\hadoop-mapreduce-client-app\src\main\java\org\apache\hadoop\mapreduce\v2\app\webapp\dao\CounterInfo.java,18,13,1,1,0,15
hadoop-trunk\hadoop-trunk\hadoop-tools\hadoop-aws\src\main\java\org\apache\hadoop\fs\s3a\impl\NetworkBinding.java,0,12,2,3,0,17
hadoop-trunk\hadoop-trunk\hadoop-yarn-project\hadoop-yarn\hadoop-yarn-server\hadoop-yarn-server-timelineservice-documentstore\src\test\java\org\apache\hadoop\yarn\server\timelineservice\documentstore\TestDocumentStoreCollectionCreator.java,26,4,1,5,0,10
hadoop-trunk\hadoop-trunk\hadoop-yarn-project\hadoop-yarn\hadoop-yarn-server\hadoop-yarn-server-router\src\main\java\org\apache\hadoop\yarn\server\router\clientrm\RouterYarnClientUtils.java,0,26,0,1,0,27
hadoop-trunk\hadoop-trunk\hadoop-yarn-project\hadoop-yarn\hadoop-yarn-server\hadoop-yarn-server-resourcemanager\src\main\java\org\apache\hadoop\yarn\server\resourcemanager\scheduler\event\NodeAddedSchedulerEvent.java,27,14,0,1,0,15
hadoop-trunk\hadoop-trunk\hadoop-yarn-project\hadoop-yarn\hadoop-yarn-server\hadoop-yarn-server-applicationhistoryservice\src\main\java\org\apache\hadoop\yarn\server\applicationhistoryservice\webapp\AppAttemptPage.java,33,4,0,1,0,5
hadoop-trunk\hadoop-trunk\hadoop-tools\hadoop-azure\src\main\java\org\apache\hadoop\fs\azurebfs\contracts\services\ListResultEntrySchema.java,212,11,8,1,0,20
hadoop-trunk\hadoop-trunk\hadoop-hdfs-project\hadoop-hdfs\src\test\java\org\apache\hadoop\hdfs\server\datanode\web\TestHostRestrictingAuthorizationFilterHandler.java,139,18,7,1,0,26
hadoop-trunk\hadoop-trunk\hadoop-hdfs-project\hadoop-hdfs\src\main\java\org\apache\hadoop\hdfs\server\blockmanagement\BlockReportLeaseManager.java,0,45,15,8,0,68
hadoop-trunk\hadoop-trunk\hadoop-hdfs-project\hadoop-hdfs\src\main\java\org\apache\hadoop\hdfs\server\datanode\LocalReplica.java,0,102,6,3,0,111
hadoop-trunk\hadoop-trunk\hadoop-common-project\hadoop-common\src\test\java\org\apache\hadoop\fs\viewfs\ViewFsBaseTest.java,0,378,47,10,0,435
hadoop-trunk\hadoop-trunk\hadoop-hdfs-project\hadoop-hdfs\src\main\java\org\apache\hadoop\hdfs\server\namenode\EditLogFileOutputStream.java,246,46,2,3,0,51
hadoop-trunk\hadoop-trunk\hadoop-common-project\hadoop-common\src\test\java\org\apache\hadoop\security\TestUGIWithExternalKdc.java,36,6,0,2,0,8
hadoop-trunk\hadoop-trunk\hadoop-yarn-project\hadoop-yarn\hadoop-yarn-server\hadoop-yarn-server-nodemanager\src\test\java\org\apache\hadoop\yarn\server\nodemanager\containermanager\localizer\MockLocalResourceStatus.java,58,47,3,3,0,53
hadoop-trunk\hadoop-trunk\hadoop-tools\hadoop-aws\src\main\java\org\apache\hadoop\fs\s3a\commit\staging\StagingCommitterConstants.java,0,0,0,1,0,1
hadoop-trunk\hadoop-trunk\hadoop-hdfs-project\hadoop-hdfs\src\test\java\org\apache\hadoop\hdfs\TestErasureCodingMultipleRacks.java,151,16,4,4,0,24
hadoop-trunk\hadoop-trunk\hadoop-hdfs-project\hadoop-hdfs-client\src\main\java\org\apache\hadoop\hdfs\DFSStripedOutputStream.java,0,175,17,10,0,202
hadoop-trunk\hadoop-trunk\hadoop-tools\hadoop-aws\src\test\java\org\apache\hadoop\fs\s3a\audit\ITestAuditAccessChecks.java,150,8,2,6,0,16
hadoop-trunk\hadoop-trunk\hadoop-yarn-project\hadoop-yarn\hadoop-yarn-server\hadoop-yarn-server-resourcemanager\src\main\java\org\apache\hadoop\yarn\server\resourcemanager\webapp\ContainerPage.java,18,4,0,1,0,5
hadoop-trunk\hadoop-trunk\hadoop-common-project\hadoop-common\src\test\java\org\apache\hadoop\fs\shell\TestXAttrCommands.java,66,26,7,6,0,39
hadoop-trunk\hadoop-trunk\hadoop-tools\hadoop-federation-balance\src\main\java\org\apache\hadoop\tools\fedbalance\FedBalanceOptions.java,0,10,0,1,0,11
hadoop-trunk\hadoop-trunk\hadoop-hdfs-project\hadoop-hdfs\src\main\java\org\apache\hadoop\hdfs\tools\offlineEditsViewer\BinaryEditsVisitor.java,36,12,2,1,0,15
hadoop-trunk\hadoop-trunk\hadoop-common-project\hadoop-nfs\src\main\java\org\apache\hadoop\oncrpc\SimpleTcpServer.java,0,29,2,2,0,33
hadoop-trunk\hadoop-trunk\hadoop-yarn-project\hadoop-yarn\hadoop-yarn-server\hadoop-yarn-server-resourcemanager\src\main\java\org\apache\hadoop\yarn\server\resourcemanager\scheduler\capacity\conf\FSSchedulerConfigurationStore.java,320,33,20,1,0,54
hadoop-trunk\hadoop-trunk\hadoop-common-project\hadoop-common\src\main\java\org\apache\hadoop\metrics2\lib\MutableRollingAverages.java,263,39,1,2,0,42
hadoop-trunk\hadoop-trunk\hadoop-hdfs-project\hadoop-hdfs\src\test\java\org\apache\hadoop\hdfs\server\namenode\TestReencryption.java,1882,235,27,2,0,264
hadoop-trunk\hadoop-trunk\hadoop-mapreduce-project\hadoop-mapreduce-client\hadoop-mapreduce-client-core\src\main\java\org\apache\hadoop\mapred\pipes\UpwardProtocol.java,0,14,1,1,0,16
hadoop-trunk\hadoop-trunk\hadoop-tools\hadoop-azure\src\test\java\org\apache\hadoop\fs\azure\contract\ITestAzureNativeContractAppend.java,13,4,0,1,0,5
hadoop-trunk\hadoop-trunk\hadoop-yarn-project\hadoop-yarn\hadoop-yarn-api\src\main\java\org\apache\hadoop\yarn\api\protocolrecords\ContainerUpdateResponse.java,55,4,0,1,0,5
hadoop-trunk\hadoop-trunk\hadoop-mapreduce-project\hadoop-mapreduce-client\hadoop-mapreduce-client-core\src\main\java\org\apache\hadoop\mapreduce\lib\aggregate\UniqValueCount.java,99,23,2,1,0,26
hadoop-trunk\hadoop-trunk\hadoop-yarn-project\hadoop-yarn\hadoop-yarn-api\src\main\java\org\apache\hadoop\yarn\api\protocolrecords\ReservationListRequest.java,202,10,0,1,0,11
hadoop-trunk\hadoop-trunk\hadoop-mapreduce-project\hadoop-mapreduce-client\hadoop-mapreduce-client-common\src\main\java\org\apache\hadoop\mapreduce\v2\api\protocolrecords\GetDiagnosticsResponse.java,0,22,7,1,0,30
hadoop-trunk\hadoop-trunk\hadoop-mapreduce-project\hadoop-mapreduce-client\hadoop-mapreduce-client-hs\src\test\java\org\apache\hadoop\mapreduce\v2\hs\MockHistoryJobs.java,191,46,0,3,0,49
hadoop-trunk\hadoop-trunk\hadoop-tools\hadoop-azure\src\test\java\org\apache\hadoop\fs\azurebfs\contract\ITestAbfsFileSystemContractConcat.java,26,8,0,2,0,10
hadoop-trunk\hadoop-trunk\hadoop-tools\hadoop-azure\src\test\java\org\apache\hadoop\fs\azurebfs\services\TestAbfsOutputStream.java,0,99,6,61,0,166
hadoop-trunk\hadoop-trunk\hadoop-hdfs-project\hadoop-hdfs\src\main\java\org\apache\hadoop\hdfs\web\AuthFilter.java,20,8,0,2,0,10
hadoop-trunk\hadoop-trunk\hadoop-tools\hadoop-azure\src\test\java\org\apache\hadoop\fs\azurebfs\extensions\StubAbfsTokenIdentifier.java,144,14,0,2,0,16
hadoop-trunk\hadoop-trunk\hadoop-yarn-project\hadoop-yarn\hadoop-yarn-server\hadoop-yarn-server-resourcemanager\src\main\java\org\apache\hadoop\yarn\server\resourcemanager\scheduler\distributed\QueueLimitCalculator.java,90,20,1,2,0,23
hadoop-trunk\hadoop-trunk\hadoop-hdfs-project\hadoop-hdfs\src\main\java\org\apache\hadoop\hdfs\qjournal\protocol\QJournalProtocol.java,0,66,21,7,0,94
hadoop-trunk\hadoop-trunk\hadoop-mapreduce-project\hadoop-mapreduce-client\hadoop-mapreduce-client-app\src\test\java\org\apache\hadoop\mapreduce\v2\app\webapp\TasksBlockForTest.java,25,16,1,1,0,18
hadoop-trunk\hadoop-trunk\hadoop-mapreduce-project\hadoop-mapreduce-client\hadoop-mapreduce-client-nativetask\src\main\java\org\apache\hadoop\mapred\nativetask\serde\DefaultSerializer.java,40,15,4,3,0,22
hadoop-trunk\hadoop-trunk\hadoop-common-project\hadoop-common\src\main\java\org\apache\hadoop\security\token\delegation\web\DelegationTokenManager.java,190,68,5,6,0,79
hadoop-trunk\hadoop-trunk\hadoop-mapreduce-project\hadoop-mapreduce-client\hadoop-mapreduce-client-core\src\main\java\org\apache\hadoop\mapred\lib\aggregate\ValueAggregatorMapper.java,0,20,4,2,0,26
hadoop-trunk\hadoop-trunk\hadoop-hdfs-project\hadoop-hdfs\src\test\java\org\apache\hadoop\hdfs\server\namenode\TestFSDirAttrOp.java,111,37,7,1,0,45
hadoop-trunk\hadoop-trunk\hadoop-yarn-project\hadoop-yarn\hadoop-yarn-server\hadoop-yarn-server-timelineservice-documentstore\src\main\java\org\apache\hadoop\yarn\server\timelineservice\documentstore\DocumentStoreUtils.java,0,78,4,14,0,96
hadoop-trunk\hadoop-trunk\hadoop-common-project\hadoop-common\src\main\java\org\apache\hadoop\util\hash\MurmurHash.java,63,33,3,1,0,37
hadoop-trunk\hadoop-trunk\hadoop-mapreduce-project\hadoop-mapreduce-client\hadoop-mapreduce-client-jobclient\src\test\java\org\apache\hadoop\mapred\TestTextOutputFormat.java,197,23,2,5,0,30
hadoop-trunk\hadoop-trunk\hadoop-hdfs-project\hadoop-hdfs-rbf\src\main\java\org\apache\hadoop\hdfs\server\federation\store\protocol\GetDestinationRequest.java,29,7,0,2,0,9
hadoop-trunk\hadoop-trunk\hadoop-yarn-project\hadoop-yarn\hadoop-yarn-server\hadoop-yarn-server-timelineservice-documentstore\src\test\java\org\apache\hadoop\yarn\server\timelineservice\documentstore\DocumentStoreTestUtils.java,0,22,0,4,0,26
hadoop-trunk\hadoop-trunk\hadoop-yarn-project\hadoop-yarn\hadoop-yarn-server\hadoop-yarn-server-applicationhistoryservice\src\main\java\org\apache\hadoop\yarn\server\applicationhistoryservice\webapp\AHSWebServices.java,255,93,2,1,0,96
hadoop-trunk\hadoop-trunk\hadoop-cloud-storage-project\hadoop-huaweicloud\src\test\java\org\apache\hadoop\fs\obs\OBSContract.java,46,12,4,1,0,17
hadoop-trunk\hadoop-trunk\hadoop-hdfs-project\hadoop-hdfs\src\test\java\org\apache\hadoop\hdfs\TestCrcCorruption.java,234,99,9,5,0,113
hadoop-trunk\hadoop-trunk\hadoop-tools\hadoop-aliyun\src\main\java\org\apache\hadoop\fs\aliyun\oss\OSSListResult.java,0,13,2,1,0,16
hadoop-trunk\hadoop-trunk\hadoop-yarn-project\hadoop-yarn\hadoop-yarn-common\src\test\java\org\apache\hadoop\yarn\api\TestApplicationId.java,29,12,0,1,0,13
hadoop-trunk\hadoop-trunk\hadoop-yarn-project\hadoop-yarn\hadoop-yarn-server\hadoop-yarn-server-nodemanager\src\main\java\org\apache\hadoop\yarn\server\nodemanager\containermanager\linux\resources\CGroupsMemoryResourceHandlerImpl.java,135,27,5,4,0,36
hadoop-trunk\hadoop-trunk\hadoop-common-project\hadoop-nfs\src\main\java\org\apache\hadoop\oncrpc\security\CredentialsNone.java,20,6,0,1,0,7
hadoop-trunk\hadoop-trunk\hadoop-hdfs-project\hadoop-hdfs\src\test\java\org\apache\hadoop\hdfs\server\datanode\TestCorruptMetadataFile.java,123,16,8,1,0,25
hadoop-trunk\hadoop-trunk\hadoop-tools\hadoop-resourceestimator\src\main\java\org\apache\hadoop\resourceestimator\common\config\package-info.java,0,1,0,1,0,2
hadoop-trunk\hadoop-trunk\hadoop-common-project\hadoop-common\src\main\java\org\apache\hadoop\fs\FilterFs.java,408,172,1,1,0,174
hadoop-trunk\hadoop-trunk\hadoop-mapreduce-project\hadoop-mapreduce-client\hadoop-mapreduce-client-hs\src\test\java\org\apache\hadoop\mapreduce\v2\hs\TestJobListCache.java,52,15,2,1,0,18
hadoop-trunk\hadoop-trunk\hadoop-common-project\hadoop-common\src\main\java\org\apache\hadoop\security\authorize\ProxyServers.java,28,11,2,1,0,14
hadoop-trunk\hadoop-trunk\hadoop-common-project\hadoop-common\src\main\java\org\apache\hadoop\security\token\delegation\DelegationKey.java,108,43,1,2,0,46
hadoop-trunk\hadoop-trunk\hadoop-tools\hadoop-rumen\src\main\java\org\apache\hadoop\tools\rumen\LoggedJob.java,638,330,8,3,0,341
hadoop-trunk\hadoop-trunk\hadoop-yarn-project\hadoop-yarn\hadoop-yarn-common\src\test\java\org\apache\hadoop\yarn\api\TestApplicationAttemptId.java,43,23,0,1,0,24
hadoop-trunk\hadoop-trunk\hadoop-yarn-project\hadoop-yarn\hadoop-yarn-server\hadoop-yarn-server-resourcemanager\src\main\java\org\apache\hadoop\yarn\server\resourcemanager\security\DelegationTokenRenewer.java,1116,242,41,11,0,294
hadoop-trunk\hadoop-trunk\hadoop-hdfs-project\hadoop-hdfs\src\main\java\org\apache\hadoop\hdfs\server\namenode\NNUpgradeUtil.java,201,32,9,1,0,42
hadoop-trunk\hadoop-trunk\hadoop-mapreduce-project\hadoop-mapreduce-client\hadoop-mapreduce-client-core\src\main\java\org\apache\hadoop\mapreduce\lib\output\committer\manifest\stages\CleanupJobStage.java,0,47,6,10,0,63
hadoop-trunk\hadoop-trunk\hadoop-hdfs-project\hadoop-hdfs\src\test\java\org\apache\hadoop\hdfs\TestRestartDFS.java,98,19,0,4,0,23
hadoop-trunk\hadoop-trunk\hadoop-common-project\hadoop-registry\src\main\java\org\apache\hadoop\registry\client\types\package-info.java,0,3,0,4,0,7
hadoop-trunk\hadoop-trunk\hadoop-mapreduce-project\hadoop-mapreduce-client\hadoop-mapreduce-client-nativetask\src\main\java\org\apache\hadoop\mapred\nativetask\util\LocalJobOutputFiles.java,131,60,1,10,0,71
hadoop-trunk\hadoop-trunk\hadoop-tools\hadoop-aws\src\test\java\org\apache\hadoop\fs\s3a\yarn\ITestS3AMiniYarnCluster.java,128,19,1,3,0,23
hadoop-trunk\hadoop-trunk\hadoop-yarn-project\hadoop-yarn\hadoop-yarn-server\hadoop-yarn-server-resourcemanager\src\test\java\org\apache\hadoop\yarn\server\resourcemanager\NodeManager.java,304,111,6,12,0,129
hadoop-trunk\hadoop-trunk\hadoop-mapreduce-project\hadoop-mapreduce-client\hadoop-mapreduce-client-shuffle\src\test\java\org\apache\hadoop\mapred\TestFadvisedChunkedFile.java,26,4,0,1,0,5
hadoop-trunk\hadoop-trunk\hadoop-yarn-project\hadoop-yarn\hadoop-yarn-applications\hadoop-yarn-services\hadoop-yarn-services-api\src\test\java\org\apache\hadoop\yarn\service\client\TestApiServiceClient.java,299,47,6,1,0,54
hadoop-trunk\hadoop-trunk\hadoop-common-project\hadoop-common\src\test\java\org\apache\hadoop\security\http\TestXFrameOptionsFilter.java,112,11,4,1,0,16
hadoop-trunk\hadoop-trunk\hadoop-hdfs-project\hadoop-hdfs\src\main\java\org\apache\hadoop\hdfs\server\datanode\web\RestCsrfPreventionFilterHandler.java,0,22,5,5,0,32
hadoop-trunk\hadoop-trunk\hadoop-common-project\hadoop-common\src\test\java\org\apache\hadoop\fs\TestLocalFileSystem.java,944,162,49,9,0,220
hadoop-trunk\hadoop-trunk\hadoop-common-project\hadoop-auth\src\main\java\org\apache\hadoop\security\authentication\client\PseudoAuthenticator.java,63,12,1,8,0,21
hadoop-trunk\hadoop-trunk\hadoop-hdfs-project\hadoop-hdfs\src\main\java\org\apache\hadoop\hdfs\server\protocol\RemoteEditLogManifest.java,56,19,1,1,0,21
hadoop-trunk\hadoop-trunk\hadoop-yarn-project\hadoop-yarn\hadoop-yarn-applications\hadoop-yarn-services\hadoop-yarn-services-api\src\test\java\org\apache\hadoop\yarn\service\TestCleanupAfterKill.java,50,9,0,1,0,10
hadoop-trunk\hadoop-trunk\hadoop-yarn-project\hadoop-yarn\hadoop-yarn-common\src\main\java\org\apache\hadoop\yarn\webapp\view\DefaultPage.java,38,4,3,1,0,8
hadoop-trunk\hadoop-trunk\hadoop-hdfs-project\hadoop-hdfs\src\main\java\org\apache\hadoop\hdfs\tools\offlineEditsViewer\TeeOutputStream.java,43,15,6,1,0,22
hadoop-trunk\hadoop-trunk\hadoop-mapreduce-project\hadoop-mapreduce-client\hadoop-mapreduce-client-core\src\test\java\org\apache\hadoop\mapreduce\lib\db\TestDbClasses.java,135,21,4,7,0,32
hadoop-trunk\hadoop-trunk\hadoop-yarn-project\hadoop-yarn\hadoop-yarn-server\hadoop-yarn-server-resourcemanager\src\main\java\org\apache\hadoop\yarn\server\resourcemanager\rmnode\RMNodeUpdateContainerEvent.java,14,8,2,1,0,11
hadoop-trunk\hadoop-trunk\hadoop-yarn-project\hadoop-yarn\hadoop-yarn-server\hadoop-yarn-server-resourcemanager\src\main\java\org\apache\hadoop\yarn\server\resourcemanager\scheduler\constraint\algorithm\iterators\PopularTagsIterator.java,40,7,1,2,0,10
hadoop-trunk\hadoop-trunk\hadoop-tools\hadoop-rumen\src\main\java\org\apache\hadoop\tools\rumen\datatypes\JobProperties.java,61,22,1,2,0,25
hadoop-trunk\hadoop-trunk\hadoop-yarn-project\hadoop-yarn\hadoop-yarn-server\hadoop-yarn-server-nodemanager\src\test\java\org\apache\hadoop\yarn\server\nodemanager\containermanager\localizer\TestResourceSet.java,70,3,0,1,0,4
hadoop-trunk\hadoop-trunk\hadoop-hdfs-project\hadoop-hdfs-rbf\src\main\java\org\apache\hadoop\hdfs\server\federation\store\records\RouterState.java,155,40,4,2,0,46
hadoop-trunk\hadoop-trunk\hadoop-mapreduce-project\hadoop-mapreduce-client\hadoop-mapreduce-client-core\src\test\java\org\apache\hadoop\mapreduce\lib\output\TestPreemptableFileOutputCommitter.java,66,13,1,1,0,15
hadoop-trunk\hadoop-trunk\hadoop-mapreduce-project\hadoop-mapreduce-client\hadoop-mapreduce-client-core\src\main\java\org\apache\hadoop\mapreduce\lib\output\committer\manifest\stages\ValidateRenamedFilesStage.java,148,6,0,9,0,15
hadoop-trunk\hadoop-trunk\hadoop-yarn-project\hadoop-yarn\hadoop-yarn-common\src\main\java\org\apache\hadoop\yarn\api\pb\PlacementConstraintFromProtoConverter.java,73,12,24,5,0,41
hadoop-trunk\hadoop-trunk\hadoop-yarn-project\hadoop-yarn\hadoop-yarn-api\src\main\java\org\apache\hadoop\yarn\server\api\protocolrecords\RefreshNodesResourcesRequest.java,10,1,1,1,0,3
hadoop-trunk\hadoop-trunk\hadoop-yarn-project\hadoop-yarn\hadoop-yarn-server\hadoop-yarn-server-resourcemanager\src\test\java\org\apache\hadoop\yarn\server\resourcemanager\scheduler\policy\TestFifoOrderingPolicy.java,0,42,5,9,0,56
hadoop-trunk\hadoop-trunk\hadoop-common-project\hadoop-common\src\main\java\org\apache\hadoop\io\retry\AtMostOnce.java,0,2,0,1,0,3
hadoop-trunk\hadoop-trunk\hadoop-mapreduce-project\hadoop-mapreduce-client\hadoop-mapreduce-client-jobclient\src\test\java\org\apache\hadoop\mapreduce\v2\TestMRAMWithNonNormalizedCapabilities.java,83,22,7,1,0,30
hadoop-trunk\hadoop-trunk\hadoop-mapreduce-project\hadoop-mapreduce-client\hadoop-mapreduce-client-app\src\test\java\org\apache\hadoop\mapreduce\v2\app\MRAppBenchmark.java,236,68,4,7,0,79
hadoop-trunk\hadoop-trunk\hadoop-yarn-project\hadoop-yarn\hadoop-yarn-common\src\main\java\org\apache\hadoop\yarn\nodelabels\event\StoreNewClusterNodeLabels.java,13,8,0,1,0,9
hadoop-trunk\hadoop-trunk\hadoop-common-project\hadoop-common\src\main\java\org\apache\hadoop\security\token\package-info.java,0,1,0,1,0,2
hadoop-trunk\hadoop-trunk\hadoop-mapreduce-project\hadoop-mapreduce-client\hadoop-mapreduce-client-jobclient\src\test\java\org\apache\hadoop\mapred\TestMiniMRBringup.java,30,3,5,1,0,9
hadoop-trunk\hadoop-trunk\hadoop-tools\hadoop-gridmix\src\test\java\org\apache\hadoop\mapred\gridmix\TestHighRamJob.java,155,128,1,1,0,130
hadoop-trunk\hadoop-trunk\hadoop-mapreduce-project\hadoop-mapreduce-client\hadoop-mapreduce-client-core\src\main\java\org\apache\hadoop\mapred\lib\LongSumReducer.java,0,9,0,1,0,10
hadoop-trunk\hadoop-trunk\hadoop-yarn-project\hadoop-yarn\hadoop-yarn-server\hadoop-yarn-server-resourcemanager\src\test\java\org\apache\hadoop\yarn\server\resourcemanager\rmapp\attempt\TestAMLivelinessMonitor.java,49,9,3,3,0,15
hadoop-trunk\hadoop-trunk\hadoop-mapreduce-project\hadoop-mapreduce-client\hadoop-mapreduce-client-core\src\main\java\org\apache\hadoop\mapreduce\lib\output\LazyOutputFormat.java,0,47,3,3,0,53
hadoop-trunk\hadoop-trunk\hadoop-yarn-project\hadoop-yarn\hadoop-yarn-server\hadoop-yarn-server-common\src\main\java\org\apache\hadoop\yarn\server\api\records\impl\pb\OpportunisticContainersStatusPBImpl.java,0,30,45,1,0,76
hadoop-trunk\hadoop-trunk\hadoop-yarn-project\hadoop-yarn\hadoop-yarn-server\hadoop-yarn-server-common\src\main\java\org\apache\hadoop\yarn\server\utils\LeveldbIterator.java,172,17,0,1,0,18
hadoop-trunk\hadoop-trunk\hadoop-yarn-project\hadoop-yarn\hadoop-yarn-server\hadoop-yarn-server-resourcemanager\src\test\java\org\apache\hadoop\yarn\server\resourcemanager\TestRMRestart.java,2887,403,54,41,0,498
hadoop-trunk\hadoop-trunk\hadoop-hdfs-project\hadoop-hdfs-nfs\src\test\java\org\apache\hadoop\hdfs\nfs\TestMountd.java,40,8,3,1,0,12
hadoop-trunk\hadoop-trunk\hadoop-mapreduce-project\hadoop-mapreduce-client\hadoop-mapreduce-client-jobclient\src\test\java\testjar\ExternalMapperReducer.java,0,18,8,1,0,27
hadoop-trunk\hadoop-trunk\hadoop-tools\hadoop-azure\src\test\java\org\apache\hadoop\fs\azure\ITestWasbRemoteCallHelper.java,0,67,1,31,0,99
hadoop-trunk\hadoop-trunk\hadoop-common-project\hadoop-common\src\test\java\org\apache\hadoop\fs\viewfs\TestViewFsWithAuthorityLocalFs.java,39,8,0,1,0,9
hadoop-trunk\hadoop-trunk\hadoop-yarn-project\hadoop-yarn\hadoop-yarn-server\hadoop-yarn-server-nodemanager\src\main\java\org\apache\hadoop\yarn\server\nodemanager\containermanager\linux\runtime\JavaSandboxLinuxContainerRuntime.java,0,100,10,17,0,127
hadoop-trunk\hadoop-trunk\hadoop-hdfs-project\hadoop-hdfs\src\main\java\org\apache\hadoop\hdfs\server\balancer\BalancingPolicy.java,127,55,1,1,0,57
hadoop-trunk\hadoop-trunk\hadoop-yarn-project\hadoop-yarn\hadoop-yarn-server\hadoop-yarn-server-nodemanager\src\test\java\org\apache\hadoop\yarn\server\nodemanager\containermanager\localizer\TestLocalResource.java,130,32,15,15,0,62
hadoop-trunk\hadoop-trunk\hadoop-yarn-project\hadoop-yarn\hadoop-yarn-server\hadoop-yarn-server-resourcemanager\src\main\java\org\apache\hadoop\yarn\server\resourcemanager\nodelabels\NodeLabelsUtils.java,0,9,1,1,0,11
hadoop-trunk\hadoop-trunk\hadoop-tools\hadoop-datajoin\src\main\java\org\apache\hadoop\contrib\utils\join\DataJoinJob.java,130,30,16,3,0,49
hadoop-trunk\hadoop-trunk\hadoop-yarn-project\hadoop-yarn\hadoop-yarn-applications\hadoop-yarn-services\hadoop-yarn-services-core\src\main\java\org\apache\hadoop\yarn\service\ClientAMPolicyProvider.java,14,2,0,1,0,3
hadoop-trunk\hadoop-trunk\hadoop-yarn-project\hadoop-yarn\hadoop-yarn-server\hadoop-yarn-server-nodemanager\src\main\java\org\apache\hadoop\yarn\server\nodemanager\containermanager\localizer\event\ContainerLocalizationRequestEvent.java,23,10,0,6,0,16
hadoop-trunk\hadoop-trunk\hadoop-yarn-project\hadoop-yarn\hadoop-yarn-server\hadoop-yarn-server-resourcemanager\src\main\java\org\apache\hadoop\yarn\server\resourcemanager\placement\RejectPlacementRule.java,32,7,0,2,0,9
hadoop-trunk\hadoop-trunk\hadoop-yarn-project\hadoop-yarn\hadoop-yarn-server\hadoop-yarn-server-common\src\test\java\org\apache\hadoop\yarn\server\api\TestServerRMProxy.java,25,2,2,1,0,5
hadoop-trunk\hadoop-trunk\hadoop-yarn-project\hadoop-yarn\hadoop-yarn-common\src\main\java\org\apache\hadoop\yarn\event\Dispatcher.java,0,4,3,1,0,8
hadoop-trunk\hadoop-trunk\hadoop-mapreduce-project\hadoop-mapreduce-client\hadoop-mapreduce-client-jobclient\src\test\java\org\apache\hadoop\mapred\pipes\PipeApplicationStub.java,74,14,0,2,0,16
hadoop-trunk\hadoop-trunk\hadoop-common-project\hadoop-registry\src\main\java\org\apache\hadoop\registry\client\types\AddressTypes.java,0,24,14,1,0,39
hadoop-trunk\hadoop-trunk\hadoop-common-project\hadoop-common\src\test\java\org\apache\hadoop\fs\TestRawLocalFileSystemContract.java,164,15,5,1,0,21
hadoop-trunk\hadoop-trunk\hadoop-hdfs-project\hadoop-hdfs\src\test\java\org\apache\hadoop\cli\util\ErasureCodingCliCmdExecutor.java,16,10,0,1,0,11
hadoop-trunk\hadoop-trunk\hadoop-yarn-project\hadoop-yarn\hadoop-yarn-client\src\main\java\org\apache\hadoop\yarn\client\api\ContainerShellWebSocket.java,117,31,5,1,0,37
hadoop-trunk\hadoop-trunk\hadoop-yarn-project\hadoop-yarn\hadoop-yarn-common\src\main\java\org\apache\hadoop\yarn\api\protocolrecords\impl\pb\package-info.java,0,1,0,1,0,2
hadoop-trunk\hadoop-trunk\hadoop-yarn-project\hadoop-yarn\hadoop-yarn-server\hadoop-yarn-server-common\src\main\java\org\apache\hadoop\yarn\server\federation\policies\amrmproxy\HomeAMRMProxyPolicy.java,37,5,0,5,0,10
hadoop-trunk\hadoop-trunk\hadoop-tools\hadoop-azure\src\test\java\org\apache\hadoop\fs\azure\AbstractWasbTestBase.java,0,16,2,1,0,19
hadoop-trunk\hadoop-trunk\hadoop-common-project\hadoop-common\src\test\java\org\apache\hadoop\fs\SymlinkBaseTest.java,1379,427,30,2,0,459
hadoop-trunk\hadoop-trunk\hadoop-yarn-project\hadoop-yarn\hadoop-yarn-server\hadoop-yarn-server-resourcemanager\src\main\java\org\apache\hadoop\yarn\server\resourcemanager\scheduler\capacity\placement\MappingRuleCreator.java,189,27,0,13,0,40
hadoop-trunk\hadoop-trunk\hadoop-mapreduce-project\hadoop-mapreduce-client\hadoop-mapreduce-client-app\src\test\java\org\apache\hadoop\mapreduce\v2\app\TestAMInfos.java,48,1,0,1,0,2
hadoop-trunk\hadoop-trunk\hadoop-hdfs-project\hadoop-hdfs\src\test\java\org\apache\hadoop\hdfs\server\blockmanagement\TestHost2NodesMap.java,68,26,22,1,0,49
hadoop-trunk\hadoop-trunk\hadoop-hdfs-project\hadoop-hdfs\src\test\java\org\apache\hadoop\hdfs\server\namenode\TestTruncateQuotaUpdate.java,121,16,6,1,0,23
hadoop-trunk\hadoop-trunk\hadoop-yarn-project\hadoop-yarn\hadoop-yarn-server\hadoop-yarn-server-timelineservice-hbase\hadoop-yarn-server-timelineservice-hbase-client\src\main\java\org\apache\hadoop\yarn\server\timelineservice\storage\subapplication\package-info.java,0,0,0,1,0,1
hadoop-trunk\hadoop-trunk\hadoop-hdfs-project\hadoop-hdfs\src\test\java\org\apache\hadoop\hdfs\server\namenode\web\resources\TestWebHdfsCreatePermissions.java,86,13,2,1,0,16
hadoop-trunk\hadoop-trunk\hadoop-yarn-project\hadoop-yarn\hadoop-yarn-server\hadoop-yarn-server-timelineservice-documentstore\src\main\java\org\apache\hadoop\yarn\server\timelineservice\documentstore\collection\document\entity\TimelineMetricSubDoc.java,132,42,2,3,0,47
hadoop-trunk\hadoop-trunk\hadoop-hdfs-project\hadoop-hdfs\src\test\java\org\apache\hadoop\hdfs\server\namenode\FSAclBaseTest.java,1760,378,148,3,0,529
hadoop-trunk\hadoop-trunk\hadoop-common-project\hadoop-common\src\test\java\org\apache\hadoop\util\TestLightWeightResizableGSet.java,221,40,10,1,0,51
hadoop-trunk\hadoop-trunk\hadoop-hdfs-project\hadoop-hdfs\src\main\java\org\apache\hadoop\hdfs\server\namenode\EditLogInputStream.java,183,39,1,1,0,41
hadoop-trunk\hadoop-trunk\hadoop-hdfs-project\hadoop-hdfs\src\main\java\org\apache\hadoop\hdfs\server\datanode\ReplicaAlreadyExistsException.java,12,5,0,1,0,6
hadoop-trunk\hadoop-trunk\hadoop-hdfs-project\hadoop-hdfs\src\test\java\org\apache\hadoop\hdfs\server\namenode\ha\TestXAttrsWithHA.java,72,31,1,1,0,33
hadoop-trunk\hadoop-trunk\hadoop-hdfs-project\hadoop-hdfs\src\main\java\org\apache\hadoop\hdfs\qjournal\protocol\JournalOutOfSyncException.java,9,3,0,1,0,4
hadoop-trunk\hadoop-trunk\hadoop-hdfs-project\hadoop-hdfs\src\test\java\org\apache\hadoop\hdfs\qjournal\server\TestJournalNodeSync.java,492,130,10,1,0,141
hadoop-trunk\hadoop-trunk\hadoop-yarn-project\hadoop-yarn\hadoop-yarn-api\src\test\java\org\apache\hadoop\yarn\api\records\timelineservice\TestTimelineMetric.java,0,18,3,1,0,22
hadoop-trunk\hadoop-trunk\hadoop-yarn-project\hadoop-yarn\hadoop-yarn-server\hadoop-yarn-server-resourcemanager\src\main\java\org\apache\hadoop\yarn\server\resourcemanager\scheduler\capacity\conf\YarnConfigurationStoreFactory.java,0,4,1,1,0,6
hadoop-trunk\hadoop-trunk\hadoop-mapreduce-project\hadoop-mapreduce-client\hadoop-mapreduce-client-jobclient\src\test\java\org\apache\hadoop\mapred\TestMRCJCFileOutputCommitter.java,191,32,12,4,0,48
hadoop-trunk\hadoop-trunk\hadoop-mapreduce-project\hadoop-mapreduce-client\hadoop-mapreduce-client-nativetask\src\main\java\org\apache\hadoop\mapred\nativetask\NativeDataSource.java,0,8,2,2,0,12
hadoop-trunk\hadoop-trunk\hadoop-hdfs-project\hadoop-hdfs\src\main\java\org\apache\hadoop\hdfs\server\namenode\NameNode.java,0,421,53,95,0,569
hadoop-trunk\hadoop-trunk\hadoop-hdfs-project\hadoop-hdfs\src\test\java\org\apache\hadoop\hdfs\TestAppendSnapshotTruncate.java,439,146,9,4,0,159
hadoop-trunk\hadoop-trunk\hadoop-hdfs-project\hadoop-hdfs\src\test\java\org\apache\hadoop\hdfs\server\namenode\TestListCorruptFileBlocks.java,576,123,36,9,0,168
hadoop-trunk\hadoop-trunk\hadoop-mapreduce-project\hadoop-mapreduce-client\hadoop-mapreduce-client-common\src\main\java\org\apache\hadoop\mapreduce\v2\util\MRBuilderUtils.java,80,59,1,2,0,62
hadoop-trunk\hadoop-trunk\hadoop-yarn-project\hadoop-yarn\hadoop-yarn-common\src\main\java\org\apache\hadoop\yarn\util\ResourceCalculatorProcessTree.java,159,17,5,4,0,26
hadoop-trunk\hadoop-trunk\hadoop-yarn-project\hadoop-yarn\hadoop-yarn-common\src\main\java\org\apache\hadoop\yarn\api\protocolrecords\impl\pb\GetApplicationReportResponsePBImpl.java,99,40,37,8,0,85
hadoop-trunk\hadoop-trunk\hadoop-mapreduce-project\hadoop-mapreduce-client\hadoop-mapreduce-client-hs\src\main\java\org\apache\hadoop\mapreduce\v2\hs\webapp\HsLogsPage.java,20,5,0,2,0,7
hadoop-trunk\hadoop-trunk\hadoop-yarn-project\hadoop-yarn\hadoop-yarn-server\hadoop-yarn-server-common\src\main\java\org\apache\hadoop\yarn\server\scheduler\ResourceRequestSet.java,163,16,0,1,0,17
hadoop-trunk\hadoop-trunk\hadoop-yarn-project\hadoop-yarn\hadoop-yarn-common\src\main\java\org\apache\hadoop\yarn\ipc\YarnRPC.java,38,16,5,1,0,22
hadoop-trunk\hadoop-trunk\hadoop-tools\hadoop-azure\src\test\java\org\apache\hadoop\fs\azurebfs\ITestAzureBlobFileSystemAuthorization.java,321,77,8,16,0,101
hadoop-trunk\hadoop-trunk\hadoop-common-project\hadoop-common\src\main\java\org\apache\hadoop\ipc\RPC.java,1012,475,36,10,0,521
hadoop-trunk\hadoop-trunk\hadoop-common-project\hadoop-common\src\test\java\org\apache\hadoop\io\erasurecode\rawcoder\TestNativeXORRawCoder.java,17,4,0,1,0,5
hadoop-trunk\hadoop-trunk\hadoop-tools\hadoop-azure\src\main\java\org\apache\hadoop\fs\azurebfs\services\AbfsErrors.java,0,25,0,13,0,38
hadoop-trunk\hadoop-trunk\hadoop-mapreduce-project\hadoop-mapreduce-client\hadoop-mapreduce-client-jobclient\src\test\java\org\apache\hadoop\mapred\TestCombineFileInputFormat.java,51,21,9,3,0,33
hadoop-trunk\hadoop-trunk\hadoop-hdfs-project\hadoop-hdfs\src\main\java\org\apache\hadoop\hdfs\server\datanode\fsdataset\impl\MountVolumeInfo.java,0,21,1,1,0,23
hadoop-trunk\hadoop-trunk\hadoop-yarn-project\hadoop-yarn\hadoop-yarn-server\hadoop-yarn-server-nodemanager\src\main\java\org\apache\hadoop\yarn\server\nodemanager\containermanager\volume\csi\package-info.java,0,0,0,1,0,1
hadoop-trunk\hadoop-trunk\hadoop-yarn-project\hadoop-yarn\hadoop-yarn-server\hadoop-yarn-server-nodemanager\src\test\java\org\apache\hadoop\yarn\server\nodemanager\containermanager\resourceplugin\deviceframework\FakeTestDevicePlugin4.java,23,7,2,5,0,14
hadoop-trunk\hadoop-trunk\hadoop-common-project\hadoop-common\src\test\java\org\apache\hadoop\fs\shell\find\TestName.java,68,14,2,1,0,17
hadoop-trunk\hadoop-trunk\hadoop-hdfs-project\hadoop-hdfs-rbf\src\main\java\org\apache\hadoop\hdfs\server\federation\store\records\impl\pb\MembershipStatePBImpl.java,322,61,102,8,0,171
hadoop-trunk\hadoop-trunk\hadoop-yarn-project\hadoop-yarn\hadoop-yarn-server\hadoop-yarn-server-nodemanager\src\main\java\org\apache\hadoop\yarn\server\nodemanager\containermanager\scheduler\UpdateContainerSchedulerEvent.java,62,5,0,2,0,7
hadoop-trunk\hadoop-trunk\hadoop-hdfs-project\hadoop-hdfs-client\src\main\java\org\apache\hadoop\hdfs\DeadNodeDetector.java,573,77,11,16,0,104
hadoop-trunk\hadoop-trunk\hadoop-hdfs-project\hadoop-hdfs\src\main\java\org\apache\hadoop\hdfs\qjournal\client\QuorumException.java,0,14,1,1,0,16
hadoop-trunk\hadoop-trunk\hadoop-yarn-project\hadoop-yarn\hadoop-yarn-server\hadoop-yarn-server-applicationhistoryservice\src\main\java\org\apache\hadoop\yarn\server\timeline\RollingLevelDBTimelineStore.java,1664,242,31,26,0,299
hadoop-trunk\hadoop-trunk\hadoop-hdfs-project\hadoop-hdfs\src\test\java\org\apache\hadoop\tools\TestTools.java,130,35,10,2,0,47
hadoop-trunk\hadoop-trunk\hadoop-yarn-project\hadoop-yarn\hadoop-yarn-server\hadoop-yarn-server-timelineservice-hbase\hadoop-yarn-server-timelineservice-hbase-common\src\main\java\org\apache\hadoop\yarn\server\timelineservice\storage\entity\EntityRowKeyPrefix.java,51,16,0,2,0,18
hadoop-trunk\hadoop-trunk\hadoop-common-project\hadoop-common\src\main\java\org\apache\hadoop\io\FastByteComparisons.java,211,57,20,1,0,78
hadoop-trunk\hadoop-trunk\hadoop-common-project\hadoop-common\src\test\java\org\apache\hadoop\fs\viewfs\TestViewFsLocalFs.java,18,1,0,1,0,2
hadoop-trunk\hadoop-trunk\hadoop-mapreduce-project\hadoop-mapreduce-client\hadoop-mapreduce-client-core\src\main\java\org\apache\hadoop\mapreduce\checkpoint\FSCheckpointService.java,160,47,2,1,0,50
hadoop-trunk\hadoop-trunk\hadoop-common-project\hadoop-nfs\src\main\java\org\apache\hadoop\nfs\nfs3\request\WRITE3Request.java,65,36,0,1,0,37
hadoop-trunk\hadoop-trunk\hadoop-hdfs-project\hadoop-hdfs-rbf\src\test\java\org\apache\hadoop\fs\contract\router\TestRouterHDFSContractSetTimes.java,0,5,0,1,0,6
hadoop-trunk\hadoop-trunk\hadoop-tools\hadoop-aws\src\test\java\org\apache\hadoop\fs\s3a\ITestS3ABlockOutputByteBuffer.java,12,3,0,1,0,4
hadoop-trunk\hadoop-trunk\hadoop-hdfs-project\hadoop-hdfs-rbf\src\test\java\org\apache\hadoop\hdfs\server\federation\resolver\order\TestLocalResolver.java,93,8,0,5,0,13
hadoop-trunk\hadoop-trunk\hadoop-tools\hadoop-aws\src\main\java\org\apache\hadoop\fs\s3native\S3xLoginHelper.java,0,37,8,2,0,47
hadoop-trunk\hadoop-trunk\hadoop-hdfs-project\hadoop-hdfs-rbf\src\test\java\org\apache\hadoop\hdfs\server\federation\router\TestRouterRpcSingleNS.java,163,14,20,3,0,37
hadoop-trunk\hadoop-trunk\hadoop-mapreduce-project\hadoop-mapreduce-client\hadoop-mapreduce-client-jobclient\src\test\java\org\apache\hadoop\mapred\TestReporter.java,209,82,7,1,0,90
hadoop-trunk\hadoop-trunk\hadoop-hdfs-project\hadoop-hdfs-client\src\main\java\org\apache\hadoop\hdfs\util\CombinedHostsFileReader.java,0,5,5,1,0,11
hadoop-trunk\hadoop-trunk\hadoop-yarn-project\hadoop-yarn\hadoop-yarn-server\hadoop-yarn-server-web-proxy\src\main\java\org\apache\hadoop\yarn\server\webproxy\WebAppProxyServer.java,100,19,3,2,0,24
hadoop-trunk\hadoop-trunk\hadoop-common-project\hadoop-common\src\main\java\org\apache\hadoop\fs\PathIsNotEmptyDirectoryException.java,7,3,0,1,0,4
hadoop-trunk\hadoop-trunk\hadoop-common-project\hadoop-common\src\main\java\org\apache\hadoop\security\token\delegation\web\DelegationTokenAuthenticationHandler.java,0,43,19,5,0,67
hadoop-trunk\hadoop-trunk\hadoop-yarn-project\hadoop-yarn\hadoop-yarn-applications\hadoop-yarn-services\hadoop-yarn-services-core\src\main\java\org\apache\hadoop\yarn\service\provider\docker\DockerProviderService.java,0,20,0,1,0,21
hadoop-trunk\hadoop-trunk\hadoop-yarn-project\hadoop-yarn\hadoop-yarn-server\hadoop-yarn-server-resourcemanager\src\test\java\org\apache\hadoop\yarn\server\resourcemanager\scheduler\fair\converter\TestFSConfigToCSConfigConverterMain.java,169,16,0,6,0,22
hadoop-trunk\hadoop-trunk\hadoop-common-project\hadoop-nfs\src\main\java\org\apache\hadoop\nfs\nfs3\request\CREATE3Request.java,59,29,2,1,0,32
hadoop-trunk\hadoop-trunk\hadoop-yarn-project\hadoop-yarn\hadoop-yarn-common\src\test\java\org\apache\hadoop\yarn\client\api\impl\TestTimelineReaderClientImpl.java,111,13,1,3,0,17
hadoop-trunk\hadoop-trunk\hadoop-yarn-project\hadoop-yarn\hadoop-yarn-server\hadoop-yarn-server-resourcemanager\src\main\java\org\apache\hadoop\yarn\server\resourcemanager\rmnode\RMNodeEvent.java,14,7,0,1,0,8
hadoop-trunk\hadoop-trunk\hadoop-common-project\hadoop-common\src\test\java\org\apache\hadoop\fs\TestLocalFsFCStatistics.java,34,15,0,2,0,17
hadoop-trunk\hadoop-trunk\hadoop-yarn-project\hadoop-yarn\hadoop-yarn-server\hadoop-yarn-server-resourcemanager\src\test\java\org\apache\hadoop\yarn\server\resourcemanager\TestRMNodeTransitions.java,1411,265,195,57,0,517
hadoop-trunk\hadoop-trunk\hadoop-mapreduce-project\hadoop-mapreduce-client\hadoop-mapreduce-client-core\src\main\java\org\apache\hadoop\mapreduce\lib\input\FileInputFormat.java,0,178,8,4,0,190
hadoop-trunk\hadoop-trunk\hadoop-mapreduce-project\hadoop-mapreduce-client\hadoop-mapreduce-client-core\src\main\java\org\apache\hadoop\mapreduce\lib\db\DBWritable.java,0,22,2,1,0,25
hadoop-trunk\hadoop-trunk\hadoop-yarn-project\hadoop-yarn\hadoop-yarn-api\src\main\java\org\apache\hadoop\yarn\api\records\timeline\package-info.java,0,0,0,1,0,1
hadoop-trunk\hadoop-trunk\hadoop-yarn-project\hadoop-yarn\hadoop-yarn-common\src\main\java\org\apache\hadoop\yarn\server\metrics\package-info.java,0,0,0,1,0,1
hadoop-trunk\hadoop-trunk\hadoop-yarn-project\hadoop-yarn\hadoop-yarn-common\src\test\java\org\apache\hadoop\yarn\util\resource\CustomResourceTypesConfigurationProvider.java,0,40,0,1,0,41
hadoop-trunk\hadoop-trunk\hadoop-yarn-project\hadoop-yarn\hadoop-yarn-server\hadoop-yarn-server-resourcemanager\src\test\java\org\apache\hadoop\yarn\server\resourcemanager\scheduler\capacity\conf\TestLeveldbConfigurationStore.java,113,8,1,5,0,14
hadoop-trunk\hadoop-trunk\hadoop-mapreduce-project\hadoop-mapreduce-client\hadoop-mapreduce-client-app\src\main\java\org\apache\hadoop\mapreduce\v2\app\webapp\dao\TaskCounterGroupInfo.java,19,8,2,1,0,11
hadoop-trunk\hadoop-trunk\hadoop-yarn-project\hadoop-yarn\hadoop-yarn-common\src\main\java\org\apache\hadoop\yarn\ipc\HadoopYarnProtoRPC.java,33,20,2,1,0,23
hadoop-trunk\hadoop-trunk\hadoop-mapreduce-project\hadoop-mapreduce-client\hadoop-mapreduce-client-hs\src\main\java\org\apache\hadoop\mapreduce\v2\hs\webapp\dao\HistoryInfo.java,32,17,0,1,0,18
hadoop-trunk\hadoop-trunk\hadoop-tools\hadoop-resourceestimator\src\test\java\org\apache\hadoop\resourceestimator\common\api\TestResourceSkyline.java,93,47,1,3,0,51
hadoop-trunk\hadoop-trunk\hadoop-common-project\hadoop-registry\src\main\java\org\apache\hadoop\registry\server\dns\RegistryDNSServer.java,220,25,1,1,0,27
hadoop-trunk\hadoop-trunk\hadoop-common-project\hadoop-common\src\test\java\org\apache\hadoop\io\TestVersionedWritable.java,0,125,4,22,0,151
hadoop-trunk\hadoop-trunk\hadoop-common-project\hadoop-common\src\test\java\org\apache\hadoop\fs\TestPath.java,484,94,10,10,0,114
hadoop-trunk\hadoop-trunk\hadoop-common-project\hadoop-common\src\test\java\org\apache\hadoop\ipc\TestIdentityProviders.java,49,6,3,1,0,10
hadoop-trunk\hadoop-trunk\hadoop-mapreduce-project\hadoop-mapreduce-client\hadoop-mapreduce-client-core\src\main\java\org\apache\hadoop\mapred\join\InnerJoinRecordReader.java,0,10,1,1,0,12
hadoop-trunk\hadoop-trunk\hadoop-common-project\hadoop-common\src\main\java\org\apache\hadoop\ipc\protocolPB\RefreshCallQueueProtocolClientSideTranslatorPB.java,0,14,6,2,0,22
hadoop-trunk\hadoop-trunk\hadoop-mapreduce-project\hadoop-mapreduce-client\hadoop-mapreduce-client-core\src\main\java\org\apache\hadoop\mapreduce\lib\output\committer\manifest\impl\ManifestStoreOperationsThroughFileSystem.java,148,27,1,6,0,34
hadoop-trunk\hadoop-trunk\hadoop-mapreduce-project\hadoop-mapreduce-client\hadoop-mapreduce-client-core\src\main\java\org\apache\hadoop\mapreduce\protocol\ClientProtocol.java,0,136,31,8,0,175
hadoop-trunk\hadoop-trunk\hadoop-yarn-project\hadoop-yarn\hadoop-yarn-server\hadoop-yarn-server-timelineservice-documentstore\src\main\java\org\apache\hadoop\yarn\server\timelineservice\documentstore\lib\DocumentStoreNotSupportedException.java,11,2,0,1,0,3
hadoop-trunk\hadoop-trunk\hadoop-mapreduce-project\hadoop-mapreduce-examples\src\main\java\org\apache\hadoop\examples\Join.java,118,48,8,3,0,59
hadoop-trunk\hadoop-trunk\hadoop-yarn-project\hadoop-yarn\hadoop-yarn-common\src\main\java\org\apache\hadoop\yarn\nodelabels\store\FSStoreOpHandler.java,95,14,13,3,0,30
hadoop-trunk\hadoop-trunk\hadoop-common-project\hadoop-nfs\src\main\java\org\apache\hadoop\nfs\nfs3\request\MKDIR3Request.java,35,17,0,1,0,18
hadoop-trunk\hadoop-trunk\hadoop-yarn-project\hadoop-yarn\hadoop-yarn-server\hadoop-yarn-server-resourcemanager\src\main\java\org\apache\hadoop\yarn\server\resourcemanager\scheduler\common\PendingAsk.java,35,14,0,1,0,15
hadoop-trunk\hadoop-trunk\hadoop-hdfs-project\hadoop-hdfs\src\main\java\org\apache\hadoop\hdfs\server\datanode\fsdataset\FsDatasetSpi.java,0,143,7,9,0,159
hadoop-trunk\hadoop-trunk\hadoop-tools\hadoop-streaming\src\main\java\org\apache\hadoop\streaming\io\OutputReader.java,0,13,0,1,0,14
hadoop-trunk\hadoop-trunk\hadoop-tools\hadoop-sls\src\main\java\org\apache\hadoop\yarn\sls\web\SLSWebApp.java,593,190,20,6,0,216
hadoop-trunk\hadoop-trunk\hadoop-tools\hadoop-openstack\src\main\java\org\apache\hadoop\fs\swift\auth\ApiKeyCredentials.java,62,14,1,1,0,16
hadoop-trunk\hadoop-trunk\hadoop-yarn-project\hadoop-yarn\hadoop-yarn-server\hadoop-yarn-server-timelineservice-hbase\hadoop-yarn-server-timelineservice-hbase-common\src\main\java\org\apache\hadoop\yarn\server\timelineservice\storage\common\EventColumnName.java,41,17,0,1,0,18
hadoop-trunk\hadoop-trunk\hadoop-tools\hadoop-sls\src\main\java\org\apache\hadoop\yarn\sls\scheduler\NodeUpdateSchedulerEventWrapper.java,8,4,0,1,0,5
hadoop-trunk\hadoop-trunk\hadoop-yarn-project\hadoop-yarn\hadoop-yarn-server\hadoop-yarn-server-resourcemanager\src\main\java\org\apache\hadoop\yarn\server\resourcemanager\reservation\exceptions\ContractValidationException.java,10,3,0,1,0,4
hadoop-trunk\hadoop-trunk\hadoop-hdfs-project\hadoop-hdfs\src\test\java\org\apache\hadoop\hdfs\tools\TestAdminHelper.java,26,4,0,1,0,5
hadoop-trunk\hadoop-trunk\hadoop-yarn-project\hadoop-yarn\hadoop-yarn-server\hadoop-yarn-server-nodemanager\src\main\java\org\apache\hadoop\yarn\server\nodemanager\health\NodeHealthCheckerService.java,0,15,1,1,0,17
hadoop-trunk\hadoop-trunk\hadoop-hdfs-project\hadoop-hdfs\src\test\java\org\apache\hadoop\hdfs\client\impl\TestClientBlockVerification.java,91,34,7,1,0,42
hadoop-trunk\hadoop-trunk\hadoop-tools\hadoop-distcp\src\main\java\org\apache\hadoop\tools\mapred\CopyMapper.java,0,96,9,11,0,116
hadoop-trunk\hadoop-trunk\hadoop-yarn-project\hadoop-yarn\hadoop-yarn-server\hadoop-yarn-server-resourcemanager\src\main\java\org\apache\hadoop\yarn\server\resourcemanager\scheduler\capacity\CSQueuePreemptionSettings.java,101,18,2,2,0,22
hadoop-trunk\hadoop-trunk\hadoop-common-project\hadoop-common\src\main\java\org\apache\hadoop\io\compress\snappy\SnappyCompressor.java,255,28,6,1,0,35
hadoop-trunk\hadoop-trunk\hadoop-tools\hadoop-distcp\src\main\java\org\apache\hadoop\tools\RegexpInConfigurationFilter.java,37,5,2,1,0,8
hadoop-trunk\hadoop-trunk\hadoop-tools\hadoop-distcp\src\test\java\org\apache\hadoop\tools\mapred\TestCopyMapper.java,1338,177,21,33,0,231
hadoop-trunk\hadoop-trunk\hadoop-yarn-project\hadoop-yarn\hadoop-yarn-server\hadoop-yarn-server-common\src\main\java\org\apache\hadoop\yarn\server\federation\store\records\impl\pb\GetSubClusterInfoResponsePBImpl.java,101,20,34,5,0,59
hadoop-trunk\hadoop-trunk\hadoop-hdfs-project\hadoop-hdfs-rbf\src\main\java\org\apache\hadoop\hdfs\server\federation\resolver\order\RandomResolver.java,23,2,0,1,0,3
hadoop-trunk\hadoop-trunk\hadoop-yarn-project\hadoop-yarn\hadoop-yarn-server\hadoop-yarn-server-timelineservice-hbase\hadoop-yarn-server-timelineservice-hbase-common\src\main\java\org\apache\hadoop\yarn\server\timelineservice\storage\entity\EntityColumn.java,0,14,1,5,0,20
hadoop-trunk\hadoop-trunk\hadoop-tools\hadoop-azure\src\main\java\org\apache\hadoop\fs\azurebfs\contracts\exceptions\InvalidUriAuthorityException.java,0,4,0,2,0,6
hadoop-trunk\hadoop-trunk\hadoop-yarn-project\hadoop-yarn\hadoop-yarn-server\hadoop-yarn-server-resourcemanager\src\main\java\org\apache\hadoop\yarn\server\resourcemanager\scheduler\fifo\FifoAppAttempt.java,77,16,4,8,0,28
hadoop-trunk\hadoop-trunk\hadoop-mapreduce-project\hadoop-mapreduce-client\hadoop-mapreduce-client-common\src\main\java\org\apache\hadoop\mapreduce\v2\api\protocolrecords\impl\pb\CancelDelegationTokenRequestPBImpl.java,77,30,33,4,0,67
hadoop-trunk\hadoop-trunk\hadoop-common-project\hadoop-registry\src\main\java\org\apache\hadoop\registry\client\api\RegistryOperations.java,0,5,1,1,0,7
hadoop-trunk\hadoop-trunk\hadoop-hdfs-project\hadoop-hdfs\src\test\java\org\apache\hadoop\hdfs\server\datanode\fsdataset\impl\TestSpaceReservation.java,679,101,26,6,0,133
hadoop-trunk\hadoop-trunk\hadoop-hdfs-project\hadoop-hdfs-rbf\src\test\java\org\apache\hadoop\hdfs\server\federation\router\TestDFSRouter.java,15,3,0,1,0,4
hadoop-trunk\hadoop-trunk\hadoop-tools\hadoop-openstack\src\test\java\org\apache\hadoop\fs\swift\TestLogResources.java,35,8,0,1,0,9
hadoop-trunk\hadoop-trunk\hadoop-mapreduce-project\hadoop-mapreduce-client\hadoop-mapreduce-client-jobclient\src\test\java\org\apache\hadoop\mapred\MiniMRClientClusterFactory.java,51,10,1,1,0,12
hadoop-trunk\hadoop-trunk\hadoop-yarn-project\hadoop-yarn\hadoop-yarn-server\hadoop-yarn-server-nodemanager\src\main\java\org\apache\hadoop\yarn\server\nodemanager\webapp\TerminalServlet.java,17,5,0,1,0,6
hadoop-trunk\hadoop-trunk\hadoop-yarn-project\hadoop-yarn\hadoop-yarn-client\src\main\java\org\apache\hadoop\yarn\client\api\package-info.java,0,1,0,1,0,2
hadoop-trunk\hadoop-trunk\hadoop-yarn-project\hadoop-yarn\hadoop-yarn-server\hadoop-yarn-server-nodemanager\src\test\java\org\apache\hadoop\yarn\server\nodemanager\containermanager\application\TestApplication.java,0,125,20,25,0,170
hadoop-trunk\hadoop-trunk\hadoop-yarn-project\hadoop-yarn\hadoop-yarn-server\hadoop-yarn-server-resourcemanager\src\main\java\org\apache\hadoop\yarn\server\resourcemanager\scheduler\distributed\ClusterNode.java,231,56,2,1,0,59
hadoop-trunk\hadoop-trunk\hadoop-tools\hadoop-azure\src\main\java\org\apache\hadoop\fs\azurebfs\contracts\services\package-info.java,0,2,0,1,0,3
hadoop-trunk\hadoop-trunk\hadoop-yarn-project\hadoop-yarn\hadoop-yarn-api\src\main\java\org\apache\hadoop\yarn\server\api\ApplicationInitializationContext.java,45,22,0,2,0,24
hadoop-trunk\hadoop-trunk\hadoop-yarn-project\hadoop-yarn\hadoop-yarn-common\src\main\java\org\apache\hadoop\yarn\api\records\impl\pb\EnhancedHeadroomPBImpl.java,98,19,36,2,0,57
hadoop-trunk\hadoop-trunk\hadoop-yarn-project\hadoop-yarn\hadoop-yarn-server\hadoop-yarn-server-common\src\main\java\org\apache\hadoop\yarn\server\federation\utils\package-info.java,0,0,0,1,0,1
hadoop-trunk\hadoop-trunk\hadoop-yarn-project\hadoop-yarn\hadoop-yarn-server\hadoop-yarn-server-timelineservice-hbase\hadoop-yarn-server-timelineservice-hbase-server\hadoop-yarn-server-timelineservice-hbase-server-1\src\main\java\org\apache\hadoop\yarn\server\timelineservice\storage\common\HBaseTimelineServerUtils.java,0,23,2,3,0,28
hadoop-trunk\hadoop-trunk\hadoop-tools\hadoop-streaming\src\main\java\org\apache\hadoop\record\RecordInput.java,0,14,0,1,0,15
hadoop-trunk\hadoop-trunk\hadoop-mapreduce-project\hadoop-mapreduce-client\hadoop-mapreduce-client-core\src\main\java\org\apache\hadoop\mapreduce\lib\chain\ChainReducer.java,0,31,6,1,0,38
hadoop-trunk\hadoop-trunk\hadoop-yarn-project\hadoop-yarn\hadoop-yarn-server\hadoop-yarn-server-resourcemanager\src\main\java\org\apache\hadoop\yarn\server\resourcemanager\volume\csi\provisioner\VolumeProvisioner.java,0,0,0,1,0,1
hadoop-trunk\hadoop-trunk\hadoop-tools\hadoop-azure\src\main\java\org\apache\hadoop\fs\azurebfs\utils\Base64.java,0,125,0,16,0,141
hadoop-trunk\hadoop-trunk\hadoop-mapreduce-project\hadoop-mapreduce-client\hadoop-mapreduce-client-nativetask\src\test\java\org\apache\hadoop\mapred\nativetask\kvtest\LargeKVTest.java,91,22,2,8,0,32
hadoop-trunk\hadoop-trunk\hadoop-hdfs-project\hadoop-hdfs\src\test\java\org\apache\hadoop\cli\CLITestCmdDFS.java,14,8,1,1,0,10
hadoop-trunk\hadoop-trunk\hadoop-common-project\hadoop-nfs\src\main\java\org\apache\hadoop\nfs\nfs3\response\READLINK3Response.java,41,20,0,1,0,21
hadoop-trunk\hadoop-trunk\hadoop-hdfs-project\hadoop-hdfs-rbf\src\main\java\org\apache\hadoop\hdfs\server\federation\router\ConnectionPoolId.java,106,13,1,1,0,15
hadoop-trunk\hadoop-trunk\hadoop-common-project\hadoop-common\src\test\java\org\apache\hadoop\cli\util\RegexpAcrossOutputComparator.java,13,3,0,1,0,4
hadoop-trunk\hadoop-trunk\hadoop-common-project\hadoop-common\src\test\java\org\apache\hadoop\fs\TestTruncatedInputBug.java,80,17,5,1,0,23
hadoop-trunk\hadoop-trunk\hadoop-yarn-project\hadoop-yarn\hadoop-yarn-csi\src\test\java\org\apache\hadoop\yarn\csi\client\FakeCsiIdentityService.java,0,3,8,1,0,12
hadoop-trunk\hadoop-trunk\hadoop-tools\hadoop-azure\src\test\java\org\apache\hadoop\fs\azure\ITestAzureFileSystemErrorConditions.java,195,26,4,5,0,35
hadoop-trunk\hadoop-trunk\hadoop-yarn-project\hadoop-yarn\hadoop-yarn-common\src\main\java\org\apache\hadoop\yarn\api\records\impl\pb\LocalizationStatusPBImpl.java,159,30,43,2,0,75
hadoop-trunk\hadoop-trunk\hadoop-tools\hadoop-resourceestimator\src\main\java\org\apache\hadoop\resourceestimator\translator\validator\ParserValidator.java,13,1,1,1,0,3
hadoop-trunk\hadoop-trunk\hadoop-hdfs-project\hadoop-hdfs\src\test\java\org\apache\hadoop\hdfs\server\namenode\TestGetImageServlet.java,54,15,1,4,0,20
hadoop-trunk\hadoop-trunk\hadoop-yarn-project\hadoop-yarn\hadoop-yarn-server\hadoop-yarn-server-nodemanager\src\main\java\org\apache\hadoop\yarn\server\nodemanager\ContainerStateTransitionListener.java,0,0,0,4,0,4
hadoop-trunk\hadoop-trunk\hadoop-yarn-project\hadoop-yarn\hadoop-yarn-common\src\test\java\org\apache\hadoop\yarn\util\TestTimes.java,42,24,0,1,0,25
hadoop-trunk\hadoop-trunk\hadoop-hdfs-project\hadoop-hdfs-rbf\src\main\java\org\apache\hadoop\hdfs\server\federation\store\protocol\impl\pb\GetNamespaceInfoResponsePBImpl.java,0,11,33,6,0,50
hadoop-trunk\hadoop-trunk\hadoop-common-project\hadoop-common\src\main\java\org\apache\hadoop\crypto\CipherSuite.java,0,17,0,1,0,18
hadoop-trunk\hadoop-trunk\hadoop-yarn-project\hadoop-yarn\hadoop-yarn-server\hadoop-yarn-server-nodemanager\src\test\java\org\apache\hadoop\yarn\server\nodemanager\MockContainerLocalizer.java,20,12,1,1,0,14
hadoop-trunk\hadoop-trunk\hadoop-hdfs-project\hadoop-hdfs\src\main\java\org\apache\hadoop\hdfs\qjournal\protocolPB\InterQJournalProtocolPB.java,0,2,3,2,0,7
hadoop-trunk\hadoop-trunk\hadoop-hdfs-project\hadoop-hdfs-client\src\main\java\org\apache\hadoop\hdfs\server\protocol\DataNodeUsageReport.java,0,48,3,1,0,52
hadoop-trunk\hadoop-trunk\hadoop-mapreduce-project\hadoop-mapreduce-client\hadoop-mapreduce-client-core\src\test\java\org\apache\hadoop\mapreduce\lib\output\TestFileOutputCommitter.java,805,116,43,3,0,162
hadoop-trunk\hadoop-trunk\hadoop-hdfs-project\hadoop-hdfs\src\test\java\org\apache\hadoop\hdfs\server\namenode\TestListOpenFiles.java,291,39,14,2,0,55
hadoop-trunk\hadoop-trunk\hadoop-tools\hadoop-aws\src\main\java\org\apache\hadoop\fs\s3a\commit\staging\DirectoryStagingCommitter.java,88,10,4,1,0,15
hadoop-trunk\hadoop-trunk\hadoop-tools\hadoop-azure\src\test\java\org\apache\hadoop\fs\azurebfs\constants\TestConfigurationKeys.java,0,51,0,23,0,74
hadoop-trunk\hadoop-trunk\hadoop-hdfs-project\hadoop-hdfs-client\src\main\java\org\apache\hadoop\hdfs\web\resources\RenewerParam.java,22,4,1,1,0,6
hadoop-trunk\hadoop-trunk\hadoop-hdfs-project\hadoop-hdfs-rbf\src\main\java\org\apache\hadoop\hdfs\server\federation\store\protocol\AddMountTableEntryRequest.java,21,6,0,2,0,8
hadoop-trunk\hadoop-trunk\hadoop-yarn-project\hadoop-yarn\hadoop-yarn-api\src\main\java\org\apache\hadoop\yarn\api\protocolrecords\GetClusterNodesRequest.java,31,10,1,1,0,12
hadoop-trunk\hadoop-trunk\hadoop-mapreduce-project\hadoop-mapreduce-client\hadoop-mapreduce-client-common\src\main\java\org\apache\hadoop\mapreduce\v2\security\client\ClientHSTokenSelector.java,26,5,1,1,0,7
hadoop-trunk\hadoop-trunk\hadoop-yarn-project\hadoop-yarn\hadoop-yarn-server\hadoop-yarn-server-timelineservice-hbase\hadoop-yarn-server-timelineservice-hbase-server\hadoop-yarn-server-timelineservice-hbase-server-2\src\main\java\org\apache\hadoop\yarn\server\timelineservice\storage\flow\FlowRunCoprocessor.java,0,41,13,4,0,58
hadoop-trunk\hadoop-trunk\hadoop-cloud-storage-project\hadoop-huaweicloud\src\test\java\org\apache\hadoop\fs\obs\TestOBSFileContextUtil.java,25,2,0,1,0,3
hadoop-trunk\hadoop-trunk\hadoop-hdfs-project\hadoop-hdfs\src\test\java\org\apache\hadoop\hdfs\server\namenode\ha\TestRetryCacheWithHA.java,1372,393,15,6,0,414
hadoop-trunk\hadoop-trunk\hadoop-mapreduce-project\hadoop-mapreduce-client\hadoop-mapreduce-client-common\src\main\java\org\apache\hadoop\mapreduce\v2\api\impl\pb\client\HSClientProtocolPBClientImpl.java,0,6,0,1,0,7
hadoop-trunk\hadoop-trunk\hadoop-yarn-project\hadoop-yarn\hadoop-yarn-server\hadoop-yarn-server-sharedcachemanager\src\test\java\org\apache\hadoop\yarn\server\sharedcachemanager\metrics\TestCleanerMetrics.java,40,18,0,1,0,19
hadoop-trunk\hadoop-trunk\hadoop-hdfs-project\hadoop-hdfs\src\main\java\org\apache\hadoop\hdfs\server\namenode\metrics\ECBlockGroupsMBean.java,0,7,0,1,0,8
hadoop-trunk\hadoop-trunk\hadoop-mapreduce-project\hadoop-mapreduce-client\hadoop-mapreduce-client-core\src\main\java\org\apache\hadoop\mapred\ReduceTaskStatus.java,0,49,3,3,0,55
hadoop-trunk\hadoop-trunk\hadoop-hdfs-project\hadoop-hdfs\src\main\java\org\apache\hadoop\hdfs\qjournal\client\IPCLoggerChannelMetrics.java,0,35,2,2,0,39
hadoop-trunk\hadoop-trunk\hadoop-tools\hadoop-aws\src\test\java\org\apache\hadoop\fs\contract\s3a\ITestS3AContractContentSummary.java,39,10,0,5,0,15
hadoop-trunk\hadoop-trunk\hadoop-mapreduce-project\hadoop-mapreduce-client\hadoop-mapreduce-client-core\src\main\java\org\apache\hadoop\mapred\join\MultiFilterRecordReader.java,0,35,8,1,0,44
hadoop-trunk\hadoop-trunk\hadoop-yarn-project\hadoop-yarn\hadoop-yarn-server\hadoop-yarn-server-web-proxy\src\main\java\org\apache\hadoop\yarn\server\webproxy\ProxyCA.java,352,87,4,1,0,92
hadoop-trunk\hadoop-trunk\hadoop-common-project\hadoop-common\src\main\java\org\apache\hadoop\fs\XAttrCodec.java,0,27,2,1,0,30
hadoop-trunk\hadoop-trunk\hadoop-tools\hadoop-azure\src\main\java\org\apache\hadoop\fs\azurebfs\contracts\diagnostics\ConfigurationValidator.java,0,2,0,3,0,5
hadoop-trunk\hadoop-trunk\hadoop-hdfs-project\hadoop-hdfs-client\src\main\java\org\apache\hadoop\hdfs\protocol\HdfsLocatedFileStatus.java,0,55,4,1,0,60
hadoop-trunk\hadoop-trunk\hadoop-hdfs-project\hadoop-hdfs-rbf\src\test\java\org\apache\hadoop\hdfs\server\federation\security\MockNotRunningSecretManager.java,0,7,1,3,0,11
hadoop-trunk\hadoop-trunk\hadoop-yarn-project\hadoop-yarn\hadoop-yarn-api\src\test\java\org\apache\hadoop\yarn\api\records\timelineservice\TestApplicationEntity.java,0,1,0,1,0,2
hadoop-trunk\hadoop-trunk\hadoop-yarn-project\hadoop-yarn\hadoop-yarn-server\hadoop-yarn-server-nodemanager\src\test\java\org\apache\hadoop\yarn\server\nodemanager\containermanager\launcher\TestContainerLaunch.java,0,479,164,49,0,692
hadoop-trunk\hadoop-trunk\hadoop-mapreduce-project\hadoop-mapreduce-client\hadoop-mapreduce-client-core\src\main\java\org\apache\hadoop\mapred\SequenceFileAsBinaryInputFormat.java,0,41,6,1,0,48
hadoop-trunk\hadoop-trunk\hadoop-yarn-project\hadoop-yarn\hadoop-yarn-common\src\main\java\org\apache\hadoop\yarn\api\protocolrecords\impl\pb\RenewDelegationTokenRequestPBImpl.java,94,35,37,3,0,75
hadoop-trunk\hadoop-trunk\hadoop-yarn-project\hadoop-yarn\hadoop-yarn-server\hadoop-yarn-server-nodemanager\src\main\java\org\apache\hadoop\yarn\server\nodemanager\api\deviceplugin\package-info.java,0,1,0,1,0,2
hadoop-trunk\hadoop-trunk\hadoop-mapreduce-project\hadoop-mapreduce-examples\src\main\java\org\apache\hadoop\examples\pi\math\Bellard.java,0,187,24,4,0,215
hadoop-trunk\hadoop-trunk\hadoop-common-project\hadoop-common\src\main\java\org\apache\hadoop\fs\protocolPB\PBHelper.java,0,13,27,1,0,41
hadoop-trunk\hadoop-trunk\hadoop-yarn-project\hadoop-yarn\hadoop-yarn-common\src\main\java\org\apache\hadoop\yarn\api\protocolrecords\impl\pb\SignalContainerResponsePBImpl.java,21,13,13,3,0,29
hadoop-trunk\hadoop-trunk\hadoop-common-project\hadoop-common\src\main\java\org\apache\hadoop\fs\StreamCapabilitiesPolicy.java,0,4,3,1,0,8
hadoop-trunk\hadoop-trunk\hadoop-yarn-project\hadoop-yarn\hadoop-yarn-server\hadoop-yarn-server-common\src\main\java\org\apache\hadoop\yarn\server\records\impl\pb\VersionPBImpl.java,53,19,26,2,0,47
hadoop-trunk\hadoop-trunk\hadoop-yarn-project\hadoop-yarn\hadoop-yarn-server\hadoop-yarn-server-resourcemanager\src\main\java\org\apache\hadoop\yarn\server\resourcemanager\nodelabels\NodeAttributesManagerImpl.java,684,140,12,3,0,155
hadoop-trunk\hadoop-trunk\hadoop-common-project\hadoop-common\src\main\java\org\apache\hadoop\ipc\package-info.java,0,0,0,1,0,1
hadoop-trunk\hadoop-trunk\hadoop-mapreduce-project\hadoop-mapreduce-client\hadoop-mapreduce-client-jobclient\src\test\java\org\apache\hadoop\mapreduce\lib\join\TestJoinDatamerge.java,412,108,26,3,0,137
hadoop-trunk\hadoop-trunk\hadoop-hdfs-project\hadoop-hdfs\src\test\java\org\apache\hadoop\hdfs\server\blockmanagement\TestRBWBlockInvalidation.java,253,35,4,7,0,46
hadoop-trunk\hadoop-trunk\hadoop-hdfs-project\hadoop-hdfs-httpfs\src\main\java\org\apache\hadoop\fs\http\server\HttpFSAuthenticationFilter.java,0,11,1,5,0,17
hadoop-trunk\hadoop-trunk\hadoop-tools\hadoop-federation-balance\src\test\java\org\apache\hadoop\tools\fedbalance\procedure\TestBalanceProcedureScheduler.java,395,73,47,4,0,124
hadoop-trunk\hadoop-trunk\hadoop-yarn-project\hadoop-yarn\hadoop-yarn-server\hadoop-yarn-server-timelineservice\src\main\java\org\apache\hadoop\yarn\server\timelineservice\reader\TimelineParserForDataToRetrieve.java,64,12,1,5,0,18
hadoop-trunk\hadoop-trunk\hadoop-yarn-project\hadoop-yarn\hadoop-yarn-server\hadoop-yarn-server-resourcemanager\src\main\java\org\apache\hadoop\yarn\server\resourcemanager\scheduler\placement\LocalityAppPlacementAllocator.java,0,90,9,9,0,108
hadoop-trunk\hadoop-trunk\hadoop-common-project\hadoop-common\src\test\java\org\apache\hadoop\cli\util\CommandExecutor.java,0,41,4,1,0,46
hadoop-trunk\hadoop-trunk\hadoop-yarn-project\hadoop-yarn\hadoop-yarn-server\hadoop-yarn-server-resourcemanager\src\test\java\org\apache\hadoop\yarn\server\resourcemanager\security\TestDelegationTokenRenewer.java,0,493,98,17,0,608
hadoop-trunk\hadoop-trunk\hadoop-mapreduce-project\hadoop-mapreduce-client\hadoop-mapreduce-client-app\src\test\java\org\apache\hadoop\mapreduce\v2\app\webapp\TestAMWebServicesJobs.java,850,109,4,5,0,118
hadoop-trunk\hadoop-trunk\hadoop-hdfs-project\hadoop-hdfs-rbf\src\main\java\org\apache\hadoop\hdfs\server\federation\store\protocol\impl\pb\GetRouterRegistrationRequestPBImpl.java,0,11,29,5,0,45
hadoop-trunk\hadoop-trunk\hadoop-mapreduce-project\hadoop-mapreduce-client\hadoop-mapreduce-client-app\src\main\java\org\apache\hadoop\mapred\WrappedProgressSplitsBlock.java,47,17,1,1,0,19
hadoop-trunk\hadoop-trunk\hadoop-common-project\hadoop-common\src\test\java\org\apache\hadoop\security\alias\TestCredentialProvider.java,24,17,0,4,0,21
hadoop-trunk\hadoop-trunk\hadoop-hdfs-project\hadoop-hdfs\src\main\java\org\apache\hadoop\hdfs\protocolPB\package-info.java,0,1,1,1,0,3
hadoop-trunk\hadoop-trunk\hadoop-yarn-project\hadoop-yarn\hadoop-yarn-server\hadoop-yarn-server-resourcemanager\src\test\java\org\apache\hadoop\yarn\server\resourcemanager\scheduler\capacity\TestCSAllocateCustomResource.java,263,32,14,10,0,56
hadoop-trunk\hadoop-trunk\hadoop-hdfs-project\hadoop-hdfs\src\test\java\org\apache\hadoop\hdfs\qjournal\TestNNWithQJM.java,166,30,2,1,0,33
hadoop-trunk\hadoop-trunk\hadoop-hdfs-project\hadoop-hdfs-rbf\src\test\java\org\apache\hadoop\hdfs\server\federation\router\TestRouterRpcMultiDestination.java,400,14,5,5,0,24
hadoop-trunk\hadoop-trunk\hadoop-mapreduce-project\hadoop-mapreduce-client\hadoop-mapreduce-client-app\src\main\java\org\apache\hadoop\mapreduce\v2\app\job\event\JobFinishEvent.java,0,8,0,1,0,9
hadoop-trunk\hadoop-trunk\hadoop-yarn-project\hadoop-yarn\hadoop-yarn-common\src\main\java\org\apache\hadoop\yarn\api\protocolrecords\impl\pb\GetNodesToAttributesResponsePBImpl.java,0,18,41,1,0,60
hadoop-trunk\hadoop-trunk\hadoop-hdfs-project\hadoop-hdfs-nfs\src\test\java\org\apache\hadoop\hdfs\nfs\nfs3\TestReaddir.java,157,40,12,1,0,53
hadoop-trunk\hadoop-trunk\hadoop-yarn-project\hadoop-yarn\hadoop-yarn-applications\hadoop-yarn-services\hadoop-yarn-services-core\src\main\java\org\apache\hadoop\yarn\service\provider\docker\DockerClientProvider.java,0,9,2,1,0,12
hadoop-trunk\hadoop-trunk\hadoop-yarn-project\hadoop-yarn\hadoop-yarn-applications\hadoop-yarn-services\hadoop-yarn-services-core\src\test\java\org\apache\hadoop\yarn\service\monitor\probe\TestDefaultProbe.java,113,14,2,1,0,17
hadoop-trunk\hadoop-trunk\hadoop-common-project\hadoop-common\src\test\java\org\apache\hadoop\ha\ZKFCTestUtil.java,14,7,1,1,0,9
hadoop-trunk\hadoop-trunk\hadoop-common-project\hadoop-common\src\main\java\org\apache\hadoop\security\KDiag.java,0,154,13,3,0,170
hadoop-trunk\hadoop-trunk\hadoop-yarn-project\hadoop-yarn\hadoop-yarn-server\hadoop-yarn-server-web-proxy\src\main\java\org\apache\hadoop\yarn\server\webproxy\AppReportFetcher.java,133,29,2,3,0,34
hadoop-trunk\hadoop-trunk\hadoop-hdfs-project\hadoop-hdfs\src\main\java\org\apache\hadoop\hdfs\server\datanode\BlockPoolSliceStorage.java,843,156,18,14,0,188
hadoop-trunk\hadoop-trunk\hadoop-yarn-project\hadoop-yarn\hadoop-yarn-common\src\test\java\org\apache\hadoop\yarn\api\BasePBImplRecordsTest.java,256,68,20,3,0,91
hadoop-trunk\hadoop-trunk\hadoop-yarn-project\hadoop-yarn\hadoop-yarn-server\hadoop-yarn-server-resourcemanager\src\main\java\org\apache\hadoop\yarn\server\resourcemanager\ClientRMService.java,1741,232,20,50,0,302
hadoop-trunk\hadoop-trunk\hadoop-common-project\hadoop-common\src\main\java\org\apache\hadoop\fs\shell\find\Result.java,0,21,6,1,0,28
hadoop-trunk\hadoop-trunk\hadoop-tools\hadoop-azure\src\test\java\org\apache\hadoop\fs\azurebfs\contract\ITestAbfsFileSystemContractCreate.java,26,8,0,2,0,10
hadoop-trunk\hadoop-trunk\hadoop-yarn-project\hadoop-yarn\hadoop-yarn-server\hadoop-yarn-server-timelineservice\src\main\java\org\apache\hadoop\yarn\server\timelineservice\reader\filter\TimelineCompareOp.java,0,7,0,1,0,8
hadoop-trunk\hadoop-trunk\hadoop-common-project\hadoop-common\src\main\java\org\apache\hadoop\fs\FileSystemStorageStatistics.java,126,16,1,1,0,18
hadoop-trunk\hadoop-trunk\hadoop-yarn-project\hadoop-yarn\hadoop-yarn-server\hadoop-yarn-server-timelineservice\src\test\java\org\apache\hadoop\yarn\server\timelineservice\reader\TestTimelineReaderWebServicesACL.java,122,34,1,3,0,38
hadoop-trunk\hadoop-trunk\hadoop-common-project\hadoop-common\src\main\java\org\apache\hadoop\tools\protocolPB\GetUserMappingsProtocolPB.java,0,4,3,3,0,10
hadoop-trunk\hadoop-trunk\hadoop-hdfs-project\hadoop-hdfs\src\main\java\org\apache\hadoop\hdfs\server\datanode\fsdataset\impl\BlockPoolSlice.java,1057,166,30,14,0,210
hadoop-trunk\hadoop-trunk\hadoop-yarn-project\hadoop-yarn\hadoop-yarn-server\hadoop-yarn-server-resourcemanager\src\main\java\org\apache\hadoop\yarn\server\resourcemanager\scheduler\policy\CompoundComparator.java,0,6,1,1,0,8
hadoop-trunk\hadoop-trunk\hadoop-mapreduce-project\hadoop-mapreduce-client\hadoop-mapreduce-client-core\src\main\java\org\apache\hadoop\mapreduce\lib\aggregate\ValueAggregatorJob.java,139,60,3,2,0,65
hadoop-trunk\hadoop-trunk\hadoop-common-project\hadoop-common\src\test\java\org\apache\hadoop\security\TestUGILoginFromKeytab.java,542,35,24,4,0,63
hadoop-trunk\hadoop-trunk\hadoop-tools\hadoop-aws\src\main\java\org\apache\hadoop\fs\s3a\statistics\S3AInputStreamStatistics.java,164,18,0,1,0,19
hadoop-trunk\hadoop-trunk\hadoop-tools\hadoop-aliyun\src\test\java\org\apache\hadoop\fs\aliyun\oss\AliyunOSSTestUtils.java,0,7,1,1,0,9
hadoop-trunk\hadoop-trunk\hadoop-hdfs-project\hadoop-hdfs-rbf\src\test\java\org\apache\hadoop\hdfs\server\federation\router\TestRouterMountTable.java,697,45,10,10,0,65
hadoop-trunk\hadoop-trunk\hadoop-common-project\hadoop-common\src\main\java\org\apache\hadoop\metrics2\lib\MetricsInfoImpl.java,0,9,1,1,0,11
hadoop-trunk\hadoop-trunk\hadoop-hdfs-project\hadoop-hdfs-rbf\src\test\java\org\apache\hadoop\fs\contract\router\TestRouterHDFSContractConcatSecure.java,0,4,0,1,0,5
hadoop-trunk\hadoop-trunk\hadoop-yarn-project\hadoop-yarn\hadoop-yarn-server\hadoop-yarn-server-resourcemanager\src\test\java\org\apache\hadoop\yarn\server\resourcemanager\TestRMHAForAsyncScheduler.java,159,32,0,6,0,38
hadoop-trunk\hadoop-trunk\hadoop-common-project\hadoop-common\src\main\java\org\apache\hadoop\metrics2\impl\MetricsRecordFiltered.java,0,7,0,1,0,8
hadoop-trunk\hadoop-trunk\hadoop-yarn-project\hadoop-yarn\hadoop-yarn-common\src\main\java\org\apache\hadoop\yarn\webapp\example\package-info.java,0,1,0,1,0,2
hadoop-trunk\hadoop-trunk\hadoop-yarn-project\hadoop-yarn\hadoop-yarn-server\hadoop-yarn-server-resourcemanager\src\main\java\org\apache\hadoop\yarn\server\resourcemanager\monitor\invariants\MetricsInvariantChecker.java,138,20,8,2,0,30
hadoop-trunk\hadoop-trunk\hadoop-common-project\hadoop-common\src\test\java\org\apache\hadoop\io\erasurecode\rawcoder\TestDummyRawCoder.java,65,12,2,1,0,15
hadoop-trunk\hadoop-trunk\hadoop-mapreduce-project\hadoop-mapreduce-client\hadoop-mapreduce-client-core\src\main\java\org\apache\hadoop\mapred\SequenceFileRecordReader.java,0,52,9,1,0,62
hadoop-trunk\hadoop-trunk\hadoop-yarn-project\hadoop-yarn\hadoop-yarn-server\hadoop-yarn-server-router\src\main\java\org\apache\hadoop\yarn\server\router\webapp\FederationPage.java,0,1,0,1,0,2
hadoop-trunk\hadoop-trunk\hadoop-yarn-project\hadoop-yarn\hadoop-yarn-server\hadoop-yarn-server-router\src\main\java\org\apache\hadoop\yarn\server\router\webapp\RESTRequestInterceptor.java,0,2,0,2,0,4
hadoop-trunk\hadoop-trunk\hadoop-yarn-project\hadoop-yarn\hadoop-yarn-server\hadoop-yarn-server-resourcemanager\src\main\java\org\apache\hadoop\yarn\server\resourcemanager\scheduler\fair\converter\FSQueueConverterBuilder.java,0,50,0,1,0,51
hadoop-trunk\hadoop-trunk\hadoop-yarn-project\hadoop-yarn\hadoop-yarn-common\src\main\java\org\apache\hadoop\yarn\event\Event.java,0,4,1,1,0,6
hadoop-trunk\hadoop-trunk\hadoop-yarn-project\hadoop-yarn\hadoop-yarn-server\hadoop-yarn-server-resourcemanager\src\main\java\org\apache\hadoop\yarn\server\resourcemanager\RMAppManagerEvent.java,25,16,0,1,0,17
hadoop-trunk\hadoop-trunk\hadoop-yarn-project\hadoop-yarn\hadoop-yarn-api\src\main\java\org\apache\hadoop\yarn\api\records\timelineservice\FlowRunEntity.java,98,42,0,1,0,43
hadoop-trunk\hadoop-trunk\hadoop-yarn-project\hadoop-yarn\hadoop-yarn-applications\hadoop-yarn-services\hadoop-yarn-services-core\src\test\java\org\apache\hadoop\yarn\service\containerlaunch\TestAbstractLauncher.java,69,6,2,1,0,9
hadoop-trunk\hadoop-trunk\hadoop-common-project\hadoop-common\src\main\java\org\apache\hadoop\ha\FenceMethod.java,0,4,2,1,0,7
hadoop-trunk\hadoop-trunk\hadoop-hdfs-project\hadoop-hdfs-rbf\src\test\java\org\apache\hadoop\hdfs\server\federation\resolver\order\TestAvailableSpaceResolver.java,178,14,0,9,0,23
hadoop-trunk\hadoop-trunk\hadoop-common-project\hadoop-common\src\test\java\org\apache\hadoop\fs\viewfs\TestViewFSOverloadSchemeCentralMountTableConfig.java,0,7,0,1,0,8
hadoop-trunk\hadoop-trunk\hadoop-hdfs-project\hadoop-hdfs\src\main\java\org\apache\hadoop\hdfs\server\datanode\checker\StorageLocationChecker.java,191,16,7,5,0,28
hadoop-trunk\hadoop-trunk\hadoop-common-project\hadoop-common\src\main\java\org\apache\hadoop\metrics2\util\MBeans.java,0,28,6,1,0,35
hadoop-trunk\hadoop-trunk\hadoop-hdfs-project\hadoop-hdfs-rbf\src\main\java\org\apache\hadoop\hdfs\server\federation\utils\ConsistentHashRing.java,111,15,0,1,0,16
hadoop-trunk\hadoop-trunk\hadoop-mapreduce-project\hadoop-mapreduce-client\hadoop-mapreduce-client-core\src\main\java\org\apache\hadoop\mapreduce\filecache\ClientDistributedCacheManager.java,294,89,5,5,0,99
hadoop-trunk\hadoop-trunk\hadoop-common-project\hadoop-auth\src\test\java\org\apache\hadoop\security\authentication\util\TestRandomSignerSecretProvider.java,86,7,2,1,0,10
hadoop-trunk\hadoop-trunk\hadoop-hdfs-project\hadoop-hdfs\src\test\java\org\apache\hadoop\hdfs\server\diskbalancer\DiskBalancerResultVerifier.java,0,8,1,1,0,10
hadoop-trunk\hadoop-trunk\hadoop-yarn-project\hadoop-yarn\hadoop-yarn-server\hadoop-yarn-server-nodemanager\src\main\java\org\apache\hadoop\yarn\server\nodemanager\containermanager\logaggregation\AllContainerLogAggregationPolicy.java,6,4,0,2,0,6
hadoop-trunk\hadoop-trunk\hadoop-yarn-project\hadoop-yarn\hadoop-yarn-server\hadoop-yarn-server-timelineservice\src\main\java\org\apache\hadoop\yarn\server\timelineservice\security\CollectorNodemanagerSecurityInfo.java,0,6,0,1,0,7
hadoop-trunk\hadoop-trunk\hadoop-mapreduce-project\hadoop-mapreduce-client\hadoop-mapreduce-client-core\src\main\java\org\apache\hadoop\mapreduce\lib\output\committer\manifest\stages\AbstractJobOrTaskStage.java,0,49,22,28,0,99
hadoop-trunk\hadoop-trunk\hadoop-mapreduce-project\hadoop-mapreduce-client\hadoop-mapreduce-client-core\src\main\java\org\apache\hadoop\mapreduce\security\token\delegation\DelegationTokenIdentifier.java,0,8,1,2,0,11
hadoop-trunk\hadoop-trunk\hadoop-mapreduce-project\hadoop-mapreduce-client\hadoop-mapreduce-client-hs\src\test\java\org\apache\hadoop\mapreduce\v2\hs\webapp\VerifyJobsUtils.java,111,42,1,4,0,47
hadoop-trunk\hadoop-trunk\hadoop-yarn-project\hadoop-yarn\hadoop-yarn-server\hadoop-yarn-server-timelineservice-hbase\hadoop-yarn-server-timelineservice-hbase-common\src\main\java\org\apache\hadoop\yarn\server\timelineservice\storage\common\ColumnFamily.java,0,1,0,1,0,2
hadoop-trunk\hadoop-trunk\hadoop-hdfs-project\hadoop-hdfs-client\src\main\java\org\apache\hadoop\hdfs\protocol\DatanodeAdminProperties.java,90,10,0,1,0,11
hadoop-trunk\hadoop-trunk\hadoop-hdfs-project\hadoop-hdfs\src\main\java\org\apache\hadoop\hdfs\util\DataTransferThrottler.java,106,54,0,2,0,56
hadoop-trunk\hadoop-trunk\hadoop-tools\hadoop-distcp\src\test\java\org\apache\hadoop\tools\TestCopyListingFileStatus.java,48,24,3,1,0,28
hadoop-trunk\hadoop-trunk\hadoop-common-project\hadoop-auth\src\test\java\org\apache\hadoop\security\authentication\util\StringSignerSecretProvider.java,0,10,4,1,0,15
hadoop-trunk\hadoop-trunk\hadoop-yarn-project\hadoop-yarn\hadoop-yarn-common\src\main\java\org\apache\hadoop\yarn\api\records\impl\pb\ContainerReportPBImpl.java,359,78,108,1,0,187
hadoop-trunk\hadoop-trunk\hadoop-tools\hadoop-azure\src\test\java\org\apache\hadoop\fs\azure\ITestOutputStreamSemantics.java,386,45,6,5,0,56
hadoop-trunk\hadoop-trunk\hadoop-tools\hadoop-gridmix\src\main\java\org\apache\hadoop\mapred\gridmix\ReadRecordFactory.java,0,19,0,1,0,20
hadoop-trunk\hadoop-trunk\hadoop-hdfs-project\hadoop-hdfs-httpfs\src\test\java\org\apache\hadoop\fs\http\client\TestHttpFSFileSystemLocalFileSystem.java,62,14,5,3,0,22
hadoop-trunk\hadoop-trunk\hadoop-tools\hadoop-resourceestimator\src\main\java\org\apache\hadoop\resourceestimator\common\api\RecurrenceId.java,69,9,3,1,0,13
hadoop-trunk\hadoop-trunk\hadoop-mapreduce-project\hadoop-mapreduce-client\hadoop-mapreduce-client-shuffle\src\test\java\org\apache\hadoop\mapred\TestShuffleHandler.java,1117,284,70,4,0,358
hadoop-trunk\hadoop-trunk\hadoop-yarn-project\hadoop-yarn\hadoop-yarn-applications\hadoop-yarn-services\hadoop-yarn-services-core\src\main\java\org\apache\hadoop\yarn\service\monitor\probe\MonitorKeys.java,0,3,13,1,0,17
hadoop-trunk\hadoop-trunk\hadoop-tools\hadoop-streaming\src\test\java\org\apache\hadoop\streaming\TrAppReduce.java,0,38,5,2,0,45
hadoop-trunk\hadoop-trunk\hadoop-yarn-project\hadoop-yarn\hadoop-yarn-server\hadoop-yarn-server-tests\src\test\java\org\apache\hadoop\yarn\server\MiniYARNCluster.java,875,187,19,25,0,231
hadoop-trunk\hadoop-trunk\hadoop-hdfs-project\hadoop-hdfs\src\main\java\org\apache\hadoop\hdfs\server\namenode\snapshot\SnapshotManager.java,772,174,8,7,0,189
hadoop-trunk\hadoop-trunk\hadoop-hdfs-project\hadoop-hdfs-client\src\main\java\org\apache\hadoop\hdfs\client\impl\SnapshotDiffReportGenerator.java,229,40,1,2,0,43
hadoop-trunk\hadoop-trunk\hadoop-mapreduce-project\hadoop-mapreduce-examples\src\main\java\org\apache\hadoop\examples\pi\TaskResult.java,0,30,4,1,0,35
hadoop-trunk\hadoop-trunk\hadoop-hdfs-project\hadoop-hdfs\src\test\java\org\apache\hadoop\hdfs\TestDFSInotifyEventInputStream.java,579,84,56,39,0,179
hadoop-trunk\hadoop-trunk\hadoop-common-project\hadoop-common\src\test\java\org\apache\hadoop\util\ClassLoaderCheck.java,15,7,4,1,0,12
hadoop-trunk\hadoop-trunk\hadoop-mapreduce-project\hadoop-mapreduce-client\hadoop-mapreduce-client-core\src\main\java\org\apache\hadoop\mapred\RunningJob.java,0,83,25,4,0,112
hadoop-trunk\hadoop-trunk\hadoop-yarn-project\hadoop-yarn\hadoop-yarn-server\hadoop-yarn-server-resourcemanager\src\main\java\org\apache\hadoop\yarn\server\resourcemanager\scheduler\capacity\ReservationQueue.java,62,21,2,5,0,28
hadoop-trunk\hadoop-trunk\hadoop-yarn-project\hadoop-yarn\hadoop-yarn-api\src\main\java\org\apache\hadoop\yarn\api\records\QueueStatistics.java,290,77,0,1,0,78
hadoop-trunk\hadoop-trunk\hadoop-yarn-project\hadoop-yarn\hadoop-yarn-server\hadoop-yarn-server-nodemanager\src\main\java\org\apache\hadoop\yarn\server\nodemanager\ContainerManagerEvent.java,7,2,0,1,0,3
hadoop-trunk\hadoop-trunk\hadoop-common-project\hadoop-common\src\main\java\org\apache\hadoop\fs\WindowsGetSpaceUsed.java,19,2,0,1,0,3
hadoop-trunk\hadoop-trunk\hadoop-yarn-project\hadoop-yarn\hadoop-yarn-applications\hadoop-yarn-applications-distributedshell\src\main\java\org\apache\hadoop\yarn\applications\distributedshell\Log4jPropertyHelper.java,21,4,1,1,0,6
hadoop-trunk\hadoop-trunk\hadoop-hdfs-project\hadoop-hdfs\src\test\java\org\apache\hadoop\hdfs\server\blockmanagement\BaseReplicationPolicyTest.java,0,76,4,2,0,82
hadoop-trunk\hadoop-trunk\hadoop-mapreduce-project\hadoop-mapreduce-client\hadoop-mapreduce-client-nativetask\src\test\java\org\apache\hadoop\mapred\nativetask\kvtest\KVTest.java,111,22,2,5,0,29
hadoop-trunk\hadoop-trunk\hadoop-yarn-project\hadoop-yarn\hadoop-yarn-server\hadoop-yarn-server-nodemanager\src\main\java\org\apache\hadoop\yarn\server\nodemanager\containermanager\resourceplugin\fpga\IntelFpgaOpenclPlugin.java,253,60,16,2,0,78
hadoop-trunk\hadoop-trunk\hadoop-hdfs-project\hadoop-hdfs-client\src\main\java\org\apache\hadoop\hdfs\web\resources\XAttrEncodingParam.java,36,6,0,1,0,7
hadoop-trunk\hadoop-trunk\hadoop-hdfs-project\hadoop-hdfs-rbf\src\main\java\org\apache\hadoop\hdfs\rbfbalance\RouterDistCpProcedure.java,29,9,1,1,0,11
hadoop-trunk\hadoop-trunk\hadoop-tools\hadoop-streaming\src\test\java\org\apache\hadoop\streaming\TestStreamXmlMultipleRecords.java,0,22,1,1,0,24
hadoop-trunk\hadoop-trunk\hadoop-mapreduce-project\hadoop-mapreduce-client\hadoop-mapreduce-client-jobclient\src\test\java\org\apache\hadoop\mapred\MiniMRYarnClusterAdapter.java,50,12,0,1,0,13
hadoop-trunk\hadoop-trunk\hadoop-yarn-project\hadoop-yarn\hadoop-yarn-common\src\test\java\org\apache\hadoop\yarn\logaggregation\TestAggregatedLogDeletionService.java,527,111,8,14,0,133
hadoop-trunk\hadoop-trunk\hadoop-common-project\hadoop-common\src\main\java\org\apache\hadoop\io\erasurecode\coder\util\HHUtil.java,0,31,6,1,0,38
hadoop-trunk\hadoop-trunk\hadoop-common-project\hadoop-common\src\main\java\org\apache\hadoop\ipc\ProtocolProxy.java,86,30,2,1,0,33
hadoop-trunk\hadoop-trunk\hadoop-yarn-project\hadoop-yarn\hadoop-yarn-common\src\main\java\org\apache\hadoop\yarn\api\protocolrecords\impl\pb\RollbackResponsePBImpl.java,43,16,17,1,0,34
hadoop-trunk\hadoop-trunk\hadoop-tools\hadoop-openstack\src\main\java\org\apache\hadoop\fs\swift\auth\AuthenticationResponse.java,39,28,0,1,0,29
hadoop-trunk\hadoop-trunk\hadoop-common-project\hadoop-common\src\test\java\org\apache\hadoop\metrics2\lib\TestMutableRollingAverages.java,152,24,6,1,0,31
hadoop-trunk\hadoop-trunk\hadoop-hdfs-project\hadoop-hdfs\src\test\java\org\apache\hadoop\cli\TestAclCLI.java,65,9,0,1,0,10
hadoop-trunk\hadoop-trunk\hadoop-hdfs-project\hadoop-hdfs\src\test\java\org\apache\hadoop\hdfs\server\namenode\TestHostsFiles.java,0,21,10,4,0,35
hadoop-trunk\hadoop-trunk\hadoop-yarn-project\hadoop-yarn\hadoop-yarn-server\hadoop-yarn-server-common\src\main\java\org\apache\hadoop\yarn\server\federation\store\utils\package-info.java,0,1,0,1,0,2
hadoop-trunk\hadoop-trunk\hadoop-hdfs-project\hadoop-hdfs\src\main\java\org\apache\hadoop\hdfs\server\namenode\snapshot\FSImageFormatPBSnapshot.java,569,118,77,13,0,208
hadoop-trunk\hadoop-trunk\hadoop-hdfs-project\hadoop-hdfs\src\test\java\org\apache\hadoop\hdfs\server\aliasmap\ITestInMemoryAliasMap.java,0,39,2,1,0,42
hadoop-trunk\hadoop-trunk\hadoop-mapreduce-project\hadoop-mapreduce-client\hadoop-mapreduce-client-nativetask\src\main\java\org\apache\hadoop\mapred\nativetask\StatusReportChecker.java,0,16,0,2,0,18
hadoop-trunk\hadoop-trunk\hadoop-common-project\hadoop-common\src\test\java\org\apache\hadoop\ipc\TestServer.java,167,52,14,3,0,69
hadoop-trunk\hadoop-trunk\hadoop-yarn-project\hadoop-yarn\hadoop-yarn-server\hadoop-yarn-server-resourcemanager\src\main\java\org\apache\hadoop\yarn\server\resourcemanager\scheduler\fair\QueuePlacementPolicy.java,0,35,9,8,0,52
hadoop-trunk\hadoop-trunk\hadoop-hdfs-project\hadoop-hdfs-httpfs\src\test\java\org\apache\hadoop\lib\wsrs\TestJSONProvider.java,19,1,0,1,0,2
hadoop-trunk\hadoop-trunk\hadoop-hdfs-project\hadoop-hdfs\src\test\java\org\apache\hadoop\hdfs\server\datanode\TestReadOnlySharedStorage.java,214,86,24,18,0,128
hadoop-trunk\hadoop-trunk\hadoop-yarn-project\hadoop-yarn\hadoop-yarn-server\hadoop-yarn-server-resourcemanager\src\main\java\org\apache\hadoop\yarn\server\resourcemanager\placement\FSPlacementRule.java,140,15,2,4,0,21
hadoop-trunk\hadoop-trunk\hadoop-yarn-project\hadoop-yarn\hadoop-yarn-server\hadoop-yarn-server-common\src\main\java\org\apache\hadoop\yarn\server\api\impl\pb\client\SCMUploaderProtocolPBClientImpl.java,0,11,6,11,0,28
hadoop-trunk\hadoop-trunk\hadoop-yarn-project\hadoop-yarn\hadoop-yarn-server\hadoop-yarn-server-timelineservice-documentstore\src\main\java\org\apache\hadoop\yarn\server\timelineservice\documentstore\collection\CollectionType.java,0,11,1,1,0,13
hadoop-trunk\hadoop-trunk\hadoop-common-project\hadoop-registry\src\main\java\org\apache\hadoop\registry\client\types\yarn\YarnRegistryAttributes.java,0,5,0,1,0,6
hadoop-trunk\hadoop-trunk\hadoop-yarn-project\hadoop-yarn\hadoop-yarn-server\hadoop-yarn-server-nodemanager\src\main\java\org\apache\hadoop\yarn\server\nodemanager\containermanager\localizer\event\ContainerLocalizationEvent.java,15,7,0,3,0,10
hadoop-trunk\hadoop-trunk\hadoop-common-project\hadoop-common\src\main\java\org\apache\hadoop\io\Closeable.java,0,1,0,1,0,2
hadoop-trunk\hadoop-trunk\hadoop-yarn-project\hadoop-yarn\hadoop-yarn-server\hadoop-yarn-server-common\src\main\java\org\apache\hadoop\yarn\server\uam\UnmanagedApplicationManager.java,469,57,5,6,0,68
hadoop-trunk\hadoop-trunk\hadoop-common-project\hadoop-common\src\test\java\org\apache\hadoop\fs\shell\TestTail.java,28,5,0,1,0,6
hadoop-trunk\hadoop-trunk\hadoop-hdfs-project\hadoop-hdfs\src\test\java\org\apache\hadoop\hdfs\tools\offlineEditsViewer\TestOfflineEditsViewer.java,309,42,18,3,0,63
hadoop-trunk\hadoop-trunk\hadoop-hdfs-project\hadoop-hdfs-nfs\src\test\java\org\apache\hadoop\hdfs\nfs\nfs3\TestOffsetRange.java,35,12,0,1,0,13
hadoop-trunk\hadoop-trunk\hadoop-tools\hadoop-aws\src\test\java\org\apache\hadoop\fs\s3a\commit\MiniDFSClusterService.java,50,14,1,1,0,16
hadoop-trunk\hadoop-trunk\hadoop-yarn-project\hadoop-yarn\hadoop-yarn-server\hadoop-yarn-server-timelineservice-documentstore\src\main\java\org\apache\hadoop\yarn\server\timelineservice\documentstore\writer\cosmosdb\CosmosDBDocumentStoreWriter.java,0,37,8,11,0,56
hadoop-trunk\hadoop-trunk\hadoop-yarn-project\hadoop-yarn\hadoop-yarn-common\src\main\java\org\apache\hadoop\yarn\state\MultipleArcTransition.java,0,8,4,1,0,13
hadoop-trunk\hadoop-trunk\hadoop-hdfs-project\hadoop-hdfs\src\main\java\org\apache\hadoop\hdfs\protocolPB\InMemoryAliasMapProtocolClientSideTranslatorPB.java,0,19,24,5,0,48
hadoop-trunk\hadoop-trunk\hadoop-common-project\hadoop-common\src\test\java\org\apache\hadoop\fs\FSWrapper.java,0,122,40,3,0,165
hadoop-trunk\hadoop-trunk\hadoop-mapreduce-project\hadoop-mapreduce-client\hadoop-mapreduce-client-hs\src\main\java\org\apache\hadoop\mapreduce\v2\hs\webapp\JAXBContextResolver.java,27,8,1,2,0,11
hadoop-trunk\hadoop-trunk\hadoop-tools\hadoop-aws\src\test\java\org\apache\hadoop\fs\s3a\commit\staging\TestStagingPartitionedJobCommit.java,0,16,5,1,0,22
hadoop-trunk\hadoop-trunk\hadoop-hdfs-project\hadoop-hdfs-rbf\src\main\java\org\apache\hadoop\hdfs\server\federation\router\MountTableRefresherThread.java,72,16,0,3,0,19
hadoop-trunk\hadoop-trunk\hadoop-mapreduce-project\hadoop-mapreduce-client\hadoop-mapreduce-client-core\src\main\java\org\apache\hadoop\mapred\SequenceFileAsTextRecordReader.java,0,29,3,3,0,35
hadoop-trunk\hadoop-trunk\hadoop-yarn-project\hadoop-yarn\hadoop-yarn-applications\hadoop-yarn-services\hadoop-yarn-services-core\src\main\java\org\apache\hadoop\yarn\service\component\instance\ComponentInstance.java,1088,201,45,7,0,253
hadoop-trunk\hadoop-trunk\hadoop-hdfs-project\hadoop-hdfs\src\main\java\org\apache\hadoop\hdfs\server\protocol\DropSPSWorkCommand.java,9,2,0,1,0,3
hadoop-trunk\hadoop-trunk\hadoop-common-project\hadoop-common\src\main\java\org\apache\hadoop\security\ssl\SSLFactory.java,317,56,7,1,0,64
hadoop-trunk\hadoop-trunk\hadoop-tools\hadoop-distcp\src\test\java\org\apache\hadoop\tools\TestGlobbedCopyListing.java,103,17,3,4,0,24
hadoop-trunk\hadoop-trunk\hadoop-hdfs-project\hadoop-hdfs\src\test\java\org\apache\hadoop\hdfs\server\namenode\metrics\TestTopMetrics.java,29,8,0,2,0,10
hadoop-trunk\hadoop-trunk\hadoop-common-project\hadoop-common\src\main\java\org\apache\hadoop\io\compress\zlib\BuiltInZlibDeflater.java,52,16,1,1,0,18
hadoop-trunk\hadoop-trunk\hadoop-common-project\hadoop-common\src\main\java\org\apache\hadoop\util\ApplicationClassLoader.java,202,46,4,1,0,51
hadoop-trunk\hadoop-trunk\hadoop-common-project\hadoop-common\src\main\java\org\apache\hadoop\io\compress\CompressionOutputStream.java,0,13,0,1,0,14
hadoop-trunk\hadoop-trunk\hadoop-tools\hadoop-aws\src\main\java\org\apache\hadoop\fs\s3a\commit\staging\DirectoryStagingCommitterFactory.java,0,5,0,1,0,6
hadoop-trunk\hadoop-trunk\hadoop-mapreduce-project\hadoop-mapreduce-client\hadoop-mapreduce-client-core\src\test\java\org\apache\hadoop\mapreduce\lib\output\committer\manifest\TaggedFileStatus.java,0,6,0,2,0,8
hadoop-trunk\hadoop-trunk\hadoop-yarn-project\hadoop-yarn\hadoop-yarn-server\hadoop-yarn-server-common\src\main\java\org\apache\hadoop\yarn\server\federation\policies\manager\RejectAllPolicyManager.java,11,1,0,3,0,4
hadoop-trunk\hadoop-trunk\hadoop-tools\hadoop-azure\src\test\java\org\apache\hadoop\fs\azurebfs\ITestAbfsIdentityTransformer.java,308,82,1,63,0,146
hadoop-trunk\hadoop-trunk\hadoop-hdfs-project\hadoop-hdfs-client\src\main\java\org\apache\hadoop\hdfs\protocol\DSQuotaExceededException.java,28,14,1,2,0,17
hadoop-trunk\hadoop-trunk\hadoop-tools\hadoop-distcp\src\test\java\org\apache\hadoop\tools\util\TestDistCpUtilsWithCombineMode.java,73,18,0,2,0,20
hadoop-trunk\hadoop-trunk\hadoop-mapreduce-project\hadoop-mapreduce-client\hadoop-mapreduce-client-core\src\main\java\org\apache\hadoop\mapreduce\OutputCommitter.java,188,52,2,1,0,55
hadoop-trunk\hadoop-trunk\hadoop-tools\hadoop-aws\src\test\java\org\apache\hadoop\fs\s3a\commit\AbstractYarnClusterITest.java,287,31,2,3,0,36
hadoop-trunk\hadoop-trunk\hadoop-tools\hadoop-streaming\src\test\java\org\apache\hadoop\streaming\ValueCountReduce.java,0,16,12,2,0,30
hadoop-trunk\hadoop-trunk\hadoop-common-project\hadoop-common\src\main\java\org\apache\hadoop\io\file\tfile\ByteArray.java,0,17,0,1,0,18
hadoop-trunk\hadoop-trunk\hadoop-hdfs-project\hadoop-hdfs\src\main\java\org\apache\hadoop\hdfs\server\protocol\BalancerProtocols.java,0,0,0,1,0,1
hadoop-trunk\hadoop-trunk\hadoop-common-project\hadoop-common\src\main\java\org\apache\hadoop\ipc\ProtocolTranslator.java,0,2,1,1,0,4
hadoop-trunk\hadoop-trunk\hadoop-tools\hadoop-azure\src\main\java\org\apache\hadoop\fs\azure\SecureModeException.java,17,7,0,1,0,8
hadoop-trunk\hadoop-trunk\hadoop-tools\hadoop-federation-balance\src\main\java\org\apache\hadoop\tools\fedbalance\TrashProcedure.java,78,19,2,2,0,23
hadoop-trunk\hadoop-trunk\hadoop-yarn-project\hadoop-yarn\hadoop-yarn-api\src\main\java\org\apache\hadoop\yarn\api\protocolrecords\ReservationSubmissionRequest.java,85,14,0,1,0,15
hadoop-trunk\hadoop-trunk\hadoop-yarn-project\hadoop-yarn\hadoop-yarn-server\hadoop-yarn-server-common\src\test\java\org\apache\hadoop\yarn\server\MockResourceManagerFacade.java,0,152,13,47,0,212
hadoop-trunk\hadoop-trunk\hadoop-common-project\hadoop-common\src\test\java\org\apache\hadoop\security\ssl\TestDelegatingSSLSocketFactory.java,25,2,0,1,0,3
hadoop-trunk\hadoop-trunk\hadoop-yarn-project\hadoop-yarn\hadoop-yarn-common\src\main\java\org\apache\hadoop\yarn\api\records\impl\pb\PreemptionContainerPBImpl.java,98,25,36,2,0,63
hadoop-trunk\hadoop-trunk\hadoop-hdfs-project\hadoop-hdfs-rbf\src\main\java\org\apache\hadoop\hdfs\server\federation\store\RecordStore.java,65,4,2,1,0,7
hadoop-trunk\hadoop-trunk\hadoop-common-project\hadoop-common\src\main\java\org\apache\hadoop\metrics2\MetricsInfo.java,0,1,0,1,0,2
hadoop-trunk\hadoop-trunk\hadoop-mapreduce-project\hadoop-mapreduce-client\hadoop-mapreduce-client-jobclient\src\test\java\org\apache\hadoop\mapreduce\lib\input\TestLineRecordReaderJobs.java,100,12,1,1,0,14
hadoop-trunk\hadoop-trunk\hadoop-hdfs-project\hadoop-hdfs-httpfs\src\main\java\org\apache\hadoop\lib\server\BaseService.java,151,15,4,5,0,24
hadoop-trunk\hadoop-trunk\hadoop-yarn-project\hadoop-yarn\hadoop-yarn-server\hadoop-yarn-server-nodemanager\src\test\java\org\apache\hadoop\yarn\server\nodemanager\containermanager\linux\resources\TestTrafficController.java,279,47,8,9,0,64
hadoop-trunk\hadoop-trunk\hadoop-yarn-project\hadoop-yarn\hadoop-yarn-server\hadoop-yarn-server-resourcemanager\src\main\java\org\apache\hadoop\yarn\server\resourcemanager\scheduler\capacity\conf\FileBasedCSConfigurationProvider.java,34,9,2,3,0,14
hadoop-trunk\hadoop-trunk\hadoop-hdfs-project\hadoop-hdfs\src\test\java\org\apache\hadoop\hdfs\server\namenode\TestStoragePolicySatisfierWithHA.java,76,19,3,1,0,23
hadoop-trunk\hadoop-trunk\hadoop-hdfs-project\hadoop-hdfs\src\main\java\org\apache\hadoop\hdfs\server\diskbalancer\planner\Planner.java,0,1,0,1,0,2
hadoop-trunk\hadoop-trunk\hadoop-yarn-project\hadoop-yarn\hadoop-yarn-server\hadoop-yarn-server-resourcemanager\src\main\java\org\apache\hadoop\yarn\server\resourcemanager\webapp\dao\NodeAllocationInfo.java,37,15,3,2,0,20
hadoop-trunk\hadoop-trunk\hadoop-common-project\hadoop-common\src\main\java\org\apache\hadoop\io\retry\CallReturn.java,0,13,0,1,0,14
hadoop-trunk\hadoop-trunk\hadoop-hdfs-project\hadoop-hdfs-rbf\src\main\java\org\apache\hadoop\hdfs\server\federation\store\package-info.java,0,1,0,1,0,2
hadoop-trunk\hadoop-trunk\hadoop-mapreduce-project\hadoop-mapreduce-client\hadoop-mapreduce-client-core\src\main\java\org\apache\hadoop\mapred\pipes\Application.java,0,64,13,1,0,78
hadoop-trunk\hadoop-trunk\hadoop-hdfs-project\hadoop-hdfs\src\main\java\org\apache\hadoop\hdfs\server\datanode\web\package-info.java,0,1,0,1,0,2
hadoop-trunk\hadoop-trunk\hadoop-yarn-project\hadoop-yarn\hadoop-yarn-common\src\main\java\org\apache\hadoop\yarn\security\ConfiguredYarnAuthorizer.java,80,23,1,3,0,27
hadoop-trunk\hadoop-trunk\hadoop-yarn-project\hadoop-yarn\hadoop-yarn-client\src\main\java\org\apache\hadoop\yarn\client\SCMAdmin.java,147,21,1,4,0,26
hadoop-trunk\hadoop-trunk\hadoop-tools\hadoop-aws\src\test\java\org\apache\hadoop\fs\s3a\ITestS3AMultipartUtils.java,94,11,2,1,0,14
hadoop-trunk\hadoop-trunk\hadoop-tools\hadoop-streaming\src\main\java\org\apache\hadoop\streaming\io\TypedBytesInputWriter.java,0,11,0,1,0,12
hadoop-trunk\hadoop-trunk\hadoop-yarn-project\hadoop-yarn\hadoop-yarn-common\src\main\java\org\apache\hadoop\yarn\api\protocolrecords\impl\pb\AllocateRequestPBImpl.java,455,84,104,7,0,195
hadoop-trunk\hadoop-trunk\hadoop-yarn-project\hadoop-yarn\hadoop-yarn-server\hadoop-yarn-server-common\src\main\java\org\apache\hadoop\yarn\server\api\records\OpportunisticContainersStatus.java,141,1,0,1,0,2
hadoop-trunk\hadoop-trunk\hadoop-hdfs-project\hadoop-hdfs-httpfs\src\main\java\org\apache\hadoop\fs\http\server\HttpFSServer.java,940,158,22,33,0,213
hadoop-trunk\hadoop-trunk\hadoop-tools\hadoop-aws\src\test\java\org\apache\hadoop\fs\s3a\audit\AbstractAuditingTest.java,166,12,2,3,0,17
hadoop-trunk\hadoop-trunk\hadoop-tools\hadoop-aws\src\main\java\org\apache\hadoop\fs\s3a\auth\package-info.java,0,0,0,1,0,1
hadoop-trunk\hadoop-trunk\hadoop-yarn-project\hadoop-yarn\hadoop-yarn-server\hadoop-yarn-server-common\src\main\java\org\apache\hadoop\yarn\server\api\protocolrecords\SCMUploaderCanUploadRequest.java,19,0,0,1,0,1
hadoop-trunk\hadoop-trunk\hadoop-tools\hadoop-aws\src\main\java\org\apache\hadoop\fs\s3a\auth\MarshalledCredentials.java,0,29,3,1,0,33
hadoop-trunk\hadoop-trunk\hadoop-tools\hadoop-azure\src\main\java\org\apache\hadoop\fs\azurebfs\services\ReadBuffer.java,0,45,0,6,0,51
hadoop-trunk\hadoop-trunk\hadoop-common-project\hadoop-common\src\test\java\org\apache\hadoop\fs\TestLocalFSCopyFromLocal.java,69,13,0,3,0,16
hadoop-trunk\hadoop-trunk\hadoop-tools\hadoop-resourceestimator\src\main\java\org\apache\hadoop\resourceestimator\common\api\package-info.java,0,1,0,1,0,2
hadoop-trunk\hadoop-trunk\hadoop-yarn-project\hadoop-yarn\hadoop-yarn-client\src\main\java\org\apache\hadoop\yarn\client\api\impl\RemoteRequestsTable.java,0,52,49,3,0,104
hadoop-trunk\hadoop-trunk\hadoop-yarn-project\hadoop-yarn\hadoop-yarn-server\hadoop-yarn-server-resourcemanager\src\main\java\org\apache\hadoop\yarn\server\resourcemanager\volume\package-info.java,0,1,0,1,0,2
hadoop-trunk\hadoop-trunk\hadoop-yarn-project\hadoop-yarn\hadoop-yarn-server\hadoop-yarn-server-resourcemanager\src\main\java\org\apache\hadoop\yarn\server\resourcemanager\webapp\dao\PartitionQueueCapacitiesInfo.java,144,110,1,1,0,112
hadoop-trunk\hadoop-trunk\hadoop-common-project\hadoop-common\src\main\java\org\apache\hadoop\security\UGIExceptionMessages.java,0,11,0,1,0,12
hadoop-trunk\hadoop-trunk\hadoop-common-project\hadoop-registry\src\main\java\org\apache\hadoop\registry\server\services\MicroZookeeperServiceKeys.java,0,29,16,1,0,46
hadoop-trunk\hadoop-trunk\hadoop-common-project\hadoop-common\src\main\java\org\apache\hadoop\http\HtmlQuoting.java,198,53,3,1,0,57
hadoop-trunk\hadoop-trunk\hadoop-mapreduce-project\hadoop-mapreduce-client\hadoop-mapreduce-client-core\src\main\java\org\apache\hadoop\mapreduce\lib\input\SequenceFileAsTextRecordReader.java,0,25,0,1,0,26
hadoop-trunk\hadoop-trunk\hadoop-hdfs-project\hadoop-hdfs\src\main\java\org\apache\hadoop\hdfs\protocolPB\PBHelper.java,997,190,116,55,0,361
hadoop-trunk\hadoop-trunk\hadoop-tools\hadoop-rumen\src\main\java\org\apache\hadoop\tools\rumen\JobConfigurationParser.java,78,4,6,1,0,11
hadoop-trunk\hadoop-trunk\hadoop-mapreduce-project\hadoop-mapreduce-client\hadoop-mapreduce-client-core\src\main\java\org\apache\hadoop\mapred\ProgressSplitsBlock.java,0,36,0,3,0,39
hadoop-trunk\hadoop-trunk\hadoop-yarn-project\hadoop-yarn\hadoop-yarn-client\src\main\java\org\apache\hadoop\yarn\client\api\impl\SharedCacheClientImpl.java,118,22,1,3,0,26
hadoop-trunk\hadoop-trunk\hadoop-tools\hadoop-aws\src\main\java\org\apache\hadoop\fs\s3a\audit\S3AAuditConstants.java,0,0,0,1,0,1
hadoop-trunk\hadoop-trunk\hadoop-yarn-project\hadoop-yarn\hadoop-yarn-server\hadoop-yarn-server-common\src\main\java\org\apache\hadoop\yarn\server\api\protocolrecords\impl\pb\RegisterNodeManagerResponsePBImpl.java,0,56,84,5,0,145
hadoop-trunk\hadoop-trunk\hadoop-yarn-project\hadoop-yarn\hadoop-yarn-server\hadoop-yarn-server-router\src\test\java\org\apache\hadoop\yarn\server\router\rmadmin\MockRMAdminRequestInterceptor.java,0,4,0,3,0,7
hadoop-trunk\hadoop-trunk\hadoop-hdfs-project\hadoop-hdfs\src\test\java\org\apache\hadoop\hdfs\server\blockmanagement\TestReplicationPolicyConsiderLoad.java,0,77,1,1,0,79
hadoop-trunk\hadoop-trunk\hadoop-yarn-project\hadoop-yarn\hadoop-yarn-server\hadoop-yarn-server-nodemanager\src\main\java\org\apache\hadoop\yarn\server\nodemanager\containermanager\localizer\sharedcache\SharedCacheUploader.java,0,70,11,5,0,86
hadoop-trunk\hadoop-trunk\hadoop-tools\hadoop-azure\src\test\java\org\apache\hadoop\fs\azurebfs\ITestAzureBlobFileSystemLease.java,293,70,0,52,0,122
hadoop-trunk\hadoop-trunk\hadoop-tools\hadoop-azure-datalake\src\test\java\org\apache\hadoop\fs\adl\live\TestAdlContractRootDirLive.java,0,2,0,1,0,3
hadoop-trunk\hadoop-trunk\hadoop-yarn-project\hadoop-yarn\hadoop-yarn-server\hadoop-yarn-server-resourcemanager\src\main\java\org\apache\hadoop\yarn\server\resourcemanager\recovery\RMStateVersionIncompatibleException.java,17,7,0,1,0,8
hadoop-trunk\hadoop-trunk\hadoop-tools\hadoop-aws\src\test\java\org\apache\hadoop\fs\s3a\auth\TestMarshalledCredentials.java,101,9,0,1,0,10
hadoop-trunk\hadoop-trunk\hadoop-yarn-project\hadoop-yarn\hadoop-yarn-server\hadoop-yarn-server-timelineservice-hbase\hadoop-yarn-server-timelineservice-hbase-common\src\main\java\org\apache\hadoop\yarn\server\timelineservice\storage\flow\package-info.java,0,0,0,1,0,1
hadoop-trunk\hadoop-trunk\hadoop-common-project\hadoop-common\src\test\java\org\apache\hadoop\io\TestWritableName.java,82,25,6,1,0,32
hadoop-trunk\hadoop-trunk\hadoop-yarn-project\hadoop-yarn\hadoop-yarn-server\hadoop-yarn-server-applicationhistoryservice\src\main\java\org\apache\hadoop\yarn\server\timeline\recovery\LeveldbTimelineStateStore.java,361,51,13,6,0,70
hadoop-trunk\hadoop-trunk\hadoop-yarn-project\hadoop-yarn\hadoop-yarn-server\hadoop-yarn-server-nodemanager\src\main\java\org\apache\hadoop\yarn\server\nodemanager\webapp\NMView.java,17,5,0,1,0,6
hadoop-trunk\hadoop-trunk\hadoop-common-project\hadoop-common\src\main\java\org\apache\hadoop\conf\StorageSize.java,80,20,0,1,0,21
hadoop-trunk\hadoop-trunk\hadoop-yarn-project\hadoop-yarn\hadoop-yarn-server\hadoop-yarn-server-common\src\main\java\org\apache\hadoop\yarn\server\federation\store\records\impl\pb\SubClusterRegisterRequestPBImpl.java,101,20,34,5,0,59
hadoop-trunk\hadoop-trunk\hadoop-common-project\hadoop-nfs\src\main\java\org\apache\hadoop\oncrpc\RpcCallCache.java,142,59,2,2,0,63
hadoop-trunk\hadoop-trunk\hadoop-hdfs-project\hadoop-hdfs-client\src\main\java\org\apache\hadoop\hdfs\protocol\HdfsFileStatus.java,0,91,6,1,0,98
hadoop-trunk\hadoop-trunk\hadoop-yarn-project\hadoop-yarn\hadoop-yarn-server\hadoop-yarn-server-nodemanager\src\test\java\org\apache\hadoop\yarn\server\nodemanager\TestDeletionService.java,331,63,5,4,0,72
hadoop-trunk\hadoop-trunk\hadoop-yarn-project\hadoop-yarn\hadoop-yarn-server\hadoop-yarn-server-common\src\main\java\org\apache\hadoop\yarn\server\federation\store\records\impl\pb\SubClusterInfoPBImpl.java,215,43,81,5,0,129
hadoop-trunk\hadoop-trunk\hadoop-yarn-project\hadoop-yarn\hadoop-yarn-server\hadoop-yarn-server-resourcemanager\src\main\java\org\apache\hadoop\yarn\server\resourcemanager\RMFatalEventType.java,0,5,0,1,0,6
hadoop-trunk\hadoop-trunk\hadoop-yarn-project\hadoop-yarn\hadoop-yarn-server\hadoop-yarn-server-resourcemanager\src\main\java\org\apache\hadoop\yarn\server\resourcemanager\RMNMInfoBeans.java,0,2,1,1,0,4
hadoop-trunk\hadoop-trunk\hadoop-hdfs-project\hadoop-hdfs-client\src\main\java\org\apache\hadoop\hdfs\web\resources\EnumSetParam.java,0,17,3,2,0,22
hadoop-trunk\hadoop-trunk\hadoop-hdfs-project\hadoop-hdfs\src\test\java\org\apache\hadoop\hdfs\TestErasureCodingPolicyWithSnapshotWithRandomECPolicy.java,22,4,1,1,0,6
hadoop-trunk\hadoop-trunk\hadoop-mapreduce-project\hadoop-mapreduce-client\hadoop-mapreduce-client-nativetask\src\test\java\org\apache\hadoop\mapred\nativetask\testutil\ResultVerifier.java,130,23,4,7,0,34
hadoop-trunk\hadoop-trunk\hadoop-tools\hadoop-openstack\src\main\java\org\apache\hadoop\fs\swift\auth\ApiKeyAuthenticationRequest.java,39,11,0,2,0,13
hadoop-trunk\hadoop-trunk\hadoop-yarn-project\hadoop-yarn\hadoop-yarn-server\hadoop-yarn-server-nodemanager\src\test\java\org\apache\hadoop\yarn\server\nodemanager\containermanager\linux\runtime\TestJavaSandboxLinuxContainerRuntime.java,374,68,13,26,0,107
hadoop-trunk\hadoop-trunk\hadoop-common-project\hadoop-common\src\test\java\org\apache\hadoop\crypto\key\TestKeyProvider.java,246,68,12,2,0,82
hadoop-trunk\hadoop-trunk\hadoop-tools\hadoop-azure\src\test\java\org\apache\hadoop\fs\azurebfs\contract\ITestAzureBlobFileSystemBasics.java,71,9,1,5,0,15
hadoop-trunk\hadoop-trunk\hadoop-yarn-project\hadoop-yarn\hadoop-yarn-server\hadoop-yarn-server-common\src\main\java\org\apache\hadoop\yarn\server\uam\package-info.java,0,1,0,1,0,2
hadoop-trunk\hadoop-trunk\hadoop-common-project\hadoop-registry\src\test\java\org\apache\hadoop\registry\client\binding\TestRegistryPathUtils.java,158,33,6,1,0,40
hadoop-trunk\hadoop-trunk\hadoop-yarn-project\hadoop-yarn\hadoop-yarn-server\hadoop-yarn-server-router\src\main\java\org\apache\hadoop\yarn\server\router\clientrm\ClientRequestInterceptor.java,0,0,0,1,0,1
hadoop-trunk\hadoop-trunk\hadoop-mapreduce-project\hadoop-mapreduce-client\hadoop-mapreduce-client-app\src\main\java\org\apache\hadoop\mapreduce\v2\app\job\Job.java,0,38,2,1,0,41
hadoop-trunk\hadoop-trunk\hadoop-mapreduce-project\hadoop-mapreduce-client\hadoop-mapreduce-client-app\src\main\java\org\apache\hadoop\mapreduce\v2\app\launcher\ContainerRemoteLaunchEvent.java,41,20,2,1,0,23
hadoop-trunk\hadoop-trunk\hadoop-yarn-project\hadoop-yarn\hadoop-yarn-server\hadoop-yarn-server-nodemanager\src\test\java\org\apache\hadoop\yarn\server\nodemanager\containermanager\resourceplugin\fpga\TestFpgaDiscoverer.java,286,32,1,8,0,41
hadoop-trunk\hadoop-trunk\hadoop-hdfs-project\hadoop-hdfs-rbf\src\main\java\org\apache\hadoop\hdfs\server\federation\store\records\QueryResult.java,31,3,0,1,0,4
hadoop-trunk\hadoop-trunk\hadoop-yarn-project\hadoop-yarn\hadoop-yarn-common\src\main\java\org\apache\hadoop\yarn\webapp\example\MyApp.java,45,16,0,1,0,17
hadoop-trunk\hadoop-trunk\hadoop-yarn-project\hadoop-yarn\hadoop-yarn-server\hadoop-yarn-server-common\src\main\java\org\apache\hadoop\yarn\server\federation\store\records\impl\pb\UpdateApplicationHomeSubClusterRequestPBImpl.java,0,18,35,6,0,59
hadoop-trunk\hadoop-trunk\hadoop-hdfs-project\hadoop-hdfs-client\src\main\java\org\apache\hadoop\hdfs\protocol\CacheDirectiveEntry.java,19,11,0,1,0,12
hadoop-trunk\hadoop-trunk\hadoop-mapreduce-project\hadoop-mapreduce-client\hadoop-mapreduce-client-core\src\main\java\org\apache\hadoop\mapred\lib\Chain.java,0,82,34,1,0,117
hadoop-trunk\hadoop-trunk\hadoop-common-project\hadoop-common\src\main\java\org\apache\hadoop\ha\ZKFCProtocol.java,0,22,3,2,0,27
hadoop-trunk\hadoop-trunk\hadoop-tools\hadoop-aws\src\main\java\org\apache\hadoop\fs\s3a\auth\MarshalledCredentialBinding.java,0,3,0,2,0,5
hadoop-trunk\hadoop-trunk\hadoop-common-project\hadoop-kms\src\main\java\org\apache\hadoop\crypto\key\kms\server\SimpleKMSAuditLogger.java,0,3,7,1,0,11
hadoop-trunk\hadoop-trunk\hadoop-yarn-project\hadoop-yarn\hadoop-yarn-server\hadoop-yarn-server-tests\src\test\java\org\apache\hadoop\yarn\server\ContainerTokenIdentifierForTest.java,160,75,38,4,0,117
hadoop-trunk\hadoop-trunk\hadoop-yarn-project\hadoop-yarn\hadoop-yarn-server\hadoop-yarn-server-timelineservice-documentstore\src\main\java\org\apache\hadoop\yarn\server\timelineservice\documentstore\collection\document\flowactivity\FlowActivityDocument.java,98,52,2,3,0,57
hadoop-trunk\hadoop-trunk\hadoop-hdfs-project\hadoop-hdfs\src\test\java\org\apache\hadoop\hdfs\tools\TestViewFileSystemOverloadSchemeWithDFSAdmin.java,240,27,4,1,0,32
hadoop-trunk\hadoop-trunk\hadoop-common-project\hadoop-common\src\main\java\org\apache\hadoop\util\ProgramDriver.java,126,63,1,2,0,66
hadoop-trunk\hadoop-trunk\hadoop-hdfs-project\hadoop-hdfs-rbf\src\main\java\org\apache\hadoop\hdfs\server\federation\store\records\impl\pb\RouterStatePBImpl.java,179,39,95,7,0,141
hadoop-trunk\hadoop-trunk\hadoop-hdfs-project\hadoop-hdfs\src\main\java\org\apache\hadoop\hdfs\web\AuthFilterInitializer.java,37,10,0,3,0,13
hadoop-trunk\hadoop-trunk\hadoop-hdfs-project\hadoop-hdfs-client\src\main\java\org\apache\hadoop\hdfs\protocol\CachePoolEntry.java,18,11,0,1,0,12
hadoop-trunk\hadoop-trunk\hadoop-cloud-storage-project\hadoop-huaweicloud\src\main\java\org\apache\hadoop\fs\obs\RenameFailedException.java,0,0,0,1,0,1
hadoop-trunk\hadoop-trunk\hadoop-hdfs-project\hadoop-hdfs-httpfs\src\main\java\org\apache\hadoop\lib\wsrs\LongParam.java,17,6,0,1,0,7
hadoop-trunk\hadoop-trunk\hadoop-common-project\hadoop-common\src\test\java\org\apache\hadoop\util\TestCacheableIPList.java,166,31,37,4,0,72
hadoop-trunk\hadoop-trunk\hadoop-common-project\hadoop-common\src\main\java\org\apache\hadoop\conf\ReconfigurationException.java,80,37,0,1,0,38
hadoop-trunk\hadoop-trunk\hadoop-hdfs-project\hadoop-hdfs\src\test\java\org\apache\hadoop\hdfs\server\blockmanagement\TestBlockManagerSafeMode.java,686,104,37,4,0,145
hadoop-trunk\hadoop-trunk\hadoop-common-project\hadoop-common\src\test\java\org\apache\hadoop\security\token\delegation\TestZKDelegationTokenSecretManager.java,455,62,15,11,0,88
hadoop-trunk\hadoop-trunk\hadoop-yarn-project\hadoop-yarn\hadoop-yarn-server\hadoop-yarn-server-web-proxy\src\main\java\org\apache\hadoop\yarn\server\webproxy\WebAppProxy.java,124,38,1,3,0,42
hadoop-trunk\hadoop-trunk\hadoop-yarn-project\hadoop-yarn\hadoop-yarn-client\src\main\java\org\apache\hadoop\yarn\client\api\impl\AHSv2ClientImpl.java,109,23,0,1,0,24
hadoop-trunk\hadoop-trunk\hadoop-hdfs-project\hadoop-hdfs\src\test\java\org\apache\hadoop\hdfs\TestReadStripedFileWithDecoding.java,116,9,4,7,0,20
hadoop-trunk\hadoop-trunk\hadoop-yarn-project\hadoop-yarn\hadoop-yarn-server\hadoop-yarn-server-resourcemanager\src\test\java\org\apache\hadoop\yarn\server\resourcemanager\TestApplicationCleanup.java,505,95,11,9,0,115
hadoop-trunk\hadoop-trunk\hadoop-hdfs-project\hadoop-hdfs-nfs\src\main\java\org\apache\hadoop\hdfs\nfs\mount\Mountd.java,14,8,0,1,0,9
hadoop-trunk\hadoop-trunk\hadoop-mapreduce-project\hadoop-mapreduce-client\hadoop-mapreduce-client-jobclient\src\test\java\org\apache\hadoop\fs\slive\Operation.java,80,22,0,1,0,23
hadoop-trunk\hadoop-trunk\hadoop-tools\hadoop-aws\src\main\java\org\apache\hadoop\fs\s3a\auth\AbstractSessionCredentialsProvider.java,0,2,0,1,0,3
hadoop-trunk\hadoop-trunk\hadoop-mapreduce-project\hadoop-mapreduce-client\hadoop-mapreduce-client-core\src\main\java\org\apache\hadoop\mapreduce\counters\LimitExceededException.java,14,4,0,1,0,5
hadoop-trunk\hadoop-trunk\hadoop-common-project\hadoop-registry\src\main\java\org\apache\hadoop\registry\client\binding\RegistryUtils.java,347,47,7,3,0,57
hadoop-trunk\hadoop-trunk\hadoop-tools\hadoop-aws\src\main\java\org\apache\hadoop\fs\s3a\auth\delegation\package-info.java,0,1,0,2,0,3
hadoop-trunk\hadoop-trunk\hadoop-hdfs-project\hadoop-hdfs-client\src\main\java\org\apache\hadoop\hdfs\ReplicaAccessorBuilder.java,77,19,0,1,0,20
hadoop-trunk\hadoop-trunk\hadoop-mapreduce-project\hadoop-mapreduce-client\hadoop-mapreduce-client-app\src\main\java\org\apache\hadoop\mapreduce\v2\app\webapp\dao\JobTaskCounterInfo.java,26,10,2,2,0,14
hadoop-trunk\hadoop-trunk\hadoop-yarn-project\hadoop-yarn\hadoop-yarn-server\hadoop-yarn-server-resourcemanager\src\main\java\org\apache\hadoop\yarn\server\resourcemanager\scheduler\capacity\preemption\PreemptableQueue.java,67,22,2,2,0,26
hadoop-trunk\hadoop-trunk\hadoop-common-project\hadoop-common\src\test\java\org\apache\hadoop\util\TestHostsFileReader.java,375,46,34,2,0,82
hadoop-trunk\hadoop-trunk\hadoop-yarn-project\hadoop-yarn\hadoop-yarn-server\hadoop-yarn-server-resourcemanager\src\main\java\org\apache\hadoop\yarn\server\resourcemanager\rmnode\RMNodeEventType.java,0,19,0,1,0,20
hadoop-trunk\hadoop-trunk\hadoop-common-project\hadoop-common\src\main\java\org\apache\hadoop\io\nativeio\NativeIO.java,1078,462,41,23,0,526
hadoop-trunk\hadoop-trunk\hadoop-tools\hadoop-aws\src\main\java\org\apache\hadoop\fs\s3a\S3AFileSystem.java,0,309,53,42,0,404
hadoop-trunk\hadoop-trunk\hadoop-yarn-project\hadoop-yarn\hadoop-yarn-common\src\main\java\org\apache\hadoop\yarn\webapp\view\TwoColumnCssLayout.java,62,9,2,1,0,12
hadoop-trunk\hadoop-trunk\hadoop-mapreduce-project\hadoop-mapreduce-client\hadoop-mapreduce-client-jobclient\src\test\java\org\apache\hadoop\mapred\TestTaskPerformanceSplits.java,49,54,4,1,0,59
hadoop-trunk\hadoop-trunk\hadoop-hdfs-project\hadoop-hdfs\src\main\java\org\apache\hadoop\hdfs\server\namenode\ImageServlet.java,720,170,28,27,0,225
hadoop-trunk\hadoop-trunk\hadoop-yarn-project\hadoop-yarn\hadoop-yarn-server\hadoop-yarn-server-nodemanager\src\main\java\org\apache\hadoop\yarn\server\nodemanager\containermanager\resourceplugin\fpga\FpgaDevice.java,118,41,1,2,0,44
hadoop-trunk\hadoop-trunk\hadoop-tools\hadoop-azure\src\test\java\org\apache\hadoop\fs\azurebfs\AbstractAbfsTestWithTimeout.java,91,6,2,2,0,10
hadoop-trunk\hadoop-trunk\hadoop-common-project\hadoop-common\src\main\java\org\apache\hadoop\util\PriorityQueue.java,128,29,7,3,0,39
hadoop-trunk\hadoop-trunk\hadoop-mapreduce-project\hadoop-mapreduce-client\hadoop-mapreduce-client-jobclient\src\test\java\org\apache\hadoop\mapred\TestReduceFetch.java,45,8,4,1,0,13
hadoop-trunk\hadoop-trunk\hadoop-tools\hadoop-aws\src\test\java\org\apache\hadoop\fs\contract\s3a\ITestS3AContractUnbuffer.java,8,2,0,1,0,3
hadoop-trunk\hadoop-trunk\hadoop-yarn-project\hadoop-yarn\hadoop-yarn-api\src\main\java\org\apache\hadoop\yarn\api\protocolrecords\CancelDelegationTokenRequest.java,24,3,0,1,0,4
hadoop-trunk\hadoop-trunk\hadoop-yarn-project\hadoop-yarn\hadoop-yarn-server\hadoop-yarn-server-common\src\main\java\org\apache\hadoop\yarn\server\federation\store\records\SubClusterDeregisterRequest.java,52,3,0,1,0,4
hadoop-trunk\hadoop-trunk\hadoop-hdfs-project\hadoop-hdfs\src\test\java\org\apache\hadoop\hdfs\server\diskbalancer\connectors\NullConnector.java,33,3,0,2,0,5
hadoop-trunk\hadoop-trunk\hadoop-common-project\hadoop-common\src\test\java\org\apache\hadoop\conf\TestConfiguration.java,0,580,23,13,0,616
hadoop-trunk\hadoop-trunk\hadoop-common-project\hadoop-common\src\test\java\org\apache\hadoop\crypto\TestCryptoStreams.java,457,118,13,2,0,133
hadoop-trunk\hadoop-trunk\hadoop-yarn-project\hadoop-yarn\hadoop-yarn-server\hadoop-yarn-server-resourcemanager\src\test\java\org\apache\hadoop\yarn\server\resourcemanager\scheduler\fair\FairSchedulerTestBase.java,339,138,1,14,0,153
hadoop-trunk\hadoop-trunk\hadoop-yarn-project\hadoop-yarn\hadoop-yarn-server\hadoop-yarn-server-nodemanager\src\main\java\org\apache\hadoop\yarn\server\nodemanager\containermanager\launcher\ContainersLauncherEvent.java,0,10,2,2,0,14
hadoop-trunk\hadoop-trunk\hadoop-hdfs-project\hadoop-hdfs\src\test\java\org\apache\hadoop\hdfs\server\datanode\TestSimulatedFSDatasetWithMultipleStorages.java,0,3,0,1,0,4
hadoop-trunk\hadoop-trunk\hadoop-hdfs-project\hadoop-hdfs\src\test\java\org\apache\hadoop\hdfs\tools\offlineImageViewer\TestPBImageCorruption.java,29,11,3,1,0,15
hadoop-trunk\hadoop-trunk\hadoop-mapreduce-project\hadoop-mapreduce-client\hadoop-mapreduce-client-jobclient\src\test\java\org\apache\hadoop\fs\TestFileSystem.java,0,258,42,13,0,313
hadoop-trunk\hadoop-trunk\hadoop-hdfs-project\hadoop-hdfs-httpfs\src\main\java\org\apache\hadoop\fs\http\server\HttpFSExceptionProvider.java,67,12,0,4,0,16
hadoop-trunk\hadoop-trunk\hadoop-common-project\hadoop-kms\src\main\java\org\apache\hadoop\crypto\key\kms\server\KMSJSONReader.java,19,13,0,1,0,14
hadoop-trunk\hadoop-trunk\hadoop-mapreduce-project\hadoop-mapreduce-client\hadoop-mapreduce-client-nativetask\src\test\java\org\apache\hadoop\mapred\nativetask\TestTaskContext.java,25,6,0,1,0,7
hadoop-trunk\hadoop-trunk\hadoop-common-project\hadoop-common\src\main\java\org\apache\hadoop\ipc\IpcException.java,8,1,0,1,0,2
hadoop-trunk\hadoop-trunk\hadoop-hdfs-project\hadoop-hdfs-client\src\main\java\org\apache\hadoop\hdfs\protocol\SnapshottableDirectoryStatus.java,205,77,5,1,0,83
hadoop-trunk\hadoop-trunk\hadoop-yarn-project\hadoop-yarn\hadoop-yarn-client\src\main\java\org\apache\hadoop\yarn\client\api\InvalidContainerRequestException.java,14,7,0,1,0,8
hadoop-trunk\hadoop-trunk\hadoop-hdfs-project\hadoop-hdfs\src\main\java\org\apache\hadoop\hdfs\server\diskbalancer\connectors\ConnectorFactory.java,0,6,1,1,0,8
hadoop-trunk\hadoop-trunk\hadoop-mapreduce-project\hadoop-mapreduce-client\hadoop-mapreduce-client-app\src\main\java\org\apache\hadoop\mapreduce\v2\app\job\event\TaskRecoverEvent.java,27,17,0,1,0,18
hadoop-trunk\hadoop-trunk\hadoop-tools\hadoop-azure\src\test\java\org\apache\hadoop\fs\azure\ITestOutOfBandAzureBlobOperationsLive.java,155,24,9,6,0,39
hadoop-trunk\hadoop-trunk\hadoop-common-project\hadoop-common\src\test\java\org\apache\hadoop\io\TestSortedMapWritable.java,153,38,12,13,0,63
hadoop-trunk\hadoop-trunk\hadoop-tools\hadoop-azure\src\main\java\org\apache\hadoop\fs\azurebfs\services\ReadBufferManager.java,0,96,23,65,0,184
hadoop-trunk\hadoop-trunk\hadoop-tools\hadoop-sls\src\test\java\org\apache\hadoop\yarn\sls\BaseSLSRunnerTest.java,111,28,6,2,0,36
hadoop-trunk\hadoop-trunk\hadoop-common-project\hadoop-common\src\main\java\org\apache\hadoop\security\http\package-info.java,0,2,0,1,0,3
hadoop-trunk\hadoop-trunk\hadoop-tools\hadoop-aliyun\src\main\java\org\apache\hadoop\fs\aliyun\oss\AliyunOSSBlockOutputStream.java,183,36,5,4,0,45
hadoop-trunk\hadoop-trunk\hadoop-yarn-project\hadoop-yarn\hadoop-yarn-server\hadoop-yarn-server-resourcemanager\src\test\java\org\apache\hadoop\yarn\server\resourcemanager\reservation\planning\TestAlignedPlanner.java,1134,405,35,10,0,450
hadoop-trunk\hadoop-trunk\hadoop-common-project\hadoop-common\src\main\java\org\apache\hadoop\net\NetworkTopologyWithNodeGroup.java,316,70,8,1,0,79
hadoop-trunk\hadoop-trunk\hadoop-common-project\hadoop-common\src\test\java\org\apache\hadoop\metrics2\sink\RollingFileSystemSinkTestBase.java,496,98,10,4,0,112
hadoop-trunk\hadoop-trunk\hadoop-yarn-project\hadoop-yarn\hadoop-yarn-common\src\main\java\org\apache\hadoop\yarn\api\protocolrecords\impl\pb\GetApplicationAttemptReportRequestPBImpl.java,107,24,34,5,0,63
hadoop-trunk\hadoop-trunk\hadoop-mapreduce-project\hadoop-mapreduce-client\hadoop-mapreduce-client-hs\src\main\java\org\apache\hadoop\mapreduce\v2\hs\webapp\HsCountersPage.java,36,8,1,3,0,12
hadoop-trunk\hadoop-trunk\hadoop-common-project\hadoop-common\src\main\java\org\apache\hadoop\util\ProcessUtils.java,0,5,0,2,0,7
hadoop-trunk\hadoop-trunk\hadoop-hdfs-project\hadoop-hdfs\src\main\java\org\apache\hadoop\hdfs\server\protocol\KeyUpdateCommand.java,17,6,0,1,0,7
hadoop-trunk\hadoop-trunk\hadoop-mapreduce-project\hadoop-mapreduce-client\hadoop-mapreduce-client-jobclient\src\test\java\org\apache\hadoop\util\TestMRCJCReflectionUtils.java,29,9,1,1,0,11
hadoop-trunk\hadoop-trunk\hadoop-tools\hadoop-aws\src\main\java\org\apache\hadoop\fs\s3a\commit\files\PersistentCommitData.java,35,0,1,1,0,2
hadoop-trunk\hadoop-trunk\hadoop-common-project\hadoop-common\src\main\java\org\apache\hadoop\security\KerberosAuthException.java,86,24,1,1,0,26
hadoop-trunk\hadoop-trunk\hadoop-hdfs-project\hadoop-hdfs-client\src\main\java\org\apache\hadoop\hdfs\protocol\package-info.java,0,0,0,1,0,1
hadoop-trunk\hadoop-trunk\hadoop-tools\hadoop-distcp\src\main\java\org\apache\hadoop\tools\mapred\RetriableFileCopyCommand.java,349,97,12,3,0,112
hadoop-trunk\hadoop-trunk\hadoop-yarn-project\hadoop-yarn\hadoop-yarn-server\hadoop-yarn-server-resourcemanager\src\main\java\org\apache\hadoop\yarn\server\resourcemanager\reservation\ReservationInputValidator.java,280,37,2,2,0,41
hadoop-trunk\hadoop-trunk\hadoop-hdfs-project\hadoop-hdfs-client\src\main\java\org\apache\hadoop\hdfs\web\oauth2\OAuth2ConnectionConfigurator.java,43,12,1,2,0,15
hadoop-trunk\hadoop-trunk\hadoop-mapreduce-project\hadoop-mapreduce-examples\src\main\java\org\apache\hadoop\examples\dancing\Pentomino.java,438,206,19,1,0,226
hadoop-trunk\hadoop-trunk\hadoop-common-project\hadoop-common\src\main\java\org\apache\hadoop\io\nativeio\package-info.java,0,1,0,1,0,2
hadoop-trunk\hadoop-trunk\hadoop-hdfs-project\hadoop-hdfs-httpfs\src\test\java\org\apache\hadoop\lib\service\hadoop\TestFileSystemAccessService.java,420,44,7,16,0,67
hadoop-trunk\hadoop-trunk\hadoop-hdfs-project\hadoop-hdfs\src\main\java\org\apache\hadoop\hdfs\server\common\blockaliasmap\impl\TextFileRegionAliasMap.java,0,121,9,1,0,131
hadoop-trunk\hadoop-trunk\hadoop-mapreduce-project\hadoop-mapreduce-client\hadoop-mapreduce-client-nativetask\src\test\java\org\apache\hadoop\mapred\nativetask\nonsorttest\NonSortTest.java,76,10,0,2,0,12
hadoop-trunk\hadoop-trunk\hadoop-tools\hadoop-azure\src\test\java\org\apache\hadoop\fs\azurebfs\contract\ListResultSchemaTest.java,125,3,0,1,0,4
hadoop-trunk\hadoop-trunk\hadoop-hdfs-project\hadoop-hdfs\src\test\java\org\apache\hadoop\hdfs\server\namenode\ha\TestStandbyIsHot.java,182,58,6,6,0,70
hadoop-trunk\hadoop-trunk\hadoop-common-project\hadoop-common\src\test\java\org\apache\hadoop\security\TestShellBasedIdMapping.java,338,138,10,15,0,163
hadoop-trunk\hadoop-trunk\hadoop-hdfs-project\hadoop-hdfs\src\test\java\org\apache\hadoop\hdfs\server\datanode\TestBlockHasMultipleReplicasOnSameDN.java,95,19,3,5,0,27
hadoop-trunk\hadoop-trunk\hadoop-mapreduce-project\hadoop-mapreduce-client\hadoop-mapreduce-client-jobclient\src\test\java\org\apache\hadoop\mapreduce\TestMapperReducerCleanup.java,296,68,6,1,0,75
hadoop-trunk\hadoop-trunk\hadoop-cloud-storage-project\hadoop-huaweicloud\src\main\java\org\apache\hadoop\fs\obs\OBSFsDFSListing.java,0,1,9,1,0,11
hadoop-trunk\hadoop-trunk\hadoop-mapreduce-project\hadoop-mapreduce-client\hadoop-mapreduce-client-app\src\main\java\org\apache\hadoop\mapreduce\v2\app\webapp\package-info.java,0,1,0,1,0,2
hadoop-trunk\hadoop-trunk\hadoop-mapreduce-project\hadoop-mapreduce-client\hadoop-mapreduce-client-core\src\main\java\org\apache\hadoop\mapreduce\lib\output\PartialOutputCommitter.java,0,2,1,1,0,4
hadoop-trunk\hadoop-trunk\hadoop-yarn-project\hadoop-yarn\hadoop-yarn-server\hadoop-yarn-server-resourcemanager\src\main\java\org\apache\hadoop\yarn\server\resourcemanager\placement\csmappingrule\MappingRuleValidationHelper.java,0,18,2,5,0,25
hadoop-trunk\hadoop-trunk\hadoop-yarn-project\hadoop-yarn\hadoop-yarn-common\src\main\java\org\apache\hadoop\yarn\api\impl\pb\client\ApplicationMasterProtocolPBClientImpl.java,0,15,9,15,0,39
hadoop-trunk\hadoop-trunk\hadoop-hdfs-project\hadoop-hdfs\src\main\java\org\apache\hadoop\hdfs\server\protocol\BlocksWithLocations.java,106,64,0,1,0,65
hadoop-trunk\hadoop-trunk\hadoop-common-project\hadoop-common\src\main\java\org\apache\hadoop\ipc\protocolPB\GenericRefreshProtocolClientSideTranslatorPB.java,0,19,11,9,0,39
hadoop-trunk\hadoop-trunk\hadoop-tools\hadoop-sls\src\main\java\org\apache\hadoop\yarn\sls\synthetic\SynthTraceJobProducer.java,612,336,2,7,0,345
hadoop-trunk\hadoop-trunk\hadoop-yarn-project\hadoop-yarn\hadoop-yarn-server\hadoop-yarn-server-nodemanager\src\test\java\org\apache\hadoop\yarn\server\nodemanager\containermanager\linux\runtime\docker\TestDockerStartCommand.java,27,7,1,2,0,10
hadoop-trunk\hadoop-trunk\hadoop-common-project\hadoop-common\src\test\arm-java\org\apache\hadoop\ipc\protobuf\TestProtosLegacy.java,0,3529,1001,767,0,5297
hadoop-trunk\hadoop-trunk\hadoop-tools\hadoop-distcp\src\main\java\org\apache\hadoop\tools\package-info.java,0,1,0,1,0,2
hadoop-trunk\hadoop-trunk\hadoop-common-project\hadoop-kms\src\test\java\org\apache\hadoop\crypto\key\kms\server\TestKMSMDCFilter.java,49,10,1,1,0,12
hadoop-trunk\hadoop-trunk\hadoop-hdfs-project\hadoop-hdfs-rbf\src\test\java\org\apache\hadoop\fs\contract\router\TestRouterHDFSContractOpenSecure.java,18,4,0,1,0,5
hadoop-trunk\hadoop-trunk\hadoop-mapreduce-project\hadoop-mapreduce-client\hadoop-mapreduce-client-core\src\main\java\org\apache\hadoop\mapreduce\lib\input\UncompressedSplitLineReader.java,74,21,2,1,0,24
hadoop-trunk\hadoop-trunk\hadoop-common-project\hadoop-common\src\test\java\org\apache\hadoop\io\compress\TestDecompressorStream.java,69,21,5,1,0,27
hadoop-trunk\hadoop-trunk\hadoop-yarn-project\hadoop-yarn\hadoop-yarn-server\hadoop-yarn-server-common\src\main\java\org\apache\hadoop\yarn\server\api\protocolrecords\impl\pb\UnRegisterNodeManagerRequestPBImpl.java,78,15,30,4,0,49
hadoop-trunk\hadoop-trunk\hadoop-hdfs-project\hadoop-hdfs\src\test\java\org\apache\hadoop\hdfs\server\namenode\snapshot\SnapshotTestHelper.java,431,131,11,7,0,149
hadoop-trunk\hadoop-trunk\hadoop-yarn-project\hadoop-yarn\hadoop-yarn-server\hadoop-yarn-server-nodemanager\src\main\java\org\apache\hadoop\yarn\server\nodemanager\containermanager\resourceplugin\com\nec\UdevUtil.java,0,19,15,2,0,36
hadoop-trunk\hadoop-trunk\hadoop-tools\hadoop-azure\src\main\java\org\apache\hadoop\fs\azurebfs\services\AbfsLease.java,0,58,6,23,0,87
hadoop-trunk\hadoop-trunk\hadoop-mapreduce-project\hadoop-mapreduce-client\hadoop-mapreduce-client-hs\src\test\java\org\apache\hadoop\mapreduce\v2\hs\TestHistoryServerLeveldbStateStoreService.java,167,9,0,2,0,11
hadoop-trunk\hadoop-trunk\hadoop-common-project\hadoop-common\src\main\java\org\apache\hadoop\fs\store\audit\ActiveThreadSpanSource.java,0,1,0,1,0,2
hadoop-trunk\hadoop-trunk\hadoop-common-project\hadoop-nfs\src\main\java\org\apache\hadoop\oncrpc\security\SecurityHandler.java,68,17,0,1,0,18
hadoop-trunk\hadoop-trunk\hadoop-mapreduce-project\hadoop-mapreduce-client\hadoop-mapreduce-client-core\src\main\java\org\apache\hadoop\mapred\TaskCompletionEvent.java,0,49,6,1,0,56
hadoop-trunk\hadoop-trunk\hadoop-yarn-project\hadoop-yarn\hadoop-yarn-api\src\main\java\org\apache\hadoop\yarn\server\api\ResourceManagerAdministrationProtocol.java,0,39,12,27,0,78
hadoop-trunk\hadoop-trunk\hadoop-common-project\hadoop-common\src\test\java\org\apache\hadoop\util\TestJsonSerialization.java,179,20,6,1,0,27
hadoop-trunk\hadoop-trunk\hadoop-yarn-project\hadoop-yarn\hadoop-yarn-server\hadoop-yarn-server-common\src\main\java\org\apache\hadoop\yarn\server\federation\failover\FederationProxyProviderUtil.java,0,12,0,1,0,13
hadoop-trunk\hadoop-trunk\hadoop-mapreduce-project\hadoop-mapreduce-client\hadoop-mapreduce-client-app\src\main\java\org\apache\hadoop\mapreduce\v2\app\job\event\TaskEventType.java,0,9,0,1,0,10
hadoop-trunk\hadoop-trunk\hadoop-common-project\hadoop-common\src\main\java\org\apache\hadoop\security\http\RestCsrfPreventionFilter.java,231,42,2,1,0,45
hadoop-trunk\hadoop-trunk\hadoop-hdfs-project\hadoop-hdfs\src\main\java\org\apache\hadoop\hdfs\server\blockmanagement\DatanodeStorageInfo.java,382,138,4,1,0,143
hadoop-trunk\hadoop-trunk\hadoop-common-project\hadoop-common\src\main\java\org\apache\hadoop\security\alias\LocalBouncyCastleFipsKeyStoreProvider.java,41,8,0,1,0,9
hadoop-trunk\hadoop-trunk\hadoop-mapreduce-project\hadoop-mapreduce-client\hadoop-mapreduce-client-app\src\main\java\org\apache\hadoop\mapreduce\v2\app\commit\CommitterEventHandler.java,0,59,6,4,0,69
hadoop-trunk\hadoop-trunk\hadoop-hdfs-project\hadoop-hdfs\src\main\java\org\apache\hadoop\hdfs\server\namenode\NameNodeResourcePolicy.java,0,8,2,1,0,11
hadoop-trunk\hadoop-trunk\hadoop-tools\hadoop-azure\src\main\java\org\apache\hadoop\fs\azurebfs\oauth2\IdentityTransformerInterface.java,0,7,2,6,0,15
hadoop-trunk\hadoop-trunk\hadoop-tools\hadoop-azure\src\main\java\org\apache\hadoop\fs\azurebfs\security\AbfsDelegationTokenIdentifier.java,34,9,0,2,0,11
hadoop-trunk\hadoop-trunk\hadoop-yarn-project\hadoop-yarn\hadoop-yarn-server\hadoop-yarn-server-nodemanager\src\main\java\org\apache\hadoop\yarn\server\nodemanager\containermanager\resourceplugin\fpga\FpgaDiscoverer.java,132,25,1,9,0,35
hadoop-trunk\hadoop-trunk\hadoop-yarn-project\hadoop-yarn\hadoop-yarn-applications\hadoop-yarn-services\hadoop-yarn-services-core\src\main\java\org\apache\hadoop\yarn\service\timelineservice\ServiceTimelineEntityType.java,0,0,0,1,0,1
hadoop-trunk\hadoop-trunk\hadoop-common-project\hadoop-common\src\main\java\org\apache\hadoop\security\ssl\DelegatingSSLSocketFactory.java,0,35,3,1,0,39
hadoop-trunk\hadoop-trunk\hadoop-yarn-project\hadoop-yarn\hadoop-yarn-server\hadoop-yarn-server-tests\src\test\java\org\apache\hadoop\yarn\server\timelineservice\security\TestTimelineAuthFilterForV2.java,0,81,5,11,0,97
hadoop-trunk\hadoop-trunk\hadoop-yarn-project\hadoop-yarn\hadoop-yarn-server\hadoop-yarn-server-resourcemanager\src\test\java\org\apache\hadoop\yarn\server\resourcemanager\TestRMEmbeddedElector.java,316,59,6,1,0,66
hadoop-trunk\hadoop-trunk\hadoop-hdfs-project\hadoop-hdfs\src\test\java\org\apache\hadoop\hdfs\TestDFSStripedInputStream.java,603,50,13,3,0,66
hadoop-trunk\hadoop-trunk\hadoop-yarn-project\hadoop-yarn\hadoop-yarn-server\hadoop-yarn-server-timelineservice\src\main\java\org\apache\hadoop\yarn\server\timelineservice\collector\AppLevelTimelineCollector.java,98,38,3,1,0,42
hadoop-trunk\hadoop-trunk\hadoop-yarn-project\hadoop-yarn\hadoop-yarn-applications\hadoop-yarn-services\hadoop-yarn-services-core\src\main\java\org\apache\hadoop\yarn\service\api\records\ServiceStatus.java,108,43,2,4,0,49
hadoop-trunk\hadoop-trunk\hadoop-tools\hadoop-aws\src\test\java\org\apache\hadoop\fs\s3a\performance\ITestS3ARenameCost.java,176,8,5,1,0,14
hadoop-trunk\hadoop-trunk\hadoop-yarn-project\hadoop-yarn\hadoop-yarn-server\hadoop-yarn-server-resourcemanager\src\main\java\org\apache\hadoop\yarn\server\resourcemanager\timelineservice\package-info.java,0,0,0,1,0,1
hadoop-trunk\hadoop-trunk\hadoop-common-project\hadoop-common\src\main\java\org\apache\hadoop\security\authorize\AccessControlList.java,325,67,3,4,0,74
hadoop-trunk\hadoop-trunk\hadoop-yarn-project\hadoop-yarn\hadoop-yarn-client\src\main\java\org\apache\hadoop\yarn\client\api\async\NMClientAsync.java,406,85,9,1,0,95
hadoop-trunk\hadoop-trunk\hadoop-common-project\hadoop-common\src\main\java\org\apache\hadoop\security\token\delegation\web\KerberosDelegationTokenAuthenticator.java,0,1,0,1,0,2
hadoop-trunk\hadoop-trunk\hadoop-yarn-project\hadoop-yarn\hadoop-yarn-server\hadoop-yarn-server-resourcemanager\src\test\java\org\apache\hadoop\yarn\server\resourcemanager\reservation\TestCapacitySchedulerPlanFollower.java,161,39,5,8,0,52
hadoop-trunk\hadoop-trunk\hadoop-mapreduce-project\hadoop-mapreduce-client\hadoop-mapreduce-client-jobclient\src\test\java\org\apache\hadoop\FailMapper.java,0,6,4,1,0,11
hadoop-trunk\hadoop-trunk\hadoop-common-project\hadoop-common\src\main\java\org\apache\hadoop\io\erasurecode\rawcoder\ByteArrayEncodingState.java,0,25,1,1,0,27
hadoop-trunk\hadoop-trunk\hadoop-yarn-project\hadoop-yarn\hadoop-yarn-server\hadoop-yarn-server-nodemanager\src\test\java\org\apache\hadoop\yarn\server\nodemanager\containermanager\logaggregation\TestLogAggregationService.java,0,405,102,36,0,543
hadoop-trunk\hadoop-trunk\hadoop-yarn-project\hadoop-yarn\hadoop-yarn-server\hadoop-yarn-server-resourcemanager\src\test\java\org\apache\hadoop\yarn\server\resourcemanager\scheduler\capacity\TestCapacitySchedulerMultiNodes.java,424,71,15,10,0,96
hadoop-trunk\hadoop-trunk\hadoop-mapreduce-project\hadoop-mapreduce-client\hadoop-mapreduce-client-core\src\main\java\org\apache\hadoop\mapreduce\jobhistory\TaskAttemptUnsuccessfulCompletionEvent.java,260,133,45,1,0,179
hadoop-trunk\hadoop-trunk\hadoop-mapreduce-project\hadoop-mapreduce-client\hadoop-mapreduce-client-app\src\main\java\org\apache\hadoop\mapreduce\v2\app\webapp\AppController.java,413,65,10,1,0,76
hadoop-trunk\hadoop-trunk\hadoop-tools\hadoop-aws\src\main\java\org\apache\hadoop\fs\s3a\S3ABlockOutputStream.java,0,50,11,6,0,67
hadoop-trunk\hadoop-trunk\hadoop-yarn-project\hadoop-yarn\hadoop-yarn-api\src\main\java\org\apache\hadoop\yarn\api\records\timelineservice\HierarchicalTimelineEntity.java,101,32,1,1,0,34
hadoop-trunk\hadoop-trunk\hadoop-yarn-project\hadoop-yarn\hadoop-yarn-common\src\test\java\org\apache\hadoop\yarn\api\TestTimelineEntityGroupId.java,28,8,0,6,0,14
hadoop-trunk\hadoop-trunk\hadoop-yarn-project\hadoop-yarn\hadoop-yarn-common\src\test\java\org\apache\hadoop\yarn\TestYarnUncaughtExceptionHandler.java,89,6,2,2,0,10
hadoop-trunk\hadoop-trunk\hadoop-yarn-project\hadoop-yarn\hadoop-yarn-server\hadoop-yarn-server-resourcemanager\src\main\java\org\apache\hadoop\yarn\server\resourcemanager\scheduler\activities\DiagnosticsCollector.java,0,6,0,1,0,7
hadoop-trunk\hadoop-trunk\hadoop-yarn-project\hadoop-yarn\hadoop-yarn-server\hadoop-yarn-server-router\src\test\java\org\apache\hadoop\yarn\server\router\webapp\TestRouterWebServicesREST.java,1329,89,1,57,0,147
hadoop-trunk\hadoop-trunk\hadoop-yarn-project\hadoop-yarn\hadoop-yarn-server\hadoop-yarn-server-common\src\main\java\org\apache\hadoop\yarn\server\federation\store\impl\SQLFederationStateStore.java,922,114,33,37,0,184
hadoop-trunk\hadoop-trunk\hadoop-yarn-project\hadoop-yarn\hadoop-yarn-applications\hadoop-yarn-services\hadoop-yarn-services-core\src\main\java\org\apache\hadoop\yarn\service\utils\ServiceRegistryUtils.java,81,14,2,1,0,17
hadoop-trunk\hadoop-trunk\hadoop-tools\hadoop-openstack\src\main\java\org\apache\hadoop\fs\swift\http\SwiftRestClient.java,0,176,27,11,0,214
hadoop-trunk\hadoop-trunk\hadoop-tools\hadoop-federation-balance\src\test\java\org\apache\hadoop\tools\fedbalance\procedure\RetryProcedure.java,41,17,2,1,0,20
hadoop-trunk\hadoop-trunk\hadoop-yarn-project\hadoop-yarn\hadoop-yarn-api\src\main\java\org\apache\hadoop\yarn\api\records\ApplicationAccessType.java,0,0,0,1,0,1
hadoop-trunk\hadoop-trunk\hadoop-common-project\hadoop-common\src\main\java\org\apache\hadoop\metrics2\lib\MetricsRegistry.java,422,132,2,1,0,135
hadoop-trunk\hadoop-trunk\hadoop-yarn-project\hadoop-yarn\hadoop-yarn-server\hadoop-yarn-server-nodemanager\src\main\java\org\apache\hadoop\yarn\server\nodemanager\containermanager\deletion\recovery\DeletionTaskRecoveryInfo.java,48,10,0,3,0,13
hadoop-trunk\hadoop-trunk\hadoop-yarn-project\hadoop-yarn\hadoop-yarn-server\hadoop-yarn-server-resourcemanager\src\test\java\org\apache\hadoop\yarn\server\resourcemanager\scheduler\capacity\conf\PersistentConfigurationStoreBaseTest.java,105,5,0,1,0,6
hadoop-trunk\hadoop-trunk\hadoop-yarn-project\hadoop-yarn\hadoop-yarn-server\hadoop-yarn-server-web-proxy\src\test\java\org\apache\hadoop\yarn\server\webproxy\amfilter\TestAmFilterInitializer.java,234,19,8,1,0,28
hadoop-trunk\hadoop-trunk\hadoop-yarn-project\hadoop-yarn\hadoop-yarn-server\hadoop-yarn-server-applicationhistoryservice\src\main\java\org\apache\hadoop\yarn\server\applicationhistoryservice\records\ApplicationStartData.java,76,22,0,1,0,23
hadoop-trunk\hadoop-trunk\hadoop-tools\hadoop-azure\src\main\java\org\apache\hadoop\fs\azurebfs\services\AbfsInputStreamContext.java,145,66,1,3,0,70
hadoop-trunk\hadoop-trunk\hadoop-common-project\hadoop-common\src\main\java\org\apache\hadoop\conf\ConfigRedactor.java,52,9,1,1,0,11
hadoop-trunk\hadoop-trunk\hadoop-hdfs-project\hadoop-hdfs\src\test\java\org\apache\hadoop\hdfs\web\TestWebHdfsWithMultipleNameNodes.java,125,41,5,4,0,50
hadoop-trunk\hadoop-trunk\hadoop-common-project\hadoop-common\src\main\java\org\apache\hadoop\crypto\key\KeyProviderExtension.java,0,42,1,1,0,44
hadoop-trunk\hadoop-trunk\hadoop-tools\hadoop-resourceestimator\src\main\java\org\apache\hadoop\resourceestimator\translator\api\JobMetaData.java,126,6,1,3,0,10
hadoop-trunk\hadoop-trunk\hadoop-common-project\hadoop-common\src\test\java\org\apache\hadoop\io\compress\TestCodecFactory.java,267,40,5,1,0,46
hadoop-trunk\hadoop-trunk\hadoop-common-project\hadoop-common\src\main\java\org\apache\hadoop\util\Shell.java,1340,203,21,4,0,228
hadoop-trunk\hadoop-trunk\hadoop-tools\hadoop-openstack\src\test\java\org\apache\hadoop\fs\swift\SwiftFileSystemBaseTest.java,348,80,6,3,0,89
hadoop-trunk\hadoop-trunk\hadoop-hdfs-project\hadoop-hdfs-rbf\src\main\java\org\apache\hadoop\hdfs\server\federation\resolver\ActiveNamenodeResolver.java,0,0,0,1,0,1
hadoop-trunk\hadoop-trunk\hadoop-hdfs-project\hadoop-hdfs-client\src\main\java\org\apache\hadoop\hdfs\web\resources\UserParam.java,58,10,1,2,0,13
hadoop-trunk\hadoop-trunk\hadoop-hdfs-project\hadoop-hdfs\src\test\java\org\apache\hadoop\hdfs\TestDFSStripedOutputStreamWithFailureWithRandomECPolicy.java,18,4,1,1,0,6
hadoop-trunk\hadoop-trunk\hadoop-tools\hadoop-azure\src\test\java\org\apache\hadoop\fs\azurebfs\extensions\MockErrorSASTokenProvider.java,0,13,3,5,0,21
hadoop-trunk\hadoop-trunk\hadoop-mapreduce-project\hadoop-mapreduce-client\hadoop-mapreduce-client-core\src\test\java\org\apache\hadoop\mapred\TestJobInfo.java,37,13,3,1,0,17
hadoop-trunk\hadoop-trunk\hadoop-tools\hadoop-aws\src\main\java\org\apache\hadoop\fs\s3a\commit\AbstractS3ACommitter.java,0,106,24,8,0,138
hadoop-trunk\hadoop-trunk\hadoop-hdfs-project\hadoop-hdfs\src\test\java\org\apache\hadoop\hdfs\tools\offlineImageViewer\TestOfflineImageViewerForAcl.java,187,23,16,1,0,40
hadoop-trunk\hadoop-trunk\hadoop-tools\hadoop-sls\src\main\java\org\apache\hadoop\yarn\sls\synthetic\SynthUtils.java,0,15,0,1,0,16
hadoop-trunk\hadoop-trunk\hadoop-hdfs-project\hadoop-hdfs-rbf\src\main\java\org\apache\hadoop\hdfs\server\federation\store\protocol\LeaveSafeModeResponse.java,22,6,0,2,0,8
hadoop-trunk\hadoop-trunk\hadoop-tools\hadoop-aws\src\main\java\org\apache\hadoop\fs\s3a\statistics\DelegationTokenStatistics.java,0,0,0,1,0,1
hadoop-trunk\hadoop-trunk\hadoop-tools\hadoop-azure\src\test\java\org\apache\hadoop\fs\azurebfs\services\ITestReadBufferManager.java,127,41,1,29,0,71
hadoop-trunk\hadoop-trunk\hadoop-mapreduce-project\hadoop-mapreduce-client\hadoop-mapreduce-client-core\src\main\java\org\apache\hadoop\mapreduce\lib\output\NamedCommitterFactory.java,42,4,0,1,0,5
hadoop-trunk\hadoop-trunk\hadoop-tools\hadoop-azure\src\test\java\org\apache\hadoop\fs\azure\TestNativeAzureFileSystemMocked.java,40,3,6,1,0,10
hadoop-trunk\hadoop-trunk\hadoop-yarn-project\hadoop-yarn\hadoop-yarn-server\hadoop-yarn-server-timelineservice-hbase\hadoop-yarn-server-timelineservice-hbase-common\src\main\java\org\apache\hadoop\yarn\server\timelineservice\storage\common\ValueConverter.java,0,0,0,1,0,1
hadoop-trunk\hadoop-trunk\hadoop-hdfs-project\hadoop-hdfs\src\main\java\org\apache\hadoop\hdfs\server\diskbalancer\planner\GreedyPlanner.java,226,32,9,1,0,42
hadoop-trunk\hadoop-trunk\hadoop-yarn-project\hadoop-yarn\hadoop-yarn-server\hadoop-yarn-server-resourcemanager\src\main\java\org\apache\hadoop\yarn\server\resourcemanager\scheduler\activities\AppAllocation.java,97,55,0,1,0,56
hadoop-trunk\hadoop-trunk\hadoop-common-project\hadoop-common\src\main\java\org\apache\hadoop\fs\HardLink.java,0,93,1,3,0,97
hadoop-trunk\hadoop-trunk\hadoop-hdfs-project\hadoop-hdfs\src\main\java\org\apache\hadoop\hdfs\server\diskbalancer\datamodel\package-info.java,0,2,0,1,0,3
hadoop-trunk\hadoop-trunk\hadoop-hdfs-project\hadoop-hdfs\src\test\java\org\apache\hadoop\hdfs\server\namenode\TestNameNodeMetricsLogger.java,140,30,5,1,0,36
hadoop-trunk\hadoop-trunk\hadoop-common-project\hadoop-common\src\test\java\org\apache\hadoop\security\token\TestToken.java,0,32,8,5,0,45
hadoop-trunk\hadoop-trunk\hadoop-mapreduce-project\hadoop-mapreduce-client\hadoop-mapreduce-client-core\src\main\java\org\apache\hadoop\mapreduce\lib\partition\KeyFieldBasedPartitioner.java,0,68,3,1,0,72
hadoop-trunk\hadoop-trunk\hadoop-tools\hadoop-azure\src\main\java\org\apache\hadoop\fs\azurebfs\services\AbfsClientThrottlingIntercept.java,0,17,1,3,0,21
hadoop-trunk\hadoop-trunk\hadoop-hdfs-project\hadoop-hdfs\src\test\java\org\apache\hadoop\hdfs\server\blockmanagement\TestStorageBlockPoolUsageStdDev.java,121,35,0,6,0,41
hadoop-trunk\hadoop-trunk\hadoop-hdfs-project\hadoop-hdfs\src\test\java\org\apache\hadoop\hdfs\server\namenode\ha\TestObserverNode.java,541,58,5,5,0,68
hadoop-trunk\hadoop-trunk\hadoop-mapreduce-project\hadoop-mapreduce-client\hadoop-mapreduce-client-common\src\main\java\org\apache\hadoop\mapreduce\v2\api\records\package-info.java,0,1,0,1,0,2
hadoop-trunk\hadoop-trunk\hadoop-yarn-project\hadoop-yarn\hadoop-yarn-common\src\main\java\org\apache\hadoop\yarn\ipc\RPCUtil.java,112,19,8,1,0,28
hadoop-trunk\hadoop-trunk\hadoop-hdfs-project\hadoop-hdfs\src\main\java\org\apache\hadoop\hdfs\server\balancer\Balancer.java,959,283,28,22,0,333
hadoop-trunk\hadoop-trunk\hadoop-hdfs-project\hadoop-hdfs\src\main\java\org\apache\hadoop\hdfs\util\XMLUtils.java,344,103,19,2,0,124
hadoop-trunk\hadoop-trunk\hadoop-yarn-project\hadoop-yarn\hadoop-yarn-server\hadoop-yarn-server-resourcemanager\src\test\java\org\apache\hadoop\yarn\server\resourcemanager\MockRMWithCustomAMLauncher.java,44,14,0,4,0,18
hadoop-trunk\hadoop-trunk\hadoop-common-project\hadoop-common\src\main\java\org\apache\hadoop\HadoopIllegalArgumentException.java,12,3,0,1,0,4
hadoop-trunk\hadoop-trunk\hadoop-yarn-project\hadoop-yarn\hadoop-yarn-server\hadoop-yarn-server-resourcemanager\src\test\java\org\apache\hadoop\yarn\server\resourcemanager\applicationsmanager\TestSchedulerNegotiator.java,144,9,2,10,0,21
hadoop-trunk\hadoop-trunk\hadoop-common-project\hadoop-common\src\main\java\org\apache\hadoop\util\Options.java,128,66,2,1,0,69
hadoop-trunk\hadoop-trunk\hadoop-hdfs-project\hadoop-hdfs-nfs\src\test\java\org\apache\hadoop\hdfs\nfs\TestUdpServer.java,103,39,9,1,0,49
hadoop-trunk\hadoop-trunk\hadoop-tools\hadoop-azure\src\test\java\org\apache\hadoop\fs\azurebfs\ITestAzureBlobFileSystemDelegationSAS.java,417,52,5,33,0,90
hadoop-trunk\hadoop-trunk\hadoop-yarn-project\hadoop-yarn\hadoop-yarn-server\hadoop-yarn-server-resourcemanager\src\test\java\org\apache\hadoop\yarn\server\resourcemanager\scheduler\policy\TestFairOrderingPolicy.java,350,55,7,7,0,69
hadoop-trunk\hadoop-trunk\hadoop-mapreduce-project\hadoop-mapreduce-client\hadoop-mapreduce-client-jobclient\src\test\java\org\apache\hadoop\fs\slive\Constants.java,0,34,1,2,0,37
hadoop-trunk\hadoop-trunk\hadoop-yarn-project\hadoop-yarn\hadoop-yarn-applications\hadoop-yarn-applications-mawo\hadoop-yarn-applications-mawo-core\src\main\java\org\apache\hadoop\applications\mawo\server\common\TaskType.java,0,0,0,1,0,1
hadoop-trunk\hadoop-trunk\hadoop-tools\hadoop-azure\src\main\java\org\apache\hadoop\fs\azurebfs\security\AbfsDelegationTokenManager.java,125,17,0,7,0,24
hadoop-trunk\hadoop-trunk\hadoop-yarn-project\hadoop-yarn\hadoop-yarn-server\hadoop-yarn-server-nodemanager\src\test\java\org\apache\hadoop\yarn\server\nodemanager\containermanager\loghandler\TestNonAggregatingLogHandler.java,511,114,9,12,0,135
hadoop-trunk\hadoop-trunk\hadoop-yarn-project\hadoop-yarn\hadoop-yarn-server\hadoop-yarn-server-router\src\main\java\org\apache\hadoop\yarn\server\router\security\authorize\package-info.java,0,0,0,1,0,1
hadoop-trunk\hadoop-trunk\hadoop-yarn-project\hadoop-yarn\hadoop-yarn-server\hadoop-yarn-server-resourcemanager\src\test\java\org\apache\hadoop\yarn\server\resourcemanager\rmapp\TestApplicationLifetimeMonitor.java,537,75,19,10,0,104
hadoop-trunk\hadoop-trunk\hadoop-mapreduce-project\hadoop-mapreduce-client\hadoop-mapreduce-client-app\src\test\java\org\apache\hadoop\mapreduce\v2\app\webapp\ViewForTest.java,9,3,1,1,0,5
hadoop-trunk\hadoop-trunk\hadoop-yarn-project\hadoop-yarn\hadoop-yarn-server\hadoop-yarn-server-resourcemanager\src\test\java\org\apache\hadoop\yarn\server\resourcemanager\scheduler\constraint\algorithm\TestLocalAllocationTagsManager.java,118,8,1,6,0,15
hadoop-trunk\hadoop-trunk\hadoop-mapreduce-project\hadoop-mapreduce-client\hadoop-mapreduce-client-core\src\main\java\org\apache\hadoop\mapred\lib\aggregate\ValueAggregatorReducer.java,0,19,4,3,0,26
hadoop-trunk\hadoop-trunk\hadoop-yarn-project\hadoop-yarn\hadoop-yarn-common\src\main\java\org\apache\hadoop\yarn\event\EventHandler.java,0,2,0,1,0,3
hadoop-trunk\hadoop-trunk\hadoop-tools\hadoop-rumen\src\main\java\org\apache\hadoop\tools\rumen\datatypes\DefaultDataType.java,16,7,0,1,0,8
hadoop-trunk\hadoop-trunk\hadoop-yarn-project\hadoop-yarn\hadoop-yarn-server\hadoop-yarn-server-common\src\main\java\org\apache\hadoop\yarn\server\webapp\WebServices.java,515,112,2,6,0,120
hadoop-trunk\hadoop-trunk\hadoop-tools\hadoop-sls\src\main\java\org\apache\hadoop\yarn\sls\conf\SLSConfiguration.java,108,73,1,1,0,75
hadoop-trunk\hadoop-trunk\hadoop-tools\hadoop-aliyun\src\test\java\org\apache\hadoop\fs\aliyun\oss\TestAliyunOSSFileSystemStore.java,84,12,3,1,0,16
hadoop-trunk\hadoop-trunk\hadoop-tools\hadoop-azure\src\main\java\org\apache\hadoop\fs\azure\metrics\ResponseReceivedMetricUpdater.java,0,23,4,3,0,30
hadoop-trunk\hadoop-trunk\hadoop-yarn-project\hadoop-yarn\hadoop-yarn-server\hadoop-yarn-server-resourcemanager\src\main\java\org\apache\hadoop\yarn\server\resourcemanager\scheduler\capacity\CapacitySchedulerQueueManager.java,0,117,10,32,0,159
hadoop-trunk\hadoop-trunk\hadoop-common-project\hadoop-common\src\test\java\org\apache\hadoop\net\TestDNS.java,212,21,11,1,0,33
hadoop-trunk\hadoop-trunk\hadoop-yarn-project\hadoop-yarn\hadoop-yarn-server\hadoop-yarn-server-common\src\main\java\org\apache\hadoop\yarn\server\api\protocolrecords\RemoteNode.java,140,17,0,1,0,18
hadoop-trunk\hadoop-trunk\hadoop-hdfs-project\hadoop-hdfs\src\main\java\org\apache\hadoop\hdfs\tools\offlineImageViewer\DepthCounter.java,0,10,2,1,0,13
hadoop-trunk\hadoop-trunk\hadoop-yarn-project\hadoop-yarn\hadoop-yarn-applications\hadoop-yarn-services\hadoop-yarn-services-api\src\main\java\org\apache\hadoop\yarn\service\webapp\ApiServerWebApp.java,113,13,6,3,0,22
hadoop-trunk\hadoop-trunk\hadoop-yarn-project\hadoop-yarn\hadoop-yarn-server\hadoop-yarn-server-nodemanager\src\test\java\org\apache\hadoop\yarn\server\nodemanager\containermanager\linux\resources\TestResourceHandlerModule.java,78,7,2,2,0,11
hadoop-trunk\hadoop-trunk\hadoop-yarn-project\hadoop-yarn\hadoop-yarn-server\hadoop-yarn-server-resourcemanager\src\main\java\org\apache\hadoop\yarn\server\resourcemanager\recovery\RMStateStoreAppAttemptEvent.java,13,9,0,2,0,11
hadoop-trunk\hadoop-trunk\hadoop-yarn-project\hadoop-yarn\hadoop-yarn-server\hadoop-yarn-server-resourcemanager\src\main\java\org\apache\hadoop\yarn\server\resourcemanager\scheduler\YarnScheduler.java,0,35,18,5,0,58
hadoop-trunk\hadoop-trunk\hadoop-hdfs-project\hadoop-hdfs\src\main\java\org\apache\hadoop\hdfs\server\namenode\GlobalStateIdContext.java,0,16,11,1,0,28
hadoop-trunk\hadoop-trunk\hadoop-yarn-project\hadoop-yarn\hadoop-yarn-server\hadoop-yarn-server-resourcemanager\src\main\java\org\apache\hadoop\yarn\server\resourcemanager\webapp\RMWSConsts.java,0,52,0,1,0,53
hadoop-trunk\hadoop-trunk\hadoop-tools\hadoop-distcp\src\main\java\org\apache\hadoop\tools\FileBasedCopyListing.java,65,9,3,3,0,15
hadoop-trunk\hadoop-trunk\hadoop-yarn-project\hadoop-yarn\hadoop-yarn-server\hadoop-yarn-server-resourcemanager\src\main\java\org\apache\hadoop\yarn\server\resourcemanager\scheduler\capacity\placement\schema\MappingRulesDescription.java,69,60,0,8,0,68
hadoop-trunk\hadoop-trunk\hadoop-tools\hadoop-aws\src\test\java\org\apache\hadoop\fs\s3a\commit\terasort\ITestTerasortOnS3A.java,0,24,9,1,0,34
hadoop-trunk\hadoop-trunk\hadoop-tools\hadoop-aws\src\main\java\org\apache\hadoop\fs\s3a\WriteOperations.java,0,2,1,1,0,4
hadoop-trunk\hadoop-trunk\hadoop-tools\hadoop-aws\src\test\java\org\apache\hadoop\fs\s3a\commit\staging\MockedStagingCommitter.java,0,9,1,1,0,11
hadoop-trunk\hadoop-trunk\hadoop-hdfs-project\hadoop-hdfs\src\test\java\org\apache\hadoop\hdfs\server\namenode\ha\TestBootstrapStandbyWithInProgressTailing.java,0,1,0,2,0,3
hadoop-trunk\hadoop-trunk\hadoop-mapreduce-project\hadoop-mapreduce-client\hadoop-mapreduce-client-nativetask\src\main\java\org\apache\hadoop\mapred\nativetask\serde\FloatWritableSerializer.java,8,4,0,1,0,5
hadoop-trunk\hadoop-trunk\hadoop-yarn-project\hadoop-yarn\hadoop-yarn-server\hadoop-yarn-server-resourcemanager\src\main\java\org\apache\hadoop\yarn\server\resourcemanager\scheduler\placement\SimpleCandidateNodeSet.java,0,14,0,1,0,15
hadoop-trunk\hadoop-trunk\hadoop-common-project\hadoop-common\src\test\java\org\apache\hadoop\fs\TestFileSystemCanonicalization.java,340,159,3,5,0,167
hadoop-trunk\hadoop-trunk\hadoop-yarn-project\hadoop-yarn\hadoop-yarn-applications\hadoop-yarn-applications-catalog\hadoop-yarn-applications-catalog-webapp\src\main\java\org\apache\hadoop\yarn\appcatalog\application\AppCatalogSolrClient.java,392,72,10,1,0,83
hadoop-trunk\hadoop-trunk\hadoop-common-project\hadoop-common\src\test\java\org\apache\hadoop\ha\TestNodeFencer.java,164,58,3,4,0,65
hadoop-trunk\hadoop-trunk\hadoop-mapreduce-project\hadoop-mapreduce-client\hadoop-mapreduce-client-core\src\main\java\org\apache\hadoop\mapred\RawKeyValueIterator.java,0,19,0,1,0,20
hadoop-trunk\hadoop-trunk\hadoop-yarn-project\hadoop-yarn\hadoop-yarn-applications\hadoop-yarn-services\hadoop-yarn-services-core\src\main\java\org\apache\hadoop\yarn\service\ClientAMSecurityInfo.java,31,7,0,1,0,8
hadoop-trunk\hadoop-trunk\hadoop-hdfs-project\hadoop-hdfs\src\test\java\org\apache\hadoop\hdfs\TestSafeModeWithStripedFile.java,133,19,4,1,0,24
hadoop-trunk\hadoop-trunk\hadoop-common-project\hadoop-common\src\test\java\org\apache\hadoop\fs\shell\TestMove.java,93,36,7,1,0,44
hadoop-trunk\hadoop-trunk\hadoop-hdfs-project\hadoop-hdfs\src\test\java\org\apache\hadoop\hdfs\server\namenode\ha\TestFailoverWithBlockTokensEnabled.java,152,48,2,6,0,56
hadoop-trunk\hadoop-trunk\hadoop-mapreduce-project\hadoop-mapreduce-client\hadoop-mapreduce-client-core\src\test\java\org\apache\hadoop\mapreduce\TestShufflePlugin.java,0,38,10,19,0,67
hadoop-trunk\hadoop-trunk\hadoop-hdfs-project\hadoop-hdfs\src\test\java\org\apache\hadoop\hdfs\server\datanode\TestDataNodeLifeline.java,314,46,5,11,0,62
hadoop-trunk\hadoop-trunk\hadoop-mapreduce-project\hadoop-mapreduce-client\hadoop-mapreduce-client-jobclient\src\test\java\org\apache\hadoop\mapreduce\TestCounters.java,123,29,7,1,0,37
hadoop-trunk\hadoop-trunk\hadoop-hdfs-project\hadoop-hdfs-client\src\main\java\org\apache\hadoop\hdfs\inotify\MissingEventsException.java,30,16,1,1,0,18
hadoop-trunk\hadoop-trunk\hadoop-yarn-project\hadoop-yarn\hadoop-yarn-server\hadoop-yarn-server-resourcemanager\src\test\java\org\apache\hadoop\yarn\server\resourcemanager\scheduler\fair\TestFairSchedulerFairShare.java,321,97,5,9,0,111
hadoop-trunk\hadoop-trunk\hadoop-yarn-project\hadoop-yarn\hadoop-yarn-common\src\main\java\org\apache\hadoop\yarn\webapp\dao\package-info.java,0,0,0,1,0,1
hadoop-trunk\hadoop-trunk\hadoop-mapreduce-project\hadoop-mapreduce-client\hadoop-mapreduce-client-nativetask\src\main\java\org\apache\hadoop\mapred\nativetask\buffer\DataOutputStream.java,14,6,0,2,0,8
hadoop-trunk\hadoop-trunk\hadoop-mapreduce-project\hadoop-mapreduce-client\hadoop-mapreduce-client-core\src\main\java\org\apache\hadoop\mapreduce\InputFormat.java,0,30,0,3,0,33
hadoop-trunk\hadoop-trunk\hadoop-tools\hadoop-aws\src\test\java\org\apache\hadoop\fs\contract\s3a\ITestS3AContractGetFileStatus.java,0,4,0,1,0,5
hadoop-trunk\hadoop-trunk\hadoop-tools\hadoop-sls\src\main\java\org\apache\hadoop\yarn\sls\scheduler\SLSSchedulerCommons.java,291,51,2,14,0,67
hadoop-trunk\hadoop-trunk\hadoop-common-project\hadoop-common\src\main\java\org\apache\hadoop\security\alias\CredentialShell.java,494,89,22,1,0,112
hadoop-trunk\hadoop-trunk\hadoop-hdfs-project\hadoop-hdfs\src\test\java\org\apache\hadoop\hdfs\TestDistributedFileSystemWithECFile.java,248,51,21,1,0,73
hadoop-trunk\hadoop-trunk\hadoop-cloud-storage-project\hadoop-cos\src\main\java\org\apache\hadoop\fs\cosn\package-info.java,0,0,0,1,0,1
hadoop-trunk\hadoop-trunk\hadoop-hdfs-project\hadoop-hdfs\src\main\java\org\apache\hadoop\hdfs\security\token\block\ExportedBlockKeys.java,85,32,1,1,0,34
hadoop-trunk\hadoop-trunk\hadoop-mapreduce-project\hadoop-mapreduce-client\hadoop-mapreduce-client-core\src\test\java\org\apache\hadoop\mapreduce\lib\output\TestPathOutputCommitterFactory.java,455,45,5,4,0,54
hadoop-trunk\hadoop-trunk\hadoop-yarn-project\hadoop-yarn\hadoop-yarn-applications\hadoop-yarn-services\hadoop-yarn-services-core\src\main\java\org\apache\hadoop\yarn\service\provider\ProviderUtils.java,425,92,19,9,0,120
hadoop-trunk\hadoop-trunk\hadoop-yarn-project\hadoop-yarn\hadoop-yarn-server\hadoop-yarn-server-resourcemanager\src\main\java\org\apache\hadoop\yarn\server\resourcemanager\rmapp\RMApp.java,0,28,0,6,0,34
hadoop-trunk\hadoop-trunk\hadoop-tools\hadoop-aws\src\test\java\org\apache\hadoop\fs\s3a\scale\ITestS3AHugeFilesArrayBlocks.java,7,1,0,1,0,2
hadoop-trunk\hadoop-trunk\hadoop-tools\hadoop-streaming\src\test\java\org\apache\hadoop\streaming\TestTypedBytesStreaming.java,59,29,2,6,0,37
hadoop-trunk\hadoop-trunk\hadoop-tools\hadoop-aliyun\src\main\java\org\apache\hadoop\fs\aliyun\oss\ReadBuffer.java,60,36,0,1,0,37
hadoop-trunk\hadoop-trunk\hadoop-yarn-project\hadoop-yarn\hadoop-yarn-server\hadoop-yarn-server-resourcemanager\src\main\java\org\apache\hadoop\yarn\server\resourcemanager\recovery\ZKRMStateStoreOpDurations.java,0,24,1,1,0,26
hadoop-trunk\hadoop-trunk\hadoop-common-project\hadoop-common\src\main\java\org\apache\hadoop\tools\GetUserMappingsProtocol.java,0,7,2,1,0,10
hadoop-trunk\hadoop-trunk\hadoop-hdfs-project\hadoop-hdfs\src\main\java\org\apache\hadoop\hdfs\server\datanode\DataNodeLayoutVersion.java,0,25,1,2,0,28
hadoop-trunk\hadoop-trunk\hadoop-yarn-project\hadoop-yarn\hadoop-yarn-client\src\test\java\org\apache\hadoop\yarn\client\TestRMFailoverProxyProvider.java,0,19,44,1,0,64
hadoop-trunk\hadoop-trunk\hadoop-hdfs-project\hadoop-hdfs\src\main\java\org\apache\hadoop\hdfs\tools\offlineImageViewer\OfflineImageViewer.java,241,65,9,21,0,95
hadoop-trunk\hadoop-trunk\hadoop-hdfs-project\hadoop-hdfs\src\test\java\org\apache\hadoop\hdfs\server\namenode\TestQuotaWithStripedBlocksWithRandomECPolicy.java,22,4,1,1,0,6
hadoop-trunk\hadoop-trunk\hadoop-hdfs-project\hadoop-hdfs-rbf\src\main\java\org\apache\hadoop\hdfs\server\federation\router\MountTableRefresherService.java,247,24,3,3,0,30
hadoop-trunk\hadoop-trunk\hadoop-yarn-project\hadoop-yarn\hadoop-yarn-server\hadoop-yarn-server-resourcemanager\src\main\java\org\apache\hadoop\yarn\server\resourcemanager\webapp\dao\NodesInfo.java,20,11,5,1,0,17
hadoop-trunk\hadoop-trunk\hadoop-tools\hadoop-aws\src\test\java\org\apache\hadoop\fs\s3a\commit\LoggingTextOutputFormat.java,0,26,1,1,0,28
hadoop-trunk\hadoop-trunk\hadoop-yarn-project\hadoop-yarn\hadoop-yarn-server\hadoop-yarn-server-resourcemanager\src\test\java\org\apache\hadoop\yarn\server\resourcemanager\scheduler\capacity\TestCapacitySchedulerAutoCreatedQueueBase.java,832,261,24,14,0,299
hadoop-trunk\hadoop-trunk\hadoop-mapreduce-project\hadoop-mapreduce-client\hadoop-mapreduce-client-core\src\main\java\org\apache\hadoop\mapred\lib\aggregate\DoubleValueSum.java,0,2,0,1,0,3
hadoop-trunk\hadoop-trunk\hadoop-mapreduce-project\hadoop-mapreduce-client\hadoop-mapreduce-client-hs\src\test\java\org\apache\hadoop\mapreduce\v2\hs\webapp\TestHsWebServicesJobs.java,761,73,6,4,0,83
hadoop-trunk\hadoop-trunk\hadoop-common-project\hadoop-common\src\test\java\org\apache\hadoop\io\erasurecode\rawcoder\TestRSRawCoderBase.java,94,61,14,1,0,76
hadoop-trunk\hadoop-trunk\hadoop-mapreduce-project\hadoop-mapreduce-client\hadoop-mapreduce-client-core\src\test\java\org\apache\hadoop\mapreduce\checkpoint\TestFSCheckpointID.java,23,2,0,1,0,3
hadoop-trunk\hadoop-trunk\hadoop-common-project\hadoop-common\src\main\java\org\apache\hadoop\security\token\TokenRenewer.java,38,9,0,1,0,10
hadoop-trunk\hadoop-trunk\hadoop-common-project\hadoop-common\src\test\java\org\apache\hadoop\security\TestShellBasedUnixGroupsMapping.java,0,36,12,1,0,49
hadoop-trunk\hadoop-trunk\hadoop-yarn-project\hadoop-yarn\hadoop-yarn-server\hadoop-yarn-server-common\src\test\java\org\apache\hadoop\yarn\server\api\protocolrecords\TestRegisterNodeManagerResponse.java,67,36,6,6,0,48
hadoop-trunk\hadoop-trunk\hadoop-yarn-project\hadoop-yarn\hadoop-yarn-applications\hadoop-yarn-services\hadoop-yarn-services-core\src\main\java\org\apache\hadoop\yarn\service\client\ClientAMProxy.java,27,3,0,1,0,4
hadoop-trunk\hadoop-trunk\hadoop-hdfs-project\hadoop-hdfs\src\test\java\org\apache\hadoop\hdfs\TestReplaceDatanodeFailureReplication.java,244,29,11,2,0,42
hadoop-trunk\hadoop-trunk\hadoop-mapreduce-project\hadoop-mapreduce-client\hadoop-mapreduce-client-core\src\main\java\org\apache\hadoop\mapred\SequenceFileOutputFormat.java,0,38,4,2,0,44
hadoop-trunk\hadoop-trunk\hadoop-hdfs-project\hadoop-hdfs\src\test\java\org\apache\hadoop\hdfs\server\blockmanagement\TestBlockPlacementStatusDefault.java,30,6,0,1,0,7
hadoop-trunk\hadoop-trunk\hadoop-yarn-project\hadoop-yarn\hadoop-yarn-server\hadoop-yarn-server-timelineservice-hbase\hadoop-yarn-server-timelineservice-hbase-common\src\main\java\org\apache\hadoop\yarn\server\timelineservice\storage\domain\DomainColumnFamily.java,0,2,0,2,0,4
hadoop-trunk\hadoop-trunk\hadoop-yarn-project\hadoop-yarn\hadoop-yarn-server\hadoop-yarn-server-nodemanager\src\main\java\org\apache\hadoop\yarn\server\nodemanager\nodelabels\ScriptBasedNodeLabelsProvider.java,86,11,1,1,0,13
hadoop-trunk\hadoop-trunk\hadoop-common-project\hadoop-common\src\main\java\org\apache\hadoop\metrics2\lib\MethodMetric.java,0,46,12,1,0,59
hadoop-trunk\hadoop-trunk\hadoop-yarn-project\hadoop-yarn\hadoop-yarn-server\hadoop-yarn-server-resourcemanager\src\main\java\org\apache\hadoop\yarn\server\resourcemanager\resource\ResourceProfilesManager.java,0,0,0,1,0,1
hadoop-trunk\hadoop-trunk\hadoop-yarn-project\hadoop-yarn\hadoop-yarn-common\src\main\java\org\apache\hadoop\yarn\api\protocolrecords\impl\pb\ReservationListRequestPBImpl.java,144,28,51,1,0,80
hadoop-trunk\hadoop-trunk\hadoop-common-project\hadoop-common\src\test\java\org\apache\hadoop\io\file\tfile\TestCompression.java,45,7,9,1,0,17
hadoop-trunk\hadoop-trunk\hadoop-common-project\hadoop-common\src\test\java\org\apache\hadoop\metrics2\lib\MetricsTestHelper.java,0,10,0,1,0,11
hadoop-trunk\hadoop-trunk\hadoop-tools\hadoop-aws\src\test\java\org\apache\hadoop\fs\s3a\select\ITestS3SelectCLI.java,293,40,4,7,0,51
hadoop-trunk\hadoop-trunk\hadoop-hdfs-project\hadoop-hdfs\src\main\java\org\apache\hadoop\hdfs\server\common\sps\package-info.java,0,1,0,1,0,2
hadoop-trunk\hadoop-trunk\hadoop-yarn-project\hadoop-yarn\hadoop-yarn-server\hadoop-yarn-server-applicationhistoryservice\src\test\java\org\apache\hadoop\yarn\server\timeline\security\TestTimelineACLsManager.java,180,12,0,1,0,13
hadoop-trunk\hadoop-trunk\hadoop-common-project\hadoop-common\src\main\java\org\apache\hadoop\util\SysInfoLinux.java,700,105,35,1,0,141
hadoop-trunk\hadoop-trunk\hadoop-hdfs-project\hadoop-hdfs\src\test\java\org\apache\hadoop\hdfs\server\datanode\TestDataNodeMultipleRegistrations.java,332,59,26,13,0,98
hadoop-trunk\hadoop-trunk\hadoop-yarn-project\hadoop-yarn\hadoop-yarn-server\hadoop-yarn-server-resourcemanager\src\test\java\org\apache\hadoop\yarn\server\resourcemanager\webapp\TestRMWebServicesCapacitySchedDynamicConfig.java,281,46,1,34,0,81
hadoop-trunk\hadoop-trunk\hadoop-yarn-project\hadoop-yarn\hadoop-yarn-server\hadoop-yarn-server-timelineservice-hbase\hadoop-yarn-server-timelineservice-hbase-common\src\main\java\org\apache\hadoop\yarn\server\timelineservice\storage\apptoflow\AppToFlowRowKey.java,34,8,0,3,0,11
hadoop-trunk\hadoop-trunk\hadoop-hdfs-project\hadoop-hdfs-rbf\src\test\java\org\apache\hadoop\fs\contract\router\TestRouterHDFSContractRenameSecure.java,0,5,0,1,0,6
hadoop-trunk\hadoop-trunk\hadoop-mapreduce-project\hadoop-mapreduce-client\hadoop-mapreduce-client-nativetask\src\main\java\org\apache\hadoop\mapred\nativetask\buffer\ByteBufferDataWriter.java,136,41,1,2,0,44
hadoop-trunk\hadoop-trunk\hadoop-yarn-project\hadoop-yarn\hadoop-yarn-server\hadoop-yarn-server-common\src\main\java\org\apache\hadoop\yarn\server\api\impl\pb\service\SCMUploaderProtocolPBServiceImpl.java,40,10,13,11,0,34
hadoop-trunk\hadoop-trunk\hadoop-hdfs-project\hadoop-hdfs\src\main\java\org\apache\hadoop\hdfs\server\blockmanagement\DatanodeStats.java,0,17,0,1,0,18
hadoop-trunk\hadoop-trunk\hadoop-common-project\hadoop-common\src\test\java\org\apache\hadoop\log\TestLogLevel.java,377,57,6,1,0,64
hadoop-trunk\hadoop-trunk\hadoop-common-project\hadoop-registry\src\test\java\org\apache\hadoop\registry\server\dns\TestSecureRegistryDNS.java,21,2,0,1,0,3
hadoop-trunk\hadoop-trunk\hadoop-mapreduce-project\hadoop-mapreduce-client\hadoop-mapreduce-client-jobclient\src\test\java\org\apache\hadoop\mapreduce\TestMapReduceLazyOutput.java,147,51,16,1,0,68
hadoop-trunk\hadoop-trunk\hadoop-hdfs-project\hadoop-hdfs-rbf\src\test\java\org\apache\hadoop\fs\contract\router\TestRouterHDFSContractGetFileStatus.java,0,5,0,1,0,6
hadoop-trunk\hadoop-trunk\hadoop-yarn-project\hadoop-yarn\hadoop-yarn-server\hadoop-yarn-server-nodemanager\src\main\java\org\apache\hadoop\yarn\server\nodemanager\containermanager\runtime\ContainerRuntimeContext.java,0,28,0,2,0,30
hadoop-trunk\hadoop-trunk\hadoop-yarn-project\hadoop-yarn\hadoop-yarn-api\src\main\java\org\apache\hadoop\yarn\api\records\timeline\TimelineDomains.java,49,15,2,1,0,18
hadoop-trunk\hadoop-trunk\hadoop-yarn-project\hadoop-yarn\hadoop-yarn-server\hadoop-yarn-server-resourcemanager\src\main\java\org\apache\hadoop\yarn\server\resourcemanager\webapp\dao\ReservationDeleteResponseInfo.java,8,1,2,1,0,4
hadoop-trunk\hadoop-trunk\hadoop-tools\hadoop-resourceestimator\src\test\java\org\apache\hadoop\resourceestimator\translator\api\TestJobMetaData.java,128,27,1,2,0,30
hadoop-trunk\hadoop-trunk\hadoop-yarn-project\hadoop-yarn\hadoop-yarn-server\hadoop-yarn-server-resourcemanager\src\test\java\org\apache\hadoop\yarn\server\resourcemanager\scheduler\fair\TestQueueManager.java,681,18,4,2,0,24
hadoop-trunk\hadoop-trunk\hadoop-common-project\hadoop-common\src\test\java\org\apache\hadoop\ha\TestHAAdmin.java,69,25,3,1,0,29
hadoop-trunk\hadoop-trunk\hadoop-tools\hadoop-resourceestimator\src\main\java\org\apache\hadoop\resourceestimator\solver\impl\BaseSolver.java,54,0,1,3,0,4
hadoop-trunk\hadoop-trunk\hadoop-common-project\hadoop-common\src\main\java\org\apache\hadoop\fs\impl\MultipartUploaderBuilderImpl.java,0,27,0,3,0,30
hadoop-trunk\hadoop-trunk\hadoop-mapreduce-project\hadoop-mapreduce-client\hadoop-mapreduce-client-core\src\main\java\org\apache\hadoop\mapreduce\counters\package-info.java,0,0,0,1,0,1
hadoop-trunk\hadoop-trunk\hadoop-yarn-project\hadoop-yarn\hadoop-yarn-server\hadoop-yarn-server-resourcemanager\src\test\java\org\apache\hadoop\yarn\server\resourcemanager\scheduler\capacity\TestCapacitySchedulerWithMultiResourceTypes.java,423,69,36,17,0,122
hadoop-trunk\hadoop-trunk\hadoop-mapreduce-project\hadoop-mapreduce-client\hadoop-mapreduce-client-core\src\main\java\org\apache\hadoop\mapreduce\TaskID.java,0,102,7,1,0,110
hadoop-trunk\hadoop-trunk\hadoop-yarn-project\hadoop-yarn\hadoop-yarn-server\hadoop-yarn-server-common\src\main\java\org\apache\hadoop\yarn\server\utils\YarnServerSecurityUtils.java,0,6,1,1,0,8
hadoop-trunk\hadoop-trunk\hadoop-yarn-project\hadoop-yarn\hadoop-yarn-server\hadoop-yarn-server-common\src\main\java\org\apache\hadoop\yarn\server\scheduler\package-info.java,0,0,0,1,0,1
hadoop-trunk\hadoop-trunk\hadoop-tools\hadoop-aws\src\main\java\org\apache\hadoop\fs\s3a\impl\ExecutingStoreOperation.java,0,0,0,1,0,1
hadoop-trunk\hadoop-trunk\hadoop-common-project\hadoop-common\src\test\java\org\apache\hadoop\fs\TestGetSpaceUsed.java,105,22,4,1,0,27
hadoop-trunk\hadoop-trunk\hadoop-hdfs-project\hadoop-hdfs-rbf\src\main\java\org\apache\hadoop\hdfs\server\federation\metrics\NamenodeBeanMetrics.java,0,98,7,7,0,112
hadoop-trunk\hadoop-trunk\hadoop-yarn-project\hadoop-yarn\hadoop-yarn-server\hadoop-yarn-server-applicationhistoryservice\src\test\java\org\apache\hadoop\yarn\server\applicationhistoryservice\ApplicationHistoryStoreTestUtils.java,53,19,0,8,0,27
hadoop-trunk\hadoop-trunk\hadoop-hdfs-project\hadoop-hdfs\src\test\java\org\apache\hadoop\hdfs\TestBlockTokenWrappingQOP.java,130,21,4,2,0,27
hadoop-trunk\hadoop-trunk\hadoop-hdfs-project\hadoop-hdfs-httpfs\src\main\java\org\apache\hadoop\lib\wsrs\Param.java,39,16,2,2,0,20
hadoop-trunk\hadoop-trunk\hadoop-mapreduce-project\hadoop-mapreduce-client\hadoop-mapreduce-client-common\src\main\java\org\apache\hadoop\mapreduce\v2\security\client\ClientHSSecurityInfo.java,0,7,0,1,0,8
hadoop-trunk\hadoop-trunk\hadoop-common-project\hadoop-common\src\test\java\org\apache\hadoop\fs\contract\rawlocal\TestRawlocalContractRename.java,51,7,0,1,0,8
hadoop-trunk\hadoop-trunk\hadoop-mapreduce-project\hadoop-mapreduce-client\hadoop-mapreduce-client-app\src\test\java\org\apache\hadoop\mapreduce\v2\api\records\TestTaskAttemptReport.java,0,9,1,2,0,12
hadoop-trunk\hadoop-trunk\hadoop-tools\hadoop-aws\src\test\java\org\apache\hadoop\fs\s3a\impl\TestHeaderProcessing.java,272,19,3,3,0,25
hadoop-trunk\hadoop-trunk\hadoop-tools\hadoop-aws\src\main\java\org\apache\hadoop\fs\s3a\auth\NoAuthWithAWSException.java,11,2,0,1,0,3
hadoop-trunk\hadoop-trunk\hadoop-common-project\hadoop-common\src\test\java\org\apache\hadoop\fs\shell\find\TestPrint0.java,28,7,3,1,0,11
hadoop-trunk\hadoop-trunk\hadoop-common-project\hadoop-auth\src\test\java\org\apache\hadoop\security\authentication\KerberosTestUtils.java,102,30,1,9,0,40
hadoop-trunk\hadoop-trunk\hadoop-tools\hadoop-aws\src\main\java\org\apache\hadoop\fs\s3a\auth\delegation\AbstractS3ATokenIdentifier.java,0,18,1,2,0,21
hadoop-trunk\hadoop-trunk\hadoop-tools\hadoop-distcp\src\main\java\org\apache\hadoop\tools\DistCpConstants.java,0,81,0,17,0,98
hadoop-trunk\hadoop-trunk\hadoop-hdfs-project\hadoop-hdfs-rbf\src\main\java\org\apache\hadoop\hdfs\server\federation\router\RouterRpcMonitor.java,0,4,0,1,0,5
hadoop-trunk\hadoop-trunk\hadoop-common-project\hadoop-common\src\test\java\org\apache\hadoop\util\TestLightWeightCache.java,431,160,2,3,0,165
hadoop-trunk\hadoop-trunk\hadoop-yarn-project\hadoop-yarn\hadoop-yarn-server\hadoop-yarn-server-resourcemanager\src\main\java\org\apache\hadoop\yarn\server\resourcemanager\scheduler\constraint\PlacementConstraintsUtil.java,0,55,7,9,0,71
hadoop-trunk\hadoop-trunk\hadoop-hdfs-project\hadoop-hdfs\src\main\java\org\apache\hadoop\hdfs\server\diskbalancer\command\HelpCommand.java,80,7,1,1,0,9
hadoop-trunk\hadoop-trunk\hadoop-mapreduce-project\hadoop-mapreduce-client\hadoop-mapreduce-client-jobclient\src\test\java\org\apache\hadoop\mapreduce\security\ssl\TestEncryptedShuffle.java,0,15,3,2,0,20
hadoop-trunk\hadoop-trunk\hadoop-mapreduce-project\hadoop-mapreduce-client\hadoop-mapreduce-client-core\src\main\java\org\apache\hadoop\mapreduce\lib\join\StreamBackedIterator.java,0,29,6,1,0,36
hadoop-trunk\hadoop-trunk\hadoop-yarn-project\hadoop-yarn\hadoop-yarn-server\hadoop-yarn-server-common\src\main\java\org\apache\hadoop\yarn\server\api\protocolrecords\RegisterDistributedSchedulingAMResponse.java,72,17,0,2,0,19
hadoop-trunk\hadoop-trunk\hadoop-tools\hadoop-azure\src\main\java\org\apache\hadoop\fs\azure\SecureWasbRemoteCallHelper.java,177,19,5,3,0,27
hadoop-trunk\hadoop-trunk\hadoop-mapreduce-project\hadoop-mapreduce-client\hadoop-mapreduce-client-core\src\main\java\org\apache\hadoop\mapred\JVMId.java,0,66,13,1,0,80
hadoop-trunk\hadoop-trunk\hadoop-yarn-project\hadoop-yarn\hadoop-yarn-server\hadoop-yarn-server-resourcemanager\src\main\java\org\apache\hadoop\yarn\server\resourcemanager\scheduler\fair\converter\weightconversion\CapacityConverter.java,0,2,0,2,0,4
hadoop-trunk\hadoop-trunk\hadoop-yarn-project\hadoop-yarn\hadoop-yarn-server\hadoop-yarn-server-resourcemanager\src\test\java\org\apache\hadoop\yarn\server\resourcemanager\TestRMHATimelineCollectors.java,96,7,0,2,0,9
hadoop-trunk\hadoop-trunk\hadoop-mapreduce-project\hadoop-mapreduce-client\hadoop-mapreduce-client-core\src\main\java\org\apache\hadoop\mapred\pipes\OutputHandler.java,0,58,4,2,0,64
hadoop-trunk\hadoop-trunk\hadoop-yarn-project\hadoop-yarn\hadoop-yarn-server\hadoop-yarn-server-resourcemanager\src\main\java\org\apache\hadoop\yarn\server\resourcemanager\scheduler\fair\allocation\QueueProperties.java,257,120,0,3,0,123
hadoop-trunk\hadoop-trunk\hadoop-hdfs-project\hadoop-hdfs\src\test\java\org\apache\hadoop\hdfs\server\namenode\ha\TestStandbyInProgressTail.java,436,72,18,4,0,94
hadoop-trunk\hadoop-trunk\hadoop-tools\hadoop-aws\src\main\java\org\apache\hadoop\fs\s3a\AWSRedirectException.java,13,2,0,1,0,3
hadoop-trunk\hadoop-trunk\hadoop-yarn-project\hadoop-yarn\hadoop-yarn-api\src\main\java\org\apache\hadoop\yarn\api\records\FinalApplicationStatus.java,0,1,0,1,0,2
hadoop-trunk\hadoop-trunk\hadoop-hdfs-project\hadoop-hdfs\src\test\java\org\apache\hadoop\hdfs\TestPipelines.java,124,31,7,6,0,44
hadoop-trunk\hadoop-trunk\hadoop-hdfs-project\hadoop-hdfs\src\test\java\org\apache\hadoop\hdfs\TestSnapshotCommands.java,238,67,4,20,0,91
hadoop-trunk\hadoop-trunk\hadoop-hdfs-project\hadoop-hdfs\src\main\java\org\apache\hadoop\hdfs\server\namenode\FSImageFormat.java,1316,262,32,26,0,320
hadoop-trunk\hadoop-trunk\hadoop-common-project\hadoop-auth\src\main\java\org\apache\hadoop\security\authentication\util\SignerSecretProvider.java,35,3,1,1,0,5
hadoop-trunk\hadoop-trunk\hadoop-hdfs-project\hadoop-hdfs-client\src\main\java\org\apache\hadoop\hdfs\shortcircuit\ShortCircuitShm.java,592,120,26,3,0,149
hadoop-trunk\hadoop-trunk\hadoop-yarn-project\hadoop-yarn\hadoop-yarn-server\hadoop-yarn-server-common\src\main\java\org\apache\hadoop\yarn\server\federation\store\exception\FederationStateStoreException.java,25,9,0,1,0,10
hadoop-trunk\hadoop-trunk\hadoop-yarn-project\hadoop-yarn\hadoop-yarn-server\hadoop-yarn-server-resourcemanager\src\main\java\org\apache\hadoop\yarn\server\resourcemanager\placement\SpecifiedPlacementRule.java,39,7,0,4,0,11
hadoop-trunk\hadoop-trunk\hadoop-common-project\hadoop-common\src\main\java\org\apache\hadoop\security\AnnotatedSecurityInfo.java,15,7,0,1,0,8
hadoop-trunk\hadoop-trunk\hadoop-yarn-project\hadoop-yarn\hadoop-yarn-server\hadoop-yarn-server-resourcemanager\src\main\java\org\apache\hadoop\yarn\server\resourcemanager\scheduler\capacity\queuemanagement\package-info.java,0,1,0,2,0,3
hadoop-trunk\hadoop-trunk\hadoop-hdfs-project\hadoop-hdfs-httpfs\src\test\java\org\apache\hadoop\lib\lang\TestXException.java,38,2,0,1,0,3
hadoop-trunk\hadoop-trunk\hadoop-hdfs-project\hadoop-hdfs\src\test\java\org\apache\hadoop\hdfs\server\namenode\TestSaveNamespace.java,737,139,30,2,0,171
hadoop-trunk\hadoop-trunk\hadoop-hdfs-project\hadoop-hdfs-rbf\src\main\java\org\apache\hadoop\hdfs\server\federation\router\NamenodeHeartbeatService.java,431,46,15,5,0,66
hadoop-trunk\hadoop-trunk\hadoop-tools\hadoop-sls\src\test\java\org\apache\hadoop\yarn\sls\scheduler\TestTaskRunner.java,221,85,2,1,0,88
hadoop-trunk\hadoop-trunk\hadoop-yarn-project\hadoop-yarn\hadoop-yarn-server\hadoop-yarn-server-resourcemanager\src\test\java\org\apache\hadoop\yarn\server\resourcemanager\scheduler\capacity\policy\TestPriorityUtilizationQueueOrderingPolicy.java,218,253,2,8,0,263
hadoop-trunk\hadoop-trunk\hadoop-yarn-project\hadoop-yarn\hadoop-yarn-server\hadoop-yarn-server-router\src\main\java\org\apache\hadoop\yarn\server\router\webapp\AppsBlock.java,91,8,1,1,0,10
hadoop-trunk\hadoop-trunk\hadoop-yarn-project\hadoop-yarn\hadoop-yarn-server\hadoop-yarn-server-resourcemanager\src\test\java\org\apache\hadoop\yarn\server\resourcemanager\nodelabels\TestNodeAttributesManager.java,320,45,0,1,0,46
hadoop-trunk\hadoop-trunk\hadoop-common-project\hadoop-common\src\main\java\org\apache\hadoop\crypto\CryptoOutputStream.java,0,137,2,3,0,142
hadoop-trunk\hadoop-trunk\hadoop-hdfs-project\hadoop-hdfs\src\main\java\org\apache\hadoop\hdfs\server\datanode\fsdataset\impl\ReplicaMap.java,0,70,1,14,0,85
hadoop-trunk\hadoop-trunk\hadoop-tools\hadoop-gridmix\src\test\java\org\apache\hadoop\mapred\gridmix\TestLoadJob.java,50,11,4,1,0,16
hadoop-trunk\hadoop-trunk\hadoop-yarn-project\hadoop-yarn\hadoop-yarn-server\hadoop-yarn-server-nodemanager\src\main\java\org\apache\hadoop\yarn\server\nodemanager\containermanager\linux\resources\fpga\FpgaResourceHandlerImpl.java,212,53,12,21,0,86
hadoop-trunk\hadoop-trunk\hadoop-yarn-project\hadoop-yarn\hadoop-yarn-server\hadoop-yarn-server-nodemanager\src\main\java\org\apache\hadoop\yarn\server\nodemanager\containermanager\localizer\event\ResourceLocalizedEvent.java,22,12,0,3,0,15
hadoop-trunk\hadoop-trunk\hadoop-yarn-project\hadoop-yarn\hadoop-yarn-server\hadoop-yarn-server-resourcemanager\src\main\java\org\apache\hadoop\yarn\server\resourcemanager\scheduler\common\fica\FiCaSchedulerApp.java,1151,162,19,43,0,224
hadoop-trunk\hadoop-trunk\hadoop-common-project\hadoop-common\src\test\java\org\apache\hadoop\fs\contract\sftp\SFTPContract.java,72,14,2,1,0,17
hadoop-trunk\hadoop-trunk\hadoop-yarn-project\hadoop-yarn\hadoop-yarn-server\hadoop-yarn-server-resourcemanager\src\test\java\org\apache\hadoop\yarn\server\resourcemanager\scheduler\capacity\TestUtils.java,415,216,24,22,0,262
hadoop-trunk\hadoop-trunk\hadoop-tools\hadoop-distcp\src\main\java\org\apache\hadoop\tools\mapred\lib\DynamicInputChunkContext.java,0,17,8,2,0,27
hadoop-trunk\hadoop-trunk\hadoop-yarn-project\hadoop-yarn\hadoop-yarn-server\hadoop-yarn-server-common\src\main\java\org\apache\hadoop\yarn\server\federation\store\records\impl\pb\UpdateApplicationHomeSubClusterResponsePBImpl.java,0,13,17,3,0,33
hadoop-trunk\hadoop-trunk\hadoop-mapreduce-project\hadoop-mapreduce-client\hadoop-mapreduce-client-jobclient\src\test\java\org\apache\hadoop\mapreduce\TimelineEntityConverterV1.java,0,20,6,1,0,27
hadoop-trunk\hadoop-trunk\hadoop-common-project\hadoop-common\src\main\java\org\apache\hadoop\metrics2\annotation\Metrics.java,0,2,0,1,0,3
hadoop-trunk\hadoop-trunk\hadoop-hdfs-project\hadoop-hdfs\src\main\java\org\apache\hadoop\hdfs\qjournal\client\SegmentRecoveryComparator.java,0,20,11,8,0,39
hadoop-trunk\hadoop-trunk\hadoop-tools\hadoop-aws\src\main\java\org\apache\hadoop\fs\s3a\auth\delegation\SessionTokenIdentifier.java,106,3,0,2,0,5
hadoop-trunk\hadoop-trunk\hadoop-client-modules\hadoop-client-integration-tests\src\test\java\org\apache\hadoop\example\ITUseHadoopCodecs.java,98,24,45,10,0,79
hadoop-trunk\hadoop-trunk\hadoop-tools\hadoop-rumen\src\main\java\org\apache\hadoop\tools\rumen\MapAttempt20LineHistoryEventEmitter.java,64,15,8,1,0,24
hadoop-trunk\hadoop-trunk\hadoop-yarn-project\hadoop-yarn\hadoop-yarn-common\src\main\java\org\apache\hadoop\yarn\sharedcache\SharedCacheChecksum.java,0,2,1,1,0,4
hadoop-trunk\hadoop-trunk\hadoop-yarn-project\hadoop-yarn\hadoop-yarn-server\hadoop-yarn-server-nodemanager\src\test\java\org\apache\hadoop\yarn\server\nodemanager\TestNetworkTagMappingJsonManager.java,259,23,8,5,0,36
hadoop-trunk\hadoop-trunk\hadoop-yarn-project\hadoop-yarn\hadoop-yarn-api\src\main\java\org\apache\hadoop\yarn\api\protocolrecords\GetClusterMetricsResponse.java,25,6,0,1,0,7
hadoop-trunk\hadoop-trunk\hadoop-yarn-project\hadoop-yarn\hadoop-yarn-server\hadoop-yarn-server-common\src\main\java\org\apache\hadoop\yarn\server\timeline\security\TimelineAuthenticationFilterInitializer.java,59,8,0,8,0,16
hadoop-trunk\hadoop-trunk\hadoop-common-project\hadoop-common\src\main\java\org\apache\hadoop\crypto\key\KeyProviderDelegationTokenExtension.java,0,31,4,1,0,36
hadoop-trunk\hadoop-trunk\hadoop-tools\hadoop-azure\src\main\java\org\apache\hadoop\fs\azure\WasbFsck.java,158,22,2,3,0,27
hadoop-trunk\hadoop-trunk\hadoop-hdfs-project\hadoop-hdfs\src\test\java\org\apache\hadoop\security\TestPermissionSymlinks.java,382,65,23,2,0,90
hadoop-trunk\hadoop-trunk\hadoop-common-project\hadoop-common\src\main\java\org\apache\hadoop\security\protocolPB\RefreshUserMappingsProtocolServerSideTranslatorPB.java,44,23,16,7,0,46
hadoop-trunk\hadoop-trunk\hadoop-yarn-project\hadoop-yarn\hadoop-yarn-server\hadoop-yarn-server-nodemanager\src\main\java\org\apache\hadoop\yarn\server\nodemanager\containermanager\monitor\ChangeMonitoringContainerResourceEvent.java,15,9,0,2,0,11
hadoop-trunk\hadoop-trunk\hadoop-tools\hadoop-distcp\src\main\java\org\apache\hadoop\tools\mapred\RetriableDirectoryCreateCommand.java,42,7,2,2,0,11
hadoop-trunk\hadoop-trunk\hadoop-mapreduce-project\hadoop-mapreduce-client\hadoop-mapreduce-client-common\src\main\java\org\apache\hadoop\mapreduce\v2\api\protocolrecords\package-info.java,0,1,0,1,0,2
hadoop-trunk\hadoop-trunk\hadoop-mapreduce-project\hadoop-mapreduce-client\hadoop-mapreduce-client-common\src\main\java\org\apache\hadoop\mapreduce\v2\api\records\Phase.java,0,6,0,1,0,7
hadoop-trunk\hadoop-trunk\hadoop-common-project\hadoop-common\src\test\java\org\apache\hadoop\fs\FileSystemTestWrapper.java,0,94,3,3,0,100
hadoop-trunk\hadoop-trunk\hadoop-mapreduce-project\hadoop-mapreduce-client\hadoop-mapreduce-client-common\src\main\java\org\apache\hadoop\mapreduce\v2\api\protocolrecords\GetDelegationTokenRequest.java,0,3,0,1,0,4
hadoop-trunk\hadoop-trunk\hadoop-yarn-project\hadoop-yarn\hadoop-yarn-server\hadoop-yarn-server-resourcemanager\src\main\java\org\apache\hadoop\yarn\server\resourcemanager\monitor\capacity\AbstractPreemptableResourceCalculator.java,286,40,4,2,0,46
hadoop-trunk\hadoop-trunk\hadoop-hdfs-project\hadoop-hdfs-rbf\src\main\java\org\apache\hadoop\hdfs\server\federation\store\StateStoreConnectionMonitorService.java,38,6,0,1,0,7
hadoop-trunk\hadoop-trunk\hadoop-tools\hadoop-rumen\src\main\java\org\apache\hadoop\tools\rumen\ReduceTaskAttemptInfo.java,68,33,1,1,0,35
hadoop-trunk\hadoop-trunk\hadoop-tools\hadoop-aws\src\main\java\org\apache\hadoop\fs\s3a\tools\MarkerTool.java,0,54,2,5,0,61
hadoop-trunk\hadoop-trunk\hadoop-hdfs-project\hadoop-hdfs\src\main\java\org\apache\hadoop\hdfs\net\DFSNetworkTopology.java,355,26,5,1,0,32
hadoop-trunk\hadoop-trunk\hadoop-yarn-project\hadoop-yarn\hadoop-yarn-common\src\test\java\org\apache\hadoop\yarn\webapp\view\TestHtmlPage.java,40,10,2,1,0,13
hadoop-trunk\hadoop-trunk\hadoop-hdfs-project\hadoop-hdfs\src\test\java\org\apache\hadoop\hdfs\server\namenode\TestGetBlockLocations.java,111,18,1,2,0,21
hadoop-trunk\hadoop-trunk\hadoop-mapreduce-project\hadoop-mapreduce-client\hadoop-mapreduce-client-core\src\test\java\org\apache\hadoop\mapreduce\lib\db\DriverForTest.java,75,26,10,1,0,37
hadoop-trunk\hadoop-trunk\hadoop-yarn-project\hadoop-yarn\hadoop-yarn-server\hadoop-yarn-server-nodemanager\src\main\java\org\apache\hadoop\yarn\server\nodemanager\containermanager\application\Application.java,0,8,0,2,0,10
hadoop-trunk\hadoop-trunk\hadoop-hdfs-project\hadoop-hdfs\src\main\java\org\apache\hadoop\hdfs\server\namenode\snapshot\SnapshotDiffListingInfo.java,0,34,1,3,0,38
hadoop-trunk\hadoop-trunk\hadoop-yarn-project\hadoop-yarn\hadoop-yarn-server\hadoop-yarn-server-common\src\test\java\org\apache\hadoop\yarn\server\federation\policies\TestFederationPolicyInitializationContextValidator.java,102,18,5,8,0,31
hadoop-trunk\hadoop-trunk\hadoop-common-project\hadoop-common\src\main\java\org\apache\hadoop\fs\statistics\BufferedIOStatisticsOutputStream.java,0,2,0,2,0,4
hadoop-trunk\hadoop-trunk\hadoop-tools\hadoop-rumen\src\main\java\org\apache\hadoop\tools\rumen\JsonObjectMapperParser.java,0,18,1,1,0,20
hadoop-trunk\hadoop-trunk\hadoop-common-project\hadoop-common\src\main\java\org\apache\hadoop\fs\DUHelper.java,70,32,9,2,0,43
hadoop-trunk\hadoop-trunk\hadoop-tools\hadoop-azure\src\main\java\org\apache\hadoop\fs\azurebfs\oauth2\UserPasswordTokenProvider.java,28,12,0,4,0,16
hadoop-trunk\hadoop-trunk\hadoop-yarn-project\hadoop-yarn\hadoop-yarn-server\hadoop-yarn-server-common\src\main\java\org\apache\hadoop\yarn\server\federation\policies\router\UniformRandomRouterPolicy.java,63,6,0,4,0,10
hadoop-trunk\hadoop-trunk\hadoop-mapreduce-project\hadoop-mapreduce-client\hadoop-mapreduce-client-hs\src\main\java\org\apache\hadoop\mapreduce\v2\hs\protocolPB\HSAdminRefreshProtocolServerSideTranslatorPB.java,76,32,1,9,0,42
hadoop-trunk\hadoop-trunk\hadoop-mapreduce-project\hadoop-mapreduce-client\hadoop-mapreduce-client-jobclient\src\test\java\org\apache\hadoop\mapreduce\security\CredentialsTestJob.java,97,62,0,3,0,65
hadoop-trunk\hadoop-trunk\hadoop-yarn-project\hadoop-yarn\hadoop-yarn-server\hadoop-yarn-server-resourcemanager\src\test\java\org\apache\hadoop\yarn\server\resourcemanager\placement\TestFairQueuePlacementUtils.java,101,4,0,7,0,11
hadoop-trunk\hadoop-trunk\hadoop-common-project\hadoop-common\src\test\java\org\apache\hadoop\ha\TestShellCommandFencer.java,212,34,4,1,0,39
hadoop-trunk\hadoop-trunk\hadoop-common-project\hadoop-common\src\main\java\org\apache\hadoop\io\retry\FailoverProxyProvider.java,0,22,4,1,0,27
hadoop-trunk\hadoop-trunk\hadoop-tools\hadoop-azure\src\main\java\org\apache\hadoop\fs\azure\NativeAzureFileSystemHelper.java,0,14,5,5,0,24
hadoop-trunk\hadoop-trunk\hadoop-hdfs-project\hadoop-hdfs\src\main\java\org\apache\hadoop\hdfs\server\blockmanagement\CacheReplicationMonitor.java,759,62,34,4,0,100
hadoop-trunk\hadoop-trunk\hadoop-mapreduce-project\hadoop-mapreduce-client\hadoop-mapreduce-client-jobclient\src\test\java\org\apache\hadoop\mapred\join\TestTupleWritable.java,345,152,9,13,0,174
hadoop-trunk\hadoop-trunk\hadoop-hdfs-project\hadoop-hdfs\src\test\java\org\apache\hadoop\hdfs\TestDeprecatedKeys.java,31,10,7,2,0,19
hadoop-trunk\hadoop-trunk\hadoop-mapreduce-project\hadoop-mapreduce-client\hadoop-mapreduce-client-app\src\main\java\org\apache\hadoop\mapreduce\v2\app\job\event\TaskAttemptFailEvent.java,32,7,0,1,0,8
hadoop-trunk\hadoop-trunk\hadoop-tools\hadoop-resourceestimator\src\main\java\org\apache\hadoop\resourceestimator\common\serialization\RLESparseResourceAllocationSerDe.java,32,4,1,2,0,7
hadoop-trunk\hadoop-trunk\hadoop-common-project\hadoop-common\src\main\java\org\apache\hadoop\ha\HAServiceStatus.java,34,19,0,1,0,20
hadoop-trunk\hadoop-trunk\hadoop-hdfs-project\hadoop-hdfs-httpfs\src\test\java\org\apache\hadoop\lib\util\TestCheck.java,117,27,0,1,0,28
hadoop-trunk\hadoop-trunk\hadoop-tools\hadoop-aws\src\test\java\org\apache\hadoop\fs\s3a\auth\delegation\ILoadTestRoleCredentials.java,13,2,0,2,0,4
hadoop-trunk\hadoop-trunk\hadoop-yarn-project\hadoop-yarn\hadoop-yarn-server\hadoop-yarn-server-resourcemanager\src\main\java\org\apache\hadoop\yarn\server\resourcemanager\rmapp\attempt\event\RMAppAttemptContainerFinishedEvent.java,21,14,0,3,0,17
hadoop-trunk\hadoop-trunk\hadoop-common-project\hadoop-common\src\test\java\org\apache\hadoop\io\erasurecode\rawcoder\TestXORRawCoderInteroperable2.java,12,1,0,1,0,2
hadoop-trunk\hadoop-trunk\hadoop-hdfs-project\hadoop-hdfs-client\src\test\java\org\apache\hadoop\hdfs\protocol\TestExtendedBlock.java,53,14,1,1,0,16
hadoop-trunk\hadoop-trunk\hadoop-common-project\hadoop-common\src\main\java\org\apache\hadoop\fs\Syncable.java,0,1,0,1,0,2
hadoop-trunk\hadoop-trunk\hadoop-common-project\hadoop-common\src\main\java\org\apache\hadoop\metrics2\MetricsTag.java,58,16,0,1,0,17
hadoop-trunk\hadoop-trunk\hadoop-yarn-project\hadoop-yarn\hadoop-yarn-server\hadoop-yarn-server-common\src\main\java\org\apache\hadoop\yarn\server\security\BaseContainerTokenSecretManager.java,89,26,3,1,0,30
hadoop-trunk\hadoop-trunk\hadoop-common-project\hadoop-common\src\main\java\org\apache\hadoop\ipc\ObserverRetryOnActiveException.java,7,2,0,1,0,3
hadoop-trunk\hadoop-trunk\hadoop-yarn-project\hadoop-yarn\hadoop-yarn-server\hadoop-yarn-server-nodemanager\src\test\java\org\apache\hadoop\yarn\server\nodemanager\nodelabels\TestConfigurationNodeAttributesProvider.java,215,27,5,1,0,33
hadoop-trunk\hadoop-trunk\hadoop-yarn-project\hadoop-yarn\hadoop-yarn-common\src\main\java\org\apache\hadoop\yarn\api\resource\PlacementConstraintTransformations.java,161,31,0,7,0,38
hadoop-trunk\hadoop-trunk\hadoop-yarn-project\hadoop-yarn\hadoop-yarn-server\hadoop-yarn-server-applicationhistoryservice\src\test\java\org\apache\hadoop\yarn\server\applicationhistoryservice\TestMemoryApplicationHistoryStore.java,171,12,0,4,0,16
hadoop-trunk\hadoop-trunk\hadoop-hdfs-project\hadoop-hdfs\src\test\java\org\apache\hadoop\hdfs\server\datanode\TestBPOfferService.java,1193,159,16,7,0,182
hadoop-trunk\hadoop-trunk\hadoop-yarn-project\hadoop-yarn\hadoop-yarn-server\hadoop-yarn-server-applicationhistoryservice\src\main\java\org\apache\hadoop\yarn\server\timeline\KeyValueBasedTimelineStore.java,0,60,2,7,0,69
hadoop-trunk\hadoop-trunk\hadoop-tools\hadoop-streaming\src\test\java\org\apache\hadoop\streaming\DelayEchoApp.java,32,11,4,2,0,17
hadoop-trunk\hadoop-trunk\hadoop-common-project\hadoop-common\src\test\java\org\apache\hadoop\ipc\TestFairCallQueue.java,749,198,17,13,0,228
hadoop-trunk\hadoop-trunk\hadoop-tools\hadoop-streaming\src\main\java\org\apache\hadoop\record\Buffer.java,0,71,8,2,0,81
hadoop-trunk\hadoop-trunk\hadoop-common-project\hadoop-common\src\main\java\org\apache\hadoop\net\package-info.java,0,0,0,1,0,1
hadoop-trunk\hadoop-trunk\hadoop-common-project\hadoop-common\src\main\java\org\apache\hadoop\io\serializer\SerializationFactory.java,65,16,4,2,0,22
hadoop-trunk\hadoop-trunk\hadoop-hdfs-project\hadoop-hdfs-client\src\main\java\org\apache\hadoop\hdfs\util\IOUtilsClient.java,45,14,3,1,0,18
hadoop-trunk\hadoop-trunk\hadoop-yarn-project\hadoop-yarn\hadoop-yarn-server\hadoop-yarn-server-nodemanager\src\test\java\org\apache\hadoop\yarn\server\nodemanager\containermanager\TestContainerManager.java,0,238,221,34,0,493
hadoop-trunk\hadoop-trunk\hadoop-yarn-project\hadoop-yarn\hadoop-yarn-api\src\main\java\org\apache\hadoop\yarn\api\records\ReservationACL.java,0,1,0,1,0,2
hadoop-trunk\hadoop-trunk\hadoop-common-project\hadoop-common\src\main\java\org\apache\hadoop\fs\statistics\BufferedIOStatisticsInputStream.java,0,0,0,2,0,2
hadoop-trunk\hadoop-trunk\hadoop-yarn-project\hadoop-yarn\hadoop-yarn-api\src\main\java\org\apache\hadoop\yarn\server\api\SCMAdminProtocol.java,0,6,1,5,0,12
hadoop-trunk\hadoop-trunk\hadoop-yarn-project\hadoop-yarn\hadoop-yarn-api\src\main\java\org\apache\hadoop\yarn\api\protocolrecords\ReservationSubmissionResponse.java,12,1,1,1,0,3
hadoop-trunk\hadoop-trunk\hadoop-tools\hadoop-aws\src\main\java\org\apache\hadoop\fs\s3a\tools\package-info.java,0,0,0,1,0,1
hadoop-trunk\hadoop-trunk\hadoop-hdfs-project\hadoop-hdfs\src\test\java\org\apache\hadoop\hdfs\TestDFSUtil.java,1025,324,41,27,0,392
hadoop-trunk\hadoop-trunk\hadoop-hdfs-project\hadoop-hdfs\src\main\java\org\apache\hadoop\hdfs\server\datanode\fsdataset\ReplicaOutputStreams.java,128,45,2,1,0,48
hadoop-trunk\hadoop-trunk\hadoop-hdfs-project\hadoop-hdfs\src\test\java\org\apache\hadoop\hdfs\server\namenode\snapshot\TestSnapshotDiffReport.java,1538,112,26,2,0,140
hadoop-trunk\hadoop-trunk\hadoop-hdfs-project\hadoop-hdfs\src\main\java\org\apache\hadoop\hdfs\server\datanode\ReplicaWaitingToBeRecovered.java,88,32,3,1,0,36
hadoop-trunk\hadoop-trunk\hadoop-mapreduce-project\hadoop-mapreduce-client\hadoop-mapreduce-client-app\src\test\java\org\apache\hadoop\mapreduce\v2\app\job\impl\TestJobImpl.java,1218,194,14,8,0,216
hadoop-trunk\hadoop-trunk\hadoop-yarn-project\hadoop-yarn\hadoop-yarn-applications\hadoop-yarn-services\hadoop-yarn-services-core\src\test\java\org\apache\hadoop\yarn\service\providers\TestAbstractClientProvider.java,125,12,10,1,0,23
hadoop-trunk\hadoop-trunk\hadoop-mapreduce-project\hadoop-mapreduce-examples\src\main\java\org\apache\hadoop\examples\terasort\TeraInputFormat.java,0,87,5,5,0,97
hadoop-trunk\hadoop-trunk\hadoop-yarn-project\hadoop-yarn\hadoop-yarn-api\src\main\java\org\apache\hadoop\yarn\api\protocolrecords\GetLabelsToNodesRequest.java,18,6,0,1,0,7
hadoop-trunk\hadoop-trunk\hadoop-yarn-project\hadoop-yarn\hadoop-yarn-server\hadoop-yarn-server-common\src\test\java\org\apache\hadoop\yarn\TestYSCRPCFactories.java,88,21,5,7,0,33
hadoop-trunk\hadoop-trunk\hadoop-yarn-project\hadoop-yarn\hadoop-yarn-client\src\main\java\org\apache\hadoop\yarn\client\api\async\AMRMClientAsync.java,0,109,5,3,0,117
hadoop-trunk\hadoop-trunk\hadoop-mapreduce-project\hadoop-mapreduce-client\hadoop-mapreduce-client-core\src\main\java\org\apache\hadoop\mapreduce\JobStatus.java,0,266,4,2,0,272
hadoop-trunk\hadoop-trunk\hadoop-yarn-project\hadoop-yarn\hadoop-yarn-common\src\test\java\org\apache\hadoop\yarn\event\TestAsyncDispatcher.java,0,72,52,1,0,125
hadoop-trunk\hadoop-trunk\hadoop-yarn-project\hadoop-yarn\hadoop-yarn-server\hadoop-yarn-server-nodemanager\src\main\java\org\apache\hadoop\yarn\server\nodemanager\containermanager\localizer\LocalResourceRequest.java,0,69,4,2,0,75
hadoop-trunk\hadoop-trunk\hadoop-tools\hadoop-resourceestimator\src\test\java\org\apache\hadoop\resourceestimator\translator\impl\TestRmParser.java,192,22,0,6,0,28
hadoop-trunk\hadoop-trunk\hadoop-mapreduce-project\hadoop-mapreduce-client\hadoop-mapreduce-client-nativetask\src\test\java\org\apache\hadoop\mapred\nativetask\combinertest\OldAPICombinerTest.java,85,22,1,12,0,35
hadoop-trunk\hadoop-trunk\hadoop-mapreduce-project\hadoop-mapreduce-examples\src\main\java\org\apache\hadoop\examples\AggregateWordCount.java,40,13,1,1,0,15
hadoop-trunk\hadoop-trunk\hadoop-mapreduce-project\hadoop-mapreduce-client\hadoop-mapreduce-client-core\src\main\java\org\apache\hadoop\mapred\JobInProgress.java,22,14,0,1,0,15
hadoop-trunk\hadoop-trunk\hadoop-mapreduce-project\hadoop-mapreduce-client\hadoop-mapreduce-client-core\src\main\java\org\apache\hadoop\mapreduce\jobhistory\TaskFailedEvent.java,145,80,28,1,0,109
hadoop-trunk\hadoop-trunk\hadoop-common-project\hadoop-common\src\test\java\org\apache\hadoop\fs\contract\AbstractContractMkdirTest.java,152,14,0,2,0,16
hadoop-trunk\hadoop-trunk\hadoop-common-project\hadoop-common\src\test\java\org\apache\hadoop\io\TestDefaultStringifier.java,90,37,5,8,0,50
hadoop-trunk\hadoop-trunk\hadoop-yarn-project\hadoop-yarn\hadoop-yarn-applications\hadoop-yarn-services\hadoop-yarn-services-core\src\test\java\org\apache\hadoop\yarn\service\MockRunningServiceContext.java,146,17,5,2,0,24
hadoop-trunk\hadoop-trunk\hadoop-yarn-project\hadoop-yarn\hadoop-yarn-server\hadoop-yarn-server-nodemanager\src\main\java\org\apache\hadoop\yarn\server\nodemanager\containermanager\linux\runtime\DefaultLinuxContainerRuntime.java,245,33,7,12,0,52
hadoop-trunk\hadoop-trunk\hadoop-yarn-project\hadoop-yarn\hadoop-yarn-server\hadoop-yarn-server-nodemanager\src\main\java\org\apache\hadoop\yarn\server\nodemanager\containermanager\localizer\event\ResourceReleaseEvent.java,16,8,0,3,0,11
hadoop-trunk\hadoop-trunk\hadoop-tools\hadoop-rumen\src\main\java\org\apache\hadoop\tools\rumen\datatypes\util\JobPropertyParser.java,0,5,1,1,0,7
hadoop-trunk\hadoop-trunk\hadoop-mapreduce-project\hadoop-mapreduce-client\hadoop-mapreduce-client-core\src\main\java\org\apache\hadoop\mapreduce\lib\output\committer\manifest\stages\StageEventCallbacks.java,0,0,0,1,0,1
hadoop-trunk\hadoop-trunk\hadoop-tools\hadoop-aws\src\test\java\org\apache\hadoop\fs\s3a\tools\ITestMarkerToolRootOperations.java,34,6,2,1,0,9
hadoop-trunk\hadoop-trunk\hadoop-yarn-project\hadoop-yarn\hadoop-yarn-server\hadoop-yarn-server-common\src\test\java\org\apache\hadoop\yarn\server\federation\utils\FederationPoliciesTestUtil.java,0,54,5,4,0,63
hadoop-trunk\hadoop-trunk\hadoop-common-project\hadoop-common\src\main\java\org\apache\hadoop\io\erasurecode\ErasureCodeConstants.java,0,16,0,1,0,17
hadoop-trunk\hadoop-trunk\hadoop-common-project\hadoop-common\src\main\java\org\apache\hadoop\io\erasurecode\ErasureCodeNative.java,0,7,1,1,0,9
hadoop-trunk\hadoop-trunk\hadoop-mapreduce-project\hadoop-mapreduce-client\hadoop-mapreduce-client-app\src\main\java\org\apache\hadoop\mapreduce\v2\app\job\TaskStateInternal.java,0,7,0,1,0,8
hadoop-trunk\hadoop-trunk\hadoop-yarn-project\hadoop-yarn\hadoop-yarn-common\src\main\java\org\apache\hadoop\yarn\server\api\protocolrecords\impl\pb\RefreshNodesResponsePBImpl.java,42,20,18,3,0,41
hadoop-trunk\hadoop-trunk\hadoop-hdfs-project\hadoop-hdfs\src\test\java\org\apache\hadoop\hdfs\server\datanode\fsdataset\impl\TestLazyPersistReplicaRecovery.java,70,9,2,1,0,12
hadoop-trunk\hadoop-trunk\hadoop-hdfs-project\hadoop-hdfs-client\src\main\java\org\apache\hadoop\hdfs\client\impl\package-info.java,0,0,0,1,0,1
hadoop-trunk\hadoop-trunk\hadoop-mapreduce-project\hadoop-mapreduce-client\hadoop-mapreduce-client-jobclient\src\test\java\org\apache\hadoop\mapreduce\security\TestMRCredentials.java,91,42,4,3,0,49
hadoop-trunk\hadoop-trunk\hadoop-yarn-project\hadoop-yarn\hadoop-yarn-applications\hadoop-yarn-applications-distributedshell\src\test\java\org\apache\hadoop\yarn\applications\distributedshell\ContainerLaunchFailAppMaster.java,58,10,2,1,0,13
hadoop-trunk\hadoop-trunk\hadoop-yarn-project\hadoop-yarn\hadoop-yarn-common\src\main\java\org\apache\hadoop\yarn\metrics\package-info.java,0,1,0,1,0,2
hadoop-trunk\hadoop-trunk\hadoop-common-project\hadoop-common\src\test\java\org\apache\hadoop\security\TestHttpCrossOriginFilterInitializer.java,32,1,0,1,0,2
hadoop-trunk\hadoop-trunk\hadoop-tools\hadoop-aws\src\test\java\org\apache\hadoop\fs\s3a\auth\delegation\ITestRoleDelegationTokens.java,81,6,1,6,0,13
hadoop-trunk\hadoop-trunk\hadoop-yarn-project\hadoop-yarn\hadoop-yarn-server\hadoop-yarn-server-resourcemanager\src\main\java\org\apache\hadoop\yarn\server\resourcemanager\scheduler\capacity\policy\QueueOrderingPolicy.java,0,3,0,2,0,5
hadoop-trunk\hadoop-trunk\hadoop-yarn-project\hadoop-yarn\hadoop-yarn-common\src\main\java\org\apache\hadoop\yarn\api\records\impl\pb\QueueStatisticsPBImpl.java,265,71,113,1,0,185
hadoop-trunk\hadoop-trunk\hadoop-yarn-project\hadoop-yarn\hadoop-yarn-common\src\main\java\org\apache\hadoop\yarn\webapp\dao\QueueConfigInfo.java,24,12,3,1,0,16
hadoop-trunk\hadoop-trunk\hadoop-hdfs-project\hadoop-hdfs\src\main\java\org\apache\hadoop\hdfs\server\common\sps\BlockMovementStatus.java,0,4,1,1,0,6
hadoop-trunk\hadoop-trunk\hadoop-hdfs-project\hadoop-hdfs\src\test\java\org\apache\hadoop\hdfs\util\TestDiff.java,302,82,6,3,0,91
hadoop-trunk\hadoop-trunk\hadoop-yarn-project\hadoop-yarn\hadoop-yarn-server\hadoop-yarn-server-timelineservice\src\main\java\org\apache\hadoop\yarn\server\timelineservice\storage\FileSystemTimelineReaderImpl.java,0,69,7,5,0,81
hadoop-trunk\hadoop-trunk\hadoop-yarn-project\hadoop-yarn\hadoop-yarn-common\src\main\java\org\apache\hadoop\yarn\logaggregation\LogToolUtils.java,0,46,7,1,0,54
hadoop-trunk\hadoop-trunk\hadoop-tools\hadoop-aws\src\test\java\org\apache\hadoop\fs\s3a\S3ATestConstants.java,0,7,39,4,0,50
hadoop-trunk\hadoop-trunk\hadoop-hdfs-project\hadoop-hdfs-rbf\src\main\java\org\apache\hadoop\hdfs\server\federation\router\RouterClientMetrics.java,608,159,2,1,0,162
hadoop-trunk\hadoop-trunk\hadoop-hdfs-project\hadoop-hdfs-client\src\test\java\org\apache\hadoop\fs\TestXAttr.java,65,17,9,1,0,27
hadoop-trunk\hadoop-trunk\hadoop-hdfs-project\hadoop-hdfs-client\src\main\java\org\apache\hadoop\hdfs\client\impl\DfsClientConf.java,916,122,6,56,0,184
hadoop-trunk\hadoop-trunk\hadoop-hdfs-project\hadoop-hdfs\src\test\java\org\apache\hadoop\hdfs\server\namenode\ha\TestBootstrapStandby.java,314,34,6,6,0,46
hadoop-trunk\hadoop-trunk\hadoop-yarn-project\hadoop-yarn\hadoop-yarn-server\hadoop-yarn-server-common\src\main\java\org\apache\hadoop\yarn\server\api\protocolrecords\impl\pb\ReportNewCollectorInfoRequestPBImpl.java,115,18,38,5,0,61
hadoop-trunk\hadoop-trunk\hadoop-tools\hadoop-aws\src\main\java\org\apache\hadoop\fs\s3a\auth\MarshalledCredentialProvider.java,50,7,0,2,0,9
hadoop-trunk\hadoop-trunk\hadoop-hdfs-project\hadoop-hdfs-rbf\src\test\java\org\apache\hadoop\hdfs\server\federation\router\TestSafeMode.java,49,3,0,3,0,6
hadoop-trunk\hadoop-trunk\hadoop-mapreduce-project\hadoop-mapreduce-client\hadoop-mapreduce-client-common\src\main\java\org\apache\hadoop\mapreduce\v2\api\records\TaskState.java,0,6,0,1,0,7
hadoop-trunk\hadoop-trunk\hadoop-yarn-project\hadoop-yarn\hadoop-yarn-common\src\test\java\org\apache\hadoop\yarn\logaggregation\filecontroller\TestLogAggregationFileControllerFactory.java,246,48,3,6,0,57
hadoop-trunk\hadoop-trunk\hadoop-common-project\hadoop-common\src\main\java\org\apache\hadoop\fs\impl\FileSystemMultipartUploader.java,193,36,4,1,0,41
hadoop-trunk\hadoop-trunk\hadoop-hdfs-project\hadoop-hdfs\src\test\java\org\apache\hadoop\hdfs\TestDFSInputStreamBlockLocations.java,194,41,4,12,0,57
hadoop-trunk\hadoop-trunk\hadoop-yarn-project\hadoop-yarn\hadoop-yarn-server\hadoop-yarn-server-common\src\main\java\org\apache\hadoop\yarn\server\webapp\dao\AppAttemptInfo.java,74,44,0,1,0,45
hadoop-trunk\hadoop-trunk\hadoop-yarn-project\hadoop-yarn\hadoop-yarn-server\hadoop-yarn-server-common\src\main\java\org\apache\hadoop\yarn\server\api\protocolrecords\NMContainerStatus.java,142,52,3,1,0,56
hadoop-trunk\hadoop-trunk\hadoop-hdfs-project\hadoop-hdfs\src\main\java\org\apache\hadoop\hdfs\server\datanode\fsdataset\AvailableSpaceVolumeChoosingPolicy.java,0,85,5,21,0,111
hadoop-trunk\hadoop-trunk\hadoop-hdfs-project\hadoop-hdfs\src\test\java\org\apache\hadoop\hdfs\server\datanode\TestLargeBlockReport.java,99,21,11,4,0,36
hadoop-trunk\hadoop-trunk\hadoop-yarn-project\hadoop-yarn\hadoop-yarn-server\hadoop-yarn-server-common\src\test\java\org\apache\hadoop\yarn\server\federation\store\metrics\TestFederationStateStoreClientMetrics.java,119,16,0,1,0,17
hadoop-trunk\hadoop-trunk\hadoop-yarn-project\hadoop-yarn\hadoop-yarn-server\hadoop-yarn-server-resourcemanager\src\main\java\org\apache\hadoop\yarn\server\resourcemanager\RMCriticalThreadUncaughtExceptionHandler.java,0,9,2,1,0,12
hadoop-trunk\hadoop-trunk\hadoop-tools\hadoop-aws\src\main\java\org\apache\hadoop\fs\s3a\auth\delegation\FullCredentialsTokenIdentifier.java,22,3,0,1,0,4
hadoop-trunk\hadoop-trunk\hadoop-yarn-project\hadoop-yarn\hadoop-yarn-client\src\main\java\org\apache\hadoop\yarn\client\cli\package-info.java,0,1,0,1,0,2
hadoop-trunk\hadoop-trunk\hadoop-common-project\hadoop-common\src\test\java\org\apache\hadoop\io\TestSetFile.java,159,64,23,5,0,92
hadoop-trunk\hadoop-trunk\hadoop-yarn-project\hadoop-yarn\hadoop-yarn-server\hadoop-yarn-server-nodemanager\src\main\java\org\apache\hadoop\yarn\server\nodemanager\containermanager\linux\resources\DefaultOOMHandler.java,296,35,5,8,0,48
hadoop-trunk\hadoop-trunk\hadoop-common-project\hadoop-common\src\main\java\org\apache\hadoop\fs\HarFileSystem.java,1261,391,17,9,0,417
hadoop-trunk\hadoop-trunk\hadoop-yarn-project\hadoop-yarn\hadoop-yarn-common\src\main\java\org\apache\hadoop\yarn\logaggregation\ExtendedLogMetaRequest.java,261,103,0,1,0,104
hadoop-trunk\hadoop-trunk\hadoop-yarn-project\hadoop-yarn\hadoop-yarn-server\hadoop-yarn-server-applicationhistoryservice\src\test\java\org\apache\hadoop\yarn\server\applicationhistoryservice\TestFileSystemApplicationHistoryStore.java,260,36,1,4,0,41
hadoop-trunk\hadoop-trunk\hadoop-mapreduce-project\hadoop-mapreduce-client\hadoop-mapreduce-client-app\src\main\java\org\apache\hadoop\mapreduce\v2\app\speculate\DataStatistics.java,82,21,3,1,0,25
hadoop-trunk\hadoop-trunk\hadoop-tools\hadoop-gridmix\src\main\java\org\apache\hadoop\mapred\gridmix\FilePool.java,0,71,10,1,0,82
hadoop-trunk\hadoop-trunk\hadoop-yarn-project\hadoop-yarn\hadoop-yarn-server\hadoop-yarn-server-applicationhistoryservice\src\main\java\org\apache\hadoop\yarn\server\timeline\GenericObjectMapper.java,99,50,2,1,0,53
hadoop-trunk\hadoop-trunk\hadoop-common-project\hadoop-common\src\test\java\org\apache\hadoop\service\launcher\testservices\FailInInitService.java,16,4,0,1,0,5
hadoop-trunk\hadoop-trunk\hadoop-hdfs-project\hadoop-hdfs\src\main\java\org\apache\hadoop\hdfs\server\datanode\checker\TimeoutFuture.java,0,15,2,2,0,19
hadoop-trunk\hadoop-trunk\hadoop-yarn-project\hadoop-yarn\hadoop-yarn-server\hadoop-yarn-server-resourcemanager\src\main\java\org\apache\hadoop\yarn\server\resourcemanager\scheduler\AbstractResourceUsage.java,174,55,5,2,0,62
hadoop-trunk\hadoop-trunk\hadoop-common-project\hadoop-common\src\test\java\org\apache\hadoop\fs\viewfs\TestViewFsOverloadSchemeListStatus.java,119,8,4,1,0,13
hadoop-trunk\hadoop-trunk\hadoop-mapreduce-project\hadoop-mapreduce-client\hadoop-mapreduce-client-jobclient\src\test\java\org\apache\hadoop\mapred\TestMRCJCJobClient.java,63,18,4,1,0,23
hadoop-trunk\hadoop-trunk\hadoop-mapreduce-project\hadoop-mapreduce-client\hadoop-mapreduce-client-nativetask\src\main\java\org\apache\hadoop\mapred\nativetask\Command.java,36,23,0,1,0,24
hadoop-trunk\hadoop-trunk\hadoop-yarn-project\hadoop-yarn\hadoop-yarn-applications\hadoop-yarn-services\hadoop-yarn-services-core\src\main\java\org\apache\hadoop\yarn\service\api\records\Component.java,510,205,3,17,0,225
hadoop-trunk\hadoop-trunk\hadoop-yarn-project\hadoop-yarn\hadoop-yarn-common\src\main\java\org\apache\hadoop\yarn\api\protocolrecords\impl\pb\GetResourceProfileResponsePBImpl.java,0,16,28,3,0,47
hadoop-trunk\hadoop-trunk\hadoop-yarn-project\hadoop-yarn\hadoop-yarn-api\src\main\java\org\apache\hadoop\yarn\api\records\timelineservice\TimelineEvent.java,95,38,6,1,0,45
hadoop-trunk\hadoop-trunk\hadoop-tools\hadoop-gridmix\src\main\java\org\apache\hadoop\mapred\gridmix\GridmixJob.java,0,181,7,3,0,191
hadoop-trunk\hadoop-trunk\hadoop-yarn-project\hadoop-yarn\hadoop-yarn-common\src\main\java\org\apache\hadoop\yarn\client\api\package-info.java,0,0,0,1,0,1
hadoop-trunk\hadoop-trunk\hadoop-hdfs-project\hadoop-hdfs\src\main\java\org\apache\hadoop\hdfs\server\blockmanagement\PendingRecoveryBlocks.java,0,19,1,1,0,21
hadoop-trunk\hadoop-trunk\hadoop-yarn-project\hadoop-yarn\hadoop-yarn-server\hadoop-yarn-server-nodemanager\src\test\java\org\apache\hadoop\yarn\server\nodemanager\containermanager\linux\runtime\docker\TestDockerInspectCommand.java,46,8,0,2,0,10
hadoop-trunk\hadoop-trunk\hadoop-common-project\hadoop-common\src\test\java\org\apache\hadoop\util\Crc32PerformanceTest.java,404,82,4,1,0,87
hadoop-trunk\hadoop-trunk\hadoop-yarn-project\hadoop-yarn\hadoop-yarn-server\hadoop-yarn-server-nodemanager\src\test\java\org\apache\hadoop\yarn\server\nodemanager\TestNMAuditLogger.java,201,35,11,1,0,47
hadoop-trunk\hadoop-trunk\hadoop-common-project\hadoop-common\src\main\java\org\apache\hadoop\ha\HAServiceProtocol.java,0,46,9,2,0,57
hadoop-trunk\hadoop-trunk\hadoop-hdfs-project\hadoop-hdfs-rbf\src\main\java\org\apache\hadoop\hdfs\server\federation\store\protocol\UpdateMountTableEntryRequest.java,22,6,0,2,0,8
hadoop-trunk\hadoop-trunk\hadoop-tools\hadoop-aws\src\main\java\org\apache\hadoop\fs\s3a\select\SelectBinding.java,378,16,3,1,0,20
hadoop-trunk\hadoop-trunk\hadoop-tools\hadoop-azure\src\main\java\org\apache\hadoop\fs\azurebfs\AbfsConfiguration.java,1016,353,11,117,0,481
hadoop-trunk\hadoop-trunk\hadoop-common-project\hadoop-common\src\test\java\org\apache\hadoop\service\BreakableStateChangeListener.java,0,35,4,1,0,40
hadoop-trunk\hadoop-trunk\hadoop-common-project\hadoop-common\src\main\java\org\apache\hadoop\metrics2\lib\MetricsSourceBuilder.java,122,47,8,4,0,59
hadoop-trunk\hadoop-trunk\hadoop-tools\hadoop-azure\src\main\java\org\apache\hadoop\fs\azurebfs\contracts\exceptions\TimeoutException.java,0,3,0,1,0,4
hadoop-trunk\hadoop-trunk\hadoop-yarn-project\hadoop-yarn\hadoop-yarn-common\src\main\java\org\apache\hadoop\yarn\security\client\ClientRMSecurityInfo.java,49,6,0,1,0,7
hadoop-trunk\hadoop-trunk\hadoop-hdfs-project\hadoop-hdfs-nfs\src\test\java\org\apache\hadoop\hdfs\nfs\nfs3\TestDFSClientCache.java,78,5,8,2,0,15
hadoop-trunk\hadoop-trunk\hadoop-mapreduce-project\hadoop-mapreduce-client\hadoop-mapreduce-client-jobclient\src\test\java\org\apache\hadoop\mapreduce\util\TestMRAsyncDiskService.java,314,49,6,2,0,57
hadoop-trunk\hadoop-trunk\hadoop-mapreduce-project\hadoop-mapreduce-client\hadoop-mapreduce-client-jobclient\src\test\java\org\apache\hadoop\mapreduce\LargeSorter.java,215,100,6,2,0,108
hadoop-trunk\hadoop-trunk\hadoop-tools\hadoop-aws\src\test\java\org\apache\hadoop\fs\s3a\auth\delegation\MiniKerberizedHadoopCluster.java,318,51,18,6,0,75
hadoop-trunk\hadoop-trunk\hadoop-yarn-project\hadoop-yarn\hadoop-yarn-server\hadoop-yarn-server-applicationhistoryservice\src\main\java\org\apache\hadoop\yarn\server\applicationhistoryservice\FileSystemApplicationHistoryStore.java,0,94,64,25,0,183
hadoop-trunk\hadoop-trunk\hadoop-common-project\hadoop-common\src\main\java\org\apache\hadoop\metrics2\filter\GlobFilter.java,8,2,0,1,0,3
hadoop-trunk\hadoop-trunk\hadoop-hdfs-project\hadoop-hdfs\src\test\java\org\apache\hadoop\hdfs\TestWriteBlockGetsBlockLengthHint.java,71,20,4,2,0,26
hadoop-trunk\hadoop-trunk\hadoop-hdfs-project\hadoop-hdfs\src\test\java\org\apache\hadoop\hdfs\TestReadWhileWriting.java,0,65,4,8,0,77
hadoop-trunk\hadoop-trunk\hadoop-common-project\hadoop-common\src\main\java\org\apache\hadoop\io\retry\LossyRetryInvocationHandler.java,38,18,0,2,0,20
hadoop-trunk\hadoop-trunk\hadoop-yarn-project\hadoop-yarn\hadoop-yarn-common\src\main\java\org\apache\hadoop\yarn\api\protocolrecords\impl\pb\ContainerUpdateRequestPBImpl.java,131,20,42,3,0,65
hadoop-trunk\hadoop-trunk\hadoop-yarn-project\hadoop-yarn\hadoop-yarn-server\hadoop-yarn-server-applicationhistoryservice\src\test\java\org\apache\hadoop\yarn\server\timeline\webapp\TestTimelineWebServicesWithSSL.java,98,18,2,2,0,22
hadoop-trunk\hadoop-trunk\hadoop-yarn-project\hadoop-yarn\hadoop-yarn-common\src\main\java\org\apache\hadoop\yarn\api\records\impl\pb\ResourceUtilizationPBImpl.java,104,26,36,2,0,64
hadoop-trunk\hadoop-trunk\hadoop-common-project\hadoop-nfs\src\test\java\org\apache\hadoop\oncrpc\TestRpcCall.java,35,21,0,4,0,25
hadoop-trunk\hadoop-trunk\hadoop-yarn-project\hadoop-yarn\hadoop-yarn-common\src\main\java\org\apache\hadoop\yarn\client\AutoRefreshNoHARMFailoverProxyProvider.java,0,14,1,1,0,16
hadoop-trunk\hadoop-trunk\hadoop-yarn-project\hadoop-yarn\hadoop-yarn-server\hadoop-yarn-server-resourcemanager\src\test\java\org\apache\hadoop\yarn\server\resourcemanager\scheduler\capacity\conf\TestMutableCSConfigurationProvider.java,214,17,2,4,0,23
hadoop-trunk\hadoop-trunk\hadoop-tools\hadoop-rumen\src\main\java\org\apache\hadoop\tools\rumen\JobTraceReader.java,24,5,0,1,0,6
hadoop-trunk\hadoop-trunk\hadoop-yarn-project\hadoop-yarn\hadoop-yarn-server\hadoop-yarn-server-resourcemanager\src\test\java\org\apache\hadoop\yarn\server\resourcemanager\scheduler\TestSchedulerApplicationAttempt.java,388,119,3,10,0,132
hadoop-trunk\hadoop-trunk\hadoop-hdfs-project\hadoop-hdfs\src\test\java\org\apache\hadoop\fs\permission\TestStickyBit.java,465,90,38,4,0,132
hadoop-trunk\hadoop-trunk\hadoop-hdfs-project\hadoop-hdfs\src\main\java\org\apache\hadoop\hdfs\server\blockmanagement\HostConfigManager.java,48,0,0,1,0,1
hadoop-trunk\hadoop-trunk\hadoop-hdfs-project\hadoop-hdfs\src\test\java\org\apache\hadoop\hdfs\TestReplication.java,0,214,20,19,0,253
hadoop-trunk\hadoop-trunk\hadoop-common-project\hadoop-nfs\src\main\java\org\apache\hadoop\nfs\nfs3\request\REMOVE3Request.java,26,13,0,1,0,14
hadoop-trunk\hadoop-trunk\hadoop-yarn-project\hadoop-yarn\hadoop-yarn-api\src\main\java\org\apache\hadoop\yarn\api\records\RejectionReason.java,0,0,0,1,0,1
hadoop-trunk\hadoop-trunk\hadoop-hdfs-project\hadoop-hdfs\src\test\java\org\apache\hadoop\hdfs\TestListFilesInFileContext.java,157,40,0,1,0,41
hadoop-trunk\hadoop-trunk\hadoop-mapreduce-project\hadoop-mapreduce-client\hadoop-mapreduce-client-jobclient\src\test\java\org\apache\hadoop\mapreduce\TestMRIntermediateDataEncryption.java,445,58,9,1,0,68
hadoop-trunk\hadoop-trunk\hadoop-yarn-project\hadoop-yarn\hadoop-yarn-applications\hadoop-yarn-services\hadoop-yarn-services-core\src\test\java\org\apache\hadoop\yarn\service\providers\TestProviderFactory.java,37,6,0,5,0,11
hadoop-trunk\hadoop-trunk\hadoop-yarn-project\hadoop-yarn\hadoop-yarn-server\hadoop-yarn-server-timelineservice-hbase-tests\src\test\java\org\apache\hadoop\yarn\server\timelineservice\reader\DummyTimelineReaderMetrics.java,15,5,2,2,0,9
hadoop-trunk\hadoop-trunk\hadoop-common-project\hadoop-common\src\main\java\org\apache\hadoop\security\token\delegation\AbstractDelegationTokenIdentifier.java,0,95,4,4,0,103
hadoop-trunk\hadoop-trunk\hadoop-mapreduce-project\hadoop-mapreduce-client\hadoop-mapreduce-client-hs\src\test\java\org\apache\hadoop\mapreduce\v2\hs\webapp\TestHsWebServicesTasks.java,723,78,4,3,0,85
hadoop-trunk\hadoop-trunk\hadoop-common-project\hadoop-common\src\test\java\org\apache\hadoop\io\TestText.java,446,161,19,3,0,183
hadoop-trunk\hadoop-trunk\hadoop-yarn-project\hadoop-yarn\hadoop-yarn-server\hadoop-yarn-server-timelineservice-documentstore\src\main\java\org\apache\hadoop\yarn\server\timelineservice\documentstore\lib\package-info.java,0,0,0,1,0,1
hadoop-trunk\hadoop-trunk\hadoop-common-project\hadoop-common\src\main\java\org\apache\hadoop\util\functional\InvocationRaisingIOE.java,0,0,0,1,0,1
hadoop-trunk\hadoop-trunk\hadoop-mapreduce-project\hadoop-mapreduce-client\hadoop-mapreduce-client-common\src\main\java\org\apache\hadoop\mapreduce\v2\api\records\impl\pb\TaskIdPBImpl.java,114,33,51,1,0,85
hadoop-trunk\hadoop-trunk\hadoop-yarn-project\hadoop-yarn\hadoop-yarn-server\hadoop-yarn-server-resourcemanager\src\test\java\org\apache\hadoop\yarn\server\resourcemanager\TestRM.java,670,123,12,12,0,147
hadoop-trunk\hadoop-trunk\hadoop-hdfs-project\hadoop-hdfs-client\src\main\java\org\apache\hadoop\hdfs\server\protocol\DatanodeStorageReport.java,19,13,0,1,0,14
hadoop-trunk\hadoop-trunk\hadoop-yarn-project\hadoop-yarn\hadoop-yarn-server\hadoop-yarn-server-nodemanager\src\main\java\org\apache\hadoop\yarn\server\nodemanager\containermanager\localizer\event\LocalizerEvent.java,15,9,0,3,0,12
hadoop-trunk\hadoop-trunk\hadoop-common-project\hadoop-common\src\test\java\org\apache\hadoop\cli\util\ComparatorBase.java,15,3,2,1,0,6
hadoop-trunk\hadoop-trunk\hadoop-mapreduce-project\hadoop-mapreduce-client\hadoop-mapreduce-client-jobclient\src\test\java\org\apache\hadoop\mapred\UtilsForTests.java,0,328,37,4,0,369
hadoop-trunk\hadoop-trunk\hadoop-hdfs-project\hadoop-hdfs\src\test\java\org\apache\hadoop\hdfs\server\datanode\TestIncrementalBrVariations.java,208,47,7,10,0,64
hadoop-trunk\hadoop-trunk\hadoop-common-project\hadoop-common\src\main\java\org\apache\hadoop\fs\Trash.java,114,25,0,1,0,26
hadoop-trunk\hadoop-trunk\hadoop-hdfs-project\hadoop-hdfs\src\test\java\org\apache\hadoop\hdfs\TestViewDistributedFileSystemWithMountLinks.java,121,10,0,4,0,14
hadoop-trunk\hadoop-trunk\hadoop-hdfs-project\hadoop-hdfs-rbf\src\main\java\org\apache\hadoop\hdfs\server\federation\store\protocol\impl\pb\UpdateNamenodeRegistrationResponsePBImpl.java,0,11,28,4,0,43
hadoop-trunk\hadoop-trunk\hadoop-common-project\hadoop-common\src\main\java\org\apache\hadoop\security\alias\LocalJavaKeyStoreProvider.java,40,8,0,1,0,9
hadoop-trunk\hadoop-trunk\hadoop-hdfs-project\hadoop-hdfs\src\main\java\org\apache\hadoop\hdfs\server\datanode\checker\package-info.java,0,0,0,1,0,1
hadoop-trunk\hadoop-trunk\hadoop-yarn-project\hadoop-yarn\hadoop-yarn-common\src\test\java\org\apache\hadoop\yarn\client\api\impl\TestTimelineClientForATS1_5.java,223,34,5,3,0,42
hadoop-trunk\hadoop-trunk\hadoop-tools\hadoop-azure\src\main\java\org\apache\hadoop\fs\azurebfs\diagnostics\IntegerConfigurationBasicValidator.java,50,18,3,9,0,30
hadoop-trunk\hadoop-trunk\hadoop-hdfs-project\hadoop-hdfs\src\test\java\org\apache\hadoop\hdfs\server\namenode\snapshot\TestFileContextSnapshot.java,89,18,3,1,0,22
hadoop-trunk\hadoop-trunk\hadoop-yarn-project\hadoop-yarn\hadoop-yarn-server\hadoop-yarn-server-resourcemanager\src\main\java\org\apache\hadoop\yarn\server\resourcemanager\metrics\TimelineServiceV2Publisher.java,466,66,12,6,0,84
hadoop-trunk\hadoop-trunk\hadoop-mapreduce-project\hadoop-mapreduce-client\hadoop-mapreduce-client-nativetask\src\test\java\org\apache\hadoop\mapred\nativetask\kvtest\KVJob.java,71,35,5,6,0,46
hadoop-trunk\hadoop-trunk\hadoop-hdfs-project\hadoop-hdfs-client\src\main\java\org\apache\hadoop\hdfs\web\resources\GetOpParam.java,0,37,1,1,0,39
hadoop-trunk\hadoop-trunk\hadoop-tools\hadoop-gridmix\src\test\java\org\apache\hadoop\mapred\gridmix\TestRandomTextDataGenerator.java,54,21,11,1,0,33
hadoop-trunk\hadoop-trunk\hadoop-common-project\hadoop-common\src\test\java\org\apache\hadoop\ipc\TestDecayRpcScheduler.java,495,121,9,7,0,137
hadoop-trunk\hadoop-trunk\hadoop-yarn-project\hadoop-yarn\hadoop-yarn-server\hadoop-yarn-server-nodemanager\src\main\java\org\apache\hadoop\yarn\server\nodemanager\containermanager\resourceplugin\NodeResourceUpdaterPlugin.java,12,2,0,3,0,5
hadoop-trunk\hadoop-trunk\hadoop-common-project\hadoop-common\src\main\java\org\apache\hadoop\fs\impl\FutureIOSupport.java,0,3,2,1,0,6
hadoop-trunk\hadoop-trunk\hadoop-common-project\hadoop-common\src\main\java\org\apache\hadoop\util\Time.java,0,7,1,1,0,9
hadoop-trunk\hadoop-trunk\hadoop-yarn-project\hadoop-yarn\hadoop-yarn-server\hadoop-yarn-server-resourcemanager\src\main\java\org\apache\hadoop\yarn\server\resourcemanager\scheduler\constraint\api\SchedulingRequestWithPlacementAttempt.java,28,15,0,1,0,16
hadoop-trunk\hadoop-trunk\hadoop-common-project\hadoop-nfs\src\main\java\org\apache\hadoop\nfs\nfs3\response\READDIR3Response.java,128,59,2,1,0,62
hadoop-trunk\hadoop-trunk\hadoop-yarn-project\hadoop-yarn\hadoop-yarn-common\src\main\java\org\apache\hadoop\yarn\api\protocolrecords\impl\pb\GetApplicationReportRequestPBImpl.java,99,39,37,6,0,82
hadoop-trunk\hadoop-trunk\hadoop-mapreduce-project\hadoop-mapreduce-client\hadoop-mapreduce-client-core\src\main\java\org\apache\hadoop\mapreduce\lib\db\DateSplitter.java,134,33,10,13,0,56
hadoop-trunk\hadoop-trunk\hadoop-common-project\hadoop-common\src\test\java\org\apache\hadoop\crypto\TestCryptoStreamsForLocalFS.java,96,69,13,1,0,83
hadoop-trunk\hadoop-trunk\hadoop-hdfs-project\hadoop-hdfs-client\src\main\java\org\apache\hadoop\hdfs\client\impl\BlockReaderLocal.java,0,86,29,2,0,117
hadoop-trunk\hadoop-trunk\hadoop-common-project\hadoop-common\src\test\java\org\apache\hadoop\http\HttpServerFunctionalTest.java,240,61,3,5,0,69
hadoop-trunk\hadoop-trunk\hadoop-mapreduce-project\hadoop-mapreduce-client\hadoop-mapreduce-client-core\src\test\java\org\apache\hadoop\mapreduce\lib\output\committer\manifest\TestJobThroughManifestCommitter.java,0,41,25,31,0,97
hadoop-trunk\hadoop-trunk\hadoop-tools\hadoop-sls\src\test\java\org\apache\hadoop\yarn\sls\web\TestSLSWebApp.java,91,24,0,4,0,28
hadoop-trunk\hadoop-trunk\hadoop-hdfs-project\hadoop-hdfs\src\test\java\org\apache\hadoop\hdfs\server\namenode\TestEditsDoubleBuffer.java,111,13,3,1,0,17
hadoop-trunk\hadoop-trunk\hadoop-mapreduce-project\hadoop-mapreduce-client\hadoop-mapreduce-client-app\src\main\java\org\apache\hadoop\mapreduce\v2\app\webapp\AttemptsPage.java,44,7,1,1,0,9
hadoop-trunk\hadoop-trunk\hadoop-tools\hadoop-azure\src\test\java\org\apache\hadoop\fs\azurebfs\ITestAbfsDurationTrackers.java,70,5,2,5,0,12
hadoop-trunk\hadoop-trunk\hadoop-tools\hadoop-azure\src\main\java\org\apache\hadoop\fs\azurebfs\services\AbfsClientThrottlingAnalyzer.java,0,39,6,4,0,49
hadoop-trunk\hadoop-trunk\hadoop-mapreduce-project\hadoop-mapreduce-client\hadoop-mapreduce-client-core\src\test\java\org\apache\hadoop\mapreduce\lib\output\committer\manifest\TestCleanupStage.java,108,8,0,7,0,15
hadoop-trunk\hadoop-trunk\hadoop-mapreduce-project\hadoop-mapreduce-client\hadoop-mapreduce-client-core\src\main\java\org\apache\hadoop\mapreduce\lib\map\RegexMapper.java,0,17,0,1,0,18
hadoop-trunk\hadoop-trunk\hadoop-yarn-project\hadoop-yarn\hadoop-yarn-common\src\main\java\org\apache\hadoop\yarn\api\protocolrecords\impl\pb\GetNodesToLabelsRequestPBImpl.java,45,17,18,1,0,36
hadoop-trunk\hadoop-trunk\hadoop-yarn-project\hadoop-yarn\hadoop-yarn-server\hadoop-yarn-server-resourcemanager\src\main\java\org\apache\hadoop\yarn\server\resourcemanager\webapp\dao\NodeAttributeInfo.java,35,15,0,1,0,16
hadoop-trunk\hadoop-trunk\hadoop-hdfs-project\hadoop-hdfs\src\test\java\org\apache\hadoop\hdfs\TestDatanodeDeath.java,0,152,8,11,0,171
hadoop-trunk\hadoop-trunk\hadoop-mapreduce-project\hadoop-mapreduce-client\hadoop-mapreduce-client-core\src\main\java\org\apache\hadoop\mapreduce\JobResourceUploader.java,0,132,9,1,0,142
hadoop-trunk\hadoop-trunk\hadoop-hdfs-project\hadoop-hdfs\src\main\java\org\apache\hadoop\hdfs\server\namenode\snapshot\SnapshotFSImageFormat.java,324,87,3,5,0,95
hadoop-trunk\hadoop-trunk\hadoop-yarn-project\hadoop-yarn\hadoop-yarn-server\hadoop-yarn-server-resourcemanager\src\main\java\org\apache\hadoop\yarn\server\resourcemanager\volume\csi\lifecycle\package-info.java,0,1,0,1,0,2
hadoop-trunk\hadoop-trunk\hadoop-tools\hadoop-aws\src\main\java\org\apache\hadoop\fs\s3a\auth\delegation\RoleTokenIdentifier.java,23,2,0,1,0,3
hadoop-trunk\hadoop-trunk\hadoop-yarn-project\hadoop-yarn\hadoop-yarn-server\hadoop-yarn-server-resourcemanager\src\main\java\org\apache\hadoop\yarn\server\resourcemanager\reservation\planning\StageExecutionIntervalByDemand.java,106,16,4,4,0,24
hadoop-trunk\hadoop-trunk\hadoop-tools\hadoop-azure\src\main\java\org\apache\hadoop\fs\azure\metrics\AzureFileSystemMetricsSystem.java,0,16,0,1,0,17
hadoop-trunk\hadoop-trunk\hadoop-common-project\hadoop-common\src\test\java\org\apache\hadoop\fs\ftp\TestFTPFileSystem.java,185,33,7,1,0,41
hadoop-trunk\hadoop-trunk\hadoop-common-project\hadoop-common\src\test\java\org\apache\hadoop\io\file\tfile\TestTFileSplit.java,0,63,10,3,0,76
hadoop-trunk\hadoop-trunk\hadoop-mapreduce-project\hadoop-mapreduce-client\hadoop-mapreduce-client-core\src\main\java\org\apache\hadoop\mapreduce\InputSplit.java,35,15,7,1,0,23
hadoop-trunk\hadoop-trunk\hadoop-tools\hadoop-distcp\src\main\java\org\apache\hadoop\tools\mapred\lib\DynamicInputChunk.java,0,24,6,1,0,31
hadoop-trunk\hadoop-trunk\hadoop-tools\hadoop-rumen\src\main\java\org\apache\hadoop\tools\rumen\JobStory.java,0,28,13,1,0,42
hadoop-trunk\hadoop-trunk\hadoop-yarn-project\hadoop-yarn\hadoop-yarn-server\hadoop-yarn-server-router\src\main\java\org\apache\hadoop\yarn\server\router\clientrm\AbstractClientRequestInterceptor.java,0,11,0,1,0,12
hadoop-trunk\hadoop-trunk\hadoop-hdfs-project\hadoop-hdfs-rbf\src\test\java\org\apache\hadoop\hdfs\server\federation\metrics\TestRouterClientMetrics.java,0,16,3,1,0,20
hadoop-trunk\hadoop-trunk\hadoop-mapreduce-project\hadoop-mapreduce-client\hadoop-mapreduce-client-hs\src\test\java\org\apache\hadoop\mapreduce\v2\hs\TestJobHistoryEntities.java,210,104,5,8,0,117
hadoop-trunk\hadoop-trunk\hadoop-yarn-project\hadoop-yarn\hadoop-yarn-common\src\main\java\org\apache\hadoop\yarn\webapp\YarnJacksonJaxbJsonProvider.java,22,7,1,1,0,9
hadoop-trunk\hadoop-trunk\hadoop-common-project\hadoop-common\src\test\java\org\apache\hadoop\io\erasurecode\rawcoder\TestRSRawCoderInteroperable1.java,13,1,0,1,0,2
hadoop-trunk\hadoop-trunk\hadoop-yarn-project\hadoop-yarn\hadoop-yarn-server\hadoop-yarn-server-resourcemanager\src\main\java\org\apache\hadoop\yarn\server\resourcemanager\ahs\WritingContainerStartEvent.java,27,13,1,2,0,16
hadoop-trunk\hadoop-trunk\hadoop-hdfs-project\hadoop-hdfs-rbf\src\main\java\org\apache\hadoop\hdfs\server\federation\router\ConnectionManager.java,447,15,7,1,0,23
hadoop-trunk\hadoop-trunk\hadoop-yarn-project\hadoop-yarn\hadoop-yarn-server\hadoop-yarn-server-resourcemanager\src\main\java\org\apache\hadoop\yarn\server\resourcemanager\RMAuditLogger.java,650,379,5,13,0,397
hadoop-trunk\hadoop-trunk\hadoop-hdfs-project\hadoop-hdfs\src\main\java\org\apache\hadoop\hdfs\qjournal\server\Journal.java,1145,320,65,21,0,406
hadoop-trunk\hadoop-trunk\hadoop-yarn-project\hadoop-yarn\hadoop-yarn-server\hadoop-yarn-server-common\src\main\java\org\apache\hadoop\yarn\server\api\records\AppCollectorData.java,97,30,6,1,0,37
hadoop-trunk\hadoop-trunk\hadoop-hdfs-project\hadoop-hdfs\src\test\java\org\apache\hadoop\hdfs\server\datanode\TestBlockPoolSliceStorage.java,121,43,3,2,0,48
hadoop-trunk\hadoop-trunk\hadoop-yarn-project\hadoop-yarn\hadoop-yarn-server\hadoop-yarn-server-nodemanager\src\main\java\org\apache\hadoop\yarn\server\nodemanager\containermanager\scheduler\ContainerSchedulerEvent.java,24,4,0,1,0,5
hadoop-trunk\hadoop-trunk\hadoop-hdfs-project\hadoop-hdfs\src\test\java\org\apache\hadoop\hdfs\server\namenode\TestEditLogRace.java,0,159,34,13,0,206
hadoop-trunk\hadoop-trunk\hadoop-hdfs-project\hadoop-hdfs\src\test\java\org\apache\hadoop\hdfs\tools\TestDelegationTokenFetcher.java,113,12,2,4,0,18
hadoop-trunk\hadoop-trunk\hadoop-hdfs-project\hadoop-hdfs-client\src\main\java\org\apache\hadoop\hdfs\security\token\block\BlockTokenIdentifier.java,334,90,10,2,0,102
hadoop-trunk\hadoop-trunk\hadoop-hdfs-project\hadoop-hdfs\src\main\java\org\apache\hadoop\hdfs\server\diskbalancer\connectors\package-info.java,0,1,0,1,0,2
hadoop-trunk\hadoop-trunk\hadoop-common-project\hadoop-common\src\main\java\org\apache\hadoop\io\erasurecode\rawcoder\EncodingState.java,19,7,0,1,0,8
hadoop-trunk\hadoop-trunk\hadoop-yarn-project\hadoop-yarn\hadoop-yarn-common\src\main\java\org\apache\hadoop\yarn\api\impl\pb\client\ApplicationClientProtocolPBClientImpl.java,530,87,95,115,0,297
hadoop-trunk\hadoop-trunk\hadoop-hdfs-project\hadoop-hdfs\src\main\java\org\apache\hadoop\hdfs\server\blockmanagement\SequentialBlockIdGenerator.java,40,10,0,1,0,11
hadoop-trunk\hadoop-trunk\hadoop-yarn-project\hadoop-yarn\hadoop-yarn-server\hadoop-yarn-server-resourcemanager\src\test\java\org\apache\hadoop\yarn\server\resourcemanager\placement\csmappingrule\TestMappingRuleActions.java,153,18,2,1,0,21
hadoop-trunk\hadoop-trunk\hadoop-yarn-project\hadoop-yarn\hadoop-yarn-api\src\main\java\org\apache\hadoop\yarn\api\records\LocalizationState.java,0,3,0,1,0,4
hadoop-trunk\hadoop-trunk\hadoop-common-project\hadoop-registry\src\main\java\org\apache\hadoop\registry\server\dns\RecordCreatorFactory.java,0,34,8,1,0,43
hadoop-trunk\hadoop-trunk\hadoop-yarn-project\hadoop-yarn\hadoop-yarn-api\src\main\java\org\apache\hadoop\yarn\api\records\ApplicationSubmissionContext.java,551,148,0,6,0,154
hadoop-trunk\hadoop-trunk\hadoop-common-project\hadoop-common\src\test\java\org\apache\hadoop\fs\contract\ftp\TestFTPContractOpen.java,9,2,0,1,0,3
hadoop-trunk\hadoop-trunk\hadoop-hdfs-project\hadoop-hdfs\src\test\java\org\apache\hadoop\hdfs\TestInjectionForSimulatedStorage.java,0,84,8,12,0,104
hadoop-trunk\hadoop-trunk\hadoop-hdfs-project\hadoop-hdfs-rbf\src\test\java\org\apache\hadoop\hdfs\server\federation\router\TestRouterMultiRack.java,91,12,2,4,0,18
hadoop-trunk\hadoop-trunk\hadoop-hdfs-project\hadoop-hdfs\src\main\java\org\apache\hadoop\hdfs\server\datanode\DirectoryScanner.java,717,98,0,11,0,109
hadoop-trunk\hadoop-trunk\hadoop-common-project\hadoop-common\src\main\java\org\apache\hadoop\security\authentication\server\package-info.java,0,0,0,1,0,1
hadoop-trunk\hadoop-trunk\hadoop-common-project\hadoop-common\src\test\java\org\apache\hadoop\fs\TestAfsCheckPath.java,148,60,2,2,0,64
hadoop-trunk\hadoop-trunk\hadoop-hdfs-project\hadoop-hdfs\src\main\java\org\apache\hadoop\hdfs\server\diskbalancer\planner\MoveStep.java,226,36,1,1,0,38
hadoop-trunk\hadoop-trunk\hadoop-tools\hadoop-azure\src\test\java\org\apache\hadoop\fs\azurebfs\services\ITestAbfsUnbuffer.java,51,15,1,3,0,19
hadoop-trunk\hadoop-trunk\hadoop-common-project\hadoop-common\src\main\java\org\apache\hadoop\service\ServiceStateException.java,94,16,0,1,0,17
hadoop-trunk\hadoop-trunk\hadoop-hdfs-project\hadoop-hdfs\src\test\java\org\apache\hadoop\hdfs\qjournal\server\TestJournaledEditsCache.java,208,109,3,1,0,113
hadoop-trunk\hadoop-trunk\hadoop-yarn-project\hadoop-yarn\hadoop-yarn-server\hadoop-yarn-server-resourcemanager\src\test\java\org\apache\hadoop\yarn\server\resourcemanager\TestKillApplicationWithRMHA.java,227,40,0,4,0,44
hadoop-trunk\hadoop-trunk\hadoop-hdfs-project\hadoop-hdfs-client\src\main\java\org\apache\hadoop\hdfs\server\protocol\DataNodeUsageReportUtil.java,0,25,0,1,0,26
hadoop-trunk\hadoop-trunk\hadoop-mapreduce-project\hadoop-mapreduce-client\hadoop-mapreduce-client-core\src\test\java\org\apache\hadoop\mapreduce\TestJobResourceUploaderWithSharedCache.java,302,45,4,1,0,50
hadoop-trunk\hadoop-trunk\hadoop-yarn-project\hadoop-yarn\hadoop-yarn-api\src\main\java\org\apache\hadoop\yarn\api\records\ContainerStatus.java,200,41,0,2,0,43
hadoop-trunk\hadoop-trunk\hadoop-hdfs-project\hadoop-hdfs\src\main\java\org\apache\hadoop\hdfs\protocolPB\AliasMapProtocolServerSideTranslatorPB.java,0,20,33,5,0,58
hadoop-trunk\hadoop-trunk\hadoop-mapreduce-project\hadoop-mapreduce-client\hadoop-mapreduce-client-jobclient\src\test\java\org\apache\hadoop\mapred\TestTaskCommit.java,277,72,7,3,0,82
hadoop-trunk\hadoop-trunk\hadoop-yarn-project\hadoop-yarn\hadoop-yarn-server\hadoop-yarn-server-nodemanager\src\test\java\org\apache\hadoop\yarn\server\nodemanager\TestLocalDirsHandlerService.java,130,14,3,1,0,18
hadoop-trunk\hadoop-trunk\hadoop-common-project\hadoop-common\src\main\java\org\apache\hadoop\fs\UnsupportedMultipartUploaderException.java,13,0,0,1,0,1
hadoop-trunk\hadoop-trunk\hadoop-yarn-project\hadoop-yarn\hadoop-yarn-server\hadoop-yarn-server-nodemanager\src\main\java\org\apache\hadoop\yarn\server\nodemanager\containermanager\deletion\task\DockerContainerDeletionTask.java,0,13,6,3,0,22
hadoop-trunk\hadoop-trunk\hadoop-yarn-project\hadoop-yarn\hadoop-yarn-server\hadoop-yarn-server-resourcemanager\src\main\java\org\apache\hadoop\yarn\server\resourcemanager\volume\csi\event\ValidateVolumeEvent.java,7,2,0,2,0,4
hadoop-trunk\hadoop-trunk\hadoop-common-project\hadoop-common\src\test\java\org\apache\hadoop\fs\contract\localfs\TestLocalFSContractAppend.java,9,2,0,1,0,3
hadoop-trunk\hadoop-trunk\hadoop-mapreduce-project\hadoop-mapreduce-client\hadoop-mapreduce-client-app\src\main\java\org\apache\hadoop\mapreduce\v2\app\job\event\package-info.java,0,1,0,1,0,2
hadoop-trunk\hadoop-trunk\hadoop-mapreduce-project\hadoop-mapreduce-client\hadoop-mapreduce-client-app\src\main\java\org\apache\hadoop\mapreduce\v2\app\job\event\TaskAttemptTooManyFetchFailureEvent.java,26,10,0,1,0,11
hadoop-trunk\hadoop-trunk\hadoop-tools\hadoop-aws\src\main\java\org\apache\hadoop\fs\s3a\impl\InternalConstants.java,0,6,0,6,0,12
hadoop-trunk\hadoop-trunk\hadoop-tools\hadoop-gridmix\src\main\java\org\apache\hadoop\mapred\gridmix\JobMonitor.java,0,50,7,1,0,58
hadoop-trunk\hadoop-trunk\hadoop-yarn-project\hadoop-yarn\hadoop-yarn-api\src\main\java\org\apache\hadoop\yarn\api\protocolrecords\RollbackResponse.java,13,0,0,1,0,1
hadoop-trunk\hadoop-trunk\hadoop-yarn-project\hadoop-yarn\hadoop-yarn-server\hadoop-yarn-server-common\src\main\java\org\apache\hadoop\yarn\server\security\MasterKeyData.java,0,13,0,1,0,14
hadoop-trunk\hadoop-trunk\hadoop-common-project\hadoop-common\src\main\java\org\apache\hadoop\fs\impl\StoreImplementationUtils.java,0,8,1,1,0,10
hadoop-trunk\hadoop-trunk\hadoop-hdfs-project\hadoop-hdfs\src\test\java\org\apache\hadoop\hdfs\TestRollingUpgradeRollback.java,245,29,1,2,0,32
hadoop-trunk\hadoop-trunk\hadoop-yarn-project\hadoop-yarn\hadoop-yarn-server\hadoop-yarn-server-resourcemanager\src\main\java\org\apache\hadoop\yarn\server\resourcemanager\scheduler\ApplicationPlacementAllocatorFactory.java,36,12,1,7,0,20
hadoop-trunk\hadoop-trunk\hadoop-yarn-project\hadoop-yarn\hadoop-yarn-server\hadoop-yarn-server-resourcemanager\src\test\java\org\apache\hadoop\yarn\server\resourcemanager\webapp\TestRMWebServicesAppCustomResourceTypes.java,123,12,0,9,0,21
hadoop-trunk\hadoop-trunk\hadoop-common-project\hadoop-common\src\main\java\org\apache\hadoop\fs\BBPartHandle.java,0,6,0,1,0,7
hadoop-trunk\hadoop-trunk\hadoop-mapreduce-project\hadoop-mapreduce-client\hadoop-mapreduce-client-core\src\main\java\org\apache\hadoop\mapred\AMFeedback.java,35,26,0,1,0,27
hadoop-trunk\hadoop-trunk\hadoop-hdfs-project\hadoop-hdfs\src\test\java\org\apache\hadoop\hdfs\web\TestWebHDFSAcl.java,44,3,1,2,0,6
hadoop-trunk\hadoop-trunk\hadoop-mapreduce-project\hadoop-mapreduce-client\hadoop-mapreduce-client-app\src\main\java\org\apache\hadoop\mapreduce\v2\app\job\impl\package-info.java,0,1,0,1,0,2
hadoop-trunk\hadoop-trunk\hadoop-yarn-project\hadoop-yarn\hadoop-yarn-csi\src\main\java\org\apache\hadoop\yarn\csi\client\CsiClient.java,0,3,9,1,0,13
hadoop-trunk\hadoop-trunk\hadoop-yarn-project\hadoop-yarn\hadoop-yarn-api\src\main\java\org\apache\hadoop\yarn\api\protocolrecords\GetApplicationsResponse.java,34,6,0,1,0,7
hadoop-trunk\hadoop-trunk\hadoop-yarn-project\hadoop-yarn\hadoop-yarn-common\src\main\java\org\apache\hadoop\yarn\webapp\log\AggregatedLogsNavBlock.java,11,2,0,1,0,3
hadoop-trunk\hadoop-trunk\hadoop-common-project\hadoop-common\src\main\java\org\apache\hadoop\io\SequenceFile.java,3627,1529,167,41,0,1737
hadoop-trunk\hadoop-trunk\hadoop-common-project\hadoop-annotations\src\main\java\org\apache\hadoop\classification\InterfaceStability.java,25,13,0,1,0,14
hadoop-trunk\hadoop-trunk\hadoop-mapreduce-project\hadoop-mapreduce-client\hadoop-mapreduce-client-core\src\main\java\org\apache\hadoop\mapreduce\jobhistory\TaskUpdatedEvent.java,44,23,14,1,0,38
hadoop-trunk\hadoop-trunk\hadoop-hdfs-project\hadoop-hdfs\src\main\java\org\apache\hadoop\hdfs\server\datanode\BlockPoolManager.java,0,61,8,3,0,72
hadoop-trunk\hadoop-trunk\hadoop-mapreduce-project\hadoop-mapreduce-client\hadoop-mapreduce-client-core\src\main\java\org\apache\hadoop\mapreduce\security\token\delegation\DelegationTokenSelector.java,0,4,0,2,0,6
hadoop-trunk\hadoop-trunk\hadoop-hdfs-project\hadoop-hdfs\src\test\java\org\apache\hadoop\hdfs\TestClientProtocolForPipelineRecovery.java,0,107,25,14,0,146
hadoop-trunk\hadoop-trunk\hadoop-yarn-project\hadoop-yarn\hadoop-yarn-api\src\main\java\org\apache\hadoop\yarn\api\records\UpdatedContainer.java,89,7,0,1,0,8
hadoop-trunk\hadoop-trunk\hadoop-hdfs-project\hadoop-hdfs\src\main\java\org\apache\hadoop\hdfs\qjournal\client\AsyncLogger.java,0,61,35,7,0,103
hadoop-trunk\hadoop-trunk\hadoop-hdfs-project\hadoop-hdfs\src\main\java\org\apache\hadoop\hdfs\server\namenode\sps\BlockMovementListener.java,0,1,0,1,0,2
hadoop-trunk\hadoop-trunk\hadoop-yarn-project\hadoop-yarn\hadoop-yarn-server\hadoop-yarn-server-resourcemanager\src\test\java\org\apache\hadoop\yarn\server\resourcemanager\scheduler\fair\SimpleGroupsMapping.java,35,5,2,1,0,8
hadoop-trunk\hadoop-trunk\hadoop-yarn-project\hadoop-yarn\hadoop-yarn-common\src\main\java\org\apache\hadoop\yarn\api\protocolrecords\impl\pb\GetLabelsToNodesResponsePBImpl.java,0,30,49,3,0,82
hadoop-trunk\hadoop-trunk\hadoop-common-project\hadoop-common\src\main\java\org\apache\hadoop\security\ProviderUtils.java,0,31,2,2,0,35
hadoop-trunk\hadoop-trunk\hadoop-common-project\hadoop-common\src\main\java\org\apache\hadoop\util\LineReader.java,0,90,2,5,0,97
hadoop-trunk\hadoop-trunk\hadoop-tools\hadoop-aws\src\test\java\org\apache\hadoop\fs\contract\s3a\ITestS3AContractRootDir.java,21,4,3,1,0,8
hadoop-trunk\hadoop-trunk\hadoop-mapreduce-project\hadoop-mapreduce-examples\src\test\java\org\apache\hadoop\mapreduce\lib\db\TestDBJob.java,13,5,0,1,0,6
hadoop-trunk\hadoop-trunk\hadoop-hdfs-project\hadoop-hdfs-httpfs\src\test\java\org\apache\hadoop\lib\service\security\DummyGroupMapping.java,37,8,6,1,0,15
hadoop-trunk\hadoop-trunk\hadoop-tools\hadoop-distcp\src\main\java\org\apache\hadoop\tools\DistCpOptionSwitch.java,0,62,0,6,0,68
hadoop-trunk\hadoop-trunk\hadoop-common-project\hadoop-common\src\main\java\org\apache\hadoop\fs\viewfs\HCFSMountTableConfigLoader.java,88,7,2,1,0,10
hadoop-trunk\hadoop-trunk\hadoop-common-project\hadoop-common\src\test\java\org\apache\hadoop\io\TestMD5Hash.java,124,113,4,3,0,120
hadoop-trunk\hadoop-trunk\hadoop-hdfs-project\hadoop-hdfs\src\test\java\org\apache\hadoop\hdfs\server\datanode\TestIncrementalBlockReports.java,181,31,3,5,0,39
hadoop-trunk\hadoop-trunk\hadoop-hdfs-project\hadoop-hdfs-rbf\src\test\java\org\apache\hadoop\hdfs\server\federation\store\driver\TestStateStoreZK.java,108,18,1,6,0,25
hadoop-trunk\hadoop-trunk\hadoop-tools\hadoop-distcp\src\main\java\org\apache\hadoop\tools\util\DistCpUtils.java,609,111,13,10,0,134
hadoop-trunk\hadoop-trunk\hadoop-yarn-project\hadoop-yarn\hadoop-yarn-common\src\main\java\org\apache\hadoop\yarn\api\records\impl\pb\SchedulingRequestPBImpl.java,273,61,72,1,0,134
hadoop-trunk\hadoop-trunk\hadoop-yarn-project\hadoop-yarn\hadoop-yarn-server\hadoop-yarn-server-resourcemanager\src\test\java\org\apache\hadoop\yarn\server\resourcemanager\TestSignalContainer.java,77,13,2,3,0,18
hadoop-trunk\hadoop-trunk\hadoop-tools\hadoop-streaming\src\main\java\org\apache\hadoop\streaming\DumpTypedBytes.java,100,23,3,1,0,27
hadoop-trunk\hadoop-trunk\hadoop-yarn-project\hadoop-yarn\hadoop-yarn-api\src\main\java\org\apache\hadoop\yarn\exceptions\InvalidContainerReleaseException.java,18,12,0,1,0,13
hadoop-trunk\hadoop-trunk\hadoop-yarn-project\hadoop-yarn\hadoop-yarn-server\hadoop-yarn-server-applicationhistoryservice\src\test\java\org\apache\hadoop\yarn\server\applicationhistoryservice\webapp\TestAHSWebApp.java,200,29,1,9,0,39
hadoop-trunk\hadoop-trunk\hadoop-hdfs-project\hadoop-hdfs-httpfs\src\test\java\org\apache\hadoop\test\TestJetty.java,0,3,0,4,0,7
hadoop-trunk\hadoop-trunk\hadoop-hdfs-project\hadoop-hdfs-client\src\main\java\org\apache\hadoop\hdfs\web\resources\XAttrSetFlagParam.java,31,5,0,1,0,6
hadoop-trunk\hadoop-trunk\hadoop-yarn-project\hadoop-yarn\hadoop-yarn-server\hadoop-yarn-server-nodemanager\src\main\java\org\apache\hadoop\yarn\server\nodemanager\webapp\AggregatedLogsBlock.java,0,1,0,1,0,2
hadoop-trunk\hadoop-trunk\hadoop-hdfs-project\hadoop-hdfs\src\main\java\org\apache\hadoop\hdfs\server\namenode\sps\DatanodeCacheManager.java,77,11,0,2,0,13
hadoop-trunk\hadoop-trunk\hadoop-mapreduce-project\hadoop-mapreduce-client\hadoop-mapreduce-client-core\src\main\java\org\apache\hadoop\mapreduce\counters\AbstractCounterGroup.java,0,54,0,1,0,55
hadoop-trunk\hadoop-trunk\hadoop-tools\hadoop-azure\src\main\java\org\apache\hadoop\fs\azure\PageBlobInputStream.java,0,50,5,2,0,57
hadoop-trunk\hadoop-trunk\hadoop-common-project\hadoop-common\src\main\java\org\apache\hadoop\metrics2\sink\ganglia\GangliaConf.java,0,14,0,1,0,15
hadoop-trunk\hadoop-trunk\hadoop-common-project\hadoop-common\src\test\java\org\apache\hadoop\http\TestHttpServer.java,0,146,24,26,0,196
hadoop-trunk\hadoop-trunk\hadoop-yarn-project\hadoop-yarn\hadoop-yarn-api\src\main\java\org\apache\hadoop\yarn\api\records\LogAggregationContext.java,163,20,0,2,0,22
hadoop-trunk\hadoop-trunk\hadoop-mapreduce-project\hadoop-mapreduce-client\hadoop-mapreduce-client-core\src\test\java\org\apache\hadoop\mapreduce\lib\db\TestSplitters.java,124,56,6,3,0,65
hadoop-trunk\hadoop-trunk\hadoop-common-project\hadoop-common\src\main\java\org\apache\hadoop\http\FilterContainer.java,0,2,0,2,0,4
hadoop-trunk\hadoop-trunk\hadoop-common-project\hadoop-common\src\main\java\org\apache\hadoop\conf\ConfServlet.java,82,22,1,1,0,24
hadoop-trunk\hadoop-trunk\hadoop-yarn-project\hadoop-yarn\hadoop-yarn-server\hadoop-yarn-server-common\src\main\java\org\apache\hadoop\yarn\server\webapp\dao\RemoteLogPaths.java,21,14,1,1,0,16
hadoop-trunk\hadoop-trunk\hadoop-yarn-project\hadoop-yarn\hadoop-yarn-server\hadoop-yarn-server-resourcemanager\src\main\java\org\apache\hadoop\yarn\server\resourcemanager\OpportunisticContainerAllocatorAMService.java,402,52,11,22,0,85
hadoop-trunk\hadoop-trunk\hadoop-hdfs-project\hadoop-hdfs\src\main\java\org\apache\hadoop\hdfs\protocolPB\AliasMapProtocolPB.java,0,0,3,1,0,4
hadoop-trunk\hadoop-trunk\hadoop-hdfs-project\hadoop-hdfs-rbf\src\test\java\org\apache\hadoop\hdfs\server\federation\store\TestStateStoreRouterState.java,183,13,0,6,0,19
hadoop-trunk\hadoop-trunk\hadoop-yarn-project\hadoop-yarn\hadoop-yarn-common\src\main\java\org\apache\hadoop\yarn\webapp\NotFoundException.java,17,7,1,3,0,11
hadoop-trunk\hadoop-trunk\hadoop-common-project\hadoop-common\src\main\java\org\apache\hadoop\io\WritableComparable.java,0,13,0,6,0,19
hadoop-trunk\hadoop-trunk\hadoop-common-project\hadoop-nfs\src\main\java\org\apache\hadoop\nfs\nfs3\response\RMDIR3Response.java,30,16,0,1,0,17
hadoop-trunk\hadoop-trunk\hadoop-tools\hadoop-openstack\src\test\java\org\apache\hadoop\fs\swift\TestSwiftObjectPath.java,135,27,4,6,0,37
hadoop-trunk\hadoop-trunk\hadoop-yarn-project\hadoop-yarn\hadoop-yarn-common\src\main\java\org\apache\hadoop\yarn\client\api\AppAdminClient.java,293,17,1,1,0,19
hadoop-trunk\hadoop-trunk\hadoop-yarn-project\hadoop-yarn\hadoop-yarn-server\hadoop-yarn-server-router\src\main\java\org\apache\hadoop\yarn\server\router\clientrm\RouterClientRMService.java,0,89,5,16,0,110
hadoop-trunk\hadoop-trunk\hadoop-hdfs-project\hadoop-hdfs-rbf\src\main\java\org\apache\hadoop\hdfs\server\federation\router\NoNamenodesAvailableException.java,9,3,0,1,0,4
hadoop-trunk\hadoop-trunk\hadoop-hdfs-project\hadoop-hdfs\src\main\java\org\apache\hadoop\hdfs\server\diskbalancer\command\QueryCommand.java,0,4,0,1,0,5
hadoop-trunk\hadoop-trunk\hadoop-hdfs-project\hadoop-hdfs-client\src\main\java\org\apache\hadoop\hdfs\DFSInputStream.java,1966,314,70,21,0,405
hadoop-trunk\hadoop-trunk\hadoop-cloud-storage-project\hadoop-huaweicloud\src\test\java\org\apache\hadoop\fs\obs\TestOBSContractDelete.java,8,1,0,1,0,2
hadoop-trunk\hadoop-trunk\hadoop-yarn-project\hadoop-yarn\hadoop-yarn-api\src\main\java\org\apache\hadoop\yarn\api\protocolrecords\NodeUnpublishVolumeResponse.java,7,2,1,1,0,4
hadoop-trunk\hadoop-trunk\hadoop-yarn-project\hadoop-yarn\hadoop-yarn-applications\hadoop-yarn-services\hadoop-yarn-services-core\src\main\java\org\apache\hadoop\yarn\service\utils\CoreFileSystem.java,506,116,6,14,0,136
hadoop-trunk\hadoop-trunk\hadoop-mapreduce-project\hadoop-mapreduce-client\hadoop-mapreduce-client-core\src\main\java\org\apache\hadoop\mapred\TaskAttemptContext.java,0,8,4,1,0,13
hadoop-trunk\hadoop-trunk\hadoop-common-project\hadoop-common\src\test\java\org\apache\hadoop\fs\FileContextPermissionBase.java,0,68,9,5,0,82
hadoop-trunk\hadoop-trunk\hadoop-yarn-project\hadoop-yarn\hadoop-yarn-server\hadoop-yarn-server-timelineservice-hbase\hadoop-yarn-server-timelineservice-hbase-client\src\main\java\org\apache\hadoop\yarn\server\timelineservice\storage\reader\package-info.java,0,1,0,1,0,2
hadoop-trunk\hadoop-trunk\hadoop-common-project\hadoop-common\src\main\java\org\apache\hadoop\crypto\OpensslAesCtrCryptoCodec.java,41,10,0,1,0,11
hadoop-trunk\hadoop-trunk\hadoop-yarn-project\hadoop-yarn\hadoop-yarn-server\hadoop-yarn-server-timelineservice-hbase-tests\src\test\java\org\apache\hadoop\yarn\server\timelineservice\storage\TestHBaseTimelineStorageSchema.java,105,6,2,3,0,11
hadoop-trunk\hadoop-trunk\hadoop-tools\hadoop-aws\src\test\java\org\apache\hadoop\fs\contract\s3a\ITestS3AContractSeek.java,280,28,0,4,0,32
hadoop-trunk\hadoop-trunk\hadoop-yarn-project\hadoop-yarn\hadoop-yarn-server\hadoop-yarn-server-router\src\test\java\org\apache\hadoop\yarn\server\router\clientrm\BaseRouterClientRMTest.java,499,72,25,10,0,107
hadoop-trunk\hadoop-trunk\hadoop-yarn-project\hadoop-yarn\hadoop-yarn-server\hadoop-yarn-server-resourcemanager\src\main\java\org\apache\hadoop\yarn\server\resourcemanager\scheduler\ContainerUpdates.java,41,9,0,1,0,10
hadoop-trunk\hadoop-trunk\hadoop-common-project\hadoop-registry\src\main\java\org\apache\hadoop\registry\client\exceptions\NoPathPermissionsException.java,19,14,0,2,0,16
hadoop-trunk\hadoop-trunk\hadoop-tools\hadoop-gridmix\src\main\java\org\apache\hadoop\mapred\gridmix\FileQueue.java,0,19,1,1,0,21
hadoop-trunk\hadoop-trunk\hadoop-yarn-project\hadoop-yarn\hadoop-yarn-server\hadoop-yarn-server-resourcemanager\src\main\java\org\apache\hadoop\yarn\server\resourcemanager\scheduler\SchedulerApplication.java,65,47,2,1,0,50
hadoop-trunk\hadoop-trunk\hadoop-tools\hadoop-rumen\src\main\java\org\apache\hadoop\tools\rumen\MapTaskAttemptInfo.java,46,18,0,1,0,19
hadoop-trunk\hadoop-trunk\hadoop-yarn-project\hadoop-yarn\hadoop-yarn-server\hadoop-yarn-server-resourcemanager\src\test\java\org\apache\hadoop\yarn\server\resourcemanager\reservation\TestCapacityOverTimePolicy.java,103,66,5,5,0,76
hadoop-trunk\hadoop-trunk\hadoop-mapreduce-project\hadoop-mapreduce-client\hadoop-mapreduce-client-common\src\main\java\org\apache\hadoop\mapreduce\v2\api\records\TaskAttemptId.java,72,16,6,1,0,23
hadoop-trunk\hadoop-trunk\hadoop-yarn-project\hadoop-yarn\hadoop-yarn-server\hadoop-yarn-server-resourcemanager\src\main\java\org\apache\hadoop\yarn\server\resourcemanager\scheduler\constraint\api\ConstraintPlacementAlgorithmOutputCollector.java,0,0,0,1,0,1
hadoop-trunk\hadoop-trunk\hadoop-hdfs-project\hadoop-hdfs-client\src\test\java\org\apache\hadoop\hdfs\web\oauth2\TestClientCredentialTimeBasedTokenRefresher.java,84,20,3,5,0,28
hadoop-trunk\hadoop-trunk\hadoop-hdfs-project\hadoop-hdfs\src\main\java\org\apache\hadoop\hdfs\server\blockmanagement\HostFileManager.java,126,30,2,1,0,33
hadoop-trunk\hadoop-trunk\hadoop-hdfs-project\hadoop-hdfs-rbf\src\test\java\org\apache\hadoop\hdfs\server\federation\resolver\TestNamenodeResolver.java,286,28,1,11,0,40
hadoop-trunk\hadoop-trunk\hadoop-yarn-project\hadoop-yarn\hadoop-yarn-server\hadoop-yarn-server-timelineservice-hbase\hadoop-yarn-server-timelineservice-hbase-common\src\main\java\org\apache\hadoop\yarn\server\timelineservice\storage\flow\FlowRunColumn.java,0,22,3,6,0,31
hadoop-trunk\hadoop-trunk\hadoop-common-project\hadoop-common\src\main\java\org\apache\hadoop\security\protocolPB\RefreshAuthorizationPolicyProtocolClientSideTranslatorPB.java,0,15,6,3,0,24
hadoop-trunk\hadoop-trunk\hadoop-tools\hadoop-azure\src\test\java\org\apache\hadoop\fs\azurebfs\services\TestTextFileBasedIdentityHandler.java,114,62,14,36,0,112
hadoop-trunk\hadoop-trunk\hadoop-yarn-project\hadoop-yarn\hadoop-yarn-applications\hadoop-yarn-services\hadoop-yarn-services-core\src\main\java\org\apache\hadoop\yarn\service\conf\YarnServiceConf.java,201,81,1,17,0,99
hadoop-trunk\hadoop-trunk\hadoop-mapreduce-project\hadoop-mapreduce-client\hadoop-mapreduce-client-core\src\main\java\org\apache\hadoop\mapreduce\checkpoint\CheckpointNamingService.java,0,2,1,1,0,4
hadoop-trunk\hadoop-trunk\hadoop-mapreduce-project\hadoop-mapreduce-client\hadoop-mapreduce-client-hs\src\test\java\org\apache\hadoop\mapreduce\v2\hs\TestJHSDelegationTokenSecretManager.java,163,26,2,4,0,32
hadoop-trunk\hadoop-trunk\hadoop-yarn-project\hadoop-yarn\hadoop-yarn-common\src\main\java\org\apache\hadoop\yarn\api\protocolrecords\impl\pb\GetPluginInfoRequestPBImpl.java,35,9,12,1,0,22
hadoop-trunk\hadoop-trunk\hadoop-yarn-project\hadoop-yarn\hadoop-yarn-server\hadoop-yarn-server-applicationhistoryservice\src\main\java\org\apache\hadoop\yarn\server\timeline\security\authorize\TimelinePolicyProvider.java,13,3,0,2,0,5
hadoop-trunk\hadoop-trunk\hadoop-mapreduce-project\hadoop-mapreduce-client\hadoop-mapreduce-client-app\src\test\java\org\apache\hadoop\mapreduce\v2\app\rm\TestRMCommunicator.java,62,9,1,1,0,11
hadoop-trunk\hadoop-trunk\hadoop-common-project\hadoop-common\src\test\java\org\apache\hadoop\ipc\TestSocketFactory.java,212,32,10,6,0,48
hadoop-trunk\hadoop-trunk\hadoop-hdfs-project\hadoop-hdfs\src\main\java\org\apache\hadoop\hdfs\server\datanode\BlockReceiver.java,0,327,66,9,0,402
hadoop-trunk\hadoop-trunk\hadoop-tools\hadoop-rumen\src\main\java\org\apache\hadoop\tools\rumen\Node.java,121,32,4,2,0,38
hadoop-trunk\hadoop-trunk\hadoop-tools\hadoop-resourceestimator\src\main\java\org\apache\hadoop\resourceestimator\service\package-info.java,0,1,0,1,0,2
hadoop-trunk\hadoop-trunk\hadoop-common-project\hadoop-registry\src\test\java\org\apache\hadoop\registry\RegistryTestHelper.java,300,81,5,6,0,92
hadoop-trunk\hadoop-trunk\hadoop-mapreduce-project\hadoop-mapreduce-client\hadoop-mapreduce-client-core\src\main\java\org\apache\hadoop\mapreduce\Partitioner.java,0,13,2,1,0,16
hadoop-trunk\hadoop-trunk\hadoop-tools\hadoop-azure-datalake\src\main\java\org\apache\hadoop\fs\adl\package-info.java,0,1,0,1,0,2
hadoop-trunk\hadoop-trunk\hadoop-yarn-project\hadoop-yarn\hadoop-yarn-server\hadoop-yarn-server-nodemanager\src\main\java\org\apache\hadoop\yarn\server\nodemanager\amrmproxy\DefaultRequestInterceptor.java,213,30,0,9,0,39
hadoop-trunk\hadoop-trunk\hadoop-common-project\hadoop-common\src\main\java\org\apache\hadoop\io\erasurecode\rawcoder\RawErasureCoderFactory.java,0,0,0,1,0,1
hadoop-trunk\hadoop-trunk\hadoop-yarn-project\hadoop-yarn\hadoop-yarn-common\src\main\java\org\apache\hadoop\yarn\webapp\Params.java,0,14,8,1,0,23
hadoop-trunk\hadoop-trunk\hadoop-tools\hadoop-azure\src\main\java\org\apache\hadoop\fs\azure\NativeFileSystemStore.java,0,7,1,5,0,13
hadoop-trunk\hadoop-trunk\hadoop-yarn-project\hadoop-yarn\hadoop-yarn-common\src\test\java\org\apache\hadoop\yarn\webapp\hamlet2\TestHamlet.java,136,20,10,1,0,31
hadoop-trunk\hadoop-trunk\hadoop-mapreduce-project\hadoop-mapreduce-client\hadoop-mapreduce-client-core\src\main\java\org\apache\hadoop\mapred\TaskLogAppender.java,120,36,0,2,0,38
hadoop-trunk\hadoop-trunk\hadoop-mapreduce-project\hadoop-mapreduce-client\hadoop-mapreduce-client-jobclient\src\test\java\org\apache\hadoop\mapred\TestJobCleanup.java,283,49,8,3,0,60
hadoop-trunk\hadoop-trunk\hadoop-yarn-project\hadoop-yarn\hadoop-yarn-server\hadoop-yarn-server-resourcemanager\src\main\java\org\apache\hadoop\yarn\server\resourcemanager\webapp\NavBlock.java,49,7,2,1,0,10
hadoop-trunk\hadoop-trunk\hadoop-yarn-project\hadoop-yarn\hadoop-yarn-server\hadoop-yarn-server-timelineservice-hbase\hadoop-yarn-server-timelineservice-hbase-common\src\main\java\org\apache\hadoop\yarn\server\timelineservice\storage\domain\DomainRowKey.java,149,19,1,3,0,23
hadoop-trunk\hadoop-trunk\hadoop-yarn-project\hadoop-yarn\hadoop-yarn-server\hadoop-yarn-server-resourcemanager\src\main\java\org\apache\hadoop\yarn\server\resourcemanager\placement\SecondaryGroupExistingPlacementRule.java,59,8,1,6,0,15
hadoop-trunk\hadoop-trunk\hadoop-common-project\hadoop-annotations\src\main\java\org\apache\hadoop\classification\tools\ExcludePrivateAnnotationsStandardDoclet.java,32,14,1,2,0,17
hadoop-trunk\hadoop-trunk\hadoop-common-project\hadoop-kms\src\main\java\org\apache\hadoop\crypto\key\kms\server\KMSWebServer.java,148,28,0,6,0,34
hadoop-trunk\hadoop-trunk\hadoop-common-project\hadoop-registry\src\main\java\org\apache\hadoop\registry\server\dns\PrivilegedRegistryDNSStarter.java,46,10,1,3,0,14
hadoop-trunk\hadoop-trunk\hadoop-yarn-project\hadoop-yarn\hadoop-yarn-api\src\main\java\org\apache\hadoop\yarn\api\records\NodeAttributeKey.java,32,9,0,1,0,10
hadoop-trunk\hadoop-trunk\hadoop-yarn-project\hadoop-yarn\hadoop-yarn-server\hadoop-yarn-server-nodemanager\src\test\java\org\apache\hadoop\yarn\server\nodemanager\containermanager\linux\resources\TestCGroupsResourceCalculator.java,241,40,1,2,0,43
hadoop-trunk\hadoop-trunk\hadoop-hdfs-project\hadoop-hdfs\src\test\java\org\apache\hadoop\hdfs\server\namenode\TestNameNodeAcl.java,9,1,0,1,0,2
hadoop-trunk\hadoop-trunk\hadoop-common-project\hadoop-common\src\main\java\org\apache\hadoop\metrics2\util\Servers.java,30,8,1,1,0,10
hadoop-trunk\hadoop-trunk\hadoop-mapreduce-project\hadoop-mapreduce-client\hadoop-mapreduce-client-app\src\main\java\org\apache\hadoop\mapreduce\v2\app\speculate\Speculator.java,0,6,1,2,0,9
hadoop-trunk\hadoop-trunk\hadoop-tools\hadoop-openstack\src\main\java\org\apache\hadoop\fs\swift\auth\PasswordCredentials.java,0,12,1,1,0,14
hadoop-trunk\hadoop-trunk\hadoop-hdfs-project\hadoop-hdfs\src\main\java\org\apache\hadoop\hdfs\server\protocol\NamenodeProtocol.java,0,65,17,1,0,83
hadoop-trunk\hadoop-trunk\hadoop-mapreduce-project\hadoop-mapreduce-client\hadoop-mapreduce-client-core\src\main\java\org\apache\hadoop\mapred\InputFormat.java,0,29,0,3,0,32
hadoop-trunk\hadoop-trunk\hadoop-mapreduce-project\hadoop-mapreduce-client\hadoop-mapreduce-client-jobclient\src\test\java\org\apache\hadoop\mapreduce\TestLargeSort.java,34,9,0,1,0,10
hadoop-trunk\hadoop-trunk\hadoop-mapreduce-project\hadoop-mapreduce-client\hadoop-mapreduce-client-app\src\main\java\org\apache\hadoop\mapreduce\v2\app\webapp\NavBlock.java,56,12,0,1,0,13
hadoop-trunk\hadoop-trunk\hadoop-tools\hadoop-aws\src\test\java\org\apache\hadoop\fs\s3a\select\AbstractS3SelectTest.java,665,55,2,1,0,58
hadoop-trunk\hadoop-trunk\hadoop-yarn-project\hadoop-yarn\hadoop-yarn-server\hadoop-yarn-server-nodemanager\src\main\java\org\apache\hadoop\yarn\server\nodemanager\containermanager\localizer\security\LocalizerSecurityInfo.java,33,8,0,2,0,10
hadoop-trunk\hadoop-trunk\hadoop-mapreduce-project\hadoop-mapreduce-client\hadoop-mapreduce-client-core\src\main\java\org\apache\hadoop\mapred\lib\InputSampler.java,0,68,5,2,0,75
hadoop-trunk\hadoop-trunk\hadoop-hdfs-project\hadoop-hdfs\src\test\java\org\apache\hadoop\hdfs\server\datanode\TestDataNodeFSDataSetSink.java,103,12,1,1,0,14
hadoop-trunk\hadoop-trunk\hadoop-mapreduce-project\hadoop-mapreduce-client\hadoop-mapreduce-client-core\src\main\java\org\apache\hadoop\mapred\FileOutputFormat.java,0,112,6,7,0,125
hadoop-trunk\hadoop-trunk\hadoop-tools\hadoop-aliyun\src\test\java\org\apache\hadoop\fs\aliyun\oss\fileContext\TestOSSFileContextCreateMkdir.java,0,1,1,1,0,3
hadoop-trunk\hadoop-trunk\hadoop-yarn-project\hadoop-yarn\hadoop-yarn-server\hadoop-yarn-server-resourcemanager\src\main\java\org\apache\hadoop\yarn\server\resourcemanager\volume\csi\lifecycle\Volume.java,0,5,0,2,0,7
hadoop-trunk\hadoop-trunk\hadoop-tools\hadoop-azure\src\main\java\org\apache\hadoop\fs\azure\NativeAzureFileSystem.java,0,623,143,210,0,976
hadoop-trunk\hadoop-trunk\hadoop-tools\hadoop-azure\src\test\java\org\apache\hadoop\fs\azure\MockStorageInterface.java,594,201,22,24,0,247
hadoop-trunk\hadoop-trunk\hadoop-common-project\hadoop-common\src\main\java\org\apache\hadoop\util\concurrent\AsyncGet.java,0,8,1,1,0,10
hadoop-trunk\hadoop-trunk\hadoop-yarn-project\hadoop-yarn\hadoop-yarn-server\hadoop-yarn-server-resourcemanager\src\main\java\org\apache\hadoop\yarn\server\resourcemanager\webapp\dao\ApplicationSubmissionContextInfo.java,210,142,0,1,0,143
hadoop-trunk\hadoop-trunk\hadoop-common-project\hadoop-common\src\main\java\org\apache\hadoop\util\ExitCodeProvider.java,0,0,0,1,0,1
hadoop-trunk\hadoop-trunk\hadoop-yarn-project\hadoop-yarn\hadoop-yarn-server\hadoop-yarn-server-resourcemanager\src\main\java\org\apache\hadoop\yarn\server\resourcemanager\webapp\dao\AppQueue.java,21,12,1,1,0,14
hadoop-trunk\hadoop-trunk\hadoop-common-project\hadoop-common\src\main\java\org\apache\hadoop\io\erasurecode\codec\HHXORErasureCodec.java,17,5,0,1,0,6
hadoop-trunk\hadoop-trunk\hadoop-yarn-project\hadoop-yarn\hadoop-yarn-common\src\main\java\org\apache\hadoop\yarn\api\records\impl\pb\NodeAttributeKeyPBImpl.java,109,22,29,1,0,52
hadoop-trunk\hadoop-trunk\hadoop-tools\hadoop-azure-datalake\src\test\java\org\apache\hadoop\fs\adl\live\TestAdlFileContextCreateMkdirLive.java,0,4,0,1,0,5
hadoop-trunk\hadoop-trunk\hadoop-common-project\hadoop-common\src\main\java\org\apache\hadoop\io\compress\GzipCodec.java,102,40,2,3,0,45
hadoop-trunk\hadoop-trunk\hadoop-hdfs-project\hadoop-hdfs-httpfs\src\test\java\org\apache\hadoop\lib\util\TestConfigurationUtils.java,112,8,0,2,0,10
hadoop-trunk\hadoop-trunk\hadoop-mapreduce-project\hadoop-mapreduce-client\hadoop-mapreduce-client-jobclient\src\test\java\org\apache\hadoop\mapred\TestCombineTextInputFormat.java,204,76,8,1,0,85
hadoop-trunk\hadoop-trunk\hadoop-yarn-project\hadoop-yarn\hadoop-yarn-api\src\test\java\org\apache\hadoop\yarn\conf\TestResourceInformation.java,0,21,1,1,0,23
hadoop-trunk\hadoop-trunk\hadoop-hdfs-project\hadoop-hdfs\src\test\java\org\apache\hadoop\hdfs\server\datanode\checker\TestDatasetVolumeChecker.java,204,34,16,7,0,57
hadoop-trunk\hadoop-trunk\hadoop-common-project\hadoop-common\src\test\java\org\apache\hadoop\ipc\TestSaslRPC.java,0,274,39,64,0,377
hadoop-trunk\hadoop-trunk\hadoop-common-project\hadoop-common\src\main\java\org\apache\hadoop\util\InstrumentedReadWriteLock.java,25,10,0,1,0,11
hadoop-trunk\hadoop-trunk\hadoop-yarn-project\hadoop-yarn\hadoop-yarn-common\src\main\java\org\apache\hadoop\yarn\server\api\protocolrecords\impl\pb\RefreshSuperUserGroupsConfigurationRequestPBImpl.java,0,22,18,5,0,45
hadoop-trunk\hadoop-trunk\hadoop-tools\hadoop-rumen\src\main\java\org\apache\hadoop\tools\rumen\TopologyBuilder.java,105,19,0,4,0,23
hadoop-trunk\hadoop-trunk\hadoop-mapreduce-project\hadoop-mapreduce-client\hadoop-mapreduce-client-core\src\main\java\org\apache\hadoop\mapreduce\lib\input\DelegatingRecordReader.java,0,18,0,1,0,19
hadoop-trunk\hadoop-trunk\hadoop-tools\hadoop-aws\src\test\java\org\apache\hadoop\fs\s3a\auth\ProgressCounter.java,17,9,0,1,0,10
hadoop-trunk\hadoop-trunk\hadoop-yarn-project\hadoop-yarn\hadoop-yarn-server\hadoop-yarn-server-timelineservice-hbase\hadoop-yarn-server-timelineservice-hbase-common\src\main\java\org\apache\hadoop\yarn\server\timelineservice\storage\flow\AggregationCompactionDimension.java,0,11,1,1,0,13
hadoop-trunk\hadoop-trunk\hadoop-common-project\hadoop-common\src\main\java\org\apache\hadoop\security\IngressPortBasedResolver.java,51,9,5,1,0,15
hadoop-trunk\hadoop-trunk\hadoop-hdfs-project\hadoop-hdfs\src\main\java\org\apache\hadoop\hdfs\server\common\sps\BlocksMovementsStatusHandler.java,0,0,0,1,0,1
hadoop-trunk\hadoop-trunk\hadoop-yarn-project\hadoop-yarn\hadoop-yarn-server\hadoop-yarn-server-resourcemanager\src\main\java\org\apache\hadoop\yarn\server\resourcemanager\webapp\RMWebAppUtil.java,0,13,4,8,0,25
hadoop-trunk\hadoop-trunk\hadoop-common-project\hadoop-common\src\test\java\org\apache\hadoop\fs\TestLocatedFileStatus.java,23,1,6,1,0,8
hadoop-trunk\hadoop-trunk\hadoop-hdfs-project\hadoop-hdfs\src\test\java\org\apache\hadoop\hdfs\server\namenode\TestFileTruncate.java,1428,204,68,4,0,276
hadoop-trunk\hadoop-trunk\hadoop-tools\hadoop-azure-datalake\src\test\java\org\apache\hadoop\fs\adl\common\CustomMockTokenProvider.java,32,13,0,1,0,14
hadoop-trunk\hadoop-trunk\hadoop-common-project\hadoop-common\src\main\java\org\apache\hadoop\util\MachineList.java,156,35,8,3,0,46
hadoop-trunk\hadoop-trunk\hadoop-yarn-project\hadoop-yarn\hadoop-yarn-server\hadoop-yarn-server-resourcemanager\src\main\java\org\apache\hadoop\yarn\server\resourcemanager\scheduler\capacity\CSQueueStore.java,260,15,1,1,0,17
hadoop-trunk\hadoop-trunk\hadoop-hdfs-project\hadoop-hdfs\src\main\java\org\apache\hadoop\hdfs\server\namenode\sps\BlockStorageMovementNeeded.java,304,43,4,1,0,48
hadoop-trunk\hadoop-trunk\hadoop-hdfs-project\hadoop-hdfs\src\main\java\org\apache\hadoop\hdfs\server\namenode\BackupNode.java,429,132,10,14,0,156
hadoop-trunk\hadoop-trunk\hadoop-yarn-project\hadoop-yarn\hadoop-yarn-api\src\main\java\org\apache\hadoop\yarn\exceptions\ApplicationIdNotProvidedException.java,17,10,0,1,0,11
hadoop-trunk\hadoop-trunk\hadoop-mapreduce-project\hadoop-mapreduce-client\hadoop-mapreduce-client-app\src\main\java\org\apache\hadoop\mapreduce\v2\app\rm\package-info.java,0,1,0,1,0,2
hadoop-trunk\hadoop-trunk\hadoop-yarn-project\hadoop-yarn\hadoop-yarn-server\hadoop-yarn-server-common\src\main\java\org\apache\hadoop\yarn\server\federation\store\records\SetSubClusterPolicyConfigurationRequest.java,31,2,0,1,0,3
hadoop-trunk\hadoop-trunk\hadoop-yarn-project\hadoop-yarn\hadoop-yarn-server\hadoop-yarn-server-resourcemanager\src\main\java\org\apache\hadoop\yarn\server\resourcemanager\rmapp\RMAppImpl.java,0,396,36,24,0,456
hadoop-trunk\hadoop-trunk\hadoop-yarn-project\hadoop-yarn\hadoop-yarn-common\src\test\java\org\apache\hadoop\yarn\conf\TestHAUtil.java,180,25,2,3,0,30
hadoop-trunk\hadoop-trunk\hadoop-common-project\hadoop-common\src\main\java\org\apache\hadoop\ha\ShellCommandFencer.java,0,44,9,1,0,54
hadoop-trunk\hadoop-trunk\hadoop-tools\hadoop-aws\src\test\java\org\apache\hadoop\fs\contract\s3a\ITestS3AContractRename.java,85,13,0,2,0,15
hadoop-trunk\hadoop-trunk\hadoop-tools\hadoop-aws\src\main\java\org\apache\hadoop\fs\s3a\audit\impl\NoopAuditManagerS3A.java,0,11,2,2,0,15
hadoop-trunk\hadoop-trunk\hadoop-common-project\hadoop-common\src\main\java\org\apache\hadoop\security\authorize\Service.java,26,14,0,1,0,15
hadoop-trunk\hadoop-trunk\hadoop-yarn-project\hadoop-yarn\hadoop-yarn-server\hadoop-yarn-server-resourcemanager\src\main\java\org\apache\hadoop\yarn\server\resourcemanager\rmnode\RMNodeStatusEvent.java,57,35,0,1,0,36
hadoop-trunk\hadoop-trunk\hadoop-hdfs-project\hadoop-hdfs\src\main\java\org\apache\hadoop\hdfs\server\namenode\INodesInPath.java,492,96,10,8,0,114
hadoop-trunk\hadoop-trunk\hadoop-common-project\hadoop-common\src\test\java\org\apache\hadoop\fs\FileContextUtilBase.java,66,24,3,4,0,31
hadoop-trunk\hadoop-trunk\hadoop-hdfs-project\hadoop-hdfs\src\main\java\org\apache\hadoop\hdfs\server\namenode\startupprogress\package-info.java,0,7,0,3,0,10
hadoop-trunk\hadoop-trunk\hadoop-tools\hadoop-aws\src\test\java\org\apache\hadoop\fs\s3a\audit\TestAuditSpanLifecycle.java,99,9,0,1,0,10
hadoop-trunk\hadoop-trunk\hadoop-yarn-project\hadoop-yarn\hadoop-yarn-common\src\main\java\org\apache\hadoop\yarn\api\protocolrecords\impl\pb\GetContainersResponsePBImpl.java,144,24,42,3,0,69
hadoop-trunk\hadoop-trunk\hadoop-common-project\hadoop-common\src\main\java\org\apache\hadoop\io\compress\CompressionCodec.java,0,32,2,4,0,38
hadoop-trunk\hadoop-trunk\hadoop-common-project\hadoop-common\src\main\java\org\apache\hadoop\ipc\ProtocolMetaInterface.java,0,2,1,1,0,4
hadoop-trunk\hadoop-trunk\hadoop-mapreduce-project\hadoop-mapreduce-client\hadoop-mapreduce-client-core\src\main\java\org\apache\hadoop\mapred\lib\aggregate\ValueAggregatorJob.java,156,67,3,5,0,75
hadoop-trunk\hadoop-trunk\hadoop-tools\hadoop-resourceestimator\src\main\java\org\apache\hadoop\resourceestimator\skylinestore\validator\package-info.java,0,1,0,1,0,2
hadoop-trunk\hadoop-trunk\hadoop-hdfs-project\hadoop-hdfs-rbf\src\test\java\org\apache\hadoop\fs\contract\router\web\TestRouterWebHDFSContractSeek.java,33,7,0,1,0,8
hadoop-trunk\hadoop-trunk\hadoop-tools\hadoop-streaming\src\test\java\org\apache\hadoop\streaming\TestStreamingOutputOnlyKeys.java,28,8,0,1,0,9
hadoop-trunk\hadoop-trunk\hadoop-common-project\hadoop-common\src\main\java\org\apache\hadoop\security\token\delegation\web\DelegationTokenAuthenticator.java,301,81,13,3,0,97
hadoop-trunk\hadoop-trunk\hadoop-yarn-project\hadoop-yarn\hadoop-yarn-server\hadoop-yarn-server-common\src\main\java\org\apache\hadoop\yarn\server\federation\policies\manager\HashBroadcastPolicyManager.java,11,1,0,3,0,4
hadoop-trunk\hadoop-trunk\hadoop-common-project\hadoop-nfs\src\main\java\org\apache\hadoop\oncrpc\security\VerifierGSS.java,20,5,2,1,0,8
hadoop-trunk\hadoop-trunk\hadoop-tools\hadoop-dynamometer\hadoop-dynamometer-infra\src\test\java\org\apache\hadoop\tools\dynamometer\TestDynoInfraUtils.java,38,5,0,1,0,6
hadoop-trunk\hadoop-trunk\hadoop-tools\hadoop-aws\src\main\java\org\apache\hadoop\fs\s3a\impl\BulkDeleteRetryHandler.java,101,9,5,1,0,15
hadoop-trunk\hadoop-trunk\hadoop-yarn-project\hadoop-yarn\hadoop-yarn-api\src\main\java\org\apache\hadoop\yarn\api\records\ReservationDefinition.java,188,24,1,1,0,26
hadoop-trunk\hadoop-trunk\hadoop-yarn-project\hadoop-yarn\hadoop-yarn-server\hadoop-yarn-server-common\src\main\java\org\apache\hadoop\yarn\server\federation\policies\FederationPolicyInitializationContextValidator.java,0,3,0,2,0,5
hadoop-trunk\hadoop-trunk\hadoop-common-project\hadoop-common\src\test\java\org\apache\hadoop\fs\TestStat.java,128,50,3,4,0,57
hadoop-trunk\hadoop-trunk\hadoop-hdfs-project\hadoop-hdfs\src\test\java\org\apache\hadoop\cli\util\CacheAdminCmdExecutor.java,16,11,0,1,0,12
hadoop-trunk\hadoop-trunk\hadoop-mapreduce-project\hadoop-mapreduce-client\hadoop-mapreduce-client-common\src\main\java\org\apache\hadoop\mapreduce\v2\api\MRDelegationTokenIdentifier.java,33,14,2,3,0,19
hadoop-trunk\hadoop-trunk\hadoop-yarn-project\hadoop-yarn\hadoop-yarn-server\hadoop-yarn-server-timelineservice-documentstore\src\main\java\org\apache\hadoop\yarn\server\timelineservice\documentstore\collection\document\TimelineDocument.java,0,7,1,2,0,10
hadoop-trunk\hadoop-trunk\hadoop-yarn-project\hadoop-yarn\hadoop-yarn-common\src\main\java\org\apache\hadoop\yarn\api\protocolrecords\impl\pb\FinishApplicationMasterResponsePBImpl.java,61,27,29,7,0,63
hadoop-trunk\hadoop-trunk\hadoop-tools\hadoop-aws\src\test\java\org\apache\hadoop\fs\s3a\scale\S3AScaleTestBase.java,151,17,2,2,0,21
hadoop-trunk\hadoop-trunk\hadoop-hdfs-project\hadoop-hdfs-httpfs\src\test\java\org\apache\hadoop\lib\server\TestBaseService.java,43,10,1,3,0,14
hadoop-trunk\hadoop-trunk\hadoop-common-project\hadoop-common\src\test\java\org\apache\hadoop\security\ssl\TestReloadingX509KeyManager.java,167,50,12,17,0,79
hadoop-trunk\hadoop-trunk\hadoop-tools\hadoop-azure\src\main\java\org\apache\hadoop\fs\azure\CachingAuthorizer.java,0,51,3,4,0,58
hadoop-trunk\hadoop-trunk\hadoop-hdfs-project\hadoop-hdfs-client\src\main\java\org\apache\hadoop\hdfs\server\namenode\ha\IPFailoverProxyProvider.java,44,12,1,1,0,14
hadoop-trunk\hadoop-trunk\hadoop-yarn-project\hadoop-yarn\hadoop-yarn-api\src\main\java\org\apache\hadoop\yarn\api\records\SchedulingRequest.java,167,27,0,1,0,28
hadoop-trunk\hadoop-trunk\hadoop-yarn-project\hadoop-yarn\hadoop-yarn-server\hadoop-yarn-server-resourcemanager\src\test\java\org\apache\hadoop\yarn\server\resourcemanager\scheduler\fair\converter\weightconversion\TestWeightToWeightConverter.java,75,11,0,3,0,14
hadoop-trunk\hadoop-trunk\hadoop-hdfs-project\hadoop-hdfs-client\src\main\java\org\apache\hadoop\hdfs\DataStreamer.java,0,333,68,26,0,427
hadoop-trunk\hadoop-trunk\hadoop-yarn-project\hadoop-yarn\hadoop-yarn-server\hadoop-yarn-server-nodemanager\src\main\java\org\apache\hadoop\yarn\server\nodemanager\containermanager\container\ContainerEvent.java,15,6,0,1,0,7
hadoop-trunk\hadoop-trunk\hadoop-common-project\hadoop-common\src\main\java\org\apache\hadoop\metrics2\util\package-info.java,0,1,0,1,0,2
hadoop-trunk\hadoop-trunk\hadoop-mapreduce-project\hadoop-mapreduce-client\hadoop-mapreduce-client-jobclient\src\test\java\org\apache\hadoop\mapred\HadoopTestCase.java,176,30,8,7,0,45
hadoop-trunk\hadoop-trunk\hadoop-tools\hadoop-aws\src\main\java\org\apache\hadoop\fs\s3a\statistics\package-info.java,0,0,0,1,0,1
hadoop-trunk\hadoop-trunk\hadoop-hdfs-project\hadoop-hdfs-httpfs\src\main\java\org\apache\hadoop\fs\http\client\HttpFSFileSystem.java,0,415,30,31,0,476
hadoop-trunk\hadoop-trunk\hadoop-tools\hadoop-sls\src\test\java\org\apache\hadoop\yarn\sls\TestSLSGenericSynth.java,39,5,1,3,0,9
hadoop-trunk\hadoop-trunk\hadoop-tools\hadoop-azure\src\main\java\org\apache\hadoop\fs\azurebfs\oauth2\AccessTokenProvider.java,65,4,1,2,0,7
hadoop-trunk\hadoop-trunk\hadoop-yarn-project\hadoop-yarn\hadoop-yarn-server\hadoop-yarn-server-nodemanager\src\main\java\org\apache\hadoop\yarn\server\nodemanager\amrmproxy\AbstractRequestInterceptor.java,130,15,0,5,0,20
hadoop-trunk\hadoop-trunk\hadoop-tools\hadoop-resourceestimator\src\main\java\org\apache\hadoop\resourceestimator\translator\impl\NativeSingleLineParser.java,73,9,2,5,0,16
hadoop-trunk\hadoop-trunk\hadoop-common-project\hadoop-registry\src\main\java\org\apache\hadoop\registry\client\api\RegistryOperationsFactory.java,0,22,1,4,0,27
hadoop-trunk\hadoop-trunk\hadoop-yarn-project\hadoop-yarn\hadoop-yarn-server\hadoop-yarn-server-nodemanager\src\main\java\org\apache\hadoop\yarn\server\nodemanager\containermanager\localizer\LocalCacheCleaner.java,0,31,0,1,0,32
hadoop-trunk\hadoop-trunk\hadoop-mapreduce-project\hadoop-mapreduce-client\hadoop-mapreduce-client-nativetask\src\main\java\org\apache\hadoop\mapred\nativetask\NativeDataTarget.java,0,7,3,1,0,11
hadoop-trunk\hadoop-trunk\hadoop-yarn-project\hadoop-yarn\hadoop-yarn-server\hadoop-yarn-server-resourcemanager\src\main\java\org\apache\hadoop\yarn\server\resourcemanager\scheduler\event\AppAttemptRemovedSchedulerEvent.java,28,15,0,2,0,17
hadoop-trunk\hadoop-trunk\hadoop-common-project\hadoop-common\src\main\java\org\apache\hadoop\fs\InvalidRequestException.java,12,5,0,1,0,6
hadoop-trunk\hadoop-trunk\hadoop-hdfs-project\hadoop-hdfs-httpfs\src\main\java\org\apache\hadoop\lib\servlet\MDCFilter.java,0,6,2,3,0,11
hadoop-trunk\hadoop-trunk\hadoop-hdfs-project\hadoop-hdfs\src\test\java\org\apache\hadoop\hdfs\tools\TestDFSHAAdminMiniCluster.java,257,60,2,1,0,63
hadoop-trunk\hadoop-trunk\hadoop-mapreduce-project\hadoop-mapreduce-client\hadoop-mapreduce-client-app\src\main\java\org\apache\hadoop\mapreduce\v2\app\job\event\TaskTAttemptKilledEvent.java,16,7,0,1,0,8
hadoop-trunk\hadoop-trunk\hadoop-common-project\hadoop-common\src\main\java\org\apache\hadoop\ha\ActiveStandbyElector.java,0,175,26,5,0,206
hadoop-trunk\hadoop-trunk\hadoop-common-project\hadoop-common\src\main\java\org\apache\hadoop\fs\ContentSummary.java,455,175,4,1,0,180
hadoop-trunk\hadoop-trunk\hadoop-yarn-project\hadoop-yarn\hadoop-yarn-server\hadoop-yarn-server-timelineservice-hbase\hadoop-yarn-server-timelineservice-hbase-common\src\test\java\org\apache\hadoop\yarn\server\timelineservice\storage\common\TestRowKeysAsString.java,111,25,0,5,0,30
hadoop-trunk\hadoop-trunk\hadoop-common-project\hadoop-common\src\test\java\org\apache\hadoop\fs\shell\TestLs.java,1412,188,32,4,0,224
hadoop-trunk\hadoop-trunk\hadoop-hdfs-project\hadoop-hdfs\src\test\java\org\apache\hadoop\hdfs\AdminStatesBaseTest.java,410,125,13,1,0,139
hadoop-trunk\hadoop-trunk\hadoop-hdfs-project\hadoop-hdfs-rbf\src\test\java\org\apache\hadoop\fs\contract\router\TestRouterHDFSContractGetFileStatusSecure.java,0,4,0,1,0,5
hadoop-trunk\hadoop-trunk\hadoop-tools\hadoop-resourceestimator\src\main\java\org\apache\hadoop\resourceestimator\skylinestore\exceptions\EmptyResourceSkylineException.java,8,1,0,1,0,2
hadoop-trunk\hadoop-trunk\hadoop-yarn-project\hadoop-yarn\hadoop-yarn-common\src\main\java\org\apache\hadoop\yarn\client\RMProxy.java,250,65,9,1,0,75
hadoop-trunk\hadoop-trunk\hadoop-common-project\hadoop-common\src\main\java\org\apache\hadoop\io\erasurecode\coder\HHXORErasureEncodingStep.java,117,20,0,1,0,21
hadoop-trunk\hadoop-trunk\hadoop-hdfs-project\hadoop-hdfs-rbf\src\main\java\org\apache\hadoop\hdfs\server\federation\resolver\FederationNamenodeServiceState.java,0,10,0,1,0,11
hadoop-trunk\hadoop-trunk\hadoop-cloud-storage-project\hadoop-huaweicloud\src\main\java\org\apache\hadoop\fs\obs\OBSFileStatus.java,0,0,0,1,0,1
hadoop-trunk\hadoop-trunk\hadoop-common-project\hadoop-kms\src\main\java\org\apache\hadoop\crypto\key\kms\server\KMSWebApp.java,210,58,6,1,0,65
hadoop-trunk\hadoop-trunk\hadoop-mapreduce-project\hadoop-mapreduce-client\hadoop-mapreduce-client-nativetask\src\test\java\org\apache\hadoop\mapred\nativetask\handlers\TestCombineHandler.java,50,15,1,5,0,21
hadoop-trunk\hadoop-trunk\hadoop-yarn-project\hadoop-yarn\hadoop-yarn-server\hadoop-yarn-server-resourcemanager\src\main\java\org\apache\hadoop\yarn\server\resourcemanager\webapp\dao\ApplicationStatisticsInfo.java,18,9,4,1,0,14
hadoop-trunk\hadoop-trunk\hadoop-hdfs-project\hadoop-hdfs\src\main\java\org\apache\hadoop\hdfs\HdfsDtFetcher.java,43,10,0,1,0,11
hadoop-trunk\hadoop-trunk\hadoop-hdfs-project\hadoop-hdfs\src\main\java\org\apache\hadoop\hdfs\qjournal\protocol\RequestInfo.java,50,38,1,1,0,40
hadoop-trunk\hadoop-trunk\hadoop-mapreduce-project\hadoop-mapreduce-client\hadoop-mapreduce-client-app\src\main\java\org\apache\hadoop\mapreduce\v2\app\job\event\JobCommitCompletedEvent.java,7,2,0,1,0,3
hadoop-trunk\hadoop-trunk\hadoop-yarn-project\hadoop-yarn\hadoop-yarn-api\src\main\java\org\apache\hadoop\yarn\server\api\protocolrecords\RunSharedCacheCleanerTaskResponse.java,24,4,0,1,0,5
hadoop-trunk\hadoop-trunk\hadoop-hdfs-project\hadoop-hdfs-httpfs\src\main\java\org\apache\hadoop\fs\http\server\CheckUploadContentTypeFilter.java,74,9,4,2,0,15
hadoop-trunk\hadoop-trunk\hadoop-yarn-project\hadoop-yarn\hadoop-yarn-server\hadoop-yarn-server-nodemanager\src\main\java\org\apache\hadoop\yarn\server\nodemanager\nodelabels\package-info.java,0,0,0,1,0,1
hadoop-trunk\hadoop-trunk\hadoop-yarn-project\hadoop-yarn\hadoop-yarn-server\hadoop-yarn-server-resourcemanager\src\test\java\org\apache\hadoop\yarn\server\resourcemanager\scheduler\fair\TestFairSchedulerUtilities.java,39,3,0,2,0,5
hadoop-trunk\hadoop-trunk\hadoop-tools\hadoop-aws\src\main\java\org\apache\hadoop\fs\s3a\commit\MagicCommitIntegration.java,141,20,2,1,0,23
hadoop-trunk\hadoop-trunk\hadoop-yarn-project\hadoop-yarn\hadoop-yarn-server\hadoop-yarn-server-timelineservice-hbase\hadoop-yarn-server-timelineservice-hbase-common\src\main\java\org\apache\hadoop\yarn\server\timelineservice\storage\domain\DomainTable.java,0,0,0,1,0,1
hadoop-trunk\hadoop-trunk\hadoop-hdfs-project\hadoop-hdfs-rbf\src\main\java\org\apache\hadoop\hdfs\server\federation\resolver\NamenodeStatusReport.java,544,73,0,3,0,76
hadoop-trunk\hadoop-trunk\hadoop-common-project\hadoop-common\src\test\java\org\apache\hadoop\fs\FileContextCreateMkdirBaseTest.java,179,50,4,1,0,55
hadoop-trunk\hadoop-trunk\hadoop-hdfs-project\hadoop-hdfs\src\main\java\org\apache\hadoop\hdfs\qjournal\server\JournalMetrics.java,0,56,0,2,0,58
hadoop-trunk\hadoop-trunk\hadoop-yarn-project\hadoop-yarn\hadoop-yarn-server\hadoop-yarn-server-nodemanager\src\test\java\org\apache\hadoop\yarn\server\nodemanager\TestNodeStatusUpdater.java,1880,467,70,50,0,587
hadoop-trunk\hadoop-trunk\hadoop-tools\hadoop-azure\src\main\java\org\apache\hadoop\fs\azurebfs\services\AbfsStreamContext.java,16,6,1,2,0,9
hadoop-trunk\hadoop-trunk\hadoop-hdfs-project\hadoop-hdfs\src\main\java\org\apache\hadoop\hdfs\server\protocol\NamespaceInfo.java,156,116,2,1,0,119
hadoop-trunk\hadoop-trunk\hadoop-yarn-project\hadoop-yarn\hadoop-yarn-applications\hadoop-yarn-applications-catalog\hadoop-yarn-applications-catalog-webapp\src\test\java\org\apache\hadoop\yarn\appcatalog\controller\AppListControllerTest.java,56,8,5,1,0,14
hadoop-trunk\hadoop-trunk\hadoop-hdfs-project\hadoop-hdfs\src\main\java\org\apache\hadoop\hdfs\server\namenode\Checkpointer.java,0,68,12,6,0,86
hadoop-trunk\hadoop-trunk\hadoop-yarn-project\hadoop-yarn\hadoop-yarn-server\hadoop-yarn-server-applicationhistoryservice\src\test\java\org\apache\hadoop\yarn\server\timeline\TimelineStoreTestUtils.java,987,370,29,10,0,409
hadoop-trunk\hadoop-trunk\hadoop-hdfs-project\hadoop-hdfs-nfs\src\test\java\org\apache\hadoop\hdfs\nfs\nfs3\TestViewfsWithNfs3.java,266,50,18,1,0,69
hadoop-trunk\hadoop-trunk\hadoop-yarn-project\hadoop-yarn\hadoop-yarn-server\hadoop-yarn-server-resourcemanager\src\main\java\org\apache\hadoop\yarn\server\resourcemanager\scheduler\AppSchedulingInfo.java,816,178,19,13,0,210
hadoop-trunk\hadoop-trunk\hadoop-yarn-project\hadoop-yarn\hadoop-yarn-api\src\main\java\org\apache\hadoop\yarn\api\resource\package-info.java,0,0,0,1,0,1
hadoop-trunk\hadoop-trunk\hadoop-hdfs-project\hadoop-hdfs-client\src\main\java\org\apache\hadoop\hdfs\protocol\SnapshotDiffReportListing.java,128,57,0,1,0,58
hadoop-trunk\hadoop-trunk\hadoop-hdfs-project\hadoop-hdfs-rbf\src\main\java\org\apache\hadoop\hdfs\server\federation\store\protocol\EnterSafeModeRequest.java,6,2,0,2,0,4
hadoop-trunk\hadoop-trunk\hadoop-mapreduce-project\hadoop-mapreduce-examples\src\main\java\org\apache\hadoop\examples\terasort\Random16.java,0,83,2,2,0,87
hadoop-trunk\hadoop-trunk\hadoop-common-project\hadoop-nfs\src\main\java\org\apache\hadoop\nfs\nfs3\response\COMMIT3Response.java,43,22,0,1,0,23
hadoop-trunk\hadoop-trunk\hadoop-yarn-project\hadoop-yarn\hadoop-yarn-common\src\test\java\org\apache\hadoop\yarn\nodelabels\TestCommonNodeLabelsManager.java,595,83,37,14,0,134
hadoop-trunk\hadoop-trunk\hadoop-yarn-project\hadoop-yarn\hadoop-yarn-server\hadoop-yarn-server-nodemanager\src\main\java\org\apache\hadoop\yarn\server\nodemanager\containermanager\resourceplugin\deviceframework\ShellWrapper.java,19,6,1,2,0,9
hadoop-trunk\hadoop-trunk\hadoop-mapreduce-project\hadoop-mapreduce-client\hadoop-mapreduce-client-jobclient\src\test\java\org\apache\hadoop\mapreduce\lib\partition\TestMRKeyFieldBasedPartitioner.java,103,19,0,2,0,21
hadoop-trunk\hadoop-trunk\hadoop-yarn-project\hadoop-yarn\hadoop-yarn-server\hadoop-yarn-server-nodemanager\src\test\java\org\apache\hadoop\yarn\server\nodemanager\util\TestCgroupsLCEResourcesHandler.java,379,58,5,2,0,65
hadoop-trunk\hadoop-trunk\hadoop-yarn-project\hadoop-yarn\hadoop-yarn-server\hadoop-yarn-server-timelineservice-hbase-tests\src\test\java\org\apache\hadoop\yarn\server\timelineservice\reader\TestTimelineReaderWebServicesHBaseStorage.java,0,890,93,6,0,989
hadoop-trunk\hadoop-trunk\hadoop-yarn-project\hadoop-yarn\hadoop-yarn-common\src\main\java\org\apache\hadoop\yarn\server\api\ResourceManagerAdministrationProtocolPB.java,0,3,2,4,0,9
hadoop-trunk\hadoop-trunk\hadoop-mapreduce-project\hadoop-mapreduce-client\hadoop-mapreduce-client-core\src\main\java\org\apache\hadoop\mapreduce\server\jobtracker\JTConfig.java,0,42,18,2,0,62
hadoop-trunk\hadoop-trunk\hadoop-hdfs-project\hadoop-hdfs\src\test\java\org\apache\hadoop\hdfs\TestDFSMkdirs.java,118,14,5,4,0,23
hadoop-trunk\hadoop-trunk\hadoop-yarn-project\hadoop-yarn\hadoop-yarn-common\src\main\java\org\apache\hadoop\yarn\nodelabels\NodeAttributeStore.java,0,0,0,1,0,1
hadoop-trunk\hadoop-trunk\hadoop-tools\hadoop-aws\src\test\java\org\apache\hadoop\fs\s3a\commit\AbstractITCommitProtocol.java,1708,137,22,8,0,167
hadoop-trunk\hadoop-trunk\hadoop-common-project\hadoop-common\src\main\java\org\apache\hadoop\io\serializer\avro\AvroReflectSerialization.java,56,18,5,1,0,24
hadoop-trunk\hadoop-trunk\hadoop-tools\hadoop-azure\src\test\java\org\apache\hadoop\fs\azurebfs\ITestAzureBlobFileSystemCreate.java,426,37,6,14,0,57
hadoop-trunk\hadoop-trunk\hadoop-tools\hadoop-resourceestimator\src\main\java\org\apache\hadoop\resourceestimator\skylinestore\exceptions\NullRecurrenceIdException.java,8,1,0,1,0,2
hadoop-trunk\hadoop-trunk\hadoop-mapreduce-project\hadoop-mapreduce-client\hadoop-mapreduce-client-jobclient\src\test\java\org\apache\hadoop\mapred\TestUtils.java,55,8,1,1,0,10
hadoop-trunk\hadoop-trunk\hadoop-yarn-project\hadoop-yarn\hadoop-yarn-server\hadoop-yarn-server-nodemanager\src\main\java\org\apache\hadoop\yarn\server\nodemanager\containermanager\localizer\event\LocalizerEventType.java,0,1,0,2,0,3
hadoop-trunk\hadoop-trunk\hadoop-hdfs-project\hadoop-hdfs-rbf\src\main\java\org\apache\hadoop\hdfs\server\federation\store\protocol\impl\pb\EnterSafeModeRequestPBImpl.java,0,9,23,5,0,37
hadoop-trunk\hadoop-trunk\hadoop-mapreduce-project\hadoop-mapreduce-client\hadoop-mapreduce-client-common\src\main\java\org\apache\hadoop\mapreduce\v2\api\protocolrecords\KillTaskAttemptResponse.java,0,0,0,1,0,1
hadoop-trunk\hadoop-trunk\hadoop-mapreduce-project\hadoop-mapreduce-client\hadoop-mapreduce-client-core\src\main\java\org\apache\hadoop\mapred\Task.java,0,794,85,23,0,902
hadoop-trunk\hadoop-trunk\hadoop-yarn-project\hadoop-yarn\hadoop-yarn-server\hadoop-yarn-server-resourcemanager\src\main\java\org\apache\hadoop\yarn\server\resourcemanager\scheduler\capacity\UsersManager.java,1092,190,17,6,0,213
hadoop-trunk\hadoop-trunk\hadoop-yarn-project\hadoop-yarn\hadoop-yarn-server\hadoop-yarn-server-resourcemanager\src\main\java\org\apache\hadoop\yarn\server\resourcemanager\scheduler\constraint\algorithm\package-info.java,0,0,0,2,0,2
hadoop-trunk\hadoop-trunk\hadoop-common-project\hadoop-common\src\main\java\org\apache\hadoop\util\functional\BiFunctionRaisingIOE.java,0,0,0,1,0,1
hadoop-trunk\hadoop-trunk\hadoop-yarn-project\hadoop-yarn\hadoop-yarn-common\src\main\java\org\apache\hadoop\yarn\api\protocolrecords\impl\pb\ReservationListResponsePBImpl.java,121,20,36,4,0,60
hadoop-trunk\hadoop-trunk\hadoop-common-project\hadoop-common\src\main\java\org\apache\hadoop\io\erasurecode\rawcoder\NativeRSRawEncoder.java,48,10,0,1,0,11
hadoop-trunk\hadoop-trunk\hadoop-mapreduce-project\hadoop-mapreduce-examples\src\main\java\org\apache\hadoop\examples\terasort\TeraSort.java,300,123,4,1,0,128
hadoop-trunk\hadoop-trunk\hadoop-hdfs-project\hadoop-hdfs\src\main\java\org\apache\hadoop\hdfs\server\blockmanagement\BlockPlacementStatusWithUpgradeDomain.java,78,21,1,1,0,23
hadoop-trunk\hadoop-trunk\hadoop-yarn-project\hadoop-yarn\hadoop-yarn-common\src\main\java\org\apache\hadoop\yarn\server\api\protocolrecords\impl\pb\NodeToAttributesPBImpl.java,132,19,34,1,0,54
hadoop-trunk\hadoop-trunk\hadoop-common-project\hadoop-common\src\test\java\org\apache\hadoop\fs\viewfs\TestViewFsTrash.java,41,19,0,7,0,26
hadoop-trunk\hadoop-trunk\hadoop-common-project\hadoop-common\src\test\java\org\apache\hadoop\security\alias\TestCredShell.java,260,51,3,8,0,62
hadoop-trunk\hadoop-trunk\hadoop-yarn-project\hadoop-yarn\hadoop-yarn-client\src\main\java\org\apache\hadoop\yarn\client\cli\RMAdminCLI.java,957,120,16,20,0,156
hadoop-trunk\hadoop-trunk\hadoop-common-project\hadoop-common\src\main\java\org\apache\hadoop\fs\impl\FunctionsRaisingIOE.java,0,6,1,4,0,11
hadoop-trunk\hadoop-trunk\hadoop-common-project\hadoop-registry\src\main\java\org\apache\hadoop\registry\client\api\DNSOperationsFactory.java,0,5,0,1,0,6
hadoop-trunk\hadoop-trunk\hadoop-mapreduce-project\hadoop-mapreduce-client\hadoop-mapreduce-client-hs\src\main\java\org\apache\hadoop\mapreduce\v2\hs\client\HSAdmin.java,317,30,0,9,0,39
hadoop-trunk\hadoop-trunk\hadoop-yarn-project\hadoop-yarn\hadoop-yarn-server\hadoop-yarn-server-resourcemanager\src\test\java\org\apache\hadoop\yarn\server\resourcemanager\scheduler\capacity\TestApplicationLimits.java,929,348,52,35,0,435
hadoop-trunk\hadoop-trunk\hadoop-common-project\hadoop-common\src\main\java\org\apache\hadoop\util\VersionUtil.java,19,4,0,1,0,5
hadoop-trunk\hadoop-trunk\hadoop-mapreduce-project\hadoop-mapreduce-client\hadoop-mapreduce-client-core\src\main\java\org\apache\hadoop\mapred\lib\aggregate\StringValueMin.java,0,3,0,1,0,4
hadoop-trunk\hadoop-trunk\hadoop-yarn-project\hadoop-yarn\hadoop-yarn-server\hadoop-yarn-server-common\src\main\java\org\apache\hadoop\yarn\server\federation\store\records\impl\pb\ApplicationHomeSubClusterPBImpl.java,131,27,44,5,0,76
hadoop-trunk\hadoop-trunk\hadoop-yarn-project\hadoop-yarn\hadoop-yarn-server\hadoop-yarn-server-nodemanager\src\main\java\org\apache\hadoop\yarn\server\nodemanager\api\protocolrecords\LocalizerAction.java,0,3,0,1,0,4
hadoop-trunk\hadoop-trunk\hadoop-yarn-project\hadoop-yarn\hadoop-yarn-server\hadoop-yarn-server-resourcemanager\src\main\java\org\apache\hadoop\yarn\server\resourcemanager\scheduler\fair\FSSchedulerNode.java,241,55,5,2,0,62
hadoop-trunk\hadoop-trunk\hadoop-yarn-project\hadoop-yarn\hadoop-yarn-server\hadoop-yarn-server-sharedcachemanager\src\test\java\org\apache\hadoop\yarn\server\sharedcachemanager\TestSharedCacheUploaderService.java,136,18,3,4,0,25
hadoop-trunk\hadoop-trunk\hadoop-common-project\hadoop-common\src\main\java\org\apache\hadoop\security\Groups.java,429,83,10,11,0,104
hadoop-trunk\hadoop-trunk\hadoop-yarn-project\hadoop-yarn\hadoop-yarn-server\hadoop-yarn-server-resourcemanager\src\main\java\org\apache\hadoop\yarn\server\resourcemanager\webapp\dao\CapacitySchedulerHealthInfo.java,105,47,3,2,0,52
hadoop-trunk\hadoop-trunk\hadoop-mapreduce-project\hadoop-mapreduce-client\hadoop-mapreduce-client-common\src\main\java\org\apache\hadoop\mapreduce\v2\api\protocolrecords\impl\pb\GetTaskAttemptCompletionEventsResponsePBImpl.java,144,53,41,15,0,109
hadoop-trunk\hadoop-trunk\hadoop-common-project\hadoop-kms\src\main\java\org\apache\hadoop\crypto\key\kms\server\KMSServerJSONUtils.java,40,9,10,1,0,20
hadoop-trunk\hadoop-trunk\hadoop-yarn-project\hadoop-yarn\hadoop-yarn-server\hadoop-yarn-server-applicationhistoryservice\src\test\java\org\apache\hadoop\yarn\server\timeline\TestGenericObjectMapper.java,68,36,2,1,0,39
hadoop-trunk\hadoop-trunk\hadoop-common-project\hadoop-common\src\main\java\org\apache\hadoop\io\erasurecode\rawcoder\RSRawErasureCoderFactory.java,25,7,0,1,0,8
hadoop-trunk\hadoop-trunk\hadoop-mapreduce-project\hadoop-mapreduce-client\hadoop-mapreduce-client-common\src\main\java\org\apache\hadoop\mapreduce\v2\api\protocolrecords\KillTaskRequest.java,0,7,2,1,0,10
hadoop-trunk\hadoop-trunk\hadoop-yarn-project\hadoop-yarn\hadoop-yarn-applications\hadoop-yarn-services\hadoop-yarn-services-core\src\main\java\org\apache\hadoop\yarn\service\exceptions\SliderException.java,44,18,0,1,0,19
hadoop-trunk\hadoop-trunk\hadoop-yarn-project\hadoop-yarn\hadoop-yarn-server\hadoop-yarn-server-resourcemanager\src\main\java\org\apache\hadoop\yarn\server\resourcemanager\webapp\dao\DelegationToken.java,73,62,1,1,0,64
hadoop-trunk\hadoop-trunk\hadoop-mapreduce-project\hadoop-mapreduce-client\hadoop-mapreduce-client-app\src\test\java\org\apache\hadoop\mapreduce\v2\app\metrics\TestMRAppMetrics.java,96,26,2,1,0,29
hadoop-trunk\hadoop-trunk\hadoop-yarn-project\hadoop-yarn\hadoop-yarn-server\hadoop-yarn-server-resourcemanager\src\test\java\org\apache\hadoop\yarn\server\resourcemanager\scheduler\TestQueueMetricsForCustomResources.java,607,112,6,23,0,141
hadoop-trunk\hadoop-trunk\hadoop-yarn-project\hadoop-yarn\hadoop-yarn-server\hadoop-yarn-server-resourcemanager\src\main\java\org\apache\hadoop\yarn\server\resourcemanager\metrics\NoOpSystemMetricPublisher.java,46,26,10,2,0,38
hadoop-trunk\hadoop-trunk\hadoop-common-project\hadoop-common\src\test\java\org\apache\hadoop\fs\shell\find\TestHelper.java,0,9,2,1,0,12
hadoop-trunk\hadoop-trunk\hadoop-hdfs-project\hadoop-hdfs\src\main\java\org\apache\hadoop\hdfs\server\common\BlockAlias.java,0,1,0,1,0,2
hadoop-trunk\hadoop-trunk\hadoop-mapreduce-project\hadoop-mapreduce-examples\src\main\java\org\apache\hadoop\examples\RandomTextWriter.java,682,139,7,3,0,149
hadoop-trunk\hadoop-trunk\hadoop-tools\hadoop-aws\src\test\java\org\apache\hadoop\fs\s3a\MultipartTestUtils.java,0,43,6,1,0,50
hadoop-trunk\hadoop-trunk\hadoop-common-project\hadoop-common\src\main\java\org\apache\hadoop\net\SocksSocketFactory.java,120,40,8,2,0,50
hadoop-trunk\hadoop-trunk\hadoop-yarn-project\hadoop-yarn\hadoop-yarn-server\hadoop-yarn-server-timelineservice\src\main\java\org\apache\hadoop\yarn\server\timelineservice\collector\TimelineCollectorContext.java,51,20,0,1,0,21
hadoop-trunk\hadoop-trunk\hadoop-hdfs-project\hadoop-hdfs\src\test\java\org\apache\hadoop\hdfs\server\namenode\snapshot\TestSetQuotaWithSnapshot.java,116,33,1,2,0,36
hadoop-trunk\hadoop-trunk\hadoop-common-project\hadoop-common\src\test\java\org\apache\hadoop\io\file\tfile\TestTFileComparator2.java,73,34,1,1,0,36
hadoop-trunk\hadoop-trunk\hadoop-mapreduce-project\hadoop-mapreduce-client\hadoop-mapreduce-client-core\src\main\java\org\apache\hadoop\mapreduce\util\ProcessTree.java,313,84,12,1,0,97
hadoop-trunk\hadoop-trunk\hadoop-yarn-project\hadoop-yarn\hadoop-yarn-server\hadoop-yarn-server-resourcemanager\src\test\java\org\apache\hadoop\yarn\server\resourcemanager\webapp\ActivitiesTestUtils.java,0,70,5,3,0,78
hadoop-trunk\hadoop-trunk\hadoop-yarn-project\hadoop-yarn\hadoop-yarn-server\hadoop-yarn-server-timelineservice\src\main\java\org\apache\hadoop\yarn\server\timelineservice\reader\filter\TimelineExistsFilter.java,79,23,1,1,0,25
hadoop-trunk\hadoop-trunk\hadoop-cloud-storage-project\hadoop-cos\src\test\java\org\apache\hadoop\fs\cosn\TestCosNOutputStream.java,52,11,2,1,0,14
hadoop-trunk\hadoop-trunk\hadoop-mapreduce-project\hadoop-mapreduce-client\hadoop-mapreduce-client-nativetask\src\main\java\org\apache\hadoop\mapred\nativetask\serde\LongWritableSerializer.java,7,4,0,1,0,5
hadoop-trunk\hadoop-trunk\hadoop-yarn-project\hadoop-yarn\hadoop-yarn-server\hadoop-yarn-server-resourcemanager\src\test\java\org\apache\hadoop\yarn\server\resourcemanager\scheduler\capacity\TestAMAllocatedToNonExclusivePartition.java,76,10,1,9,0,20
hadoop-trunk\hadoop-trunk\hadoop-common-project\hadoop-common\src\test\java\org\apache\hadoop\util\TestShutdownThreadsHelper.java,34,4,0,1,0,5
hadoop-trunk\hadoop-trunk\hadoop-hdfs-project\hadoop-hdfs-rbf\src\main\java\org\apache\hadoop\hdfs\server\federation\store\protocol\DisableNameserviceRequest.java,21,5,0,2,0,7
hadoop-trunk\hadoop-trunk\hadoop-tools\hadoop-rumen\src\main\java\org\apache\hadoop\tools\rumen\state\State.java,0,12,2,1,0,15
hadoop-trunk\hadoop-trunk\hadoop-hdfs-project\hadoop-hdfs\src\test\java\org\apache\hadoop\hdfs\tools\TestStoragePolicySatisfyAdminCommands.java,0,19,0,1,0,20
hadoop-trunk\hadoop-trunk\hadoop-common-project\hadoop-common\src\test\java\org\apache\hadoop\security\TestLdapGroupsMappingWithFailover.java,0,2,0,3,0,5
hadoop-trunk\hadoop-trunk\hadoop-common-project\hadoop-common\src\test\java\org\apache\hadoop\conf\TestStorageUnit.java,247,173,0,1,0,174
hadoop-trunk\hadoop-trunk\hadoop-mapreduce-project\hadoop-mapreduce-client\hadoop-mapreduce-client-core\src\main\java\org\apache\hadoop\mapreduce\lib\join\Parser.java,493,158,26,6,0,190
hadoop-trunk\hadoop-trunk\hadoop-yarn-project\hadoop-yarn\hadoop-yarn-common\src\main\java\org\apache\hadoop\yarn\api\protocolrecords\impl\pb\GetContainersRequestPBImpl.java,103,24,34,3,0,61
hadoop-trunk\hadoop-trunk\hadoop-tools\hadoop-openstack\src\main\java\org\apache\hadoop\fs\swift\http\HttpBodyContent.java,24,13,0,2,0,15
hadoop-trunk\hadoop-trunk\hadoop-hdfs-project\hadoop-hdfs-rbf\src\main\java\org\apache\hadoop\hdfs\server\federation\resolver\order\OrderedResolver.java,0,1,0,1,0,2
hadoop-trunk\hadoop-trunk\hadoop-common-project\hadoop-minikdc\src\main\java\org\apache\hadoop\minikdc\MiniKdc.java,355,55,8,1,0,64
hadoop-trunk\hadoop-trunk\hadoop-common-project\hadoop-common\src\main\java\org\apache\hadoop\io\retry\RetryProxy.java,80,30,1,4,0,35
hadoop-trunk\hadoop-trunk\hadoop-mapreduce-project\hadoop-mapreduce-client\hadoop-mapreduce-client-app\src\main\java\org\apache\hadoop\mapreduce\v2\app\speculate\SpeculatorEvent.java,0,33,1,3,0,37
hadoop-trunk\hadoop-trunk\hadoop-yarn-project\hadoop-yarn\hadoop-yarn-server\hadoop-yarn-server-common\src\main\java\org\apache\hadoop\yarn\server\federation\policies\dao\WeightedPolicyInfo.java,196,17,2,2,0,21
hadoop-trunk\hadoop-trunk\hadoop-yarn-project\hadoop-yarn\hadoop-yarn-client\src\test\java\org\apache\hadoop\yarn\client\api\async\impl\TestNMClientAsync.java,858,161,13,1,0,175
hadoop-trunk\hadoop-trunk\hadoop-common-project\hadoop-common\src\test\java\org\apache\hadoop\security\TestWhitelistBasedResolver.java,138,68,26,26,0,120
hadoop-trunk\hadoop-trunk\hadoop-common-project\hadoop-common\src\test\arm-java\org\apache\hadoop\ipc\protobuf\TestRpcServiceProtosLegacy.java,0,1971,919,771,0,3661
hadoop-trunk\hadoop-trunk\hadoop-tools\hadoop-sls\src\main\java\org\apache\hadoop\yarn\sls\appmaster\StreamAMSimulator.java,212,38,8,1,0,47
hadoop-trunk\hadoop-trunk\hadoop-cloud-storage-project\hadoop-huaweicloud\src\main\java\org\apache\hadoop\fs\obs\OBSClientFactory.java,0,0,0,1,0,1
hadoop-trunk\hadoop-trunk\hadoop-yarn-project\hadoop-yarn\hadoop-yarn-server\hadoop-yarn-server-timelineservice-hbase\hadoop-yarn-server-timelineservice-hbase-common\src\main\java\org\apache\hadoop\yarn\server\timelineservice\storage\application\ApplicationColumnFamily.java,0,3,1,2,0,6
hadoop-trunk\hadoop-trunk\hadoop-common-project\hadoop-common\src\test\java\org\apache\hadoop\io\nativeio\TestNativeIO.java,868,167,93,1,0,261
hadoop-trunk\hadoop-trunk\hadoop-yarn-project\hadoop-yarn\hadoop-yarn-server\hadoop-yarn-server-web-proxy\src\test\java\org\apache\hadoop\yarn\server\webproxy\TestAppReportFetcher.java,81,23,4,1,0,28
hadoop-trunk\hadoop-trunk\hadoop-common-project\hadoop-common\src\main\java\org\apache\hadoop\fs\FileSystem.java,0,595,51,15,0,661
hadoop-trunk\hadoop-trunk\hadoop-common-project\hadoop-common\src\test\java\org\apache\hadoop\fs\FileContextTestWrapper.java,0,92,3,3,0,98
hadoop-trunk\hadoop-trunk\hadoop-hdfs-project\hadoop-hdfs-rbf\src\main\java\org\apache\hadoop\hdfs\server\federation\fairness\RouterRpcFairnessConstants.java,9,0,1,1,0,2
hadoop-trunk\hadoop-trunk\hadoop-yarn-project\hadoop-yarn\hadoop-yarn-server\hadoop-yarn-server-resourcemanager\src\main\java\org\apache\hadoop\yarn\server\resourcemanager\webapp\CapacitySchedulerPage.java,0,104,3,18,0,125
hadoop-trunk\hadoop-trunk\hadoop-yarn-project\hadoop-yarn\hadoop-yarn-common\src\test\java\org\apache\hadoop\yarn\api\TestApplicatonReport.java,0,8,1,1,0,10
hadoop-trunk\hadoop-trunk\hadoop-hdfs-project\hadoop-hdfs\src\main\java\org\apache\hadoop\hdfs\server\blockmanagement\CorruptReplicasMap.java,235,61,8,1,0,70
hadoop-trunk\hadoop-trunk\hadoop-common-project\hadoop-common\src\test\java\org\apache\hadoop\security\TestProxyUserFromEnv.java,29,2,1,1,0,4
hadoop-trunk\hadoop-trunk\hadoop-common-project\hadoop-common\src\test\java\org\apache\hadoop\ipc\TestRpcServerHandoff.java,178,42,6,1,0,49
hadoop-trunk\hadoop-trunk\hadoop-mapreduce-project\hadoop-mapreduce-client\hadoop-mapreduce-client-common\src\main\java\org\apache\hadoop\mapreduce\v2\api\protocolrecords\GetTaskReportsRequest.java,0,14,4,1,0,19
hadoop-trunk\hadoop-trunk\hadoop-tools\hadoop-gridmix\src\main\java\org\apache\hadoop\mapred\gridmix\Statistics.java,0,81,8,2,0,91
hadoop-trunk\hadoop-trunk\hadoop-tools\hadoop-resourceestimator\src\main\java\org\apache\hadoop\resourceestimator\common\serialization\ResourceSerDe.java,0,2,1,1,0,4
hadoop-trunk\hadoop-trunk\hadoop-common-project\hadoop-common\src\test\java\org\apache\hadoop\fs\viewfs\TestViewFileSystemLocalFileSystem.java,87,7,1,1,0,9
hadoop-trunk\hadoop-trunk\hadoop-common-project\hadoop-nfs\src\main\java\org\apache\hadoop\oncrpc\security\VerifierNone.java,20,6,0,1,0,7
hadoop-trunk\hadoop-trunk\hadoop-tools\hadoop-azure\src\main\java\org\apache\hadoop\fs\azurebfs\diagnostics\ConfigurationBasicValidator.java,41,15,1,11,0,27
hadoop-trunk\hadoop-trunk\hadoop-yarn-project\hadoop-yarn\hadoop-yarn-common\src\test\java\org\apache\hadoop\yarn\webapp\test\WebAppTests.java,142,50,2,2,0,54
hadoop-trunk\hadoop-trunk\hadoop-common-project\hadoop-common\src\test\java\org\apache\hadoop\util\functional\TestRemoteIterators.java,425,50,3,2,0,55
hadoop-trunk\hadoop-trunk\hadoop-common-project\hadoop-common\src\main\java\org\apache\hadoop\fs\PathAccessDeniedException.java,18,9,0,1,0,10
hadoop-trunk\hadoop-trunk\hadoop-hdfs-project\hadoop-hdfs-client\src\test\java\org\apache\hadoop\hdfs\web\TestByteRangeInputStream.java,251,40,11,2,0,53
hadoop-trunk\hadoop-trunk\hadoop-common-project\hadoop-common\src\main\java\org\apache\hadoop\io\BloomMapFile.java,246,148,30,5,0,183
hadoop-trunk\hadoop-trunk\hadoop-hdfs-project\hadoop-hdfs-rbf\src\main\java\org\apache\hadoop\hdfs\server\federation\router\security\package-info.java,0,1,0,1,0,2
hadoop-trunk\hadoop-trunk\hadoop-common-project\hadoop-nfs\src\main\java\org\apache\hadoop\nfs\nfs3\response\RENAME3Response.java,38,21,0,1,0,22
hadoop-trunk\hadoop-trunk\hadoop-hdfs-project\hadoop-hdfs-rbf\src\main\java\org\apache\hadoop\hdfs\server\federation\store\protocol\impl\pb\GetDestinationResponsePBImpl.java,0,13,35,5,0,53
hadoop-trunk\hadoop-trunk\hadoop-yarn-project\hadoop-yarn\hadoop-yarn-server\hadoop-yarn-server-resourcemanager\src\test\java\org\apache\hadoop\yarn\server\resourcemanager\nodelabels\TestRMDelegatedNodeLabelsUpdater.java,118,24,1,2,0,27
hadoop-trunk\hadoop-trunk\hadoop-hdfs-project\hadoop-hdfs\src\test\java\org\apache\hadoop\hdfs\TestErasureCodingPolicies.java,910,106,32,4,0,142
hadoop-trunk\hadoop-trunk\hadoop-yarn-project\hadoop-yarn\hadoop-yarn-server\hadoop-yarn-server-resourcemanager\src\main\java\org\apache\hadoop\yarn\server\resourcemanager\webapp\dao\FairSchedulerQueueInfoList.java,20,10,2,1,0,13
hadoop-trunk\hadoop-trunk\hadoop-mapreduce-project\hadoop-mapreduce-client\hadoop-mapreduce-client-core\src\test\java\org\apache\hadoop\mapreduce\lib\output\committer\manifest\TestLoadManifestsStage.java,99,3,0,6,0,9
hadoop-trunk\hadoop-trunk\hadoop-mapreduce-project\hadoop-mapreduce-client\hadoop-mapreduce-client-core\src\main\java\org\apache\hadoop\mapred\LocatedFileStatusFetcher.java,401,71,7,9,0,87
hadoop-trunk\hadoop-trunk\hadoop-tools\hadoop-distcp\src\test\java\org\apache\hadoop\tools\mapred\TestUniformSizeInputFormat.java,139,51,4,6,0,61
hadoop-trunk\hadoop-trunk\hadoop-mapreduce-project\hadoop-mapreduce-client\hadoop-mapreduce-client-app\src\main\java\org\apache\hadoop\mapreduce\v2\app\commit\package-info.java,0,1,0,1,0,2
hadoop-trunk\hadoop-trunk\hadoop-yarn-project\hadoop-yarn\hadoop-yarn-applications\hadoop-yarn-services\hadoop-yarn-services-api\src\main\java\org\apache\hadoop\yarn\service\client\package-info.java,0,0,0,1,0,1
hadoop-trunk\hadoop-trunk\hadoop-yarn-project\hadoop-yarn\hadoop-yarn-server\hadoop-yarn-server-common\src\main\java\org\apache\hadoop\yarn\server\api\records\impl\pb\AppCollectorDataPBImpl.java,194,38,55,3,0,96
hadoop-trunk\hadoop-trunk\hadoop-common-project\hadoop-common\src\main\java\org\apache\hadoop\util\Waitable.java,30,17,0,1,0,18
hadoop-trunk\hadoop-trunk\hadoop-yarn-project\hadoop-yarn\hadoop-yarn-server\hadoop-yarn-server-nodemanager\src\test\java\org\apache\hadoop\yarn\server\nodemanager\containermanager\container\TestContainer.java,1533,349,26,33,0,408
hadoop-trunk\hadoop-trunk\hadoop-yarn-project\hadoop-yarn\hadoop-yarn-server\hadoop-yarn-server-nodemanager\src\main\java\org\apache\hadoop\yarn\server\nodemanager\api\impl\pb\ResourceLocalizationSpecPBImpl.java,89,18,34,3,0,55
hadoop-trunk\hadoop-trunk\hadoop-mapreduce-project\hadoop-mapreduce-client\hadoop-mapreduce-client-core\src\main\java\org\apache\hadoop\mapred\JobID.java,0,37,4,1,0,42
hadoop-trunk\hadoop-trunk\hadoop-mapreduce-project\hadoop-mapreduce-client\hadoop-mapreduce-client-jobclient\src\test\java\org\apache\hadoop\mapreduce\lib\chain\TestMapReduceChain.java,215,54,1,3,0,58
hadoop-trunk\hadoop-trunk\hadoop-hdfs-project\hadoop-hdfs-client\src\test\java\org\apache\hadoop\hdfs\TestDefaultNameNodePort.java,39,9,0,1,0,10
hadoop-trunk\hadoop-trunk\hadoop-tools\hadoop-streaming\src\test\java\org\apache\hadoop\streaming\TestAutoInputFormat.java,73,15,7,2,0,24
hadoop-trunk\hadoop-trunk\hadoop-tools\hadoop-azure\src\test\java\org\apache\hadoop\fs\azure\TestBlobOperationDescriptor.java,265,14,0,1,0,15
hadoop-trunk\hadoop-trunk\hadoop-yarn-project\hadoop-yarn\hadoop-yarn-api\src\main\java\org\apache\hadoop\yarn\api\protocolrecords\GetApplicationAttemptsRequest.java,32,9,0,2,0,11
hadoop-trunk\hadoop-trunk\hadoop-hdfs-project\hadoop-hdfs\src\test\java\org\apache\hadoop\hdfs\TestWriteReadStripedFile.java,286,70,5,2,0,77
hadoop-trunk\hadoop-trunk\hadoop-common-project\hadoop-common\src\test\java\org\apache\hadoop\util\TestLightWeightGSet.java,82,30,4,1,0,35
hadoop-trunk\hadoop-trunk\hadoop-tools\hadoop-openstack\src\main\java\org\apache\hadoop\fs\swift\auth\KeyStoneAuthRequest.java,32,14,0,3,0,17
hadoop-trunk\hadoop-trunk\hadoop-mapreduce-project\hadoop-mapreduce-client\hadoop-mapreduce-client-core\src\main\java\org\apache\hadoop\mapred\OutputLogFilter.java,8,5,0,1,0,6
hadoop-trunk\hadoop-trunk\hadoop-hdfs-project\hadoop-hdfs\src\test\java\org\apache\hadoop\hdfs\TestDatanodeConfig.java,126,20,3,1,0,24
hadoop-trunk\hadoop-trunk\hadoop-common-project\hadoop-common\src\main\java\org\apache\hadoop\fs\FsTracer.java,0,3,0,1,0,4
hadoop-trunk\hadoop-trunk\hadoop-common-project\hadoop-common\src\main\java\org\apache\hadoop\util\ServletUtil.java,68,29,2,3,0,34
hadoop-trunk\hadoop-trunk\hadoop-yarn-project\hadoop-yarn\hadoop-yarn-common\src\main\java\org\apache\hadoop\yarn\api\impl\pb\client\ContainerManagementProtocolPBClientImpl.java,214,35,33,32,0,100
hadoop-trunk\hadoop-trunk\hadoop-yarn-project\hadoop-yarn\hadoop-yarn-common\src\main\java\org\apache\hadoop\yarn\nodelabels\FileSystemNodeLabelsStore.java,0,15,0,1,0,16
hadoop-trunk\hadoop-trunk\hadoop-yarn-project\hadoop-yarn\hadoop-yarn-server\hadoop-yarn-server-resourcemanager\src\test\java\org\apache\hadoop\yarn\server\resourcemanager\placement\csmappingrule\TestMappingRuleValidationContextImpl.java,241,15,4,3,0,22
hadoop-trunk\hadoop-trunk\hadoop-mapreduce-project\hadoop-mapreduce-client\hadoop-mapreduce-client-app\src\test\java\org\apache\hadoop\mapreduce\v2\app\MockEventHandler.java,6,1,1,1,0,3
hadoop-trunk\hadoop-trunk\hadoop-hdfs-project\hadoop-hdfs\src\main\java\org\apache\hadoop\hdfs\server\namenode\startupprogress\AbstractTracking.java,16,9,0,2,0,11
hadoop-trunk\hadoop-trunk\hadoop-hdfs-project\hadoop-hdfs\src\test\java\org\apache\hadoop\hdfs\server\datanode\TestDataNodeMetrics.java,620,83,10,7,0,100
hadoop-trunk\hadoop-trunk\hadoop-hdfs-project\hadoop-hdfs-client\src\main\java\org\apache\hadoop\hdfs\ClientGSIContext.java,54,10,10,1,0,21
hadoop-trunk\hadoop-trunk\hadoop-mapreduce-project\hadoop-mapreduce-client\hadoop-mapreduce-client-nativetask\src\test\java\org\apache\hadoop\mapred\nativetask\testutil\MockValueClass.java,52,17,0,1,0,18
hadoop-trunk\hadoop-trunk\hadoop-yarn-project\hadoop-yarn\hadoop-yarn-common\src\test\java\org\apache\hadoop\yarn\logaggregation\TestAggregatedLogFormat.java,406,53,22,6,0,81
hadoop-trunk\hadoop-trunk\hadoop-common-project\hadoop-kms\src\main\java\org\apache\hadoop\crypto\key\kms\server\KMSJSONWriter.java,27,20,1,1,0,22
hadoop-trunk\hadoop-trunk\hadoop-common-project\hadoop-common\src\main\java\org\apache\hadoop\ha\SshFenceByTcpPort.java,0,54,10,2,0,66
hadoop-trunk\hadoop-trunk\hadoop-mapreduce-project\hadoop-mapreduce-client\hadoop-mapreduce-client-core\src\main\java\org\apache\hadoop\mapreduce\counters\CounterGroupBase.java,0,8,0,1,0,9
hadoop-trunk\hadoop-trunk\hadoop-yarn-project\hadoop-yarn\hadoop-yarn-server\hadoop-yarn-server-timelineservice-hbase\hadoop-yarn-server-timelineservice-hbase-common\src\main\java\org\apache\hadoop\yarn\server\timelineservice\storage\apptoflow\AppToFlowColumnPrefix.java,0,11,2,6,0,19
hadoop-trunk\hadoop-trunk\hadoop-yarn-project\hadoop-yarn\hadoop-yarn-server\hadoop-yarn-server-common\src\main\java\org\apache\hadoop\yarn\server\api\protocolrecords\impl\pb\DistributedSchedulingAllocateResponsePBImpl.java,154,24,43,4,0,71
hadoop-trunk\hadoop-trunk\hadoop-mapreduce-project\hadoop-mapreduce-client\hadoop-mapreduce-client-core\src\main\java\org\apache\hadoop\mapreduce\lib\input\KeyValueTextInputFormat.java,0,10,0,1,0,11
hadoop-trunk\hadoop-trunk\hadoop-mapreduce-project\hadoop-mapreduce-client\hadoop-mapreduce-client-jobclient\src\test\java\org\apache\hadoop\mapred\pipes\WordCountInputFormat.java,0,34,6,1,0,41
hadoop-trunk\hadoop-trunk\hadoop-mapreduce-project\hadoop-mapreduce-client\hadoop-mapreduce-client-core\src\main\java\org\apache\hadoop\mapred\QueueACL.java,0,11,2,1,0,14
hadoop-trunk\hadoop-trunk\hadoop-common-project\hadoop-nfs\src\main\java\org\apache\hadoop\nfs\nfs3\response\READDIRPLUS3Response.java,129,61,4,1,0,66
hadoop-trunk\hadoop-trunk\hadoop-mapreduce-project\hadoop-mapreduce-client\hadoop-mapreduce-client-app\src\main\java\org\apache\hadoop\mapreduce\v2\app\webapp\dao\ConfEntryInfo.java,32,25,1,1,0,27
hadoop-trunk\hadoop-trunk\hadoop-tools\hadoop-resourceestimator\src\main\java\org\apache\hadoop\resourceestimator\common\config\ResourceEstimatorUtil.java,0,7,4,2,0,13
hadoop-trunk\hadoop-trunk\hadoop-yarn-project\hadoop-yarn\hadoop-yarn-server\hadoop-yarn-server-nodemanager\src\test\java\org\apache\hadoop\yarn\server\nodemanager\containermanager\localizer\TestLocalResourcesTrackerImpl.java,924,70,16,26,0,112
hadoop-trunk\hadoop-trunk\hadoop-yarn-project\hadoop-yarn\hadoop-yarn-server\hadoop-yarn-server-nodemanager\src\main\java\org\apache\hadoop\yarn\server\nodemanager\containermanager\records\AuxServiceFile.java,104,32,2,1,0,35
hadoop-trunk\hadoop-trunk\hadoop-yarn-project\hadoop-yarn\hadoop-yarn-server\hadoop-yarn-server-resourcemanager\src\main\java\org\apache\hadoop\yarn\server\resourcemanager\ahs\WritingContainerFinishEvent.java,27,14,1,3,0,18
hadoop-trunk\hadoop-trunk\hadoop-yarn-project\hadoop-yarn\hadoop-yarn-server\hadoop-yarn-server-resourcemanager\src\test\java\org\apache\hadoop\yarn\server\resourcemanager\webapp\fairscheduler\FairSchedulerJsonVerifications.java,104,14,0,1,0,15
hadoop-trunk\hadoop-trunk\hadoop-common-project\hadoop-common\src\main\java\org\apache\hadoop\fs\permission\FsCreateModes.java,0,16,0,1,0,17
hadoop-trunk\hadoop-trunk\hadoop-tools\hadoop-distcp\src\test\java\org\apache\hadoop\tools\TestOptionsParser.java,0,86,30,18,0,134
hadoop-trunk\hadoop-trunk\hadoop-mapreduce-project\hadoop-mapreduce-client\hadoop-mapreduce-client-core\src\main\java\org\apache\hadoop\mapreduce\TaskAttemptID.java,0,90,6,2,0,98
hadoop-trunk\hadoop-trunk\hadoop-tools\hadoop-aws\src\main\java\org\apache\hadoop\fs\s3a\api\package-info.java,0,0,0,1,0,1
hadoop-trunk\hadoop-trunk\hadoop-yarn-project\hadoop-yarn\hadoop-yarn-common\src\main\java\org\apache\hadoop\yarn\api\protocolrecords\impl\pb\StartContainersRequestPBImpl.java,111,24,40,4,0,68
hadoop-trunk\hadoop-trunk\hadoop-yarn-project\hadoop-yarn\hadoop-yarn-server\hadoop-yarn-server-nodemanager\src\test\java\org\apache\hadoop\yarn\server\nodemanager\containermanager\linux\resources\DummyRunnableWithContext.java,8,4,4,2,0,10
hadoop-trunk\hadoop-trunk\hadoop-hdfs-project\hadoop-hdfs-rbf\src\test\java\org\apache\hadoop\hdfs\server\federation\router\TestRouterNetworkTopologyServlet.java,172,25,1,3,0,29
hadoop-trunk\hadoop-trunk\hadoop-yarn-project\hadoop-yarn\hadoop-yarn-server\hadoop-yarn-server-resourcemanager\src\test\java\org\apache\hadoop\yarn\server\resourcemanager\webapp\TestRMWebappAuthentication.java,213,24,4,7,0,35
hadoop-trunk\hadoop-trunk\hadoop-yarn-project\hadoop-yarn\hadoop-yarn-server\hadoop-yarn-server-nodemanager\src\main\java\org\apache\hadoop\yarn\server\nodemanager\containermanager\linux\runtime\docker\DockerStartCommand.java,9,3,0,2,0,5
hadoop-trunk\hadoop-trunk\hadoop-hdfs-project\hadoop-hdfs\src\test\java\org\apache\hadoop\hdfs\server\namenode\TestNameNodeConfiguration.java,15,0,0,1,0,1
hadoop-trunk\hadoop-trunk\hadoop-yarn-project\hadoop-yarn\hadoop-yarn-server\hadoop-yarn-server-resourcemanager\src\test\java\org\apache\hadoop\yarn\server\resourcemanager\webapp\helper\ResourceRequestsJsonVerifications.java,212,34,1,3,0,38
hadoop-trunk\hadoop-trunk\hadoop-hdfs-project\hadoop-hdfs\src\test\java\org\apache\hadoop\hdfs\server\blockmanagement\TestProvidedStorageMap.java,81,10,7,1,0,18
hadoop-trunk\hadoop-trunk\hadoop-common-project\hadoop-registry\src\main\java\org\apache\hadoop\registry\client\exceptions\InvalidPathnameException.java,12,7,0,1,0,8
hadoop-trunk\hadoop-trunk\hadoop-yarn-project\hadoop-yarn\hadoop-yarn-server\hadoop-yarn-server-resourcemanager\src\main\java\org\apache\hadoop\yarn\server\resourcemanager\rmapp\attempt\event\RMAppAttemptStatusupdateEvent.java,27,16,0,3,0,19
hadoop-trunk\hadoop-trunk\hadoop-cloud-storage-project\hadoop-cos\src\main\java\org\apache\hadoop\fs\cosn\CosNCopyFileTask.java,40,15,1,1,0,17
hadoop-trunk\hadoop-trunk\hadoop-common-project\hadoop-common\src\main\java\org\apache\hadoop\metrics2\impl\MetricsRecordBuilderImpl.java,0,39,1,1,0,41
hadoop-trunk\hadoop-trunk\hadoop-hdfs-project\hadoop-hdfs-client\src\main\java\org\apache\hadoop\hdfs\shortcircuit\ShortCircuitReplicaInfo.java,0,12,0,1,0,13
hadoop-trunk\hadoop-trunk\hadoop-yarn-project\hadoop-yarn\hadoop-yarn-server\hadoop-yarn-server-resourcemanager\src\main\java\org\apache\hadoop\yarn\server\resourcemanager\security\FairReservationsACLsManager.java,14,3,0,4,0,7
hadoop-trunk\hadoop-trunk\hadoop-common-project\hadoop-common\src\main\java\org\apache\hadoop\security\SaslInputStream.java,340,59,12,2,0,73
hadoop-trunk\hadoop-trunk\hadoop-hdfs-project\hadoop-hdfs\src\test\java\org\apache\hadoop\fs\TestUrlStreamHandler.java,144,22,9,3,0,34
hadoop-trunk\hadoop-trunk\hadoop-mapreduce-project\hadoop-mapreduce-client\hadoop-mapreduce-client-core\src\main\java\org\apache\hadoop\mapred\lib\IdentityReducer.java,0,14,0,1,0,15
hadoop-trunk\hadoop-trunk\hadoop-yarn-project\hadoop-yarn\hadoop-yarn-applications\hadoop-yarn-services\hadoop-yarn-services-core\src\main\java\org\apache\hadoop\yarn\service\exceptions\ServiceLaunchException.java,0,15,0,1,0,16
hadoop-trunk\hadoop-trunk\hadoop-hdfs-project\hadoop-hdfs-httpfs\src\test\java\org\apache\hadoop\test\SysPropsForTestsLoader.java,45,10,3,8,0,21
hadoop-trunk\hadoop-trunk\hadoop-common-project\hadoop-common\src\main\java\org\apache\hadoop\fs\audit\CommonAuditContext.java,0,13,0,1,0,14
hadoop-trunk\hadoop-trunk\hadoop-hdfs-project\hadoop-hdfs\src\main\java\org\apache\hadoop\hdfs\server\datanode\fsdataset\RoundRobinVolumeChoosingPolicy.java,0,19,3,6,0,28
hadoop-trunk\hadoop-trunk\hadoop-mapreduce-project\hadoop-mapreduce-client\hadoop-mapreduce-client-nativetask\src\main\java\org\apache\hadoop\mapred\nativetask\serde\ByteWritableSerializer.java,8,3,0,1,0,4
hadoop-trunk\hadoop-trunk\hadoop-yarn-project\hadoop-yarn\hadoop-yarn-server\hadoop-yarn-server-resourcemanager\src\main\java\org\apache\hadoop\yarn\server\resourcemanager\reservation\planning\AlignedPlannerWithGreedy.java,98,23,9,2,0,34
hadoop-trunk\hadoop-trunk\hadoop-common-project\hadoop-common\src\test\java\org\apache\hadoop\util\TestDirectBufferPool.java,68,31,3,2,0,36
hadoop-trunk\hadoop-trunk\hadoop-hdfs-project\hadoop-hdfs-client\src\main\java\org\apache\hadoop\hdfs\protocol\datatransfer\Op.java,0,42,0,1,0,43
hadoop-trunk\hadoop-trunk\hadoop-tools\hadoop-fs2img\src\main\java\org\apache\hadoop\hdfs\server\namenode\FileSystemImage.java,110,10,0,1,0,11
hadoop-trunk\hadoop-trunk\hadoop-yarn-project\hadoop-yarn\hadoop-yarn-api\src\main\java\org\apache\hadoop\yarn\server\api\protocolrecords\NodeToAttributes.java,28,7,0,1,0,8
hadoop-trunk\hadoop-trunk\hadoop-tools\hadoop-distcp\src\main\java\org\apache\hadoop\tools\util\WorkRequest.java,29,12,0,1,0,13
hadoop-trunk\hadoop-trunk\hadoop-common-project\hadoop-common\src\main\java\org\apache\hadoop\ipc\ProtobufRpcEngineCallback.java,0,3,0,1,0,4
hadoop-trunk\hadoop-trunk\hadoop-hdfs-project\hadoop-hdfs\src\test\java\org\apache\hadoop\hdfs\server\blockmanagement\TestBlockPlacementPolicyDebugLoggingBuilder.java,52,8,2,1,0,11
hadoop-trunk\hadoop-trunk\hadoop-yarn-project\hadoop-yarn\hadoop-yarn-server\hadoop-yarn-server-timelineservice-hbase\hadoop-yarn-server-timelineservice-hbase-client\src\main\java\org\apache\hadoop\yarn\server\timelineservice\storage\HBaseStorageMonitor.java,57,13,1,7,0,21
hadoop-trunk\hadoop-trunk\hadoop-common-project\hadoop-common\src\main\java\org\apache\hadoop\security\alias\CredentialProvider.java,125,18,0,1,0,19
hadoop-trunk\hadoop-trunk\hadoop-hdfs-project\hadoop-hdfs\src\main\java\org\apache\hadoop\hdfs\server\datanode\fsdataset\impl\AddBlockPoolException.java,38,16,0,1,0,17
hadoop-trunk\hadoop-trunk\hadoop-yarn-project\hadoop-yarn\hadoop-yarn-server\hadoop-yarn-server-resourcemanager\src\main\java\org\apache\hadoop\yarn\server\resourcemanager\preprocessor\QueueProcessor.java,0,4,0,1,0,5
hadoop-trunk\hadoop-trunk\hadoop-common-project\hadoop-common\src\test\java\org\apache\hadoop\ipc\TestRPCCallBenchmark.java,16,5,1,1,0,7
hadoop-trunk\hadoop-trunk\hadoop-yarn-project\hadoop-yarn\hadoop-yarn-server\hadoop-yarn-server-nodemanager\src\main\java\org\apache\hadoop\yarn\server\nodemanager\nodelabels\AbstractNodeDescriptorsProvider.java,0,31,1,1,0,33
hadoop-trunk\hadoop-trunk\hadoop-common-project\hadoop-common\src\test\java\org\apache\hadoop\io\erasurecode\rawcoder\TestRawCoderBase.java,314,39,6,3,0,48
hadoop-trunk\hadoop-trunk\hadoop-yarn-project\hadoop-yarn\hadoop-yarn-server\hadoop-yarn-server-common\src\main\java\org\apache\hadoop\yarn\server\federation\policies\amrmproxy\AbstractAMRMProxyPolicy.java,21,4,1,3,0,8
hadoop-trunk\hadoop-trunk\hadoop-common-project\hadoop-common\src\main\java\org\apache\hadoop\http\AdminAuthorizedServlet.java,16,3,0,1,0,4
hadoop-trunk\hadoop-trunk\hadoop-yarn-project\hadoop-yarn\hadoop-yarn-server\hadoop-yarn-server-resourcemanager\src\main\java\org\apache\hadoop\yarn\server\resourcemanager\scheduler\fair\MaxRunningAppsEnforcer.java,370,65,5,4,0,74
hadoop-trunk\hadoop-trunk\hadoop-tools\hadoop-azure\src\test\java\org\apache\hadoop\fs\azure\ITestFileSystemOperationsExceptionHandlingMultiThreaded.java,0,32,3,1,0,36
hadoop-trunk\hadoop-trunk\hadoop-mapreduce-project\hadoop-mapreduce-client\hadoop-mapreduce-client-core\src\main\java\org\apache\hadoop\mapred\MROutputFiles.java,188,22,3,1,0,26
hadoop-trunk\hadoop-trunk\hadoop-hdfs-project\hadoop-hdfs\src\test\java\org\apache\hadoop\hdfs\web\TestFSMainOperationsWebHdfs.java,194,41,8,4,0,53
hadoop-trunk\hadoop-trunk\hadoop-mapreduce-project\hadoop-mapreduce-client\hadoop-mapreduce-client-common\src\main\java\org\apache\hadoop\mapreduce\v2\api\protocolrecords\impl\pb\GetTaskReportsRequestPBImpl.java,105,39,43,5,0,87
hadoop-trunk\hadoop-trunk\hadoop-tools\hadoop-aws\src\main\java\org\apache\hadoop\fs\s3a\audit\package-info.java,0,2,0,2,0,4
hadoop-trunk\hadoop-trunk\hadoop-hdfs-project\hadoop-hdfs-client\src\main\java\org\apache\hadoop\hdfs\protocol\AddErasureCodingPolicyResponse.java,67,27,0,1,0,28
hadoop-trunk\hadoop-trunk\hadoop-hdfs-project\hadoop-hdfs-rbf\src\main\java\org\apache\hadoop\hdfs\server\federation\resolver\package-info.java,0,1,0,1,0,2
hadoop-trunk\hadoop-trunk\hadoop-mapreduce-project\hadoop-mapreduce-client\hadoop-mapreduce-client-jobclient\src\test\java\org\apache\hadoop\mapred\TestMultiFileInputFormat.java,109,71,11,4,0,86
hadoop-trunk\hadoop-trunk\hadoop-tools\hadoop-streaming\src\main\java\org\apache\hadoop\streaming\PipeMapRunner.java,0,6,4,1,0,11
hadoop-trunk\hadoop-trunk\hadoop-yarn-project\hadoop-yarn\hadoop-yarn-server\hadoop-yarn-server-common\src\main\java\org\apache\hadoop\yarn\server\api\protocolrecords\NodeHeartbeatResponse.java,94,38,3,2,0,43
hadoop-trunk\hadoop-trunk\hadoop-yarn-project\hadoop-yarn\hadoop-yarn-server\hadoop-yarn-server-common\src\main\java\org\apache\hadoop\yarn\server\service\package-info.java,0,1,0,1,0,2
hadoop-trunk\hadoop-trunk\hadoop-common-project\hadoop-common\src\test\java\org\apache\hadoop\io\compress\snappy\TestSnappyCompressorDecompressor.java,446,120,21,7,0,148
hadoop-trunk\hadoop-trunk\hadoop-hdfs-project\hadoop-hdfs-httpfs\src\main\java\org\apache\hadoop\lib\servlet\FileSystemReleaseFilter.java,72,10,2,4,0,16
hadoop-trunk\hadoop-trunk\hadoop-tools\hadoop-azure\src\main\java\org\apache\hadoop\fs\azurebfs\utils\DateTimeUtils.java,0,5,5,4,0,14
hadoop-trunk\hadoop-trunk\hadoop-tools\hadoop-azure\src\test\java\org\apache\hadoop\fs\azurebfs\ITestAzureBlobFileSystemOauth.java,141,27,6,25,0,58
hadoop-trunk\hadoop-trunk\hadoop-hdfs-project\hadoop-hdfs\src\main\java\org\apache\hadoop\hdfs\server\namenode\NameNodeRpcServer.java,2459,602,56,54,0,712
hadoop-trunk\hadoop-trunk\hadoop-tools\hadoop-aws\src\test\java\org\apache\hadoop\fs\s3a\ITestS3AEncryptionSSEKMSDefaultKey.java,0,4,1,1,0,6
hadoop-trunk\hadoop-trunk\hadoop-yarn-project\hadoop-yarn\hadoop-yarn-server\hadoop-yarn-server-timelineservice\src\main\java\org\apache\hadoop\yarn\server\timelineservice\storage\SchemaCreator.java,0,1,0,1,0,2
hadoop-trunk\hadoop-trunk\hadoop-yarn-project\hadoop-yarn\hadoop-yarn-server\hadoop-yarn-server-resourcemanager\src\main\java\org\apache\hadoop\yarn\server\resourcemanager\scheduler\activities\AllocationState.java,0,5,0,1,0,6
hadoop-trunk\hadoop-trunk\hadoop-hdfs-project\hadoop-hdfs\src\test\java\org\apache\hadoop\hdfs\server\namenode\TestNNStorageRetentionFunctional.java,112,38,0,3,0,41
hadoop-trunk\hadoop-trunk\hadoop-yarn-project\hadoop-yarn\hadoop-yarn-api\src\main\java\org\apache\hadoop\yarn\api\ApplicationHistoryProtocol.java,0,0,0,1,0,1
hadoop-trunk\hadoop-trunk\hadoop-common-project\hadoop-common\src\test\java\org\apache\hadoop\security\token\TestDtFetcher.java,17,13,4,1,0,18
hadoop-trunk\hadoop-trunk\hadoop-yarn-project\hadoop-yarn\hadoop-yarn-server\hadoop-yarn-server-nodemanager\src\main\java\org\apache\hadoop\yarn\server\nodemanager\containermanager\monitor\ContainerStartMonitoringEvent.java,40,27,0,1,0,28
hadoop-trunk\hadoop-trunk\hadoop-mapreduce-project\hadoop-mapreduce-client\hadoop-mapreduce-client-jobclient\src\test\java\org\apache\hadoop\mapred\TestMultipleLevelCaching.java,150,46,8,2,0,56
hadoop-trunk\hadoop-trunk\hadoop-hdfs-project\hadoop-hdfs-client\src\main\java\org\apache\hadoop\hdfs\util\StripedBlockUtil.java,956,287,6,3,0,296
hadoop-trunk\hadoop-trunk\hadoop-yarn-project\hadoop-yarn\hadoop-yarn-common\src\test\java\org\apache\hadoop\yarn\webapp\view\BlockForTest.java,0,6,1,1,0,8
hadoop-trunk\hadoop-trunk\hadoop-tools\hadoop-aws\src\main\java\org\apache\hadoop\fs\s3a\ArnResource.java,0,21,6,9,0,36
hadoop-trunk\hadoop-trunk\hadoop-common-project\hadoop-common\src\main\java\org\apache\hadoop\security\JniBasedUnixGroupsNetgroupMappingWithFallback.java,41,10,0,1,0,11
hadoop-trunk\hadoop-trunk\hadoop-yarn-project\hadoop-yarn\hadoop-yarn-server\hadoop-yarn-server-applicationhistoryservice\src\main\java\org\apache\hadoop\yarn\server\timeline\TimelineReader.java,0,14,1,1,0,16
hadoop-trunk\hadoop-trunk\hadoop-yarn-project\hadoop-yarn\hadoop-yarn-common\src\test\java\org\apache\hadoop\yarn\MockApps.java,43,18,1,1,0,20
hadoop-trunk\hadoop-trunk\hadoop-common-project\hadoop-common\src\test\java\org\apache\hadoop\security\token\delegation\TestDelegationToken.java,528,253,31,10,0,294
hadoop-trunk\hadoop-trunk\hadoop-common-project\hadoop-common\src\main\java\org\apache\hadoop\fs\ReadOption.java,0,0,0,1,0,1
hadoop-trunk\hadoop-trunk\hadoop-common-project\hadoop-common\src\main\java\org\apache\hadoop\metrics2\lib\MutableMetricsFactory.java,139,46,0,2,0,48
hadoop-trunk\hadoop-trunk\hadoop-common-project\hadoop-common\src\main\java\org\apache\hadoop\io\erasurecode\rawcoder\XORRawDecoder.java,57,9,2,1,0,12
hadoop-trunk\hadoop-trunk\hadoop-yarn-project\hadoop-yarn\hadoop-yarn-applications\hadoop-yarn-services\hadoop-yarn-services-api\src\test\java\org\apache\hadoop\yarn\service\TestApiServer.java,0,36,2,2,0,40
hadoop-trunk\hadoop-trunk\hadoop-hdfs-project\hadoop-hdfs\src\test\java\org\apache\hadoop\hdfs\TestLease.java,0,122,20,16,0,158
hadoop-trunk\hadoop-trunk\hadoop-mapreduce-project\hadoop-mapreduce-client\hadoop-mapreduce-client-app\src\main\java\org\apache\hadoop\mapreduce\v2\app\job\TaskAttempt.java,0,17,1,2,0,20
hadoop-trunk\hadoop-trunk\hadoop-tools\hadoop-aws\src\main\java\org\apache\hadoop\fs\s3a\impl\DirectoryPolicy.java,0,1,0,2,0,3
hadoop-trunk\hadoop-trunk\hadoop-yarn-project\hadoop-yarn\hadoop-yarn-server\hadoop-yarn-server-timelineservice\src\main\java\org\apache\hadoop\yarn\server\timelineservice\storage\TimelineStorageMonitor.java,68,22,1,1,0,24
hadoop-trunk\hadoop-trunk\hadoop-mapreduce-project\hadoop-mapreduce-client\hadoop-mapreduce-client-hs-plugins\src\test\java\org\apache\hadoop\mapreduce\v2\hs\webapp\TestMapReduceTrackingUriPlugin.java,38,8,0,1,0,9
hadoop-trunk\hadoop-trunk\hadoop-yarn-project\hadoop-yarn\hadoop-yarn-server\hadoop-yarn-server-resourcemanager\src\test\java\org\apache\hadoop\yarn\server\resourcemanager\volume\csi\TestVolumeMetaData.java,144,12,4,2,0,18
hadoop-trunk\hadoop-trunk\hadoop-yarn-project\hadoop-yarn\hadoop-yarn-server\hadoop-yarn-server-resourcemanager\src\main\java\org\apache\hadoop\yarn\server\resourcemanager\webapp\dao\NodeAttributesInfo.java,19,7,3,1,0,11
hadoop-trunk\hadoop-trunk\hadoop-yarn-project\hadoop-yarn\hadoop-yarn-server\hadoop-yarn-server-nodemanager\src\main\java\org\apache\hadoop\yarn\server\nodemanager\containermanager\ContainerManager.java,16,6,0,2,0,8
hadoop-trunk\hadoop-trunk\hadoop-hdfs-project\hadoop-hdfs-client\src\main\java\org\apache\hadoop\hdfs\protocol\datatransfer\sasl\SaslParticipant.java,0,29,5,1,0,35
hadoop-trunk\hadoop-trunk\hadoop-yarn-project\hadoop-yarn\hadoop-yarn-common\src\main\java\org\apache\hadoop\yarn\server\api\protocolrecords\impl\pb\RefreshNodesResourcesResponsePBImpl.java,44,18,18,4,0,40
hadoop-trunk\hadoop-trunk\hadoop-yarn-project\hadoop-yarn\hadoop-yarn-common\src\main\java\org\apache\hadoop\yarn\api\protocolrecords\impl\pb\GetNodesToLabelsResponsePBImpl.java,131,30,47,3,0,80
hadoop-trunk\hadoop-trunk\hadoop-yarn-project\hadoop-yarn\hadoop-yarn-server\hadoop-yarn-server-nodemanager\src\main\java\org\apache\hadoop\yarn\server\nodemanager\containermanager\linux\resources\gpu\GpuResourceAllocator.java,275,45,3,6,0,54
hadoop-trunk\hadoop-trunk\hadoop-yarn-project\hadoop-yarn\hadoop-yarn-common\src\main\java\org\apache\hadoop\yarn\state\MultiStateTransitionListener.java,0,14,3,1,0,18
hadoop-trunk\hadoop-trunk\hadoop-mapreduce-project\hadoop-mapreduce-client\hadoop-mapreduce-client-hs\src\main\java\org\apache\hadoop\mapreduce\v2\hs\webapp\dao\JobInfo.java,295,131,10,4,0,145
hadoop-trunk\hadoop-trunk\hadoop-mapreduce-project\hadoop-mapreduce-client\hadoop-mapreduce-client-jobclient\src\test\java\org\apache\hadoop\mapred\TestJobClients.java,227,43,3,2,0,48
hadoop-trunk\hadoop-trunk\hadoop-mapreduce-project\hadoop-mapreduce-client\hadoop-mapreduce-client-core\src\main\java\org\apache\hadoop\mapreduce\lib\db\DataDrivenDBRecordReader.java,0,49,41,4,0,94
hadoop-trunk\hadoop-trunk\hadoop-tools\hadoop-azure\src\main\java\org\apache\hadoop\fs\azurebfs\services\AbfsOutputStreamStatistics.java,56,0,0,1,0,1
hadoop-trunk\hadoop-trunk\hadoop-common-project\hadoop-common\src\main\java\org\apache\hadoop\http\FilterInitializer.java,9,3,0,2,0,5
hadoop-trunk\hadoop-trunk\hadoop-hdfs-project\hadoop-hdfs\src\main\java\org\apache\hadoop\hdfs\tools\offlineImageViewer\ImageVisitor.java,188,109,1,1,0,111
hadoop-trunk\hadoop-trunk\hadoop-yarn-project\hadoop-yarn\hadoop-yarn-server\hadoop-yarn-server-common\src\test\java\org\apache\hadoop\yarn\TestYarnServerApiClasses.java,446,73,34,13,0,120
hadoop-trunk\hadoop-trunk\hadoop-common-project\hadoop-auth\src\main\java\org\apache\hadoop\security\authentication\server\AuthenticationHandlerUtil.java,0,4,0,4,0,8
hadoop-trunk\hadoop-trunk\hadoop-common-project\hadoop-common\src\test\java\org\apache\hadoop\security\token\TestDtUtilShell.java,289,78,8,1,0,87
hadoop-trunk\hadoop-trunk\hadoop-cloud-storage-project\hadoop-cos\src\test\java\org\apache\hadoop\fs\cosn\contract\TestCosNContractSeek.java,7,2,0,1,0,3
hadoop-trunk\hadoop-trunk\hadoop-yarn-project\hadoop-yarn\hadoop-yarn-server\hadoop-yarn-server-resourcemanager\src\test\java\org\apache\hadoop\yarn\server\resourcemanager\preprocessor\TestNodeLabelProcessor.java,16,4,1,1,0,6
hadoop-trunk\hadoop-trunk\hadoop-common-project\hadoop-common\src\test\java\org\apache\hadoop\util\bloom\TestBloomFilters.java,227,58,4,11,0,73
hadoop-trunk\hadoop-trunk\hadoop-yarn-project\hadoop-yarn\hadoop-yarn-server\hadoop-yarn-server-resourcemanager\src\main\java\org\apache\hadoop\yarn\server\resourcemanager\preprocessor\ContextProcessor.java,0,0,0,1,0,1
hadoop-trunk\hadoop-trunk\hadoop-tools\hadoop-rumen\src\main\java\org\apache\hadoop\tools\rumen\datatypes\util\MapReduceJobPropertiesParser.java,0,73,7,1,0,81
hadoop-trunk\hadoop-trunk\hadoop-common-project\hadoop-common\src\main\java\org\apache\hadoop\security\alias\UserProvider.java,83,20,0,3,0,23
hadoop-trunk\hadoop-trunk\hadoop-tools\hadoop-sls\src\main\java\org\apache\hadoop\yarn\sls\scheduler\FifoSchedulerMetrics.java,34,4,1,1,0,6
hadoop-trunk\hadoop-trunk\hadoop-yarn-project\hadoop-yarn\hadoop-yarn-applications\hadoop-yarn-applications-catalog\hadoop-yarn-applications-catalog-webapp\src\main\java\org\apache\hadoop\yarn\appcatalog\model\package-info.java,0,0,0,1,0,1
hadoop-trunk\hadoop-trunk\hadoop-mapreduce-project\hadoop-mapreduce-client\hadoop-mapreduce-client-nativetask\src\main\java\org\apache\hadoop\mapred\nativetask\util\OutputUtil.java,20,9,4,4,0,17
hadoop-trunk\hadoop-trunk\hadoop-tools\hadoop-distcp\src\test\java\org\apache\hadoop\tools\TestIntegration.java,546,163,3,10,0,176
hadoop-trunk\hadoop-trunk\hadoop-tools\hadoop-fs2img\src\main\java\org\apache\hadoop\hdfs\server\namenode\FsUGIResolver.java,33,7,0,1,0,8
hadoop-trunk\hadoop-trunk\hadoop-yarn-project\hadoop-yarn\hadoop-yarn-server\hadoop-yarn-server-resourcemanager\src\test\java\org\apache\hadoop\yarn\server\resourcemanager\TestApplicationMasterServiceCapacity.java,157,25,0,7,0,32
hadoop-trunk\hadoop-trunk\hadoop-tools\hadoop-openstack\src\test\java\org\apache\hadoop\fs\swift\TestSwiftFileSystemConcurrency.java,68,7,3,1,0,11
hadoop-trunk\hadoop-trunk\hadoop-tools\hadoop-azure\src\test\java\org\apache\hadoop\fs\azure\MockWasbAuthorizerImpl.java,182,55,3,14,0,72
hadoop-trunk\hadoop-trunk\hadoop-yarn-project\hadoop-yarn\hadoop-yarn-server\hadoop-yarn-server-timelineservice-hbase\hadoop-yarn-server-timelineservice-hbase-common\src\main\java\org\apache\hadoop\yarn\server\timelineservice\storage\flow\FlowRunRowKeyPrefix.java,30,5,0,2,0,7
hadoop-trunk\hadoop-trunk\hadoop-yarn-project\hadoop-yarn\hadoop-yarn-common\src\test\java\org\apache\hadoop\yarn\api\TestResourceRequest.java,18,3,0,1,0,4
hadoop-trunk\hadoop-trunk\hadoop-tools\hadoop-aws\src\test\java\org\apache\hadoop\fs\s3a\ITestBlockingThreadPoolExecutorService.java,182,22,4,1,0,27
hadoop-trunk\hadoop-trunk\hadoop-yarn-project\hadoop-yarn\hadoop-yarn-api\src\main\java\org\apache\hadoop\yarn\util\constraint\PlacementConstraintParser.java,0,99,15,3,0,117
hadoop-trunk\hadoop-trunk\hadoop-hdfs-project\hadoop-hdfs\src\test\java\org\apache\hadoop\hdfs\server\namenode\snapshot\TestListSnapshot.java,105,16,2,1,0,19
hadoop-trunk\hadoop-trunk\hadoop-tools\hadoop-gridmix\src\main\java\org\apache\hadoop\mapred\gridmix\JobFactory.java,0,94,3,2,0,99
hadoop-trunk\hadoop-trunk\hadoop-yarn-project\hadoop-yarn\hadoop-yarn-common\src\main\java\org\apache\hadoop\yarn\nodelabels\RMNodeAttribute.java,69,32,1,1,0,34
hadoop-trunk\hadoop-trunk\hadoop-common-project\hadoop-common\src\test\java\org\apache\hadoop\fs\http\TestHttpFileSystem.java,47,16,0,7,0,23
hadoop-trunk\hadoop-trunk\hadoop-hdfs-project\hadoop-hdfs\src\test\java\org\apache\hadoop\cli\TestCacheAdminCLI.java,102,24,1,1,0,26
hadoop-trunk\hadoop-trunk\hadoop-yarn-project\hadoop-yarn\hadoop-yarn-server\hadoop-yarn-server-nodemanager\src\main\java\org\apache\hadoop\yarn\server\nodemanager\containermanager\container\ContainerInitEvent.java,8,2,0,1,0,3
hadoop-trunk\hadoop-trunk\hadoop-tools\hadoop-sls\src\main\java\org\apache\hadoop\yarn\sls\scheduler\SLSFairScheduler.java,0,40,0,5,0,45
hadoop-trunk\hadoop-trunk\hadoop-yarn-project\hadoop-yarn\hadoop-yarn-server\hadoop-yarn-server-common\src\main\java\org\apache\hadoop\yarn\server\federation\store\records\impl\pb\GetSubClusterPolicyConfigurationRequestPBImpl.java,0,16,27,4,0,47
hadoop-trunk\hadoop-trunk\hadoop-common-project\hadoop-common\src\main\java\org\apache\hadoop\net\DNSToSwitchMappingWithDependency.java,0,8,1,1,0,10
hadoop-trunk\hadoop-trunk\hadoop-tools\hadoop-streaming\src\main\java\org\apache\hadoop\streaming\io\RawBytesInputWriter.java,0,12,0,1,0,13
hadoop-trunk\hadoop-trunk\hadoop-hdfs-project\hadoop-hdfs\src\main\java\org\apache\hadoop\hdfs\server\namenode\top\metrics\TopMetrics.java,124,36,4,4,0,44
hadoop-trunk\hadoop-trunk\hadoop-common-project\hadoop-common\src\main\java\org\apache\hadoop\util\StopWatch.java,94,13,0,1,0,14
hadoop-trunk\hadoop-trunk\hadoop-tools\hadoop-azure\src\test\java\org\apache\hadoop\fs\azurebfs\commit\ITestAbfsCreateOutputDirectoriesStage.java,26,6,0,3,0,9
hadoop-trunk\hadoop-trunk\hadoop-yarn-project\hadoop-yarn\hadoop-yarn-server\hadoop-yarn-server-resourcemanager\src\test\java\org\apache\hadoop\yarn\server\resourcemanager\scheduler\constraint\TestPlacementProcessor.java,879,278,19,8,0,305
hadoop-trunk\hadoop-trunk\hadoop-mapreduce-project\hadoop-mapreduce-client\hadoop-mapreduce-client-core\src\main\java\org\apache\hadoop\mapreduce\lib\reduce\LongSumReducer.java,0,8,1,1,0,10
hadoop-trunk\hadoop-trunk\hadoop-tools\hadoop-aws\src\main\java\org\apache\hadoop\fs\s3a\statistics\BlockOutputStreamStatistics.java,121,2,0,1,0,3
hadoop-trunk\hadoop-trunk\hadoop-tools\hadoop-openstack\src\main\java\org\apache\hadoop\fs\swift\auth\entities\Tenant.java,79,12,0,1,0,13
hadoop-trunk\hadoop-trunk\hadoop-common-project\hadoop-registry\src\main\java\org\apache\hadoop\registry\client\impl\zk\ZKPathDumper.java,97,20,0,1,0,21
hadoop-trunk\hadoop-trunk\hadoop-hdfs-project\hadoop-hdfs\src\main\java\org\apache\hadoop\hdfs\protocol\datatransfer\sasl\SaslDataTransferServer.java,410,67,10,12,0,89
hadoop-trunk\hadoop-trunk\hadoop-tools\hadoop-resourceestimator\src\main\java\org\apache\hadoop\resourceestimator\service\ShutdownHook.java,18,6,0,1,0,7
hadoop-trunk\hadoop-trunk\hadoop-tools\hadoop-rumen\src\main\java\org\apache\hadoop\tools\rumen\ParsedLine.java,0,14,1,2,0,17
hadoop-trunk\hadoop-trunk\hadoop-hdfs-project\hadoop-hdfs\src\test\java\org\apache\hadoop\hdfs\server\blockmanagement\TestOverReplicatedBlocks.java,0,56,3,5,0,64
hadoop-trunk\hadoop-trunk\hadoop-yarn-project\hadoop-yarn\hadoop-yarn-common\src\main\java\org\apache\hadoop\yarn\server\api\protocolrecords\impl\pb\RemoveFromClusterNodeLabelsRequestPBImpl.java,0,23,30,1,0,54
hadoop-trunk\hadoop-trunk\hadoop-tools\hadoop-azure\src\main\java\org\apache\hadoop\fs\azurebfs\security\AbfssDtFetcher.java,12,0,0,1,0,1
hadoop-trunk\hadoop-trunk\hadoop-hdfs-project\hadoop-hdfs\src\test\java\org\apache\hadoop\hdfs\server\namenode\TestDecommissioningStatus.java,538,100,13,3,0,116
hadoop-trunk\hadoop-trunk\hadoop-yarn-project\hadoop-yarn\hadoop-yarn-server\hadoop-yarn-server-common\src\main\java\org\apache\hadoop\yarn\server\package-info.java,0,1,0,1,0,2
hadoop-trunk\hadoop-trunk\hadoop-common-project\hadoop-common\src\test\java\org\apache\hadoop\io\compress\lz4\TestLz4CompressorDecompressor.java,318,98,31,12,0,141
hadoop-trunk\hadoop-trunk\hadoop-hdfs-project\hadoop-hdfs\src\main\java\org\apache\hadoop\hdfs\server\protocol\NodeRegistration.java,0,7,4,1,0,12
hadoop-trunk\hadoop-trunk\hadoop-yarn-project\hadoop-yarn\hadoop-yarn-server\hadoop-yarn-server-nodemanager\src\main\java\org\apache\hadoop\yarn\server\nodemanager\containermanager\resourceplugin\gpu\AssignedGpuDevice.java,55,19,1,2,0,22
hadoop-trunk\hadoop-trunk\hadoop-common-project\hadoop-common\src\test\java\org\apache\hadoop\fs\TestGetFileBlockLocations.java,108,32,11,1,0,44
hadoop-trunk\hadoop-trunk\hadoop-hdfs-project\hadoop-hdfs\src\main\java\org\apache\hadoop\hdfs\server\namenode\top\TopConf.java,0,7,0,1,0,8
hadoop-trunk\hadoop-trunk\hadoop-yarn-project\hadoop-yarn\hadoop-yarn-server\hadoop-yarn-server-resourcemanager\src\test\java\org\apache\hadoop\yarn\server\resourcemanager\monitor\capacity\mockframework\MockApplication.java,0,39,3,14,0,56
hadoop-trunk\hadoop-trunk\hadoop-hdfs-project\hadoop-hdfs\src\test\java\org\apache\hadoop\hdfs\tools\offlineImageViewer\TestOfflineImageViewerForStoragePolicy.java,135,11,6,2,0,19
hadoop-trunk\hadoop-trunk\hadoop-hdfs-project\hadoop-hdfs\src\main\java\org\apache\hadoop\hdfs\server\blockmanagement\OutOfLegacyGenerationStampsException.java,8,1,0,1,0,2
hadoop-trunk\hadoop-trunk\hadoop-yarn-project\hadoop-yarn\hadoop-yarn-api\src\main\java\org\apache\hadoop\yarn\server\api\protocolrecords\ReplaceLabelsOnNodeRequest.java,26,6,0,1,0,7
hadoop-trunk\hadoop-trunk\hadoop-tools\hadoop-federation-balance\src\test\java\org\apache\hadoop\tools\fedbalance\procedure\WaitProcedure.java,49,15,2,1,0,18
hadoop-trunk\hadoop-trunk\hadoop-yarn-project\hadoop-yarn\hadoop-yarn-api\src\main\java\org\apache\hadoop\yarn\api\protocolrecords\GetQueueInfoResponse.java,23,7,0,2,0,9
hadoop-trunk\hadoop-trunk\hadoop-yarn-project\hadoop-yarn\hadoop-yarn-applications\hadoop-yarn-applications-catalog\hadoop-yarn-applications-catalog-webapp\src\main\java\org\apache\hadoop\yarn\appcatalog\controller\package-info.java,0,0,0,1,0,1
hadoop-trunk\hadoop-trunk\hadoop-hdfs-project\hadoop-hdfs\src\test\java\org\apache\hadoop\hdfs\server\namenode\snapshot\TestSnapshotDeletion.java,1291,334,26,6,0,366
hadoop-trunk\hadoop-trunk\hadoop-tools\hadoop-aws\src\test\java\org\apache\hadoop\fs\s3a\fileContext\ITestS3AFileContext.java,4,2,1,1,0,4
hadoop-trunk\hadoop-trunk\hadoop-mapreduce-project\hadoop-mapreduce-client\hadoop-mapreduce-client-nativetask\src\main\java\org\apache\hadoop\mapred\nativetask\util\NativeTaskOutputFiles.java,132,68,0,17,0,85
hadoop-trunk\hadoop-trunk\hadoop-yarn-project\hadoop-yarn\hadoop-yarn-api\src\main\java\org\apache\hadoop\yarn\api\records\QueueACL.java,0,5,0,2,0,7
hadoop-trunk\hadoop-trunk\hadoop-tools\hadoop-azure\src\test\java\org\apache\hadoop\fs\azurebfs\contract\ITestAbfsFileSystemContractSeek.java,247,40,1,12,0,53
hadoop-trunk\hadoop-trunk\hadoop-yarn-project\hadoop-yarn\hadoop-yarn-server\hadoop-yarn-server-resourcemanager\src\main\java\org\apache\hadoop\yarn\server\resourcemanager\rmnode\UpdatedContainerInfo.java,30,19,1,1,0,21
hadoop-trunk\hadoop-trunk\hadoop-hdfs-project\hadoop-hdfs-rbf\src\main\java\org\apache\hadoop\hdfs\server\federation\store\protocol\impl\pb\DisableNameserviceResponsePBImpl.java,0,13,29,5,0,47
hadoop-trunk\hadoop-trunk\hadoop-mapreduce-project\hadoop-mapreduce-client\hadoop-mapreduce-client-core\src\main\java\org\apache\hadoop\mapreduce\lib\fieldsel\FieldSelectionMapper.java,0,30,2,2,0,34
hadoop-trunk\hadoop-trunk\hadoop-tools\hadoop-azure\src\main\java\org\apache\hadoop\fs\azurebfs\constants\HttpHeaderConfigurations.java,0,52,0,7,0,59
hadoop-trunk\hadoop-trunk\hadoop-common-project\hadoop-common\src\main\java\org\apache\hadoop\security\http\CrossOriginFilter.java,231,56,8,5,0,69
hadoop-trunk\hadoop-trunk\hadoop-hdfs-project\hadoop-hdfs\src\test\java\org\apache\hadoop\hdfs\qjournal\MiniJournalCluster.java,0,82,7,6,0,95
hadoop-trunk\hadoop-trunk\hadoop-yarn-project\hadoop-yarn\hadoop-yarn-client\src\test\java\org\apache\hadoop\yarn\client\api\impl\TestAMRMProxy.java,205,18,1,6,0,25
hadoop-trunk\hadoop-trunk\hadoop-yarn-project\hadoop-yarn\hadoop-yarn-server\hadoop-yarn-server-nodemanager\src\main\java\org\apache\hadoop\yarn\server\nodemanager\containermanager\resourceplugin\gpu\GpuDockerCommandPluginFactory.java,18,4,1,3,0,8
hadoop-trunk\hadoop-trunk\hadoop-tools\hadoop-aws\src\main\java\org\apache\hadoop\fs\s3a\impl\GetContentSummaryOperation.java,181,19,0,12,0,31
hadoop-trunk\hadoop-trunk\hadoop-yarn-project\hadoop-yarn\hadoop-yarn-common\src\main\java\org\apache\hadoop\yarn\api\impl\pb\client\ApplicationHistoryProtocolPBClientImpl.java,0,24,27,30,0,81
hadoop-trunk\hadoop-trunk\hadoop-yarn-project\hadoop-yarn\hadoop-yarn-server\hadoop-yarn-server-applicationhistoryservice\src\main\java\org\apache\hadoop\yarn\server\applicationhistoryservice\records\impl\pb\ContainerStartDataPBImpl.java,219,56,75,4,0,135
hadoop-trunk\hadoop-trunk\hadoop-common-project\hadoop-common\src\main\java\org\apache\hadoop\util\FileBasedIPList.java,74,14,5,1,0,20
hadoop-trunk\hadoop-trunk\hadoop-yarn-project\hadoop-yarn\hadoop-yarn-common\src\main\java\org\apache\hadoop\yarn\api\protocolrecords\impl\pb\NodePublishVolumeResponsePBImpl.java,0,9,12,1,0,22
hadoop-trunk\hadoop-trunk\hadoop-mapreduce-project\hadoop-mapreduce-client\hadoop-mapreduce-client-nativetask\src\test\java\org\apache\hadoop\mapred\nativetask\combinertest\WordCountWithOldAPI.java,38,15,0,1,0,16
hadoop-trunk\hadoop-trunk\hadoop-tools\hadoop-azure\src\test\java\org\apache\hadoop\fs\azurebfs\contract\ABFSContractTestBinding.java,35,11,0,5,0,16
hadoop-trunk\hadoop-trunk\hadoop-common-project\hadoop-registry\src\main\java\org\apache\hadoop\registry\server\integration\package-info.java,0,0,0,1,0,1
hadoop-trunk\hadoop-trunk\hadoop-common-project\hadoop-common\src\test\java\org\apache\hadoop\ipc\TestResponseBuffer.java,60,5,2,1,0,8
hadoop-trunk\hadoop-trunk\hadoop-yarn-project\hadoop-yarn\hadoop-yarn-server\hadoop-yarn-server-timelineservice\src\main\java\org\apache\hadoop\yarn\server\timelineservice\metrics\TimelineReaderMetrics.java,80,28,1,1,0,30
hadoop-trunk\hadoop-trunk\hadoop-common-project\hadoop-common\src\test\java\org\apache\hadoop\io\erasurecode\coder\TestRSErasureCoder.java,98,48,10,1,0,59
hadoop-trunk\hadoop-trunk\hadoop-hdfs-project\hadoop-hdfs-client\src\main\java\org\apache\hadoop\hdfs\server\protocol\SlowDiskReports.java,0,13,3,1,0,17
hadoop-trunk\hadoop-trunk\hadoop-common-project\hadoop-common\src\test\java\org\apache\hadoop\security\authorize\TestDefaultImpersonationProvider.java,67,13,3,1,0,17
hadoop-trunk\hadoop-trunk\hadoop-hdfs-project\hadoop-hdfs\src\test\java\org\apache\hadoop\hdfs\server\namenode\TestUpgradeDomainBlockPlacementPolicy.java,207,29,0,3,0,32
hadoop-trunk\hadoop-trunk\hadoop-mapreduce-project\hadoop-mapreduce-client\hadoop-mapreduce-client-common\src\main\java\org\apache\hadoop\mapreduce\v2\util\MRWebAppUtil.java,145,51,2,2,0,55
hadoop-trunk\hadoop-trunk\hadoop-yarn-project\hadoop-yarn\hadoop-yarn-server\hadoop-yarn-server-resourcemanager\src\test\java\org\apache\hadoop\yarn\server\resourcemanager\preprocessor\TestTagAddProcessor.java,17,4,1,1,0,6
hadoop-trunk\hadoop-trunk\hadoop-tools\hadoop-azure\src\main\java\org\apache\hadoop\fs\azurebfs\oauth2\QueryParams.java,43,14,1,1,0,16
hadoop-trunk\hadoop-trunk\hadoop-yarn-project\hadoop-yarn\hadoop-yarn-applications\hadoop-yarn-services\hadoop-yarn-services-core\src\main\java\org\apache\hadoop\yarn\service\ServiceScheduler.java,1017,171,71,10,0,252
hadoop-trunk\hadoop-trunk\hadoop-common-project\hadoop-common\src\main\java\org\apache\hadoop\fs\FsStatus.java,45,23,0,1,0,24
hadoop-trunk\hadoop-trunk\hadoop-yarn-project\hadoop-yarn\hadoop-yarn-client\src\test\java\org\apache\hadoop\yarn\client\api\async\impl\TestAMRMClientAsync.java,548,134,18,2,0,154
hadoop-trunk\hadoop-trunk\hadoop-hdfs-project\hadoop-hdfs\src\main\java\org\apache\hadoop\hdfs\server\namenode\NNStorageRetentionManager.java,253,64,4,5,0,73
hadoop-trunk\hadoop-trunk\hadoop-tools\hadoop-aws\src\test\java\org\apache\hadoop\fs\s3a\auth\delegation\Csvout.java,0,9,0,1,0,10
hadoop-trunk\hadoop-trunk\hadoop-mapreduce-project\hadoop-mapreduce-client\hadoop-mapreduce-client-core\src\main\java\org\apache\hadoop\mapred\lib\aggregate\ValueHistogram.java,0,3,0,1,0,4
hadoop-trunk\hadoop-trunk\hadoop-mapreduce-project\hadoop-mapreduce-client\hadoop-mapreduce-client-core\src\main\java\org\apache\hadoop\mapreduce\lib\join\WrappedRecordReader.java,0,75,8,2,0,85
hadoop-trunk\hadoop-trunk\hadoop-yarn-project\hadoop-yarn\hadoop-yarn-server\hadoop-yarn-server-nodemanager\src\main\java\org\apache\hadoop\yarn\server\nodemanager\containermanager\localizer\LocalizerContext.java,38,31,0,1,0,32
hadoop-trunk\hadoop-trunk\hadoop-common-project\hadoop-common\src\main\java\org\apache\hadoop\metrics2\util\Contracts.java,76,34,1,1,0,36
hadoop-trunk\hadoop-trunk\hadoop-cloud-storage-project\hadoop-cos\src\main\java\org\apache\hadoop\fs\cosn\CosNUtils.java,0,22,6,1,0,29
hadoop-trunk\hadoop-trunk\hadoop-hdfs-project\hadoop-hdfs\src\test\java\org\apache\hadoop\hdfs\server\balancer\TestBalancerLongRunningTasks.java,0,110,15,20,0,145
hadoop-trunk\hadoop-trunk\hadoop-yarn-project\hadoop-yarn\hadoop-yarn-csi\src\main\java\org\apache\hadoop\yarn\csi\package-info.java,0,1,0,1,0,2
hadoop-trunk\hadoop-trunk\hadoop-common-project\hadoop-registry\src\test\java\org\apache\hadoop\registry\integration\TestYarnPolicySelector.java,38,10,0,1,0,11
hadoop-trunk\hadoop-trunk\hadoop-hdfs-project\hadoop-hdfs\src\main\java\org\apache\hadoop\hdfs\server\namenode\snapshot\AbstractINodeDiffList.java,0,66,6,1,0,73
hadoop-trunk\hadoop-trunk\hadoop-yarn-project\hadoop-yarn\hadoop-yarn-server\hadoop-yarn-server-resourcemanager\src\test\java\org\apache\hadoop\yarn\server\resourcemanager\TestAppManagerWithFairScheduler.java,213,18,1,7,0,26
hadoop-trunk\hadoop-trunk\hadoop-yarn-project\hadoop-yarn\hadoop-yarn-server\hadoop-yarn-server-common\src\main\java\org\apache\hadoop\yarn\server\webapp\ErrorsAndWarningsBlock.java,213,66,1,8,0,75
hadoop-trunk\hadoop-trunk\hadoop-tools\hadoop-aws\src\test\java\org\apache\hadoop\fs\s3a\audit\TestLoggingAuditor.java,162,3,2,2,0,7
hadoop-trunk\hadoop-trunk\hadoop-common-project\hadoop-common\src\test\java\org\apache\hadoop\http\TestSSLHttpServerConfigs.java,222,77,1,6,0,84
hadoop-trunk\hadoop-trunk\hadoop-yarn-project\hadoop-yarn\hadoop-yarn-server\hadoop-yarn-server-timelineservice-hbase\hadoop-yarn-server-timelineservice-hbase-common\src\test\java\org\apache\hadoop\yarn\server\timelineservice\storage\common\TestSeparator.java,0,31,2,1,0,34
hadoop-trunk\hadoop-trunk\hadoop-tools\hadoop-openstack\src\main\java\org\apache\hadoop\fs\swift\http\CopyRequest.java,0,2,1,1,0,4
hadoop-trunk\hadoop-trunk\hadoop-tools\hadoop-streaming\src\main\java\org\apache\hadoop\streaming\mapreduce\StreamXmlRecordReader.java,295,107,12,1,0,120
hadoop-trunk\hadoop-trunk\hadoop-mapreduce-project\hadoop-mapreduce-client\hadoop-mapreduce-client-app\src\main\java\org\apache\hadoop\mapreduce\v2\app\webapp\TasksPage.java,0,4,1,1,0,6
hadoop-trunk\hadoop-trunk\hadoop-mapreduce-project\hadoop-mapreduce-client\hadoop-mapreduce-client-jobclient\src\test\java\org\apache\hadoop\mapreduce\security\TestBinaryTokenFile.java,240,73,3,22,0,98
hadoop-trunk\hadoop-trunk\hadoop-yarn-project\hadoop-yarn\hadoop-yarn-server\hadoop-yarn-server-tests\src\test\java\org\apache\hadoop\yarn\server\TestContainerManagerSecurity.java,0,176,21,12,0,209
hadoop-trunk\hadoop-trunk\hadoop-mapreduce-project\hadoop-mapreduce-client\hadoop-mapreduce-client-jobclient\src\test\java\org\apache\hadoop\mapred\TestOldCombinerGrouping.java,155,29,7,1,0,37
hadoop-trunk\hadoop-trunk\hadoop-yarn-project\hadoop-yarn\hadoop-yarn-server\hadoop-yarn-server-web-proxy\src\main\java\org\apache\hadoop\yarn\server\webproxy\amfilter\AmFilterInitializer.java,62,15,1,2,0,18
hadoop-trunk\hadoop-trunk\hadoop-hdfs-project\hadoop-hdfs\src\main\java\org\apache\hadoop\hdfs\server\namenode\NameNodeHttpServer.java,255,60,2,9,0,71
hadoop-trunk\hadoop-trunk\hadoop-hdfs-project\hadoop-hdfs-client\src\main\java\org\apache\hadoop\hdfs\web\resources\RecursiveParam.java,30,2,0,1,0,3
hadoop-trunk\hadoop-trunk\hadoop-hdfs-project\hadoop-hdfs-rbf\src\main\java\org\apache\hadoop\hdfs\server\federation\metrics\StateStoreMetrics.java,111,45,2,1,0,48
hadoop-trunk\hadoop-trunk\hadoop-yarn-project\hadoop-yarn\hadoop-yarn-server\hadoop-yarn-server-resourcemanager\src\test\java\org\apache\hadoop\yarn\server\resourcemanager\TestTokenClientRMService.java,262,48,1,2,0,51
hadoop-trunk\hadoop-trunk\hadoop-yarn-project\hadoop-yarn\hadoop-yarn-api\src\main\java\org\apache\hadoop\yarn\api\protocolrecords\IncreaseContainersResourceResponse.java,54,7,0,2,0,9
hadoop-trunk\hadoop-trunk\hadoop-mapreduce-project\hadoop-mapreduce-client\hadoop-mapreduce-client-core\src\main\java\org\apache\hadoop\mapreduce\lib\input\CombineTextInputFormat.java,0,13,0,1,0,14
hadoop-trunk\hadoop-trunk\hadoop-common-project\hadoop-common\src\main\java\org\apache\hadoop\net\NetUtils.java,0,218,29,12,0,259
hadoop-trunk\hadoop-trunk\hadoop-hdfs-project\hadoop-hdfs-rbf\src\test\java\org\apache\hadoop\hdfs\server\federation\router\TestRouterFsck.java,152,14,2,9,0,25
hadoop-trunk\hadoop-trunk\hadoop-yarn-project\hadoop-yarn\hadoop-yarn-common\src\main\java\org\apache\hadoop\yarn\client\api\impl\TimelineConnector.java,385,92,8,8,0,108
hadoop-trunk\hadoop-trunk\hadoop-mapreduce-project\hadoop-mapreduce-client\hadoop-mapreduce-client-core\src\main\java\org\apache\hadoop\mapreduce\filecache\package-info.java,0,1,0,1,0,2
hadoop-trunk\hadoop-trunk\hadoop-tools\hadoop-azure\src\test\java\org\apache\hadoop\fs\azure\metrics\TestBandwidthGaugeUpdater.java,51,18,0,5,0,23
hadoop-trunk\hadoop-trunk\hadoop-common-project\hadoop-common\src\main\java\org\apache\hadoop\fs\UnresolvedLinkException.java,12,4,0,1,0,5
hadoop-trunk\hadoop-trunk\hadoop-tools\hadoop-azure\src\main\java\org\apache\hadoop\fs\azurebfs\services\ListingSupport.java,0,3,0,4,0,7
hadoop-trunk\hadoop-trunk\hadoop-hdfs-project\hadoop-hdfs\src\main\java\org\apache\hadoop\hdfs\protocol\SnapshotException.java,16,3,0,1,0,4
hadoop-trunk\hadoop-trunk\hadoop-tools\hadoop-azure\src\main\java\org\apache\hadoop\fs\azurebfs\commit\package-info.java,0,1,0,1,0,2
hadoop-trunk\hadoop-trunk\hadoop-tools\hadoop-azure\src\test\java\org\apache\hadoop\fs\azurebfs\commit\package-info.java,0,0,1,1,0,2
hadoop-trunk\hadoop-trunk\hadoop-common-project\hadoop-common\src\main\java\org\apache\hadoop\io\serializer\avro\AvroReflectSerializable.java,0,3,0,1,0,4
hadoop-trunk\hadoop-trunk\hadoop-yarn-project\hadoop-yarn\hadoop-yarn-api\src\main\java\org\apache\hadoop\yarn\server\api\protocolrecords\CheckForDecommissioningNodesRequest.java,10,1,1,1,0,3
hadoop-trunk\hadoop-trunk\hadoop-tools\hadoop-azure\src\main\java\org\apache\hadoop\fs\azure\RemoteSASKeyGeneratorImpl.java,0,49,5,14,0,68
hadoop-trunk\hadoop-trunk\hadoop-common-project\hadoop-common\src\main\java\org\apache\hadoop\io\compress\CodecConstants.java,0,0,0,1,0,1
hadoop-trunk\hadoop-trunk\hadoop-hdfs-project\hadoop-hdfs-client\src\main\java\org\apache\hadoop\hdfs\web\SWebHdfsFileSystem.java,23,4,0,1,0,5
hadoop-trunk\hadoop-trunk\hadoop-tools\hadoop-dynamometer\hadoop-dynamometer-infra\src\main\java\org\apache\hadoop\tools\dynamometer\AMOptions.java,0,75,0,1,0,76
hadoop-trunk\hadoop-trunk\hadoop-yarn-project\hadoop-yarn\hadoop-yarn-server\hadoop-yarn-server-nodemanager\src\main\java\org\apache\hadoop\yarn\server\nodemanager\containermanager\resourceplugin\deviceframework\DeviceResourceHandlerImpl.java,287,61,12,12,0,85
hadoop-trunk\hadoop-trunk\hadoop-tools\hadoop-streaming\src\test\java\org\apache\hadoop\streaming\StreamAggregate.java,0,15,4,1,0,20
hadoop-trunk\hadoop-trunk\hadoop-hdfs-project\hadoop-hdfs-nfs\src\main\java\org\apache\hadoop\hdfs\nfs\nfs3\OffsetRange.java,51,22,3,1,0,26
hadoop-trunk\hadoop-trunk\hadoop-hdfs-project\hadoop-hdfs-client\src\test\java\org\apache\hadoop\hdfs\web\TestOffsetUrlInputStream.java,39,9,0,3,0,12
hadoop-trunk\hadoop-trunk\hadoop-hdfs-project\hadoop-hdfs\src\test\java\org\apache\hadoop\cli\util\CLICommandCryptoAdmin.java,3,0,0,1,0,1
hadoop-trunk\hadoop-trunk\hadoop-yarn-project\hadoop-yarn\hadoop-yarn-server\hadoop-yarn-server-resourcemanager\src\test\java\org\apache\hadoop\yarn\server\resourcemanager\webapp\helper\AppInfoXmlVerifications.java,0,7,0,2,0,9
hadoop-trunk\hadoop-trunk\hadoop-hdfs-project\hadoop-hdfs\src\main\java\org\apache\hadoop\hdfs\protocolPB\JournalProtocolServerSideTranslatorPB.java,56,20,21,10,0,51
hadoop-trunk\hadoop-trunk\hadoop-mapreduce-project\hadoop-mapreduce-client\hadoop-mapreduce-client-nativetask\src\main\java\org\apache\hadoop\mapred\nativetask\handlers\BufferPushee.java,0,28,4,3,0,35
hadoop-trunk\hadoop-trunk\hadoop-yarn-project\hadoop-yarn\hadoop-yarn-server\hadoop-yarn-server-tests\src\test\java\org\apache\hadoop\yarn\server\NMTokenIdentifierNewForTest.java,107,62,40,4,0,106
hadoop-trunk\hadoop-trunk\hadoop-mapreduce-project\hadoop-mapreduce-client\hadoop-mapreduce-client-core\src\main\java\org\apache\hadoop\mapred\ShuffleConsumerPlugin.java,0,120,11,1,0,132
hadoop-trunk\hadoop-trunk\hadoop-cloud-storage-project\hadoop-cos\src\main\java\org\apache\hadoop\fs\cosn\ByteBufferOutputStream.java,48,10,0,1,0,11
hadoop-trunk\hadoop-trunk\hadoop-common-project\hadoop-common\src\main\java\org\apache\hadoop\util\IntrusiveCollection.java,0,77,13,1,0,91
hadoop-trunk\hadoop-trunk\hadoop-hdfs-project\hadoop-hdfs\src\main\java\org\apache\hadoop\hdfs\server\protocol\DisallowedDatanodeException.java,14,8,0,1,0,9
hadoop-trunk\hadoop-trunk\hadoop-yarn-project\hadoop-yarn\hadoop-yarn-common\src\main\java\org\apache\hadoop\yarn\api\records\impl\pb\PreemptionContractPBImpl.java,215,36,62,4,0,102
hadoop-trunk\hadoop-trunk\hadoop-mapreduce-project\hadoop-mapreduce-client\hadoop-mapreduce-client-core\src\main\java\org\apache\hadoop\mapreduce\lib\input\SplitLineReader.java,0,9,0,1,0,10
hadoop-trunk\hadoop-trunk\hadoop-hdfs-project\hadoop-hdfs\src\test\java\org\apache\hadoop\fs\viewfs\TestViewFileSystemWithAcls.java,143,27,5,8,0,40
hadoop-trunk\hadoop-trunk\hadoop-mapreduce-project\hadoop-mapreduce-client\hadoop-mapreduce-client-core\src\test\java\org\apache\hadoop\mapred\TestLineRecordReader.java,640,117,16,2,0,135
hadoop-trunk\hadoop-trunk\hadoop-tools\hadoop-aliyun\src\test\java\org\apache\hadoop\fs\aliyun\oss\fileContext\TestOSSFileContextURI.java,19,2,1,1,0,4
hadoop-trunk\hadoop-trunk\hadoop-common-project\hadoop-common\src\main\java\org\apache\hadoop\net\DomainNameResolverFactory.java,0,9,0,1,0,10
hadoop-trunk\hadoop-trunk\hadoop-mapreduce-project\hadoop-mapreduce-client\hadoop-mapreduce-client-core\src\main\java\org\apache\hadoop\mapreduce\FileSystemCounter.java,0,6,0,1,0,7
hadoop-trunk\hadoop-trunk\hadoop-mapreduce-project\hadoop-mapreduce-client\hadoop-mapreduce-client-core\src\main\java\org\apache\hadoop\mapreduce\split\JobSplit.java,173,123,2,2,0,127
hadoop-trunk\hadoop-trunk\hadoop-hdfs-project\hadoop-hdfs\src\main\java\org\apache\hadoop\hdfs\server\blockmanagement\BlockPlacementPolicy.java,233,68,1,2,0,71
hadoop-trunk\hadoop-trunk\hadoop-yarn-project\hadoop-yarn\hadoop-yarn-common\src\test\java\org\apache\hadoop\yarn\logaggregation\filecontroller\TestLogAggregationFileController.java,97,12,0,5,0,17
hadoop-trunk\hadoop-trunk\hadoop-common-project\hadoop-annotations\src\main\java\org\apache\hadoop\classification\VisibleForTesting.java,0,1,0,2,0,3
hadoop-trunk\hadoop-trunk\hadoop-common-project\hadoop-common\src\test\java\org\apache\hadoop\log\TestLog4Json.java,225,47,18,1,0,66
hadoop-trunk\hadoop-trunk\hadoop-tools\hadoop-azure-datalake\src\test\java\org\apache\hadoop\fs\adl\live\TestAdlContractConcatLive.java,18,4,0,1,0,5
hadoop-trunk\hadoop-trunk\hadoop-yarn-project\hadoop-yarn\hadoop-yarn-server\hadoop-yarn-server-timelineservice-hbase\hadoop-yarn-server-timelineservice-hbase-client\src\main\java\org\apache\hadoop\yarn\server\timelineservice\reader\filter\TimelineFilterUtils.java,0,35,3,3,0,41
hadoop-trunk\hadoop-trunk\hadoop-hdfs-project\hadoop-hdfs\src\main\java\org\apache\hadoop\hdfs\server\diskbalancer\datamodel\DiskBalancerDataNode.java,242,17,4,1,0,22
hadoop-trunk\hadoop-trunk\hadoop-hdfs-project\hadoop-hdfs\src\main\java\org\apache\hadoop\hdfs\util\CyclicIteration.java,0,19,0,1,0,20
hadoop-trunk\hadoop-trunk\hadoop-yarn-project\hadoop-yarn\hadoop-yarn-server\hadoop-yarn-server-common\src\main\java\org\apache\hadoop\yarn\server\scheduler\SchedulerRequestKey.java,150,33,1,1,0,35
hadoop-trunk\hadoop-trunk\hadoop-yarn-project\hadoop-yarn\hadoop-yarn-api\src\main\java\org\apache\hadoop\yarn\api\protocolrecords\CommitResponse.java,13,0,0,1,0,1
hadoop-trunk\hadoop-trunk\hadoop-yarn-project\hadoop-yarn\hadoop-yarn-common\src\main\java\org\apache\hadoop\yarn\api\protocolrecords\impl\pb\GetAllResourceProfilesRequestPBImpl.java,0,9,13,2,0,24
hadoop-trunk\hadoop-trunk\hadoop-hdfs-project\hadoop-hdfs-rbf\src\main\java\org\apache\hadoop\hdfs\server\federation\store\protocol\RouterHeartbeatRequest.java,22,6,0,2,0,8
hadoop-trunk\hadoop-trunk\hadoop-tools\hadoop-streaming\src\main\java\org\apache\hadoop\streaming\mapreduce\StreamInputFormat.java,61,6,4,1,0,11
hadoop-trunk\hadoop-trunk\hadoop-yarn-project\hadoop-yarn\hadoop-yarn-server\hadoop-yarn-server-nodemanager\src\test\java\org\apache\hadoop\yarn\server\nodemanager\containermanager\localizer\sharedcache\TestSharedCacheUploader.java,197,16,0,6,0,22
hadoop-trunk\hadoop-trunk\hadoop-common-project\hadoop-common\src\main\java\org\apache\hadoop\security\token\delegation\package-info.java,0,1,0,1,0,2
hadoop-trunk\hadoop-trunk\hadoop-hdfs-project\hadoop-hdfs-client\src\main\java\org\apache\hadoop\hdfs\web\resources\DeleteOpParam.java,0,9,1,1,0,11
hadoop-trunk\hadoop-trunk\hadoop-mapreduce-project\hadoop-mapreduce-client\hadoop-mapreduce-client-uploader\src\main\java\org\apache\hadoop\mapred\uploader\FrameworkUploader.java,542,95,53,1,0,149
hadoop-trunk\hadoop-trunk\hadoop-yarn-project\hadoop-yarn\hadoop-yarn-server\hadoop-yarn-server-applicationhistoryservice\src\main\java\org\apache\hadoop\yarn\server\timeline\TimelineStoreMapAdapter.java,0,6,0,1,0,7
hadoop-trunk\hadoop-trunk\hadoop-yarn-project\hadoop-yarn\hadoop-yarn-server\hadoop-yarn-server-router\src\main\java\org\apache\hadoop\yarn\server\router\webapp\HTTPMethods.java,0,5,0,1,0,6
hadoop-trunk\hadoop-trunk\hadoop-hdfs-project\hadoop-hdfs\src\main\java\org\apache\hadoop\hdfs\server\namenode\FSEditLogOpCodes.java,0,121,1,1,0,123
hadoop-trunk\hadoop-trunk\hadoop-tools\hadoop-streaming\src\test\java\org\apache\hadoop\streaming\OutputOnlyApp.java,13,3,1,1,0,5
hadoop-trunk\hadoop-trunk\hadoop-common-project\hadoop-common\src\test\java\org\apache\hadoop\test\MultithreadedTestUtil.java,173,27,6,1,0,34
hadoop-trunk\hadoop-trunk\hadoop-yarn-project\hadoop-yarn\hadoop-yarn-server\hadoop-yarn-server-nodemanager\src\main\java\org\apache\hadoop\yarn\server\nodemanager\containermanager\linux\runtime\OCIContainerRuntime.java,310,54,11,11,0,76
hadoop-trunk\hadoop-trunk\hadoop-mapreduce-project\hadoop-mapreduce-client\hadoop-mapreduce-client-app\src\test\java\org\apache\hadoop\mapreduce\v2\app\MockJobs.java,598,126,5,6,0,137
hadoop-trunk\hadoop-trunk\hadoop-yarn-project\hadoop-yarn\hadoop-yarn-server\hadoop-yarn-server-nodemanager\src\main\java\org\apache\hadoop\yarn\server\nodemanager\containermanager\loghandler\event\LogHandlerEvent.java,8,5,0,2,0,7
hadoop-trunk\hadoop-trunk\hadoop-hdfs-project\hadoop-hdfs\src\test\java\org\apache\hadoop\hdfs\server\namenode\TestHDFSConcat.java,515,183,18,5,0,206
hadoop-trunk\hadoop-trunk\hadoop-yarn-project\hadoop-yarn\hadoop-yarn-applications\hadoop-yarn-services\hadoop-yarn-services-core\src\main\java\org\apache\hadoop\yarn\service\api\records\PlacementConstraint.java,239,95,2,1,0,98
hadoop-trunk\hadoop-trunk\hadoop-mapreduce-project\hadoop-mapreduce-client\hadoop-mapreduce-client-core\src\main\java\org\apache\hadoop\mapreduce\lib\output\committer\manifest\impl\ManifestStoreOperations.java,245,16,2,6,0,24
hadoop-trunk\hadoop-trunk\hadoop-yarn-project\hadoop-yarn\hadoop-yarn-common\src\main\java\org\apache\hadoop\yarn\api\protocolrecords\impl\pb\NodePublishVolumeRequestPBImpl.java,167,35,52,3,0,90
hadoop-trunk\hadoop-trunk\hadoop-mapreduce-project\hadoop-mapreduce-examples\src\main\java\org\apache\hadoop\examples\terasort\TeraValidate.java,138,51,2,1,0,54
hadoop-trunk\hadoop-trunk\hadoop-yarn-project\hadoop-yarn\hadoop-yarn-server\hadoop-yarn-server-nodemanager\src\main\java\org\apache\hadoop\yarn\server\nodemanager\containermanager\linux\runtime\runc\HdfsManifestToResourcesPlugin.java,123,33,0,9,0,42
hadoop-trunk\hadoop-trunk\hadoop-yarn-project\hadoop-yarn\hadoop-yarn-server\hadoop-yarn-server-resourcemanager\src\test\java\org\apache\hadoop\yarn\server\resourcemanager\webapp\TestRMWebServicesDelegationTokens.java,680,58,8,8,0,74
hadoop-trunk\hadoop-trunk\hadoop-common-project\hadoop-common\src\test\java\org\apache\hadoop\io\erasurecode\rawcoder\TestRSLegacyRawCoder.java,10,1,0,1,0,2
hadoop-trunk\hadoop-trunk\hadoop-hdfs-project\hadoop-hdfs-rbf\src\main\java\org\apache\hadoop\hdfs\server\federation\resolver\FileSubclusterResolver.java,0,0,1,1,0,2
hadoop-trunk\hadoop-trunk\hadoop-tools\hadoop-azure\src\main\java\org\apache\hadoop\fs\azurebfs\utils\CRC64.java,39,8,1,1,0,10
hadoop-trunk\hadoop-trunk\hadoop-hdfs-project\hadoop-hdfs\src\test\java\org\apache\hadoop\hdfs\server\namenode\TestAddOverReplicatedStripedBlocks.java,252,24,2,1,0,27
hadoop-trunk\hadoop-trunk\hadoop-yarn-project\hadoop-yarn\hadoop-yarn-server\hadoop-yarn-server-resourcemanager\src\main\java\org\apache\hadoop\yarn\server\resourcemanager\scheduler\policy\FifoOrderingPolicyForPendingApps.java,0,11,4,2,0,17
hadoop-trunk\hadoop-trunk\hadoop-common-project\hadoop-common\src\test\java\org\apache\hadoop\cli\TestCLI.java,31,6,0,1,0,7
hadoop-trunk\hadoop-trunk\hadoop-common-project\hadoop-common\src\main\java\org\apache\hadoop\ipc\ResponseBuffer.java,75,38,0,1,0,39
hadoop-trunk\hadoop-trunk\hadoop-yarn-project\hadoop-yarn\hadoop-yarn-server\hadoop-yarn-server-resourcemanager\src\main\java\org\apache\hadoop\yarn\server\resourcemanager\webapp\dao\AppTimeoutsInfo.java,17,7,4,1,0,12
hadoop-trunk\hadoop-trunk\hadoop-yarn-project\hadoop-yarn\hadoop-yarn-server\hadoop-yarn-server-nodemanager\src\test\java\org\apache\hadoop\yarn\server\nodemanager\DummyContainerManager.java,159,42,13,22,0,77
hadoop-trunk\hadoop-trunk\hadoop-yarn-project\hadoop-yarn\hadoop-yarn-common\src\main\java\org\apache\hadoop\yarn\api\records\impl\pb\ContainerPBImpl.java,389,98,108,1,0,207
hadoop-trunk\hadoop-trunk\hadoop-tools\hadoop-azure\src\test\java\org\apache\hadoop\fs\azurebfs\contract\ITestAbfsFileSystemContractDelete.java,26,7,0,2,0,9
hadoop-trunk\hadoop-trunk\hadoop-tools\hadoop-azure\src\test\java\org\apache\hadoop\fs\azurebfs\diagnostics\package-info.java,0,2,1,1,0,4
hadoop-trunk\hadoop-trunk\hadoop-common-project\hadoop-common\src\main\java\org\apache\hadoop\metrics2\MetricType.java,0,2,0,1,0,3
hadoop-trunk\hadoop-trunk\hadoop-tools\hadoop-resourceestimator\src\test\java\org\apache\hadoop\resourceestimator\service\GuiceServletConfig.java,14,6,0,1,0,7
hadoop-trunk\hadoop-trunk\hadoop-common-project\hadoop-common\src\test\java\org\apache\hadoop\http\TestHttpCookieFlag.java,113,18,3,1,0,22
hadoop-trunk\hadoop-trunk\hadoop-yarn-project\hadoop-yarn\hadoop-yarn-server\hadoop-yarn-server-common\src\main\java\org\apache\hadoop\yarn\server\scheduler\DistributedOpportunisticContainerAllocator.java,0,60,7,1,0,68
hadoop-trunk\hadoop-trunk\hadoop-yarn-project\hadoop-yarn\hadoop-yarn-server\hadoop-yarn-server-resourcemanager\src\test\java\org\apache\hadoop\yarn\server\resourcemanager\monitor\capacity\TestProportionalCapacityPreemptionPolicyIntraQueueFairOrdering.java,0,33,0,3,0,36
hadoop-trunk\hadoop-trunk\hadoop-tools\hadoop-rumen\src\main\java\org\apache\hadoop\tools\rumen\ParsedTask.java,99,20,4,1,0,25
hadoop-trunk\hadoop-trunk\hadoop-hdfs-project\hadoop-hdfs\src\test\java\org\apache\hadoop\hdfs\server\datanode\TestDataNodeReconfiguration.java,681,104,10,74,0,188
hadoop-trunk\hadoop-trunk\hadoop-hdfs-project\hadoop-hdfs\src\test\java\org\apache\hadoop\hdfs\server\namenode\TestAuditLogger.java,0,101,22,10,0,133
hadoop-trunk\hadoop-trunk\hadoop-hdfs-project\hadoop-hdfs\src\main\java\org\apache\hadoop\hdfs\util\RwLock.java,0,13,8,1,0,22
hadoop-trunk\hadoop-trunk\hadoop-yarn-project\hadoop-yarn\hadoop-yarn-server\hadoop-yarn-server-nodemanager\src\main\java\org\apache\hadoop\yarn\server\nodemanager\containermanager\linux\runtime\docker\DockerImagesCommand.java,14,5,0,2,0,7
hadoop-trunk\hadoop-trunk\hadoop-mapreduce-project\hadoop-mapreduce-client\hadoop-mapreduce-client-jobclient\src\test\java\org\apache\hadoop\mapreduce\lib\chain\TestSingleElementChain.java,36,4,0,1,0,5
hadoop-trunk\hadoop-trunk\hadoop-tools\hadoop-aliyun\src\test\java\org\apache\hadoop\fs\aliyun\oss\fileContext\TestOSSFileContext.java,4,2,1,1,0,4
hadoop-trunk\hadoop-trunk\hadoop-hdfs-project\hadoop-hdfs\src\test\java\org\apache\hadoop\hdfs\TestQuotaAllowOwner.java,214,13,1,1,0,15
hadoop-trunk\hadoop-trunk\hadoop-hdfs-project\hadoop-hdfs-client\src\main\java\org\apache\hadoop\hdfs\protocol\ExtendedBlock.java,100,45,0,1,0,46
hadoop-trunk\hadoop-trunk\hadoop-mapreduce-project\hadoop-mapreduce-client\hadoop-mapreduce-client-core\src\main\java\org\apache\hadoop\mapreduce\lib\join\CompositeRecordReader.java,0,129,7,1,0,137
hadoop-trunk\hadoop-trunk\hadoop-tools\hadoop-resourceestimator\src\main\java\org\apache\hadoop\resourceestimator\translator\api\package-info.java,0,1,0,1,0,2
hadoop-trunk\hadoop-trunk\hadoop-hdfs-project\hadoop-hdfs-rbf\src\main\java\org\apache\hadoop\hdfs\server\federation\store\protocol\NamenodeHeartbeatRequest.java,24,6,0,2,0,8
hadoop-trunk\hadoop-trunk\hadoop-yarn-project\hadoop-yarn\hadoop-yarn-common\src\main\java\org\apache\hadoop\yarn\util\package-info.java,0,1,0,1,0,2
hadoop-trunk\hadoop-trunk\hadoop-yarn-project\hadoop-yarn\hadoop-yarn-server\hadoop-yarn-server-resourcemanager\src\main\java\org\apache\hadoop\yarn\server\resourcemanager\scheduler\fair\converter\weightconversion\WeightToPercentConverter.java,0,17,3,3,0,23
hadoop-trunk\hadoop-trunk\hadoop-yarn-project\hadoop-yarn\hadoop-yarn-server\hadoop-yarn-server-resourcemanager\src\main\java\org\apache\hadoop\yarn\server\resourcemanager\scheduler\placement\SingleConstraintAppPlacementAllocator.java,0,61,6,16,0,83
hadoop-trunk\hadoop-trunk\hadoop-hdfs-project\hadoop-hdfs\src\test\java\org\apache\hadoop\hdfs\server\namenode\TestCreateEditsLog.java,72,11,0,1,0,12
hadoop-trunk\hadoop-trunk\hadoop-yarn-project\hadoop-yarn\hadoop-yarn-server\hadoop-yarn-server-applicationhistoryservice\src\main\java\org\apache\hadoop\yarn\server\timeline\LeveldbTimelineStore.java,0,408,65,36,0,509
hadoop-trunk\hadoop-trunk\hadoop-mapreduce-project\hadoop-mapreduce-client\hadoop-mapreduce-client-core\src\main\java\org\apache\hadoop\mapred\SplitLocationInfo.java,22,16,0,1,0,17
hadoop-trunk\hadoop-trunk\hadoop-hdfs-project\hadoop-hdfs-client\src\main\java\org\apache\hadoop\fs\HdfsBlockLocation.java,28,9,1,1,0,11
hadoop-trunk\hadoop-trunk\hadoop-hdfs-project\hadoop-hdfs\src\test\java\org\apache\hadoop\hdfs\TestDatanodeStartupFixesLegacyStorageIDs.java,89,13,2,3,0,18
hadoop-trunk\hadoop-trunk\hadoop-tools\hadoop-aliyun\src\main\java\org\apache\hadoop\fs\aliyun\oss\package-info.java,0,2,0,1,0,3
hadoop-trunk\hadoop-trunk\hadoop-common-project\hadoop-common\src\main\java\org\apache\hadoop\util\CpuTimeTracker.java,88,18,0,1,0,19
hadoop-trunk\hadoop-trunk\hadoop-tools\hadoop-aws\src\test\java\org\apache\hadoop\fs\s3a\auth\ITestRestrictedReadAccess.java,0,18,4,3,0,25
hadoop-trunk\hadoop-trunk\hadoop-yarn-project\hadoop-yarn\hadoop-yarn-server\hadoop-yarn-server-router\src\main\java\org\apache\hadoop\yarn\server\router\webapp\NodesBlock.java,73,7,0,1,0,8
hadoop-trunk\hadoop-trunk\hadoop-hdfs-project\hadoop-hdfs-rbf\src\test\java\org\apache\hadoop\hdfs\server\federation\store\FederationStateStoreTestUtils.java,0,31,0,6,0,37
hadoop-trunk\hadoop-trunk\hadoop-yarn-project\hadoop-yarn\hadoop-yarn-server\hadoop-yarn-server-resourcemanager\src\main\java\org\apache\hadoop\yarn\server\resourcemanager\security\AppPriorityACLsManager.java,192,31,2,2,0,35
hadoop-trunk\hadoop-trunk\hadoop-yarn-project\hadoop-yarn\hadoop-yarn-server\hadoop-yarn-server-resourcemanager\src\main\java\org\apache\hadoop\yarn\server\resourcemanager\reservation\planning\IterativePlanner.java,349,65,9,7,0,81
hadoop-trunk\hadoop-trunk\hadoop-yarn-project\hadoop-yarn\hadoop-yarn-server\hadoop-yarn-server-resourcemanager\src\main\java\org\apache\hadoop\yarn\server\resourcemanager\webapp\dao\QueueAclsInfo.java,21,12,5,1,0,18
hadoop-trunk\hadoop-trunk\hadoop-yarn-project\hadoop-yarn\hadoop-yarn-client\src\test\java\org\apache\hadoop\yarn\client\api\impl\TestAMRMClientPlacementConstraints.java,285,102,19,2,0,123
hadoop-trunk\hadoop-trunk\hadoop-yarn-project\hadoop-yarn\hadoop-yarn-server\hadoop-yarn-server-timelineservice-hbase\hadoop-yarn-server-timelineservice-hbase-common\src\main\java\org\apache\hadoop\yarn\server\timelineservice\storage\apptoflow\AppToFlowColumnFamily.java,0,2,0,2,0,4
hadoop-trunk\hadoop-trunk\hadoop-hdfs-project\hadoop-hdfs\src\test\java\org\apache\hadoop\hdfs\server\namenode\TestStartup.java,730,156,24,16,0,196
hadoop-trunk\hadoop-trunk\hadoop-hdfs-project\hadoop-hdfs-client\src\main\java\org\apache\hadoop\hdfs\web\resources\BooleanParam.java,0,2,0,1,0,3
hadoop-trunk\hadoop-trunk\hadoop-yarn-project\hadoop-yarn\hadoop-yarn-server\hadoop-yarn-server-timelineservice-hbase\hadoop-yarn-server-timelineservice-hbase-client\src\main\java\org\apache\hadoop\yarn\server\timelineservice\storage\common\BaseTableRW.java,129,18,1,1,0,20
hadoop-trunk\hadoop-trunk\hadoop-hdfs-project\hadoop-hdfs\src\main\java\org\apache\hadoop\hdfs\server\sps\ExternalStoragePolicySatisfier.java,0,7,2,1,0,10
hadoop-trunk\hadoop-trunk\hadoop-yarn-project\hadoop-yarn\hadoop-yarn-applications\hadoop-yarn-services\hadoop-yarn-services-core\src\main\java\org\apache\hadoop\yarn\service\utils\PublishedConfiguration.java,147,43,4,1,0,48
hadoop-trunk\hadoop-trunk\hadoop-common-project\hadoop-common\src\main\java\org\apache\hadoop\util\hash\Hash.java,96,17,1,3,0,21
hadoop-trunk\hadoop-trunk\hadoop-common-project\hadoop-nfs\src\main\java\org\apache\hadoop\oncrpc\security\CredentialsSys.java,110,47,4,1,0,52
hadoop-trunk\hadoop-trunk\hadoop-hdfs-project\hadoop-hdfs\src\main\java\org\apache\hadoop\hdfs\server\namenode\IllegalReservedPathException.java,11,7,0,1,0,8
hadoop-trunk\hadoop-trunk\hadoop-maven-plugins\src\main\java\org\apache\hadoop\maven\plugin\paralleltests\CreateDirsMojo.java,72,24,0,1,0,25
hadoop-trunk\hadoop-trunk\hadoop-yarn-project\hadoop-yarn\hadoop-yarn-server\hadoop-yarn-server-resourcemanager\src\main\java\org\apache\hadoop\yarn\server\resourcemanager\webapp\RMAppAttemptBlock.java,529,45,0,14,0,59
hadoop-trunk\hadoop-trunk\hadoop-common-project\hadoop-common\src\main\java\org\apache\hadoop\util\bloom\RetouchedBloomFilter.java,0,75,7,16,0,98
hadoop-trunk\hadoop-trunk\hadoop-hdfs-project\hadoop-hdfs\src\main\java\org\apache\hadoop\hdfs\tools\DiskBalancerCLI.java,463,40,44,1,0,85
hadoop-trunk\hadoop-trunk\hadoop-yarn-project\hadoop-yarn\hadoop-yarn-common\src\main\java\org\apache\hadoop\yarn\client\ClientRMProxy.java,118,16,0,1,0,17
hadoop-trunk\hadoop-trunk\hadoop-hdfs-project\hadoop-hdfs\src\main\java\org\apache\hadoop\hdfs\qjournal\server\JournalNodeSyncer.java,462,68,30,3,0,101
hadoop-trunk\hadoop-trunk\hadoop-common-project\hadoop-common\src\test\java\org\apache\hadoop\service\launcher\testservices\StoppingInStartLaunchableService.java,0,6,0,2,0,8
hadoop-trunk\hadoop-trunk\hadoop-yarn-project\hadoop-yarn\hadoop-yarn-common\src\main\java\org\apache\hadoop\yarn\logaggregation\filecontroller\tfile\TFileAggregatedLogsBlock.java,160,26,10,2,0,38
hadoop-trunk\hadoop-trunk\hadoop-mapreduce-project\hadoop-mapreduce-client\hadoop-mapreduce-client-jobclient\src\test\java\org\apache\hadoop\mapred\join\TestDatamerge.java,369,122,28,1,0,151
hadoop-trunk\hadoop-trunk\hadoop-yarn-project\hadoop-yarn\hadoop-yarn-api\src\main\java\org\apache\hadoop\yarn\server\api\ContainerType.java,0,4,0,1,0,5
hadoop-trunk\hadoop-trunk\hadoop-mapreduce-project\hadoop-mapreduce-client\hadoop-mapreduce-client-jobclient\src\test\java\org\apache\hadoop\mapreduce\JobHistoryFileReplayMapperV2.java,0,17,8,4,0,29
hadoop-trunk\hadoop-trunk\hadoop-mapreduce-project\hadoop-mapreduce-client\hadoop-mapreduce-client-hs\src\main\java\org\apache\hadoop\mapreduce\v2\hs\webapp\HsJobsBlock.java,117,18,1,2,0,21
hadoop-trunk\hadoop-trunk\hadoop-hdfs-project\hadoop-hdfs-client\src\main\java\org\apache\hadoop\hdfs\protocol\LocatedBlock.java,242,92,1,2,0,95
hadoop-trunk\hadoop-trunk\hadoop-common-project\hadoop-common\src\main\java\org\apache\hadoop\crypto\OpensslCipher.java,0,116,5,4,0,125
hadoop-trunk\hadoop-trunk\hadoop-yarn-project\hadoop-yarn\hadoop-yarn-api\src\main\java\org\apache\hadoop\yarn\api\records\LogAggregationStatus.java,0,2,0,1,0,3
hadoop-trunk\hadoop-trunk\hadoop-tools\hadoop-aws\src\test\java\org\apache\hadoop\fs\s3a\auth\delegation\AbstractDelegationIT.java,170,13,0,4,0,17
hadoop-trunk\hadoop-trunk\hadoop-yarn-project\hadoop-yarn\hadoop-yarn-server\hadoop-yarn-server-resourcemanager\src\test\java\org\apache\hadoop\yarn\server\resourcemanager\scheduler\fair\TestConfigurableResource.java,43,14,0,1,0,15
hadoop-trunk\hadoop-trunk\hadoop-hdfs-project\hadoop-hdfs\src\test\java\org\apache\hadoop\fs\viewfs\TestNNStartupWhenViewFSOverloadSchemeEnabled.java,56,10,0,1,0,11
hadoop-trunk\hadoop-trunk\hadoop-yarn-project\hadoop-yarn\hadoop-yarn-common\src\main\java\org\apache\hadoop\yarn\security\SchedulerSecurityInfo.java,28,6,0,1,0,7
hadoop-trunk\hadoop-trunk\hadoop-mapreduce-project\hadoop-mapreduce-client\hadoop-mapreduce-client-app\src\main\java\org\apache\hadoop\mapreduce\v2\app\webapp\InfoPage.java,12,3,0,1,0,4
hadoop-trunk\hadoop-trunk\hadoop-common-project\hadoop-common\src\test\java\org\apache\hadoop\net\unix\TestDomainSocket.java,712,228,35,4,0,267
hadoop-trunk\hadoop-trunk\hadoop-mapreduce-project\hadoop-mapreduce-client\hadoop-mapreduce-client-core\src\main\java\org\apache\hadoop\mapred\lib\KeyFieldBasedComparator.java,0,8,0,1,0,9
hadoop-trunk\hadoop-trunk\hadoop-hdfs-project\hadoop-hdfs-httpfs\src\test\java\org\apache\hadoop\test\TestDir.java,0,0,0,1,0,1
hadoop-trunk\hadoop-trunk\hadoop-tools\hadoop-azure\src\test\java\org\apache\hadoop\fs\azure\integration\ITestAzureHugeFiles.java,394,35,43,1,0,79
hadoop-trunk\hadoop-trunk\hadoop-yarn-project\hadoop-yarn\hadoop-yarn-server\hadoop-yarn-server-nodemanager\src\main\java\org\apache\hadoop\yarn\server\nodemanager\nodelabels\NodeAttributesProvider.java,0,2,0,1,0,3
hadoop-trunk\hadoop-trunk\hadoop-mapreduce-project\hadoop-mapreduce-client\hadoop-mapreduce-client-core\src\main\java\org\apache\hadoop\mapreduce\checkpoint\RandomNameCNS.java,9,2,0,1,0,3
hadoop-trunk\hadoop-trunk\hadoop-common-project\hadoop-common\src\test\java\org\apache\hadoop\fs\contract\localfs\TestLocalFSContractRename.java,9,2,0,1,0,3
hadoop-trunk\hadoop-trunk\hadoop-yarn-project\hadoop-yarn\hadoop-yarn-server\hadoop-yarn-server-resourcemanager\src\main\java\org\apache\hadoop\yarn\server\resourcemanager\webapp\dao\ResourceUtilizationInfo.java,58,27,1,1,0,29
hadoop-trunk\hadoop-trunk\hadoop-common-project\hadoop-registry\src\main\java\org\apache\hadoop\registry\client\impl\zk\BindingInformation.java,13,5,0,1,0,6
hadoop-trunk\hadoop-trunk\hadoop-hdfs-project\hadoop-hdfs-rbf\src\test\java\org\apache\hadoop\fs\contract\router\TestRouterHDFSContractOpen.java,18,4,0,1,0,5
hadoop-trunk\hadoop-trunk\hadoop-yarn-project\hadoop-yarn\hadoop-yarn-server\hadoop-yarn-server-timelineservice-hbase\hadoop-yarn-server-timelineservice-hbase-common\src\main\java\org\apache\hadoop\yarn\server\timelineservice\storage\flow\Attribute.java,18,11,0,1,0,12
hadoop-trunk\hadoop-trunk\hadoop-common-project\hadoop-common\src\main\java\org\apache\hadoop\service\launcher\LaunchableService.java,0,2,0,1,0,3
hadoop-trunk\hadoop-trunk\hadoop-yarn-project\hadoop-yarn\hadoop-yarn-server\hadoop-yarn-server-resourcemanager\src\test\java\org\apache\hadoop\yarn\server\resourcemanager\monitor\capacity\TestProportionalCapacityPreemptionPolicyIntraQueueUserLimit.java,900,116,0,13,0,129
hadoop-trunk\hadoop-trunk\hadoop-hdfs-project\hadoop-hdfs\src\main\java\org\apache\hadoop\hdfs\tools\JMXGet.java,296,64,14,2,0,80
hadoop-trunk\hadoop-trunk\hadoop-yarn-project\hadoop-yarn\hadoop-yarn-server\hadoop-yarn-server-nodemanager\src\main\java\org\apache\hadoop\yarn\server\nodemanager\executor\ContainerStartContext.java,0,111,3,2,0,116
hadoop-trunk\hadoop-trunk\hadoop-tools\hadoop-azure\src\test\java\org\apache\hadoop\fs\azure\contract\ITestAzureNativeContractSeek.java,8,3,0,1,0,4
hadoop-trunk\hadoop-trunk\hadoop-yarn-project\hadoop-yarn\hadoop-yarn-server\hadoop-yarn-server-resourcemanager\src\test\java\org\apache\hadoop\yarn\server\resourcemanager\scheduler\capacity\TestContainerAllocation.java,1320,221,26,25,0,272
hadoop-trunk\hadoop-trunk\hadoop-yarn-project\hadoop-yarn\hadoop-yarn-server\hadoop-yarn-server-timelineservice\src\main\java\org\apache\hadoop\yarn\server\timelineservice\reader\TimelineParseConstants.java,0,8,0,1,0,9
hadoop-trunk\hadoop-trunk\hadoop-common-project\hadoop-common\src\main\java\org\apache\hadoop\ipc\ClientCache.java,90,19,0,3,0,22
hadoop-trunk\hadoop-trunk\hadoop-hdfs-project\hadoop-hdfs-client\src\main\java\org\apache\hadoop\hdfs\ReplicaAccessor.java,68,3,0,1,0,4
hadoop-trunk\hadoop-trunk\hadoop-common-project\hadoop-auth\src\test\java\org\apache\hadoop\security\authentication\client\AuthenticatorTestCase.java,208,52,13,9,0,74
hadoop-trunk\hadoop-trunk\hadoop-yarn-project\hadoop-yarn\hadoop-yarn-server\hadoop-yarn-server-common\src\main\java\org\apache\hadoop\yarn\server\federation\store\records\SubClusterIdInfo.java,41,9,0,1,0,10
hadoop-trunk\hadoop-trunk\hadoop-mapreduce-project\hadoop-mapreduce-client\hadoop-mapreduce-client-jobclient\src\test\java\org\apache\hadoop\fs\slive\MkdirOp.java,0,9,3,1,0,13
hadoop-trunk\hadoop-trunk\hadoop-yarn-project\hadoop-yarn\hadoop-yarn-server\hadoop-yarn-server-resourcemanager\src\test\java\org\apache\hadoop\yarn\server\resourcemanager\scheduler\capacity\TestNodeLabelContainerAllocation.java,3401,907,156,53,0,1116
hadoop-trunk\hadoop-trunk\hadoop-mapreduce-project\hadoop-mapreduce-examples\src\main\java\org\apache\hadoop\examples\SecondarySort.java,190,90,2,3,0,95
hadoop-trunk\hadoop-trunk\hadoop-mapreduce-project\hadoop-mapreduce-client\hadoop-mapreduce-client-jobclient\src\test\java\org\apache\hadoop\mapred\TestMRTimelineEventHandling.java,508,54,19,5,0,78
hadoop-trunk\hadoop-trunk\hadoop-yarn-project\hadoop-yarn\hadoop-yarn-common\src\main\java\org\apache\hadoop\yarn\api\protocolrecords\impl\pb\GetContainerStatusesResponsePBImpl.java,179,37,67,4,0,108
hadoop-trunk\hadoop-trunk\hadoop-yarn-project\hadoop-yarn\hadoop-yarn-server\hadoop-yarn-server-resourcemanager\src\test\java\org\apache\hadoop\yarn\server\resourcemanager\TestDecommissioningNodesWatcher.java,0,19,1,2,0,22
hadoop-trunk\hadoop-trunk\hadoop-mapreduce-project\hadoop-mapreduce-client\hadoop-mapreduce-client-core\src\main\java\org\apache\hadoop\mapred\lib\DelegatingInputFormat.java,0,15,16,2,0,33
hadoop-trunk\hadoop-trunk\hadoop-mapreduce-project\hadoop-mapreduce-client\hadoop-mapreduce-client-common\src\main\java\org\apache\hadoop\mapreduce\v2\api\protocolrecords\CancelDelegationTokenResponse.java,0,0,0,1,0,1
hadoop-trunk\hadoop-trunk\hadoop-yarn-project\hadoop-yarn\hadoop-yarn-server\hadoop-yarn-server-resourcemanager\src\test\java\org\apache\hadoop\yarn\server\resourcemanager\TestAMAuthorization.java,0,68,5,14,0,87
hadoop-trunk\hadoop-trunk\hadoop-yarn-project\hadoop-yarn\hadoop-yarn-server\hadoop-yarn-server-resourcemanager\src\main\java\org\apache\hadoop\yarn\server\resourcemanager\reservation\planning\TryManyReservationAgents.java,84,19,1,2,0,22
hadoop-trunk\hadoop-trunk\hadoop-common-project\hadoop-common\src\test\java\org\apache\hadoop\fs\statistics\TestMeanStatistic.java,189,32,0,1,0,33
hadoop-trunk\hadoop-trunk\hadoop-hdfs-project\hadoop-hdfs\src\test\java\org\apache\hadoop\metrics2\sink\TestRollingFileSystemSinkWithSecureHdfs.java,0,13,1,11,0,25
hadoop-trunk\hadoop-trunk\hadoop-hdfs-project\hadoop-hdfs\src\main\java\org\apache\hadoop\hdfs\server\protocol\ReceivedDeletedBlockInfo.java,92,49,1,1,0,51
hadoop-trunk\hadoop-trunk\hadoop-yarn-project\hadoop-yarn\hadoop-yarn-server\hadoop-yarn-server-resourcemanager\src\test\java\org\apache\hadoop\yarn\server\resourcemanager\TestRMTimelineService.java,0,19,0,5,0,24
hadoop-trunk\hadoop-trunk\hadoop-common-project\hadoop-common\src\main\java\org\apache\hadoop\io\Text.java,0,209,32,8,0,249
hadoop-trunk\hadoop-trunk\hadoop-tools\hadoop-extras\src\main\java\org\apache\hadoop\tools\package-info.java,0,0,0,1,0,1
hadoop-trunk\hadoop-trunk\hadoop-yarn-project\hadoop-yarn\hadoop-yarn-server\hadoop-yarn-server-timelineservice-hbase\hadoop-yarn-server-timelineservice-hbase-common\src\main\java\org\apache\hadoop\yarn\server\timelineservice\storage\common\StringKeyConverter.java,0,3,2,1,0,6
hadoop-trunk\hadoop-trunk\hadoop-mapreduce-project\hadoop-mapreduce-client\hadoop-mapreduce-client-core\src\main\java\org\apache\hadoop\mapreduce\lib\output\committer\manifest\files\DiagnosticKeys.java,0,3,0,1,0,4
hadoop-trunk\hadoop-trunk\hadoop-yarn-project\hadoop-yarn\hadoop-yarn-server\hadoop-yarn-server-common\src\main\java\org\apache\hadoop\yarn\server\volume\csi\VolumeMetaData.java,198,56,0,2,0,58
hadoop-trunk\hadoop-trunk\hadoop-mapreduce-project\hadoop-mapreduce-client\hadoop-mapreduce-client-core\src\main\java\org\apache\hadoop\mapreduce\lib\output\committer\manifest\stages\CreateOutputDirectoriesStage.java,0,36,13,16,0,65
hadoop-trunk\hadoop-trunk\hadoop-common-project\hadoop-common\src\test\java\org\apache\hadoop\conf\TestDeprecatedKeys.java,77,13,7,2,0,22
hadoop-trunk\hadoop-trunk\hadoop-mapreduce-project\hadoop-mapreduce-client\hadoop-mapreduce-client-core\src\main\java\org\apache\hadoop\mapred\lib\aggregate\LongValueSum.java,0,3,0,1,0,4
hadoop-trunk\hadoop-trunk\hadoop-mapreduce-project\hadoop-mapreduce-client\hadoop-mapreduce-client-hs\src\test\java\org\apache\hadoop\mapreduce\v2\hs\webapp\TestHSWebApp.java,0,37,4,5,0,46
hadoop-trunk\hadoop-trunk\hadoop-mapreduce-project\hadoop-mapreduce-client\hadoop-mapreduce-client-jobclient\src\test\java\org\apache\hadoop\mapreduce\TestClientProtocolProviderImpls.java,66,5,0,1,0,6
hadoop-trunk\hadoop-trunk\hadoop-common-project\hadoop-common\src\test\java\org\apache\hadoop\ha\DummyHAService.java,0,95,11,7,0,113
hadoop-trunk\hadoop-trunk\hadoop-yarn-project\hadoop-yarn\hadoop-yarn-api\src\main\java\org\apache\hadoop\yarn\api\records\ShellContainerCommand.java,0,2,0,1,0,3
hadoop-trunk\hadoop-trunk\hadoop-yarn-project\hadoop-yarn\hadoop-yarn-api\src\main\java\org\apache\hadoop\yarn\exceptions\ApplicationNotFoundException.java,18,11,1,1,0,13
hadoop-trunk\hadoop-trunk\hadoop-yarn-project\hadoop-yarn\hadoop-yarn-server\hadoop-yarn-server-resourcemanager\src\test\java\org\apache\hadoop\yarn\server\resourcemanager\placement\TestPlacementManager.java,111,16,0,8,0,24
hadoop-trunk\hadoop-trunk\hadoop-yarn-project\hadoop-yarn\hadoop-yarn-server\hadoop-yarn-server-resourcemanager\src\main\java\org\apache\hadoop\yarn\server\resourcemanager\webapp\FairSchedulerPage.java,253,69,0,14,0,83
hadoop-trunk\hadoop-trunk\hadoop-yarn-project\hadoop-yarn\hadoop-yarn-api\src\main\java\org\apache\hadoop\yarn\api\protocolrecords\ReservationDeleteRequest.java,38,10,0,2,0,12
hadoop-trunk\hadoop-trunk\hadoop-yarn-project\hadoop-yarn\hadoop-yarn-server\hadoop-yarn-server-resourcemanager\src\test\java\org\apache\hadoop\yarn\server\resourcemanager\recovery\TestZKRMStateStoreZKClientConnections.java,130,27,3,3,0,33
hadoop-trunk\hadoop-trunk\hadoop-yarn-project\hadoop-yarn\hadoop-yarn-server\hadoop-yarn-server-resourcemanager\src\main\java\org\apache\hadoop\yarn\server\resourcemanager\scheduler\policy\FifoComparator.java,0,7,0,1,0,8
hadoop-trunk\hadoop-trunk\hadoop-mapreduce-project\hadoop-mapreduce-client\hadoop-mapreduce-client-core\src\main\java\org\apache\hadoop\mapreduce\util\package-info.java,0,1,0,1,0,2
hadoop-trunk\hadoop-trunk\hadoop-mapreduce-project\hadoop-mapreduce-client\hadoop-mapreduce-client-jobclient\src\test\java\org\apache\hadoop\mapred\TestFixedLengthInputFormat.java,379,115,30,1,0,146
hadoop-trunk\hadoop-trunk\hadoop-common-project\hadoop-common\src\main\java\org\apache\hadoop\metrics2\impl\MetricsSourceAdapter.java,0,86,13,1,0,100
hadoop-trunk\hadoop-trunk\hadoop-yarn-project\hadoop-yarn\hadoop-yarn-server\hadoop-yarn-server-common\src\main\java\org\apache\hadoop\yarn\server\api\records\impl\pb\NodeStatusPBImpl.java,442,113,105,6,0,224
hadoop-trunk\hadoop-trunk\hadoop-mapreduce-project\hadoop-mapreduce-client\hadoop-mapreduce-client-jobclient\src\test\java\org\apache\hadoop\mapred\jobcontrol\JobControlTestUtils.java,111,36,4,3,0,43
hadoop-trunk\hadoop-trunk\hadoop-hdfs-project\hadoop-hdfs-rbf\src\main\java\org\apache\hadoop\hdfs\server\federation\store\StateStoreCacheUpdateService.java,37,7,0,1,0,8
hadoop-trunk\hadoop-trunk\hadoop-tools\hadoop-gridmix\src\main\java\org\apache\hadoop\mapred\gridmix\emulators\resourceusage\ResourceUsageEmulatorPlugin.java,0,15,0,1,0,16
hadoop-trunk\hadoop-trunk\hadoop-mapreduce-project\hadoop-mapreduce-client\hadoop-mapreduce-client-app\src\main\java\org\apache\hadoop\mapreduce\v2\app\MRClientSecurityInfo.java,28,6,0,1,0,7
hadoop-trunk\hadoop-trunk\hadoop-mapreduce-project\hadoop-mapreduce-client\hadoop-mapreduce-client-core\src\main\java\org\apache\hadoop\mapreduce\lib\join\TupleWritable.java,0,73,11,5,0,89
hadoop-trunk\hadoop-trunk\hadoop-yarn-project\hadoop-yarn\hadoop-yarn-api\src\main\java\org\apache\hadoop\yarn\api\protocolrecords\GetPluginInfoResponse.java,20,7,0,1,0,8
hadoop-trunk\hadoop-trunk\hadoop-tools\hadoop-streaming\src\main\java\org\apache\hadoop\typedbytes\TypedBytesOutput.java,301,63,15,2,0,80
hadoop-trunk\hadoop-trunk\hadoop-tools\hadoop-dynamometer\hadoop-dynamometer-workload\src\main\java\org\apache\hadoop\tools\dynamometer\workloadgenerator\VirtualRecordReader.java,0,16,2,1,0,19
hadoop-trunk\hadoop-trunk\hadoop-yarn-project\hadoop-yarn\hadoop-yarn-server\hadoop-yarn-server-nodemanager\src\test\java\org\apache\hadoop\yarn\server\nodemanager\health\TestExceptionReporter.java,16,2,0,1,0,3
hadoop-trunk\hadoop-trunk\hadoop-yarn-project\hadoop-yarn\hadoop-yarn-server\hadoop-yarn-server-resourcemanager\src\main\java\org\apache\hadoop\yarn\server\resourcemanager\scheduler\constraint\api\ConstraintPlacementAlgorithm.java,0,0,0,1,0,1
hadoop-trunk\hadoop-trunk\hadoop-yarn-project\hadoop-yarn\hadoop-yarn-server\hadoop-yarn-server-timelineservice-documentstore\src\main\java\org\apache\hadoop\yarn\server\timelineservice\documentstore\writer\cosmosdb\package-info.java,0,0,0,2,0,2
hadoop-trunk\hadoop-trunk\hadoop-common-project\hadoop-common\src\test\java\org\apache\hadoop\service\BreakableService.java,95,45,0,1,0,46
hadoop-trunk\hadoop-trunk\hadoop-yarn-project\hadoop-yarn\hadoop-yarn-server\hadoop-yarn-server-timelineservice-hbase\hadoop-yarn-server-timelineservice-hbase-client\src\main\java\org\apache\hadoop\yarn\server\timelineservice\storage\flow\FlowRunTableRW.java,66,8,3,1,0,12
hadoop-trunk\hadoop-trunk\hadoop-common-project\hadoop-common\src\main\java\org\apache\hadoop\io\file\tfile\TFile.java,2231,424,39,14,0,477
hadoop-trunk\hadoop-trunk\hadoop-yarn-project\hadoop-yarn\hadoop-yarn-server\hadoop-yarn-server-nodemanager\src\main\java\org\apache\hadoop\yarn\server\nodemanager\amrmproxy\FederationInterceptor.java,1702,107,65,15,0,187
hadoop-trunk\hadoop-trunk\hadoop-common-project\hadoop-common\src\test\java\org\apache\hadoop\util\TestConfTest.java,178,18,1,2,0,21
hadoop-trunk\hadoop-trunk\hadoop-yarn-project\hadoop-yarn\hadoop-yarn-server\hadoop-yarn-server-router\src\test\java\org\apache\hadoop\yarn\server\router\webapp\TestRouterWebServices.java,276,8,1,8,0,17
hadoop-trunk\hadoop-trunk\hadoop-hdfs-project\hadoop-hdfs\src\test\java\org\apache\hadoop\fs\viewfs\TestViewFileSystemWithXAttrs.java,114,24,3,1,0,28
hadoop-trunk\hadoop-trunk\hadoop-yarn-project\hadoop-yarn\hadoop-yarn-api\src\main\java\org\apache\hadoop\yarn\api\records\NodeId.java,100,24,7,1,0,32
hadoop-trunk\hadoop-trunk\hadoop-yarn-project\hadoop-yarn\hadoop-yarn-api\src\main\java\org\apache\hadoop\yarn\api\protocolrecords\ValidateVolumeCapabilitiesRequest.java,90,34,0,1,0,35
hadoop-trunk\hadoop-trunk\hadoop-tools\hadoop-aws\src\main\java\org\apache\hadoop\fs\s3a\S3ADataBlocks.java,0,124,14,1,0,139
hadoop-trunk\hadoop-trunk\hadoop-yarn-project\hadoop-yarn\hadoop-yarn-server\hadoop-yarn-server-resourcemanager\src\main\java\org\apache\hadoop\yarn\server\resourcemanager\recovery\StoreLimitException.java,8,2,0,1,0,3
hadoop-trunk\hadoop-trunk\hadoop-tools\hadoop-azure\src\test\java\org\apache\hadoop\fs\azurebfs\extensions\MockDelegationSASTokenProvider.java,105,53,2,28,0,83
hadoop-trunk\hadoop-trunk\hadoop-tools\hadoop-sls\src\main\java\org\apache\hadoop\yarn\sls\scheduler\SchedulerMetrics.java,661,127,21,10,0,158
hadoop-trunk\hadoop-trunk\hadoop-yarn-project\hadoop-yarn\hadoop-yarn-common\src\test\java\org\apache\hadoop\yarn\api\records\TestResourceUtilization.java,87,51,0,1,0,52
hadoop-trunk\hadoop-trunk\hadoop-yarn-project\hadoop-yarn\hadoop-yarn-server\hadoop-yarn-server-resourcemanager\src\main\java\org\apache\hadoop\yarn\server\resourcemanager\scheduler\capacity\QueueAppLifetimeAndLimitSettings.java,108,34,3,8,0,45
hadoop-trunk\hadoop-trunk\hadoop-yarn-project\hadoop-yarn\hadoop-yarn-server\hadoop-yarn-server-router\src\test\java\org\apache\hadoop\yarn\server\router\webapp\TestFederationInterceptorREST.java,502,19,1,9,0,29
hadoop-trunk\hadoop-trunk\hadoop-yarn-project\hadoop-yarn\hadoop-yarn-server\hadoop-yarn-server-resourcemanager\src\main\java\org\apache\hadoop\yarn\server\resourcemanager\scheduler\fair\FSAppAttempt.java,0,173,19,11,0,203
hadoop-trunk\hadoop-trunk\hadoop-hdfs-project\hadoop-hdfs-client\src\main\java\org\apache\hadoop\hdfs\web\resources\XAttrNameParam.java,22,6,1,1,0,8
hadoop-trunk\hadoop-trunk\hadoop-tools\hadoop-aws\src\test\java\org\apache\hadoop\fs\s3a\auth\delegation\ITestRoleDelegationInFileystem.java,34,3,0,4,0,7
hadoop-trunk\hadoop-trunk\hadoop-yarn-project\hadoop-yarn\hadoop-yarn-common\src\main\java\org\apache\hadoop\yarn\api\records\impl\pb\NodeAttributePBImpl.java,136,29,43,1,0,73
hadoop-trunk\hadoop-trunk\hadoop-yarn-project\hadoop-yarn\hadoop-yarn-server\hadoop-yarn-server-nodemanager\src\test\java\org\apache\hadoop\yarn\server\nodemanager\webapp\MockApp.java,69,54,1,6,0,61
hadoop-trunk\hadoop-trunk\hadoop-yarn-project\hadoop-yarn\hadoop-yarn-server\hadoop-yarn-server-sharedcachemanager\src\main\java\org\apache\hadoop\yarn\server\sharedcachemanager\SharedCacheManager.java,118,19,2,2,0,23
hadoop-trunk\hadoop-trunk\hadoop-common-project\hadoop-nfs\src\main\java\org\apache\hadoop\nfs\nfs3\request\LINK3Request.java,36,17,0,1,0,18
hadoop-trunk\hadoop-trunk\hadoop-mapreduce-project\hadoop-mapreduce-examples\src\main\java\org\apache\hadoop\examples\dancing\Sudoku.java,293,163,9,1,0,173
hadoop-trunk\hadoop-trunk\hadoop-yarn-project\hadoop-yarn\hadoop-yarn-server\hadoop-yarn-server-nodemanager\src\main\java\org\apache\hadoop\yarn\server\nodemanager\containermanager\volume\csi\ContainerVolumePublisher.java,162,20,9,5,0,34
hadoop-trunk\hadoop-trunk\hadoop-hdfs-project\hadoop-hdfs\src\main\java\org\apache\hadoop\hdfs\server\balancer\Matcher.java,0,24,4,1,0,29
hadoop-trunk\hadoop-trunk\hadoop-hdfs-project\hadoop-hdfs-client\src\main\java\org\apache\hadoop\hdfs\protocol\SystemErasureCodingPolicies.java,0,21,0,1,0,22
hadoop-trunk\hadoop-trunk\hadoop-common-project\hadoop-common\src\main\java\org\apache\hadoop\util\RunJar.java,342,35,5,1,0,41
hadoop-trunk\hadoop-trunk\hadoop-hdfs-project\hadoop-hdfs\src\main\java\org\apache\hadoop\hdfs\server\namenode\LogsPurgeable.java,0,7,1,1,0,9
hadoop-trunk\hadoop-trunk\hadoop-mapreduce-project\hadoop-mapreduce-client\hadoop-mapreduce-client-core\src\test\java\org\apache\hadoop\mapreduce\lib\output\committer\manifest\impl\UnreliableManifestStoreOperations.java,326,48,1,7,0,56
hadoop-trunk\hadoop-trunk\hadoop-yarn-project\hadoop-yarn\hadoop-yarn-server\hadoop-yarn-server-resourcemanager\src\test\java\org\apache\hadoop\yarn\server\resourcemanager\scheduler\capacity\TestCapacityScheduler.java,2769,620,153,121,0,894
hadoop-trunk\hadoop-trunk\hadoop-common-project\hadoop-common\src\main\java\org\apache\hadoop\metrics2\util\SampleStat.java,174,57,5,1,0,63
hadoop-trunk\hadoop-trunk\hadoop-tools\hadoop-aws\src\test\java\org\apache\hadoop\fs\s3a\impl\TestNetworkBinding.java,72,13,1,2,0,16
hadoop-trunk\hadoop-trunk\hadoop-yarn-project\hadoop-yarn\hadoop-yarn-server\hadoop-yarn-server-resourcemanager\src\main\java\org\apache\hadoop\yarn\server\resourcemanager\scheduler\TimeBucketMetrics.java,0,32,2,1,0,35
hadoop-trunk\hadoop-trunk\hadoop-hdfs-project\hadoop-hdfs-rbf\src\main\java\org\apache\hadoop\hdfs\server\federation\store\driver\package-info.java,0,2,0,1,0,3
hadoop-trunk\hadoop-trunk\hadoop-mapreduce-project\hadoop-mapreduce-client\hadoop-mapreduce-client-core\src\main\java\org\apache\hadoop\mapreduce\lib\aggregate\ValueAggregatorReducer.java,0,12,3,1,0,16
hadoop-trunk\hadoop-trunk\hadoop-tools\hadoop-rumen\src\main\java\org\apache\hadoop\tools\rumen\Anonymizer.java,229,61,7,1,0,69
hadoop-trunk\hadoop-trunk\hadoop-hdfs-project\hadoop-hdfs-rbf\src\test\java\org\apache\hadoop\hdfs\server\federation\router\TestRouterFaultTolerant.java,594,53,4,13,0,70
hadoop-trunk\hadoop-trunk\hadoop-hdfs-project\hadoop-hdfs\src\test\java\org\apache\hadoop\hdfs\server\datanode\extdataset\ExternalReplicaInPipeline.java,113,30,8,1,0,39
hadoop-trunk\hadoop-trunk\hadoop-yarn-project\hadoop-yarn\hadoop-yarn-server\hadoop-yarn-server-nodemanager\src\test\java\org\apache\hadoop\yarn\server\nodemanager\containermanager\linux\resources\TestCompareResourceCalculators.java,187,42,8,2,0,52
hadoop-trunk\hadoop-trunk\hadoop-tools\hadoop-aws\src\main\java\org\apache\hadoop\fs\s3a\statistics\S3AMultipartUploaderStatistics.java,15,6,0,1,0,7
hadoop-trunk\hadoop-trunk\hadoop-yarn-project\hadoop-yarn\hadoop-yarn-server\hadoop-yarn-server-web-proxy\src\main\java\org\apache\hadoop\yarn\server\webproxy\ProxyUriUtils.java,199,58,2,4,0,64
hadoop-trunk\hadoop-trunk\hadoop-hdfs-project\hadoop-hdfs\src\main\java\org\apache\hadoop\hdfs\server\datanode\DataStorage.java,1361,278,38,7,0,323
hadoop-trunk\hadoop-trunk\hadoop-mapreduce-project\hadoop-mapreduce-client\hadoop-mapreduce-client-jobclient\src\test\java\org\apache\hadoop\fs\slive\WeightSelector.java,0,32,4,2,0,38
hadoop-trunk\hadoop-trunk\hadoop-tools\hadoop-azure\src\test\java\org\apache\hadoop\fs\azure\metrics\TestNativeAzureFileSystemMetricsSystem.java,70,16,5,4,0,25
hadoop-trunk\hadoop-trunk\hadoop-yarn-project\hadoop-yarn\hadoop-yarn-common\src\test\java\org\apache\hadoop\yarn\webapp\TestSubViews.java,46,12,2,1,0,15
hadoop-trunk\hadoop-trunk\hadoop-hdfs-project\hadoop-hdfs\src\main\java\org\apache\hadoop\hdfs\security\token\block\BlockKey.java,15,12,0,1,0,13
hadoop-trunk\hadoop-trunk\hadoop-hdfs-project\hadoop-hdfs\src\test\java\org\apache\hadoop\fs\TestUnbuffer.java,124,11,6,1,0,18
hadoop-trunk\hadoop-trunk\hadoop-mapreduce-project\hadoop-mapreduce-client\hadoop-mapreduce-client-common\src\main\java\org\apache\hadoop\mapreduce\v2\api\protocolrecords\impl\pb\GetJobReportRequestPBImpl.java,79,34,33,5,0,72
hadoop-trunk\hadoop-trunk\hadoop-yarn-project\hadoop-yarn\hadoop-yarn-server\hadoop-yarn-server-applicationhistoryservice\src\main\java\org\apache\hadoop\yarn\server\applicationhistoryservice\records\impl\pb\ApplicationAttemptFinishDataPBImpl.java,205,45,67,6,0,118
hadoop-trunk\hadoop-trunk\hadoop-yarn-project\hadoop-yarn\hadoop-yarn-server\hadoop-yarn-server-nodemanager\src\main\java\org\apache\hadoop\yarn\server\nodemanager\containermanager\launcher\RecoverPausedContainerLaunch.java,93,16,9,4,0,29
hadoop-trunk\hadoop-trunk\hadoop-yarn-project\hadoop-yarn\hadoop-yarn-applications\hadoop-yarn-applications-distributedshell\src\main\java\org\apache\hadoop\yarn\applications\distributedshell\ApplicationMaster.java,0,260,69,15,0,344
hadoop-trunk\hadoop-trunk\hadoop-common-project\hadoop-common\src\test\java\org\apache\hadoop\io\erasurecode\TestECSchema.java,69,6,0,1,0,7
hadoop-trunk\hadoop-trunk\hadoop-hdfs-project\hadoop-hdfs-httpfs\src\test\java\org\apache\hadoop\lib\wsrs\TestParam.java,101,24,5,3,0,32
hadoop-trunk\hadoop-trunk\hadoop-tools\hadoop-azure\src\test\java\org\apache\hadoop\fs\azurebfs\commit\ITestAbfsCleanupStage.java,26,5,0,2,0,7
hadoop-trunk\hadoop-trunk\hadoop-hdfs-project\hadoop-hdfs\src\test\java\org\apache\hadoop\hdfs\server\namenode\TestNameNodeMetadataConsistency.java,139,17,4,1,0,22
hadoop-trunk\hadoop-trunk\hadoop-hdfs-project\hadoop-hdfs\src\test\java\org\apache\hadoop\hdfs\TestDatanodeReport.java,188,41,6,9,0,56
hadoop-trunk\hadoop-trunk\hadoop-yarn-project\hadoop-yarn\hadoop-yarn-applications\hadoop-yarn-services\hadoop-yarn-services-core\src\main\java\org\apache\hadoop\yarn\service\ClientAMProtocol.java,0,9,36,10,0,55
hadoop-trunk\hadoop-trunk\hadoop-yarn-project\hadoop-yarn\hadoop-yarn-server\hadoop-yarn-server-resourcemanager\src\main\java\org\apache\hadoop\yarn\server\resourcemanager\scheduler\fair\FSParentQueue.java,288,66,2,4,0,72
hadoop-trunk\hadoop-trunk\hadoop-mapreduce-project\hadoop-mapreduce-client\hadoop-mapreduce-client-jobclient\src\test\java\org\apache\hadoop\mapred\TestLocalMRNotification.java,8,1,0,1,0,2
hadoop-trunk\hadoop-trunk\hadoop-yarn-project\hadoop-yarn\hadoop-yarn-server\hadoop-yarn-server-common\src\main\java\org\apache\hadoop\yarn\server\webapp\dao\RemoteLogPathEntry.java,29,22,1,1,0,24
hadoop-trunk\hadoop-trunk\hadoop-common-project\hadoop-common\src\main\java\org\apache\hadoop\security\authorize\ServiceAuthorizationManager.java,196,74,6,10,0,90
hadoop-trunk\hadoop-trunk\hadoop-hdfs-project\hadoop-hdfs\src\main\java\org\apache\hadoop\hdfs\protocolPB\DatanodeProtocolPB.java,0,2,3,2,0,7
hadoop-trunk\hadoop-trunk\hadoop-hdfs-project\hadoop-hdfs-rbf\src\main\java\org\apache\hadoop\hdfs\server\federation\store\StateStoreUnavailableException.java,9,3,0,1,0,4
hadoop-trunk\hadoop-trunk\hadoop-yarn-project\hadoop-yarn\hadoop-yarn-server\hadoop-yarn-server-applicationhistoryservice\src\main\java\org\apache\hadoop\yarn\server\applicationhistoryservice\webapp\AHSErrorsAndWarningsPage.java,0,4,1,1,0,6
hadoop-trunk\hadoop-trunk\hadoop-cloud-storage-project\hadoop-huaweicloud\src\main\java\org\apache\hadoop\fs\obs\OBSListing.java,0,0,1,1,0,2
hadoop-trunk\hadoop-trunk\hadoop-hdfs-project\hadoop-hdfs\src\main\java\org\apache\hadoop\hdfs\server\datanode\FileIoProvider.java,1002,196,1,1,0,198
hadoop-trunk\hadoop-trunk\hadoop-cloud-storage-project\hadoop-huaweicloud\src\test\java\org\apache\hadoop\fs\obs\TestOBSContractSeek.java,8,1,0,1,0,2
hadoop-trunk\hadoop-trunk\hadoop-common-project\hadoop-common\src\main\java\org\apache\hadoop\ipc\DecayRpcSchedulerMXBean.java,0,7,0,1,0,8
hadoop-trunk\hadoop-trunk\hadoop-common-project\hadoop-common\src\test\java\org\apache\hadoop\crypto\key\TestCachingKeyProvider.java,132,25,5,1,0,31
hadoop-trunk\hadoop-trunk\hadoop-hdfs-project\hadoop-hdfs-rbf\src\main\java\org\apache\hadoop\hdfs\server\federation\store\protocol\impl\pb\DisableNameserviceRequestPBImpl.java,0,12,29,5,0,46
hadoop-trunk\hadoop-trunk\hadoop-tools\hadoop-aws\src\test\java\org\apache\hadoop\fs\s3a\impl\ITestPartialRenamesDeletes.java,667,35,19,4,0,58
hadoop-trunk\hadoop-trunk\hadoop-tools\hadoop-azure\src\main\java\org\apache\hadoop\fs\azure\security\WasbTokenRenewer.java,60,7,1,1,0,9
hadoop-trunk\hadoop-trunk\hadoop-mapreduce-project\hadoop-mapreduce-client\hadoop-mapreduce-client-nativetask\src\main\java\org\apache\hadoop\mapred\nativetask\buffer\OutputBuffer.java,52,21,1,1,0,23
hadoop-trunk\hadoop-trunk\hadoop-yarn-project\hadoop-yarn\hadoop-yarn-server\hadoop-yarn-server-nodemanager\src\main\java\org\apache\hadoop\yarn\server\nodemanager\containermanager\resourceplugin\gpu\NvidiaBinaryHelper.java,29,1,0,4,0,5
hadoop-trunk\hadoop-trunk\hadoop-yarn-project\hadoop-yarn\hadoop-yarn-common\src\main\java\org\apache\hadoop\yarn\security\Permission.java,21,11,0,1,0,12
hadoop-trunk\hadoop-trunk\hadoop-hdfs-project\hadoop-hdfs-httpfs\src\main\java\org\apache\hadoop\fs\http\server\FSOperations.java,0,441,52,36,0,529
hadoop-trunk\hadoop-trunk\hadoop-common-project\hadoop-common\src\main\java\org\apache\hadoop\util\IPList.java,0,3,1,1,0,5
hadoop-trunk\hadoop-trunk\hadoop-hdfs-project\hadoop-hdfs\src\main\java\org\apache\hadoop\hdfs\server\datanode\web\webhdfs\DataNodeUGIProvider.java,113,19,2,2,0,23
hadoop-trunk\hadoop-trunk\hadoop-mapreduce-project\hadoop-mapreduce-client\hadoop-mapreduce-client-app\src\test\java\org\apache\hadoop\mapreduce\v2\app\webapp\AppControllerForTest.java,78,42,1,3,0,46
hadoop-trunk\hadoop-trunk\hadoop-hdfs-project\hadoop-hdfs\src\main\java\org\apache\hadoop\hdfs\server\common\HttpPutFailedException.java,14,8,0,2,0,10
hadoop-trunk\hadoop-trunk\hadoop-yarn-project\hadoop-yarn\hadoop-yarn-csi\src\test\java\org\apache\hadoop\yarn\csi\adaptor\TestCsiAdaptorService.java,389,24,15,6,0,45
hadoop-trunk\hadoop-trunk\hadoop-common-project\hadoop-common\src\test\java\org\apache\hadoop\metrics2\impl\TestMetricsVisitor.java,49,19,5,1,0,25
hadoop-trunk\hadoop-trunk\hadoop-yarn-project\hadoop-yarn\hadoop-yarn-server\hadoop-yarn-server-nodemanager\src\main\java\org\apache\hadoop\yarn\server\nodemanager\containermanager\linux\runtime\docker\DockerInspectCommand.java,54,21,0,3,0,24
hadoop-trunk\hadoop-trunk\hadoop-yarn-project\hadoop-yarn\hadoop-yarn-server\hadoop-yarn-server-resourcemanager\src\main\java\org\apache\hadoop\yarn\server\resourcemanager\rmapp\attempt\RMAppAttempt.java,0,19,0,4,0,23
hadoop-trunk\hadoop-trunk\hadoop-mapreduce-project\hadoop-mapreduce-client\hadoop-mapreduce-client-nativetask\src\test\java\org\apache\hadoop\mapred\nativetask\testutil\TestInput.java,38,14,1,4,0,19
hadoop-trunk\hadoop-trunk\hadoop-yarn-project\hadoop-yarn\hadoop-yarn-server\hadoop-yarn-server-nodemanager\src\test\java\org\apache\hadoop\yarn\server\nodemanager\webapp\MockContainer.java,248,69,16,7,0,92
hadoop-trunk\hadoop-trunk\hadoop-tools\hadoop-azure-datalake\src\test\java\org\apache\hadoop\fs\adl\live\TestAdlSdkConfiguration.java,70,8,0,1,0,9
hadoop-trunk\hadoop-trunk\hadoop-common-project\hadoop-registry\src\main\java\org\apache\hadoop\registry\client\impl\RegistryOperationsClient.java,12,5,0,1,0,6
hadoop-trunk\hadoop-trunk\hadoop-tools\hadoop-aws\src\main\java\org\apache\hadoop\fs\s3a\CredentialInitializationException.java,19,5,0,1,0,6
hadoop-trunk\hadoop-trunk\hadoop-yarn-project\hadoop-yarn\hadoop-yarn-server\hadoop-yarn-server-sharedcachemanager\src\main\java\org\apache\hadoop\yarn\server\sharedcachemanager\CleanerTask.java,0,46,14,2,0,62
hadoop-trunk\hadoop-trunk\hadoop-yarn-project\hadoop-yarn\hadoop-yarn-server\hadoop-yarn-server-resourcemanager\src\test\java\org\apache\hadoop\yarn\server\resourcemanager\scheduler\fair\converter\TestConvertedConfigValidator.java,32,7,0,1,0,8
hadoop-trunk\hadoop-trunk\hadoop-hdfs-project\hadoop-hdfs-client\src\main\java\org\apache\hadoop\hdfs\client\HdfsClientConfigKeys.java,0,341,466,3,0,810
hadoop-trunk\hadoop-trunk\hadoop-common-project\hadoop-common\src\main\java\org\apache\hadoop\ipc\DefaultRpcScheduler.java,25,11,6,1,0,18
hadoop-trunk\hadoop-trunk\hadoop-common-project\hadoop-common\src\main\java\org\apache\hadoop\util\ClassUtil.java,32,5,1,1,0,7
hadoop-trunk\hadoop-trunk\hadoop-yarn-project\hadoop-yarn\hadoop-yarn-server\hadoop-yarn-server-resourcemanager\src\main\java\org\apache\hadoop\yarn\server\resourcemanager\federation\package-info.java,0,0,0,1,0,1
hadoop-trunk\hadoop-trunk\hadoop-common-project\hadoop-common\src\test\java\org\apache\hadoop\fs\contract\localfs\TestLocalFSContractSetTimes.java,9,2,0,1,0,3
hadoop-trunk\hadoop-trunk\hadoop-tools\hadoop-openstack\src\test\java\org\apache\hadoop\fs\swift\TestSwiftFileSystemRename.java,241,24,9,1,0,34
hadoop-trunk\hadoop-trunk\hadoop-yarn-project\hadoop-yarn\hadoop-yarn-server\hadoop-yarn-server-nodemanager\src\main\java\org\apache\hadoop\yarn\server\nodemanager\containermanager\linux\resources\ResourcesExceptionUtil.java,0,5,0,4,0,9
hadoop-trunk\hadoop-trunk\hadoop-tools\hadoop-openstack\src\main\java\org\apache\hadoop\fs\swift\auth\KeystoneApiKeyCredentials.java,41,23,0,2,0,25
hadoop-trunk\hadoop-trunk\hadoop-yarn-project\hadoop-yarn\hadoop-yarn-server\hadoop-yarn-server-timelineservice\src\main\java\org\apache\hadoop\yarn\server\timelineservice\collector\TimelineCollectorManager.java,231,31,9,1,0,41
hadoop-trunk\hadoop-trunk\hadoop-mapreduce-project\hadoop-mapreduce-client\hadoop-mapreduce-client-common\src\main\java\org\apache\hadoop\mapreduce\v2\jobhistory\JobIndexInfo.java,108,114,1,2,0,117
hadoop-trunk\hadoop-trunk\hadoop-hdfs-project\hadoop-hdfs\src\main\java\org\apache\hadoop\hdfs\tools\offlineImageViewer\OfflineImageReconstructor.java,0,147,119,22,0,288
hadoop-trunk\hadoop-trunk\hadoop-tools\hadoop-azure\src\test\java\org\apache\hadoop\fs\azurebfs\extensions\ITestAbfsDelegationTokens.java,311,17,1,4,0,22
hadoop-trunk\hadoop-trunk\hadoop-yarn-project\hadoop-yarn\hadoop-yarn-server\hadoop-yarn-server-router\src\main\java\org\apache\hadoop\yarn\server\router\webapp\package-info.java,0,0,0,1,0,1
hadoop-trunk\hadoop-trunk\hadoop-mapreduce-project\hadoop-mapreduce-client\hadoop-mapreduce-client-app\src\main\java\org\apache\hadoop\mapreduce\v2\app\ClusterInfo.java,20,11,0,1,0,12
hadoop-trunk\hadoop-trunk\hadoop-mapreduce-project\hadoop-mapreduce-client\hadoop-mapreduce-client-core\src\main\java\org\apache\hadoop\mapreduce\lib\db\BigDecimalSplitter.java,111,27,4,8,0,39
hadoop-trunk\hadoop-trunk\hadoop-yarn-project\hadoop-yarn\hadoop-yarn-api\src\main\java\org\apache\hadoop\yarn\api\protocolrecords\GetNodesToLabelsRequest.java,6,2,0,1,0,3
hadoop-trunk\hadoop-trunk\hadoop-common-project\hadoop-common\src\test\java\org\apache\hadoop\security\TestDoAsEffectiveUser.java,405,60,12,6,0,78
hadoop-trunk\hadoop-trunk\hadoop-tools\hadoop-aws\src\test\java\org\apache\hadoop\fs\s3a\TestS3AExceptionTranslation.java,177,46,9,1,0,56
hadoop-trunk\hadoop-trunk\hadoop-common-project\hadoop-registry\src\main\java\org\apache\hadoop\registry\client\binding\package-info.java,0,0,0,1,0,1
hadoop-trunk\hadoop-trunk\hadoop-hdfs-project\hadoop-hdfs\src\main\java\org\apache\hadoop\hdfs\server\namenode\SafeMode.java,0,4,2,1,0,7
hadoop-trunk\hadoop-trunk\hadoop-hdfs-project\hadoop-hdfs\src\main\java\org\apache\hadoop\hdfs\protocolPB\InterDatanodeProtocolServerSideTranslatorPB.java,48,12,15,7,0,34
hadoop-trunk\hadoop-trunk\hadoop-common-project\hadoop-common\src\test\java\org\apache\hadoop\fs\contract\rawlocal\TestRawLocalContractUnderlyingFileBehavior.java,22,4,2,1,0,7
hadoop-trunk\hadoop-trunk\hadoop-mapreduce-project\hadoop-mapreduce-client\hadoop-mapreduce-client-core\src\main\java\org\apache\hadoop\mapred\lib\db\DBOutputFormat.java,0,39,5,3,0,47
hadoop-trunk\hadoop-trunk\hadoop-mapreduce-project\hadoop-mapreduce-client\hadoop-mapreduce-client-core\src\test\java\org\apache\hadoop\mapred\TestJobEndNotifier.java,167,37,10,1,0,48
hadoop-trunk\hadoop-trunk\hadoop-yarn-project\hadoop-yarn\hadoop-yarn-api\src\main\java\org\apache\hadoop\yarn\exceptions\ApplicationAttemptNotFoundException.java,17,13,1,4,0,18
hadoop-trunk\hadoop-trunk\hadoop-mapreduce-project\hadoop-mapreduce-examples\src\main\java\org\apache\hadoop\examples\DBCountPageView.java,365,213,17,7,0,237
hadoop-trunk\hadoop-trunk\hadoop-common-project\hadoop-common\src\main\java\org\apache\hadoop\fs\PartHandle.java,0,1,0,1,0,2
hadoop-trunk\hadoop-trunk\hadoop-yarn-project\hadoop-yarn\hadoop-yarn-server\hadoop-yarn-server-router\src\test\java\org\apache\hadoop\yarn\server\router\webapp\MockDefaultRequestInterceptorREST.java,0,57,3,4,0,64
hadoop-trunk\hadoop-trunk\hadoop-yarn-project\hadoop-yarn\hadoop-yarn-api\src\main\java\org\apache\hadoop\yarn\api\records\ResourceAllocationRequest.java,78,3,0,1,0,4
hadoop-trunk\hadoop-trunk\hadoop-mapreduce-project\hadoop-mapreduce-client\hadoop-mapreduce-client-hs\src\main\java\org\apache\hadoop\mapreduce\v2\hs\package-info.java,0,1,0,1,0,2
hadoop-trunk\hadoop-trunk\hadoop-common-project\hadoop-nfs\src\main\java\org\apache\hadoop\nfs\nfs3\request\READDIR3Request.java,42,25,0,1,0,26
hadoop-trunk\hadoop-trunk\hadoop-tools\hadoop-dynamometer\hadoop-dynamometer-blockgen\src\main\java\org\apache\hadoop\tools\dynamometer\blockgenerator\XMLParser.java,0,17,3,1,0,21
hadoop-trunk\hadoop-trunk\hadoop-hdfs-project\hadoop-hdfs\src\test\java\org\apache\hadoop\hdfs\server\namenode\snapshot\TestSnapshotReplication.java,196,57,2,2,0,61
hadoop-trunk\hadoop-trunk\hadoop-common-project\hadoop-common\src\main\java\org\apache\hadoop\crypto\CryptoProtocolVersion.java,0,20,0,1,0,21
hadoop-trunk\hadoop-trunk\hadoop-hdfs-project\hadoop-hdfs-client\src\main\java\org\apache\hadoop\hdfs\web\resources\BlockSizeParam.java,36,4,0,3,0,7
hadoop-trunk\hadoop-trunk\hadoop-mapreduce-project\hadoop-mapreduce-client\hadoop-mapreduce-client-core\src\main\java\org\apache\hadoop\mapred\MultiFileInputFormat.java,0,41,2,2,0,45
hadoop-trunk\hadoop-trunk\hadoop-hdfs-project\hadoop-hdfs\src\main\java\org\apache\hadoop\hdfs\server\diskbalancer\planner\NodePlan.java,160,25,0,1,0,26
hadoop-trunk\hadoop-trunk\hadoop-yarn-project\hadoop-yarn\hadoop-yarn-applications\hadoop-yarn-applications-catalog\hadoop-yarn-applications-catalog-webapp\src\main\java\org\apache\hadoop\yarn\appcatalog\controller\AppDetailsController.java,254,10,2,1,0,13
hadoop-trunk\hadoop-trunk\hadoop-hdfs-project\hadoop-hdfs\src\main\java\org\apache\hadoop\hdfs\server\datanode\erasurecode\StripedBlockReconstructor.java,0,7,2,1,0,10
hadoop-trunk\hadoop-trunk\hadoop-common-project\hadoop-common\src\main\java\org\apache\hadoop\util\GenericsUtil.java,62,26,3,5,0,34
hadoop-trunk\hadoop-trunk\hadoop-yarn-project\hadoop-yarn\hadoop-yarn-server\hadoop-yarn-server-nodemanager\src\main\java\org\apache\hadoop\yarn\server\nodemanager\containermanager\linux\resources\CpuResourceHandler.java,0,0,0,2,0,2
hadoop-trunk\hadoop-trunk\hadoop-mapreduce-project\hadoop-mapreduce-client\hadoop-mapreduce-client-core\src\main\java\org\apache\hadoop\filecache\DistributedCache.java,0,22,1,4,0,27
hadoop-trunk\hadoop-trunk\hadoop-yarn-project\hadoop-yarn\hadoop-yarn-common\src\main\java\org\apache\hadoop\yarn\api\records\impl\pb\ExecutionTypeRequestPBImpl.java,71,18,28,2,0,48
hadoop-trunk\hadoop-trunk\hadoop-tools\hadoop-resourceestimator\src\main\java\org\apache\hadoop\resourceestimator\translator\exceptions\DataFieldNotFoundException.java,8,1,0,1,0,2
hadoop-trunk\hadoop-trunk\hadoop-mapreduce-project\hadoop-mapreduce-client\hadoop-mapreduce-client-common\src\main\java\org\apache\hadoop\mapreduce\v2\api\records\impl\pb\TaskReportPBImpl.java,391,108,104,3,0,215
hadoop-trunk\hadoop-trunk\hadoop-tools\hadoop-dynamometer\hadoop-dynamometer-infra\src\main\java\org\apache\hadoop\tools\dynamometer\BlockPlacementPolicyAlwaysSatisfied.java,0,4,0,2,0,6
hadoop-trunk\hadoop-trunk\hadoop-yarn-project\hadoop-yarn\hadoop-yarn-common\src\main\java\org\apache\hadoop\yarn\api\records\impl\pb\ApplicationAttemptReportPBImpl.java,282,64,94,4,0,162
hadoop-trunk\hadoop-trunk\hadoop-yarn-project\hadoop-yarn\hadoop-yarn-server\hadoop-yarn-server-common\src\main\java\org\apache\hadoop\yarn\server\api\impl\pb\client\DistributedSchedulingAMProtocolPBClientImpl.java,0,16,12,16,0,44
hadoop-trunk\hadoop-trunk\hadoop-yarn-project\hadoop-yarn\hadoop-yarn-common\src\main\java\org\apache\hadoop\yarn\api\records\impl\pb\StrictPreemptionContractPBImpl.java,139,28,44,4,0,76
hadoop-trunk\hadoop-trunk\hadoop-mapreduce-project\hadoop-mapreduce-client\hadoop-mapreduce-client-jobclient\src\test\java\org\apache\hadoop\mapred\TestSequenceFileAsBinaryOutputFormat.java,185,51,7,1,0,59
hadoop-trunk\hadoop-trunk\hadoop-common-project\hadoop-common\src\main\java\org\apache\hadoop\io\erasurecode\rawcoder\DummyRawErasureCoderFactory.java,24,7,0,1,0,8
hadoop-trunk\hadoop-trunk\hadoop-hdfs-project\hadoop-hdfs\src\test\java\org\apache\hadoop\hdfs\server\namenode\ha\TestDNFencing.java,583,116,12,7,0,135
hadoop-trunk\hadoop-trunk\hadoop-hdfs-project\hadoop-hdfs\src\test\java\org\apache\hadoop\hdfs\TestHttpPolicy.java,0,1,0,1,0,2
hadoop-trunk\hadoop-trunk\hadoop-yarn-project\hadoop-yarn\hadoop-yarn-server\hadoop-yarn-server-nodemanager\src\test\java\org\apache\hadoop\yarn\server\nodemanager\containermanager\linux\runtime\docker\TestDockerClient.java,84,6,0,3,0,9
hadoop-trunk\hadoop-trunk\hadoop-common-project\hadoop-common\src\main\java\org\apache\hadoop\ipc\CallQueueManager.java,0,134,22,2,0,158
hadoop-trunk\hadoop-trunk\hadoop-yarn-project\hadoop-yarn\hadoop-yarn-applications\hadoop-yarn-services\hadoop-yarn-services-core\src\main\java\org\apache\hadoop\yarn\service\containerlaunch\ContainerLaunchService.java,168,80,3,2,0,85
hadoop-trunk\hadoop-trunk\hadoop-hdfs-project\hadoop-hdfs\src\main\java\org\apache\hadoop\hdfs\server\protocol\BalancerBandwidthCommand.java,32,7,0,1,0,8
hadoop-trunk\hadoop-trunk\hadoop-common-project\hadoop-common\src\main\java\org\apache\hadoop\metrics2\MetricsSystemMXBean.java,0,9,5,1,0,15
hadoop-trunk\hadoop-trunk\hadoop-hdfs-project\hadoop-hdfs\src\test\java\org\apache\hadoop\fs\TestSymlinkHdfsDisable.java,37,7,0,1,0,8
hadoop-trunk\hadoop-trunk\hadoop-mapreduce-project\hadoop-mapreduce-client\hadoop-mapreduce-client-app\src\main\java\org\apache\hadoop\mapreduce\v2\app\webapp\dao\TasksInfo.java,17,8,4,1,0,13
hadoop-trunk\hadoop-trunk\hadoop-common-project\hadoop-common\src\test\java\org\apache\hadoop\test\AssertExtensions.java,0,4,1,1,0,6
hadoop-trunk\hadoop-trunk\hadoop-yarn-project\hadoop-yarn\hadoop-yarn-server\hadoop-yarn-server-common\src\main\java\org\apache\hadoop\yarn\server\federation\store\exception\FederationStateStoreInvalidInputException.java,21,7,0,1,0,8
hadoop-trunk\hadoop-trunk\hadoop-mapreduce-project\hadoop-mapreduce-examples\src\test\java\org\apache\hadoop\examples\pi\math\TestLongLong.java,57,13,0,1,0,14
hadoop-trunk\hadoop-trunk\hadoop-mapreduce-project\hadoop-mapreduce-client\hadoop-mapreduce-client-common\src\main\java\org\apache\hadoop\mapreduce\v2\api\records\TaskAttemptReport.java,0,95,32,1,0,128
hadoop-trunk\hadoop-trunk\hadoop-mapreduce-project\hadoop-mapreduce-client\hadoop-mapreduce-client-jobclient\src\test\java\org\apache\hadoop\mapreduce\lib\input\TestCombineFileInputFormat.java,1772,327,23,15,0,365
hadoop-trunk\hadoop-trunk\hadoop-yarn-project\hadoop-yarn\hadoop-yarn-server\hadoop-yarn-server-resourcemanager\src\main\java\org\apache\hadoop\yarn\server\resourcemanager\scheduler\capacity\queuemanagement\LeafQueueEntitlements.java,25,13,0,6,0,19
hadoop-trunk\hadoop-trunk\hadoop-hdfs-project\hadoop-hdfs\src\main\java\org\apache\hadoop\hdfs\server\datanode\FinalizedReplica.java,141,51,3,1,0,55
hadoop-trunk\hadoop-trunk\hadoop-yarn-project\hadoop-yarn\hadoop-yarn-server\hadoop-yarn-server-nodemanager\src\main\java\org\apache\hadoop\yarn\server\nodemanager\containermanager\localizer\event\LocalizerResourceRequestEvent.java,35,23,2,5,0,30
hadoop-trunk\hadoop-trunk\hadoop-yarn-project\hadoop-yarn\hadoop-yarn-server\hadoop-yarn-server-resourcemanager\src\test\java\org\apache\hadoop\yarn\server\resourcemanager\resourcetracker\TestNMReconnect.java,198,33,4,11,0,48
hadoop-trunk\hadoop-trunk\hadoop-hdfs-project\hadoop-hdfs-rbf\src\main\java\org\apache\hadoop\hdfs\server\federation\store\impl\MountTableStoreImpl.java,194,16,0,14,0,30
hadoop-trunk\hadoop-trunk\hadoop-yarn-project\hadoop-yarn\hadoop-yarn-server\hadoop-yarn-server-resourcemanager\src\test\java\org\apache\hadoop\yarn\server\resourcemanager\security\TestDelegationTokenRenewerLifecycle.java,16,2,1,1,0,4
hadoop-trunk\hadoop-trunk\hadoop-common-project\hadoop-nfs\src\main\java\org\apache\hadoop\nfs\nfs3\Nfs3FileAttributes.java,205,121,0,2,0,123
hadoop-trunk\hadoop-trunk\hadoop-common-project\hadoop-common\src\main\java\org\apache\hadoop\io\erasurecode\rawcoder\DummyRawEncoder.java,17,4,0,1,0,5
hadoop-trunk\hadoop-trunk\hadoop-common-project\hadoop-auth\src\test\java\org\apache\hadoop\security\authentication\util\StringSignerSecretProviderCreator.java,11,2,1,1,0,4
hadoop-trunk\hadoop-trunk\hadoop-yarn-project\hadoop-yarn\hadoop-yarn-server\hadoop-yarn-server-resourcemanager\src\test\java\org\apache\hadoop\yarn\server\resourcemanager\TestRMAdminService.java,1659,138,79,41,0,258
hadoop-trunk\hadoop-trunk\hadoop-hdfs-project\hadoop-hdfs\src\main\java\org\apache\hadoop\hdfs\server\namenode\HdfsAuditLogger.java,0,20,0,2,0,22
hadoop-trunk\hadoop-trunk\hadoop-yarn-project\hadoop-yarn\hadoop-yarn-common\src\main\java\org\apache\hadoop\yarn\webapp\dao\SchedConfUpdateInfo.java,51,28,13,1,0,42
hadoop-trunk\hadoop-trunk\hadoop-tools\hadoop-aws\src\main\java\org\apache\hadoop\fs\s3a\TemporaryAWSCredentialsProvider.java,58,4,0,1,0,5
hadoop-trunk\hadoop-trunk\hadoop-yarn-project\hadoop-yarn\hadoop-yarn-server\hadoop-yarn-server-common\src\main\java\org\apache\hadoop\yarn\server\api\protocolrecords\DistributedSchedulingAllocateRequest.java,37,1,0,1,0,2
hadoop-trunk\hadoop-trunk\hadoop-common-project\hadoop-nfs\src\main\java\org\apache\hadoop\nfs\nfs3\response\PATHCONF3Response.java,93,33,0,1,0,34
hadoop-trunk\hadoop-trunk\hadoop-mapreduce-project\hadoop-mapreduce-client\hadoop-mapreduce-client-core\src\main\java\org\apache\hadoop\mapreduce\util\MRJobConfUtil.java,0,12,7,1,0,20
hadoop-trunk\hadoop-trunk\hadoop-tools\hadoop-sls\src\main\java\org\apache\hadoop\yarn\sls\utils\SLSUtils.java,196,30,15,3,0,48
hadoop-trunk\hadoop-trunk\hadoop-hdfs-project\hadoop-hdfs-httpfs\src\test\java\org\apache\hadoop\fs\http\client\TestHttpFSWithHttpFSFileSystem.java,29,6,2,1,0,9
hadoop-trunk\hadoop-trunk\hadoop-hdfs-project\hadoop-hdfs\src\main\java\org\apache\hadoop\hdfs\server\namenode\SecondaryNameNode.java,1016,218,32,15,0,265
hadoop-trunk\hadoop-trunk\hadoop-yarn-project\hadoop-yarn\hadoop-yarn-server\hadoop-yarn-server-resourcemanager\src\main\java\org\apache\hadoop\yarn\server\resourcemanager\ResourceManager.java,0,230,43,45,0,318
hadoop-trunk\hadoop-trunk\hadoop-tools\hadoop-aws\src\test\java\org\apache\hadoop\fs\s3a\audit\AuditTestSupport.java,0,2,0,8,0,10
hadoop-trunk\hadoop-trunk\hadoop-common-project\hadoop-common\src\main\java\org\apache\hadoop\io\erasurecode\rawcoder\util\GaloisField.java,535,147,19,1,0,167
hadoop-trunk\hadoop-trunk\hadoop-tools\hadoop-openstack\src\test\java\org\apache\hadoop\fs\swift\contract\TestSwiftContractOpen.java,18,4,0,1,0,5
hadoop-trunk\hadoop-trunk\hadoop-tools\hadoop-rumen\src\main\java\org\apache\hadoop\tools\rumen\Folder.java,505,69,36,3,0,108
hadoop-trunk\hadoop-trunk\hadoop-hdfs-project\hadoop-hdfs\src\test\java\org\apache\hadoop\hdfs\server\common\StorageAdapter.java,14,8,0,1,0,9
hadoop-trunk\hadoop-trunk\hadoop-common-project\hadoop-common\src\main\java\org\apache\hadoop\util\DataChecksum.java,585,368,16,3,0,387
hadoop-trunk\hadoop-trunk\hadoop-mapreduce-project\hadoop-mapreduce-client\hadoop-mapreduce-client-core\src\main\java\org\apache\hadoop\mapred\lib\CombineFileInputFormat.java,0,49,3,5,0,57
hadoop-trunk\hadoop-trunk\hadoop-tools\hadoop-rumen\src\main\java\org\apache\hadoop\tools\rumen\anonymization\WordListAnonymizerUtility.java,83,40,4,1,0,45
hadoop-trunk\hadoop-trunk\hadoop-common-project\hadoop-common\src\test\java\org\apache\hadoop\service\launcher\TestServiceConf.java,0,9,1,1,0,11
hadoop-trunk\hadoop-trunk\hadoop-yarn-project\hadoop-yarn\hadoop-yarn-api\src\main\java\org\apache\hadoop\yarn\server\api\protocolrecords\RefreshUserToGroupsMappingsResponse.java,10,1,1,1,0,3
hadoop-trunk\hadoop-trunk\hadoop-yarn-project\hadoop-yarn\hadoop-yarn-server\hadoop-yarn-server-nodemanager\src\main\java\org\apache\hadoop\yarn\server\nodemanager\containermanager\resourceplugin\gpu\NvidiaDockerV1CommandPlugin.java,264,39,5,10,0,54
hadoop-trunk\hadoop-trunk\hadoop-tools\hadoop-openstack\src\main\java\org\apache\hadoop\fs\swift\snative\SwiftNativeFileSystem.java,707,98,8,8,0,114
hadoop-trunk\hadoop-trunk\hadoop-common-project\hadoop-common\src\test\java\org\apache\hadoop\test\TestLambdaTestUtils.java,584,61,2,1,0,64
hadoop-trunk\hadoop-trunk\hadoop-hdfs-project\hadoop-hdfs-rbf\src\main\java\org\apache\hadoop\hdfs\server\federation\store\protocol\impl\pb\GetNamenodeRegistrationsResponsePBImpl.java,0,14,35,6,0,55
hadoop-trunk\hadoop-trunk\hadoop-yarn-project\hadoop-yarn\hadoop-yarn-server\hadoop-yarn-server-resourcemanager\src\main\java\org\apache\hadoop\yarn\server\resourcemanager\scheduler\capacity\QueueConfigurationAutoRefreshPolicy.java,0,25,12,4,0,41
hadoop-trunk\hadoop-trunk\hadoop-yarn-project\hadoop-yarn\hadoop-yarn-server\hadoop-yarn-server-resourcemanager\src\main\java\org\apache\hadoop\yarn\server\resourcemanager\webapp\AboutBlock.java,31,11,0,1,0,12
hadoop-trunk\hadoop-trunk\hadoop-hdfs-project\hadoop-hdfs\src\test\java\org\apache\hadoop\fs\viewfs\TestViewFileSystemOverloadSchemeHdfsFileSystemContract.java,0,8,2,3,0,13
hadoop-trunk\hadoop-trunk\hadoop-mapreduce-project\hadoop-mapreduce-client\hadoop-mapreduce-client-app\src\main\java\org\apache\hadoop\mapreduce\v2\app\rm\RMContainerAllocator.java,0,371,92,20,0,483
hadoop-trunk\hadoop-trunk\hadoop-hdfs-project\hadoop-hdfs-client\src\main\java\org\apache\hadoop\hdfs\web\resources\TokenArgumentParam.java,22,2,1,1,0,4
hadoop-trunk\hadoop-trunk\hadoop-yarn-project\hadoop-yarn\hadoop-yarn-api\src\main\java\org\apache\hadoop\yarn\api\protocolrecords\AllocateResponse.java,637,111,3,3,0,117
hadoop-trunk\hadoop-trunk\hadoop-yarn-project\hadoop-yarn\hadoop-yarn-server\hadoop-yarn-server-resourcemanager\src\main\java\org\apache\hadoop\yarn\server\resourcemanager\security\ClientToAMTokenSecretManagerInRM.java,42,20,0,1,0,21
hadoop-trunk\hadoop-trunk\hadoop-yarn-project\hadoop-yarn\hadoop-yarn-server\hadoop-yarn-server-resourcemanager\src\test\java\org\apache\hadoop\yarn\server\resourcemanager\resource\TestResourceProfiles.java,153,36,3,2,0,41
hadoop-trunk\hadoop-trunk\hadoop-common-project\hadoop-common\src\main\java\org\apache\hadoop\security\token\TokenSelector.java,0,3,0,1,0,4
hadoop-trunk\hadoop-trunk\hadoop-yarn-project\hadoop-yarn\hadoop-yarn-server\hadoop-yarn-server-resourcemanager\src\test\java\org\apache\hadoop\yarn\server\resourcemanager\federation\TestFederationRMStateStoreService.java,127,20,4,5,0,29
hadoop-trunk\hadoop-trunk\hadoop-yarn-project\hadoop-yarn\hadoop-yarn-common\src\main\java\org\apache\hadoop\yarn\client\RMFailoverProxyProvider.java,0,2,1,1,0,4
hadoop-trunk\hadoop-trunk\hadoop-tools\hadoop-aws\src\test\java\org\apache\hadoop\fs\s3a\auth\delegation\CountInvocationsProvider.java,0,4,1,1,0,6
hadoop-trunk\hadoop-trunk\hadoop-mapreduce-project\hadoop-mapreduce-client\hadoop-mapreduce-client-core\src\main\java\org\apache\hadoop\mapred\BufferSorter.java,0,26,6,2,0,34
hadoop-trunk\hadoop-trunk\hadoop-common-project\hadoop-common\src\test\java\org\apache\hadoop\fs\TestGlobPattern.java,0,21,1,2,0,24
hadoop-trunk\hadoop-trunk\hadoop-yarn-project\hadoop-yarn\hadoop-yarn-server\hadoop-yarn-server-nodemanager\src\main\java\org\apache\hadoop\yarn\server\nodemanager\containermanager\application\ApplicationFinishEvent.java,22,7,0,1,0,8
hadoop-trunk\hadoop-trunk\hadoop-common-project\hadoop-common\src\main\java\org\apache\hadoop\fs\ftp\FTPInputStream.java,110,33,0,2,0,35
hadoop-trunk\hadoop-trunk\hadoop-hdfs-project\hadoop-hdfs\src\test\java\org\apache\hadoop\hdfs\server\namenode\TestAclTransformation.java,1217,106,7,1,0,114
hadoop-trunk\hadoop-trunk\hadoop-yarn-project\hadoop-yarn\hadoop-yarn-common\src\main\java\org\apache\hadoop\yarn\api\protocolrecords\impl\pb\GetQueueUserAclsInfoResponsePBImpl.java,140,34,45,6,0,85
hadoop-trunk\hadoop-trunk\hadoop-yarn-project\hadoop-yarn\hadoop-yarn-common\src\main\java\org\apache\hadoop\yarn\api\protocolrecords\impl\pb\MoveApplicationAcrossQueuesResponsePBImpl.java,41,22,18,6,0,46
hadoop-trunk\hadoop-trunk\hadoop-yarn-project\hadoop-yarn\hadoop-yarn-server\hadoop-yarn-server-resourcemanager\src\main\java\org\apache\hadoop\yarn\server\resourcemanager\volume\csi\VolumeStates.java,32,6,0,2,0,8
hadoop-trunk\hadoop-trunk\hadoop-common-project\hadoop-common\src\main\java\org\apache\hadoop\io\erasurecode\coder\DummyErasureDecoder.java,17,4,0,1,0,5
hadoop-trunk\hadoop-trunk\hadoop-hdfs-project\hadoop-hdfs\src\main\java\org\apache\hadoop\hdfs\web\resources\ExceptionHandler.java,83,19,3,2,0,24
hadoop-trunk\hadoop-trunk\hadoop-tools\hadoop-sls\src\main\java\org\apache\hadoop\yarn\sls\appmaster\DAGAMSimulator.java,218,35,5,1,0,41
hadoop-trunk\hadoop-trunk\hadoop-common-project\hadoop-common\src\main\java\org\apache\hadoop\util\GenericOptionsParser.java,502,103,10,8,0,121
hadoop-trunk\hadoop-trunk\hadoop-yarn-project\hadoop-yarn\hadoop-yarn-server\hadoop-yarn-server-resourcemanager\src\test\java\org\apache\hadoop\yarn\server\resourcemanager\scheduler\distributed\TestCentralizedOpportunisticContainerAllocator.java,603,114,12,1,0,127
hadoop-trunk\hadoop-trunk\hadoop-common-project\hadoop-common\src\test\java\org\apache\hadoop\io\retry\UnreliableInterface.java,0,38,8,1,0,47
hadoop-trunk\hadoop-trunk\hadoop-mapreduce-project\hadoop-mapreduce-client\hadoop-mapreduce-client-nativetask\src\main\java\org\apache\hadoop\mapred\nativetask\serde\IntWritableSerializer.java,8,4,0,1,0,5
hadoop-trunk\hadoop-trunk\hadoop-yarn-project\hadoop-yarn\hadoop-yarn-server\hadoop-yarn-server-nodemanager\src\main\java\org\apache\hadoop\yarn\server\nodemanager\containermanager\AuxServices.java,0,120,40,8,0,168
hadoop-trunk\hadoop-trunk\hadoop-mapreduce-project\hadoop-mapreduce-client\hadoop-mapreduce-client-app\src\main\java\org\apache\hadoop\mapreduce\v2\app\security\authorize\MRAMPolicyProvider.java,19,5,0,1,0,6
hadoop-trunk\hadoop-trunk\hadoop-hdfs-project\hadoop-hdfs\src\test\java\org\apache\hadoop\hdfs\TestTrashWithEncryptionZones.java,139,29,6,1,0,36
hadoop-trunk\hadoop-trunk\hadoop-tools\hadoop-azure\src\main\java\org\apache\hadoop\fs\azure\SimpleKeyProvider.java,28,8,0,1,0,9
hadoop-trunk\hadoop-trunk\hadoop-yarn-project\hadoop-yarn\hadoop-yarn-server\hadoop-yarn-server-nodemanager\src\main\java\org\apache\hadoop\yarn\server\nodemanager\containermanager\linux\runtime\docker\DockerVolumeCommand.java,50,27,0,2,0,29
hadoop-trunk\hadoop-trunk\hadoop-yarn-project\hadoop-yarn\hadoop-yarn-applications\hadoop-yarn-applications-mawo\hadoop-yarn-applications-mawo-core\src\main\java\org\apache\hadoop\applications\mawo\server\common\TaskId.java,119,2,2,1,0,5
hadoop-trunk\hadoop-trunk\hadoop-yarn-project\hadoop-yarn\hadoop-yarn-server\hadoop-yarn-server-sharedcachemanager\src\main\java\org\apache\hadoop\yarn\server\sharedcachemanager\webapp\SCMWebServer.java,55,20,2,2,0,24
hadoop-trunk\hadoop-trunk\hadoop-yarn-project\hadoop-yarn\hadoop-yarn-server\hadoop-yarn-server-timelineservice-hbase\hadoop-yarn-server-timelineservice-hbase-client\src\main\java\org\apache\hadoop\yarn\server\timelineservice\storage\reader\AbstractTimelineStorageReader.java,124,27,0,6,0,33
hadoop-trunk\hadoop-trunk\hadoop-hdfs-project\hadoop-hdfs-rbf\src\main\java\org\apache\hadoop\hdfs\server\federation\store\protocol\UpdateNamenodeRegistrationResponse.java,23,6,0,2,0,8
hadoop-trunk\hadoop-trunk\hadoop-tools\hadoop-distcp\src\main\java\org\apache\hadoop\tools\mapred\CopyOutputFormat.java,0,17,0,6,0,23
hadoop-trunk\hadoop-trunk\hadoop-yarn-project\hadoop-yarn\hadoop-yarn-common\src\main\java\org\apache\hadoop\yarn\server\api\protocolrecords\impl\pb\RemoveFromClusterNodeLabelsResponsePBImpl.java,44,17,18,3,0,38
hadoop-trunk\hadoop-trunk\hadoop-tools\hadoop-openstack\src\main\java\org\apache\hadoop\fs\swift\snative\SwiftNativeOutputStream.java,0,63,4,5,0,72
hadoop-trunk\hadoop-trunk\hadoop-yarn-project\hadoop-yarn\hadoop-yarn-server\hadoop-yarn-server-nodemanager\src\test\java\org\apache\hadoop\yarn\server\nodemanager\TestNodeResourceMonitor.java,29,4,1,1,0,6
hadoop-trunk\hadoop-trunk\hadoop-yarn-project\hadoop-yarn\hadoop-yarn-server\hadoop-yarn-server-timeline-pluginstorage\src\main\java\org\apache\hadoop\yarn\server\timeline\EntityGroupFSTimelineStore.java,0,172,30,11,0,213
hadoop-trunk\hadoop-trunk\hadoop-yarn-project\hadoop-yarn\hadoop-yarn-applications\hadoop-yarn-services\hadoop-yarn-services-core\src\main\java\org\apache\hadoop\yarn\service\exceptions\ErrorStrings.java,0,12,9,3,0,24
hadoop-trunk\hadoop-trunk\hadoop-yarn-project\hadoop-yarn\hadoop-yarn-server\hadoop-yarn-server-common\src\test\java\org\apache\hadoop\yarn\server\federation\policies\router\TestUniformRandomRouterPolicy.java,28,2,0,2,0,4
hadoop-trunk\hadoop-trunk\hadoop-yarn-project\hadoop-yarn\hadoop-yarn-server\hadoop-yarn-server-nodemanager\src\main\java\org\apache\hadoop\yarn\server\nodemanager\containermanager\container\ContainerDiagnosticsUpdateEvent.java,14,6,0,1,0,7
hadoop-trunk\hadoop-trunk\hadoop-yarn-project\hadoop-yarn\hadoop-yarn-common\src\main\java\org\apache\hadoop\yarn\api\protocolrecords\impl\pb\RegisterApplicationMasterResponsePBImpl.java,540,79,104,11,0,194
hadoop-trunk\hadoop-trunk\hadoop-hdfs-project\hadoop-hdfs\src\main\java\org\apache\hadoop\hdfs\protocolPB\DatanodeProtocolServerSideTranslatorPB.java,244,60,80,26,0,166
hadoop-trunk\hadoop-trunk\hadoop-mapreduce-project\hadoop-mapreduce-client\hadoop-mapreduce-client-hs\src\main\java\org\apache\hadoop\mapreduce\v2\hs\webapp\dao\AMAttemptInfo.java,73,38,1,1,0,40
hadoop-trunk\hadoop-trunk\hadoop-hdfs-project\hadoop-hdfs\src\test\java\org\apache\hadoop\hdfs\server\datanode\fsdataset\impl\TestCacheByPmemMappableBlockLoader.java,256,40,10,3,0,53
hadoop-trunk\hadoop-trunk\hadoop-yarn-project\hadoop-yarn\hadoop-yarn-common\src\main\java\org\apache\hadoop\yarn\factories\impl\pb\RpcServerFactoryPBImpl.java,136,65,9,10,0,84
hadoop-trunk\hadoop-trunk\hadoop-mapreduce-project\hadoop-mapreduce-client\hadoop-mapreduce-client-uploader\src\main\java\org\apache\hadoop\mapred\uploader\DefaultJars.java,0,18,0,1,0,19
hadoop-trunk\hadoop-trunk\hadoop-yarn-project\hadoop-yarn\hadoop-yarn-server\hadoop-yarn-server-applicationhistoryservice\src\test\java\org\apache\hadoop\yarn\server\applicationhistoryservice\TestApplicationHistoryClientService.java,214,20,0,6,0,26
hadoop-trunk\hadoop-trunk\hadoop-yarn-project\hadoop-yarn\hadoop-yarn-server\hadoop-yarn-server-resourcemanager\src\test\java\org\apache\hadoop\yarn\server\resourcemanager\resourcetracker\TestRMNMRPCResponseId.java,87,21,2,10,0,33
hadoop-trunk\hadoop-trunk\hadoop-yarn-project\hadoop-yarn\hadoop-yarn-api\src\main\java\org\apache\hadoop\yarn\api\records\Priority.java,61,21,5,1,0,27
hadoop-trunk\hadoop-trunk\hadoop-hdfs-project\hadoop-hdfs\src\test\java\org\apache\hadoop\hdfs\server\blockmanagement\TestReplicationPolicyWithUpgradeDomain.java,0,130,14,1,0,145
hadoop-trunk\hadoop-trunk\hadoop-yarn-project\hadoop-yarn\hadoop-yarn-server\hadoop-yarn-server-resourcemanager\src\main\java\org\apache\hadoop\yarn\server\resourcemanager\scheduler\SchedulerApplicationAttempt.java,1410,413,20,30,0,463
hadoop-trunk\hadoop-trunk\hadoop-hdfs-project\hadoop-hdfs\src\main\java\org\apache\hadoop\hdfs\server\common\NoLockManager.java,44,14,7,2,0,23
hadoop-trunk\hadoop-trunk\hadoop-yarn-project\hadoop-yarn\hadoop-yarn-applications\hadoop-yarn-services\hadoop-yarn-services-core\src\test\java\org\apache\hadoop\yarn\service\client\TestBuildExternalComponents.java,77,13,0,2,0,15
hadoop-trunk\hadoop-trunk\hadoop-common-project\hadoop-common\src\test\java\org\apache\hadoop\metrics2\impl\TestMetricsSourceAdapter.java,280,52,8,2,0,62
hadoop-trunk\hadoop-trunk\hadoop-yarn-project\hadoop-yarn\hadoop-yarn-common\src\test\java\org\apache\hadoop\yarn\util\resource\TestResources.java,278,149,6,4,0,159
hadoop-trunk\hadoop-trunk\hadoop-yarn-project\hadoop-yarn\hadoop-yarn-server\hadoop-yarn-server-resourcemanager\src\test\java\org\apache\hadoop\yarn\server\resourcemanager\scheduler\capacity\TestCapacitySchedulerDynamicBehavior.java,256,40,7,27,0,74
hadoop-trunk\hadoop-trunk\hadoop-mapreduce-project\hadoop-mapreduce-client\hadoop-mapreduce-client-jobclient\src\test\java\org\apache\hadoop\mapreduce\TestNewCombinerGrouping.java,140,25,2,1,0,28
hadoop-trunk\hadoop-trunk\hadoop-yarn-project\hadoop-yarn\hadoop-yarn-server\hadoop-yarn-server-common\src\test\java\org\apache\hadoop\yarn\server\federation\store\impl\TestZookeeperFederationStateStore.java,0,8,1,1,0,10
hadoop-trunk\hadoop-trunk\hadoop-yarn-project\hadoop-yarn\hadoop-yarn-server\hadoop-yarn-server-nodemanager\src\test\java\org\apache\hadoop\yarn\server\nodemanager\containermanager\linux\resources\TestNetworkPacketTaggingHandlerImpl.java,131,20,2,5,0,27
hadoop-trunk\hadoop-trunk\hadoop-hdfs-project\hadoop-hdfs\src\test\java\org\apache\hadoop\hdfs\TestByteBufferPread.java,246,24,0,1,0,25
hadoop-trunk\hadoop-trunk\hadoop-mapreduce-project\hadoop-mapreduce-client\hadoop-mapreduce-client-jobclient\src\test\java\org\apache\hadoop\mapreduce\MiniHadoopClusterManager.java,262,38,9,3,0,50
hadoop-trunk\hadoop-trunk\hadoop-mapreduce-project\hadoop-mapreduce-client\hadoop-mapreduce-client-common\src\main\java\org\apache\hadoop\mapreduce\v2\jobhistory\JHAdminConfig.java,249,83,3,3,0,89
hadoop-trunk\hadoop-trunk\hadoop-yarn-project\hadoop-yarn\hadoop-yarn-server\hadoop-yarn-server-nodemanager\src\test\java\org\apache\hadoop\yarn\server\nodemanager\containermanager\linux\runtime\docker\TestDockerCommandExecutor.java,358,42,11,13,0,66
hadoop-trunk\hadoop-trunk\hadoop-yarn-project\hadoop-yarn\hadoop-yarn-server\hadoop-yarn-server-timelineservice-hbase\hadoop-yarn-server-timelineservice-hbase-client\src\main\java\org\apache\hadoop\yarn\server\timelineservice\storage\entity\package-info.java,0,0,0,1,0,1
hadoop-trunk\hadoop-trunk\hadoop-hdfs-project\hadoop-hdfs\src\test\java\org\apache\hadoop\hdfs\server\namenode\ha\TestRemoteNameNodeInfo.java,30,7,0,2,0,9
hadoop-trunk\hadoop-trunk\hadoop-yarn-project\hadoop-yarn\hadoop-yarn-common\src\main\java\org\apache\hadoop\yarn\client\api\impl\TimelineV2ClientImpl.java,537,71,17,3,0,91
hadoop-trunk\hadoop-trunk\hadoop-yarn-project\hadoop-yarn\hadoop-yarn-server\hadoop-yarn-server-applicationhistoryservice\src\main\java\org\apache\hadoop\yarn\server\applicationhistoryservice\webapp\NavBlock.java,56,8,2,2,0,12
hadoop-trunk\hadoop-trunk\hadoop-mapreduce-project\hadoop-mapreduce-client\hadoop-mapreduce-client-core\src\test\java\org\apache\hadoop\mapred\TestMapTask.java,46,8,2,1,0,11
hadoop-trunk\hadoop-trunk\hadoop-yarn-project\hadoop-yarn\hadoop-yarn-server\hadoop-yarn-server-resourcemanager\src\main\java\org\apache\hadoop\yarn\server\resourcemanager\reservation\planning\StageAllocatorGreedyRLE.java,210,36,3,5,0,44
hadoop-trunk\hadoop-trunk\hadoop-yarn-project\hadoop-yarn\hadoop-yarn-server\hadoop-yarn-server-nodemanager\src\main\java\org\apache\hadoop\yarn\server\nodemanager\util\DefaultLCEResourcesHandler.java,39,26,5,1,0,32
hadoop-trunk\hadoop-trunk\hadoop-tools\hadoop-aws\src\test\java\org\apache\hadoop\fs\s3a\scale\AbstractSTestS3AHugeFiles.java,514,64,52,6,0,122
hadoop-trunk\hadoop-trunk\hadoop-mapreduce-project\hadoop-mapreduce-client\hadoop-mapreduce-client-app\src\main\java\org\apache\hadoop\mapreduce\v2\app\webapp\SingleCounterBlock.java,121,29,1,2,0,32
hadoop-trunk\hadoop-trunk\hadoop-hdfs-project\hadoop-hdfs\src\main\java\org\apache\hadoop\hdfs\server\datanode\checker\Checkable.java,0,2,0,1,0,3
hadoop-trunk\hadoop-trunk\hadoop-hdfs-project\hadoop-hdfs\src\test\java\org\apache\hadoop\hdfs\TestDFSInotifyEventInputStreamKerberized.java,159,22,6,17,0,45
hadoop-trunk\hadoop-trunk\hadoop-yarn-project\hadoop-yarn\hadoop-yarn-server\hadoop-yarn-server-resourcemanager\src\main\java\org\apache\hadoop\yarn\server\resourcemanager\scheduler\fair\converter\FSConfigToCSConfigConverter.java,454,81,2,15,0,98
hadoop-trunk\hadoop-trunk\hadoop-hdfs-project\hadoop-hdfs-nfs\src\main\java\org\apache\hadoop\hdfs\nfs\nfs3\DFSClientCache.java,0,50,4,1,0,55
hadoop-trunk\hadoop-trunk\hadoop-tools\hadoop-azure\src\main\java\org\apache\hadoop\fs\azure\AzureFileSystemThreadPoolExecutor.java,0,81,5,33,0,119
hadoop-trunk\hadoop-trunk\hadoop-tools\hadoop-aliyun\src\test\java\org\apache\hadoop\fs\aliyun\oss\TestAliyunOSSInputStream.java,160,56,14,1,0,71
hadoop-trunk\hadoop-trunk\hadoop-tools\hadoop-aws\src\main\java\org\apache\hadoop\fs\s3a\commit\S3ACommitterFactory.java,86,7,2,2,0,11
hadoop-trunk\hadoop-trunk\hadoop-yarn-project\hadoop-yarn\hadoop-yarn-api\src\test\java\org\apache\hadoop\yarn\api\resource\TestPlacementConstraintParser.java,0,24,18,14,0,56
hadoop-trunk\hadoop-trunk\hadoop-mapreduce-project\hadoop-mapreduce-client\hadoop-mapreduce-client-core\src\main\java\org\apache\hadoop\mapreduce\lib\output\committer\manifest\files\ManifestPrinter.java,109,15,0,2,0,17
hadoop-trunk\hadoop-trunk\hadoop-mapreduce-project\hadoop-mapreduce-client\hadoop-mapreduce-client-core\src\main\java\org\apache\hadoop\mapreduce\task\TaskInputOutputContextImpl.java,0,29,4,1,0,34
hadoop-trunk\hadoop-trunk\hadoop-yarn-project\hadoop-yarn\hadoop-yarn-server\hadoop-yarn-server-resourcemanager\src\main\java\org\apache\hadoop\yarn\server\resourcemanager\blacklist\BlacklistManager.java,0,1,0,1,0,2
hadoop-trunk\hadoop-trunk\hadoop-yarn-project\hadoop-yarn\hadoop-yarn-server\hadoop-yarn-server-resourcemanager\src\test\java\org\apache\hadoop\yarn\server\resourcemanager\Task.java,119,93,5,2,0,100
hadoop-trunk\hadoop-trunk\hadoop-common-project\hadoop-common\src\main\java\org\apache\hadoop\security\GroupMappingServiceProvider.java,0,11,4,2,0,17
hadoop-trunk\hadoop-trunk\hadoop-tools\hadoop-aliyun\src\main\java\org\apache\hadoop\fs\aliyun\oss\AliyunOSSFileSystem.java,695,86,20,3,0,109
hadoop-trunk\hadoop-trunk\hadoop-mapreduce-project\hadoop-mapreduce-client\hadoop-mapreduce-client-core\src\main\java\org\apache\hadoop\mapreduce\lib\db\MySQLDBRecordReader.java,0,18,2,3,0,23
hadoop-trunk\hadoop-trunk\hadoop-tools\hadoop-distcp\src\test\java\org\apache\hadoop\tools\mapred\TestRetriableFileCopyCommand.java,49,14,7,1,0,22
hadoop-trunk\hadoop-trunk\hadoop-tools\hadoop-rumen\src\test\java\org\apache\hadoop\tools\rumen\TestPiecewiseLinearInterpolation.java,99,48,2,3,0,53
hadoop-trunk\hadoop-trunk\hadoop-yarn-project\hadoop-yarn\hadoop-yarn-server\hadoop-yarn-server-resourcemanager\src\main\java\org\apache\hadoop\yarn\server\resourcemanager\reservation\planning\StageExecutionIntervalUnconstrained.java,39,6,4,3,0,13
hadoop-trunk\hadoop-trunk\hadoop-mapreduce-project\hadoop-mapreduce-client\hadoop-mapreduce-client-common\src\main\java\org\apache\hadoop\mapreduce\v2\api\records\TaskAttemptCompletionEvent.java,0,31,10,1,0,42
hadoop-trunk\hadoop-trunk\hadoop-mapreduce-project\hadoop-mapreduce-client\hadoop-mapreduce-client-core\src\main\java\org\apache\hadoop\mapreduce\lib\input\SequenceFileInputFilter.java,0,135,24,1,0,160
hadoop-trunk\hadoop-trunk\hadoop-yarn-project\hadoop-yarn\hadoop-yarn-server\hadoop-yarn-server-resourcemanager\src\main\java\org\apache\hadoop\yarn\server\resourcemanager\RMInfo.java,45,12,1,1,0,14
hadoop-trunk\hadoop-trunk\hadoop-hdfs-project\hadoop-hdfs-client\src\main\java\org\apache\hadoop\hdfs\protocol\ReencryptionStatusIterator.java,0,11,0,1,0,12
hadoop-trunk\hadoop-trunk\hadoop-common-project\hadoop-common\src\main\java\org\apache\hadoop\ipc\metrics\DecayRpcSchedulerDetailedMetrics.java,96,43,2,1,0,46
hadoop-trunk\hadoop-trunk\hadoop-yarn-project\hadoop-yarn\hadoop-yarn-server\hadoop-yarn-server-nodemanager\src\main\java\org\apache\hadoop\yarn\server\nodemanager\containermanager\container\Container.java,0,42,0,4,0,46
hadoop-trunk\hadoop-trunk\hadoop-hdfs-project\hadoop-hdfs\src\main\java\org\apache\hadoop\hdfs\server\datanode\web\webhdfs\HdfsWriter.java,0,16,4,1,0,21
hadoop-trunk\hadoop-trunk\hadoop-tools\hadoop-streaming\src\test\java\org\apache\hadoop\streaming\TestStreamingFailure.java,0,10,0,1,0,11
hadoop-trunk\hadoop-trunk\hadoop-hdfs-project\hadoop-hdfs-client\src\main\java\org\apache\hadoop\hdfs\StripedDataStreamer.java,150,30,3,2,0,35
hadoop-trunk\hadoop-trunk\hadoop-tools\hadoop-dynamometer\hadoop-dynamometer-infra\src\main\java\org\apache\hadoop\tools\dynamometer\AllowAllImpersonationProvider.java,0,8,0,1,0,9
hadoop-trunk\hadoop-trunk\hadoop-hdfs-project\hadoop-hdfs\src\test\java\org\apache\hadoop\hdfs\server\datanode\fsdataset\impl\TestReplicaMap.java,0,36,1,1,0,38
hadoop-trunk\hadoop-trunk\hadoop-hdfs-project\hadoop-hdfs-rbf\src\main\java\org\apache\hadoop\hdfs\server\federation\resolver\order\HashFirstResolver.java,47,4,0,1,0,5
hadoop-trunk\hadoop-trunk\hadoop-yarn-project\hadoop-yarn\hadoop-yarn-server\hadoop-yarn-server-timelineservice-hbase\hadoop-yarn-server-timelineservice-hbase-common\src\main\java\org\apache\hadoop\yarn\server\timelineservice\storage\common\Separator.java,0,54,1,1,0,56
hadoop-trunk\hadoop-trunk\hadoop-mapreduce-project\hadoop-mapreduce-client\hadoop-mapreduce-client-core\src\main\java\org\apache\hadoop\mapred\QueueManager.java,534,79,10,4,0,93
hadoop-trunk\hadoop-trunk\hadoop-mapreduce-project\hadoop-mapreduce-client\hadoop-mapreduce-client-core\src\main\java\org\apache\hadoop\mapreduce\lib\aggregate\ValueAggregatorCombiner.java,0,9,3,1,0,13
hadoop-trunk\hadoop-trunk\hadoop-mapreduce-project\hadoop-mapreduce-client\hadoop-mapreduce-client-nativetask\src\test\java\org\apache\hadoop\mapred\nativetask\testutil\TestConstants.java,53,69,0,31,0,100
hadoop-trunk\hadoop-trunk\hadoop-yarn-project\hadoop-yarn\hadoop-yarn-server\hadoop-yarn-server-nodemanager\src\main\java\org\apache\hadoop\yarn\server\nodemanager\containermanager\localizer\ContainerLocalizer.java,446,114,12,11,0,137
hadoop-trunk\hadoop-trunk\hadoop-mapreduce-project\hadoop-mapreduce-client\hadoop-mapreduce-client-core\src\main\java\org\apache\hadoop\mapreduce\lib\output\NullOutputFormat.java,0,23,8,1,0,32
hadoop-trunk\hadoop-trunk\hadoop-tools\hadoop-streaming\src\main\java\org\apache\hadoop\streaming\PipeCombiner.java,18,5,1,1,0,7
hadoop-trunk\hadoop-trunk\hadoop-common-project\hadoop-common\src\main\java\org\apache\hadoop\metrics2\impl\MsInfo.java,0,12,0,1,0,13
hadoop-trunk\hadoop-trunk\hadoop-common-project\hadoop-registry\src\main\java\org\apache\hadoop\registry\client\impl\zk\package-info.java,0,1,0,2,0,3
hadoop-trunk\hadoop-trunk\hadoop-hdfs-project\hadoop-hdfs\src\main\java\org\apache\hadoop\hdfs\server\datanode\fsdataset\FsVolumeReference.java,0,1,0,1,0,2
hadoop-trunk\hadoop-trunk\hadoop-hdfs-project\hadoop-hdfs-rbf\src\main\java\org\apache\hadoop\hdfs\server\federation\resolver\RouterResolveException.java,9,2,0,1,0,3
hadoop-trunk\hadoop-trunk\hadoop-tools\hadoop-aliyun\src\test\java\org\apache\hadoop\fs\aliyun\oss\contract\AliyunOSSContract.java,28,8,0,1,0,9
hadoop-trunk\hadoop-trunk\hadoop-yarn-project\hadoop-yarn\hadoop-yarn-server\hadoop-yarn-server-resourcemanager\src\main\java\org\apache\hadoop\yarn\server\resourcemanager\DecommissioningNodesWatcher.java,322,77,12,2,0,91
hadoop-trunk\hadoop-trunk\hadoop-hdfs-project\hadoop-hdfs\src\main\java\org\apache\hadoop\hdfs\protocol\UnregisteredNodeException.java,25,10,0,1,0,11
hadoop-trunk\hadoop-trunk\hadoop-hdfs-project\hadoop-hdfs\src\main\java\org\apache\hadoop\hdfs\server\namenode\startupprogress\StartupProgress.java,229,47,1,8,0,56
hadoop-trunk\hadoop-trunk\hadoop-yarn-project\hadoop-yarn\hadoop-yarn-applications\hadoop-yarn-services\hadoop-yarn-services-api\src\main\java\org\apache\hadoop\yarn\service\client\ApiServiceClient.java,678,89,9,2,0,100
hadoop-trunk\hadoop-trunk\hadoop-yarn-project\hadoop-yarn\hadoop-yarn-common\src\test\java\org\apache\hadoop\yarn\webapp\GuiceServletConfig.java,15,6,0,1,0,7
hadoop-trunk\hadoop-trunk\hadoop-yarn-project\hadoop-yarn\hadoop-yarn-server\hadoop-yarn-server-resourcemanager\src\main\java\org\apache\hadoop\yarn\server\resourcemanager\monitor\SchedulingEditPolicy.java,0,4,0,2,0,6
hadoop-trunk\hadoop-trunk\hadoop-hdfs-project\hadoop-hdfs\src\main\java\org\apache\hadoop\hdfs\server\namenode\FSImageCompression.java,141,30,1,3,0,34
hadoop-trunk\hadoop-trunk\hadoop-hdfs-project\hadoop-hdfs\src\test\java\org\apache\hadoop\fs\contract\hdfs\TestHDFSContractAppend.java,18,4,0,1,0,5
hadoop-trunk\hadoop-trunk\hadoop-tools\hadoop-aws\src\test\java\org\apache\hadoop\fs\s3a\commit\CommitterFaultInjection.java,0,11,0,1,0,12
hadoop-trunk\hadoop-trunk\hadoop-yarn-project\hadoop-yarn\hadoop-yarn-applications\hadoop-yarn-services\hadoop-yarn-services-core\src\main\java\org\apache\hadoop\yarn\service\provider\docker\DockerProviderFactory.java,30,5,0,1,0,6
hadoop-trunk\hadoop-trunk\hadoop-yarn-project\hadoop-yarn\hadoop-yarn-server\hadoop-yarn-server-timelineservice\src\main\java\org\apache\hadoop\yarn\server\timelineservice\package-info.java,0,1,0,1,0,2
hadoop-trunk\hadoop-trunk\hadoop-common-project\hadoop-common\src\main\java\org\apache\hadoop\fs\shell\find\And.java,0,11,0,1,0,12
hadoop-trunk\hadoop-trunk\hadoop-tools\hadoop-azure\src\test\java\org\apache\hadoop\fs\azurebfs\services\TestAzureADAuthenticator.java,84,8,0,11,0,19
hadoop-trunk\hadoop-trunk\hadoop-common-project\hadoop-common\src\main\java\org\apache\hadoop\fs\statistics\impl\SourceWrappedStatistics.java,18,3,0,1,0,4
hadoop-trunk\hadoop-trunk\hadoop-yarn-project\hadoop-yarn\hadoop-yarn-server\hadoop-yarn-server-resourcemanager\src\test\java\org\apache\hadoop\yarn\server\resourcemanager\TestClusterMetrics.java,54,8,1,1,0,10
hadoop-trunk\hadoop-trunk\hadoop-mapreduce-project\hadoop-mapreduce-client\hadoop-mapreduce-client-core\src\main\java\org\apache\hadoop\mapreduce\jobhistory\HistoryEventHandler.java,0,1,0,1,0,2
hadoop-trunk\hadoop-trunk\hadoop-common-project\hadoop-common\src\test\java\org\apache\hadoop\fs\shell\TestPrintableString.java,0,5,0,1,0,6
hadoop-trunk\hadoop-trunk\hadoop-yarn-project\hadoop-yarn\hadoop-yarn-server\hadoop-yarn-server-nodemanager\src\test\java\org\apache\hadoop\yarn\server\nodemanager\containermanager\localizer\sharedcache\TestSharedCacheUploadService.java,25,5,1,2,0,8
hadoop-trunk\hadoop-trunk\hadoop-tools\hadoop-aws\src\test\java\org\apache\hadoop\fs\s3a\ITestS3AEncryptionSSEC.java,329,16,4,3,0,23
hadoop-trunk\hadoop-trunk\hadoop-hdfs-project\hadoop-hdfs\src\test\java\org\apache\hadoop\hdfs\server\namenode\TestNameNodeResourcePolicy.java,74,41,0,2,0,43
hadoop-trunk\hadoop-trunk\hadoop-mapreduce-project\hadoop-mapreduce-client\hadoop-mapreduce-client-nativetask\src\main\java\org\apache\hadoop\mapred\nativetask\serde\IKVSerializer.java,0,13,4,3,0,20
hadoop-trunk\hadoop-trunk\hadoop-common-project\hadoop-common\src\main\java\org\apache\hadoop\fs\permission\PermissionStatus.java,81,62,2,1,0,65
hadoop-trunk\hadoop-trunk\hadoop-common-project\hadoop-common\src\main\java\org\apache\hadoop\ipc\StandbyException.java,7,2,0,1,0,3
hadoop-trunk\hadoop-trunk\hadoop-yarn-project\hadoop-yarn\hadoop-yarn-common\src\main\java\org\apache\hadoop\yarn\webapp\MimeType.java,0,21,10,1,0,32
hadoop-trunk\hadoop-trunk\hadoop-mapreduce-project\hadoop-mapreduce-client\hadoop-mapreduce-client-core\src\main\java\org\apache\hadoop\mapred\jobcontrol\JobControl.java,0,22,6,1,0,29
hadoop-trunk\hadoop-trunk\hadoop-mapreduce-project\hadoop-mapreduce-client\hadoop-mapreduce-client-core\src\main\java\org\apache\hadoop\mapreduce\lib\join\ResetableIterator.java,0,30,13,1,0,44
hadoop-trunk\hadoop-trunk\hadoop-yarn-project\hadoop-yarn\hadoop-yarn-server\hadoop-yarn-server-resourcemanager\src\test\java\org\apache\hadoop\yarn\server\resourcemanager\recovery\TestFSRMStateStore.java,376,62,10,10,0,82
hadoop-trunk\hadoop-trunk\hadoop-yarn-project\hadoop-yarn\hadoop-yarn-server\hadoop-yarn-server-timeline-pluginstorage\src\main\java\org\apache\hadoop\yarn\server\timeline\TimelineEntityGroupPlugin.java,44,4,0,5,0,9
hadoop-trunk\hadoop-trunk\hadoop-yarn-project\hadoop-yarn\hadoop-yarn-server\hadoop-yarn-server-timelineservice\src\test\java\org\apache\hadoop\yarn\server\timelineservice\collector\TestPerNodeTimelineCollectorsAuxService.java,214,21,3,4,0,28
hadoop-trunk\hadoop-trunk\hadoop-mapreduce-project\hadoop-mapreduce-client\hadoop-mapreduce-client-common\src\main\java\org\apache\hadoop\mapreduce\v2\api\records\impl\pb\CounterGroupPBImpl.java,172,57,57,4,0,118
hadoop-trunk\hadoop-trunk\hadoop-hdfs-project\hadoop-hdfs\src\test\java\org\apache\hadoop\hdfs\server\namenode\TestClusterId.java,439,44,18,2,0,64
hadoop-trunk\hadoop-trunk\hadoop-mapreduce-project\hadoop-mapreduce-client\hadoop-mapreduce-client-hs\src\test\java\org\apache\hadoop\mapreduce\v2\hs\webapp\TestHsWebServicesAcls.java,389,43,6,1,0,50
hadoop-trunk\hadoop-trunk\hadoop-tools\hadoop-azure\src\test\java\org\apache\hadoop\fs\azurebfs\ITestAzureBlobFilesystemAcl.java,1382,155,37,11,0,203
hadoop-trunk\hadoop-trunk\hadoop-common-project\hadoop-auth\src\main\java\org\apache\hadoop\security\authentication\util\FileSignerSecretProvider.java,49,13,3,1,0,17
hadoop-trunk\hadoop-trunk\hadoop-common-project\hadoop-common\src\main\java\org\apache\hadoop\security\KerberosInfo.java,0,5,0,1,0,6
hadoop-trunk\hadoop-trunk\hadoop-yarn-project\hadoop-yarn\hadoop-yarn-server\hadoop-yarn-server-resourcemanager\src\main\java\org\apache\hadoop\yarn\server\resourcemanager\scheduler\fair\converter\PreconditionException.java,16,8,0,1,0,9
hadoop-trunk\hadoop-trunk\hadoop-yarn-project\hadoop-yarn\hadoop-yarn-server\hadoop-yarn-server-resourcemanager\src\main\java\org\apache\hadoop\yarn\server\resourcemanager\scheduler\FSQueueMetricsForCustomResources.java,87,48,0,1,0,49
hadoop-trunk\hadoop-trunk\hadoop-common-project\hadoop-common\src\main\java\org\apache\hadoop\fs\ClusterStorageCapacityExceededException.java,21,9,0,1,0,10
hadoop-trunk\hadoop-trunk\hadoop-yarn-project\hadoop-yarn\hadoop-yarn-common\src\main\java\org\apache\hadoop\yarn\webapp\log\package-info.java,0,1,0,1,0,2
hadoop-trunk\hadoop-trunk\hadoop-yarn-project\hadoop-yarn\hadoop-yarn-server\hadoop-yarn-server-common\src\main\java\org\apache\hadoop\yarn\server\api\ResourceTracker.java,0,4,0,5,0,9
hadoop-trunk\hadoop-trunk\hadoop-hdfs-project\hadoop-hdfs\src\test\java\org\apache\hadoop\hdfs\server\datanode\TestFsDatasetCacheRevocation.java,142,22,0,1,0,23
hadoop-trunk\hadoop-trunk\hadoop-hdfs-project\hadoop-hdfs-client\src\main\java\org\apache\hadoop\hdfs\protocol\CacheDirectiveIterator.java,0,20,1,2,0,23
hadoop-trunk\hadoop-trunk\hadoop-yarn-project\hadoop-yarn\hadoop-yarn-api\src\main\java\org\apache\hadoop\yarn\server\api\protocolrecords\NodesToAttributesMappingResponse.java,6,2,1,1,0,4
hadoop-trunk\hadoop-trunk\hadoop-mapreduce-project\hadoop-mapreduce-client\hadoop-mapreduce-client-core\src\main\java\org\apache\hadoop\mapred\InvalidInputException.java,42,8,0,1,0,9
hadoop-trunk\hadoop-trunk\hadoop-yarn-project\hadoop-yarn\hadoop-yarn-csi\src\main\java\org\apache\hadoop\yarn\csi\utils\GrpcHelper.java,0,3,1,1,0,5
hadoop-trunk\hadoop-trunk\hadoop-cloud-storage-project\hadoop-huaweicloud\src\test\java\org\apache\hadoop\fs\obs\OBSTestUtils.java,0,9,4,1,0,14
hadoop-trunk\hadoop-trunk\hadoop-yarn-project\hadoop-yarn\hadoop-yarn-api\src\main\java\org\apache\hadoop\yarn\server\api\protocolrecords\RefreshSuperUserGroupsConfigurationResponse.java,10,1,1,1,0,3
hadoop-trunk\hadoop-trunk\hadoop-yarn-project\hadoop-yarn\hadoop-yarn-server\hadoop-yarn-server-resourcemanager\src\main\java\org\apache\hadoop\yarn\server\resourcemanager\scheduler\capacity\CSQueueUsageTracker.java,56,24,0,2,0,26
hadoop-trunk\hadoop-trunk\hadoop-common-project\hadoop-common\src\main\java\org\apache\hadoop\net\DNSDomainNameResolver.java,36,11,0,1,0,12
hadoop-trunk\hadoop-trunk\hadoop-hdfs-project\hadoop-hdfs\src\test\java\org\apache\hadoop\hdfs\server\datanode\TestDiskError.java,227,35,4,2,0,41
hadoop-trunk\hadoop-trunk\hadoop-common-project\hadoop-common\src\test\java\org\apache\hadoop\io\file\tfile\KVGenerator.java,0,34,3,1,0,38
hadoop-trunk\hadoop-trunk\hadoop-yarn-project\hadoop-yarn\hadoop-yarn-api\src\main\java\org\apache\hadoop\yarn\api\records\timeline\TimelineEvents.java,151,44,4,1,0,49
hadoop-trunk\hadoop-trunk\hadoop-hdfs-project\hadoop-hdfs-rbf\src\main\java\org\apache\hadoop\hdfs\server\federation\store\records\impl\pb\MembershipStatsPBImpl.java,0,80,102,5,0,187
hadoop-trunk\hadoop-trunk\hadoop-yarn-project\hadoop-yarn\hadoop-yarn-api\src\main\java\org\apache\hadoop\yarn\api\records\ReservationAllocationState.java,137,5,0,1,0,6
hadoop-trunk\hadoop-trunk\hadoop-tools\hadoop-aws\src\test\java\org\apache\hadoop\fs\s3a\TestListing.java,22,3,0,1,0,4
hadoop-trunk\hadoop-trunk\hadoop-yarn-project\hadoop-yarn\hadoop-yarn-server\hadoop-yarn-server-common\src\main\java\org\apache\hadoop\yarn\server\federation\store\records\GetSubClusterPoliciesConfigurationsRequest.java,6,2,0,1,0,3
hadoop-trunk\hadoop-trunk\hadoop-yarn-project\hadoop-yarn\hadoop-yarn-applications\hadoop-yarn-applications-mawo\hadoop-yarn-applications-mawo-core\src\main\java\org\apache\hadoop\applications\mawo\server\common\TeardownTask.java,24,0,0,1,0,1
hadoop-trunk\hadoop-trunk\hadoop-mapreduce-project\hadoop-mapreduce-client\hadoop-mapreduce-client-common\src\main\java\org\apache\hadoop\mapreduce\v2\api\protocolrecords\impl\pb\GetCountersRequestPBImpl.java,79,33,33,4,0,70
hadoop-trunk\hadoop-trunk\hadoop-tools\hadoop-aws\src\test\java\org\apache\hadoop\fs\s3a\commit\staging\integration\ITestPartitionedCommitProtocol.java,104,21,0,1,0,22
hadoop-trunk\hadoop-trunk\hadoop-tools\hadoop-streaming\src\main\java\org\apache\hadoop\record\RecordOutput.java,0,28,22,1,0,51
hadoop-trunk\hadoop-trunk\hadoop-tools\hadoop-openstack\src\main\java\org\apache\hadoop\fs\swift\exceptions\SwiftThrottledRequestException.java,9,5,0,1,0,6
hadoop-trunk\hadoop-trunk\hadoop-hdfs-project\hadoop-hdfs\src\test\java\org\apache\hadoop\hdfs\server\datanode\TestDataNodeUUID.java,81,4,1,1,0,6
hadoop-trunk\hadoop-trunk\hadoop-tools\hadoop-openstack\src\main\java\org\apache\hadoop\fs\swift\auth\entities\Catalog.java,77,14,3,1,0,18
hadoop-trunk\hadoop-trunk\hadoop-tools\hadoop-rumen\src\main\java\org\apache\hadoop\tools\rumen\package-info.java,0,136,0,37,0,173
hadoop-trunk\hadoop-trunk\hadoop-mapreduce-project\hadoop-mapreduce-client\hadoop-mapreduce-client-common\src\test\java\org\apache\hadoop\mapreduce\TestTypeConverter.java,173,51,10,19,0,80
hadoop-trunk\hadoop-trunk\hadoop-yarn-project\hadoop-yarn\hadoop-yarn-common\src\test\java\org\apache\hadoop\yarn\webapp\WebServicesTestUtils.java,119,49,2,5,0,56
hadoop-trunk\hadoop-trunk\hadoop-yarn-project\hadoop-yarn\hadoop-yarn-server\hadoop-yarn-server-nodemanager\src\main\java\org\apache\hadoop\yarn\server\nodemanager\containermanager\linux\runtime\RuncContainerRuntime.java,772,145,21,34,0,200
hadoop-trunk\hadoop-trunk\hadoop-yarn-project\hadoop-yarn\hadoop-yarn-server\hadoop-yarn-server-resourcemanager\src\main\java\org\apache\hadoop\yarn\server\resourcemanager\reservation\exceptions\PlanningException.java,18,8,0,1,0,9
hadoop-trunk\hadoop-trunk\hadoop-hdfs-project\hadoop-hdfs\src\test\java\org\apache\hadoop\tools\TestHdfsConfigFields.java,112,5,0,4,0,9
hadoop-trunk\hadoop-trunk\hadoop-yarn-project\hadoop-yarn\hadoop-yarn-server\hadoop-yarn-server-resourcemanager\src\main\java\org\apache\hadoop\yarn\server\resourcemanager\scheduler\placement\MultiNodeSortingManager.java,0,31,11,2,0,44
hadoop-trunk\hadoop-trunk\hadoop-yarn-project\hadoop-yarn\hadoop-yarn-applications\hadoop-yarn-services\hadoop-yarn-services-core\src\test\java\org\apache\hadoop\yarn\service\conf\ExampleAppJson.java,0,16,0,2,0,18
hadoop-trunk\hadoop-trunk\hadoop-mapreduce-project\hadoop-mapreduce-client\hadoop-mapreduce-client-jobclient\src\test\java\org\apache\hadoop\fs\TestDFSIO.java,0,340,90,6,0,436
hadoop-trunk\hadoop-trunk\hadoop-mapreduce-project\hadoop-mapreduce-client\hadoop-mapreduce-client-app\src\main\java\org\apache\hadoop\mapreduce\v2\app\speculate\forecast\package-info.java,0,1,0,1,0,2
hadoop-trunk\hadoop-trunk\hadoop-tools\hadoop-rumen\src\main\java\org\apache\hadoop\tools\rumen\serializers\DefaultRumenSerializer.java,12,8,3,2,0,13
hadoop-trunk\hadoop-trunk\hadoop-yarn-project\hadoop-yarn\hadoop-yarn-api\src\main\java\org\apache\hadoop\yarn\api\protocolrecords\GetAllResourceProfilesRequest.java,7,1,0,1,0,2
hadoop-trunk\hadoop-trunk\hadoop-yarn-project\hadoop-yarn\hadoop-yarn-server\hadoop-yarn-server-nodemanager\src\main\java\org\apache\hadoop\yarn\server\nodemanager\webapp\dao\gpu\PerGpuMemoryUsage.java,32,16,0,1,0,17
hadoop-trunk\hadoop-trunk\hadoop-common-project\hadoop-common\src\test\java\org\apache\hadoop\util\functional\TestTaskPool.java,535,64,4,2,0,70
hadoop-trunk\hadoop-trunk\hadoop-mapreduce-project\hadoop-mapreduce-client\hadoop-mapreduce-client-core\src\main\java\org\apache\hadoop\mapred\lib\MultithreadedMapRunner.java,0,48,6,1,0,55
hadoop-trunk\hadoop-trunk\hadoop-tools\hadoop-azure\src\main\java\org\apache\hadoop\fs\azurebfs\diagnostics\package-info.java,0,2,0,1,0,3
hadoop-trunk\hadoop-trunk\hadoop-yarn-project\hadoop-yarn\hadoop-yarn-common\src\test\java\org\apache\hadoop\yarn\api\records\timelineservice\TestTimelineServiceRecords.java,276,19,20,1,0,40
hadoop-trunk\hadoop-trunk\hadoop-yarn-project\hadoop-yarn\hadoop-yarn-common\src\main\java\org\apache\hadoop\yarn\YarnUncaughtExceptionHandler.java,36,13,5,1,0,19
hadoop-trunk\hadoop-trunk\hadoop-mapreduce-project\hadoop-mapreduce-client\hadoop-mapreduce-client-common\src\main\java\org\apache\hadoop\mapreduce\v2\api\records\JobId.java,81,27,6,1,0,34
hadoop-trunk\hadoop-trunk\hadoop-yarn-project\hadoop-yarn\hadoop-yarn-common\src\main\java\org\apache\hadoop\yarn\util\Log4jWarningErrorMetricsAppender.java,415,111,8,4,0,123
hadoop-trunk\hadoop-trunk\hadoop-hdfs-project\hadoop-hdfs\src\main\java\org\apache\hadoop\hdfs\server\datanode\Replica.java,0,21,9,1,0,31
hadoop-trunk\hadoop-trunk\hadoop-hdfs-project\hadoop-hdfs\src\main\java\org\apache\hadoop\hdfs\server\namenode\LeaseManager.java,623,124,23,3,0,150
hadoop-trunk\hadoop-trunk\hadoop-hdfs-project\hadoop-hdfs-rbf\src\main\java\org\apache\hadoop\hdfs\server\federation\store\protocol\impl\pb\RemoveMountTableEntryRequestPBImpl.java,0,13,28,4,0,45
hadoop-trunk\hadoop-trunk\hadoop-hdfs-project\hadoop-hdfs\src\test\java\org\apache\hadoop\hdfs\server\namenode\TestReencryptionWithKMS.java,57,9,1,1,0,11
hadoop-trunk\hadoop-trunk\hadoop-yarn-project\hadoop-yarn\hadoop-yarn-server\hadoop-yarn-server-nodemanager\src\main\java\org\apache\hadoop\yarn\server\nodemanager\containermanager\container\ContainerEventType.java,0,21,0,1,0,22
hadoop-trunk\hadoop-trunk\hadoop-yarn-project\hadoop-yarn\hadoop-yarn-api\src\main\java\org\apache\hadoop\yarn\api\records\Token.java,64,14,0,2,0,16
hadoop-trunk\hadoop-trunk\hadoop-common-project\hadoop-common\src\main\java\org\apache\hadoop\tools\package-info.java,0,1,0,1,0,2
hadoop-trunk\hadoop-trunk\hadoop-yarn-project\hadoop-yarn\hadoop-yarn-common\src\main\java\org\apache\hadoop\yarn\logaggregation\filecontroller\LogAggregationFileController.java,596,75,18,4,0,97
hadoop-trunk\hadoop-trunk\hadoop-common-project\hadoop-common\src\main\java\org\apache\hadoop\fs\statistics\impl\IOStatisticsBinding.java,0,60,0,3,0,63
hadoop-trunk\hadoop-trunk\hadoop-hdfs-project\hadoop-hdfs\src\test\java\org\apache\hadoop\hdfs\protocol\TestBlockListAsLongs.java,201,68,12,3,0,83
hadoop-trunk\hadoop-trunk\hadoop-yarn-project\hadoop-yarn\hadoop-yarn-server\hadoop-yarn-server-resourcemanager\src\main\java\org\apache\hadoop\yarn\server\resourcemanager\scheduler\capacity\ParentQueue.java,1581,287,27,73,0,387
hadoop-trunk\hadoop-trunk\hadoop-yarn-project\hadoop-yarn\hadoop-yarn-common\src\main\java\org\apache\hadoop\yarn\api\protocolrecords\impl\pb\GetContainerStatusesRequestPBImpl.java,114,28,43,3,0,74
hadoop-trunk\hadoop-trunk\hadoop-yarn-project\hadoop-yarn\hadoop-yarn-server\hadoop-yarn-server-timelineservice-hbase\hadoop-yarn-server-timelineservice-hbase-common\src\main\java\org\apache\hadoop\yarn\server\timelineservice\storage\common\ColumnPrefix.java,0,3,0,1,0,4
hadoop-trunk\hadoop-trunk\hadoop-common-project\hadoop-common\src\main\java\org\apache\hadoop\fs\viewfs\ViewFileSystemUtil.java,0,4,0,1,0,5
hadoop-trunk\hadoop-trunk\hadoop-common-project\hadoop-common\src\main\java\org\apache\hadoop\security\token\Token.java,503,87,2,1,0,90
hadoop-trunk\hadoop-trunk\hadoop-tools\hadoop-dynamometer\hadoop-dynamometer-workload\src\main\java\org\apache\hadoop\tools\dynamometer\workloadgenerator\WorkloadMapper.java,0,7,4,1,0,12
hadoop-trunk\hadoop-trunk\hadoop-mapreduce-project\hadoop-mapreduce-client\hadoop-mapreduce-client-core\src\main\java\org\apache\hadoop\mapreduce\Reducer.java,0,66,5,8,0,79
hadoop-trunk\hadoop-trunk\hadoop-hdfs-project\hadoop-hdfs-rbf\src\main\java\org\apache\hadoop\hdfs\server\federation\router\RouterQuotaManager.java,201,13,2,1,0,16
hadoop-trunk\hadoop-trunk\hadoop-common-project\hadoop-registry\src\main\java\org\apache\hadoop\registry\client\impl\zk\RegistrySecurity.java,1062,152,19,8,0,179
hadoop-trunk\hadoop-trunk\hadoop-common-project\hadoop-common\src\main\java\org\apache\hadoop\net\InnerNodeImpl.java,285,90,7,1,0,98
hadoop-trunk\hadoop-trunk\hadoop-tools\hadoop-gridmix\src\test\java\org\apache\hadoop\mapred\gridmix\TestSleepJob.java,105,19,7,2,0,28
hadoop-trunk\hadoop-trunk\hadoop-common-project\hadoop-common\src\main\java\org\apache\hadoop\util\NativeLibraryChecker.java,121,11,9,2,0,22
hadoop-trunk\hadoop-trunk\hadoop-yarn-project\hadoop-yarn\hadoop-yarn-common\src\test\java\org\apache\hadoop\yarn\util\timeline\TestShortenedFlowName.java,25,6,0,1,0,7
hadoop-trunk\hadoop-trunk\hadoop-common-project\hadoop-common\src\main\java\org\apache\hadoop\ipc\protocolPB\RefreshCallQueueProtocolPB.java,0,4,3,3,0,10
hadoop-trunk\hadoop-trunk\hadoop-mapreduce-project\hadoop-mapreduce-client\hadoop-mapreduce-client-core\src\main\java\org\apache\hadoop\mapreduce\security\package-info.java,0,1,0,1,0,2
hadoop-trunk\hadoop-trunk\hadoop-yarn-project\hadoop-yarn\hadoop-yarn-api\src\main\java\org\apache\hadoop\yarn\exceptions\ContainerNotFoundException.java,17,11,1,2,0,14
hadoop-trunk\hadoop-trunk\hadoop-yarn-project\hadoop-yarn\hadoop-yarn-server\hadoop-yarn-server-resourcemanager\src\main\java\org\apache\hadoop\yarn\server\resourcemanager\scheduler\fair\FairScheduler.java,0,297,44,36,0,377
hadoop-trunk\hadoop-trunk\hadoop-common-project\hadoop-minikdc\src\test\java\org\apache\hadoop\minikdc\TestChangeOrgNameAndDomain.java,12,2,0,1,0,3
hadoop-trunk\hadoop-trunk\hadoop-tools\hadoop-archive-logs\src\main\java\org\apache\hadoop\tools\HadoopArchiveLogs.java,634,124,23,8,0,155
hadoop-trunk\hadoop-trunk\hadoop-hdfs-project\hadoop-hdfs-rbf\src\main\java\org\apache\hadoop\hdfs\server\federation\metrics\RouterMBean.java,0,0,0,1,0,1
hadoop-trunk\hadoop-trunk\hadoop-hdfs-project\hadoop-hdfs\src\main\java\org\apache\hadoop\hdfs\web\resources\TokenKindParam.java,23,6,1,2,0,9
hadoop-trunk\hadoop-trunk\hadoop-mapreduce-project\hadoop-mapreduce-client\hadoop-mapreduce-client-common\src\main\java\org\apache\hadoop\mapreduce\v2\api\protocolrecords\impl\pb\GetDelegationTokenResponsePBImpl.java,80,35,33,5,0,73
hadoop-trunk\hadoop-trunk\hadoop-hdfs-project\hadoop-hdfs\src\test\java\org\apache\hadoop\fs\TestFcHdfsCreateMkdir.java,43,15,1,2,0,18
hadoop-trunk\hadoop-trunk\hadoop-yarn-project\hadoop-yarn\hadoop-yarn-server\hadoop-yarn-server-timelineservice\src\main\java\org\apache\hadoop\yarn\server\timelineservice\storage\TimelineWriter.java,0,1,0,2,0,3
hadoop-trunk\hadoop-trunk\hadoop-common-project\hadoop-common\src\main\java\org\apache\hadoop\fs\shell\CommandFactory.java,107,24,4,1,0,29
hadoop-trunk\hadoop-trunk\hadoop-mapreduce-project\hadoop-mapreduce-examples\src\main\java\org\apache\hadoop\examples\pi\Container.java,0,4,1,1,0,6
hadoop-trunk\hadoop-trunk\hadoop-mapreduce-project\hadoop-mapreduce-client\hadoop-mapreduce-client-core\src\main\java\org\apache\hadoop\mapred\lib\aggregate\StringValueMax.java,0,3,0,1,0,4
hadoop-trunk\hadoop-trunk\hadoop-yarn-project\hadoop-yarn\hadoop-yarn-common\src\test\java\org\apache\hadoop\yarn\webapp\hamlet2\TestHamletImpl.java,81,8,3,1,0,12
hadoop-trunk\hadoop-trunk\hadoop-yarn-project\hadoop-yarn\hadoop-yarn-server\hadoop-yarn-server-resourcemanager\src\main\java\org\apache\hadoop\yarn\server\resourcemanager\webapp\dao\AppState.java,29,19,1,1,0,21
hadoop-trunk\hadoop-trunk\hadoop-yarn-project\hadoop-yarn\hadoop-yarn-applications\hadoop-yarn-applications-mawo\hadoop-yarn-applications-mawo-core\src\main\java\org\apache\hadoop\applications\mawo\server\common\DieTask.java,10,0,0,1,0,1
hadoop-trunk\hadoop-trunk\hadoop-common-project\hadoop-auth\src\main\java\org\apache\hadoop\security\authentication\client\AuthenticationException.java,33,5,0,1,0,6
hadoop-trunk\hadoop-trunk\hadoop-tools\hadoop-resourceestimator\src\main\java\org\apache\hadoop\resourceestimator\skylinestore\api\package-info.java,0,1,0,1,0,2
hadoop-trunk\hadoop-trunk\hadoop-common-project\hadoop-common\src\main\java\org\apache\hadoop\fs\permission\AclEntry.java,300,43,2,3,0,48
hadoop-trunk\hadoop-trunk\hadoop-hdfs-project\hadoop-hdfs-rbf\src\test\java\org\apache\hadoop\hdfs\server\federation\router\TestRouterFederationRenameInKerberosEnv.java,0,33,0,14,0,47
hadoop-trunk\hadoop-trunk\hadoop-hdfs-project\hadoop-hdfs\src\test\java\org\apache\hadoop\hdfs\server\namenode\TestDeduplicationMap.java,13,3,0,2,0,5
hadoop-trunk\hadoop-trunk\hadoop-hdfs-project\hadoop-hdfs\src\test\java\org\apache\hadoop\hdfs\server\namenode\TestEditLogFileOutputStream.java,123,24,4,2,0,30
hadoop-trunk\hadoop-trunk\hadoop-yarn-project\hadoop-yarn\hadoop-yarn-server\hadoop-yarn-server-nodemanager\src\main\java\org\apache\hadoop\yarn\server\nodemanager\ContainerExecutor.java,841,135,17,13,0,165
hadoop-trunk\hadoop-trunk\hadoop-yarn-project\hadoop-yarn\hadoop-yarn-server\hadoop-yarn-server-common\src\main\java\org\apache\hadoop\yarn\server\federation\store\utils\FederationStateStoreUtils.java,0,29,0,5,0,34
hadoop-trunk\hadoop-trunk\hadoop-hdfs-project\hadoop-hdfs\src\test\java\org\apache\hadoop\security\TestRefreshUserMappings.java,228,89,20,7,0,116
hadoop-trunk\hadoop-trunk\hadoop-common-project\hadoop-common\src\test\java\org\apache\hadoop\security\http\TestRestCsrfPreventionFilter.java,324,15,5,1,0,21
hadoop-trunk\hadoop-trunk\hadoop-common-project\hadoop-nfs\src\main\java\org\apache\hadoop\nfs\nfs3\response\SETATTR3Response.java,30,18,0,1,0,19
hadoop-trunk\hadoop-trunk\hadoop-hdfs-project\hadoop-hdfs-nfs\src\main\java\org\apache\hadoop\hdfs\nfs\nfs3\Nfs3Utils.java,227,97,2,2,0,101
hadoop-trunk\hadoop-trunk\hadoop-yarn-project\hadoop-yarn\hadoop-yarn-server\hadoop-yarn-server-resourcemanager\src\main\java\org\apache\hadoop\yarn\server\resourcemanager\webapp\JAXBContextResolver.java,98,11,18,2,0,31
hadoop-trunk\hadoop-trunk\hadoop-common-project\hadoop-common\src\test\java\org\apache\hadoop\metrics2\util\TestMBeans.java,77,8,0,1,0,9
hadoop-trunk\hadoop-trunk\hadoop-tools\hadoop-azure\src\test\java\org\apache\hadoop\fs\azurebfs\ITestCustomerProvidedKey.java,889,83,5,27,0,115
hadoop-trunk\hadoop-trunk\hadoop-tools\hadoop-azure\src\main\java\org\apache\hadoop\fs\azurebfs\services\AbfsIoUtils.java,0,1,1,1,0,3
hadoop-trunk\hadoop-trunk\hadoop-yarn-project\hadoop-yarn\hadoop-yarn-server\hadoop-yarn-server-common\src\main\java\org\apache\hadoop\yarn\server\webapp\dao\ContainerInfo.java,132,66,0,1,0,67
hadoop-trunk\hadoop-trunk\hadoop-common-project\hadoop-common\src\test\java\org\apache\hadoop\fs\contract\localfs\TestLocalFSContractLoaded.java,24,6,0,1,0,7
hadoop-trunk\hadoop-trunk\hadoop-tools\hadoop-aws\src\main\java\org\apache\hadoop\fs\s3a\UploadInfo.java,19,11,0,1,0,12
hadoop-trunk\hadoop-trunk\hadoop-yarn-project\hadoop-yarn\hadoop-yarn-server\hadoop-yarn-server-common\src\test\java\org\apache\hadoop\yarn\server\uam\TestUnmanagedApplicationManager.java,418,76,2,5,0,83
hadoop-trunk\hadoop-trunk\hadoop-yarn-project\hadoop-yarn\hadoop-yarn-common\src\main\java\org\apache\hadoop\yarn\util\timeline\package-info.java,0,1,0,1,0,2
hadoop-trunk\hadoop-trunk\hadoop-hdfs-project\hadoop-hdfs\src\test\java\org\apache\hadoop\hdfs\server\namenode\TestStorageRestore.java,385,124,16,15,0,155
hadoop-trunk\hadoop-trunk\hadoop-tools\hadoop-aws\src\main\java\org\apache\hadoop\fs\s3a\AWSStatus500Exception.java,7,3,0,1,0,4
hadoop-trunk\hadoop-trunk\hadoop-tools\hadoop-datajoin\src\main\java\org\apache\hadoop\contrib\utils\join\JobBase.java,0,29,14,1,0,44
hadoop-trunk\hadoop-trunk\hadoop-hdfs-project\hadoop-hdfs\src\main\java\org\apache\hadoop\hdfs\server\datanode\ReplicaUnderRecovery.java,120,46,2,2,0,50
hadoop-trunk\hadoop-trunk\hadoop-yarn-project\hadoop-yarn\hadoop-yarn-server\hadoop-yarn-server-nodemanager\src\main\java\org\apache\hadoop\yarn\server\nodemanager\containermanager\localizer\sharedcache\SharedCacheUploadEvent.java,27,20,0,3,0,23
hadoop-trunk\hadoop-trunk\hadoop-common-project\hadoop-common\src\main\java\org\apache\hadoop\util\InstrumentedLock.java,248,76,3,2,0,81
hadoop-trunk\hadoop-trunk\hadoop-common-project\hadoop-nfs\src\test\java\org\apache\hadoop\oncrpc\TestRpcAcceptedReply.java,0,11,0,1,0,12
hadoop-trunk\hadoop-trunk\hadoop-hdfs-project\hadoop-hdfs\src\main\java\org\apache\hadoop\hdfs\web\resources\UserProvider.java,0,9,0,1,0,10
hadoop-trunk\hadoop-trunk\hadoop-yarn-project\hadoop-yarn\hadoop-yarn-server\hadoop-yarn-server-common\src\main\java\org\apache\hadoop\yarn\server\api\records\NodeAction.java,0,4,0,1,0,5
hadoop-trunk\hadoop-trunk\hadoop-yarn-project\hadoop-yarn\hadoop-yarn-server\hadoop-yarn-server-nodemanager\src\main\java\org\apache\hadoop\yarn\server\nodemanager\containermanager\launcher\ContainerLaunch.java,1776,260,38,25,0,323
hadoop-trunk\hadoop-trunk\hadoop-common-project\hadoop-nfs\src\main\java\org\apache\hadoop\mount\MountInterface.java,0,20,6,1,0,27
hadoop-trunk\hadoop-trunk\hadoop-mapreduce-project\hadoop-mapreduce-client\hadoop-mapreduce-client-core\src\main\java\org\apache\hadoop\mapreduce\TaskAttemptContext.java,0,14,6,1,0,21
hadoop-trunk\hadoop-trunk\hadoop-yarn-project\hadoop-yarn\hadoop-yarn-client\src\test\java\org\apache\hadoop\yarn\client\cli\TestSchedConfCLI.java,327,47,2,7,0,56
hadoop-trunk\hadoop-trunk\hadoop-hdfs-project\hadoop-hdfs\src\test\java\org\apache\hadoop\hdfs\server\namenode\TestStoragePolicySummary.java,172,148,0,8,0,156
hadoop-trunk\hadoop-trunk\hadoop-mapreduce-project\hadoop-mapreduce-client\hadoop-mapreduce-client-jobclient\src\test\java\org\apache\hadoop\fs\slive\Weights.java,0,17,4,1,0,22
hadoop-trunk\hadoop-trunk\hadoop-hdfs-project\hadoop-hdfs\src\test\java\org\apache\hadoop\hdfs\server\common\blockaliasmap\impl\TestInMemoryLevelDBAliasMapClient.java,326,98,7,2,0,107
hadoop-trunk\hadoop-trunk\hadoop-yarn-project\hadoop-yarn\hadoop-yarn-api\src\main\java\org\apache\hadoop\yarn\api\records\PreemptionContainer.java,23,4,0,2,0,6
hadoop-trunk\hadoop-trunk\hadoop-tools\hadoop-federation-balance\src\main\java\org\apache\hadoop\tools\fedbalance\procedure\BalanceProcedure.java,0,42,8,2,0,52
hadoop-trunk\hadoop-trunk\hadoop-tools\hadoop-aws\src\main\java\org\apache\hadoop\fs\s3a\auth\delegation\AbstractDTService.java,0,6,0,4,0,10
hadoop-trunk\hadoop-trunk\hadoop-tools\hadoop-azure\src\main\java\org\apache\hadoop\fs\azurebfs\constants\AuthConfigurations.java,0,0,0,1,0,1
hadoop-trunk\hadoop-trunk\hadoop-yarn-project\hadoop-yarn\hadoop-yarn-applications\hadoop-yarn-services\hadoop-yarn-services-api\src\test\java\org\apache\hadoop\yarn\service\client\TestSystemServiceManagerImpl.java,215,21,5,1,0,27
hadoop-trunk\hadoop-trunk\hadoop-hdfs-project\hadoop-hdfs-client\src\test\java\org\apache\hadoop\hdfs\server\namenode\ha\TestConfiguredFailoverProxyProvider.java,367,55,9,1,0,65
hadoop-trunk\hadoop-trunk\hadoop-common-project\hadoop-auth\src\test\java\org\apache\hadoop\security\authentication\util\TestKerberosName.java,121,20,2,2,0,24
hadoop-trunk\hadoop-trunk\hadoop-tools\hadoop-azure\src\test\java\org\apache\hadoop\fs\azure\ITestNativeAzureFileSystemContractEmulator.java,32,6,3,1,0,10
hadoop-trunk\hadoop-trunk\hadoop-maven-plugins\src\main\java\org\apache\hadoop\maven\plugin\protoc\ProtocTestMojo.java,32,22,0,1,0,23
hadoop-trunk\hadoop-trunk\hadoop-yarn-project\hadoop-yarn\hadoop-yarn-applications\hadoop-yarn-services\hadoop-yarn-services-core\src\main\java\org\apache\hadoop\yarn\service\utils\Comparators.java,37,17,0,2,0,19
hadoop-trunk\hadoop-trunk\hadoop-hdfs-project\hadoop-hdfs\src\test\java\org\apache\hadoop\hdfs\server\datanode\TestDataNodePeerMetrics.java,121,18,4,3,0,25
hadoop-trunk\hadoop-trunk\hadoop-hdfs-project\hadoop-hdfs\src\test\java\org\apache\hadoop\hdfs\TestSafeModeWithStripedFileWithRandomECPolicy.java,22,4,1,1,0,6
hadoop-trunk\hadoop-trunk\hadoop-yarn-project\hadoop-yarn\hadoop-yarn-common\src\main\java\org\apache\hadoop\yarn\logaggregation\filecontroller\LogAggregationDFSException.java,21,8,1,1,0,10
hadoop-trunk\hadoop-trunk\hadoop-tools\hadoop-azure-datalake\src\test\java\org\apache\hadoop\fs\adl\live\TestAdlContractMkdirLive.java,7,3,0,1,0,4
hadoop-trunk\hadoop-trunk\hadoop-yarn-project\hadoop-yarn\hadoop-yarn-common\src\main\java\org\apache\hadoop\yarn\util\AuxiliaryServiceHelper.java,26,12,1,1,0,14
hadoop-trunk\hadoop-trunk\hadoop-mapreduce-project\hadoop-mapreduce-client\hadoop-mapreduce-client-core\src\main\java\org\apache\hadoop\mapreduce\lib\db\FloatSplitter.java,68,8,0,2,0,10
hadoop-trunk\hadoop-trunk\hadoop-hdfs-project\hadoop-hdfs\src\main\java\org\apache\hadoop\hdfs\server\datanode\fsdataset\impl\CacheStats.java,0,23,0,1,0,24
hadoop-trunk\hadoop-trunk\hadoop-mapreduce-project\hadoop-mapreduce-client\hadoop-mapreduce-client-jobclient\src\test\java\org\apache\hadoop\mapreduce\TestNoJobSetupCleanup.java,77,26,6,3,0,35
hadoop-trunk\hadoop-trunk\hadoop-yarn-project\hadoop-yarn\hadoop-yarn-server\hadoop-yarn-server-common\src\main\java\org\apache\hadoop\yarn\server\webapp\dao\AppInfo.java,237,125,0,2,0,127
hadoop-trunk\hadoop-trunk\hadoop-yarn-project\hadoop-yarn\hadoop-yarn-common\src\main\java\org\apache\hadoop\yarn\factories\impl\pb\package-info.java,0,1,0,1,0,2
hadoop-trunk\hadoop-trunk\hadoop-yarn-project\hadoop-yarn\hadoop-yarn-common\src\main\java\org\apache\hadoop\yarn\factory\providers\RpcFactoryProvider.java,38,12,2,2,0,16
hadoop-trunk\hadoop-trunk\hadoop-hdfs-project\hadoop-hdfs\src\test\java\org\apache\hadoop\hdfs\TestMultiThreadedHflush.java,248,66,5,3,0,74
hadoop-trunk\hadoop-trunk\hadoop-yarn-project\hadoop-yarn\hadoop-yarn-server\hadoop-yarn-server-applicationhistoryservice\src\main\java\org\apache\hadoop\yarn\server\applicationhistoryservice\records\ApplicationFinishData.java,62,16,0,1,0,17
hadoop-trunk\hadoop-trunk\hadoop-cloud-storage-project\hadoop-cos\src\main\java\org\apache\hadoop\fs\cosn\Unit.java,0,5,0,1,0,6
hadoop-trunk\hadoop-trunk\hadoop-mapreduce-project\hadoop-mapreduce-client\hadoop-mapreduce-client-core\src\main\java\org\apache\hadoop\mapred\InputSplitWithLocationInfo.java,0,1,0,1,0,2
hadoop-trunk\hadoop-trunk\hadoop-yarn-project\hadoop-yarn\hadoop-yarn-server\hadoop-yarn-server-nodemanager\src\test\java\org\apache\hadoop\yarn\server\nodemanager\containermanager\linux\privileged\TestPrivilegedOperationExecutor.java,199,31,6,2,0,39
hadoop-trunk\hadoop-trunk\hadoop-hdfs-project\hadoop-hdfs-rbf\src\main\java\org\apache\hadoop\hdfs\server\federation\router\SubClusterTimeoutException.java,9,3,0,1,0,4
hadoop-trunk\hadoop-trunk\hadoop-cloud-storage-project\hadoop-cos\src\test\java\org\apache\hadoop\fs\cosn\contract\TestCosNContractRootDir.java,0,2,0,1,0,3
hadoop-trunk\hadoop-trunk\hadoop-hdfs-project\hadoop-hdfs-client\src\main\java\org\apache\hadoop\hdfs\protocol\ErasureCodingPolicy.java,0,45,3,1,0,49
hadoop-trunk\hadoop-trunk\hadoop-hdfs-project\hadoop-hdfs-client\src\main\java\org\apache\hadoop\hdfs\protocol\QuotaExceededException.java,27,20,2,2,0,24
hadoop-trunk\hadoop-trunk\hadoop-yarn-project\hadoop-yarn\hadoop-yarn-common\src\main\java\org\apache\hadoop\yarn\security\admin\AdminSecurityInfo.java,33,6,0,2,0,8
hadoop-trunk\hadoop-trunk\hadoop-yarn-project\hadoop-yarn\hadoop-yarn-csi\src\test\java\org\apache\hadoop\yarn\csi\adaptor\package-info.java,0,1,1,1,0,3
hadoop-trunk\hadoop-trunk\hadoop-hdfs-project\hadoop-hdfs\src\test\java\org\apache\hadoop\hdfs\server\datanode\TestBpServiceActorScheduler.java,195,23,7,7,0,37
hadoop-trunk\hadoop-trunk\hadoop-yarn-project\hadoop-yarn\hadoop-yarn-api\src\main\java\org\apache\hadoop\yarn\api\protocolrecords\GetDelegationTokenRequest.java,20,4,0,1,0,5
hadoop-trunk\hadoop-trunk\hadoop-yarn-project\hadoop-yarn\hadoop-yarn-server\hadoop-yarn-server-timelineservice\src\main\java\org\apache\hadoop\yarn\server\timelineservice\collector\package-info.java,0,0,0,1,0,1
hadoop-trunk\hadoop-trunk\hadoop-common-project\hadoop-common\src\main\java\org\apache\hadoop\fs\local\LocalFs.java,20,4,1,1,0,6
hadoop-trunk\hadoop-trunk\hadoop-tools\hadoop-aws\src\main\java\org\apache\hadoop\fs\s3a\ProgressableProgressListener.java,62,18,0,1,0,19
hadoop-trunk\hadoop-trunk\hadoop-common-project\hadoop-common\src\main\java\org\apache\hadoop\security\ssl\FileMonitoringTimerTask.java,75,25,2,5,0,32
hadoop-trunk\hadoop-trunk\hadoop-maven-plugins\src\main\java\org\apache\hadoop\maven\plugin\cmakebuilder\CompileMojo.java,231,33,5,1,0,39
hadoop-trunk\hadoop-trunk\hadoop-yarn-project\hadoop-yarn\hadoop-yarn-common\src\main\java\org\apache\hadoop\yarn\factories\package-info.java,0,1,0,1,0,2
hadoop-trunk\hadoop-trunk\hadoop-common-project\hadoop-common\src\main\java\org\apache\hadoop\metrics2\lib\MutableCounterInt.java,36,12,0,1,0,13
hadoop-trunk\hadoop-trunk\hadoop-hdfs-project\hadoop-hdfs\src\test\java\org\apache\hadoop\hdfs\server\namenode\TestFSImageWithXAttr.java,95,35,0,1,0,36
hadoop-trunk\hadoop-trunk\hadoop-yarn-project\hadoop-yarn\hadoop-yarn-api\src\main\java\org\apache\hadoop\yarn\api\protocolrecords\GetDelegationTokenResponse.java,25,6,0,2,0,8
hadoop-trunk\hadoop-trunk\hadoop-mapreduce-project\hadoop-mapreduce-client\hadoop-mapreduce-client-app\src\test\java\org\apache\hadoop\mapreduce\v2\app\TestTaskHeartbeatHandler.java,218,45,2,1,0,48
hadoop-trunk\hadoop-trunk\hadoop-common-project\hadoop-common\src\test\java\org\apache\hadoop\fs\contract\localfs\TestLocalFSContractGetFileStatus.java,9,2,0,1,0,3
hadoop-trunk\hadoop-trunk\hadoop-tools\hadoop-openstack\src\main\java\org\apache\hadoop\fs\swift\exceptions\SwiftAuthenticationFailedException.java,22,14,0,2,0,16
hadoop-trunk\hadoop-trunk\hadoop-yarn-project\hadoop-yarn\hadoop-yarn-server\hadoop-yarn-server-resourcemanager\src\main\java\org\apache\hadoop\yarn\server\resourcemanager\scheduler\fair\FSQueue.java,0,181,11,3,0,195
hadoop-trunk\hadoop-trunk\hadoop-yarn-project\hadoop-yarn\hadoop-yarn-common\src\main\java\org\apache\hadoop\yarn\api\protocolrecords\impl\pb\GetNodesToAttributesRequestPBImpl.java,0,17,30,2,0,49
hadoop-trunk\hadoop-trunk\hadoop-yarn-project\hadoop-yarn\hadoop-yarn-server\hadoop-yarn-server-timeline-pluginstorage\src\test\java\org\apache\hadoop\yarn\server\timeline\TestEntityGroupFSTimelineStore.java,727,80,6,6,0,92
hadoop-trunk\hadoop-trunk\hadoop-hdfs-project\hadoop-hdfs\src\main\java\org\apache\hadoop\hdfs\server\namenode\ha\ActiveState.java,44,16,1,2,0,19
hadoop-trunk\hadoop-trunk\hadoop-tools\hadoop-aws\src\test\java\org\apache\hadoop\fs\s3a\auth\delegation\ITestSessionDelegationTokens.java,256,14,3,7,0,24
hadoop-trunk\hadoop-trunk\hadoop-tools\hadoop-azure\src\test\java\org\apache\hadoop\fs\azurebfs\contract\ITestAbfsContractUnbuffer.java,49,7,0,1,0,8
hadoop-trunk\hadoop-trunk\hadoop-yarn-project\hadoop-yarn\hadoop-yarn-server\hadoop-yarn-server-common\src\main\java\org\apache\hadoop\yarn\server\federation\store\records\SubClusterHeartbeatRequest.java,109,10,0,1,0,11
hadoop-trunk\hadoop-trunk\hadoop-yarn-project\hadoop-yarn\hadoop-yarn-server\hadoop-yarn-server-resourcemanager\src\main\java\org\apache\hadoop\yarn\server\resourcemanager\reservation\planning\StageExecutionInterval.java,0,0,0,3,0,3
hadoop-trunk\hadoop-trunk\hadoop-mapreduce-project\hadoop-mapreduce-client\hadoop-mapreduce-client-jobclient\src\test\java\org\apache\hadoop\mapreduce\v2\TestMRJobsWithHistoryService.java,137,27,9,2,0,38
hadoop-trunk\hadoop-trunk\hadoop-yarn-project\hadoop-yarn\hadoop-yarn-server\hadoop-yarn-server-resourcemanager\src\main\java\org\apache\hadoop\yarn\server\resourcemanager\scheduler\fair\converter\ConvertedConfigValidator.java,43,4,0,4,0,8
hadoop-trunk\hadoop-trunk\hadoop-tools\hadoop-aws\src\test\java\org\apache\hadoop\fs\s3a\commit\ITestCommitOperations.java,587,44,10,3,0,57
hadoop-trunk\hadoop-trunk\hadoop-tools\hadoop-sls\src\main\java\org\apache\hadoop\yarn\sls\scheduler\CapacitySchedulerMetrics.java,7,2,1,1,0,4
hadoop-trunk\hadoop-trunk\hadoop-mapreduce-project\hadoop-mapreduce-client\hadoop-mapreduce-client-core\src\main\java\org\apache\hadoop\mapreduce\lib\db\DBInputFormat.java,122,96,17,3,0,116
hadoop-trunk\hadoop-trunk\hadoop-common-project\hadoop-common\src\test\java\org\apache\hadoop\security\ssl\TestSSLFactory.java,506,64,28,7,0,99
hadoop-trunk\hadoop-trunk\hadoop-mapreduce-project\hadoop-mapreduce-client\hadoop-mapreduce-client-core\src\main\java\org\apache\hadoop\mapreduce\JobCounter.java,0,28,0,1,0,29
hadoop-trunk\hadoop-trunk\hadoop-common-project\hadoop-common\src\main\java\org\apache\hadoop\util\bloom\BloomFilter.java,158,96,0,14,0,110
hadoop-trunk\hadoop-trunk\hadoop-hdfs-project\hadoop-hdfs\src\main\java\org\apache\hadoop\hdfs\server\namenode\CheckpointConf.java,79,34,2,4,0,40
hadoop-trunk\hadoop-trunk\hadoop-hdfs-project\hadoop-hdfs\src\main\java\org\apache\hadoop\hdfs\server\namenode\FSImageSerialization.java,732,216,3,10,0,229
hadoop-trunk\hadoop-trunk\hadoop-yarn-project\hadoop-yarn\hadoop-yarn-client\src\main\java\org\apache\hadoop\yarn\client\api\async\package-info.java,0,1,0,1,0,2
hadoop-trunk\hadoop-trunk\hadoop-yarn-project\hadoop-yarn\hadoop-yarn-server\hadoop-yarn-server-nodemanager\src\test\java\org\apache\hadoop\yarn\server\nodemanager\TestDirectoryCollection.java,490,142,8,5,0,155
hadoop-trunk\hadoop-trunk\hadoop-yarn-project\hadoop-yarn\hadoop-yarn-server\hadoop-yarn-server-nodemanager\src\main\java\org\apache\hadoop\yarn\server\nodemanager\containermanager\loghandler\LogHandler.java,0,6,2,2,0,10
hadoop-trunk\hadoop-trunk\hadoop-yarn-project\hadoop-yarn\hadoop-yarn-api\src\main\java\org\apache\hadoop\yarn\api\protocolrecords\StartContainerRequest.java,53,14,0,2,0,16
hadoop-trunk\hadoop-trunk\hadoop-tools\hadoop-azure\src\test\java\org\apache\hadoop\fs\azurebfs\ITestSharedKeyAuth.java,32,2,0,4,0,6
hadoop-trunk\hadoop-trunk\hadoop-yarn-project\hadoop-yarn\hadoop-yarn-server\hadoop-yarn-server-resourcemanager\src\test\java\org\apache\hadoop\test\YarnTestDriver.java,34,16,2,2,0,20
hadoop-trunk\hadoop-trunk\hadoop-tools\hadoop-fs2img\src\test\java\org\apache\hadoop\hdfs\server\namenode\TestFixedBlockResolver.java,86,36,12,1,0,49
hadoop-trunk\hadoop-trunk\hadoop-mapreduce-project\hadoop-mapreduce-client\hadoop-mapreduce-client-jobclient\src\test\java\org\apache\hadoop\mapreduce\v2\TestMRJobsWithProfiler.java,228,37,12,1,0,50
hadoop-trunk\hadoop-trunk\hadoop-yarn-project\hadoop-yarn\hadoop-yarn-api\src\main\java\org\apache\hadoop\yarn\util\UnitsConversionUtil.java,214,35,1,1,0,37
hadoop-trunk\hadoop-trunk\hadoop-yarn-project\hadoop-yarn\hadoop-yarn-server\hadoop-yarn-server-timelineservice-documentstore\src\main\java\org\apache\hadoop\yarn\server\timelineservice\documentstore\collection\document\package-info.java,0,0,0,2,0,2
hadoop-trunk\hadoop-trunk\hadoop-hdfs-project\hadoop-hdfs\src\test\java\org\apache\hadoop\hdfs\TestBatchedListDirectories.java,365,71,4,1,0,76
hadoop-trunk\hadoop-trunk\hadoop-common-project\hadoop-common\src\test\java\org\apache\hadoop\net\TestTableMapping.java,152,16,4,2,0,22
hadoop-trunk\hadoop-trunk\hadoop-mapreduce-project\hadoop-mapreduce-client\hadoop-mapreduce-client-hs\src\test\java\org\apache\hadoop\mapreduce\v2\hs\webapp\TestHsWebServicesAttempts.java,612,79,4,4,0,87
hadoop-trunk\hadoop-trunk\hadoop-yarn-project\hadoop-yarn\hadoop-yarn-common\src\main\java\org\apache\hadoop\yarn\webapp\example\HelloWorld.java,21,13,1,1,0,15
hadoop-trunk\hadoop-trunk\hadoop-yarn-project\hadoop-yarn\hadoop-yarn-server\hadoop-yarn-server-nodemanager\src\main\java\org\apache\hadoop\yarn\server\nodemanager\containermanager\resourceplugin\package-info.java,0,1,0,2,0,3
hadoop-trunk\hadoop-trunk\hadoop-yarn-project\hadoop-yarn\hadoop-yarn-server\hadoop-yarn-server-sharedcachemanager\src\main\java\org\apache\hadoop\yarn\server\sharedcachemanager\store\InMemorySCMStore.java,451,57,12,5,0,74
hadoop-trunk\hadoop-trunk\hadoop-cloud-storage-project\hadoop-cos\src\test\java\org\apache\hadoop\fs\cosn\contract\TestCosNContractDelete.java,7,2,0,1,0,3
hadoop-trunk\hadoop-trunk\hadoop-tools\hadoop-azure\src\test\java\org\apache\hadoop\fs\azurebfs\oauth2\RetryTestTokenProvider.java,38,12,2,1,0,15
hadoop-trunk\hadoop-trunk\hadoop-yarn-project\hadoop-yarn\hadoop-yarn-applications\hadoop-yarn-services\hadoop-yarn-services-core\src\main\java\org\apache\hadoop\yarn\service\ServiceMaster.java,290,42,16,4,0,62
hadoop-trunk\hadoop-trunk\hadoop-yarn-project\hadoop-yarn\hadoop-yarn-common\src\test\java\org\apache\hadoop\yarn\logaggregation\filecontroller\ifile\TestLogAggregationIndexedFileController.java,0,52,6,4,0,62
hadoop-trunk\hadoop-trunk\hadoop-hdfs-project\hadoop-hdfs\src\main\java\org\apache\hadoop\hdfs\protocol\BlockListAsLongs.java,530,128,3,3,0,134
hadoop-trunk\hadoop-trunk\hadoop-yarn-project\hadoop-yarn\hadoop-yarn-api\src\main\java\org\apache\hadoop\yarn\api\protocolrecords\GetNodesToLabelsResponse.java,18,4,0,1,0,5
hadoop-trunk\hadoop-trunk\hadoop-mapreduce-project\hadoop-mapreduce-client\hadoop-mapreduce-client-jobclient\src\test\java\org\apache\hadoop\mapreduce\TestMROutputFormat.java,0,44,12,2,0,58
hadoop-trunk\hadoop-trunk\hadoop-common-project\hadoop-common\src\main\java\org\apache\hadoop\security\protocolPB\RefreshUserMappingsProtocolPB.java,0,4,3,3,0,10
hadoop-trunk\hadoop-trunk\hadoop-hdfs-project\hadoop-hdfs\src\test\java\org\apache\hadoop\hdfs\TestFileLengthOnClusterRestart.java,66,38,1,17,0,56
hadoop-trunk\hadoop-trunk\hadoop-hdfs-project\hadoop-hdfs-httpfs\src\test\java\org\apache\hadoop\fs\http\server\TestHttpFSServer.java,0,141,184,8,0,333
hadoop-trunk\hadoop-trunk\hadoop-yarn-project\hadoop-yarn\hadoop-yarn-server\hadoop-yarn-server-resourcemanager\src\main\java\org\apache\hadoop\yarn\server\resourcemanager\volume\csi\event\package-info.java,0,1,0,1,0,2
hadoop-trunk\hadoop-trunk\hadoop-yarn-project\hadoop-yarn\hadoop-yarn-server\hadoop-yarn-server-timelineservice-hbase\hadoop-yarn-server-timelineservice-hbase-server\hadoop-yarn-server-timelineservice-hbase-server-1\src\main\java\org\apache\hadoop\yarn\server\timelineservice\storage\flow\package-info.java,0,0,0,1,0,1
hadoop-trunk\hadoop-trunk\hadoop-yarn-project\hadoop-yarn\hadoop-yarn-server\hadoop-yarn-server-nodemanager\src\test\java\org\apache\hadoop\yarn\server\nodemanager\containermanager\resourceplugin\deviceframework\TestDeviceMappingManager.java,300,51,13,11,0,75
hadoop-trunk\hadoop-trunk\hadoop-tools\hadoop-aws\src\test\java\org\apache\hadoop\fs\s3a\auth\delegation\ITestSessionDelegationInFileystem.java,679,29,13,9,0,51
hadoop-trunk\hadoop-trunk\hadoop-common-project\hadoop-common\src\main\java\org\apache\hadoop\util\RateLimiting.java,0,0,0,1,0,1
hadoop-trunk\hadoop-trunk\hadoop-mapreduce-project\hadoop-mapreduce-client\hadoop-mapreduce-client-common\src\main\java\org\apache\hadoop\mapreduce\v2\api\records\impl\pb\CountersPBImpl.java,161,56,43,5,0,104
hadoop-trunk\hadoop-trunk\hadoop-mapreduce-project\hadoop-mapreduce-client\hadoop-mapreduce-client-core\src\main\java\org\apache\hadoop\mapred\JobInfo.java,0,27,5,1,0,33
hadoop-trunk\hadoop-trunk\hadoop-yarn-project\hadoop-yarn\hadoop-yarn-server\hadoop-yarn-server-resourcemanager\src\test\java\org\apache\hadoop\yarn\server\resourcemanager\recovery\TestZKRMStateStore.java,1508,309,8,17,0,334
hadoop-trunk\hadoop-trunk\hadoop-yarn-project\hadoop-yarn\hadoop-yarn-server\hadoop-yarn-server-common\src\main\java\org\apache\hadoop\yarn\lib\ZKClient.java,100,32,3,1,0,36
hadoop-trunk\hadoop-trunk\hadoop-hdfs-project\hadoop-hdfs\src\test\java\org\apache\hadoop\hdfs\server\namenode\ha\TestMultiObserverNode.java,124,26,0,2,0,28
hadoop-trunk\hadoop-trunk\hadoop-common-project\hadoop-common\src\main\java\org\apache\hadoop\metrics2\MetricsPlugin.java,0,2,0,1,0,3
hadoop-trunk\hadoop-trunk\hadoop-hdfs-project\hadoop-hdfs\src\test\java\org\apache\hadoop\hdfs\server\datanode\fsdataset\impl\TestFsVolumeList.java,656,131,4,16,0,151
hadoop-trunk\hadoop-trunk\hadoop-common-project\hadoop-common\src\main\java\org\apache\hadoop\fs\AbstractFileSystem.java,1355,300,22,6,0,328
hadoop-trunk\hadoop-trunk\hadoop-common-project\hadoop-common\src\main\java\org\apache\hadoop\security\Credentials.java,403,81,17,2,0,100
hadoop-trunk\hadoop-trunk\hadoop-yarn-project\hadoop-yarn\hadoop-yarn-common\src\main\java\org\apache\hadoop\yarn\server\api\protocolrecords\impl\pb\RefreshNodesRequestPBImpl.java,102,31,40,5,0,76
hadoop-trunk\hadoop-trunk\hadoop-yarn-project\hadoop-yarn\hadoop-yarn-server\hadoop-yarn-server-resourcemanager\src\main\java\org\apache\hadoop\yarn\server\resourcemanager\monitor\capacity\IntraQueuePreemptionComputePlugin.java,0,0,0,2,0,2
hadoop-trunk\hadoop-trunk\hadoop-tools\hadoop-dynamometer\hadoop-dynamometer-infra\src\main\java\org\apache\hadoop\tools\dynamometer\SimulatedDataNodes.java,121,11,9,2,0,22
hadoop-trunk\hadoop-trunk\hadoop-tools\hadoop-aws\src\test\java\org\apache\hadoop\fs\s3a\ITestS3AClientSideEncryption.java,253,9,4,4,0,17
hadoop-trunk\hadoop-trunk\hadoop-common-project\hadoop-common\src\main\java\org\apache\hadoop\ipc\metrics\RpcDetailedMetrics.java,55,30,1,1,0,32
hadoop-trunk\hadoop-trunk\hadoop-tools\hadoop-azure\src\main\java\org\apache\hadoop\fs\azurebfs\utils\CachedSASToken.java,0,23,3,10,0,36
hadoop-trunk\hadoop-trunk\hadoop-hdfs-project\hadoop-hdfs-client\src\main\java\org\apache\hadoop\hdfs\web\resources\PostOpParam.java,0,15,1,1,0,17
hadoop-trunk\hadoop-trunk\hadoop-yarn-project\hadoop-yarn\hadoop-yarn-server\hadoop-yarn-server-nodemanager\src\main\java\org\apache\hadoop\yarn\server\nodemanager\containermanager\AuxServicesEvent.java,54,46,2,1,0,49
hadoop-trunk\hadoop-trunk\hadoop-yarn-project\hadoop-yarn\hadoop-yarn-server\hadoop-yarn-server-resourcemanager\src\main\java\org\apache\hadoop\yarn\server\resourcemanager\scheduler\ContainerUpdateContext.java,333,47,0,3,0,50
hadoop-trunk\hadoop-trunk\hadoop-yarn-project\hadoop-yarn\hadoop-yarn-server\hadoop-yarn-server-nodemanager\src\test\java\org\apache\hadoop\yarn\server\nodemanager\util\TestProcessIdFileReader.java,79,26,9,1,0,36
hadoop-trunk\hadoop-trunk\hadoop-hdfs-project\hadoop-hdfs\src\test\java\org\apache\hadoop\hdfs\server\datanode\fsdataset\impl\TestReplicaCachingGetSpaceUsed.java,0,26,4,2,0,32
hadoop-trunk\hadoop-trunk\hadoop-mapreduce-project\hadoop-mapreduce-client\hadoop-mapreduce-client-core\src\main\java\org\apache\hadoop\mapreduce\checkpoint\EnumCounter.java,0,5,0,1,0,6
hadoop-trunk\hadoop-trunk\hadoop-yarn-project\hadoop-yarn\hadoop-yarn-server\hadoop-yarn-server-resourcemanager\src\main\java\org\apache\hadoop\yarn\server\resourcemanager\webapp\dao\ResourcesInfo.java,51,18,1,1,0,20
hadoop-trunk\hadoop-trunk\hadoop-hdfs-project\hadoop-hdfs\src\test\java\org\apache\hadoop\fs\TestSymlinkHdfs.java,0,99,11,2,0,112
hadoop-trunk\hadoop-trunk\hadoop-hdfs-project\hadoop-hdfs\src\main\java\org\apache\hadoop\hdfs\server\namenode\DfsServlet.java,13,5,0,1,0,6
hadoop-trunk\hadoop-trunk\hadoop-yarn-project\hadoop-yarn\hadoop-yarn-api\src\main\java\org\apache\hadoop\yarn\conf\YarnConfiguration.java,4877,1120,7,53,0,1180
hadoop-trunk\hadoop-trunk\hadoop-yarn-project\hadoop-yarn\hadoop-yarn-common\src\test\java\org\apache\hadoop\yarn\api\records\impl\pb\TestProtoUtils.java,20,2,7,1,0,10
hadoop-trunk\hadoop-trunk\hadoop-yarn-project\hadoop-yarn\hadoop-yarn-server\hadoop-yarn-server-timelineservice-hbase-tests\src\test\java\org\apache\hadoop\yarn\server\timelineservice\storage\flow\TestFlowDataGenerator.java,0,94,0,1,0,95
hadoop-trunk\hadoop-trunk\hadoop-common-project\hadoop-common\src\test\java\org\apache\hadoop\test\AbstractHadoopTestBase.java,74,1,0,1,0,2
hadoop-trunk\hadoop-trunk\hadoop-yarn-project\hadoop-yarn\hadoop-yarn-server\hadoop-yarn-server-timelineservice\src\main\java\org\apache\hadoop\yarn\server\timelineservice\reader\TimelineFromIdConverter.java,0,20,0,1,0,21
hadoop-trunk\hadoop-trunk\hadoop-common-project\hadoop-common\src\main\java\org\apache\hadoop\fs\viewfs\ViewFsLocatedFileStatus.java,0,9,3,1,0,13
hadoop-trunk\hadoop-trunk\hadoop-mapreduce-project\hadoop-mapreduce-client\hadoop-mapreduce-client-core\src\main\java\org\apache\hadoop\mapred\TaskAttemptID.java,0,89,3,2,0,94
hadoop-trunk\hadoop-trunk\hadoop-yarn-project\hadoop-yarn\hadoop-yarn-api\src\main\java\org\apache\hadoop\yarn\api\records\ReservationRequests.java,60,12,0,2,0,14
hadoop-trunk\hadoop-trunk\hadoop-hdfs-project\hadoop-hdfs\src\test\java\org\apache\hadoop\hdfs\server\blockmanagement\TestDatanodeAdminMonitorBase.java,61,9,0,4,0,13
hadoop-trunk\hadoop-trunk\hadoop-hdfs-project\hadoop-hdfs\src\main\java\org\apache\hadoop\hdfs\server\namenode\INodeDirectory.java,0,247,6,9,0,262
hadoop-trunk\hadoop-trunk\hadoop-mapreduce-project\hadoop-mapreduce-client\hadoop-mapreduce-client-core\src\main\java\org\apache\hadoop\mapred\QueueAclsInfo.java,0,10,2,1,0,13
hadoop-trunk\hadoop-trunk\hadoop-common-project\hadoop-common\src\main\java\org\apache\hadoop\security\UserGroupInformation.java,2168,334,41,15,0,390
hadoop-trunk\hadoop-trunk\hadoop-tools\hadoop-azure-datalake\src\test\java\org\apache\hadoop\fs\adl\live\TestAdlDifferentSizeWritesLive.java,78,51,1,1,0,53
hadoop-trunk\hadoop-trunk\hadoop-yarn-project\hadoop-yarn\hadoop-yarn-server\hadoop-yarn-server-resourcemanager\src\main\java\org\apache\hadoop\yarn\server\resourcemanager\security\package-info.java,0,0,0,1,0,1
hadoop-trunk\hadoop-trunk\hadoop-yarn-project\hadoop-yarn\hadoop-yarn-common\src\main\java\org\apache\hadoop\yarn\api\protocolrecords\impl\pb\KillApplicationRequestPBImpl.java,117,40,43,4,0,87
hadoop-trunk\hadoop-trunk\hadoop-yarn-project\hadoop-yarn\hadoop-yarn-server\hadoop-yarn-server-resourcemanager\src\main\java\org\apache\hadoop\yarn\server\resourcemanager\scheduler\common\fica\FiCaSchedulerNode.java,138,50,1,3,0,54
hadoop-trunk\hadoop-trunk\hadoop-hdfs-project\hadoop-hdfs\src\main\java\org\apache\hadoop\hdfs\server\common\DataNodeLockManager.java,0,13,0,1,0,14
hadoop-trunk\hadoop-trunk\hadoop-yarn-project\hadoop-yarn\hadoop-yarn-server\hadoop-yarn-server-resourcemanager\src\main\java\org\apache\hadoop\yarn\server\resourcemanager\scheduler\capacity\preemption\KillableContainer.java,24,21,0,3,0,24
hadoop-trunk\hadoop-trunk\hadoop-yarn-project\hadoop-yarn\hadoop-yarn-server\hadoop-yarn-server-resourcemanager\src\main\java\org\apache\hadoop\yarn\server\resourcemanager\scheduler\capacity\CapacitySchedulerContext.java,0,25,0,7,0,32
hadoop-trunk\hadoop-trunk\hadoop-hdfs-project\hadoop-hdfs\src\test\java\org\apache\hadoop\hdfs\server\datanode\TestBlockRecovery2.java,373,45,5,3,0,53
hadoop-trunk\hadoop-trunk\hadoop-hdfs-project\hadoop-hdfs-client\src\main\java\org\apache\hadoop\hdfs\protocol\SnapshotStatus.java,175,40,2,1,0,43
hadoop-trunk\hadoop-trunk\hadoop-hdfs-project\hadoop-hdfs\src\test\java\org\apache\hadoop\hdfs\web\TestWebHDFSForHA.java,268,19,6,7,0,32
hadoop-trunk\hadoop-trunk\hadoop-tools\hadoop-aws\src\main\java\org\apache\hadoop\fs\s3a\audit\AWSAuditEventCallbacks.java,0,0,5,1,0,6
hadoop-trunk\hadoop-trunk\hadoop-yarn-project\hadoop-yarn\hadoop-yarn-server\hadoop-yarn-server-resourcemanager\src\main\java\org\apache\hadoop\yarn\server\resourcemanager\webapp\dao\CapacitySchedulerQueueInfoList.java,20,14,2,1,0,17
hadoop-trunk\hadoop-trunk\hadoop-hdfs-project\hadoop-hdfs-rbf\src\main\java\org\apache\hadoop\hdfs\server\federation\store\protocol\RemoveMountTableEntryResponse.java,15,4,0,2,0,6
hadoop-trunk\hadoop-trunk\hadoop-tools\hadoop-aws\src\main\java\org\apache\hadoop\fs\s3a\S3ListResult.java,121,17,2,1,0,20
hadoop-trunk\hadoop-trunk\hadoop-common-project\hadoop-registry\src\main\java\org\apache\hadoop\registry\client\exceptions\RegistryIOException.java,27,12,0,1,0,13
hadoop-trunk\hadoop-trunk\hadoop-mapreduce-project\hadoop-mapreduce-client\hadoop-mapreduce-client-app\src\main\java\org\apache\hadoop\mapred\LocalContainerLauncher.java,581,93,34,6,0,133
hadoop-trunk\hadoop-trunk\hadoop-mapreduce-project\hadoop-mapreduce-client\hadoop-mapreduce-client-hs\src\main\java\org\apache\hadoop\mapreduce\v2\hs\webapp\HsNavBlock.java,48,12,1,2,0,15
hadoop-trunk\hadoop-trunk\hadoop-yarn-project\hadoop-yarn\hadoop-yarn-server\hadoop-yarn-server-timelineservice-documentstore\src\main\java\org\apache\hadoop\yarn\server\timelineservice\documentstore\writer\DocumentStoreWriter.java,0,6,1,3,0,10
hadoop-trunk\hadoop-trunk\hadoop-yarn-project\hadoop-yarn\hadoop-yarn-server\hadoop-yarn-server-timelineservice-hbase\hadoop-yarn-server-timelineservice-hbase-client\src\main\java\org\apache\hadoop\yarn\server\timelineservice\storage\reader\GenericEntityReader.java,0,44,9,20,0,73
hadoop-trunk\hadoop-trunk\hadoop-common-project\hadoop-common\src\main\java\org\apache\hadoop\util\IdentityHashStore.java,0,38,1,1,0,40
hadoop-trunk\hadoop-trunk\hadoop-common-project\hadoop-common\src\main\java\org\apache\hadoop\fs\shell\FsUsage.java,0,115,5,2,0,122
hadoop-trunk\hadoop-trunk\hadoop-common-project\hadoop-common\src\test\java\org\apache\hadoop\ha\TestZKFailoverController.java,654,83,2,2,0,87
hadoop-trunk\hadoop-trunk\hadoop-common-project\hadoop-common\src\main\java\org\apache\hadoop\util\BasicDiskValidator.java,9,3,0,1,0,4
hadoop-trunk\hadoop-trunk\hadoop-hdfs-project\hadoop-hdfs\src\test\java\org\apache\hadoop\hdfs\qjournal\server\JournalTestUtil.java,27,11,1,1,0,13
hadoop-trunk\hadoop-trunk\hadoop-yarn-project\hadoop-yarn\hadoop-yarn-server\hadoop-yarn-server-timelineservice-documentstore\src\main\java\org\apache\hadoop\yarn\server\timelineservice\documentstore\writer\TimelineCollectionWriter.java,103,29,3,6,0,38
hadoop-trunk\hadoop-trunk\hadoop-common-project\hadoop-common\src\main\java\org\apache\hadoop\fs\shell\package-info.java,0,1,0,1,0,2
hadoop-trunk\hadoop-trunk\hadoop-common-project\hadoop-common\src\main\java\org\apache\hadoop\io\compress\zstd\package-info.java,0,1,0,1,0,2
hadoop-trunk\hadoop-trunk\hadoop-tools\hadoop-azure\src\main\java\org\apache\hadoop\fs\azurebfs\utils\package-info.java,0,2,0,1,0,3
hadoop-trunk\hadoop-trunk\hadoop-tools\hadoop-azure\src\test\java\org\apache\hadoop\fs\azurebfs\extensions\ClassicDelegationTokenManager.java,0,52,11,8,0,71
hadoop-trunk\hadoop-trunk\hadoop-yarn-project\hadoop-yarn\hadoop-yarn-server\hadoop-yarn-server-nodemanager\src\main\java\org\apache\hadoop\yarn\server\nodemanager\NodeStatusUpdaterImpl.java,1418,170,47,23,0,240
hadoop-trunk\hadoop-trunk\hadoop-yarn-project\hadoop-yarn\hadoop-yarn-server\hadoop-yarn-server-resourcemanager\src\test\java\org\apache\hadoop\yarn\server\resourcemanager\scheduler\policy\TestFifoOrderingPolicyWithExclusivePartitions.java,213,34,1,1,0,36
hadoop-trunk\hadoop-trunk\hadoop-yarn-project\hadoop-yarn\hadoop-yarn-server\hadoop-yarn-server-resourcemanager\src\main\java\org\apache\hadoop\yarn\server\resourcemanager\rmnode\RMNodeStartedEvent.java,39,24,0,1,0,25
hadoop-trunk\hadoop-trunk\hadoop-tools\hadoop-azure\src\main\java\org\apache\hadoop\fs\azurebfs\AbfsCountersImpl.java,202,18,1,3,0,22
hadoop-trunk\hadoop-trunk\hadoop-hdfs-project\hadoop-hdfs-client\src\main\java\org\apache\hadoop\hdfs\web\resources\CreateParentParam.java,30,2,0,1,0,3
hadoop-trunk\hadoop-trunk\hadoop-tools\hadoop-azure\src\main\java\org\apache\hadoop\fs\azure\SelfThrottlingIntercept.java,133,52,8,17,0,77
hadoop-trunk\hadoop-trunk\hadoop-yarn-project\hadoop-yarn\hadoop-yarn-server\hadoop-yarn-server-resourcemanager\src\test\java\org\apache\hadoop\yarn\server\resourcemanager\scheduler\capacity\TestReservations.java,1511,504,117,47,0,668
hadoop-trunk\hadoop-trunk\hadoop-yarn-project\hadoop-yarn\hadoop-yarn-server\hadoop-yarn-server-resourcemanager\src\main\java\org\apache\hadoop\yarn\server\resourcemanager\scheduler\constraint\api\SchedulingResponse.java,45,9,0,1,0,10
hadoop-trunk\hadoop-trunk\hadoop-yarn-project\hadoop-yarn\hadoop-yarn-server\hadoop-yarn-server-common\src\test\java\org\apache\hadoop\yarn\server\federation\policies\router\TestLoadBasedRouterPolicy.java,99,15,1,2,0,18
hadoop-trunk\hadoop-trunk\hadoop-hdfs-project\hadoop-hdfs\src\test\java\org\apache\hadoop\hdfs\TestHFlush.java,465,123,19,24,0,166
hadoop-trunk\hadoop-trunk\hadoop-mapreduce-project\hadoop-mapreduce-client\hadoop-mapreduce-client-core\src\main\java\org\apache\hadoop\mapred\Mapper.java,0,63,6,8,0,77
hadoop-trunk\hadoop-trunk\hadoop-client-modules\hadoop-client-integration-tests\src\test\java\org\apache\hadoop\example\ITUseMiniCluster.java,74,15,38,1,0,54
hadoop-trunk\hadoop-trunk\hadoop-common-project\hadoop-common\src\main\java\org\apache\hadoop\fs\RawPathHandle.java,0,9,2,1,0,12
hadoop-trunk\hadoop-trunk\hadoop-common-project\hadoop-common\src\test\java\org\apache\hadoop\util\TestJarFinder.java,89,6,3,1,0,10
hadoop-trunk\hadoop-trunk\hadoop-yarn-project\hadoop-yarn\hadoop-yarn-server\hadoop-yarn-server-common\src\main\java\org\apache\hadoop\yarn\server\webapp\dao\ContainerLogsInfo.java,43,23,1,1,0,25
hadoop-trunk\hadoop-trunk\hadoop-common-project\hadoop-common\src\test\java\org\apache\hadoop\ha\ActiveStandbyElectorTestUtil.java,53,18,1,1,0,20
hadoop-trunk\hadoop-trunk\hadoop-yarn-project\hadoop-yarn\hadoop-yarn-server\hadoop-yarn-server-applicationhistoryservice\src\main\java\org\apache\hadoop\yarn\server\applicationhistoryservice\records\ApplicationHistoryData.java,182,90,0,1,0,91
hadoop-trunk\hadoop-trunk\hadoop-yarn-project\hadoop-yarn\hadoop-yarn-server\hadoop-yarn-server-nodemanager\src\main\java\org\apache\hadoop\yarn\server\nodemanager\health\NodeHealthScriptRunner.java,241,27,2,1,0,30
hadoop-trunk\hadoop-trunk\hadoop-tools\hadoop-azure\src\test\java\org\apache\hadoop\fs\azure\ITestContainerChecks.java,147,11,3,1,0,15
hadoop-trunk\hadoop-trunk\hadoop-tools\hadoop-openstack\src\main\java\org\apache\hadoop\fs\swift\util\DurationStatsTable.java,50,11,0,3,0,14
hadoop-trunk\hadoop-trunk\hadoop-common-project\hadoop-common\src\main\java\org\apache\hadoop\fs\HarFs.java,0,1,0,1,0,2
hadoop-trunk\hadoop-trunk\hadoop-mapreduce-project\hadoop-mapreduce-client\hadoop-mapreduce-client-app\src\main\java\org\apache\hadoop\mapreduce\v2\app\job\event\JobTaskEvent.java,20,11,0,1,0,12
hadoop-trunk\hadoop-trunk\hadoop-common-project\hadoop-common\src\main\java\org\apache\hadoop\util\bloom\HashFunction.java,0,36,2,2,0,40
hadoop-trunk\hadoop-trunk\hadoop-tools\hadoop-openstack\src\test\java\org\apache\hadoop\fs\swift\TestSwiftFileSystemBasicOps.java,251,25,9,2,0,36
hadoop-trunk\hadoop-trunk\hadoop-yarn-project\hadoop-yarn\hadoop-yarn-common\src\main\java\org\apache\hadoop\yarn\logaggregation\ContainerLogAggregationType.java,0,0,0,1,0,1
hadoop-trunk\hadoop-trunk\hadoop-common-project\hadoop-common\src\main\java\org\apache\hadoop\fs\StorageType.java,0,35,0,1,0,36
hadoop-trunk\hadoop-trunk\hadoop-yarn-project\hadoop-yarn\hadoop-yarn-server\hadoop-yarn-server-common\src\main\java\org\apache\hadoop\yarn\server\volume\csi\VolumeCapabilityRange.java,0,28,0,2,0,30
hadoop-trunk\hadoop-trunk\hadoop-mapreduce-project\hadoop-mapreduce-client\hadoop-mapreduce-client-jobclient\src\test\java\testjar\UserNamePermission.java,0,47,3,1,0,51
hadoop-trunk\hadoop-trunk\hadoop-hdfs-project\hadoop-hdfs\src\main\java\org\apache\hadoop\hdfs\qjournal\protocol\InterQJournalProtocol.java,0,5,2,2,0,9
hadoop-trunk\hadoop-trunk\hadoop-yarn-project\hadoop-yarn\hadoop-yarn-server\hadoop-yarn-server-common\src\main\java\org\apache\hadoop\yarn\server\webapp\dao\AppAttemptsInfo.java,19,8,3,1,0,12
hadoop-trunk\hadoop-trunk\hadoop-yarn-project\hadoop-yarn\hadoop-yarn-server\hadoop-yarn-server-resourcemanager\src\main\java\org\apache\hadoop\yarn\server\resourcemanager\scheduler\placement\MultiNodeSorter.java,0,24,8,3,0,35
hadoop-trunk\hadoop-trunk\hadoop-common-project\hadoop-common\src\main\java\org\apache\hadoop\util\DiskChecker.java,332,56,6,1,0,63
hadoop-trunk\hadoop-trunk\hadoop-common-project\hadoop-common\src\test\java\org\apache\hadoop\fs\shell\find\TestFilterExpression.java,119,21,2,1,0,24
hadoop-trunk\hadoop-trunk\hadoop-hdfs-project\hadoop-hdfs\src\main\java\org\apache\hadoop\hdfs\server\namenode\FileUnderConstructionFeature.java,0,19,1,2,0,22
hadoop-trunk\hadoop-trunk\hadoop-tools\hadoop-streaming\src\main\java\org\apache\hadoop\streaming\io\KeyOnlyTextInputWriter.java,13,5,1,1,0,7
hadoop-trunk\hadoop-trunk\hadoop-yarn-project\hadoop-yarn\hadoop-yarn-server\hadoop-yarn-server-nodemanager\src\main\java\org\apache\hadoop\yarn\server\nodemanager\webapp\dao\AppsInfo.java,17,8,4,1,0,13
hadoop-trunk\hadoop-trunk\hadoop-common-project\hadoop-common\src\main\java\org\apache\hadoop\util\functional\package-info.java,0,1,0,1,0,2
hadoop-trunk\hadoop-trunk\hadoop-common-project\hadoop-common\src\test\java\org\apache\hadoop\fs\contract\AbstractContractPathHandleTest.java,0,24,1,3,0,28
hadoop-trunk\hadoop-trunk\hadoop-yarn-project\hadoop-yarn\hadoop-yarn-server\hadoop-yarn-server-applicationhistoryservice\src\test\java\org\apache\hadoop\yarn\server\applicationhistoryservice\TestApplicationHistoryManagerImpl.java,61,12,3,1,0,16
hadoop-trunk\hadoop-trunk\hadoop-hdfs-project\hadoop-hdfs\src\test\java\org\apache\hadoop\hdfs\server\namenode\TestMetaSave.java,268,44,35,4,0,83
hadoop-trunk\hadoop-trunk\hadoop-yarn-project\hadoop-yarn\hadoop-yarn-server\hadoop-yarn-server-nodemanager\src\main\java\org\apache\hadoop\yarn\server\nodemanager\NodeManagerMXBean.java,0,0,0,1,0,1
hadoop-trunk\hadoop-trunk\hadoop-mapreduce-project\hadoop-mapreduce-client\hadoop-mapreduce-client-core\src\main\java\org\apache\hadoop\mapreduce\task\reduce\IFileWrappedMapOutput.java,0,15,0,1,0,16
hadoop-trunk\hadoop-trunk\hadoop-hdfs-project\hadoop-hdfs-client\src\main\java\org\apache\hadoop\hdfs\RemotePeerFactory.java,0,0,0,1,0,1
hadoop-trunk\hadoop-trunk\hadoop-yarn-project\hadoop-yarn\hadoop-yarn-client\src\test\java\org\apache\hadoop\yarn\client\TestFederationRMFailoverProxyProvider.java,237,26,1,7,0,34
hadoop-trunk\hadoop-trunk\hadoop-mapreduce-project\hadoop-mapreduce-client\hadoop-mapreduce-client-core\src\main\java\org\apache\hadoop\mapreduce\task\annotation\Checkpointable.java,0,1,0,1,0,2
hadoop-trunk\hadoop-trunk\hadoop-hdfs-project\hadoop-hdfs-rbf\src\test\java\org\apache\hadoop\hdfs\server\federation\router\TestRouterUserMappings.java,343,60,12,2,0,74
hadoop-trunk\hadoop-trunk\hadoop-common-project\hadoop-common\src\test\java\org\apache\hadoop\service\launcher\testservices\FailInConstructorService.java,11,3,0,2,0,5
hadoop-trunk\hadoop-trunk\hadoop-yarn-project\hadoop-yarn\hadoop-yarn-server\hadoop-yarn-server-resourcemanager\src\main\java\org\apache\hadoop\yarn\server\resourcemanager\ahs\WritingHistoryEventType.java,0,7,0,1,0,8
hadoop-trunk\hadoop-trunk\hadoop-yarn-project\hadoop-yarn\hadoop-yarn-server\hadoop-yarn-server-applicationhistoryservice\src\main\java\org\apache\hadoop\yarn\server\applicationhistoryservice\records\impl\pb\ApplicationStartDataPBImpl.java,201,44,65,4,0,113
hadoop-trunk\hadoop-trunk\hadoop-tools\hadoop-azure\src\main\java\org\apache\hadoop\fs\azurebfs\constants\FileSystemConfigurations.java,0,78,0,16,0,94
hadoop-trunk\hadoop-trunk\hadoop-yarn-project\hadoop-yarn\hadoop-yarn-server\hadoop-yarn-server-resourcemanager\src\main\java\org\apache\hadoop\yarn\server\resourcemanager\reservation\NoOverCommitPolicy.java,50,13,0,3,0,16
hadoop-trunk\hadoop-trunk\hadoop-hdfs-project\hadoop-hdfs\src\test\java\org\apache\hadoop\hdfs\server\datanode\fsdataset\impl\TestAddBlockPoolException.java,48,4,0,1,0,5
hadoop-trunk\hadoop-trunk\hadoop-hdfs-project\hadoop-hdfs\src\test\java\org\apache\hadoop\hdfs\util\TestCombinedHostsFileReader.java,58,12,2,1,0,15
hadoop-trunk\hadoop-trunk\hadoop-yarn-project\hadoop-yarn\hadoop-yarn-server\hadoop-yarn-server-timelineservice\src\main\java\org\apache\hadoop\yarn\server\timelineservice\reader\TimelineReaderWebServices.java,3602,691,54,7,0,752
hadoop-trunk\hadoop-trunk\hadoop-tools\hadoop-aws\src\main\java\org\apache\hadoop\fs\s3a\auth\delegation\EncryptionSecrets.java,0,12,1,1,0,14
hadoop-trunk\hadoop-trunk\hadoop-yarn-project\hadoop-yarn\hadoop-yarn-common\src\test\java\org\apache\hadoop\yarn\nodelabels\DummyCommonNodeLabelsManager.java,65,21,3,2,0,26
hadoop-trunk\hadoop-trunk\hadoop-tools\hadoop-azure\src\main\java\org\apache\hadoop\fs\azurebfs\contracts\exceptions\TokenAccessProviderException.java,12,6,0,2,0,8
hadoop-trunk\hadoop-trunk\hadoop-common-project\hadoop-common\src\main\java\org\apache\hadoop\io\serializer\JavaSerializationComparator.java,0,7,0,1,0,8
hadoop-trunk\hadoop-trunk\hadoop-common-project\hadoop-common\src\main\java\org\apache\hadoop\io\FloatWritable.java,0,33,2,1,0,36
hadoop-trunk\hadoop-trunk\hadoop-mapreduce-project\hadoop-mapreduce-client\hadoop-mapreduce-client-core\src\main\java\org\apache\hadoop\mapreduce\ReduceContext.java,0,15,6,1,0,22
hadoop-trunk\hadoop-trunk\hadoop-yarn-project\hadoop-yarn\hadoop-yarn-server\hadoop-yarn-server-nodemanager\src\main\java\org\apache\hadoop\yarn\server\nodemanager\webapp\dao\gpu\PerGpuUtilizations.java,18,8,0,2,0,10
hadoop-trunk\hadoop-trunk\hadoop-common-project\hadoop-common\src\test\java\org\apache\hadoop\fs\contract\AbstractContractCreateTest.java,542,77,2,7,0,86
hadoop-trunk\hadoop-trunk\hadoop-common-project\hadoop-nfs\src\main\java\org\apache\hadoop\nfs\NfsExports.java,369,131,1,3,0,135
hadoop-trunk\hadoop-trunk\hadoop-mapreduce-project\hadoop-mapreduce-client\hadoop-mapreduce-client-core\src\test\java\org\apache\hadoop\mapreduce\TestTaskID.java,436,9,27,1,0,37
hadoop-trunk\hadoop-trunk\hadoop-hdfs-project\hadoop-hdfs\src\test\java\org\apache\hadoop\hdfs\TestListFilesInDFS.java,25,5,0,1,0,6
hadoop-trunk\hadoop-trunk\hadoop-hdfs-project\hadoop-hdfs\src\main\java\org\apache\hadoop\hdfs\protocol\datatransfer\package-info.java,0,0,0,1,0,1
hadoop-trunk\hadoop-trunk\hadoop-tools\hadoop-rumen\src\main\java\org\apache\hadoop\tools\rumen\datatypes\NodeName.java,149,59,4,1,0,64
hadoop-trunk\hadoop-trunk\hadoop-mapreduce-project\hadoop-mapreduce-client\hadoop-mapreduce-client-common\src\main\java\org\apache\hadoop\mapreduce\v2\api\records\JobReport.java,0,108,36,1,0,145
hadoop-trunk\hadoop-trunk\hadoop-mapreduce-project\hadoop-mapreduce-client\hadoop-mapreduce-client-core\src\test\java\org\apache\hadoop\mapreduce\TestJob.java,76,11,9,1,0,21
hadoop-trunk\hadoop-trunk\hadoop-tools\hadoop-azure\src\main\java\org\apache\hadoop\fs\azurebfs\contracts\exceptions\InvalidConfigurationValueException.java,10,9,0,4,0,13
hadoop-trunk\hadoop-trunk\hadoop-common-project\hadoop-common\src\test\java\org\apache\hadoop\util\TestReflectionUtils.java,177,59,17,5,0,81
hadoop-trunk\hadoop-trunk\hadoop-yarn-project\hadoop-yarn\hadoop-yarn-server\hadoop-yarn-server-nodemanager\src\main\java\org\apache\hadoop\yarn\server\nodemanager\containermanager\container\UpdateContainerTokenEvent.java,62,13,0,1,0,14
hadoop-trunk\hadoop-trunk\hadoop-mapreduce-project\hadoop-mapreduce-client\hadoop-mapreduce-client-jobclient\src\test\java\org\apache\hadoop\fs\TestJHLA.java,112,76,9,62,0,147
hadoop-trunk\hadoop-trunk\hadoop-hdfs-project\hadoop-hdfs\src\main\java\org\apache\hadoop\hdfs\server\common\blockaliasmap\impl\LevelDBFileRegionAliasMap.java,0,46,1,5,0,52
hadoop-trunk\hadoop-trunk\hadoop-hdfs-project\hadoop-hdfs-rbf\src\main\java\org\apache\hadoop\hdfs\server\federation\router\RouterStoragePolicy.java,75,17,0,1,0,18
hadoop-trunk\hadoop-trunk\hadoop-yarn-project\hadoop-yarn\hadoop-yarn-server\hadoop-yarn-server-resourcemanager\src\main\java\org\apache\hadoop\yarn\server\resourcemanager\rmapp\RMAppFailedAttemptEvent.java,15,10,0,1,0,11
hadoop-trunk\hadoop-trunk\hadoop-tools\hadoop-azure\src\test\java\org\apache\hadoop\fs\azure\ITestNativeAzureFSPageBlobLive.java,17,3,0,3,0,6
hadoop-trunk\hadoop-trunk\hadoop-yarn-project\hadoop-yarn\hadoop-yarn-common\src\main\java\org\apache\hadoop\yarn\api\protocolrecords\impl\pb\GetAllResourceProfilesResponsePBImpl.java,0,16,37,4,0,57
hadoop-trunk\hadoop-trunk\hadoop-hdfs-project\hadoop-hdfs-client\src\main\java\org\apache\hadoop\hdfs\client\package-info.java,0,1,0,1,0,2
hadoop-trunk\hadoop-trunk\hadoop-mapreduce-project\hadoop-mapreduce-client\hadoop-mapreduce-client-core\src\main\java\org\apache\hadoop\mapred\InvalidFileTypeException.java,0,5,0,1,0,6
hadoop-trunk\hadoop-trunk\hadoop-yarn-project\hadoop-yarn\hadoop-yarn-server\hadoop-yarn-server-timelineservice\src\main\java\org\apache\hadoop\yarn\server\timelineservice\reader\TimelineParseException.java,0,3,0,1,0,4
hadoop-trunk\hadoop-trunk\hadoop-mapreduce-project\hadoop-mapreduce-client\hadoop-mapreduce-client-common\src\main\java\org\apache\hadoop\mapreduce\v2\api\protocolrecords\impl\pb\GetTaskReportRequestPBImpl.java,79,34,33,5,0,72
hadoop-trunk\hadoop-trunk\hadoop-hdfs-project\hadoop-hdfs\src\main\java\org\apache\hadoop\hdfs\protocol\CacheDirective.java,0,64,3,3,0,70
hadoop-trunk\hadoop-trunk\hadoop-tools\hadoop-azure\src\test\java\org\apache\hadoop\fs\azurebfs\contract\AbfsFileSystemContract.java,34,7,0,1,0,8
hadoop-trunk\hadoop-trunk\hadoop-tools\hadoop-federation-balance\src\test\java\org\apache\hadoop\tools\fedbalance\procedure\UnrecoverableProcedure.java,29,13,2,1,0,16
hadoop-trunk\hadoop-trunk\hadoop-yarn-project\hadoop-yarn\hadoop-yarn-server\hadoop-yarn-server-resourcemanager\src\main\java\org\apache\hadoop\yarn\server\resourcemanager\webapp\dao\ResourceInformationsInfo.java,18,8,4,1,0,13
hadoop-trunk\hadoop-trunk\hadoop-common-project\hadoop-common\src\main\java\org\apache\hadoop\fs\viewfs\RegexMountPoint.java,0,30,7,1,0,38
hadoop-trunk\hadoop-trunk\hadoop-common-project\hadoop-common\src\test\java\org\apache\hadoop\metrics2\impl\TestGraphiteMetrics.java,171,42,14,13,0,69
hadoop-trunk\hadoop-trunk\hadoop-hdfs-project\hadoop-hdfs-client\src\main\java\org\apache\hadoop\hdfs\protocol\BlockChecksumOptions.java,29,15,0,1,0,16
hadoop-trunk\hadoop-trunk\hadoop-yarn-project\hadoop-yarn\hadoop-yarn-server\hadoop-yarn-server-timelineservice\src\test\java\org\apache\hadoop\yarn\server\timelineservice\collector\TestAppLevelTimelineCollector.java,3,1,0,1,0,2
hadoop-trunk\hadoop-trunk\hadoop-yarn-project\hadoop-yarn\hadoop-yarn-applications\hadoop-yarn-services\hadoop-yarn-services-core\src\main\java\org\apache\hadoop\yarn\service\timelineservice\package-info.java,0,1,0,1,0,2
hadoop-trunk\hadoop-trunk\hadoop-common-project\hadoop-common\src\main\java\org\apache\hadoop\metrics2\sink\RollingFileSystemSink.java,0,79,7,8,0,94
hadoop-trunk\hadoop-trunk\hadoop-mapreduce-project\hadoop-mapreduce-client\hadoop-mapreduce-client-common\src\main\java\org\apache\hadoop\mapreduce\v2\api\protocolrecords\impl\pb\FailTaskAttemptRequestPBImpl.java,79,34,33,6,0,73
hadoop-trunk\hadoop-trunk\hadoop-yarn-project\hadoop-yarn\hadoop-yarn-common\src\main\java\org\apache\hadoop\yarn\security\client\package-info.java,0,1,0,1,0,2
hadoop-trunk\hadoop-trunk\hadoop-yarn-project\hadoop-yarn\hadoop-yarn-server\hadoop-yarn-server-common\src\main\java\org\apache\hadoop\yarn\server\api\protocolrecords\impl\pb\NodeHeartbeatResponsePBImpl.java,0,113,116,10,0,239
hadoop-trunk\hadoop-trunk\hadoop-common-project\hadoop-common\src\test\java\org\apache\hadoop\security\authorize\TestServiceAuthorization.java,362,50,22,11,0,83
hadoop-trunk\hadoop-trunk\hadoop-common-project\hadoop-common\src\test\java\org\apache\hadoop\net\TestSwitchMapping.java,99,9,2,1,0,12
hadoop-trunk\hadoop-trunk\hadoop-mapreduce-project\hadoop-mapreduce-client\hadoop-mapreduce-client-app\src\main\java\org\apache\hadoop\mapreduce\v2\app\job\impl\JobImpl.java,0,473,47,17,0,537
hadoop-trunk\hadoop-trunk\hadoop-yarn-project\hadoop-yarn\hadoop-yarn-server\hadoop-yarn-server-common\src\test\java\org\apache\hadoop\yarn\server\federation\store\impl\HSQLDBFederationStateStore.java,220,23,3,1,0,27
hadoop-trunk\hadoop-trunk\hadoop-mapreduce-project\hadoop-mapreduce-client\hadoop-mapreduce-client-app\src\main\java\org\apache\hadoop\mapreduce\v2\app\webapp\dao\AMAttemptsInfo.java,18,8,4,1,0,13
hadoop-trunk\hadoop-trunk\hadoop-hdfs-project\hadoop-hdfs\src\main\java\org\apache\hadoop\hdfs\server\namenode\snapshot\DiffListByArrayList.java,0,22,0,1,0,23
hadoop-trunk\hadoop-trunk\hadoop-yarn-project\hadoop-yarn\hadoop-yarn-common\src\main\java\org\apache\hadoop\yarn\security\client\ClientToAMTokenSelector.java,25,5,1,1,0,7
hadoop-trunk\hadoop-trunk\hadoop-mapreduce-project\hadoop-mapreduce-client\hadoop-mapreduce-client-core\src\test\java\org\apache\hadoop\mapred\TestTaskLog.java,115,20,2,1,0,23
hadoop-trunk\hadoop-trunk\hadoop-common-project\hadoop-common\src\main\java\org\apache\hadoop\util\ReadWriteDiskValidator.java,60,5,0,1,0,6
hadoop-trunk\hadoop-trunk\hadoop-hdfs-project\hadoop-hdfs-rbf\src\main\java\org\apache\hadoop\hdfs\server\federation\router\RouterHttpServer.java,115,22,1,1,0,24
hadoop-trunk\hadoop-trunk\hadoop-yarn-project\hadoop-yarn\hadoop-yarn-server\hadoop-yarn-server-resourcemanager\src\main\java\org\apache\hadoop\yarn\server\resourcemanager\reservation\PlanContext.java,0,31,10,4,0,45
hadoop-trunk\hadoop-trunk\hadoop-common-project\hadoop-common\src\main\java\org\apache\hadoop\io\ReadaheadPool.java,217,58,7,7,0,72
hadoop-trunk\hadoop-trunk\hadoop-hdfs-project\hadoop-hdfs\src\main\java\org\apache\hadoop\hdfs\tools\offlineImageViewer\XmlImageVisitor.java,64,25,2,1,0,28
hadoop-trunk\hadoop-trunk\hadoop-hdfs-project\hadoop-hdfs-rbf\src\main\java\org\apache\hadoop\hdfs\server\federation\store\MountTableStore.java,0,15,0,2,0,17
hadoop-trunk\hadoop-trunk\hadoop-hdfs-project\hadoop-hdfs-rbf\src\test\java\org\apache\hadoop\hdfs\server\federation\router\TestRouterNamenodeMonitoring.java,351,21,0,6,0,27
hadoop-trunk\hadoop-trunk\hadoop-yarn-project\hadoop-yarn\hadoop-yarn-api\src\main\java\org\apache\hadoop\yarn\api\records\timelineservice\TimelineWriteResponse.java,129,11,2,1,0,14
hadoop-trunk\hadoop-trunk\hadoop-mapreduce-project\hadoop-mapreduce-client\hadoop-mapreduce-client-app\src\test\java\org\apache\hadoop\mapreduce\v2\app\webapp\TestAMWebServicesTasks.java,713,75,4,3,0,82
hadoop-trunk\hadoop-trunk\hadoop-mapreduce-project\hadoop-mapreduce-client\hadoop-mapreduce-client-core\src\main\java\org\apache\hadoop\mapreduce\task\reduce\ShuffleSchedulerImpl.java,0,188,27,1,0,216
hadoop-trunk\hadoop-trunk\hadoop-yarn-project\hadoop-yarn\hadoop-yarn-server\hadoop-yarn-server-nodemanager\src\test\java\org\apache\hadoop\yarn\server\nodemanager\health\TestNodeHealthScriptRunner.java,136,12,0,1,0,13
hadoop-trunk\hadoop-trunk\hadoop-hdfs-project\hadoop-hdfs\src\test\java\org\apache\hadoop\hdfs\server\namenode\TestProcessCorruptBlocks.java,265,73,2,11,0,86
hadoop-trunk\hadoop-trunk\hadoop-common-project\hadoop-common\src\main\java\org\apache\hadoop\io\BytesWritable.java,0,39,3,1,0,43
hadoop-trunk\hadoop-trunk\hadoop-hdfs-project\hadoop-hdfs\src\test\java\org\apache\hadoop\hdfs\server\blockmanagement\TestReplicationPolicyExcludeSlowNodes.java,0,16,2,1,0,19
hadoop-trunk\hadoop-trunk\hadoop-hdfs-project\hadoop-hdfs\src\main\java\org\apache\hadoop\hdfs\server\namenode\FSImageStorageInspector.java,62,29,0,5,0,34
hadoop-trunk\hadoop-trunk\hadoop-yarn-project\hadoop-yarn\hadoop-yarn-server\hadoop-yarn-server-resourcemanager\src\main\java\org\apache\hadoop\yarn\server\resourcemanager\monitor\capacity\AbstractPreemptionEntity.java,74,49,0,1,0,50
hadoop-trunk\hadoop-trunk\hadoop-common-project\hadoop-common\src\test\java\org\apache\hadoop\io\compress\TestCompressorDecompressor.java,61,26,2,8,0,36
hadoop-trunk\hadoop-trunk\hadoop-tools\hadoop-aws\src\main\java\org\apache\hadoop\fs\s3a\statistics\impl\CountingChangeTracker.java,26,5,0,1,0,6
hadoop-trunk\hadoop-trunk\hadoop-yarn-project\hadoop-yarn\hadoop-yarn-common\src\main\java\org\apache\hadoop\yarn\api\protocolrecords\impl\pb\GetPluginInfoResponsePBImpl.java,59,15,20,1,0,36
hadoop-trunk\hadoop-trunk\hadoop-tools\hadoop-aws\src\main\java\org\apache\hadoop\fs\s3a\commit\files\PendingSet.java,0,32,1,2,0,35
hadoop-trunk\hadoop-trunk\hadoop-common-project\hadoop-common\src\test\java\org\apache\hadoop\fs\TestFilterFs.java,53,23,7,1,0,31
hadoop-trunk\hadoop-trunk\hadoop-hdfs-project\hadoop-hdfs\src\test\java\org\apache\hadoop\hdfs\server\datanode\TestStorageReport.java,74,15,2,3,0,20
hadoop-trunk\hadoop-trunk\hadoop-yarn-project\hadoop-yarn\hadoop-yarn-server\hadoop-yarn-server-nodemanager\src\test\java\org\apache\hadoop\yarn\server\nodemanager\containermanager\linux\runtime\TestImageTagToManifestPlugin.java,199,49,9,14,0,72
hadoop-trunk\hadoop-trunk\hadoop-mapreduce-project\hadoop-mapreduce-client\hadoop-mapreduce-client-jobclient\src\test\java\org\apache\hadoop\mapreduce\TestMapReduce.java,440,79,10,1,0,90
hadoop-trunk\hadoop-trunk\hadoop-common-project\hadoop-common\src\main\java\org\apache\hadoop\io\retry\Idempotent.java,0,2,0,1,0,3
hadoop-trunk\hadoop-trunk\hadoop-yarn-project\hadoop-yarn\hadoop-yarn-server\hadoop-yarn-server-timelineservice\src\main\java\org\apache\hadoop\yarn\server\timelineservice\storage\common\OfflineAggregationInfo.java,0,26,0,2,0,28
hadoop-trunk\hadoop-trunk\hadoop-hdfs-project\hadoop-hdfs\src\main\java\org\apache\hadoop\hdfs\tools\offlineImageViewer\PBImageCorruption.java,84,22,1,1,0,24
hadoop-trunk\hadoop-trunk\hadoop-hdfs-project\hadoop-hdfs-rbf\src\main\java\org\apache\hadoop\hdfs\server\federation\store\protocol\impl\pb\GetRouterRegistrationsRequestPBImpl.java,0,8,23,5,0,36
hadoop-trunk\hadoop-trunk\hadoop-yarn-project\hadoop-yarn\hadoop-yarn-server\hadoop-yarn-server-common\src\main\java\org\apache\hadoop\yarn\server\webapp\AppAttemptBlock.java,212,33,3,6,0,42
hadoop-trunk\hadoop-trunk\hadoop-yarn-project\hadoop-yarn\hadoop-yarn-applications\hadoop-yarn-applications-distributedshell\src\main\java\org\apache\hadoop\yarn\applications\distributedshell\DistributedShellTimelinePlugin.java,43,13,6,1,0,20
hadoop-trunk\hadoop-trunk\hadoop-common-project\hadoop-common\src\test\java\org\apache\hadoop\io\file\tfile\TestTFileNoneCodecsJClassComparatorByteArrays.java,12,7,0,2,0,9
hadoop-trunk\hadoop-trunk\hadoop-tools\hadoop-streaming\src\main\java\org\apache\hadoop\streaming\StreamKeyValUtil.java,113,84,4,3,0,91
hadoop-trunk\hadoop-trunk\hadoop-common-project\hadoop-common\src\test\java\org\apache\hadoop\util\TestSysInfoWindows.java,133,56,1,1,0,58
hadoop-trunk\hadoop-trunk\hadoop-mapreduce-project\hadoop-mapreduce-client\hadoop-mapreduce-client-app\src\main\java\org\apache\hadoop\mapreduce\v2\app\job\impl\TaskAttemptImpl.java,2397,434,44,51,0,529
hadoop-trunk\hadoop-trunk\hadoop-cloud-storage-project\hadoop-huaweicloud\src\main\java\org\apache\hadoop\fs\obs\OBSBlockOutputStream.java,0,0,14,4,0,18
hadoop-trunk\hadoop-trunk\hadoop-mapreduce-project\hadoop-mapreduce-client\hadoop-mapreduce-client-hs\src\test\java\org\apache\hadoop\mapreduce\v2\hs\TestJobHistory.java,469,99,6,4,0,109
hadoop-trunk\hadoop-trunk\hadoop-hdfs-project\hadoop-hdfs-rbf\src\test\java\org\apache\hadoop\hdfs\server\federation\router\TestRouterNamenodeHeartbeat.java,265,50,3,12,0,65
hadoop-trunk\hadoop-trunk\hadoop-mapreduce-project\hadoop-mapreduce-client\hadoop-mapreduce-client-core\src\test\java\org\apache\hadoop\mapreduce\security\TestTokenCache.java,167,40,8,1,0,49
hadoop-trunk\hadoop-trunk\hadoop-yarn-project\hadoop-yarn\hadoop-yarn-server\hadoop-yarn-server-common\src\main\java\org\apache\hadoop\yarn\server\volume\csi\CsiConstants.java,0,7,0,1,0,8
hadoop-trunk\hadoop-trunk\hadoop-mapreduce-project\hadoop-mapreduce-client\hadoop-mapreduce-client-core\src\main\java\org\apache\hadoop\mapreduce\counters\FileSystemCounterGroup.java,0,96,12,1,0,109
hadoop-trunk\hadoop-trunk\hadoop-common-project\hadoop-common\src\main\java\org\apache\hadoop\fs\statistics\package-info.java,0,1,0,2,0,3
hadoop-trunk\hadoop-trunk\hadoop-yarn-project\hadoop-yarn\hadoop-yarn-server\hadoop-yarn-server-common\src\main\java\org\apache\hadoop\yarn\server\api\protocolrecords\impl\pb\UnRegisterNodeManagerResponsePBImpl.java,44,10,19,3,0,32
hadoop-trunk\hadoop-trunk\hadoop-common-project\hadoop-common\src\main\java\org\apache\hadoop\fs\FsUrlConnection.java,0,7,2,1,0,10
hadoop-trunk\hadoop-trunk\hadoop-yarn-project\hadoop-yarn\hadoop-yarn-client\src\test\java\org\apache\hadoop\yarn\client\cli\TestLogsCLI.java,0,250,83,99,0,432
hadoop-trunk\hadoop-trunk\hadoop-yarn-project\hadoop-yarn\hadoop-yarn-server\hadoop-yarn-server-nodemanager\src\main\java\org\apache\hadoop\yarn\server\nodemanager\containermanager\launcher\SignalContainersLauncherEvent.java,13,8,0,2,0,10
hadoop-trunk\hadoop-trunk\hadoop-hdfs-project\hadoop-hdfs\src\main\java\org\apache\hadoop\hdfs\server\datanode\fsdataset\impl\PmemMappableBlockLoader.java,138,31,4,1,0,36
hadoop-trunk\hadoop-trunk\hadoop-common-project\hadoop-common\src\test\java\org\apache\hadoop\fs\FileSystemTestHelper.java,0,151,14,3,0,168
hadoop-trunk\hadoop-trunk\hadoop-tools\hadoop-gridmix\src\test\java\org\apache\hadoop\mapred\gridmix\DebugJobFactory.java,76,29,2,1,0,32
hadoop-trunk\hadoop-trunk\hadoop-hdfs-project\hadoop-hdfs\src\main\java\org\apache\hadoop\hdfs\server\protocol\RemoteEditLog.java,72,35,3,1,0,39
hadoop-trunk\hadoop-trunk\hadoop-yarn-project\hadoop-yarn\hadoop-yarn-server\hadoop-yarn-server-resourcemanager\src\test\java\org\apache\hadoop\yarn\server\resourcemanager\monitor\invariants\TestMetricsInvariantChecker.java,71,12,1,2,0,15
hadoop-trunk\hadoop-trunk\hadoop-tools\hadoop-aws\src\main\java\org\apache\hadoop\fs\s3a\AWSS3IOException.java,30,10,0,1,0,11
hadoop-trunk\hadoop-trunk\hadoop-tools\hadoop-datajoin\src\test\java\org\apache\hadoop\contrib\utils\join\TestDataJoin.java,117,26,6,1,0,33
hadoop-trunk\hadoop-trunk\hadoop-hdfs-project\hadoop-hdfs\src\main\java\org\apache\hadoop\hdfs\server\blockmanagement\SequentialBlockGroupIdGenerator.java,44,4,0,3,0,7
hadoop-trunk\hadoop-trunk\hadoop-yarn-project\hadoop-yarn\hadoop-yarn-server\hadoop-yarn-server-resourcemanager\src\main\java\org\apache\hadoop\yarn\server\resourcemanager\webapp\dao\CapacitySchedulerQueueInfo.java,320,173,5,9,0,187
hadoop-trunk\hadoop-trunk\hadoop-yarn-project\hadoop-yarn\hadoop-yarn-server\hadoop-yarn-server-nodemanager\src\main\java\org\apache\hadoop\yarn\server\nodemanager\containermanager\scheduler\package-info.java,0,1,0,1,0,2
hadoop-trunk\hadoop-trunk\hadoop-common-project\hadoop-common\src\main\java\org\apache\hadoop\io\VLongWritable.java,0,26,4,1,0,31
hadoop-trunk\hadoop-trunk\hadoop-yarn-project\hadoop-yarn\hadoop-yarn-common\src\test\java\org\apache\hadoop\yarn\webapp\log\AggregatedLogsBlockForTest.java,26,16,1,1,0,18
hadoop-trunk\hadoop-trunk\hadoop-mapreduce-project\hadoop-mapreduce-client\hadoop-mapreduce-client-core\src\main\java\org\apache\hadoop\mapred\lib\TotalOrderPartitioner.java,0,19,2,2,0,23
hadoop-trunk\hadoop-trunk\hadoop-tools\hadoop-openstack\src\main\java\org\apache\hadoop\fs\swift\http\ExceptionDiags.java,65,8,4,1,0,13
hadoop-trunk\hadoop-trunk\hadoop-yarn-project\hadoop-yarn\hadoop-yarn-common\src\test\java\org\apache\hadoop\yarn\server\security\TestApplicationACLsManager.java,149,61,0,24,0,85
hadoop-trunk\hadoop-trunk\hadoop-yarn-project\hadoop-yarn\hadoop-yarn-server\hadoop-yarn-server-router\src\main\java\org\apache\hadoop\yarn\server\router\RouterAuditLogger.java,215,106,0,2,0,108
hadoop-trunk\hadoop-trunk\hadoop-common-project\hadoop-common\src\main\java\org\apache\hadoop\fs\ChecksumFileSystem.java,880,303,7,16,0,326
hadoop-trunk\hadoop-trunk\hadoop-tools\hadoop-aws\src\main\java\org\apache\hadoop\fs\s3a\S3ARetryPolicy.java,235,34,3,3,0,40
hadoop-trunk\hadoop-trunk\hadoop-yarn-project\hadoop-yarn\hadoop-yarn-common\src\main\java\org\apache\hadoop\yarn\util\Times.java,86,18,3,1,0,22
hadoop-trunk\hadoop-trunk\hadoop-hdfs-project\hadoop-hdfs\src\test\java\org\apache\hadoop\hdfs\qjournal\server\TestJournalNode.java,615,160,61,9,0,230
hadoop-trunk\hadoop-trunk\hadoop-maven-plugins\src\main\java\org\apache\hadoop\maven\plugin\shade\resource\package-info.java,0,0,0,1,0,1
hadoop-trunk\hadoop-trunk\hadoop-yarn-project\hadoop-yarn\hadoop-yarn-server\hadoop-yarn-server-resourcemanager\src\main\java\org\apache\hadoop\yarn\server\resourcemanager\ahs\WritingApplicationStartEvent.java,27,13,1,2,0,16
hadoop-trunk\hadoop-trunk\hadoop-mapreduce-project\hadoop-mapreduce-client\hadoop-mapreduce-client-jobclient\src\test\java\org\apache\hadoop\cli\CLITestCmdMR.java,19,6,0,1,0,7
hadoop-trunk\hadoop-trunk\hadoop-tools\hadoop-distcp\src\main\java\org\apache\hadoop\tools\mapred\CopyCommitter.java,608,88,53,21,0,162
hadoop-trunk\hadoop-trunk\hadoop-yarn-project\hadoop-yarn\hadoop-yarn-server\hadoop-yarn-server-resourcemanager\src\test\java\org\apache\hadoop\yarn\server\resourcemanager\reservation\TestSchedulerPlanFollowerBase.java,167,56,2,10,0,68
hadoop-trunk\hadoop-trunk\hadoop-common-project\hadoop-nfs\src\main\java\org\apache\hadoop\nfs\nfs3\response\SYMLINK3Response.java,60,29,0,1,0,30
hadoop-trunk\hadoop-trunk\hadoop-yarn-project\hadoop-yarn\hadoop-yarn-server\hadoop-yarn-server-nodemanager\src\main\java\org\apache\hadoop\yarn\server\nodemanager\containermanager\loghandler\event\LogHandlerAppFinishedEvent.java,15,6,0,2,0,8
hadoop-trunk\hadoop-trunk\hadoop-common-project\hadoop-common\src\test\java\org\apache\hadoop\util\TestCrcComposer.java,208,58,2,1,0,61
hadoop-trunk\hadoop-trunk\hadoop-mapreduce-project\hadoop-mapreduce-client\hadoop-mapreduce-client-core\src\main\java\org\apache\hadoop\mapred\lib\LazyOutputFormat.java,0,48,5,3,0,56
hadoop-trunk\hadoop-trunk\hadoop-common-project\hadoop-common\src\test\java\org\apache\hadoop\fs\audit\TestCommonAuditContext.java,132,9,4,5,0,18
hadoop-trunk\hadoop-trunk\hadoop-tools\hadoop-azure\src\test\java\org\apache\hadoop\fs\azure\TestNativeAzureFileSystemContractMocked.java,38,10,5,1,0,16
hadoop-trunk\hadoop-trunk\hadoop-yarn-project\hadoop-yarn\hadoop-yarn-common\src\main\java\org\apache\hadoop\yarn\logaggregation\filecontroller\ifile\package-info.java,0,1,0,1,0,2
hadoop-trunk\hadoop-trunk\hadoop-mapreduce-project\hadoop-mapreduce-client\hadoop-mapreduce-client-core\src\main\java\org\apache\hadoop\mapreduce\task\JobContextImpl.java,532,129,10,5,0,144
hadoop-trunk\hadoop-trunk\hadoop-yarn-project\hadoop-yarn\hadoop-yarn-server\hadoop-yarn-server-resourcemanager\src\test\java\org\apache\hadoop\yarn\server\resourcemanager\scheduler\fair\TestQueuePlacementPolicy.java,598,38,2,4,0,44
hadoop-trunk\hadoop-trunk\hadoop-hdfs-project\hadoop-hdfs\src\test\java\org\apache\hadoop\hdfs\server\datanode\web\webhdfs\TestDataNodeUGIProvider.java,210,32,3,7,0,42
hadoop-trunk\hadoop-trunk\hadoop-common-project\hadoop-common\src\test\java\org\apache\hadoop\tools\GetGroupsTestBase.java,96,43,1,11,0,55
hadoop-trunk\hadoop-trunk\hadoop-yarn-project\hadoop-yarn\hadoop-yarn-server\hadoop-yarn-server-nodemanager\src\main\java\org\apache\hadoop\yarn\server\nodemanager\containermanager\resourceplugin\gpu\NvidiaDockerV2CommandPlugin.java,71,17,3,9,0,29
hadoop-trunk\hadoop-trunk\hadoop-yarn-project\hadoop-yarn\hadoop-yarn-common\src\test\java\org\apache\hadoop\yarn\TestRPCFactories.java,93,20,5,6,0,31
hadoop-trunk\hadoop-trunk\hadoop-hdfs-project\hadoop-hdfs-nfs\src\test\java\org\apache\hadoop\hdfs\nfs\nfs3\TestExportsTable.java,269,11,13,1,0,25
hadoop-trunk\hadoop-trunk\hadoop-yarn-project\hadoop-yarn\hadoop-yarn-server\hadoop-yarn-server-resourcemanager\src\test\java\org\apache\hadoop\yarn\server\resourcemanager\rmapp\TestRMAppTransitions.java,1285,204,37,29,0,270
hadoop-trunk\hadoop-trunk\hadoop-mapreduce-project\hadoop-mapreduce-client\hadoop-mapreduce-client-nativetask\src\test\java\org\apache\hadoop\mapred\nativetask\kvtest\TestInputFile.java,185,87,13,8,0,108
hadoop-trunk\hadoop-trunk\hadoop-tools\hadoop-azure\src\test\java\org\apache\hadoop\fs\azurebfs\commit\ITestAbfsRenameStageFailure.java,40,7,0,2,0,9
hadoop-trunk\hadoop-trunk\hadoop-yarn-project\hadoop-yarn\hadoop-yarn-server\hadoop-yarn-server-router\src\test\java\org\apache\hadoop\yarn\server\router\clientrm\TestFederationClientInterceptor.java,572,28,3,7,0,38
hadoop-trunk\hadoop-trunk\hadoop-mapreduce-project\hadoop-mapreduce-client\hadoop-mapreduce-client-core\src\main\java\org\apache\hadoop\mapred\IndexRecord.java,14,14,1,1,0,16
hadoop-trunk\hadoop-trunk\hadoop-mapreduce-project\hadoop-mapreduce-client\hadoop-mapreduce-client-common\src\test\java\org\apache\hadoop\mapred\TestJobClient.java,67,13,2,1,0,16
hadoop-trunk\hadoop-trunk\hadoop-hdfs-project\hadoop-hdfs\src\test\java\org\apache\hadoop\hdfs\server\datanode\web\TestDatanodeHttpXFrame.java,65,10,1,1,0,12
hadoop-trunk\hadoop-trunk\hadoop-yarn-project\hadoop-yarn\hadoop-yarn-api\src\test\java\org\apache\hadoop\yarn\api\resource\TestPlacementConstraints.java,0,5,0,8,0,13
hadoop-trunk\hadoop-trunk\hadoop-common-project\hadoop-common\src\test\java\org\apache\hadoop\metrics2\util\DummyMXBean.java,0,2,0,1,0,3
hadoop-trunk\hadoop-trunk\hadoop-common-project\hadoop-common\src\test\java\org\apache\hadoop\cli\util\ExactLineComparator.java,16,3,0,1,0,4
hadoop-trunk\hadoop-trunk\hadoop-common-project\hadoop-common\src\test\java\org\apache\hadoop\conf\TestGetInstances.java,0,21,7,1,0,29
hadoop-trunk\hadoop-trunk\hadoop-tools\hadoop-sls\src\main\java\org\apache\hadoop\yarn\sls\TaskContainerDefinition.java,223,100,0,3,0,103
hadoop-trunk\hadoop-trunk\hadoop-yarn-project\hadoop-yarn\hadoop-yarn-api\src\main\java\org\apache\hadoop\yarn\api\records\timelineservice\SubApplicationEntity.java,23,7,2,1,0,10
hadoop-trunk\hadoop-trunk\hadoop-common-project\hadoop-common\src\main\java\org\apache\hadoop\fs\statistics\IOStatisticsSource.java,0,0,0,1,0,1
hadoop-trunk\hadoop-trunk\hadoop-yarn-project\hadoop-yarn\hadoop-yarn-server\hadoop-yarn-server-nodemanager\src\test\java\org\apache\hadoop\yarn\server\nodemanager\containermanager\resourceplugin\gpu\TestNvidiaDockerV1CommandPlugin.java,171,15,15,8,0,38
hadoop-trunk\hadoop-trunk\hadoop-mapreduce-project\hadoop-mapreduce-client\hadoop-mapreduce-client-jobclient\src\test\java\org\apache\hadoop\mapred\TestReduceTask.java,109,30,2,2,0,34
hadoop-trunk\hadoop-trunk\hadoop-yarn-project\hadoop-yarn\hadoop-yarn-common\src\main\java\org\apache\hadoop\yarn\api\protocolrecords\impl\pb\GetAllResourceTypeInfoResponsePBImpl.java,143,22,42,6,0,70
hadoop-trunk\hadoop-trunk\hadoop-yarn-project\hadoop-yarn\hadoop-yarn-common\src\test\java\org\apache\hadoop\yarn\api\TestPBImplRecords.java,960,170,100,207,0,477
hadoop-trunk\hadoop-trunk\hadoop-hdfs-project\hadoop-hdfs-client\src\main\java\org\apache\hadoop\hdfs\inotify\Event.java,659,274,0,2,0,276
hadoop-trunk\hadoop-trunk\hadoop-common-project\hadoop-nfs\src\main\java\org\apache\hadoop\nfs\nfs3\request\RENAME3Request.java,49,29,0,1,0,30
hadoop-trunk\hadoop-trunk\hadoop-common-project\hadoop-common\src\main\java\org\apache\hadoop\ipc\RemoteException.java,114,39,11,6,0,56
hadoop-trunk\hadoop-trunk\hadoop-tools\hadoop-azure\src\main\java\org\apache\hadoop\fs\azurebfs\services\SimpleKeyProvider.java,44,11,0,8,0,19
hadoop-trunk\hadoop-trunk\hadoop-mapreduce-project\hadoop-mapreduce-client\hadoop-mapreduce-client-jobclient\src\test\java\org\apache\hadoop\mapred\join\TestWrappedRecordReaderClassloader.java,122,56,8,3,0,67
hadoop-trunk\hadoop-trunk\hadoop-mapreduce-project\hadoop-mapreduce-client\hadoop-mapreduce-client-core\src\test\java\org\apache\hadoop\mapred\TestFileInputFormat.java,230,74,21,11,0,106
hadoop-trunk\hadoop-trunk\hadoop-mapreduce-project\hadoop-mapreduce-client\hadoop-mapreduce-client-jobclient\src\test\java\org\apache\hadoop\fs\slive\OperationData.java,0,18,2,1,0,21
hadoop-trunk\hadoop-trunk\hadoop-yarn-project\hadoop-yarn\hadoop-yarn-common\src\main\java\org\apache\hadoop\yarn\api\protocolrecords\impl\pb\GetQueueInfoRequestPBImpl.java,102,31,48,2,0,81
hadoop-trunk\hadoop-trunk\hadoop-mapreduce-project\hadoop-mapreduce-client\hadoop-mapreduce-client-app\src\main\java\org\apache\hadoop\mapreduce\v2\app\job\package-info.java,0,1,0,1,0,2
hadoop-trunk\hadoop-trunk\hadoop-yarn-project\hadoop-yarn\hadoop-yarn-server\hadoop-yarn-server-nodemanager\src\main\java\org\apache\hadoop\yarn\server\nodemanager\util\ProcessIdFileReader.java,71,8,7,1,0,16
hadoop-trunk\hadoop-trunk\hadoop-common-project\hadoop-common\src\main\java\org\apache\hadoop\util\bloom\CountingBloomFilter.java,0,102,2,10,0,114
hadoop-trunk\hadoop-trunk\hadoop-hdfs-project\hadoop-hdfs-client\src\main\java\org\apache\hadoop\hdfs\web\resources\OldSnapshotNameParam.java,19,3,1,1,0,5
hadoop-trunk\hadoop-trunk\hadoop-common-project\hadoop-common\src\main\java\org\apache\hadoop\fs\crypto\CryptoFSDataOutputStream.java,29,26,0,1,0,27
hadoop-trunk\hadoop-trunk\hadoop-mapreduce-project\hadoop-mapreduce-client\hadoop-mapreduce-client-core\src\test\java\org\apache\hadoop\mapred\lib\db\TestDBInputFormat.java,120,25,4,3,0,32
hadoop-trunk\hadoop-trunk\hadoop-tools\hadoop-aws\src\test\java\org\apache\hadoop\fs\s3a\TestArnResource.java,70,24,0,12,0,36
hadoop-trunk\hadoop-trunk\hadoop-mapreduce-project\hadoop-mapreduce-client\hadoop-mapreduce-client-app\src\test\java\org\apache\hadoop\mapreduce\v2\app\TestKillAMPreemptionPolicy.java,96,5,0,1,0,6
hadoop-trunk\hadoop-trunk\hadoop-tools\hadoop-aws\src\main\java\org\apache\hadoop\fs\s3a\S3AInputStream.java,0,80,13,5,0,98
hadoop-trunk\hadoop-trunk\hadoop-tools\hadoop-rumen\src\main\java\org\apache\hadoop\tools\rumen\CDFPiecewiseLinearRandomGenerator.java,50,5,2,2,0,9
hadoop-trunk\hadoop-trunk\hadoop-common-project\hadoop-common\src\main\java\org\apache\hadoop\io\erasurecode\ECBlockGroup.java,51,11,2,1,0,14
hadoop-trunk\hadoop-trunk\hadoop-common-project\hadoop-common\src\main\java\org\apache\hadoop\ha\HAServiceTarget.java,167,37,0,2,0,39
hadoop-trunk\hadoop-trunk\hadoop-tools\hadoop-fs2img\src\main\java\org\apache\hadoop\hdfs\server\namenode\package-info.java,0,1,0,1,0,2
hadoop-trunk\hadoop-trunk\hadoop-hdfs-project\hadoop-hdfs\src\main\java\org\apache\hadoop\hdfs\tools\offlineImageViewer\WebImageViewer.java,96,24,5,2,0,31
hadoop-trunk\hadoop-trunk\hadoop-yarn-project\hadoop-yarn\hadoop-yarn-server\hadoop-yarn-server-resourcemanager\src\main\java\org\apache\hadoop\yarn\server\resourcemanager\rmnode\RMNodeReconnectEvent.java,26,15,0,2,0,17
hadoop-trunk\hadoop-trunk\hadoop-yarn-project\hadoop-yarn\hadoop-yarn-server\hadoop-yarn-server-resourcemanager\src\test\java\org\apache\hadoop\yarn\server\resourcemanager\security\TestClientToAMTokens.java,443,59,17,7,0,83
hadoop-trunk\hadoop-trunk\hadoop-yarn-project\hadoop-yarn\hadoop-yarn-server\hadoop-yarn-server-common\src\main\java\org\apache\hadoop\yarn\server\security\AMSecretKeys.java,0,9,0,1,0,10
hadoop-trunk\hadoop-trunk\hadoop-tools\hadoop-aws\src\test\java\org\apache\hadoop\fs\s3a\statistics\ITestAWSStatisticCollection.java,42,3,0,2,0,5
hadoop-trunk\hadoop-trunk\hadoop-tools\hadoop-aws\src\main\java\org\apache\hadoop\fs\s3a\S3ObjectAttributes.java,87,46,0,1,0,47
hadoop-trunk\hadoop-trunk\hadoop-yarn-project\hadoop-yarn\hadoop-yarn-common\src\main\java\org\apache\hadoop\yarn\util\LRUCacheHashMap.java,0,9,0,1,0,10
hadoop-trunk\hadoop-trunk\hadoop-yarn-project\hadoop-yarn\hadoop-yarn-server\hadoop-yarn-server-nodemanager\src\test\java\org\apache\hadoop\yarn\server\nodemanager\TestEventFlow.java,124,16,2,7,0,25
hadoop-trunk\hadoop-trunk\hadoop-common-project\hadoop-common\src\test\java\org\apache\hadoop\io\erasurecode\TestCodecRegistry.java,134,10,0,2,0,12
hadoop-trunk\hadoop-trunk\hadoop-common-project\hadoop-registry\src\main\java\org\apache\hadoop\registry\client\exceptions\AuthenticationFailedException.java,16,10,0,1,0,11
hadoop-trunk\hadoop-trunk\hadoop-common-project\hadoop-nfs\src\main\java\org\apache\hadoop\oncrpc\security\CredentialsGSS.java,20,6,2,1,0,9
hadoop-trunk\hadoop-trunk\hadoop-yarn-project\hadoop-yarn\hadoop-yarn-common\src\main\java\org\apache\hadoop\yarn\nodelabels\NodeAttributesManager.java,104,6,0,2,0,8
hadoop-trunk\hadoop-trunk\hadoop-yarn-project\hadoop-yarn\hadoop-yarn-server\hadoop-yarn-server-resourcemanager\src\main\java\org\apache\hadoop\yarn\server\resourcemanager\scheduler\event\SchedulerEvent.java,6,2,0,1,0,3
hadoop-trunk\hadoop-trunk\hadoop-hdfs-project\hadoop-hdfs-native-client\src\main\native\fuse-dfs\test\TestFuseDFS.java,0,132,21,1,0,154
hadoop-trunk\hadoop-trunk\hadoop-mapreduce-project\hadoop-mapreduce-client\hadoop-mapreduce-client-jobclient\src\test\java\org\apache\hadoop\mapreduce\lib\jobcontrol\TestMapReduceJobControlWithMocks.java,129,41,0,2,0,43
hadoop-trunk\hadoop-trunk\hadoop-common-project\hadoop-common\src\test\java\org\apache\hadoop\ipc\TestRPCCompatibility.java,163,68,13,4,0,85
hadoop-trunk\hadoop-trunk\hadoop-hdfs-project\hadoop-hdfs\src\test\java\org\apache\hadoop\hdfs\server\namenode\TestCheckPointForSecurityTokens.java,142,34,4,10,0,48
hadoop-trunk\hadoop-trunk\hadoop-mapreduce-project\hadoop-mapreduce-client\hadoop-mapreduce-client-hs\src\main\java\org\apache\hadoop\mapreduce\v2\hs\HistoryFileManager.java,1151,226,40,9,0,275
hadoop-trunk\hadoop-trunk\hadoop-common-project\hadoop-common\src\main\java\org\apache\hadoop\fs\statistics\DurationTracker.java,0,0,0,1,0,1
hadoop-trunk\hadoop-trunk\hadoop-hdfs-project\hadoop-hdfs-rbf\src\test\java\org\apache\hadoop\hdfs\server\federation\router\TestRouterWithSecureStartup.java,43,7,1,3,0,11
hadoop-trunk\hadoop-trunk\hadoop-hdfs-project\hadoop-hdfs\src\test\java\org\apache\hadoop\hdfs\server\blockmanagement\TestSequentialBlockId.java,155,22,14,1,0,37
hadoop-trunk\hadoop-trunk\hadoop-mapreduce-project\hadoop-mapreduce-client\hadoop-mapreduce-client-core\src\main\java\org\apache\hadoop\mapreduce\Counter.java,0,6,0,1,0,7
hadoop-trunk\hadoop-trunk\hadoop-common-project\hadoop-common\src\test\java\org\apache\hadoop\io\TestSequenceFileAppend.java,343,31,12,2,0,45
hadoop-trunk\hadoop-trunk\hadoop-mapreduce-project\hadoop-mapreduce-client\hadoop-mapreduce-client-core\src\main\java\org\apache\hadoop\mapreduce\lib\aggregate\DoubleValueSum.java,68,15,1,1,0,17
hadoop-trunk\hadoop-trunk\hadoop-common-project\hadoop-common\src\test\java\org\apache\hadoop\metrics2\impl\ConfigBuilder.java,0,13,1,1,0,15
hadoop-trunk\hadoop-trunk\hadoop-hdfs-project\hadoop-hdfs\src\test\java\org\apache\hadoop\cli\TestDeleteCLI.java,62,14,0,1,0,15
hadoop-trunk\hadoop-trunk\hadoop-common-project\hadoop-common\src\main\java\org\apache\hadoop\util\ZKUtil.java,183,44,2,2,0,48
hadoop-trunk\hadoop-trunk\hadoop-common-project\hadoop-common\src\test\java\org\apache\hadoop\fs\contract\ftp\TestFTPContractCreate.java,9,2,0,1,0,3
hadoop-trunk\hadoop-trunk\hadoop-tools\hadoop-datajoin\src\main\java\org\apache\hadoop\contrib\utils\join\DataJoinReducerBase.java,192,85,12,9,0,106
hadoop-trunk\hadoop-trunk\hadoop-tools\hadoop-gridmix\src\test\java\org\apache\hadoop\mapred\gridmix\TestResourceUsageEmulators.java,0,241,13,8,0,262
hadoop-trunk\hadoop-trunk\hadoop-tools\hadoop-azure-datalake\src\main\java\org\apache\hadoop\fs\adl\AdlFileStatus.java,0,14,2,1,0,17
hadoop-trunk\hadoop-trunk\hadoop-hdfs-project\hadoop-hdfs-httpfs\src\main\java\org\apache\hadoop\fs\http\client\HttpsFSFileSystem.java,10,2,0,1,0,3
hadoop-trunk\hadoop-trunk\hadoop-hdfs-project\hadoop-hdfs\src\test\java\org\apache\hadoop\hdfs\server\namenode\OfflineEditsViewerHelper.java,99,17,1,1,0,19
hadoop-trunk\hadoop-trunk\hadoop-tools\hadoop-rumen\src\main\java\org\apache\hadoop\tools\rumen\ResourceUsageMetrics.java,0,55,3,1,0,59
hadoop-trunk\hadoop-trunk\hadoop-tools\hadoop-aws\src\main\java\org\apache\hadoop\fs\s3a\impl\package-info.java,0,0,0,1,0,1
hadoop-trunk\hadoop-trunk\hadoop-common-project\hadoop-auth\src\test\java\org\apache\hadoop\security\authentication\server\TestJWTRedirectAuthenticationHandler.java,427,70,15,15,0,100
hadoop-trunk\hadoop-trunk\hadoop-tools\hadoop-sls\src\main\java\org\apache\hadoop\yarn\sls\synthetic\SynthJob.java,328,118,3,1,0,122
hadoop-trunk\hadoop-trunk\hadoop-yarn-project\hadoop-yarn\hadoop-yarn-server\hadoop-yarn-server-nodemanager\src\main\java\org\apache\hadoop\yarn\server\nodemanager\containermanager\container\ContainerState.java,0,17,0,1,0,18
hadoop-trunk\hadoop-trunk\hadoop-tools\hadoop-azure\src\test\java\org\apache\hadoop\fs\azure\ITestNativeAzureFileSystemAppend.java,315,60,2,12,0,74
hadoop-trunk\hadoop-trunk\hadoop-hdfs-project\hadoop-hdfs\src\main\java\org\apache\hadoop\hdfs\server\datanode\BPServiceActorAction.java,0,3,1,1,0,5
hadoop-trunk\hadoop-trunk\hadoop-common-project\hadoop-common\src\main\java\org\apache\hadoop\fs\viewfs\ChRootedFs.java,0,77,1,2,0,80
hadoop-trunk\hadoop-trunk\hadoop-yarn-project\hadoop-yarn\hadoop-yarn-api\src\main\java\org\apache\hadoop\yarn\util\Records.java,10,6,1,1,0,8
hadoop-trunk\hadoop-trunk\hadoop-yarn-project\hadoop-yarn\hadoop-yarn-client\src\main\java\org\apache\hadoop\yarn\client\api\impl\NMClientImpl.java,433,74,5,6,0,85
hadoop-trunk\hadoop-trunk\hadoop-yarn-project\hadoop-yarn\hadoop-yarn-common\src\main\java\org\apache\hadoop\yarn\security\admin\package-info.java,0,1,0,1,0,2
hadoop-trunk\hadoop-trunk\hadoop-hdfs-project\hadoop-hdfs\src\test\java\org\apache\hadoop\hdfs\server\blockmanagement\TestBlockTokenWithShortCircuitRead.java,142,17,7,5,0,29
hadoop-trunk\hadoop-trunk\hadoop-hdfs-project\hadoop-hdfs\src\test\java\org\apache\hadoop\cli\TestXAttrCLI.java,68,21,0,1,0,22
hadoop-trunk\hadoop-trunk\hadoop-common-project\hadoop-nfs\src\test\java\org\apache\hadoop\oncrpc\TestRpcMessage.java,30,10,0,1,0,11
hadoop-trunk\hadoop-trunk\hadoop-mapreduce-project\hadoop-mapreduce-client\hadoop-mapreduce-client-nativetask\src\test\java\org\apache\hadoop\mapred\nativetask\compresstest\CompressTest.java,113,17,0,8,0,25
hadoop-trunk\hadoop-trunk\hadoop-yarn-project\hadoop-yarn\hadoop-yarn-common\src\main\java\org\apache\hadoop\yarn\api\records\impl\pb\NodeAttributeInfoPBImpl.java,117,23,38,1,0,62
hadoop-trunk\hadoop-trunk\hadoop-common-project\hadoop-common\src\test\java\org\apache\hadoop\util\TestOptions.java,23,9,1,1,0,11
hadoop-trunk\hadoop-trunk\hadoop-mapreduce-project\hadoop-mapreduce-client\hadoop-mapreduce-client-core\src\main\java\org\apache\hadoop\mapreduce\lib\output\PartialFileOutputCommitter.java,0,21,1,3,0,25
hadoop-trunk\hadoop-trunk\hadoop-yarn-project\hadoop-yarn\hadoop-yarn-applications\hadoop-yarn-services\hadoop-yarn-services-core\src\main\java\org\apache\hadoop\yarn\service\ServiceEventType.java,0,4,0,1,0,5
hadoop-trunk\hadoop-trunk\hadoop-yarn-project\hadoop-yarn\hadoop-yarn-server\hadoop-yarn-server-resourcemanager\src\main\java\org\apache\hadoop\yarn\server\resourcemanager\placement\csmappingrule\MappingRuleMatchers.java,257,39,0,1,0,40
hadoop-trunk\hadoop-trunk\hadoop-hdfs-project\hadoop-hdfs\src\test\java\org\apache\hadoop\hdfs\TestDFSClientFailover.java,336,68,6,9,0,83
hadoop-trunk\hadoop-trunk\hadoop-hdfs-project\hadoop-hdfs\src\test\java\org\apache\hadoop\hdfs\server\blockmanagement\TestLowRedundancyBlockQueues.java,295,77,5,1,0,83
hadoop-trunk\hadoop-trunk\hadoop-common-project\hadoop-common\src\test\java\org\apache\hadoop\util\TestShutdownHookManager.java,273,31,0,3,0,34
hadoop-trunk\hadoop-trunk\hadoop-hdfs-project\hadoop-hdfs\src\main\java\org\apache\hadoop\hdfs\protocolPB\DatanodeLifelineProtocolClientSideTranslatorPB.java,0,20,7,2,0,29
hadoop-trunk\hadoop-trunk\hadoop-hdfs-project\hadoop-hdfs\src\test\java\org\apache\hadoop\hdfs\server\datanode\TestDataNodeFaultInjector.java,134,13,3,1,0,17
hadoop-trunk\hadoop-trunk\hadoop-hdfs-project\hadoop-hdfs\src\test\java\org\apache\hadoop\hdfs\TestMaintenanceState.java,1157,124,18,1,0,143
hadoop-trunk\hadoop-trunk\hadoop-tools\hadoop-aws\src\test\java\org\apache\hadoop\fs\s3a\ITestS3ABlocksize.java,49,4,0,1,0,5
hadoop-trunk\hadoop-trunk\hadoop-hdfs-project\hadoop-hdfs-rbf\src\main\java\org\apache\hadoop\hdfs\server\federation\store\protocol\impl\pb\GetMountTableEntriesResponsePBImpl.java,0,17,44,6,0,67
hadoop-trunk\hadoop-trunk\hadoop-mapreduce-project\hadoop-mapreduce-client\hadoop-mapreduce-client-core\src\main\java\org\apache\hadoop\mapred\lib\db\DBConfiguration.java,0,53,2,2,0,57
hadoop-trunk\hadoop-trunk\hadoop-yarn-project\hadoop-yarn\hadoop-yarn-server\hadoop-yarn-server-resourcemanager\src\test\java\org\apache\hadoop\yarn\server\resourcemanager\TestApplicationMasterServiceInterceptor.java,165,40,3,6,0,49
hadoop-trunk\hadoop-trunk\hadoop-yarn-project\hadoop-yarn\hadoop-yarn-server\hadoop-yarn-server-resourcemanager\src\main\java\org\apache\hadoop\yarn\server\resourcemanager\volume\csi\provisioner\VolumeProvisioningTask.java,34,8,1,4,0,13
hadoop-trunk\hadoop-trunk\hadoop-yarn-project\hadoop-yarn\hadoop-yarn-applications\hadoop-yarn-services\hadoop-yarn-services-core\src\main\java\org\apache\hadoop\yarn\service\utils\FilterUtils.java,64,6,4,1,0,11
hadoop-trunk\hadoop-trunk\hadoop-common-project\hadoop-common\src\main\java\org\apache\hadoop\net\ConnectTimeoutException.java,8,3,0,2,0,5
hadoop-trunk\hadoop-trunk\hadoop-yarn-project\hadoop-yarn\hadoop-yarn-server\hadoop-yarn-server-nodemanager\src\main\java\org\apache\hadoop\yarn\server\nodemanager\containermanager\linux\resources\CombinedResourceCalculator.java,79,23,0,2,0,25
hadoop-trunk\hadoop-trunk\hadoop-common-project\hadoop-common\src\test\java\org\apache\hadoop\fs\ftp\FtpTestServer.java,60,21,0,1,0,22
hadoop-trunk\hadoop-trunk\hadoop-mapreduce-project\hadoop-mapreduce-client\hadoop-mapreduce-client-core\src\main\java\org\apache\hadoop\mapred\lib\TokenCountMapper.java,0,11,0,2,0,13
hadoop-trunk\hadoop-trunk\hadoop-tools\hadoop-streaming\src\test\java\org\apache\hadoop\streaming\TestStreamingBadRecords.java,0,148,16,2,0,166
hadoop-trunk\hadoop-trunk\hadoop-yarn-project\hadoop-yarn\hadoop-yarn-server\hadoop-yarn-server-nodemanager\src\main\java\org\apache\hadoop\yarn\server\nodemanager\collectormanager\package-info.java,0,0,0,1,0,1
hadoop-trunk\hadoop-trunk\hadoop-tools\hadoop-aws\src\test\java\org\apache\hadoop\fs\s3a\TestS3AInputStreamRetry.java,179,21,1,8,0,30
hadoop-trunk\hadoop-trunk\hadoop-mapreduce-project\hadoop-mapreduce-client\hadoop-mapreduce-client-jobclient\src\test\java\org\apache\hadoop\mapreduce\lib\output\TestMRSequenceFileAsBinaryOutputFormat.java,172,40,1,2,0,43
hadoop-trunk\hadoop-trunk\hadoop-yarn-project\hadoop-yarn\hadoop-yarn-server\hadoop-yarn-server-common\src\main\java\org\apache\hadoop\yarn\server\federation\store\records\DeleteApplicationHomeSubClusterResponse.java,12,1,1,1,0,3
hadoop-trunk\hadoop-trunk\hadoop-hdfs-project\hadoop-hdfs-rbf\src\main\java\org\apache\hadoop\hdfs\server\federation\router\security\token\package-info.java,0,2,0,2,0,4
hadoop-trunk\hadoop-trunk\hadoop-yarn-project\hadoop-yarn\hadoop-yarn-server\hadoop-yarn-server-resourcemanager\src\main\java\org\apache\hadoop\yarn\server\resourcemanager\scheduler\fair\SchedulingPolicy.java,164,18,4,6,0,28
hadoop-trunk\hadoop-trunk\hadoop-yarn-project\hadoop-yarn\hadoop-yarn-server\hadoop-yarn-server-resourcemanager\src\test\java\org\apache\hadoop\yarn\server\resourcemanager\AppManagerTestBase.java,50,18,5,2,0,25
hadoop-trunk\hadoop-trunk\hadoop-hdfs-project\hadoop-hdfs\src\test\java\org\apache\hadoop\hdfs\server\namenode\sps\TestStoragePolicySatisfierWithStripedFile.java,0,66,6,1,0,73
hadoop-trunk\hadoop-trunk\hadoop-hdfs-project\hadoop-hdfs\src\test\java\org\apache\hadoop\hdfs\server\namenode\TestNameNodeXAttr.java,45,25,0,1,0,26
hadoop-trunk\hadoop-trunk\hadoop-common-project\hadoop-common\src\test\java\org\apache\hadoop\conf\TestConfigurationDeprecation.java,416,91,23,4,0,118
hadoop-trunk\hadoop-trunk\hadoop-hdfs-project\hadoop-hdfs-rbf\src\main\java\org\apache\hadoop\hdfs\server\federation\store\protocol\GetRouterRegistrationRequest.java,21,6,0,2,0,8
hadoop-trunk\hadoop-trunk\hadoop-yarn-project\hadoop-yarn\hadoop-yarn-common\src\main\java\org\apache\hadoop\yarn\api\resource\package-info.java,0,0,0,1,0,1
hadoop-trunk\hadoop-trunk\hadoop-yarn-project\hadoop-yarn\hadoop-yarn-api\src\main\java\org\apache\hadoop\yarn\exceptions\InvalidAuxServiceException.java,9,4,0,1,0,5
hadoop-trunk\hadoop-trunk\hadoop-yarn-project\hadoop-yarn\hadoop-yarn-server\hadoop-yarn-server-resourcemanager\src\main\java\org\apache\hadoop\yarn\server\resourcemanager\scheduler\capacity\ConfiguredNodeLabels.java,58,8,1,2,0,11
hadoop-trunk\hadoop-trunk\hadoop-yarn-project\hadoop-yarn\hadoop-yarn-applications\hadoop-yarn-services\hadoop-yarn-services-core\src\main\java\org\apache\hadoop\yarn\service\impl\pb\service\ClientAMProtocolPB.java,0,1,2,1,0,4
hadoop-trunk\hadoop-trunk\hadoop-yarn-project\hadoop-yarn\hadoop-yarn-server\hadoop-yarn-server-resourcemanager\src\test\java\org\apache\hadoop\yarn\server\resourcemanager\reservation\TestNoOverCommitPolicy.java,50,22,1,5,0,28
hadoop-trunk\hadoop-trunk\hadoop-mapreduce-project\hadoop-mapreduce-client\hadoop-mapreduce-client-app\src\test\java\org\apache\hadoop\mapred\TestTaskAttemptFinishingMonitor.java,65,13,3,2,0,18
hadoop-trunk\hadoop-trunk\hadoop-hdfs-project\hadoop-hdfs\src\main\java\org\apache\hadoop\hdfs\server\common\Storage.java,1355,378,40,14,0,432
hadoop-trunk\hadoop-trunk\hadoop-common-project\hadoop-common\src\main\java\org\apache\hadoop\tools\TableListing.java,248,80,7,1,0,88
hadoop-trunk\hadoop-trunk\hadoop-mapreduce-project\hadoop-mapreduce-client\hadoop-mapreduce-client-hs\src\test\java\org\apache\hadoop\mapreduce\v2\hs\webapp\TestBlocks.java,434,74,9,9,0,92
hadoop-trunk\hadoop-trunk\hadoop-hdfs-project\hadoop-hdfs\src\test\java\org\apache\hadoop\hdfs\server\namenode\TestTransferFsImage.java,163,27,1,4,0,32
hadoop-trunk\hadoop-trunk\hadoop-common-project\hadoop-common\src\test\java\org\apache\hadoop\io\TestEnumSetWritable.java,0,25,3,1,0,29
hadoop-trunk\hadoop-trunk\hadoop-common-project\hadoop-nfs\src\main\java\org\apache\hadoop\portmap\PortmapMapping.java,44,27,0,1,0,28
hadoop-trunk\hadoop-trunk\hadoop-yarn-project\hadoop-yarn\hadoop-yarn-client\src\test\java\org\apache\hadoop\yarn\client\api\impl\TestNMClient.java,616,103,7,5,0,115
hadoop-trunk\hadoop-trunk\hadoop-common-project\hadoop-common\src\main\java\org\apache\hadoop\util\CloseableReferenceCount.java,95,2,3,1,0,6
hadoop-trunk\hadoop-trunk\hadoop-common-project\hadoop-common\src\test\java\org\apache\hadoop\fs\TestFileContextResolveAfs.java,36,12,1,2,0,15
hadoop-trunk\hadoop-trunk\hadoop-mapreduce-project\hadoop-mapreduce-client\hadoop-mapreduce-client-jobclient\src\test\java\org\apache\hadoop\mapred\TestIFile.java,48,16,1,2,0,19
hadoop-trunk\hadoop-trunk\hadoop-tools\hadoop-rumen\src\main\java\org\apache\hadoop\tools\rumen\DeepInequalityException.java,38,14,0,1,0,15
hadoop-trunk\hadoop-trunk\hadoop-yarn-project\hadoop-yarn\hadoop-yarn-server\hadoop-yarn-server-resourcemanager\src\main\java\org\apache\hadoop\yarn\server\resourcemanager\webapp\DeSelectFields.java,102,13,1,1,0,15
hadoop-trunk\hadoop-trunk\hadoop-hdfs-project\hadoop-hdfs-rbf\src\main\java\org\apache\hadoop\hdfs\server\federation\store\records\Query.java,43,3,0,1,0,4
hadoop-trunk\hadoop-trunk\hadoop-yarn-project\hadoop-yarn\hadoop-yarn-server\hadoop-yarn-server-nodemanager\src\main\java\org\apache\hadoop\yarn\server\nodemanager\webapp\ContainerLogsPage.java,274,41,10,4,0,55
hadoop-trunk\hadoop-trunk\hadoop-mapreduce-project\hadoop-mapreduce-client\hadoop-mapreduce-client-core\src\main\java\org\apache\hadoop\mapred\join\TupleWritable.java,0,7,3,2,0,12
hadoop-trunk\hadoop-trunk\hadoop-tools\hadoop-aws\src\test\java\org\apache\hadoop\fs\s3a\fileContext\ITestS3AFileContextURI.java,22,3,2,1,0,6
hadoop-trunk\hadoop-trunk\hadoop-common-project\hadoop-common\src\main\java\org\apache\hadoop\util\CombinedIPList.java,35,9,0,1,0,10
hadoop-trunk\hadoop-trunk\hadoop-common-project\hadoop-auth\src\test\java\org\apache\hadoop\security\authentication\server\TestKerberosAuthenticationHandler.java,0,31,8,3,0,42
hadoop-trunk\hadoop-trunk\hadoop-common-project\hadoop-common\src\main\java\org\apache\hadoop\io\Writable.java,0,11,0,1,0,12
hadoop-trunk\hadoop-trunk\hadoop-hdfs-project\hadoop-hdfs\src\main\java\org\apache\hadoop\hdfs\tools\offlineImageViewer\IndentedImageVisitor.java,0,33,7,2,0,42
hadoop-trunk\hadoop-trunk\hadoop-common-project\hadoop-common\src\main\java\org\apache\hadoop\fs\viewfs\NflyFSystem.java,0,111,28,1,0,140
hadoop-trunk\hadoop-trunk\hadoop-tools\hadoop-sls\src\test\java\org\apache\hadoop\yarn\sls\appmaster\TestAMSimulator.java,321,49,10,4,0,63
hadoop-trunk\hadoop-trunk\hadoop-yarn-project\hadoop-yarn\hadoop-yarn-server\hadoop-yarn-server-nodemanager\src\test\java\org\apache\hadoop\yarn\server\nodemanager\containermanager\linux\runtime\TestDelegatingLinuxContainerRuntime.java,146,17,2,5,0,24
hadoop-trunk\hadoop-trunk\hadoop-yarn-project\hadoop-yarn\hadoop-yarn-client\src\main\java\org\apache\hadoop\yarn\client\api\NMClient.java,242,21,3,1,0,25
hadoop-trunk\hadoop-trunk\hadoop-hdfs-project\hadoop-hdfs-rbf\src\main\java\org\apache\hadoop\hdfs\server\federation\store\protocol\RefreshSuperUserGroupsConfigurationResponse.java,24,6,0,2,0,8
hadoop-trunk\hadoop-trunk\hadoop-tools\hadoop-azure\src\test\java\org\apache\hadoop\fs\azure\TestNativeAzureFileSystemFileNameCheck.java,96,13,3,3,0,19
hadoop-trunk\hadoop-trunk\hadoop-mapreduce-project\hadoop-mapreduce-client\hadoop-mapreduce-client-shuffle\src\main\java\org\apache\hadoop\mapred\ShuffleHandler.java,1276,341,59,25,0,425
hadoop-trunk\hadoop-trunk\hadoop-yarn-project\hadoop-yarn\hadoop-yarn-server\hadoop-yarn-server-sharedcachemanager\src\main\java\org\apache\hadoop\yarn\server\sharedcachemanager\webapp\SCMController.java,15,3,1,1,0,5
hadoop-trunk\hadoop-trunk\hadoop-cloud-storage-project\hadoop-huaweicloud\src\main\java\org\apache\hadoop\fs\obs\OBSIOException.java,0,0,0,1,0,1
hadoop-trunk\hadoop-trunk\hadoop-common-project\hadoop-registry\src\main\java\org\apache\hadoop\registry\client\api\BindFlags.java,0,1,2,1,0,4
hadoop-trunk\hadoop-trunk\hadoop-yarn-project\hadoop-yarn\hadoop-yarn-server\hadoop-yarn-server-resourcemanager\src\main\java\org\apache\hadoop\yarn\server\resourcemanager\scheduler\constraint\package-info.java,0,0,0,1,0,1
hadoop-trunk\hadoop-trunk\hadoop-common-project\hadoop-common\src\main\java\org\apache\hadoop\security\JniBasedUnixGroupsMappingWithFallback.java,41,12,0,1,0,13
hadoop-trunk\hadoop-trunk\hadoop-common-project\hadoop-common\src\main\java\org\apache\hadoop\fs\FsShell.java,375,88,6,1,0,95
hadoop-trunk\hadoop-trunk\hadoop-mapreduce-project\hadoop-mapreduce-client\hadoop-mapreduce-client-core\src\main\java\org\apache\hadoop\mapred\lib\aggregate\ValueAggregatorDescriptor.java,0,13,3,2,0,18
hadoop-trunk\hadoop-trunk\hadoop-hdfs-project\hadoop-hdfs-client\src\main\java\org\apache\hadoop\hdfs\web\oauth2\ConfRefreshTokenBasedAccessTokenProvider.java,0,17,1,3,0,21
hadoop-trunk\hadoop-trunk\hadoop-hdfs-project\hadoop-hdfs-httpfs\src\test\java\org\apache\hadoop\lib\wsrs\TestInputStreamEntity.java,21,2,0,1,0,3
hadoop-trunk\hadoop-trunk\hadoop-tools\hadoop-aws\src\main\java\org\apache\hadoop\fs\s3a\statistics\impl\ForwardingIOStatisticsStore.java,152,30,0,1,0,31
hadoop-trunk\hadoop-trunk\hadoop-hdfs-project\hadoop-hdfs\src\test\java\org\apache\hadoop\hdfs\client\impl\TestBlockReaderIoProvider.java,35,6,1,1,0,8
hadoop-trunk\hadoop-trunk\hadoop-tools\hadoop-azure\src\main\java\org\apache\hadoop\fs\azurebfs\contracts\exceptions\KeyProviderException.java,16,7,1,1,0,9
hadoop-trunk\hadoop-trunk\hadoop-hdfs-project\hadoop-hdfs-client\src\main\java\org\apache\hadoop\hdfs\server\namenode\ha\HAProxyFactory.java,0,4,0,1,0,5
hadoop-trunk\hadoop-trunk\hadoop-mapreduce-project\hadoop-mapreduce-client\hadoop-mapreduce-client-common\src\main\java\org\apache\hadoop\mapreduce\v2\api\protocolrecords\impl\pb\GetTaskAttemptReportResponsePBImpl.java,79,37,33,10,0,80
hadoop-trunk\hadoop-trunk\hadoop-yarn-project\hadoop-yarn\hadoop-yarn-server\hadoop-yarn-server-nodemanager\src\main\java\org\apache\hadoop\yarn\server\nodemanager\containermanager\linux\resources\TrafficControlBandwidthHandlerImpl.java,0,32,16,6,0,54
hadoop-trunk\hadoop-trunk\hadoop-common-project\hadoop-common\src\test\java\org\apache\hadoop\fs\TestFsShellReturnCode.java,558,138,23,9,0,170
hadoop-trunk\hadoop-trunk\hadoop-mapreduce-project\hadoop-mapreduce-client\hadoop-mapreduce-client-app\src\test\java\org\apache\hadoop\mapreduce\jobhistory\TestJobHistoryEventHandler.java,0,294,23,8,0,325
hadoop-trunk\hadoop-trunk\hadoop-hdfs-project\hadoop-hdfs-client\src\main\java\org\apache\hadoop\hdfs\inotify\EventBatch.java,16,11,0,1,0,12
hadoop-trunk\hadoop-trunk\hadoop-yarn-project\hadoop-yarn\hadoop-yarn-common\src\main\java\org\apache\hadoop\yarn\client\RMHAServiceTarget.java,41,10,1,1,0,12
hadoop-trunk\hadoop-trunk\hadoop-common-project\hadoop-common\src\test\java\org\apache\hadoop\util\TestIdentityHashStore.java,130,50,12,1,0,63
hadoop-trunk\hadoop-trunk\hadoop-tools\hadoop-azure\src\test\java\org\apache\hadoop\fs\azure\contract\ITestAzureNativeContractDelete.java,7,2,0,1,0,3
hadoop-trunk\hadoop-trunk\hadoop-yarn-project\hadoop-yarn\hadoop-yarn-server\hadoop-yarn-server-tests\src\test\java\org\apache\hadoop\yarn\server\timeline\TimelineVersion.java,0,2,2,1,0,5
hadoop-trunk\hadoop-trunk\hadoop-mapreduce-project\hadoop-mapreduce-client\hadoop-mapreduce-client-hs\src\main\java\org\apache\hadoop\mapreduce\v2\hs\webapp\HsWebApp.java,0,7,0,1,0,8
hadoop-trunk\hadoop-trunk\hadoop-yarn-project\hadoop-yarn\hadoop-yarn-api\src\main\java\org\apache\hadoop\yarn\api\records\ResourceInformation.java,361,86,1,2,0,89
hadoop-trunk\hadoop-trunk\hadoop-yarn-project\hadoop-yarn\hadoop-yarn-csi\src\test\java\org\apache\hadoop\yarn\csi\adaptor\TestValidateVolumeCapabilityRequest.java,77,2,21,8,0,31
hadoop-trunk\hadoop-trunk\hadoop-hdfs-project\hadoop-hdfs\src\main\java\org\apache\hadoop\hdfs\server\namenode\IsNameNodeActiveServlet.java,10,1,0,1,0,2
hadoop-trunk\hadoop-trunk\hadoop-tools\hadoop-azure\src\test\java\org\apache\hadoop\fs\azure\metrics\ITestAzureFileSystemInstrumentation.java,491,116,16,39,0,171
hadoop-trunk\hadoop-trunk\hadoop-yarn-project\hadoop-yarn\hadoop-yarn-common\src\main\java\org\apache\hadoop\yarn\api\protocolrecords\impl\pb\GetApplicationAttemptsRequestPBImpl.java,101,24,34,3,0,61
hadoop-trunk\hadoop-trunk\hadoop-mapreduce-project\hadoop-mapreduce-client\hadoop-mapreduce-client-core\src\main\java\org\apache\hadoop\mapreduce\jobhistory\JobFinishedEvent.java,151,80,37,1,0,118
hadoop-trunk\hadoop-trunk\hadoop-tools\hadoop-azure\src\test\java\org\apache\hadoop\fs\azure\ITestFileSystemOperationsWithThreads.java,775,157,10,94,0,261
hadoop-trunk\hadoop-trunk\hadoop-yarn-project\hadoop-yarn\hadoop-yarn-common\src\main\java\org\apache\hadoop\yarn\api\records\impl\pb\URLPBImpl.java,138,43,57,1,0,101
hadoop-trunk\hadoop-trunk\hadoop-common-project\hadoop-common\src\main\java\org\apache\hadoop\fs\statistics\impl\DynamicIOStatisticsBuilder.java,212,28,0,1,0,29
hadoop-trunk\hadoop-trunk\hadoop-mapreduce-project\hadoop-mapreduce-client\hadoop-mapreduce-client-core\src\main\java\org\apache\hadoop\mapred\JobProfile.java,0,80,2,1,0,83
hadoop-trunk\hadoop-trunk\hadoop-yarn-project\hadoop-yarn\hadoop-yarn-server\hadoop-yarn-server-router\src\main\java\org\apache\hadoop\yarn\server\router\webapp\FederationBlock.java,0,9,0,3,0,12
hadoop-trunk\hadoop-trunk\hadoop-common-project\hadoop-common\src\test\java\org\apache\hadoop\cli\util\CLITestData.java,82,18,11,1,0,30
hadoop-trunk\hadoop-trunk\hadoop-common-project\hadoop-common\src\test\java\org\apache\hadoop\fs\store\TestDataBlocks.java,98,8,0,1,0,9
hadoop-trunk\hadoop-trunk\hadoop-hdfs-project\hadoop-hdfs-rbf\src\main\java\org\apache\hadoop\hdfs\server\federation\store\protocol\impl\pb\GetNamespaceInfoRequestPBImpl.java,0,8,23,5,0,36
hadoop-trunk\hadoop-trunk\hadoop-mapreduce-project\hadoop-mapreduce-client\hadoop-mapreduce-client-core\src\main\java\org\apache\hadoop\mapreduce\checkpoint\SimpleNamingService.java,18,9,0,1,0,10
hadoop-trunk\hadoop-trunk\hadoop-mapreduce-project\hadoop-mapreduce-client\hadoop-mapreduce-client-app\src\test\java\org\apache\hadoop\mapred\TestLocalContainerLauncher.java,154,28,3,2,0,33
hadoop-trunk\hadoop-trunk\hadoop-tools\hadoop-rumen\src\main\java\org\apache\hadoop\tools\rumen\RackNode.java,0,8,2,1,0,11
hadoop-trunk\hadoop-trunk\hadoop-hdfs-project\hadoop-hdfs\src\main\java\org\apache\hadoop\hdfs\server\protocol\FinalizeCommand.java,16,9,0,1,0,10
hadoop-trunk\hadoop-trunk\hadoop-mapreduce-project\hadoop-mapreduce-client\hadoop-mapreduce-client-core\src\main\java\org\apache\hadoop\mapreduce\lib\output\committer\manifest\files\FileEntry.java,0,28,1,4,0,33
hadoop-trunk\hadoop-trunk\hadoop-yarn-project\hadoop-yarn\hadoop-yarn-server\hadoop-yarn-server-timelineservice\src\main\java\org\apache\hadoop\yarn\server\timelineservice\TimelineContext.java,125,47,0,1,0,48
hadoop-trunk\hadoop-trunk\hadoop-mapreduce-project\hadoop-mapreduce-client\hadoop-mapreduce-client-common\src\main\java\org\apache\hadoop\mapreduce\v2\api\impl\pb\service\MRClientProtocolPBServiceImpl.java,186,74,71,79,0,224
hadoop-trunk\hadoop-trunk\hadoop-hdfs-project\hadoop-hdfs\src\test\java\org\apache\hadoop\tools\FakeRenewer.java,40,19,0,1,0,20
hadoop-trunk\hadoop-trunk\hadoop-cloud-storage-project\hadoop-cos\src\main\java\org\apache\hadoop\fs\cosn\auth\EnvironmentVariableCredentialsProvider.java,0,5,2,1,0,8
hadoop-trunk\hadoop-trunk\hadoop-yarn-project\hadoop-yarn\hadoop-yarn-server\hadoop-yarn-server-nodemanager\src\test\java\org\apache\hadoop\yarn\server\nodemanager\containermanager\deletion\task\TestFileDeletionTask.java,52,14,4,3,0,21
hadoop-trunk\hadoop-trunk\hadoop-mapreduce-project\hadoop-mapreduce-client\hadoop-mapreduce-client-hs\src\main\java\org\apache\hadoop\mapreduce\v2\hs\webapp\HsAttemptsPage.java,60,7,0,3,0,10
hadoop-trunk\hadoop-trunk\hadoop-yarn-project\hadoop-yarn\hadoop-yarn-server\hadoop-yarn-server-nodemanager\src\test\java\org\apache\hadoop\yarn\server\nodemanager\containermanager\scheduler\TestContainerSchedulerBehaviorCompatibility.java,0,7,0,2,0,9
hadoop-trunk\hadoop-trunk\hadoop-yarn-project\hadoop-yarn\hadoop-yarn-server\hadoop-yarn-server-resourcemanager\src\main\java\org\apache\hadoop\yarn\server\resourcemanager\rmnode\RMNodeDecommissioningEvent.java,16,6,0,1,0,7
hadoop-trunk\hadoop-trunk\hadoop-yarn-project\hadoop-yarn\hadoop-yarn-server\hadoop-yarn-server-timelineservice-hbase\hadoop-yarn-server-timelineservice-hbase-common\src\main\java\org\apache\hadoop\yarn\server\timelineservice\storage\application\ApplicationColumnPrefix.java,0,18,3,7,0,28
hadoop-trunk\hadoop-trunk\hadoop-hdfs-project\hadoop-hdfs\src\test\java\org\apache\hadoop\hdfs\TestFetchImage.java,134,28,1,2,0,31
hadoop-trunk\hadoop-trunk\hadoop-common-project\hadoop-common\src\main\java\org\apache\hadoop\io\ArrayFile.java,73,55,7,1,0,63
hadoop-trunk\hadoop-trunk\hadoop-yarn-project\hadoop-yarn\hadoop-yarn-server\hadoop-yarn-server-resourcemanager\src\main\java\org\apache\hadoop\yarn\server\resourcemanager\scheduler\activities\AllocationActivity.java,57,33,2,1,0,36
hadoop-trunk\hadoop-trunk\hadoop-yarn-project\hadoop-yarn\hadoop-yarn-common\src\main\java\org\apache\hadoop\yarn\api\protocolrecords\impl\pb\GetApplicationAttemptReportResponsePBImpl.java,107,24,35,6,0,65
hadoop-trunk\hadoop-trunk\hadoop-yarn-project\hadoop-yarn\hadoop-yarn-server\hadoop-yarn-server-timelineservice-hbase\hadoop-yarn-server-timelineservice-hbase-common\src\main\java\org\apache\hadoop\yarn\server\timelineservice\storage\common\ColumnHelper.java,0,6,3,1,0,10
hadoop-trunk\hadoop-trunk\hadoop-yarn-project\hadoop-yarn\hadoop-yarn-server\hadoop-yarn-server-resourcemanager\src\main\java\org\apache\hadoop\yarn\server\resourcemanager\recovery\records\Epoch.java,40,15,6,2,0,23
hadoop-trunk\hadoop-trunk\hadoop-hdfs-project\hadoop-hdfs\src\main\java\org\apache\hadoop\hdfs\tools\DFSck.java,340,60,29,3,0,92
hadoop-trunk\hadoop-trunk\hadoop-tools\hadoop-streaming\src\test\java\org\apache\hadoop\streaming\TestLoadTypedBytes.java,56,9,8,1,0,18
hadoop-trunk\hadoop-trunk\hadoop-hdfs-project\hadoop-hdfs\src\main\java\org\apache\hadoop\hdfs\server\namenode\startupprogress\StartupProgressView.java,288,58,0,8,0,66
hadoop-trunk\hadoop-trunk\hadoop-hdfs-project\hadoop-hdfs\src\main\java\org\apache\hadoop\hdfs\server\blockmanagement\Host2NodesMap.java,0,87,2,1,0,90
hadoop-trunk\hadoop-trunk\hadoop-common-project\hadoop-common\src\test\java\org\apache\hadoop\security\TestLdapGroupsMappingWithOneQuery.java,0,4,1,1,0,6
hadoop-trunk\hadoop-trunk\hadoop-hdfs-project\hadoop-hdfs\src\main\java\org\apache\hadoop\hdfs\server\datanode\ReplicaBeingWritten.java,72,25,2,1,0,28
hadoop-trunk\hadoop-trunk\hadoop-yarn-project\hadoop-yarn\hadoop-yarn-applications\hadoop-yarn-services\hadoop-yarn-services-core\src\test\java\org\apache\hadoop\yarn\service\client\TestServiceCLI.java,295,64,2,6,0,72
hadoop-trunk\hadoop-trunk\hadoop-yarn-project\hadoop-yarn\hadoop-yarn-server\hadoop-yarn-server-nodemanager\src\main\java\org\apache\hadoop\yarn\server\nodemanager\containermanager\resourceplugin\fpga\package-info.java,0,1,0,2,0,3
hadoop-trunk\hadoop-trunk\hadoop-common-project\hadoop-common\src\main\java\org\apache\hadoop\fs\permission\AclEntryType.java,0,0,0,1,0,1
hadoop-trunk\hadoop-trunk\hadoop-hdfs-project\hadoop-hdfs-client\src\main\java\org\apache\hadoop\hdfs\protocol\ErasureCodingPolicyState.java,0,11,0,1,0,12
hadoop-trunk\hadoop-trunk\hadoop-hdfs-project\hadoop-hdfs\src\main\java\org\apache\hadoop\hdfs\server\namenode\FSDirErasureCodingOp.java,0,33,4,4,0,41
hadoop-trunk\hadoop-trunk\hadoop-hdfs-project\hadoop-hdfs\src\test\java\org\apache\hadoop\hdfs\TestDFSRollback.java,0,89,10,19,0,118
hadoop-trunk\hadoop-trunk\hadoop-yarn-project\hadoop-yarn\hadoop-yarn-server\hadoop-yarn-server-resourcemanager\src\main\java\org\apache\hadoop\yarn\server\resourcemanager\placement\VariableContext.java,235,16,1,2,0,19
hadoop-trunk\hadoop-trunk\hadoop-mapreduce-project\hadoop-mapreduce-client\hadoop-mapreduce-client-core\src\main\java\org\apache\hadoop\mapred\pipes\DownwardProtocol.java,0,24,1,1,0,26
hadoop-trunk\hadoop-trunk\hadoop-yarn-project\hadoop-yarn\hadoop-yarn-common\src\main\java\org\apache\hadoop\yarn\api\records\impl\pb\ResourceSizingPBImpl.java,96,26,35,1,0,62
hadoop-trunk\hadoop-trunk\hadoop-mapreduce-project\hadoop-mapreduce-client\hadoop-mapreduce-client-core\src\main\java\org\apache\hadoop\mapreduce\lib\input\CombineFileSplit.java,154,106,2,1,0,109
hadoop-trunk\hadoop-trunk\hadoop-hdfs-project\hadoop-hdfs\src\test\java\org\apache\hadoop\hdfs\server\namenode\ha\TestBootstrapStandbyWithQJM.java,158,22,3,2,0,27
hadoop-trunk\hadoop-trunk\hadoop-yarn-project\hadoop-yarn\hadoop-yarn-server\hadoop-yarn-server-resourcemanager\src\main\java\org\apache\hadoop\yarn\server\resourcemanager\webapp\dao\helper\package-info.java,0,1,0,1,0,2
hadoop-trunk\hadoop-trunk\hadoop-yarn-project\hadoop-yarn\hadoop-yarn-server\hadoop-yarn-server-resourcemanager\src\main\java\org\apache\hadoop\yarn\server\resourcemanager\DefaultAMSProcessor.java,0,55,13,9,0,77
hadoop-trunk\hadoop-trunk\hadoop-tools\hadoop-aws\src\main\java\org\apache\hadoop\fs\s3a\auth\AwsSignerInitializer.java,0,1,0,1,0,2
hadoop-trunk\hadoop-trunk\hadoop-tools\hadoop-streaming\src\main\java\org\apache\hadoop\streaming\PipeMapRed.java,583,238,51,10,0,299
hadoop-trunk\hadoop-trunk\hadoop-yarn-project\hadoop-yarn\hadoop-yarn-server\hadoop-yarn-server-nodemanager\src\main\java\org\apache\hadoop\yarn\server\nodemanager\containermanager\linux\runtime\LinuxContainerRuntime.java,0,8,2,6,0,16
hadoop-trunk\hadoop-trunk\hadoop-common-project\hadoop-common\src\test\java\org\apache\hadoop\net\TestSocketIOWithTimeout.java,253,57,6,2,0,65
hadoop-trunk\hadoop-trunk\hadoop-hdfs-project\hadoop-hdfs\src\test\java\org\apache\hadoop\TestGenericRefresh.java,189,54,4,20,0,78
hadoop-trunk\hadoop-trunk\hadoop-yarn-project\hadoop-yarn\hadoop-yarn-server\hadoop-yarn-server-nodemanager\src\main\java\org\apache\hadoop\yarn\server\nodemanager\executor\ContainerLivenessContext.java,0,22,2,2,0,26
hadoop-trunk\hadoop-trunk\hadoop-yarn-project\hadoop-yarn\hadoop-yarn-server\hadoop-yarn-server-timelineservice-hbase\hadoop-yarn-server-timelineservice-hbase-common\src\main\java\org\apache\hadoop\yarn\server\timelineservice\storage\application\ApplicationColumn.java,0,16,3,5,0,24
hadoop-trunk\hadoop-trunk\hadoop-yarn-project\hadoop-yarn\hadoop-yarn-common\src\main\java\org\apache\hadoop\yarn\api\records\impl\pb\ReservationRequestPBImpl.java,123,32,48,1,0,81
hadoop-trunk\hadoop-trunk\hadoop-mapreduce-project\hadoop-mapreduce-client\hadoop-mapreduce-client-core\src\main\java\org\apache\hadoop\mapred\TaskUmbilicalProtocol.java,0,51,7,4,0,62
hadoop-trunk\hadoop-trunk\hadoop-hdfs-project\hadoop-hdfs\src\main\java\org\apache\hadoop\hdfs\qjournal\server\JournalNodeMXBean.java,0,3,0,1,0,4
hadoop-trunk\hadoop-trunk\hadoop-common-project\hadoop-common\src\main\java\org\apache\hadoop\fs\permission\FsPermission.java,417,186,13,1,0,200
hadoop-trunk\hadoop-trunk\hadoop-mapreduce-project\hadoop-mapreduce-client\hadoop-mapreduce-client-common\src\main\java\org\apache\hadoop\mapred\LocalJobRunnerMetrics.java,0,13,0,1,0,14
hadoop-trunk\hadoop-trunk\hadoop-yarn-project\hadoop-yarn\hadoop-yarn-server\hadoop-yarn-server-nodemanager\src\main\java\org\apache\hadoop\yarn\server\nodemanager\webapp\NMWebServices.java,606,87,5,12,0,104
hadoop-trunk\hadoop-trunk\hadoop-tools\hadoop-azure\src\test\java\org\apache\hadoop\fs\azure\ITestFileSystemOperationExceptionHandling.java,0,23,1,2,0,26
hadoop-trunk\hadoop-trunk\hadoop-yarn-project\hadoop-yarn\hadoop-yarn-client\src\test\java\org\apache\hadoop\yarn\client\cli\TestRMAdminCLI.java,1013,202,35,24,0,261
hadoop-trunk\hadoop-trunk\hadoop-yarn-project\hadoop-yarn\hadoop-yarn-common\src\main\java\org\apache\hadoop\yarn\webapp\Router.java,0,95,14,2,0,111
hadoop-trunk\hadoop-trunk\hadoop-common-project\hadoop-common\src\main\java\org\apache\hadoop\ha\protocolPB\ZKFCProtocolPB.java,0,6,3,2,0,11
hadoop-trunk\hadoop-trunk\hadoop-yarn-project\hadoop-yarn\hadoop-yarn-server\hadoop-yarn-server-resourcemanager\src\main\java\org\apache\hadoop\yarn\server\resourcemanager\nodelabels\RMNodeLabelsManager.java,539,91,5,2,0,98
hadoop-trunk\hadoop-trunk\hadoop-common-project\hadoop-common\src\main\java\org\apache\hadoop\io\RawComparator.java,0,5,1,3,0,9
hadoop-trunk\hadoop-trunk\hadoop-yarn-project\hadoop-yarn\hadoop-yarn-server\hadoop-yarn-server-resourcemanager\src\main\java\org\apache\hadoop\yarn\server\resourcemanager\scheduler\capacity\conf\CSConfigurationProvider.java,0,1,0,3,0,4
hadoop-trunk\hadoop-trunk\hadoop-yarn-project\hadoop-yarn\hadoop-yarn-server\hadoop-yarn-server-resourcemanager\src\main\java\org\apache\hadoop\yarn\server\resourcemanager\webapp\MetricsOverviewTable.java,202,24,1,10,0,35
hadoop-trunk\hadoop-trunk\hadoop-yarn-project\hadoop-yarn\hadoop-yarn-server\hadoop-yarn-server-nodemanager\src\test\java\org\apache\hadoop\yarn\server\nodemanager\api\protocolrecords\impl\pb\TestPBLocalizerRPC.java,66,10,1,4,0,15
hadoop-trunk\hadoop-trunk\hadoop-hdfs-project\hadoop-hdfs-httpfs\src\main\java\org\apache\hadoop\lib\server\Service.java,0,8,8,3,0,19
hadoop-trunk\hadoop-trunk\hadoop-yarn-project\hadoop-yarn\hadoop-yarn-server\hadoop-yarn-server-nodemanager\src\test\java\org\apache\hadoop\yarn\server\nodemanager\webapp\TestNMWebTerminal.java,75,10,0,2,0,12
hadoop-trunk\hadoop-trunk\hadoop-yarn-project\hadoop-yarn\hadoop-yarn-common\src\main\java\org\apache\hadoop\yarn\util\resource\DominantResourceCalculator.java,612,108,3,2,0,113
hadoop-trunk\hadoop-trunk\hadoop-common-project\hadoop-common\src\test\java\org\apache\hadoop\io\file\tfile\RandomDistribution.java,241,58,9,1,0,68
hadoop-trunk\hadoop-trunk\hadoop-mapreduce-project\hadoop-mapreduce-client\hadoop-mapreduce-client-common\src\main\java\org\apache\hadoop\mapreduce\v2\api\protocolrecords\impl\pb\GetTaskAttemptReportRequestPBImpl.java,79,35,33,7,0,75
hadoop-trunk\hadoop-trunk\hadoop-yarn-project\hadoop-yarn\hadoop-yarn-api\src\main\java\org\apache\hadoop\yarn\api\protocolrecords\GetContainersRequest.java,32,7,0,1,0,8
hadoop-trunk\hadoop-trunk\hadoop-yarn-project\hadoop-yarn\hadoop-yarn-api\src\main\java\org\apache\hadoop\yarn\ams\package-info.java,0,0,0,1,0,1
hadoop-trunk\hadoop-trunk\hadoop-hdfs-project\hadoop-hdfs\src\test\java\org\apache\hadoop\hdfs\web\TestWebHDFSXAttr.java,13,1,0,2,0,3
hadoop-trunk\hadoop-trunk\hadoop-yarn-project\hadoop-yarn\hadoop-yarn-common\src\main\java\org\apache\hadoop\yarn\webapp\view\NavBlock.java,19,2,0,1,0,3
hadoop-trunk\hadoop-trunk\hadoop-yarn-project\hadoop-yarn\hadoop-yarn-api\src\main\java\org\apache\hadoop\yarn\api\records\timeline\TimelineEntity.java,404,120,25,2,0,147
hadoop-trunk\hadoop-trunk\hadoop-yarn-project\hadoop-yarn\hadoop-yarn-server\hadoop-yarn-server-resourcemanager\src\test\java\org\apache\hadoop\yarn\server\resourcemanager\scheduler\capacity\placement\converter\TestLegacyMappingRuleToJson.java,0,24,6,4,0,34
hadoop-trunk\hadoop-trunk\hadoop-tools\hadoop-streaming\src\test\java\org\apache\hadoop\streaming\TestDumpTypedBytes.java,59,7,6,1,0,14
hadoop-trunk\hadoop-trunk\hadoop-common-project\hadoop-common\src\test\java\org\apache\hadoop\ipc\TestProtoBufRpc.java,343,80,61,4,0,145
hadoop-trunk\hadoop-trunk\hadoop-tools\hadoop-aws\src\test\java\org\apache\hadoop\fs\s3a\ITestS3AClientSideEncryptionKms.java,0,7,0,2,0,9
hadoop-trunk\hadoop-trunk\hadoop-tools\hadoop-aws\src\test\java\org\apache\hadoop\fs\s3a\ITestS3ARequesterPays.java,76,7,0,4,0,11
hadoop-trunk\hadoop-trunk\hadoop-common-project\hadoop-common\src\test\java\org\apache\hadoop\security\TestSecurityUtil.java,450,165,20,11,0,196
hadoop-trunk\hadoop-trunk\hadoop-tools\hadoop-aws\src\test\java\org\apache\hadoop\fs\s3a\MockS3ClientFactory.java,21,3,2,1,0,6
hadoop-trunk\hadoop-trunk\hadoop-hdfs-project\hadoop-hdfs\src\test\java\org\apache\hadoop\hdfs\server\datanode\FsDatasetImplTestUtilsFactory.java,0,2,0,2,0,4
hadoop-trunk\hadoop-trunk\hadoop-hdfs-project\hadoop-hdfs-httpfs\src\test\java\org\apache\hadoop\test\HFSTestCase.java,7,1,1,1,0,3
hadoop-trunk\hadoop-trunk\hadoop-tools\hadoop-aliyun\src\main\java\org\apache\hadoop\fs\aliyun\oss\OSSListRequest.java,63,10,1,1,0,12
hadoop-trunk\hadoop-trunk\hadoop-hdfs-project\hadoop-hdfs-httpfs\src\test\java\org\apache\hadoop\test\TestHFSTestCase.java,151,37,3,5,0,45
hadoop-trunk\hadoop-trunk\hadoop-mapreduce-project\hadoop-mapreduce-client\hadoop-mapreduce-client-app\src\main\java\org\apache\hadoop\mapreduce\v2\app\launcher\ContainerLauncherEvent.java,0,54,11,1,0,66
hadoop-trunk\hadoop-trunk\hadoop-common-project\hadoop-common\src\test\java\org\apache\hadoop\test\TestTimedOutTestsListener.java,152,61,7,1,0,69
hadoop-trunk\hadoop-trunk\hadoop-hdfs-project\hadoop-hdfs\src\test\java\org\apache\hadoop\hdfs\TestAbandonBlock.java,92,32,0,4,0,36
hadoop-trunk\hadoop-trunk\hadoop-mapreduce-project\hadoop-mapreduce-client\hadoop-mapreduce-client-common\src\main\java\org\apache\hadoop\mapreduce\v2\api\records\impl\pb\CounterPBImpl.java,80,27,39,1,0,67
hadoop-trunk\hadoop-trunk\hadoop-yarn-project\hadoop-yarn\hadoop-yarn-server\hadoop-yarn-server-nodemanager\src\main\java\org\apache\hadoop\yarn\server\nodemanager\amrmproxy\AMRMProxyApplicationContextImpl.java,123,41,0,1,0,42
hadoop-trunk\hadoop-trunk\hadoop-tools\hadoop-aws\src\test\java\org\apache\hadoop\fs\s3a\StorageStatisticsTracker.java,68,24,0,1,0,25
hadoop-trunk\hadoop-trunk\hadoop-tools\hadoop-azure-datalake\src\test\java\org\apache\hadoop\fs\adl\live\TestAdlFileSystemContractLive.java,30,5,1,1,0,7
hadoop-trunk\hadoop-trunk\hadoop-yarn-project\hadoop-yarn\hadoop-yarn-server\hadoop-yarn-server-common\src\main\java\org\apache\hadoop\yarn\server\api\records\NodeHealthStatus.java,49,12,0,2,0,14
hadoop-trunk\hadoop-trunk\hadoop-yarn-project\hadoop-yarn\hadoop-yarn-server\hadoop-yarn-server-resourcemanager\src\main\java\org\apache\hadoop\yarn\server\resourcemanager\webapp\dao\SchedulerTypeInfo.java,15,6,1,1,0,8
hadoop-trunk\hadoop-trunk\hadoop-common-project\hadoop-common\src\test\java\org\apache\hadoop\fs\contract\AbstractContractRootDirectoryTest.java,220,26,0,6,0,32
hadoop-trunk\hadoop-trunk\hadoop-mapreduce-project\hadoop-mapreduce-client\hadoop-mapreduce-client-core\src\main\java\org\apache\hadoop\mapreduce\lib\map\MultithreadedMapper.java,0,92,8,4,0,104
hadoop-trunk\hadoop-trunk\hadoop-mapreduce-project\hadoop-mapreduce-client\hadoop-mapreduce-client-app\src\main\java\org\apache\hadoop\mapreduce\v2\app\job\event\JobMapTaskRescheduledEvent.java,15,6,0,1,0,7
hadoop-trunk\hadoop-trunk\hadoop-yarn-project\hadoop-yarn\hadoop-yarn-server\hadoop-yarn-server-sharedcachemanager\src\test\java\org\apache\hadoop\yarn\server\sharedcachemanager\TestCleanerTask.java,112,11,0,1,0,12
hadoop-trunk\hadoop-trunk\hadoop-hdfs-project\hadoop-hdfs\src\test\java\org\apache\hadoop\hdfs\web\resources\TestParam.java,540,90,59,4,0,153
hadoop-trunk\hadoop-trunk\hadoop-yarn-project\hadoop-yarn\hadoop-yarn-server\hadoop-yarn-server-resourcemanager\src\main\java\org\apache\hadoop\yarn\server\resourcemanager\scheduler\capacity\CapacitySchedulerQueueContext.java,97,51,0,10,0,61
hadoop-trunk\hadoop-trunk\hadoop-mapreduce-project\hadoop-mapreduce-client\hadoop-mapreduce-client-app\src\main\java\org\apache\hadoop\mapreduce\v2\app\webapp\JobBlock.java,153,21,0,11,0,32
hadoop-trunk\hadoop-trunk\hadoop-common-project\hadoop-common\src\test\java\org\apache\hadoop\fs\contract\AbstractFSContractTestBase.java,0,41,3,2,0,46
hadoop-trunk\hadoop-trunk\hadoop-mapreduce-project\hadoop-mapreduce-client\hadoop-mapreduce-client-app\src\main\java\org\apache\hadoop\mapreduce\v2\app\job\JobStateInternal.java,0,14,0,1,0,15
hadoop-trunk\hadoop-trunk\hadoop-tools\hadoop-azure\src\test\java\org\apache\hadoop\fs\azurebfs\commit\AbstractAbfsClusterITest.java,209,15,3,3,0,21
hadoop-trunk\hadoop-trunk\hadoop-hdfs-project\hadoop-hdfs\src\test\java\org\apache\hadoop\hdfs\server\balancer\TestBalancerWithSaslDataTransfer.java,20,4,0,2,0,6
hadoop-trunk\hadoop-trunk\hadoop-common-project\hadoop-common\src\test\java\org\apache\hadoop\security\TestGroupsCaching.java,0,119,67,4,0,190
hadoop-trunk\hadoop-trunk\hadoop-yarn-project\hadoop-yarn\hadoop-yarn-server\hadoop-yarn-server-timelineservice-hbase\hadoop-yarn-server-timelineservice-hbase-common\src\main\java\org\apache\hadoop\yarn\server\timelineservice\storage\domain\package-info.java,0,0,0,1,0,1
hadoop-trunk\hadoop-trunk\hadoop-common-project\hadoop-common\src\main\java\org\apache\hadoop\fs\LocalFileSystemConfigKeys.java,0,22,0,3,0,25
hadoop-trunk\hadoop-trunk\hadoop-hdfs-project\hadoop-hdfs-client\src\main\java\org\apache\hadoop\hdfs\DFSOutputStream.java,0,228,17,3,0,248
hadoop-trunk\hadoop-trunk\hadoop-common-project\hadoop-common\src\main\java\org\apache\hadoop\metrics2\MetricsJsonBuilder.java,90,37,0,1,0,38
hadoop-trunk\hadoop-trunk\hadoop-mapreduce-project\hadoop-mapreduce-client\hadoop-mapreduce-client-app\src\main\java\org\apache\hadoop\mapreduce\v2\app\webapp\dao\TaskAttemptsInfo.java,20,9,2,2,0,13
hadoop-trunk\hadoop-trunk\hadoop-common-project\hadoop-common\src\test\java\org\apache\hadoop\io\erasurecode\rawcoder\TestRSRawCoder.java,10,1,0,1,0,2
hadoop-trunk\hadoop-trunk\hadoop-mapreduce-project\hadoop-mapreduce-client\hadoop-mapreduce-client-common\src\main\java\org\apache\hadoop\mapreduce\v2\api\protocolrecords\impl\pb\KillTaskAttemptResponsePBImpl.java,33,20,19,5,0,44
hadoop-trunk\hadoop-trunk\hadoop-yarn-project\hadoop-yarn\hadoop-yarn-api\src\main\java\org\apache\hadoop\yarn\api\protocolrecords\RestartContainerResponse.java,9,1,0,1,0,2
hadoop-trunk\hadoop-trunk\hadoop-common-project\hadoop-common\src\test\java\org\apache\hadoop\fs\TestDFVariations.java,0,64,3,3,0,70
hadoop-trunk\hadoop-trunk\hadoop-hdfs-project\hadoop-hdfs-client\src\test\java\org\apache\hadoop\hdfs\client\impl\TestLeaseRenewer.java,247,28,8,1,0,37
hadoop-trunk\hadoop-trunk\hadoop-tools\hadoop-distcp\src\main\java\org\apache\hadoop\tools\mapred\lib\DynamicInputFormat.java,0,98,25,5,0,128
hadoop-trunk\hadoop-trunk\hadoop-yarn-project\hadoop-yarn\hadoop-yarn-server\hadoop-yarn-server-timelineservice\src\main\java\org\apache\hadoop\yarn\server\timelineservice\reader\TimelineEntityFilters.java,0,81,0,7,0,88
hadoop-trunk\hadoop-trunk\hadoop-tools\hadoop-aws\src\test\java\org\apache\hadoop\fs\s3a\test\MinimalOperationCallbacks.java,0,25,3,1,0,29
hadoop-trunk\hadoop-trunk\hadoop-yarn-project\hadoop-yarn\hadoop-yarn-common\src\main\java\org\apache\hadoop\yarn\state\StateTransitionListener.java,0,3,3,1,0,7
hadoop-trunk\hadoop-trunk\hadoop-tools\hadoop-azure\src\main\java\org\apache\hadoop\fs\azurebfs\constants\HttpQueryParams.java,0,21,0,2,0,23
hadoop-trunk\hadoop-trunk\hadoop-yarn-project\hadoop-yarn\hadoop-yarn-server\hadoop-yarn-server-timelineservice-documentstore\src\main\java\org\apache\hadoop\yarn\server\timelineservice\documentstore\reader\cosmosdb\CosmosDBDocumentStoreReader.java,0,59,4,8,0,71
hadoop-trunk\hadoop-trunk\hadoop-mapreduce-project\hadoop-mapreduce-client\hadoop-mapreduce-client-core\src\main\java\org\apache\hadoop\mapred\IFileInputStream.java,212,87,4,1,0,92
hadoop-trunk\hadoop-trunk\hadoop-mapreduce-project\hadoop-mapreduce-client\hadoop-mapreduce-client-core\src\main\java\org\apache\hadoop\mapreduce\lib\output\committer\manifest\stages\SaveTaskManifestStage.java,0,2,1,5,0,8
hadoop-trunk\hadoop-trunk\hadoop-yarn-project\hadoop-yarn\hadoop-yarn-server\hadoop-yarn-server-resourcemanager\src\main\java\org\apache\hadoop\yarn\server\resourcemanager\webapp\dao\LeafQueueTemplateInfo.java,57,23,3,4,0,30
hadoop-trunk\hadoop-trunk\hadoop-tools\hadoop-azure\src\test\java\org\apache\hadoop\fs\azurebfs\ITestAbfsOutputStreamStatistics.java,0,11,2,10,0,23
hadoop-trunk\hadoop-trunk\hadoop-yarn-project\hadoop-yarn\hadoop-yarn-server\hadoop-yarn-server-common\src\main\java\org\apache\hadoop\yarn\server\AMRMClientRelayer.java,521,57,11,7,0,75
hadoop-trunk\hadoop-trunk\hadoop-yarn-project\hadoop-yarn\hadoop-yarn-applications\hadoop-yarn-services\hadoop-yarn-services-core\src\main\java\org\apache\hadoop\yarn\service\provider\tarball\TarballProviderService.java,20,6,0,1,0,7
hadoop-trunk\hadoop-trunk\hadoop-yarn-project\hadoop-yarn\hadoop-yarn-server\hadoop-yarn-server-resourcemanager\src\main\java\org\apache\hadoop\yarn\server\resourcemanager\recovery\RMStateStoreAMRMTokenEvent.java,25,14,0,2,0,16
hadoop-trunk\hadoop-trunk\hadoop-hdfs-project\hadoop-hdfs\src\main\java\org\apache\hadoop\hdfs\server\common\Util.java,0,103,17,5,0,125
hadoop-trunk\hadoop-trunk\hadoop-yarn-project\hadoop-yarn\hadoop-yarn-server\hadoop-yarn-server-resourcemanager\src\main\java\org\apache\hadoop\yarn\server\resourcemanager\security\ReservationsACLsManager.java,34,10,0,1,0,11
hadoop-trunk\hadoop-trunk\hadoop-mapreduce-project\hadoop-mapreduce-client\hadoop-mapreduce-client-app\src\main\java\org\apache\hadoop\mapreduce\v2\app\job\event\JobTaskAttemptCompletedEvent.java,15,8,0,2,0,10
hadoop-trunk\hadoop-trunk\hadoop-hdfs-project\hadoop-hdfs\src\test\java\org\apache\hadoop\hdfs\server\blockmanagement\TestDatanodeDescriptor.java,51,13,3,3,0,19
hadoop-trunk\hadoop-trunk\hadoop-yarn-project\hadoop-yarn\hadoop-yarn-server\hadoop-yarn-server-common\src\test\java\org\apache\hadoop\yarn\server\federation\policies\manager\TestWeightedLocalityPolicyManager.java,45,7,0,3,0,10
hadoop-trunk\hadoop-trunk\hadoop-hdfs-project\hadoop-hdfs\src\main\java\org\apache\hadoop\hdfs\server\datanode\DiskFileCorruptException.java,15,4,0,1,0,5
hadoop-trunk\hadoop-trunk\hadoop-tools\hadoop-azure\src\test\java\org\apache\hadoop\fs\azurebfs\ITestAzureBlobFileSystemRenameUnicode.java,58,12,1,7,0,20
hadoop-trunk\hadoop-trunk\hadoop-common-project\hadoop-common\src\main\java\org\apache\hadoop\security\token\DtFetcher.java,0,7,0,1,0,8
hadoop-trunk\hadoop-trunk\hadoop-yarn-project\hadoop-yarn\hadoop-yarn-server\hadoop-yarn-server-applicationhistoryservice\src\main\java\org\apache\hadoop\yarn\server\timeline\recovery\MemoryTimelineStateStore.java,0,18,1,1,0,20
hadoop-trunk\hadoop-trunk\hadoop-common-project\hadoop-common\src\main\java\org\apache\hadoop\metrics2\lib\DefaultMetricsSystem.java,0,42,2,1,0,45
hadoop-trunk\hadoop-trunk\hadoop-hdfs-project\hadoop-hdfs\src\test\java\org\apache\hadoop\hdfs\server\common\blockaliasmap\impl\TestTextBlockAliasMap.java,0,42,4,3,0,49
hadoop-trunk\hadoop-trunk\hadoop-yarn-project\hadoop-yarn\hadoop-yarn-api\src\main\java\org\apache\hadoop\yarn\api\protocolrecords\GetNodesToAttributesResponse.java,24,4,0,1,0,5
hadoop-trunk\hadoop-trunk\hadoop-mapreduce-project\hadoop-mapreduce-client\hadoop-mapreduce-client-jobclient\src\test\java\org\apache\hadoop\fs\AccumulatingReducer.java,0,26,5,1,0,32
hadoop-trunk\hadoop-trunk\hadoop-hdfs-project\hadoop-hdfs\src\test\java\org\apache\hadoop\hdfs\protocol\datatransfer\TestPacketReceiver.java,83,29,4,2,0,35
hadoop-trunk\hadoop-trunk\hadoop-common-project\hadoop-common\src\test\java\org\apache\hadoop\fs\contract\rawlocal\RawlocalFSContract.java,22,8,0,1,0,9
hadoop-trunk\hadoop-trunk\hadoop-hdfs-project\hadoop-hdfs\src\main\java\org\apache\hadoop\hdfs\server\diskbalancer\DiskBalancerException.java,81,30,0,1,0,31
hadoop-trunk\hadoop-trunk\hadoop-yarn-project\hadoop-yarn\hadoop-yarn-server\hadoop-yarn-server-timelineservice\src\test\java\org\apache\hadoop\yarn\server\timelineservice\reader\TestTimelineReaderWebServices.java,737,152,3,3,0,158
hadoop-trunk\hadoop-trunk\hadoop-common-project\hadoop-common\src\main\java\org\apache\hadoop\io\erasurecode\rawcoder\util\package-info.java,0,2,0,1,0,3
hadoop-trunk\hadoop-trunk\hadoop-hdfs-project\hadoop-hdfs-rbf\src\main\java\org\apache\hadoop\hdfs\server\federation\resolver\order\AvailableSpaceResolver.java,0,22,4,4,0,30
hadoop-trunk\hadoop-trunk\hadoop-hdfs-project\hadoop-hdfs-rbf\src\main\java\org\apache\hadoop\hdfs\server\federation\metrics\NameserviceRPCMBean.java,0,5,0,1,0,6
hadoop-trunk\hadoop-trunk\hadoop-common-project\hadoop-common\src\main\java\org\apache\hadoop\io\LongWritable.java,0,53,8,1,0,62
hadoop-trunk\hadoop-trunk\hadoop-yarn-project\hadoop-yarn\hadoop-yarn-server\hadoop-yarn-server-resourcemanager\src\main\java\org\apache\hadoop\yarn\server\resourcemanager\recovery\Recoverable.java,0,3,1,2,0,6
hadoop-trunk\hadoop-trunk\hadoop-common-project\hadoop-common\src\test\java\org\apache\hadoop\fs\contract\AbstractContractSetTimesTest.java,31,6,3,1,0,10
hadoop-trunk\hadoop-trunk\hadoop-yarn-project\hadoop-yarn\hadoop-yarn-server\hadoop-yarn-server-resourcemanager\src\main\java\org\apache\hadoop\yarn\server\resourcemanager\scheduler\capacity\conf\InMemoryConfigurationStore.java,127,15,3,1,0,19
hadoop-trunk\hadoop-trunk\hadoop-mapreduce-project\hadoop-mapreduce-client\hadoop-mapreduce-client-core\src\main\java\org\apache\hadoop\mapreduce\lib\map\WrappedMapper.java,0,73,7,1,0,81
hadoop-trunk\hadoop-trunk\hadoop-tools\hadoop-aws\src\test\java\org\apache\hadoop\fs\s3a\auth\TestSignerManager.java,534,113,9,2,0,124
hadoop-trunk\hadoop-trunk\hadoop-common-project\hadoop-common\src\main\java\org\apache\hadoop\fs\ByteBufferUtil.java,0,21,1,1,0,23
hadoop-trunk\hadoop-trunk\hadoop-yarn-project\hadoop-yarn\hadoop-yarn-server\hadoop-yarn-server-timelineservice-hbase\hadoop-yarn-server-timelineservice-hbase-common\src\main\java\org\apache\hadoop\yarn\server\timelineservice\storage\subapplication\SubApplicationColumnFamily.java,0,2,0,2,0,4
hadoop-trunk\hadoop-trunk\hadoop-yarn-project\hadoop-yarn\hadoop-yarn-api\src\main\java\org\apache\hadoop\yarn\factory\providers\RecordFactoryProvider.java,40,9,7,1,0,17
hadoop-trunk\hadoop-trunk\hadoop-yarn-project\hadoop-yarn\hadoop-yarn-common\src\main\java\org\apache\hadoop\yarn\server\api\protocolrecords\impl\pb\AddToClusterNodeLabelsResponsePBImpl.java,44,18,18,4,0,40
hadoop-trunk\hadoop-trunk\hadoop-yarn-project\hadoop-yarn\hadoop-yarn-server\hadoop-yarn-server-resourcemanager\src\main\java\org\apache\hadoop\yarn\server\resourcemanager\webapp\dao\AutoQueueTemplatePropertiesInfo.java,17,7,4,2,0,13
hadoop-trunk\hadoop-trunk\hadoop-hdfs-project\hadoop-hdfs-client\src\test\java\org\apache\hadoop\hdfs\web\oauth2\TestAccessTokenTimer.java,33,21,0,1,0,22
hadoop-trunk\hadoop-trunk\hadoop-yarn-project\hadoop-yarn\hadoop-yarn-server\hadoop-yarn-server-resourcemanager\src\main\java\org\apache\hadoop\yarn\server\resourcemanager\scheduler\event\QueueManagementChangeEvent.java,21,12,0,1,0,13
hadoop-trunk\hadoop-trunk\hadoop-common-project\hadoop-common\src\test\java\org\apache\hadoop\util\TestDurationInfo.java,36,6,1,1,0,8
hadoop-trunk\hadoop-trunk\hadoop-yarn-project\hadoop-yarn\hadoop-yarn-server\hadoop-yarn-server-timeline-pluginstorage\src\main\java\org\apache\hadoop\yarn\server\timeline\EntityCacheItem.java,125,14,1,1,0,16
hadoop-trunk\hadoop-trunk\hadoop-common-project\hadoop-common\src\test\java\org\apache\hadoop\fs\TestFSMainOperationsLocalFileSystem.java,37,10,1,2,0,13
hadoop-trunk\hadoop-trunk\hadoop-tools\hadoop-dynamometer\hadoop-dynamometer-infra\src\main\java\org\apache\hadoop\tools\dynamometer\DynoInfraUtils.java,0,72,18,2,0,92
hadoop-trunk\hadoop-trunk\hadoop-yarn-project\hadoop-yarn\hadoop-yarn-server\hadoop-yarn-server-nodemanager\src\main\java\org\apache\hadoop\yarn\server\nodemanager\health\TimedHealthReporterService.java,0,29,1,1,0,31
hadoop-trunk\hadoop-trunk\hadoop-tools\hadoop-aws\src\main\java\org\apache\hadoop\fs\s3a\audit\impl\NoopAuditor.java,67,6,0,2,0,8
hadoop-trunk\hadoop-trunk\hadoop-yarn-project\hadoop-yarn\hadoop-yarn-server\hadoop-yarn-server-resourcemanager\src\main\java\org\apache\hadoop\yarn\server\resourcemanager\monitor\invariants\InvariantViolationException.java,11,5,0,1,0,6
hadoop-trunk\hadoop-trunk\hadoop-tools\hadoop-azure\src\main\java\org\apache\hadoop\fs\azure\SASKeyGenerationException.java,17,8,0,1,0,9
hadoop-trunk\hadoop-trunk\hadoop-yarn-project\hadoop-yarn\hadoop-yarn-server\hadoop-yarn-server-web-proxy\src\test\java\org\apache\hadoop\yarn\server\webproxy\amfilter\TestAmFilter.java,288,51,10,4,0,65
hadoop-trunk\hadoop-trunk\hadoop-hdfs-project\hadoop-hdfs-rbf\src\main\java\org\apache\hadoop\hdfs\server\federation\store\driver\impl\StateStoreFileSystemImpl.java,135,20,2,1,0,23
hadoop-trunk\hadoop-trunk\hadoop-mapreduce-project\hadoop-mapreduce-client\hadoop-mapreduce-client-core\src\main\java\org\apache\hadoop\mapreduce\lib\output\committer\manifest\files\EntryStatus.java,0,9,0,1,0,10
hadoop-trunk\hadoop-trunk\hadoop-mapreduce-project\hadoop-mapreduce-client\hadoop-mapreduce-client-app\src\test\java\org\apache\hadoop\mapreduce\v2\app\TestCheckpointPreemptionPolicy.java,269,75,7,7,0,89
hadoop-trunk\hadoop-trunk\hadoop-cloud-storage-project\hadoop-cos\src\main\java\org\apache\hadoop\fs\cosn\CosNConfigKeys.java,59,30,0,1,0,31
hadoop-trunk\hadoop-trunk\hadoop-hdfs-project\hadoop-hdfs-rbf\src\test\java\org\apache\hadoop\fs\contract\router\TestRouterHDFSContractAppendSecure.java,0,4,0,1,0,5
hadoop-trunk\hadoop-trunk\hadoop-tools\hadoop-azure\src\test\java\org\apache\hadoop\fs\azure\TestBlobMetadata.java,231,17,4,1,0,22
hadoop-trunk\hadoop-trunk\hadoop-cloud-storage-project\hadoop-huaweicloud\src\test\java\org\apache\hadoop\fs\obs\TestOBSContractRootDir.java,8,1,0,1,0,2
hadoop-trunk\hadoop-trunk\hadoop-yarn-project\hadoop-yarn\hadoop-yarn-common\src\main\java\org\apache\hadoop\yarn\logaggregation\filecontroller\package-info.java,0,1,0,1,0,2
hadoop-trunk\hadoop-trunk\hadoop-yarn-project\hadoop-yarn\hadoop-yarn-server\hadoop-yarn-server-applicationhistoryservice\src\main\java\org\apache\hadoop\yarn\server\applicationhistoryservice\webapp\AHSController.java,40,12,0,1,0,13
hadoop-trunk\hadoop-trunk\hadoop-hdfs-project\hadoop-hdfs-rbf\src\test\java\org\apache\hadoop\fs\contract\router\TestRouterHDFSContractDelegationToken.java,0,7,3,4,0,14
hadoop-trunk\hadoop-trunk\hadoop-hdfs-project\hadoop-hdfs\src\main\java\org\apache\hadoop\hdfs\server\namenode\FSEditLogLoader.java,1318,286,22,17,0,325
hadoop-trunk\hadoop-trunk\hadoop-mapreduce-project\hadoop-mapreduce-client\hadoop-mapreduce-client-core\src\main\java\org\apache\hadoop\mapred\DeprecatedQueueConfigurationParser.java,0,24,6,1,0,31
hadoop-trunk\hadoop-trunk\hadoop-yarn-project\hadoop-yarn\hadoop-yarn-server\hadoop-yarn-server-common\src\main\java\org\apache\hadoop\yarn\server\federation\policies\FederationPolicyInitializationContext.java,103,17,0,3,0,20
hadoop-trunk\hadoop-trunk\hadoop-yarn-project\hadoop-yarn\hadoop-yarn-server\hadoop-yarn-server-resourcemanager\src\main\java\org\apache\hadoop\yarn\server\resourcemanager\scheduler\capacity\CapacityScheduler.java,0,459,91,91,0,641
hadoop-trunk\hadoop-trunk\hadoop-mapreduce-project\hadoop-mapreduce-client\hadoop-mapreduce-client-jobclient\src\test\java\org\apache\hadoop\mapred\lib\TestKeyFieldBasedComparator.java,124,38,8,3,0,49
hadoop-trunk\hadoop-trunk\hadoop-hdfs-project\hadoop-hdfs-client\src\main\java\org\apache\hadoop\hdfs\server\datanode\ReplicaNotFoundException.java,33,21,0,2,0,23
hadoop-trunk\hadoop-trunk\hadoop-mapreduce-project\hadoop-mapreduce-client\hadoop-mapreduce-client-app\src\main\java\org\apache\hadoop\mapreduce\v2\app\job\event\TaskAttemptEventType.java,0,20,0,1,0,21
hadoop-trunk\hadoop-trunk\hadoop-common-project\hadoop-common\src\main\java\org\apache\hadoop\tools\protocolPB\GetUserMappingsProtocolClientSideTranslatorPB.java,0,13,6,3,0,22
hadoop-trunk\hadoop-trunk\hadoop-hdfs-project\hadoop-hdfs-nfs\src\main\java\org\apache\hadoop\hdfs\nfs\mount\RpcProgramMountd.java,220,46,12,1,0,59
hadoop-trunk\hadoop-trunk\hadoop-hdfs-project\hadoop-hdfs\src\test\java\org\apache\hadoop\hdfs\ParameterizedTestDFSStripedOutputStreamWithFailureWithRandomECPolicy.java,21,5,1,1,0,7
hadoop-trunk\hadoop-trunk\hadoop-common-project\hadoop-common\src\main\java\org\apache\hadoop\service\launcher\HadoopUncaughtExceptionHandler.java,0,8,7,1,0,16
hadoop-trunk\hadoop-trunk\hadoop-hdfs-project\hadoop-hdfs\src\test\java\org\apache\hadoop\hdfs\tools\TestViewFileSystemOverloadSchemeWithFSCommands.java,120,24,3,1,0,28
hadoop-trunk\hadoop-trunk\hadoop-hdfs-project\hadoop-hdfs\src\main\java\org\apache\hadoop\hdfs\tools\offlineEditsViewer\OfflineEditsXmlLoader.java,0,63,21,6,0,90
hadoop-trunk\hadoop-trunk\hadoop-common-project\hadoop-common\src\main\java\org\apache\hadoop\io\ElasticByteBufferPool.java,0,18,5,1,0,24
hadoop-trunk\hadoop-trunk\hadoop-yarn-project\hadoop-yarn\hadoop-yarn-server\hadoop-yarn-server-resourcemanager\src\test\java\org\apache\hadoop\yarn\server\resourcemanager\scheduler\fair\PeriodGroupsMapping.java,25,8,0,1,0,9
hadoop-trunk\hadoop-trunk\hadoop-common-project\hadoop-auth\src\test\java\org\apache\hadoop\security\authentication\server\LdapConstants.java,0,3,0,1,0,4
hadoop-trunk\hadoop-trunk\hadoop-tools\hadoop-aws\src\main\java\org\apache\hadoop\fs\s3a\commit\PathCommitException.java,18,13,0,1,0,14
hadoop-trunk\hadoop-trunk\hadoop-hdfs-project\hadoop-hdfs-rbf\src\main\java\org\apache\hadoop\hdfs\server\federation\router\RouterClientProtocol.java,2104,345,39,12,0,396
hadoop-trunk\hadoop-trunk\hadoop-common-project\hadoop-common\src\main\java\org\apache\hadoop\crypto\key\kms\KMSDelegationToken.java,0,5,0,2,0,7
hadoop-trunk\hadoop-trunk\hadoop-hdfs-project\hadoop-hdfs\src\main\java\org\apache\hadoop\hdfs\qjournal\protocolPB\InterQJournalProtocolServerSideTranslatorPB.java,26,8,6,3,0,17
hadoop-trunk\hadoop-trunk\hadoop-hdfs-project\hadoop-hdfs\src\test\java\org\apache\hadoop\hdfs\server\namenode\snapshot\TestSnapRootDescendantDiff.java,47,5,0,1,0,6
hadoop-trunk\hadoop-trunk\hadoop-hdfs-project\hadoop-hdfs-client\src\main\java\org\apache\hadoop\hdfs\protocolPB\ClientDatanodeProtocolPB.java,0,0,3,2,0,5
hadoop-trunk\hadoop-trunk\hadoop-hdfs-project\hadoop-hdfs-rbf\src\test\java\org\apache\hadoop\hdfs\server\federation\metrics\TestRBFMetrics.java,342,16,0,3,0,19
hadoop-trunk\hadoop-trunk\hadoop-yarn-project\hadoop-yarn\hadoop-yarn-server\hadoop-yarn-server-resourcemanager\src\test\java\org\apache\hadoop\yarn\server\resourcemanager\reservation\TestReservationSystemUtil.java,100,30,0,2,0,32
hadoop-trunk\hadoop-trunk\hadoop-yarn-project\hadoop-yarn\hadoop-yarn-server\hadoop-yarn-server-timelineservice\src\main\java\org\apache\hadoop\yarn\server\timelineservice\reader\TimelineParser.java,0,0,0,2,0,2
hadoop-trunk\hadoop-trunk\hadoop-hdfs-project\hadoop-hdfs\src\main\java\org\apache\hadoop\hdfs\server\protocol\BlockReportContext.java,47,17,0,1,0,18
hadoop-trunk\hadoop-trunk\hadoop-tools\hadoop-azure\src\test\java\org\apache\hadoop\fs\azurebfs\constants\package-info.java,0,2,1,1,0,4
hadoop-trunk\hadoop-trunk\hadoop-mapreduce-project\hadoop-mapreduce-client\hadoop-mapreduce-client-common\src\main\java\org\apache\hadoop\mapreduce\v2\api\protocolrecords\KillTaskResponse.java,0,0,0,1,0,1
hadoop-trunk\hadoop-trunk\hadoop-yarn-project\hadoop-yarn\hadoop-yarn-server\hadoop-yarn-server-resourcemanager\src\test\java\org\apache\hadoop\yarn\server\resourcemanager\monitor\capacity\mockframework\MockNodeLabelsManager.java,0,14,1,7,0,22
hadoop-trunk\hadoop-trunk\hadoop-tools\hadoop-rumen\src\main\java\org\apache\hadoop\tools\rumen\AbstractClusterStory.java,152,59,5,1,0,65
hadoop-trunk\hadoop-trunk\hadoop-mapreduce-project\hadoop-mapreduce-client\hadoop-mapreduce-client-jobclient\src\test\java\org\apache\hadoop\mapreduce\security\TestJHSSecurity.java,230,41,10,6,0,57
hadoop-trunk\hadoop-trunk\hadoop-hdfs-project\hadoop-hdfs\src\main\java\org\apache\hadoop\hdfs\tools\offlineImageViewer\PBImageDelimitedTextWriter.java,153,44,14,5,0,63
hadoop-trunk\hadoop-trunk\hadoop-yarn-project\hadoop-yarn\hadoop-yarn-server\hadoop-yarn-server-resourcemanager\src\main\java\org\apache\hadoop\yarn\server\resourcemanager\recovery\RMStateStoreEvent.java,6,3,0,1,0,4
hadoop-trunk\hadoop-trunk\hadoop-yarn-project\hadoop-yarn\hadoop-yarn-server\hadoop-yarn-server-resourcemanager\src\main\java\org\apache\hadoop\yarn\server\resourcemanager\scheduler\fifo\FifoScheduler.java,894,250,35,34,0,319
hadoop-trunk\hadoop-trunk\hadoop-hdfs-project\hadoop-hdfs-httpfs\src\main\java\org\apache\hadoop\lib\wsrs\Parameters.java,51,15,1,3,0,19
hadoop-trunk\hadoop-trunk\hadoop-yarn-project\hadoop-yarn\hadoop-yarn-server\hadoop-yarn-server-resourcemanager\src\main\java\org\apache\hadoop\yarn\server\resourcemanager\metrics\AbstractSystemMetricsPublisher.java,0,30,2,1,0,33
hadoop-trunk\hadoop-trunk\hadoop-yarn-project\hadoop-yarn\hadoop-yarn-common\src\main\java\org\apache\hadoop\yarn\api\protocolrecords\impl\pb\RenewDelegationTokenResponsePBImpl.java,63,25,27,3,0,55
hadoop-trunk\hadoop-trunk\hadoop-tools\hadoop-gridmix\src\test\java\org\apache\hadoop\mapred\gridmix\CommonJobTest.java,328,63,11,17,0,91
hadoop-trunk\hadoop-trunk\hadoop-yarn-project\hadoop-yarn\hadoop-yarn-common\src\main\java\org\apache\hadoop\yarn\server\api\protocolrecords\impl\pb\RefreshServiceAclsRequestPBImpl.java,44,20,18,3,0,41
hadoop-trunk\hadoop-trunk\hadoop-hdfs-project\hadoop-hdfs\src\test\java\org\apache\hadoop\fs\contract\hdfs\TestHDFSContractPathHandle.java,0,8,0,1,0,9
hadoop-trunk\hadoop-trunk\hadoop-common-project\hadoop-registry\src\main\java\org\apache\hadoop\registry\client\impl\package-info.java,0,0,0,1,0,1
hadoop-trunk\hadoop-trunk\hadoop-yarn-project\hadoop-yarn\hadoop-yarn-server\hadoop-yarn-server-resourcemanager\src\test\java\org\apache\hadoop\yarn\server\resourcemanager\TestRMHAMetrics.java,61,8,1,1,0,10
hadoop-trunk\hadoop-trunk\hadoop-yarn-project\hadoop-yarn\hadoop-yarn-server\hadoop-yarn-server-resourcemanager\src\main\java\org\apache\hadoop\yarn\server\resourcemanager\reservation\SharingPolicy.java,0,3,0,2,0,5
hadoop-trunk\hadoop-trunk\hadoop-yarn-project\hadoop-yarn\hadoop-yarn-server\hadoop-yarn-server-timelineservice-hbase\hadoop-yarn-server-timelineservice-hbase-client\src\main\java\org\apache\hadoop\yarn\server\timelineservice\storage\reader\TimelineEntityReader.java,434,43,1,13,0,57
hadoop-trunk\hadoop-trunk\hadoop-hdfs-project\hadoop-hdfs-client\src\main\java\org\apache\hadoop\hdfs\client\BlockReportOptions.java,0,23,2,3,0,28
hadoop-trunk\hadoop-trunk\hadoop-common-project\hadoop-common\src\main\java\org\apache\hadoop\io\file\tfile\TFileDumper.java,0,34,12,3,0,49
hadoop-trunk\hadoop-trunk\hadoop-common-project\hadoop-common\src\main\java\org\apache\hadoop\io\BoundedByteArrayOutputStream.java,107,41,6,1,0,48
hadoop-trunk\hadoop-trunk\hadoop-hdfs-project\hadoop-hdfs-client\src\main\java\org\apache\hadoop\hdfs\protocol\LocatedStripedBlock.java,59,24,0,1,0,25
hadoop-trunk\hadoop-trunk\hadoop-tools\hadoop-distcp\src\main\java\org\apache\hadoop\tools\util\WorkRequestProcessor.java,0,3,1,1,0,5
hadoop-trunk\hadoop-trunk\hadoop-common-project\hadoop-common\src\main\java\org\apache\hadoop\io\erasurecode\ErasureCodecOptions.java,12,6,0,1,0,7
hadoop-trunk\hadoop-trunk\hadoop-mapreduce-project\hadoop-mapreduce-client\hadoop-mapreduce-client-common\src\main\java\org\apache\hadoop\mapreduce\v2\util\package-info.java,0,1,0,1,0,2
hadoop-trunk\hadoop-trunk\hadoop-yarn-project\hadoop-yarn\hadoop-yarn-api\src\main\java\org\apache\hadoop\yarn\api\protocolrecords\UpdateApplicationPriorityRequest.java,39,10,0,2,0,12
hadoop-trunk\hadoop-trunk\hadoop-yarn-project\hadoop-yarn\hadoop-yarn-server\hadoop-yarn-server-common\src\main\java\org\apache\hadoop\yarn\server\federation\store\records\impl\pb\SubClusterHeartbeatRequestPBImpl.java,0,31,54,6,0,91
hadoop-trunk\hadoop-trunk\hadoop-mapreduce-project\hadoop-mapreduce-client\hadoop-mapreduce-client-nativetask\src\main\java\org\apache\hadoop\mapred\nativetask\handlers\NativeCollectorOnlyHandler.java,0,48,1,8,0,57
hadoop-trunk\hadoop-trunk\hadoop-tools\hadoop-distcp\src\test\java\org\apache\hadoop\tools\TestCopyListing.java,0,55,10,3,0,68
hadoop-trunk\hadoop-trunk\hadoop-common-project\hadoop-nfs\src\main\java\org\apache\hadoop\nfs\nfs3\Nfs3Interface.java,0,23,22,1,0,46
hadoop-trunk\hadoop-trunk\hadoop-common-project\hadoop-common\src\main\java\org\apache\hadoop\service\launcher\LauncherArguments.java,0,3,7,1,0,11
hadoop-trunk\hadoop-trunk\hadoop-tools\hadoop-rumen\src\main\java\org\apache\hadoop\tools\rumen\JobHistoryParserFactory.java,47,11,1,3,0,15
hadoop-trunk\hadoop-trunk\hadoop-yarn-project\hadoop-yarn\hadoop-yarn-client\src\main\java\org\apache\hadoop\yarn\client\api\YarnClientApplication.java,0,11,0,1,0,12
hadoop-trunk\hadoop-trunk\hadoop-mapreduce-project\hadoop-mapreduce-client\hadoop-mapreduce-client-core\src\main\java\org\apache\hadoop\mapred\ReduceTask.java,583,251,44,10,0,305
hadoop-trunk\hadoop-trunk\hadoop-yarn-project\hadoop-yarn\hadoop-yarn-server\hadoop-yarn-server-applicationhistoryservice\src\main\java\org\apache\hadoop\yarn\server\applicationhistoryservice\webapp\AHSView.java,33,8,1,1,0,10
hadoop-trunk\hadoop-trunk\hadoop-tools\hadoop-aws\src\test\java\org\apache\hadoop\fs\s3a\performance\ITestS3AMiscOperationCost.java,124,8,5,4,0,17
hadoop-trunk\hadoop-trunk\hadoop-common-project\hadoop-common\src\main\java\org\apache\hadoop\io\UTF8.java,334,158,10,2,0,170
hadoop-trunk\hadoop-trunk\hadoop-yarn-project\hadoop-yarn\hadoop-yarn-server\hadoop-yarn-server-router\src\main\java\org\apache\hadoop\yarn\server\router\clientrm\package-info.java,0,0,0,1,0,1
hadoop-trunk\hadoop-trunk\hadoop-common-project\hadoop-common\src\main\java\org\apache\hadoop\security\alias\LocalKeyStoreProvider.java,146,23,13,1,0,37
hadoop-trunk\hadoop-trunk\hadoop-common-project\hadoop-common\src\test\java\org\apache\hadoop\io\retry\TestConnectionRetryPolicy.java,122,9,1,1,0,11
hadoop-trunk\hadoop-trunk\hadoop-yarn-project\hadoop-yarn\hadoop-yarn-server\hadoop-yarn-server-resourcemanager\src\main\java\org\apache\hadoop\yarn\server\resourcemanager\webapp\dao\QueueCapacitiesInfo.java,81,31,2,4,0,37
hadoop-trunk\hadoop-trunk\hadoop-yarn-project\hadoop-yarn\hadoop-yarn-api\src\main\java\org\apache\hadoop\yarn\api\records\timeline\TimelineHealth.java,48,22,1,1,0,24
hadoop-trunk\hadoop-trunk\hadoop-mapreduce-project\hadoop-mapreduce-client\hadoop-mapreduce-client-jobclient\src\test\java\org\apache\hadoop\fs\slive\ReadOp.java,0,8,3,1,0,12
hadoop-trunk\hadoop-trunk\hadoop-yarn-project\hadoop-yarn\hadoop-yarn-api\src\test\java\org\apache\hadoop\yarn\util\TestUnitsConversionUtil.java,0,51,2,1,0,54
hadoop-trunk\hadoop-trunk\hadoop-common-project\hadoop-common\src\test\java\org\apache\hadoop\fs\loadGenerator\StructureGenerator.java,256,187,11,3,0,201
hadoop-trunk\hadoop-trunk\hadoop-yarn-project\hadoop-yarn\hadoop-yarn-server\hadoop-yarn-server-timelineservice-hbase\hadoop-yarn-server-timelineservice-hbase-common\src\main\java\org\apache\hadoop\yarn\server\timelineservice\storage\package-info.java,0,0,0,1,0,1
hadoop-trunk\hadoop-trunk\hadoop-common-project\hadoop-registry\src\main\java\org\apache\hadoop\registry\server\dns\ServiceRecordProcessor.java,0,0,0,1,0,1
hadoop-trunk\hadoop-trunk\hadoop-mapreduce-project\hadoop-mapreduce-client\hadoop-mapreduce-client-jobclient\src\test\java\org\apache\hadoop\mapreduce\lib\input\TestMRCJCFileInputFormat.java,191,66,6,2,0,74
hadoop-trunk\hadoop-trunk\hadoop-yarn-project\hadoop-yarn\hadoop-yarn-server\hadoop-yarn-server-resourcemanager\src\main\java\org\apache\hadoop\yarn\server\resourcemanager\scheduler\constraint\processor\DisabledPlacementProcessor.java,43,9,0,4,0,13
hadoop-trunk\hadoop-trunk\hadoop-yarn-project\hadoop-yarn\hadoop-yarn-common\src\main\java\org\apache\hadoop\yarn\api\records\impl\pb\ApplicationIdPBImpl.java,54,18,21,1,0,40
hadoop-trunk\hadoop-trunk\hadoop-yarn-project\hadoop-yarn\hadoop-yarn-server\hadoop-yarn-server-resourcemanager\src\main\java\org\apache\hadoop\yarn\server\resourcemanager\security\GenericQueueACLsManager.java,24,17,2,2,0,21
hadoop-trunk\hadoop-trunk\hadoop-yarn-project\hadoop-yarn\hadoop-yarn-server\hadoop-yarn-server-nodemanager\src\test\java\org\apache\hadoop\yarn\server\nodemanager\amrmproxy\TestAMRMProxyMetrics.java,127,5,1,3,0,9
hadoop-trunk\hadoop-trunk\hadoop-hdfs-project\hadoop-hdfs\src\main\java\org\apache\hadoop\hdfs\server\namenode\FSDirectory.java,1976,479,47,27,0,553
hadoop-trunk\hadoop-trunk\hadoop-yarn-project\hadoop-yarn\hadoop-yarn-server\hadoop-yarn-server-resourcemanager\src\main\java\org\apache\hadoop\yarn\server\resourcemanager\placement\PrimaryGroupPlacementRule.java,62,8,2,6,0,16
hadoop-trunk\hadoop-trunk\hadoop-hdfs-project\hadoop-hdfs-rbf\src\main\java\org\apache\hadoop\hdfs\server\federation\store\StateStoreCache.java,0,0,0,1,0,1
hadoop-trunk\hadoop-trunk\hadoop-mapreduce-project\hadoop-mapreduce-client\hadoop-mapreduce-client-jobclient\src\test\java\org\apache\hadoop\mapred\TestFileOutputFormat.java,133,25,9,1,0,35
hadoop-trunk\hadoop-trunk\hadoop-yarn-project\hadoop-yarn\hadoop-yarn-server\hadoop-yarn-server-resourcemanager\src\test\java\org\apache\hadoop\yarn\server\resourcemanager\scheduler\TestPartitionQueueMetrics.java,719,623,5,16,0,644
hadoop-trunk\hadoop-trunk\hadoop-yarn-project\hadoop-yarn\hadoop-yarn-server\hadoop-yarn-server-router\src\main\java\org\apache\hadoop\yarn\server\router\webapp\RouterController.java,34,10,0,1,0,11
hadoop-trunk\hadoop-trunk\hadoop-mapreduce-project\hadoop-mapreduce-client\hadoop-mapreduce-client-nativetask\src\main\java\org\apache\hadoop\mapred\nativetask\buffer\DataInputStream.java,4,1,0,1,0,2
hadoop-trunk\hadoop-trunk\hadoop-yarn-project\hadoop-yarn\hadoop-yarn-server\hadoop-yarn-server-common\src\main\java\org\apache\hadoop\yarn\server\federation\store\utils\FederationPolicyStoreInputValidator.java,0,6,0,5,0,11
hadoop-trunk\hadoop-trunk\hadoop-tools\hadoop-aliyun\src\main\java\org\apache\hadoop\fs\aliyun\oss\AliyunOSSFileReaderTask.java,72,15,2,1,0,18
hadoop-trunk\hadoop-trunk\hadoop-yarn-project\hadoop-yarn\hadoop-yarn-server\hadoop-yarn-server-common\src\main\java\org\apache\hadoop\yarn\server\api\records\MasterKey.java,0,4,0,1,0,5
hadoop-trunk\hadoop-trunk\hadoop-hdfs-project\hadoop-hdfs-httpfs\src\main\java\org\apache\hadoop\lib\servlet\ServerWebApp.java,0,40,0,1,0,41
hadoop-trunk\hadoop-trunk\hadoop-yarn-project\hadoop-yarn\hadoop-yarn-server\hadoop-yarn-server-common\src\main\java\org\apache\hadoop\yarn\server\webapp\AppsBlock.java,182,24,1,5,0,30
hadoop-trunk\hadoop-trunk\hadoop-yarn-project\hadoop-yarn\hadoop-yarn-server\hadoop-yarn-server-nodemanager\src\test\java\org\apache\hadoop\yarn\server\nodemanager\executor\TestContainerReapContext.java,26,10,1,2,0,13
hadoop-trunk\hadoop-trunk\hadoop-hdfs-project\hadoop-hdfs\src\main\java\org\apache\hadoop\hdfs\server\namenode\CachePool.java,0,87,0,1,0,88
hadoop-trunk\hadoop-trunk\hadoop-mapreduce-project\hadoop-mapreduce-client\hadoop-mapreduce-client-core\src\main\java\org\apache\hadoop\mapreduce\lib\output\committer\manifest\stages\StageConfig.java,514,23,2,6,0,31
hadoop-trunk\hadoop-trunk\hadoop-mapreduce-project\hadoop-mapreduce-client\hadoop-mapreduce-client-nativetask\src\main\java\org\apache\hadoop\mapred\nativetask\handlers\CombinerHandler.java,0,29,1,6,0,36
hadoop-trunk\hadoop-trunk\hadoop-yarn-project\hadoop-yarn\hadoop-yarn-api\src\main\java\org\apache\hadoop\yarn\server\api\protocolrecords\RefreshClusterMaxPriorityResponse.java,11,2,1,1,0,4
hadoop-trunk\hadoop-trunk\hadoop-common-project\hadoop-common\src\test\java\org\apache\hadoop\security\token\delegation\web\TestDelegationTokenManager.java,47,10,1,1,0,12
hadoop-trunk\hadoop-trunk\hadoop-yarn-project\hadoop-yarn\hadoop-yarn-server\hadoop-yarn-server-nodemanager\src\test\java\org\apache\hadoop\yarn\server\nodemanager\containermanager\localizer\FakeFSDataInputStream.java,0,25,3,1,0,29
hadoop-trunk\hadoop-trunk\hadoop-yarn-project\hadoop-yarn\hadoop-yarn-server\hadoop-yarn-server-resourcemanager\src\main\java\org\apache\hadoop\yarn\server\resourcemanager\metrics\SystemMetricsPublisher.java,0,10,0,2,0,12
hadoop-trunk\hadoop-trunk\hadoop-mapreduce-project\hadoop-mapreduce-client\hadoop-mapreduce-client-app\src\main\java\org\apache\hadoop\mapreduce\v2\app\rm\ContainerFailedEvent.java,15,7,0,1,0,8
hadoop-trunk\hadoop-trunk\hadoop-tools\hadoop-aws\src\test\java\org\apache\hadoop\fs\s3a\s3guard\TestAuthoritativePath.java,92,16,0,1,0,17
hadoop-trunk\hadoop-trunk\hadoop-yarn-project\hadoop-yarn\hadoop-yarn-common\src\main\java\org\apache\hadoop\yarn\webapp\view\ErrorPage.java,42,13,0,1,0,14
hadoop-trunk\hadoop-trunk\hadoop-tools\hadoop-aws\src\test\java\org\apache\hadoop\fs\s3a\commit\AbstractCommitITest.java,324,34,9,2,0,45
hadoop-trunk\hadoop-trunk\hadoop-tools\hadoop-rumen\src\main\java\org\apache\hadoop\tools\rumen\LoggedDiscreteCDF.java,114,48,1,2,0,51
hadoop-trunk\hadoop-trunk\hadoop-yarn-project\hadoop-yarn\hadoop-yarn-applications\hadoop-yarn-services\hadoop-yarn-services-core\src\main\java\org\apache\hadoop\yarn\service\api\records\Error.java,100,40,2,1,0,43
hadoop-trunk\hadoop-trunk\hadoop-common-project\hadoop-common\src\test\java\org\apache\hadoop\util\TestSignalLogger.java,17,6,1,1,0,8
hadoop-trunk\hadoop-trunk\hadoop-yarn-project\hadoop-yarn\hadoop-yarn-common\src\main\java\org\apache\hadoop\yarn\metrics\CustomResourceMetricValue.java,45,22,0,1,0,23
hadoop-trunk\hadoop-trunk\hadoop-common-project\hadoop-common\src\test\java\org\apache\hadoop\fs\TestAvroFSInput.java,0,10,2,1,0,13
hadoop-trunk\hadoop-trunk\hadoop-yarn-project\hadoop-yarn\hadoop-yarn-server\hadoop-yarn-server-nodemanager\src\main\java\org\apache\hadoop\yarn\server\nodemanager\containermanager\container\ContainerImpl.java,2272,330,64,30,0,424
hadoop-trunk\hadoop-trunk\hadoop-mapreduce-project\hadoop-mapreduce-client\hadoop-mapreduce-client-core\src\test\java\org\apache\hadoop\mapred\TestSkipBadRecords.java,33,19,1,1,0,21
hadoop-trunk\hadoop-trunk\hadoop-tools\hadoop-aws\src\test\java\org\apache\hadoop\fs\s3a\ITestS3AEncryptionAlgorithmValidation.java,0,6,1,1,0,8
hadoop-trunk\hadoop-trunk\hadoop-yarn-project\hadoop-yarn\hadoop-yarn-server\hadoop-yarn-server-timelineservice\src\main\java\org\apache\hadoop\yarn\server\timelineservice\reader\TimelineReaderManager.java,189,24,2,1,0,27
hadoop-trunk\hadoop-trunk\hadoop-common-project\hadoop-nfs\src\main\java\org\apache\hadoop\oncrpc\security\Verifier.java,49,8,0,3,0,11
hadoop-trunk\hadoop-trunk\hadoop-hdfs-project\hadoop-hdfs\src\test\java\org\apache\hadoop\hdfs\server\datanode\TestDataNodeECN.java,22,3,1,1,0,5
hadoop-trunk\hadoop-trunk\hadoop-mapreduce-project\hadoop-mapreduce-client\hadoop-mapreduce-client-jobclient\src\test\java\org\apache\hadoop\mapred\TestCommandLineJobSubmission.java,110,48,14,3,0,65
hadoop-trunk\hadoop-trunk\hadoop-yarn-project\hadoop-yarn\hadoop-yarn-server\hadoop-yarn-server-resourcemanager\src\main\java\org\apache\hadoop\yarn\server\resourcemanager\scheduler\capacity\allocator\ContainerAllocator.java,27,16,0,8,0,24
hadoop-trunk\hadoop-trunk\hadoop-yarn-project\hadoop-yarn\hadoop-yarn-server\hadoop-yarn-server-resourcemanager\src\main\java\org\apache\hadoop\yarn\server\resourcemanager\monitor\capacity\TempAppPerPartition.java,84,35,0,2,0,37
hadoop-trunk\hadoop-trunk\hadoop-mapreduce-project\hadoop-mapreduce-client\hadoop-mapreduce-client-core\src\main\java\org\apache\hadoop\mapred\pipes\PipesReducer.java,0,34,7,2,0,43
hadoop-trunk\hadoop-trunk\hadoop-common-project\hadoop-common\src\main\java\org\apache\hadoop\util\HostsFileReader.java,330,107,9,1,0,117
hadoop-trunk\hadoop-trunk\hadoop-common-project\hadoop-kms\src\test\java\org\apache\hadoop\crypto\key\kms\server\TestKMSWithZK.java,106,10,1,2,0,13
hadoop-trunk\hadoop-trunk\hadoop-yarn-project\hadoop-yarn\hadoop-yarn-server\hadoop-yarn-server-timelineservice\src\test\java\org\apache\hadoop\yarn\server\timelineservice\reader\TestTimelineReaderUtils.java,28,2,0,1,0,3
hadoop-trunk\hadoop-trunk\hadoop-yarn-project\hadoop-yarn\hadoop-yarn-server\hadoop-yarn-server-resourcemanager\src\main\java\org\apache\hadoop\yarn\server\resourcemanager\scheduler\activities\ActivitiesManager.java,597,139,16,5,0,160
hadoop-trunk\hadoop-trunk\hadoop-yarn-project\hadoop-yarn\hadoop-yarn-api\src\main\java\org\apache\hadoop\yarn\api\records\ExecutionTypeRequest.java,0,11,0,1,0,12
hadoop-trunk\hadoop-trunk\hadoop-hdfs-project\hadoop-hdfs\src\main\java\org\apache\hadoop\hdfs\server\namenode\NetworkTopologyServlet.java,143,29,4,1,0,34
hadoop-trunk\hadoop-trunk\hadoop-yarn-project\hadoop-yarn\hadoop-yarn-client\src\test\java\org\apache\hadoop\yarn\client\cli\TestNodeAttributesCLI.java,470,25,43,6,0,74
hadoop-trunk\hadoop-trunk\hadoop-cloud-storage-project\hadoop-huaweicloud\src\main\java\org\apache\hadoop\fs\obs\OBSObjectBucketUtils.java,0,1,10,1,0,12
hadoop-trunk\hadoop-trunk\hadoop-tools\hadoop-distcp\src\test\java\org\apache\hadoop\tools\TestDistCpViewFs.java,403,82,3,9,0,94
hadoop-trunk\hadoop-trunk\hadoop-common-project\hadoop-common\src\main\java\org\apache\hadoop\util\curator\ZKCuratorManager.java,0,75,3,1,0,79
hadoop-trunk\hadoop-trunk\hadoop-hdfs-project\hadoop-hdfs-client\src\main\java\org\apache\hadoop\hdfs\protocolPB\package-info.java,0,1,1,1,0,3
hadoop-trunk\hadoop-trunk\hadoop-hdfs-project\hadoop-hdfs-rbf\src\test\java\org\apache\hadoop\hdfs\server\federation\metrics\TestNameserviceRPCMetrics.java,0,11,4,4,0,19
hadoop-trunk\hadoop-trunk\hadoop-tools\hadoop-aws\src\test\java\org\apache\hadoop\fs\s3a\TestDataBlocks.java,108,10,1,2,0,13
hadoop-trunk\hadoop-trunk\hadoop-common-project\hadoop-common\src\main\java\org\apache\hadoop\conf\ReconfigurationServlet.java,196,79,11,2,0,92
hadoop-trunk\hadoop-trunk\hadoop-common-project\hadoop-common\src\main\java\org\apache\hadoop\fs\statistics\IOStatisticsLogging.java,0,22,4,5,0,31
hadoop-trunk\hadoop-trunk\hadoop-yarn-project\hadoop-yarn\hadoop-yarn-server\hadoop-yarn-server-nodemanager\src\main\java\org\apache\hadoop\yarn\server\nodemanager\webapp\dao\NMContainerLogsInfo.java,38,9,1,1,0,11
hadoop-trunk\hadoop-trunk\hadoop-yarn-project\hadoop-yarn\hadoop-yarn-common\src\test\java\org\apache\hadoop\yarn\api\TestResourcePBImpl.java,262,37,62,1,0,100
hadoop-trunk\hadoop-trunk\hadoop-mapreduce-project\hadoop-mapreduce-client\hadoop-mapreduce-client-core\src\main\java\org\apache\hadoop\mapreduce\lib\output\PathOutputCommitter.java,68,9,0,1,0,10
hadoop-trunk\hadoop-trunk\hadoop-mapreduce-project\hadoop-mapreduce-client\hadoop-mapreduce-client-core\src\main\java\org\apache\hadoop\mapreduce\CounterGroup.java,0,0,0,1,0,1
hadoop-trunk\hadoop-trunk\hadoop-hdfs-project\hadoop-hdfs\src\test\java\org\apache\hadoop\cli\util\CLICommandCacheAdmin.java,3,0,0,1,0,1
hadoop-trunk\hadoop-trunk\hadoop-common-project\hadoop-common\src\test\java\org\apache\hadoop\io\TestWritable.java,189,86,20,6,0,112
hadoop-trunk\hadoop-trunk\hadoop-yarn-project\hadoop-yarn\hadoop-yarn-common\src\main\java\org\apache\hadoop\yarn\logaggregation\filecontroller\tfile\LogAggregationTFileController.java,0,55,15,4,0,74
hadoop-trunk\hadoop-trunk\hadoop-hdfs-project\hadoop-hdfs-rbf\src\test\java\org\apache\hadoop\fs\contract\router\TestRouterHDFSContractSeek.java,19,4,0,1,0,5
hadoop-trunk\hadoop-trunk\hadoop-common-project\hadoop-common\src\main\java\org\apache\hadoop\ha\protocolPB\HAServiceProtocolServerSideTranslatorPB.java,143,49,49,15,0,113
hadoop-trunk\hadoop-trunk\hadoop-hdfs-project\hadoop-hdfs\src\test\java\org\apache\hadoop\hdfs\server\sps\TestExternalStoragePolicySatisfier.java,0,252,18,20,0,290
hadoop-trunk\hadoop-trunk\hadoop-yarn-project\hadoop-yarn\hadoop-yarn-server\hadoop-yarn-server-nodemanager\src\main\java\org\apache\hadoop\yarn\server\nodemanager\containermanager\application\ApplicationContainerFinishedEvent.java,27,12,0,1,0,13
hadoop-trunk\hadoop-trunk\hadoop-common-project\hadoop-common\src\test\java\org\apache\hadoop\ipc\TestCallerContext.java,60,5,0,2,0,7
hadoop-trunk\hadoop-trunk\hadoop-yarn-project\hadoop-yarn\hadoop-yarn-applications\hadoop-yarn-services\hadoop-yarn-services-core\src\main\java\org\apache\hadoop\yarn\service\api\records\ReadinessCheck.java,146,54,2,5,0,61
hadoop-trunk\hadoop-trunk\hadoop-mapreduce-project\hadoop-mapreduce-client\hadoop-mapreduce-client-core\src\main\java\org\apache\hadoop\mapreduce\task\reduce\ExceptionReporter.java,0,2,0,1,0,3
hadoop-trunk\hadoop-trunk\hadoop-hdfs-project\hadoop-hdfs\src\main\java\org\apache\hadoop\hdfs\server\namenode\FsImageValidation.java,333,67,18,5,0,90
hadoop-trunk\hadoop-trunk\hadoop-yarn-project\hadoop-yarn\hadoop-yarn-client\src\test\java\org\apache\hadoop\yarn\client\TestRMFailover.java,394,42,12,7,0,61
hadoop-trunk\hadoop-trunk\hadoop-tools\hadoop-azure\src\main\java\org\apache\hadoop\fs\azure\SendRequestIntercept.java,0,11,10,3,0,24
hadoop-trunk\hadoop-trunk\hadoop-hdfs-project\hadoop-hdfs-client\src\main\java\org\apache\hadoop\hdfs\ReadStatistics.java,112,30,0,1,0,31
hadoop-trunk\hadoop-trunk\hadoop-yarn-project\hadoop-yarn\hadoop-yarn-common\src\main\java\org\apache\hadoop\yarn\webapp\view\Html.java,8,6,1,1,0,8
hadoop-trunk\hadoop-trunk\hadoop-common-project\hadoop-registry\src\main\java\org\apache\hadoop\registry\server\dns\package-info.java,0,0,0,1,0,1
hadoop-trunk\hadoop-trunk\hadoop-mapreduce-project\hadoop-mapreduce-client\hadoop-mapreduce-client-jobclient\src\test\java\testshell\ExternalMapReduce.java,97,35,9,1,0,45
hadoop-trunk\hadoop-trunk\hadoop-common-project\hadoop-nfs\src\main\java\org\apache\hadoop\oncrpc\security\Credentials.java,50,17,0,1,0,18
hadoop-trunk\hadoop-trunk\hadoop-yarn-project\hadoop-yarn\hadoop-yarn-api\src\main\java\org\apache\hadoop\yarn\conf\package-info.java,0,1,0,1,0,2
hadoop-trunk\hadoop-trunk\hadoop-mapreduce-project\hadoop-mapreduce-client\hadoop-mapreduce-client-core\src\main\java\org\apache\hadoop\mapreduce\security\token\JobTokenSelector.java,19,3,0,1,0,4
hadoop-trunk\hadoop-trunk\hadoop-yarn-project\hadoop-yarn\hadoop-yarn-server\hadoop-yarn-server-timeline-pluginstorage\src\main\java\org\apache\hadoop\yarn\server\timeline\EntityGroupFSTimelineStoreMetrics.java,0,50,1,1,0,52
hadoop-trunk\hadoop-trunk\hadoop-common-project\hadoop-common\src\test\java\org\apache\hadoop\fs\shell\TestCopy.java,185,41,4,2,0,47
hadoop-trunk\hadoop-trunk\hadoop-yarn-project\hadoop-yarn\hadoop-yarn-common\src\main\java\org\apache\hadoop\yarn\api\protocolrecords\impl\pb\GetNewReservationResponsePBImpl.java,101,22,34,3,0,59
hadoop-trunk\hadoop-trunk\hadoop-yarn-project\hadoop-yarn\hadoop-yarn-server\hadoop-yarn-server-resourcemanager\src\test\java\org\apache\hadoop\yarn\server\resourcemanager\Application.java,395,182,11,11,0,204
hadoop-trunk\hadoop-trunk\hadoop-tools\hadoop-aws\src\test\java\org\apache\hadoop\fs\s3a\ITestS3ABlockOutputDisk.java,18,2,0,1,0,3
hadoop-trunk\hadoop-trunk\hadoop-cloud-storage-project\hadoop-huaweicloud\src\test\java\org\apache\hadoop\fs\obs\TestOBSFSMainOperations.java,49,9,0,1,0,10
hadoop-trunk\hadoop-trunk\hadoop-common-project\hadoop-common\src\main\java\org\apache\hadoop\security\RefreshUserMappingsProtocol.java,0,15,5,2,0,22
hadoop-trunk\hadoop-trunk\hadoop-yarn-project\hadoop-yarn\hadoop-yarn-common\src\main\java\org\apache\hadoop\yarn\api\protocolrecords\impl\pb\NodeUnpublishVolumeRequestPBImpl.java,62,16,19,1,0,36
hadoop-trunk\hadoop-trunk\hadoop-common-project\hadoop-common\src\main\java\org\apache\hadoop\ipc\FairCallQueue.java,0,78,5,1,0,84
hadoop-trunk\hadoop-trunk\hadoop-yarn-project\hadoop-yarn\hadoop-yarn-server\hadoop-yarn-server-nodemanager\src\main\java\org\apache\hadoop\yarn\server\nodemanager\containermanager\runtime\ContainerExecutionException.java,60,37,0,1,0,38
hadoop-trunk\hadoop-trunk\hadoop-tools\hadoop-azure\src\main\java\org\apache\hadoop\fs\azure\Wasbs.java,13,1,0,1,0,2
hadoop-trunk\hadoop-trunk\hadoop-yarn-project\hadoop-yarn\hadoop-yarn-server\hadoop-yarn-server-nodemanager\src\test\java\org\apache\hadoop\yarn\server\nodemanager\TestLinuxContainerExecutor.java,615,91,19,14,0,124
hadoop-trunk\hadoop-trunk\hadoop-yarn-project\hadoop-yarn\hadoop-yarn-server\hadoop-yarn-server-resourcemanager\src\main\java\org\apache\hadoop\yarn\server\resourcemanager\volume\csi\package-info.java,0,1,0,1,0,2
hadoop-trunk\hadoop-trunk\hadoop-mapreduce-project\hadoop-mapreduce-client\hadoop-mapreduce-client-jobclient\src\test\java\org\apache\hadoop\mapred\TestLazyOutput.java,157,54,20,1,0,75
hadoop-trunk\hadoop-trunk\hadoop-yarn-project\hadoop-yarn\hadoop-yarn-server\hadoop-yarn-server-common\src\main\java\org\apache\hadoop\yarn\server\federation\policies\manager\package-info.java,0,0,0,1,0,1
hadoop-trunk\hadoop-trunk\hadoop-cloud-storage-project\hadoop-cos\src\test\java\org\apache\hadoop\fs\cosn\TestCosNInputStream.java,131,23,13,1,0,37
hadoop-trunk\hadoop-trunk\hadoop-yarn-project\hadoop-yarn\hadoop-yarn-server\hadoop-yarn-server-nodemanager\src\main\java\org\apache\hadoop\yarn\server\nodemanager\timelineservice\NMTimelinePublisher.java,498,73,28,13,0,114
hadoop-trunk\hadoop-trunk\hadoop-common-project\hadoop-common\src\main\java\org\apache\hadoop\metrics2\impl\MetricsCollectorImpl.java,50,20,3,1,0,24
hadoop-trunk\hadoop-trunk\hadoop-mapreduce-project\hadoop-mapreduce-client\hadoop-mapreduce-client-jobclient\src\test\java\org\apache\hadoop\mapred\TestMerge.java,350,104,16,1,0,121
hadoop-trunk\hadoop-trunk\hadoop-yarn-project\hadoop-yarn\hadoop-yarn-server\hadoop-yarn-server-nodemanager\src\main\java\org\apache\hadoop\yarn\server\nodemanager\executor\ContainerExecContext.java,0,32,2,2,0,36
hadoop-trunk\hadoop-trunk\hadoop-hdfs-project\hadoop-hdfs-client\src\main\java\org\apache\hadoop\hdfs\web\URLConnectionFactory.java,176,40,0,1,0,41
hadoop-trunk\hadoop-trunk\hadoop-mapreduce-project\hadoop-mapreduce-client\hadoop-mapreduce-client-core\src\main\java\org\apache\hadoop\mapreduce\lib\input\FileSplit.java,96,47,1,1,0,49
hadoop-trunk\hadoop-trunk\hadoop-hdfs-project\hadoop-hdfs-rbf\src\test\java\org\apache\hadoop\hdfs\server\federation\router\TestRouterPolicyProvider.java,55,12,2,1,0,15
hadoop-trunk\hadoop-trunk\hadoop-yarn-project\hadoop-yarn\hadoop-yarn-server\hadoop-yarn-server-common\src\main\java\org\apache\hadoop\yarn\server\federation\store\records\SubClusterPolicyConfiguration.java,123,12,1,1,0,14
hadoop-trunk\hadoop-trunk\hadoop-hdfs-project\hadoop-hdfs\src\main\java\org\apache\hadoop\hdfs\server\protocol\VolumeFailureSummary.java,51,10,0,2,0,12
hadoop-trunk\hadoop-trunk\hadoop-hdfs-project\hadoop-hdfs\src\test\java\org\apache\hadoop\hdfs\TestKeyProviderCache.java,117,28,4,1,0,33
hadoop-trunk\hadoop-trunk\hadoop-mapreduce-project\hadoop-mapreduce-client\hadoop-mapreduce-client-core\src\main\java\org\apache\hadoop\mapreduce\lib\output\FileOutputCommitterFactory.java,0,2,0,1,0,3
hadoop-trunk\hadoop-trunk\hadoop-mapreduce-project\hadoop-mapreduce-client\hadoop-mapreduce-client-core\src\main\java\org\apache\hadoop\mapred\join\OuterJoinRecordReader.java,0,10,1,1,0,12
hadoop-trunk\hadoop-trunk\hadoop-common-project\hadoop-common\src\main\java\org\apache\hadoop\metrics2\annotation\Metric.java,0,7,1,1,0,9
hadoop-trunk\hadoop-trunk\hadoop-tools\hadoop-aws\src\main\java\org\apache\hadoop\fs\s3a\audit\impl\ActiveAuditManagerS3A.java,0,10,1,4,0,15
hadoop-trunk\hadoop-trunk\hadoop-tools\hadoop-aws\src\test\java\org\apache\hadoop\fs\s3a\tools\AbstractMarkerToolTest.java,281,24,3,4,0,31
hadoop-trunk\hadoop-trunk\hadoop-yarn-project\hadoop-yarn\hadoop-yarn-server\hadoop-yarn-server-timelineservice\src\main\java\org\apache\hadoop\yarn\server\timelineservice\security\package-info.java,0,1,0,1,0,2
hadoop-trunk\hadoop-trunk\hadoop-common-project\hadoop-common\src\main\java\org\apache\hadoop\fs\LocatedFileStatus.java,174,73,15,1,0,89
hadoop-trunk\hadoop-trunk\hadoop-hdfs-project\hadoop-hdfs\src\test\java\org\apache\hadoop\hdfs\qjournal\server\TestJournalNodeRespectsBindHostKeys.java,144,23,9,6,0,38
hadoop-trunk\hadoop-trunk\hadoop-yarn-project\hadoop-yarn\hadoop-yarn-server\hadoop-yarn-server-resourcemanager\src\test\java\org\apache\hadoop\yarn\server\resourcemanager\monitor\capacity\TestProportionalCapacityPreemptionPolicyIntraQueueWithDRF.java,296,55,1,5,0,61
hadoop-trunk\hadoop-trunk\hadoop-yarn-project\hadoop-yarn\hadoop-yarn-server\hadoop-yarn-server-resourcemanager\src\test\java\org\apache\hadoop\yarn\server\resourcemanager\scheduler\capacity\TestIncreaseAllocationExpirer.java,475,84,5,7,0,96
hadoop-trunk\hadoop-trunk\hadoop-hdfs-project\hadoop-hdfs\src\test\java\org\apache\hadoop\hdfs\server\namenode\TestClientNameNodeAddress.java,66,12,9,1,0,22
hadoop-trunk\hadoop-trunk\hadoop-hdfs-project\hadoop-hdfs\src\main\java\org\apache\hadoop\hdfs\server\datanode\ReportBadBlockAction.java,79,23,1,1,0,25
hadoop-trunk\hadoop-trunk\hadoop-tools\hadoop-azure\src\test\java\org\apache\hadoop\fs\azure\contract\ITestAzureNativeContractDistCp.java,19,4,0,2,0,6
hadoop-trunk\hadoop-trunk\hadoop-yarn-project\hadoop-yarn\hadoop-yarn-server\hadoop-yarn-server-common\src\main\java\org\apache\hadoop\yarn\server\federation\store\FederationApplicationHomeSubClusterStore.java,0,0,0,11,0,11
hadoop-trunk\hadoop-trunk\hadoop-hdfs-project\hadoop-hdfs\src\test\java\org\apache\hadoop\hdfs\TestParallelUnixDomainRead.java,30,10,2,3,0,15
hadoop-trunk\hadoop-trunk\hadoop-common-project\hadoop-common\src\main\java\org\apache\hadoop\io\erasurecode\coder\XORErasureEncoder.java,19,3,0,1,0,4
hadoop-trunk\hadoop-trunk\hadoop-yarn-project\hadoop-yarn\hadoop-yarn-server\hadoop-yarn-server-router\src\test\java\org\apache\hadoop\yarn\server\router\webapp\TestableFederationInterceptorREST.java,0,3,0,1,0,4
hadoop-trunk\hadoop-trunk\hadoop-yarn-project\hadoop-yarn\hadoop-yarn-server\hadoop-yarn-server-timelineservice-documentstore\src\main\java\org\apache\hadoop\yarn\server\timelineservice\documentstore\reader\DocumentStoreReader.java,0,6,2,5,0,13
hadoop-trunk\hadoop-trunk\hadoop-hdfs-project\hadoop-hdfs-client\src\main\java\org\apache\hadoop\hdfs\web\oauth2\OAuth2Constants.java,0,10,0,1,0,11
hadoop-trunk\hadoop-trunk\hadoop-common-project\hadoop-common\src\main\java\org\apache\hadoop\tracing\Tracer.java,77,42,1,1,0,44
hadoop-trunk\hadoop-trunk\hadoop-tools\hadoop-azure\src\main\java\org\apache\hadoop\fs\azurebfs\AbfsStatistic.java,0,47,0,3,0,50
hadoop-trunk\hadoop-trunk\hadoop-yarn-project\hadoop-yarn\hadoop-yarn-common\src\main\java\org\apache\hadoop\yarn\nodelabels\store\AbstractFSNodeStore.java,195,56,12,1,0,69
hadoop-trunk\hadoop-trunk\hadoop-yarn-project\hadoop-yarn\hadoop-yarn-common\src\main\java\org\apache\hadoop\yarn\api\protocolrecords\impl\pb\CancelDelegationTokenRequestPBImpl.java,94,29,37,3,0,69
hadoop-trunk\hadoop-trunk\hadoop-common-project\hadoop-common\src\test\java\org\apache\hadoop\crypto\key\FailureInjectingJavaKeyStoreProvider.java,55,18,0,1,0,19
hadoop-trunk\hadoop-trunk\hadoop-hdfs-project\hadoop-hdfs\src\main\java\org\apache\hadoop\hdfs\server\namenode\snapshot\FileWithSnapshotFeature.java,0,52,2,1,0,55
hadoop-trunk\hadoop-trunk\hadoop-tools\hadoop-resourceestimator\src\main\java\org\apache\hadoop\resourceestimator\solver\exceptions\InvalidSolverException.java,9,1,0,1,0,2
hadoop-trunk\hadoop-trunk\hadoop-yarn-project\hadoop-yarn\hadoop-yarn-server\hadoop-yarn-server-resourcemanager\src\main\java\org\apache\hadoop\yarn\server\resourcemanager\rmapp\attempt\RMAppAttemptState.java,0,14,0,1,0,15
hadoop-trunk\hadoop-trunk\hadoop-tools\hadoop-aws\src\main\java\org\apache\hadoop\fs\s3a\commit\PutTracker.java,69,6,0,1,0,7
hadoop-trunk\hadoop-trunk\hadoop-hdfs-project\hadoop-hdfs\src\main\java\org\apache\hadoop\hdfs\tools\snapshot\SnapshotDiff.java,77,22,0,1,0,23
hadoop-trunk\hadoop-trunk\hadoop-common-project\hadoop-registry\src\main\java\org\apache\hadoop\registry\client\exceptions\package-info.java,0,0,0,1,0,1
hadoop-trunk\hadoop-trunk\hadoop-hdfs-project\hadoop-hdfs\src\test\java\org\apache\hadoop\hdfs\server\datanode\TestBlockRecovery.java,0,192,25,15,0,232
hadoop-trunk\hadoop-trunk\hadoop-common-project\hadoop-auth\src\test\java\org\apache\hadoop\security\authentication\util\TestFileSignerSecretProvider.java,51,2,1,1,0,4
hadoop-trunk\hadoop-trunk\hadoop-hdfs-project\hadoop-hdfs\src\test\java\org\apache\hadoop\hdfs\server\datanode\TestBlockReplacement.java,0,142,32,6,0,180
hadoop-trunk\hadoop-trunk\hadoop-common-project\hadoop-common\src\main\java\org\apache\hadoop\io\compress\bzip2\BZip2Constants.java,0,22,18,1,0,41
hadoop-trunk\hadoop-trunk\hadoop-yarn-project\hadoop-yarn\hadoop-yarn-api\src\main\java\org\apache\hadoop\yarn\factories\package-info.java,0,2,0,1,0,3
hadoop-trunk\hadoop-trunk\hadoop-tools\hadoop-azure\src\test\java\org\apache\hadoop\fs\azure\integration\Sizes.java,0,17,15,1,0,33
hadoop-trunk\hadoop-trunk\hadoop-common-project\hadoop-common\src\test\java\org\apache\hadoop\fs\TestSymlinkLocalFS.java,0,60,7,1,0,68
hadoop-trunk\hadoop-trunk\hadoop-mapreduce-project\hadoop-mapreduce-client\hadoop-mapreduce-client-core\src\main\java\org\apache\hadoop\mapreduce\Counters.java,0,19,0,1,0,20
hadoop-trunk\hadoop-trunk\hadoop-mapreduce-project\hadoop-mapreduce-client\hadoop-mapreduce-client-app\src\main\java\org\apache\hadoop\mapreduce\v2\app\commit\CommitterEvent.java,7,2,0,1,0,3
hadoop-trunk\hadoop-trunk\hadoop-common-project\hadoop-common\src\main\java\org\apache\hadoop\security\ShellBasedIdMapping.java,650,164,20,17,0,201
hadoop-trunk\hadoop-trunk\hadoop-yarn-project\hadoop-yarn\hadoop-yarn-api\src\main\java\org\apache\hadoop\yarn\api\protocolrecords\CancelDelegationTokenResponse.java,10,1,1,1,0,3
hadoop-trunk\hadoop-trunk\hadoop-yarn-project\hadoop-yarn\hadoop-yarn-common\src\test\java\org\apache\hadoop\yarn\webapp\JerseyTestBase.java,19,6,1,1,0,8
hadoop-trunk\hadoop-trunk\hadoop-yarn-project\hadoop-yarn\hadoop-yarn-applications\hadoop-yarn-applications-catalog\hadoop-yarn-applications-catalog-webapp\src\test\java\org\apache\hadoop\yarn\appcatalog\application\EmbeddedSolrServerFactory.java,0,2,2,1,0,5
hadoop-trunk\hadoop-trunk\hadoop-yarn-project\hadoop-yarn\hadoop-yarn-common\src\main\java\org\apache\hadoop\yarn\api\protocolrecords\impl\pb\KillApplicationResponsePBImpl.java,61,24,27,4,0,55
hadoop-trunk\hadoop-trunk\hadoop-common-project\hadoop-common\src\test\java\org\apache\hadoop\fs\viewfs\TestViewFileSystemDelegationTokenSupport.java,152,76,2,4,0,82
hadoop-trunk\hadoop-trunk\hadoop-mapreduce-project\hadoop-mapreduce-client\hadoop-mapreduce-client-app\src\test\java\org\apache\hadoop\mapreduce\v2\app\launcher\TestContainerLauncherImpl.java,463,164,9,19,0,192
hadoop-trunk\hadoop-trunk\hadoop-common-project\hadoop-common\src\main\java\org\apache\hadoop\util\CacheableIPList.java,50,19,2,3,0,24
hadoop-trunk\hadoop-trunk\hadoop-mapreduce-project\hadoop-mapreduce-client\hadoop-mapreduce-client-common\src\test\java\org\apache\hadoop\mapreduce\v2\TestRPCFactories.java,157,47,2,19,0,68
hadoop-trunk\hadoop-trunk\hadoop-hdfs-project\hadoop-hdfs-client\src\main\java\org\apache\hadoop\hdfs\protocol\datatransfer\PacketHeader.java,161,57,39,3,0,99
hadoop-trunk\hadoop-trunk\hadoop-mapreduce-project\hadoop-mapreduce-client\hadoop-mapreduce-client-app\src\main\java\org\apache\hadoop\mapreduce\v2\app\rm\RMContainerRequestor.java,528,170,18,12,0,200
hadoop-trunk\hadoop-trunk\hadoop-yarn-project\hadoop-yarn\hadoop-yarn-server\hadoop-yarn-server-common\src\main\java\org\apache\hadoop\yarn\server\api\records\impl\pb\package-info.java,0,1,0,1,0,2
hadoop-trunk\hadoop-trunk\hadoop-tools\hadoop-gridmix\src\test\java\org\apache\hadoop\mapred\gridmix\TestGridmixSubmission.java,160,26,8,2,0,36
hadoop-trunk\hadoop-trunk\hadoop-hdfs-project\hadoop-hdfs-client\src\main\java\org\apache\hadoop\hdfs\shortcircuit\DfsClientShm.java,0,12,0,2,0,14
hadoop-trunk\hadoop-trunk\hadoop-tools\hadoop-azure\src\main\java\org\apache\hadoop\fs\azurebfs\contracts\services\AzureServiceErrorCode.java,0,58,0,24,0,82
hadoop-trunk\hadoop-trunk\hadoop-mapreduce-project\hadoop-mapreduce-examples\src\main\java\org\apache\hadoop\examples\WordMedian.java,172,31,4,2,0,37
hadoop-trunk\hadoop-trunk\hadoop-common-project\hadoop-common\src\main\java\org\apache\hadoop\ipc\ProtobufRpcEngine.java,470,163,23,2,0,188
hadoop-trunk\hadoop-trunk\hadoop-tools\hadoop-azure\src\test\java\org\apache\hadoop\fs\azurebfs\commit\ITestAbfsTaskManifestFileIO.java,26,5,0,2,0,7
hadoop-trunk\hadoop-trunk\hadoop-common-project\hadoop-common\src\test\java\org\apache\hadoop\metrics2\impl\TestMetricsConfig.java,128,19,6,2,0,27
hadoop-trunk\hadoop-trunk\hadoop-yarn-project\hadoop-yarn\hadoop-yarn-server\hadoop-yarn-server-resourcemanager\src\test\java\org\apache\hadoop\yarn\server\resourcemanager\nodelabels\TestFileSystemNodeAttributeStore.java,234,16,1,1,0,18
hadoop-trunk\hadoop-trunk\hadoop-common-project\hadoop-common\src\test\java\org\apache\hadoop\util\TestAsyncDiskService.java,57,22,4,1,0,27
hadoop-trunk\hadoop-trunk\hadoop-tools\hadoop-aws\src\main\java\org\apache\hadoop\fs\s3a\commit\ValidationFailure.java,28,5,0,1,0,6
hadoop-trunk\hadoop-trunk\hadoop-yarn-project\hadoop-yarn\hadoop-yarn-server\hadoop-yarn-server-timelineservice\src\main\java\org\apache\hadoop\yarn\server\timelineservice\metrics\PerNodeAggTimelineCollectorMetrics.java,0,22,0,1,0,23
hadoop-trunk\hadoop-trunk\hadoop-common-project\hadoop-common\src\main\arm-java\org\apache\hadoop\ipc\protobuf\ProtobufRpcEngineProtos.java,0,262,140,45,0,447
hadoop-trunk\hadoop-trunk\hadoop-yarn-project\hadoop-yarn\hadoop-yarn-server\hadoop-yarn-server-timelineservice\src\main\java\org\apache\hadoop\yarn\server\timelineservice\reader\TimelineParserForKVFilters.java,0,12,0,4,0,16
hadoop-trunk\hadoop-trunk\hadoop-common-project\hadoop-common\src\test\java\org\apache\hadoop\io\TestSequenceFileSerialization.java,41,13,2,1,0,16
hadoop-trunk\hadoop-trunk\hadoop-hdfs-project\hadoop-hdfs-rbf\src\test\java\org\apache\hadoop\hdfs\server\federation\resolver\TestMultipleDestinationResolver.java,389,25,0,2,0,27
hadoop-trunk\hadoop-trunk\hadoop-common-project\hadoop-common\src\test\java\org\apache\hadoop\service\ServiceAssert.java,55,21,2,2,0,25
hadoop-trunk\hadoop-trunk\hadoop-tools\hadoop-aws\src\test\java\org\apache\hadoop\fs\s3a\TestS3ABlockOutputStream.java,125,11,2,1,0,14
hadoop-trunk\hadoop-trunk\hadoop-tools\hadoop-aws\src\test\java\org\apache\hadoop\fs\s3a\s3guard\S3GuardToolTestHelper.java,0,12,1,1,0,14
hadoop-trunk\hadoop-trunk\hadoop-tools\hadoop-streaming\src\main\java\org\apache\hadoop\streaming\JarBuilder.java,176,53,25,7,0,85
hadoop-trunk\hadoop-trunk\hadoop-hdfs-project\hadoop-hdfs\src\test\java\org\apache\hadoop\hdfs\TestPread.java,707,206,19,7,0,232
hadoop-trunk\hadoop-trunk\hadoop-mapreduce-project\hadoop-mapreduce-client\hadoop-mapreduce-client-jobclient\src\test\java\org\apache\hadoop\mapred\pipes\TestPipeApplication.java,759,136,22,23,0,181
hadoop-trunk\hadoop-trunk\hadoop-yarn-project\hadoop-yarn\hadoop-yarn-server\hadoop-yarn-server-resourcemanager\src\main\java\org\apache\hadoop\yarn\server\resourcemanager\webapp\SchedulerPageUtil.java,158,22,0,19,0,41
hadoop-trunk\hadoop-trunk\hadoop-yarn-project\hadoop-yarn\hadoop-yarn-server\hadoop-yarn-server-nodemanager\src\test\java\org\apache\hadoop\yarn\server\nodemanager\containermanager\resourceplugin\gpu\TestGpuDiscoverer.java,486,65,7,5,0,77
hadoop-trunk\hadoop-trunk\hadoop-tools\hadoop-aws\src\main\java\org\apache\hadoop\fs\s3a\audit\impl\package-info.java,0,1,0,1,0,2
hadoop-trunk\hadoop-trunk\hadoop-yarn-project\hadoop-yarn\hadoop-yarn-server\hadoop-yarn-server-timelineservice-hbase\hadoop-yarn-server-timelineservice-hbase-client\src\main\java\org\apache\hadoop\yarn\server\timelineservice\storage\domain\DomainTableRW.java,56,6,1,2,0,9
hadoop-trunk\hadoop-trunk\hadoop-common-project\hadoop-registry\src\main\java\org\apache\hadoop\registry\server\services\AddingCompositeService.java,18,6,2,1,0,9
hadoop-trunk\hadoop-trunk\hadoop-hdfs-project\hadoop-hdfs\src\test\java\org\apache\hadoop\hdfs\server\namenode\TestAddStripedBlocks.java,432,48,1,12,0,61
hadoop-trunk\hadoop-trunk\hadoop-mapreduce-project\hadoop-mapreduce-client\hadoop-mapreduce-client-app\src\test\java\org\apache\hadoop\mapreduce\v2\app\local\TestLocalContainerAllocator.java,232,18,4,6,0,28
hadoop-trunk\hadoop-trunk\hadoop-yarn-project\hadoop-yarn\hadoop-yarn-server\hadoop-yarn-server-router\src\test\java\org\apache\hadoop\yarn\server\router\rmadmin\BaseRouterRMAdminTest.java,280,40,14,25,0,79
hadoop-trunk\hadoop-trunk\hadoop-yarn-project\hadoop-yarn\hadoop-yarn-common\src\main\java\org\apache\hadoop\yarn\api\records\impl\pb\ApplicationTimeoutPBImpl.java,101,22,37,1,0,60
hadoop-trunk\hadoop-trunk\hadoop-yarn-project\hadoop-yarn\hadoop-yarn-api\src\main\java\org\apache\hadoop\yarn\api\records\NodeAttributeOpCode.java,0,0,0,1,0,1
hadoop-trunk\hadoop-trunk\hadoop-hdfs-project\hadoop-hdfs-nfs\src\test\java\org\apache\hadoop\hdfs\nfs\nfs3\TestRpcProgramNfs3.java,0,204,41,5,0,250
hadoop-trunk\hadoop-trunk\hadoop-tools\hadoop-aws\src\test\java\org\apache\hadoop\fs\s3a\audit\AccessCheckingAuditor.java,24,6,2,1,0,9
hadoop-trunk\hadoop-trunk\hadoop-hdfs-project\hadoop-hdfs\src\test\java\org\apache\hadoop\hdfs\TestDecommissionWithStripedBackoffMonitor.java,0,2,0,1,0,3
hadoop-trunk\hadoop-trunk\hadoop-yarn-project\hadoop-yarn\hadoop-yarn-server\hadoop-yarn-server-resourcemanager\src\test\java\org\apache\hadoop\yarn\server\resourcemanager\applicationsmanager\TestAMLaunchFailure.java,174,11,3,14,0,28
hadoop-trunk\hadoop-trunk\hadoop-hdfs-project\hadoop-hdfs\src\test\java\org\apache\hadoop\hdfs\server\blockmanagement\TestSlowPeerTracker.java,183,22,13,1,0,36
hadoop-trunk\hadoop-trunk\hadoop-yarn-project\hadoop-yarn\hadoop-yarn-server\hadoop-yarn-server-sharedcachemanager\src\test\java\org\apache\hadoop\yarn\server\sharedcachemanager\TestSCMAdminProtocolService.java,82,22,0,7,0,29
hadoop-trunk\hadoop-trunk\hadoop-hdfs-project\hadoop-hdfs\src\test\java\org\apache\hadoop\hdfs\security\TestDelegationToken.java,317,69,19,13,0,101
hadoop-trunk\hadoop-trunk\hadoop-mapreduce-project\hadoop-mapreduce-client\hadoop-mapreduce-client-jobclient\src\test\java\org\apache\hadoop\mapreduce\lib\db\TestDBOutputFormat.java,86,24,2,1,0,27
hadoop-trunk\hadoop-trunk\hadoop-hdfs-project\hadoop-hdfs\src\test\java\org\apache\hadoop\hdfs\TestBlockMissingException.java,87,31,2,3,0,36
hadoop-trunk\hadoop-trunk\hadoop-common-project\hadoop-auth\src\test\java\org\apache\hadoop\security\authentication\client\TestKerberosAuthenticator.java,208,48,8,18,0,74
hadoop-trunk\hadoop-trunk\hadoop-common-project\hadoop-common\src\test\java\org\apache\hadoop\io\TestMapWritable.java,137,13,11,2,0,26
hadoop-trunk\hadoop-trunk\hadoop-hdfs-project\hadoop-hdfs\src\test\java\org\apache\hadoop\hdfs\server\namenode\ha\TestHAStateTransitions.java,544,109,12,8,0,129
hadoop-trunk\hadoop-trunk\hadoop-yarn-project\hadoop-yarn\hadoop-yarn-server\hadoop-yarn-server-nodemanager\src\main\java\org\apache\hadoop\yarn\server\nodemanager\containermanager\loghandler\event\LogHandlerAppStartedEvent.java,64,46,0,2,0,48
hadoop-trunk\hadoop-trunk\hadoop-mapreduce-project\hadoop-mapreduce-client\hadoop-mapreduce-client-jobclient\src\test\java\org\apache\hadoop\mapred\lib\TestDelegatingInputFormat.java,98,13,6,1,0,20
hadoop-trunk\hadoop-trunk\hadoop-mapreduce-project\hadoop-mapreduce-client\hadoop-mapreduce-client-app\src\test\java\org\apache\hadoop\mapreduce\jobhistory\TestJobSummary.java,42,10,1,1,0,12
hadoop-trunk\hadoop-trunk\hadoop-hdfs-project\hadoop-hdfs\src\test\java\org\apache\hadoop\hdfs\server\namenode\TestNameNodeRetryCacheMetrics.java,67,15,2,4,0,21
hadoop-trunk\hadoop-trunk\hadoop-hdfs-project\hadoop-hdfs-client\src\main\java\org\apache\hadoop\hdfs\web\resources\NewLengthParam.java,30,2,0,1,0,3
hadoop-trunk\hadoop-trunk\hadoop-yarn-project\hadoop-yarn\hadoop-yarn-common\src\main\java\org\apache\hadoop\yarn\util\Apps.java,270,67,2,3,0,72
hadoop-trunk\hadoop-trunk\hadoop-hdfs-project\hadoop-hdfs\src\test\java\org\apache\hadoop\hdfs\server\blockmanagement\TestErasureCodingCorruption.java,51,11,0,2,0,13
hadoop-trunk\hadoop-trunk\hadoop-yarn-project\hadoop-yarn\hadoop-yarn-client\src\main\java\org\apache\hadoop\yarn\client\cli\LogsCLI.java,1611,206,8,3,0,217
hadoop-trunk\hadoop-trunk\hadoop-mapreduce-project\hadoop-mapreduce-client\hadoop-mapreduce-client-hs\src\test\java\org\apache\hadoop\mapreduce\v2\hs\TestHistoryServerFileSystemStateStoreService.java,193,11,2,2,0,15
hadoop-trunk\hadoop-trunk\hadoop-tools\hadoop-azure\src\test\java\org\apache\hadoop\fs\azure\ITestNativeAzureFileSystemContractLive.java,71,13,7,1,0,21
hadoop-trunk\hadoop-trunk\hadoop-hdfs-project\hadoop-hdfs\src\main\java\org\apache\hadoop\hdfs\server\namenode\startupprogress\StartupProgressMetrics.java,84,25,4,3,0,32
hadoop-trunk\hadoop-trunk\hadoop-tools\hadoop-aws\src\test\java\org\apache\hadoop\fs\s3a\commit\CommitterFaultInjectionImpl.java,0,21,0,1,0,22
hadoop-trunk\hadoop-trunk\hadoop-yarn-project\hadoop-yarn\hadoop-yarn-server\hadoop-yarn-server-nodemanager\src\main\java\org\apache\hadoop\yarn\server\nodemanager\containermanager\resourceplugin\deviceframework\package-info.java,0,1,0,2,0,3
hadoop-trunk\hadoop-trunk\hadoop-yarn-project\hadoop-yarn\hadoop-yarn-server\hadoop-yarn-server-nodemanager\src\main\java\org\apache\hadoop\yarn\server\nodemanager\timelineservice\NMTimelineEventType.java,0,2,0,1,0,3
hadoop-trunk\hadoop-trunk\hadoop-hdfs-project\hadoop-hdfs-rbf\src\main\java\org\apache\hadoop\hdfs\server\federation\store\protocol\impl\pb\EnterSafeModeResponsePBImpl.java,0,12,29,5,0,46
hadoop-trunk\hadoop-trunk\hadoop-hdfs-project\hadoop-hdfs\src\main\java\org\apache\hadoop\hdfs\protocolPB\ClientDatanodeProtocolServerSideTranslatorPB.java,285,69,103,39,0,211
hadoop-trunk\hadoop-trunk\hadoop-cloud-storage-project\hadoop-huaweicloud\src\test\java\org\apache\hadoop\fs\obs\TestOBSFileContextURI.java,40,4,0,1,0,5
hadoop-trunk\hadoop-trunk\hadoop-hdfs-project\hadoop-hdfs-nfs\src\test\java\org\apache\hadoop\hdfs\nfs\TestOutOfOrderWrite.java,133,51,4,1,0,56
hadoop-trunk\hadoop-trunk\hadoop-mapreduce-project\hadoop-mapreduce-client\hadoop-mapreduce-client-core\src\main\java\org\apache\hadoop\mapred\lib\IdentityMapper.java,0,12,0,1,0,13
hadoop-trunk\hadoop-trunk\hadoop-hdfs-project\hadoop-hdfs\src\main\java\org\apache\hadoop\hdfs\server\namenode\metrics\ReplicatedBlocksMBean.java,0,7,0,1,0,8
hadoop-trunk\hadoop-trunk\hadoop-yarn-project\hadoop-yarn\hadoop-yarn-server\hadoop-yarn-server-resourcemanager\src\test\java\org\apache\hadoop\yarn\server\resourcemanager\webapp\TestRMWebServicesReservation.java,1110,128,21,11,0,160
hadoop-trunk\hadoop-trunk\hadoop-tools\hadoop-resourceestimator\src\main\java\org\apache\hadoop\resourceestimator\skylinestore\exceptions\DuplicateRecurrenceIdException.java,8,1,0,1,0,2
hadoop-trunk\hadoop-trunk\hadoop-yarn-project\hadoop-yarn\hadoop-yarn-server\hadoop-yarn-server-resourcemanager\src\test\java\org\apache\hadoop\yarn\server\resourcemanager\monitor\capacity\mockframework\MockSchedulerNodes.java,0,10,2,8,0,20
hadoop-trunk\hadoop-trunk\hadoop-common-project\hadoop-common\src\main\java\org\apache\hadoop\metrics2\impl\MetricsRecordImpl.java,0,17,2,1,0,20
hadoop-trunk\hadoop-trunk\hadoop-common-project\hadoop-common\src\main\java\org\apache\hadoop\io\erasurecode\coder\ErasureEncoder.java,0,17,0,2,0,19
hadoop-trunk\hadoop-trunk\hadoop-hdfs-project\hadoop-hdfs\src\test\java\org\apache\hadoop\hdfs\web\TestWebHdfsFileSystemContract.java,565,112,31,6,0,149
hadoop-trunk\hadoop-trunk\hadoop-hdfs-project\hadoop-hdfs-rbf\src\main\java\org\apache\hadoop\hdfs\server\federation\store\driver\StateStoreRecordOperations.java,0,2,0,1,0,3
hadoop-trunk\hadoop-trunk\hadoop-yarn-project\hadoop-yarn\hadoop-yarn-server\hadoop-yarn-server-resourcemanager\src\test\java\org\apache\hadoop\yarn\server\resourcemanager\recovery\TestRMStateStoreUtils.java,53,16,0,2,0,18
hadoop-trunk\hadoop-trunk\hadoop-yarn-project\hadoop-yarn\hadoop-yarn-server\hadoop-yarn-server-nodemanager\src\main\java\org\apache\hadoop\yarn\server\nodemanager\webapp\dao\ContainersInfo.java,17,8,4,1,0,13
hadoop-trunk\hadoop-trunk\hadoop-hdfs-project\hadoop-hdfs\src\main\java\org\apache\hadoop\hdfs\server\namenode\FSDirSatisfyStoragePolicyOp.java,0,10,2,2,0,14
hadoop-trunk\hadoop-trunk\hadoop-common-project\hadoop-nfs\src\main\java\org\apache\hadoop\oncrpc\SimpleTcpClientHandler.java,35,16,7,1,0,24
hadoop-trunk\hadoop-trunk\hadoop-mapreduce-project\hadoop-mapreduce-client\hadoop-mapreduce-client-core\src\main\java\org\apache\hadoop\mapreduce\task\ReduceContextImpl.java,0,105,7,3,0,115
hadoop-trunk\hadoop-trunk\hadoop-mapreduce-project\hadoop-mapreduce-client\hadoop-mapreduce-client-jobclient\src\test\java\org\apache\hadoop\mapreduce\EntityWriterV2.java,0,5,1,2,0,8
hadoop-trunk\hadoop-trunk\hadoop-yarn-project\hadoop-yarn\hadoop-yarn-server\hadoop-yarn-server-resourcemanager\src\test\java\org\apache\hadoop\yarn\server\resourcemanager\blacklist\TestBlacklistManager.java,92,11,0,1,0,12
hadoop-trunk\hadoop-trunk\hadoop-yarn-project\hadoop-yarn\hadoop-yarn-server\hadoop-yarn-server-resourcemanager\src\main\java\org\apache\hadoop\yarn\server\resourcemanager\scheduler\fair\converter\FSQueueConverter.java,268,46,4,23,0,73
hadoop-trunk\hadoop-trunk\hadoop-yarn-project\hadoop-yarn\hadoop-yarn-client\src\main\java\org\apache\hadoop\yarn\client\api\AMRMClient.java,818,253,9,7,0,269
hadoop-trunk\hadoop-trunk\hadoop-hdfs-project\hadoop-hdfs\src\main\java\org\apache\hadoop\hdfs\web\resources\TokenServiceParam.java,23,7,3,2,0,12
hadoop-trunk\hadoop-trunk\hadoop-hdfs-project\hadoop-hdfs-rbf\src\main\java\org\apache\hadoop\hdfs\server\federation\fairness\AbstractRouterRpcFairnessPolicyController.java,0,15,1,1,0,17
hadoop-trunk\hadoop-trunk\hadoop-mapreduce-project\hadoop-mapreduce-client\hadoop-mapreduce-client-app\src\main\java\org\apache\hadoop\mapreduce\v2\app\job\event\TaskAttemptContainerAssignedEvent.java,21,12,0,1,0,13
hadoop-trunk\hadoop-trunk\hadoop-hdfs-project\hadoop-hdfs\src\test\java\org\apache\hadoop\hdfs\server\namenode\TestStartupProgressServlet.java,224,33,3,3,0,39
hadoop-trunk\hadoop-trunk\hadoop-mapreduce-project\hadoop-mapreduce-client\hadoop-mapreduce-client-nativetask\src\test\java\org\apache\hadoop\mapred\nativetask\combinertest\CombinerTest.java,78,25,1,11,0,37
hadoop-trunk\hadoop-trunk\hadoop-yarn-project\hadoop-yarn\hadoop-yarn-applications\hadoop-yarn-services\hadoop-yarn-services-core\src\main\java\org\apache\hadoop\yarn\service\timelineservice\ServiceMetricsSink.java,62,8,8,1,0,17
hadoop-trunk\hadoop-trunk\hadoop-yarn-project\hadoop-yarn\hadoop-yarn-server\hadoop-yarn-server-nodemanager\src\main\java\org\apache\hadoop\yarn\server\nodemanager\NodeResourceMonitorImpl.java,184,15,5,3,0,23
hadoop-trunk\hadoop-trunk\hadoop-yarn-project\hadoop-yarn\hadoop-yarn-server\hadoop-yarn-server-nodemanager\src\main\java\org\apache\hadoop\yarn\server\nodemanager\containermanager\linux\resources\CGroupsBlkioResourceHandlerImpl.java,137,22,7,4,0,33
hadoop-trunk\hadoop-trunk\hadoop-common-project\hadoop-common\src\main\java\org\apache\hadoop\io\compress\ZStandardCodec.java,0,25,1,3,0,29
hadoop-trunk\hadoop-trunk\hadoop-mapreduce-project\hadoop-mapreduce-client\hadoop-mapreduce-client-app\src\test\java\org\apache\hadoop\mapreduce\v2\app\MockAppContext.java,133,65,1,3,0,69
hadoop-trunk\hadoop-trunk\hadoop-hdfs-project\hadoop-hdfs\src\test\java\org\apache\hadoop\fs\TestSymlinkHdfsFileContext.java,27,7,1,1,0,9
hadoop-trunk\hadoop-trunk\hadoop-yarn-project\hadoop-yarn\hadoop-yarn-server\hadoop-yarn-server-nodemanager\src\test\java\org\apache\hadoop\yarn\server\nodemanager\containermanager\monitor\MockMemoryResourceCalculatorProcessTree.java,65,14,2,2,0,18
hadoop-trunk\hadoop-trunk\hadoop-yarn-project\hadoop-yarn\hadoop-yarn-common\src\main\java\org\apache\hadoop\yarn\api\records\impl\pb\ReservationIdPBImpl.java,47,18,21,1,0,40
hadoop-trunk\hadoop-trunk\hadoop-yarn-project\hadoop-yarn\hadoop-yarn-server\hadoop-yarn-server-timelineservice-hbase\hadoop-yarn-server-timelineservice-hbase-common\src\main\java\org\apache\hadoop\yarn\server\timelineservice\storage\common\TimestampGenerator.java,89,7,2,1,0,10
hadoop-trunk\hadoop-trunk\hadoop-hdfs-project\hadoop-hdfs\src\test\java\org\apache\hadoop\hdfs\TestWriteStripedFileWithFailure.java,143,36,4,3,0,43
hadoop-trunk\hadoop-trunk\hadoop-yarn-project\hadoop-yarn\hadoop-yarn-server\hadoop-yarn-server-nodemanager\src\main\java\org\apache\hadoop\yarn\server\nodemanager\containermanager\runtime\ContainerRuntimeConstants.java,18,4,0,1,0,5
hadoop-trunk\hadoop-trunk\hadoop-yarn-project\hadoop-yarn\hadoop-yarn-applications\hadoop-yarn-services\hadoop-yarn-services-core\src\main\java\org\apache\hadoop\yarn\service\provider\ProviderFactory.java,47,12,4,2,0,18
hadoop-trunk\hadoop-trunk\hadoop-hdfs-project\hadoop-hdfs\src\main\java\org\apache\hadoop\hdfs\server\namenode\NameNodeLayoutVersion.java,0,34,1,3,0,38
hadoop-trunk\hadoop-trunk\hadoop-yarn-project\hadoop-yarn\hadoop-yarn-server\hadoop-yarn-server-common\src\test\java\org\apache\hadoop\yarn\server\federation\store\records\TestFederationProtocolRecords.java,182,30,56,57,0,143
hadoop-trunk\hadoop-trunk\hadoop-common-project\hadoop-common\src\main\java\org\apache\hadoop\net\SocketIOWithTimeout.java,0,135,9,1,0,145
hadoop-trunk\hadoop-trunk\hadoop-yarn-project\hadoop-yarn\hadoop-yarn-server\hadoop-yarn-server-resourcemanager\src\main\java\org\apache\hadoop\yarn\server\resourcemanager\reservation\InMemoryReservationAllocation.java,177,79,4,2,0,85
hadoop-trunk\hadoop-trunk\hadoop-hdfs-project\hadoop-hdfs\src\main\java\org\apache\hadoop\hdfs\server\balancer\BalancerParameters.java,0,36,2,1,0,39
hadoop-trunk\hadoop-trunk\hadoop-hdfs-project\hadoop-hdfs-rbf\src\test\java\org\apache\hadoop\fs\contract\router\web\TestRouterWebHDFSContractAppend.java,0,4,0,1,0,5
hadoop-trunk\hadoop-trunk\hadoop-tools\hadoop-datajoin\src\main\java\org\apache\hadoop\contrib\utils\join\DataJoinMapperBase.java,78,34,5,2,0,41
hadoop-trunk\hadoop-trunk\hadoop-yarn-project\hadoop-yarn\hadoop-yarn-server\hadoop-yarn-server-common\src\main\java\org\apache\hadoop\yarn\server\api\SCMUploaderProtocol.java,0,2,2,5,0,9
hadoop-trunk\hadoop-trunk\hadoop-tools\hadoop-openstack\src\main\java\org\apache\hadoop\fs\swift\exceptions\SwiftInternalStateException.java,15,8,0,1,0,9
hadoop-trunk\hadoop-trunk\hadoop-yarn-project\hadoop-yarn\hadoop-yarn-server\hadoop-yarn-server-resourcemanager\src\main\java\org\apache\hadoop\yarn\server\resourcemanager\recovery\FileSystemRMStateStore.java,932,153,53,16,0,222
hadoop-trunk\hadoop-trunk\hadoop-tools\hadoop-aws\src\main\java\org\apache\hadoop\fs\s3a\impl\RequestFactoryImpl.java,637,61,6,3,0,70
hadoop-trunk\hadoop-trunk\hadoop-tools\hadoop-streaming\src\test\java\org\apache\hadoop\streaming\TestMultipleCachefiles.java,0,69,16,2,0,87
hadoop-trunk\hadoop-trunk\hadoop-common-project\hadoop-common\src\main\java\org\apache\hadoop\fs\store\audit\package-info.java,0,0,0,1,0,1
hadoop-trunk\hadoop-trunk\hadoop-mapreduce-project\hadoop-mapreduce-client\hadoop-mapreduce-client-core\src\main\java\org\apache\hadoop\mapreduce\lib\partition\TotalOrderPartitioner.java,0,170,12,6,0,188
hadoop-trunk\hadoop-trunk\hadoop-mapreduce-project\hadoop-mapreduce-client\hadoop-mapreduce-client-hs\src\main\java\org\apache\hadoop\mapreduce\v2\hs\webapp\HsWebServices.java,459,135,7,7,0,149
hadoop-trunk\hadoop-trunk\hadoop-yarn-project\hadoop-yarn\hadoop-yarn-server\hadoop-yarn-server-web-proxy\src\main\java\org\apache\hadoop\yarn\server\webproxy\amfilter\AmIpFilter.java,190,40,5,1,0,46
hadoop-trunk\hadoop-trunk\hadoop-common-project\hadoop-common\src\main\java\org\apache\hadoop\util\IndexedSorter.java,0,7,0,1,0,8
hadoop-trunk\hadoop-trunk\hadoop-common-project\hadoop-common\src\test\java\org\apache\hadoop\test\MoreAsserts.java,41,17,1,1,0,19
hadoop-trunk\hadoop-trunk\hadoop-mapreduce-project\hadoop-mapreduce-client\hadoop-mapreduce-client-core\src\main\java\org\apache\hadoop\mapred\SequenceFileAsBinaryOutputFormat.java,0,69,7,4,0,80
hadoop-trunk\hadoop-trunk\hadoop-hdfs-project\hadoop-hdfs-rbf\src\main\java\org\apache\hadoop\hdfs\server\federation\metrics\FederationRPCPerformanceMonitor.java,230,32,1,2,0,35
hadoop-trunk\hadoop-trunk\hadoop-yarn-project\hadoop-yarn\hadoop-yarn-applications\hadoop-yarn-applications-mawo\hadoop-yarn-applications-mawo-core\src\main\java\org\apache\hadoop\applications\mawo\server\worker\package-info.java,0,1,0,1,0,2
hadoop-trunk\hadoop-trunk\hadoop-hdfs-project\hadoop-hdfs\src\test\java\org\apache\hadoop\hdfs\server\namenode\TestSecondaryWebUi.java,47,15,4,2,0,21
hadoop-trunk\hadoop-trunk\hadoop-yarn-project\hadoop-yarn\hadoop-yarn-api\src\main\java\org\apache\hadoop\yarn\api\records\NodeAttributeType.java,0,0,0,1,0,1
hadoop-trunk\hadoop-trunk\hadoop-yarn-project\hadoop-yarn\hadoop-yarn-server\hadoop-yarn-server-router\src\main\java\org\apache\hadoop\yarn\server\router\Router.java,136,27,3,1,0,31
hadoop-trunk\hadoop-trunk\hadoop-tools\hadoop-rumen\src\main\java\org\apache\hadoop\tools\rumen\JobConfPropertyNames.java,0,9,0,1,0,10
hadoop-trunk\hadoop-trunk\hadoop-hdfs-project\hadoop-hdfs-nfs\src\test\java\org\apache\hadoop\hdfs\nfs\nfs3\TestNfs3Utils.java,48,60,4,14,0,78
hadoop-trunk\hadoop-trunk\hadoop-yarn-project\hadoop-yarn\hadoop-yarn-server\hadoop-yarn-server-timelineservice\src\test\java\org\apache\hadoop\yarn\server\timelineservice\storage\TestTimelineSchemaCreator.java,14,3,0,1,0,4
hadoop-trunk\hadoop-trunk\hadoop-mapreduce-project\hadoop-mapreduce-client\hadoop-mapreduce-client-jobclient\src\test\java\org\apache\hadoop\mapred\TestJobName.java,79,5,8,2,0,15
hadoop-trunk\hadoop-trunk\hadoop-tools\hadoop-azure\src\main\java\org\apache\hadoop\fs\azure\BlockBlobInputStream.java,0,52,2,1,0,55
hadoop-trunk\hadoop-trunk\hadoop-common-project\hadoop-common\src\test\java\org\apache\hadoop\fs\TestFilterFileSystem.java,296,168,67,4,0,239
hadoop-trunk\hadoop-trunk\hadoop-yarn-project\hadoop-yarn\hadoop-yarn-server\hadoop-yarn-server-resourcemanager\src\test\java\org\apache\hadoop\yarn\server\resourcemanager\scheduler\fair\TestQueueManagerRealScheduler.java,83,26,0,1,0,27
hadoop-trunk\hadoop-trunk\hadoop-hdfs-project\hadoop-hdfs\src\test\java\org\apache\hadoop\hdfs\tools\TestDFSHAAdmin.java,395,86,6,19,0,111
hadoop-trunk\hadoop-trunk\hadoop-yarn-project\hadoop-yarn\hadoop-yarn-server\hadoop-yarn-server-common\src\main\java\org\apache\hadoop\yarn\server\api\protocolrecords\LogAggregationReport.java,51,8,0,1,0,9
hadoop-trunk\hadoop-trunk\hadoop-hdfs-project\hadoop-hdfs-rbf\src\main\java\org\apache\hadoop\hdfs\protocolPB\RouterAdminProtocol.java,3,0,1,1,0,2
hadoop-trunk\hadoop-trunk\hadoop-hdfs-project\hadoop-hdfs\src\main\java\org\apache\hadoop\hdfs\server\protocol\HeartbeatResponse.java,50,37,0,1,0,38
hadoop-trunk\hadoop-trunk\hadoop-mapreduce-project\hadoop-mapreduce-client\hadoop-mapreduce-client-jobclient\src\test\java\org\apache\hadoop\mapred\TestMiniMRDFSCaching.java,43,5,6,2,0,13
hadoop-trunk\hadoop-trunk\hadoop-yarn-project\hadoop-yarn\hadoop-yarn-common\src\main\java\org\apache\hadoop\yarn\nodelabels\store\op\RemoveClusterLabelOp.java,0,15,3,1,0,19
hadoop-trunk\hadoop-trunk\hadoop-yarn-project\hadoop-yarn\hadoop-yarn-api\src\main\java\org\apache\hadoop\yarn\api\records\timelineservice\TimelineEntity.java,557,155,10,1,0,166
hadoop-trunk\hadoop-trunk\hadoop-common-project\hadoop-common\src\main\java\org\apache\hadoop\metrics2\filter\AbstractPatternFilter.java,132,33,4,1,0,38
hadoop-trunk\hadoop-trunk\hadoop-common-project\hadoop-common\src\test\java\org\apache\hadoop\fs\contract\AbstractContractStreamIOStatisticsTest.java,0,10,1,8,0,19
hadoop-trunk\hadoop-trunk\hadoop-yarn-project\hadoop-yarn\hadoop-yarn-server\hadoop-yarn-server-resourcemanager\src\test\java\org\apache\hadoop\yarn\server\resourcemanager\scheduler\capacity\CapacitySchedulerConfigGeneratorForTest.java,0,33,1,3,0,37
hadoop-trunk\hadoop-trunk\hadoop-hdfs-project\hadoop-hdfs-client\src\main\java\org\apache\hadoop\hdfs\server\datanode\BlockMetadataHeader.java,0,54,1,1,0,56
hadoop-trunk\hadoop-trunk\hadoop-hdfs-project\hadoop-hdfs-rbf\src\test\java\org\apache\hadoop\fs\contract\router\TestRouterHDFSContractRootDirectory.java,43,4,0,1,0,5
hadoop-trunk\hadoop-trunk\hadoop-tools\hadoop-streaming\src\main\java\org\apache\hadoop\typedbytes\TypedBytesWritableOutput.java,175,68,5,2,0,75
hadoop-trunk\hadoop-trunk\hadoop-yarn-project\hadoop-yarn\hadoop-yarn-api\src\main\java\org\apache\hadoop\yarn\api\records\CollectorInfo.java,30,9,0,1,0,10
hadoop-trunk\hadoop-trunk\hadoop-mapreduce-project\hadoop-mapreduce-client\hadoop-mapreduce-client-core\src\main\java\org\apache\hadoop\mapreduce\util\ConfigUtil.java,0,11,5,2,0,18
hadoop-trunk\hadoop-trunk\hadoop-yarn-project\hadoop-yarn\hadoop-yarn-server\hadoop-yarn-server-resourcemanager\src\main\java\org\apache\hadoop\yarn\server\resourcemanager\scheduler\SchedulerAppReport.java,37,13,0,1,0,14
hadoop-trunk\hadoop-trunk\hadoop-hdfs-project\hadoop-hdfs-rbf\src\test\java\org\apache\hadoop\hdfs\server\federation\MiniRouterDFSCluster.java,1068,259,10,29,0,298
hadoop-trunk\hadoop-trunk\hadoop-mapreduce-project\hadoop-mapreduce-client\hadoop-mapreduce-client-core\src\main\java\org\apache\hadoop\mapred\JobEndNotifier.java,150,47,20,2,0,69
hadoop-trunk\hadoop-trunk\hadoop-common-project\hadoop-common\src\main\java\org\apache\hadoop\io\compress\DecompressorStream.java,217,51,5,1,0,57
hadoop-trunk\hadoop-trunk\hadoop-yarn-project\hadoop-yarn\hadoop-yarn-common\src\main\java\org\apache\hadoop\yarn\api\impl\pb\service\package-info.java,0,1,0,1,0,2
hadoop-trunk\hadoop-trunk\hadoop-yarn-project\hadoop-yarn\hadoop-yarn-server\hadoop-yarn-server-timelineservice\src\main\java\org\apache\hadoop\yarn\server\timelineservice\storage\NoOpTimelineWriterImpl.java,43,18,0,2,0,20
hadoop-trunk\hadoop-trunk\hadoop-common-project\hadoop-common\src\test\java\org\apache\hadoop\fs\viewfs\TestViewFsConfig.java,36,1,0,1,0,2
hadoop-trunk\hadoop-trunk\hadoop-hdfs-project\hadoop-hdfs\src\test\java\org\apache\hadoop\hdfs\TestDecommissionWithStriped.java,0,169,27,3,0,199
hadoop-trunk\hadoop-trunk\hadoop-common-project\hadoop-nfs\src\main\java\org\apache\hadoop\nfs\nfs3\request\RMDIR3Request.java,26,13,0,1,0,14
hadoop-trunk\hadoop-trunk\hadoop-hdfs-project\hadoop-hdfs\src\test\java\org\apache\hadoop\hdfs\server\blockmanagement\TestUnderReplicatedBlocks.java,135,23,10,2,0,35
hadoop-trunk\hadoop-trunk\hadoop-tools\hadoop-aws\src\main\java\org\apache\hadoop\fs\s3a\s3guard\S3Guard.java,0,18,1,6,0,25
hadoop-trunk\hadoop-trunk\hadoop-mapreduce-project\hadoop-mapreduce-client\hadoop-mapreduce-client-core\src\main\java\org\apache\hadoop\mapreduce\lib\aggregate\UserDefinedValueAggregatorDescriptor.java,83,23,3,1,0,27
hadoop-trunk\hadoop-trunk\hadoop-yarn-project\hadoop-yarn\hadoop-yarn-common\src\main\java\org\apache\hadoop\yarn\server\api\protocolrecords\impl\pb\RefreshUserToGroupsMappingsResponsePBImpl.java,42,22,18,6,0,46
hadoop-trunk\hadoop-trunk\hadoop-hdfs-project\hadoop-hdfs\src\main\java\org\apache\hadoop\hdfs\server\common\InconsistentFSStateException.java,0,15,1,1,0,17
hadoop-trunk\hadoop-trunk\hadoop-yarn-project\hadoop-yarn\hadoop-yarn-common\src\main\java\org\apache\hadoop\yarn\api\protocolrecords\impl\pb\GetClusterNodeLabelsRequestPBImpl.java,43,18,18,3,0,39
hadoop-trunk\hadoop-trunk\hadoop-hdfs-project\hadoop-hdfs-client\src\main\java\org\apache\hadoop\hdfs\protocolPB\PBHelperClient.java,3278,571,167,52,0,790
hadoop-trunk\hadoop-trunk\hadoop-hdfs-project\hadoop-hdfs-client\src\test\java\org\apache\hadoop\hdfs\util\TestByteArrayManager.java,596,188,3,10,0,201
hadoop-trunk\hadoop-trunk\hadoop-tools\hadoop-rumen\src\main\java\org\apache\hadoop\tools\rumen\InputDemuxer.java,0,6,2,4,0,12
hadoop-trunk\hadoop-trunk\hadoop-yarn-project\hadoop-yarn\hadoop-yarn-common\src\main\java\org\apache\hadoop\yarn\api\impl\pb\service\ApplicationMasterProtocolPBServiceImpl.java,53,23,19,18,0,60
hadoop-trunk\hadoop-trunk\hadoop-yarn-project\hadoop-yarn\hadoop-yarn-server\hadoop-yarn-server-resourcemanager\src\test\java\org\apache\hadoop\yarn\server\resourcemanager\QueueACLsTestBase.java,284,35,0,1,0,36
hadoop-trunk\hadoop-trunk\hadoop-cloud-storage-project\hadoop-huaweicloud\src\main\java\org\apache\hadoop\fs\obs\OBSPosixBucketUtils.java,0,0,11,1,0,12
hadoop-trunk\hadoop-trunk\hadoop-mapreduce-project\hadoop-mapreduce-client\hadoop-mapreduce-client-app\src\main\java\org\apache\hadoop\mapreduce\v2\app\job\impl\MapTaskImpl.java,56,24,2,1,0,27
hadoop-trunk\hadoop-trunk\hadoop-yarn-project\hadoop-yarn\hadoop-yarn-server\hadoop-yarn-server-nodemanager\src\main\java\org\apache\hadoop\yarn\server\nodemanager\containermanager\linux\resources\ResourceHandler.java,0,6,0,5,0,11
hadoop-trunk\hadoop-trunk\hadoop-mapreduce-project\hadoop-mapreduce-client\hadoop-mapreduce-client-jobclient\src\test\java\org\apache\hadoop\mapreduce\lib\fieldsel\TestMRFieldSelection.java,91,106,26,1,0,133
hadoop-trunk\hadoop-trunk\hadoop-yarn-project\hadoop-yarn\hadoop-yarn-server\hadoop-yarn-server-resourcemanager\src\test\java\org\apache\hadoop\yarn\server\resourcemanager\monitor\capacity\mockframework\MockQueueHierarchy.java,0,62,7,23,0,92
hadoop-trunk\hadoop-trunk\hadoop-hdfs-project\hadoop-hdfs-httpfs\src\main\java\org\apache\hadoop\lib\service\scheduler\SchedulerService.java,95,32,4,9,0,45
hadoop-trunk\hadoop-trunk\hadoop-hdfs-project\hadoop-hdfs\src\test\java\org\apache\hadoop\hdfs\server\namenode\TestQuotaWithStripedBlocks.java,102,20,5,1,0,26
hadoop-trunk\hadoop-trunk\hadoop-tools\hadoop-azure\src\test\java\org\apache\hadoop\fs\azurebfs\ITestAzureBlobFileSystemDelete.java,219,16,0,9,0,25
hadoop-trunk\hadoop-trunk\hadoop-common-project\hadoop-auth\src\test\java\org\apache\hadoop\security\authentication\client\TestAuthenticatedURL.java,93,8,0,3,0,11
hadoop-trunk\hadoop-trunk\hadoop-hdfs-project\hadoop-hdfs\src\test\java\org\apache\hadoop\hdfs\server\datanode\TestDataNodeMXBean.java,245,47,28,3,0,78
hadoop-trunk\hadoop-trunk\hadoop-mapreduce-project\hadoop-mapreduce-client\hadoop-mapreduce-client-jobclient\src\test\java\org\apache\hadoop\mapred\TestMapProgress.java,225,91,12,7,0,110
hadoop-trunk\hadoop-trunk\hadoop-yarn-project\hadoop-yarn\hadoop-yarn-server\hadoop-yarn-server-resourcemanager\src\main\java\org\apache\hadoop\yarn\server\resourcemanager\rmapp\RMAppRunningOnNodeEvent.java,13,8,0,1,0,9
hadoop-trunk\hadoop-trunk\hadoop-hdfs-project\hadoop-hdfs\src\main\java\org\apache\hadoop\hdfs\server\namenode\startupprogress\Phase.java,0,12,2,1,0,15
hadoop-trunk\hadoop-trunk\hadoop-hdfs-project\hadoop-hdfs\src\main\java\org\apache\hadoop\hdfs\server\diskbalancer\datamodel\DiskBalancerVolume.java,340,35,3,1,0,39
hadoop-trunk\hadoop-trunk\hadoop-hdfs-project\hadoop-hdfs\src\test\java\org\apache\hadoop\hdfs\server\namenode\TestINodeAttributeProvider.java,557,65,26,3,0,94
hadoop-trunk\hadoop-trunk\hadoop-hdfs-project\hadoop-hdfs\src\test\java\org\apache\hadoop\hdfs\server\namenode\ha\TestStandbyBlockManagement.java,61,12,0,3,0,15
hadoop-trunk\hadoop-trunk\hadoop-tools\hadoop-azure-datalake\src\test\java\org\apache\hadoop\fs\adl\live\TestAdlInternalCreateNonRecursive.java,0,19,3,1,0,23
hadoop-trunk\hadoop-trunk\hadoop-yarn-project\hadoop-yarn\hadoop-yarn-common\src\test\java\org\apache\hadoop\yarn\webapp\view\TestCommonViews.java,25,10,14,1,0,25
hadoop-trunk\hadoop-trunk\hadoop-yarn-project\hadoop-yarn\hadoop-yarn-applications\hadoop-yarn-services\hadoop-yarn-services-core\src\main\java\org\apache\hadoop\yarn\service\api\records\ComponentState.java,0,6,0,1,0,7
hadoop-trunk\hadoop-trunk\hadoop-hdfs-project\hadoop-hdfs\src\test\java\org\apache\hadoop\hdfs\server\blockmanagement\TestBlockManager.java,1781,299,67,19,0,385
hadoop-trunk\hadoop-trunk\hadoop-yarn-project\hadoop-yarn\hadoop-yarn-server\hadoop-yarn-server-nodemanager\src\main\java\org\apache\hadoop\yarn\server\nodemanager\security\authorize\NMPolicyProvider.java,41,9,3,2,0,14
hadoop-trunk\hadoop-trunk\hadoop-common-project\hadoop-common\src\test\java\org\apache\hadoop\fs\TestContentSummary.java,264,75,2,2,0,79
hadoop-trunk\hadoop-trunk\hadoop-tools\hadoop-streaming\src\test\java\org\apache\hadoop\streaming\UtilTest.java,0,26,6,2,0,34
hadoop-trunk\hadoop-trunk\hadoop-mapreduce-project\hadoop-mapreduce-client\hadoop-mapreduce-client-jobclient\src\test\java\org\apache\hadoop\mapreduce\security\token\delegation\TestDelegationToken.java,108,29,13,1,0,43
hadoop-trunk\hadoop-trunk\hadoop-tools\hadoop-azure\src\test\java\org\apache\hadoop\fs\azurebfs\contract\ITestAbfsFileSystemContractMkdir.java,26,7,0,2,0,9
hadoop-trunk\hadoop-trunk\hadoop-tools\hadoop-aws\src\main\java\org\apache\hadoop\fs\s3a\statistics\CountersAndGauges.java,0,0,0,1,0,1
hadoop-trunk\hadoop-trunk\hadoop-tools\hadoop-azure\src\test\java\org\apache\hadoop\fs\azure\TestWasbFsck.java,101,18,0,3,0,21
hadoop-trunk\hadoop-trunk\hadoop-tools\hadoop-gridmix\src\main\java\org\apache\hadoop\mapred\gridmix\ClusterSummarizer.java,0,24,2,1,0,27
hadoop-trunk\hadoop-trunk\hadoop-common-project\hadoop-common\src\test\java\org\apache\hadoop\io\file\tfile\TestTFileNoneCodecsByteArrays.java,11,4,0,1,0,5
hadoop-trunk\hadoop-trunk\hadoop-mapreduce-project\hadoop-mapreduce-client\hadoop-mapreduce-client-core\src\main\java\org\apache\hadoop\mapred\lib\InverseMapper.java,0,13,0,1,0,14
hadoop-trunk\hadoop-trunk\hadoop-hdfs-project\hadoop-hdfs-nfs\src\test\java\org\apache\hadoop\hdfs\nfs\nfs3\TestWrites.java,707,188,64,10,0,262
hadoop-trunk\hadoop-trunk\hadoop-common-project\hadoop-common\src\main\java\org\apache\hadoop\util\ProtoUtil.java,173,57,38,4,0,99
hadoop-trunk\hadoop-trunk\hadoop-hdfs-project\hadoop-hdfs\src\test\java\org\apache\hadoop\hdfs\client\impl\TestBlockReaderLocalLegacy.java,175,35,9,5,0,49
hadoop-trunk\hadoop-trunk\hadoop-mapreduce-project\hadoop-mapreduce-client\hadoop-mapreduce-client-core\src\main\java\org\apache\hadoop\mapred\lib\CombineSequenceFileInputFormat.java,0,21,0,1,0,22
hadoop-trunk\hadoop-trunk\hadoop-tools\hadoop-kafka\src\main\java\org\apache\hadoop\metrics2\sink\KafkaSink.java,0,20,4,1,0,25
hadoop-trunk\hadoop-trunk\hadoop-yarn-project\hadoop-yarn\hadoop-yarn-server\hadoop-yarn-server-common\src\main\java\org\apache\hadoop\yarn\server\federation\store\records\SubClusterState.java,0,5,2,1,0,8
hadoop-trunk\hadoop-trunk\hadoop-yarn-project\hadoop-yarn\hadoop-yarn-server\hadoop-yarn-server-resourcemanager\src\test\java\org\apache\hadoop\yarn\server\resourcemanager\applicationsmanager\TestAMRMRPCResponseId.java,79,15,0,3,0,18
hadoop-trunk\hadoop-trunk\hadoop-common-project\hadoop-common\src\test\java\org\apache\hadoop\cli\util\TokenComparator.java,21,9,0,1,0,10
hadoop-trunk\hadoop-trunk\hadoop-yarn-project\hadoop-yarn\hadoop-yarn-api\src\main\java\org\apache\hadoop\yarn\exceptions\package-info.java,0,2,0,1,0,3
hadoop-trunk\hadoop-trunk\hadoop-yarn-project\hadoop-yarn\hadoop-yarn-server\hadoop-yarn-server-resourcemanager\src\test\java\org\apache\hadoop\yarn\server\resourcemanager\scheduler\capacity\TestLeafQueue.java,5302,2278,395,112,0,2785
hadoop-trunk\hadoop-trunk\hadoop-yarn-project\hadoop-yarn\hadoop-yarn-api\src\main\java\org\apache\hadoop\yarn\api\records\impl\LightWeightResource.java,133,29,8,2,0,39
hadoop-trunk\hadoop-trunk\hadoop-tools\hadoop-streaming\src\main\java\org\apache\hadoop\record\BinaryRecordOutput.java,108,83,8,1,0,92
hadoop-trunk\hadoop-trunk\hadoop-hdfs-project\hadoop-hdfs\src\test\java\org\apache\hadoop\hdfs\TestDFSUpgradeFromImage.java,0,160,19,8,0,187
hadoop-trunk\hadoop-trunk\hadoop-hdfs-project\hadoop-hdfs\src\test\java\org\apache\hadoop\hdfs\TestRead.java,151,44,5,3,0,52
hadoop-trunk\hadoop-trunk\hadoop-yarn-project\hadoop-yarn\hadoop-yarn-server\hadoop-yarn-server-resourcemanager\src\test\java\org\apache\hadoop\yarn\server\resourcemanager\TestRMDispatcher.java,45,7,3,5,0,15
hadoop-trunk\hadoop-trunk\hadoop-tools\hadoop-aws\src\main\java\org\apache\hadoop\fs\s3a\statistics\impl\StatisticsFromAwsSdkImpl.java,51,3,5,1,0,9
hadoop-trunk\hadoop-trunk\hadoop-yarn-project\hadoop-yarn\hadoop-yarn-server\hadoop-yarn-server-timelineservice\src\test\java\org\apache\hadoop\yarn\server\timelineservice\reader\TestTimelineReaderWhitelistAuthorizationFilter.java,381,22,32,2,0,56
hadoop-trunk\hadoop-trunk\hadoop-tools\hadoop-aws\src\test\java\org\apache\hadoop\fs\s3a\tools\ITestMarkerTool.java,499,36,7,8,0,51
hadoop-trunk\hadoop-trunk\hadoop-yarn-project\hadoop-yarn\hadoop-yarn-api\src\main\java\org\apache\hadoop\yarn\util\resource\package-info.java,0,1,0,1,0,2
hadoop-trunk\hadoop-trunk\hadoop-common-project\hadoop-common\src\test\java\org\apache\hadoop\fs\TestCommandFormat.java,173,58,1,1,0,60
hadoop-trunk\hadoop-trunk\hadoop-yarn-project\hadoop-yarn\hadoop-yarn-common\src\main\java\org\apache\hadoop\yarn\security\AMRMTokenIdentifier.java,117,34,27,2,0,63
hadoop-trunk\hadoop-trunk\hadoop-mapreduce-project\hadoop-mapreduce-client\hadoop-mapreduce-client-core\src\main\java\org\apache\hadoop\mapreduce\task\reduce\InMemoryWriter.java,0,27,0,1,0,28
hadoop-trunk\hadoop-trunk\hadoop-tools\hadoop-resourceestimator\src\main\java\org\apache\hadoop\resourceestimator\solver\exceptions\InvalidInputException.java,9,1,0,1,0,2
hadoop-trunk\hadoop-trunk\hadoop-yarn-project\hadoop-yarn\hadoop-yarn-server\hadoop-yarn-server-timelineservice-hbase\hadoop-yarn-server-timelineservice-hbase-common\src\main\java\org\apache\hadoop\yarn\server\timelineservice\storage\common\NumericValueConverter.java,13,1,0,1,0,2
hadoop-trunk\hadoop-trunk\hadoop-yarn-project\hadoop-yarn\hadoop-yarn-server\hadoop-yarn-server-resourcemanager\src\main\java\org\apache\hadoop\yarn\server\resourcemanager\scheduler\placement\ResourceUsageMultiNodeLookupPolicy.java,0,16,0,1,0,17
hadoop-trunk\hadoop-trunk\hadoop-common-project\hadoop-common\src\test\java\org\apache\hadoop\security\TestJNIGroupsMapping.java,39,20,9,1,0,30
hadoop-trunk\hadoop-trunk\hadoop-common-project\hadoop-nfs\src\main\java\org\apache\hadoop\nfs\nfs3\response\FSSTAT3Response.java,113,37,2,1,0,40
hadoop-trunk\hadoop-trunk\hadoop-hdfs-project\hadoop-hdfs\src\main\java\org\apache\hadoop\hdfs\server\namenode\BackupState.java,41,12,0,2,0,14
hadoop-trunk\hadoop-trunk\hadoop-yarn-project\hadoop-yarn\hadoop-yarn-server\hadoop-yarn-server-nodemanager\src\main\java\org\apache\hadoop\yarn\server\nodemanager\containermanager\linux\resources\numa\NumaResourceAllocator.java,300,38,7,6,0,51
hadoop-trunk\hadoop-trunk\hadoop-yarn-project\hadoop-yarn\hadoop-yarn-api\src\main\java\org\apache\hadoop\yarn\exceptions\InvalidApplicationMasterRequestException.java,18,11,0,3,0,14
hadoop-trunk\hadoop-trunk\hadoop-tools\hadoop-aws\src\main\java\org\apache\hadoop\fs\s3a\InconsistentAmazonS3Client.java,279,54,8,2,0,64
hadoop-trunk\hadoop-trunk\hadoop-tools\hadoop-aws\src\main\java\org\apache\hadoop\fs\s3a\audit\S3LogParser.java,0,6,0,1,0,7
hadoop-trunk\hadoop-trunk\hadoop-hdfs-project\hadoop-hdfs\src\main\java\org\apache\hadoop\hdfs\server\namenode\QuotaCounts.java,257,73,0,1,0,74
hadoop-trunk\hadoop-trunk\hadoop-yarn-project\hadoop-yarn\hadoop-yarn-server\hadoop-yarn-server-timelineservice-hbase\hadoop-yarn-server-timelineservice-hbase-server\hadoop-yarn-server-timelineservice-hbase-server-2\src\main\java\org\apache\hadoop\yarn\server\timelineservice\storage\common\HBaseTimelineServerUtils.java,0,23,7,3,0,33
hadoop-trunk\hadoop-trunk\hadoop-tools\hadoop-dynamometer\hadoop-dynamometer-blockgen\src\test\java\org\apache\hadoop\tools\dynamometer\blockgenerator\TestBlockGen.java,57,11,0,1,0,12
hadoop-trunk\hadoop-trunk\hadoop-mapreduce-project\hadoop-mapreduce-client\hadoop-mapreduce-client-common\src\main\java\org\apache\hadoop\mapreduce\v2\api\records\AMInfo.java,0,25,12,1,0,38
hadoop-trunk\hadoop-trunk\hadoop-tools\hadoop-azure\src\test\java\org\apache\hadoop\fs\azurebfs\ITestAzureBlobFileSystemAttributes.java,78,11,0,6,0,17
hadoop-trunk\hadoop-trunk\hadoop-yarn-project\hadoop-yarn\hadoop-yarn-client\src\main\java\org\apache\hadoop\yarn\client\api\impl\YarnClientImpl.java,1039,171,21,22,0,214
hadoop-trunk\hadoop-trunk\hadoop-hdfs-project\hadoop-hdfs\src\main\java\org\apache\hadoop\hdfs\server\common\sps\BlockDispatcher.java,129,27,16,4,0,47
hadoop-trunk\hadoop-trunk\hadoop-yarn-project\hadoop-yarn\hadoop-yarn-server\hadoop-yarn-server-applicationhistoryservice\src\main\java\org\apache\hadoop\yarn\server\applicationhistoryservice\records\ContainerFinishData.java,59,16,0,1,0,17
hadoop-trunk\hadoop-trunk\hadoop-tools\hadoop-fs2img\src\test\java\org\apache\hadoop\hdfs\server\namenode\TestFSTreeWalk.java,81,0,0,1,0,1
hadoop-trunk\hadoop-trunk\hadoop-yarn-project\hadoop-yarn\hadoop-yarn-server\hadoop-yarn-server-timelineservice\src\main\java\org\apache\hadoop\yarn\server\timelineservice\reader\filter\TimelineKeyValuesFilter.java,95,28,1,1,0,30
hadoop-trunk\hadoop-trunk\hadoop-common-project\hadoop-common\src\main\java\org\apache\hadoop\metrics2\util\Quantile.java,49,19,0,1,0,20
hadoop-trunk\hadoop-trunk\hadoop-common-project\hadoop-common\src\main\java\org\apache\hadoop\metrics2\sink\ganglia\AbstractGangliaSink.java,276,77,11,3,0,91
hadoop-trunk\hadoop-trunk\hadoop-hdfs-project\hadoop-hdfs\src\main\java\org\apache\hadoop\hdfs\server\common\blockaliasmap\BlockAliasMap.java,80,9,0,1,0,10
hadoop-trunk\hadoop-trunk\hadoop-yarn-project\hadoop-yarn\hadoop-yarn-server\hadoop-yarn-server-timelineservice-hbase\hadoop-yarn-server-timelineservice-hbase-client\src\main\java\org\apache\hadoop\yarn\server\timelineservice\storage\apptoflow\AppToFlowTableRW.java,50,7,3,2,0,12
hadoop-trunk\hadoop-trunk\hadoop-common-project\hadoop-common\src\main\java\org\apache\hadoop\fs\statistics\impl\DynamicIOStatistics.java,0,14,2,1,0,17
hadoop-trunk\hadoop-trunk\hadoop-mapreduce-project\hadoop-mapreduce-client\hadoop-mapreduce-client-app\src\main\java\org\apache\hadoop\mapreduce\v2\app\job\event\TaskEvent.java,14,7,0,1,0,8
hadoop-trunk\hadoop-trunk\hadoop-hdfs-project\hadoop-hdfs\src\main\java\org\apache\hadoop\hdfs\qjournal\client\LoggerTooFarBehindException.java,0,0,0,1,0,1
hadoop-trunk\hadoop-trunk\hadoop-mapreduce-project\hadoop-mapreduce-client\hadoop-mapreduce-client-app\src\test\java\org\apache\hadoop\mapreduce\v2\app\webapp\TestAMWebApp.java,346,53,9,3,0,65
hadoop-trunk\hadoop-trunk\hadoop-yarn-project\hadoop-yarn\hadoop-yarn-server\hadoop-yarn-server-nodemanager\src\main\java\org\apache\hadoop\yarn\server\nodemanager\containermanager\deletion\recovery\package-info.java,0,1,0,2,0,3
hadoop-trunk\hadoop-trunk\hadoop-common-project\hadoop-common\src\test\java\org\apache\hadoop\util\TestDataChecksum.java,0,69,8,2,0,79
hadoop-trunk\hadoop-trunk\hadoop-yarn-project\hadoop-yarn\hadoop-yarn-common\src\main\java\org\apache\hadoop\yarn\server\api\impl\pb\service\SCMAdminProtocolPBServiceImpl.java,24,8,7,7,0,22
hadoop-trunk\hadoop-trunk\hadoop-yarn-project\hadoop-yarn\hadoop-yarn-server\hadoop-yarn-server-resourcemanager\src\main\java\org\apache\hadoop\yarn\server\resourcemanager\scheduler\capacity\CSMaxRunningAppsEnforcer.java,400,51,7,2,0,60
hadoop-trunk\hadoop-trunk\hadoop-yarn-project\hadoop-yarn\hadoop-yarn-server\hadoop-yarn-server-sharedcachemanager\src\main\java\org\apache\hadoop\yarn\server\sharedcachemanager\store\SharedCacheResource.java,0,7,0,1,0,8
hadoop-trunk\hadoop-trunk\hadoop-yarn-project\hadoop-yarn\hadoop-yarn-server\hadoop-yarn-server-resourcemanager\src\main\java\org\apache\hadoop\yarn\server\resourcemanager\scheduler\fair\converter\FSYarnSiteConverter.java,149,25,0,11,0,36
hadoop-trunk\hadoop-trunk\hadoop-hdfs-project\hadoop-hdfs\src\test\java\org\apache\hadoop\fs\viewfs\TestViewFileSystemLinkMergeSlash.java,182,28,3,1,0,32
hadoop-trunk\hadoop-trunk\hadoop-common-project\hadoop-common\src\main\java\org\apache\hadoop\io\compress\lz4\Lz4Compressor.java,292,38,8,1,0,47
hadoop-trunk\hadoop-trunk\hadoop-hdfs-project\hadoop-hdfs\src\main\java\org\apache\hadoop\hdfs\server\datanode\fsdataset\impl\PmemMappedBlock.java,42,12,0,1,0,13
hadoop-trunk\hadoop-trunk\hadoop-mapreduce-project\hadoop-mapreduce-client\hadoop-mapreduce-client-nativetask\src\main\java\org\apache\hadoop\mapred\nativetask\Constants.java,27,26,0,7,0,33
hadoop-trunk\hadoop-trunk\hadoop-tools\hadoop-gridmix\src\main\java\org\apache\hadoop\mapred\gridmix\LoadJob.java,0,177,19,5,0,201
hadoop-trunk\hadoop-trunk\hadoop-yarn-project\hadoop-yarn\hadoop-yarn-server\hadoop-yarn-server-nodemanager\src\main\java\org\apache\hadoop\yarn\server\nodemanager\recovery\NMNullStateStoreService.java,255,76,53,6,0,135
hadoop-trunk\hadoop-trunk\hadoop-mapreduce-project\hadoop-mapreduce-client\hadoop-mapreduce-client-core\src\main\java\org\apache\hadoop\mapred\TextInputFormat.java,0,20,2,1,0,23
hadoop-trunk\hadoop-trunk\hadoop-hdfs-project\hadoop-hdfs-rbf\src\main\java\org\apache\hadoop\hdfs\server\federation\store\protocol\RouterHeartbeatResponse.java,22,6,0,2,0,8
hadoop-trunk\hadoop-trunk\hadoop-common-project\hadoop-common\src\test\java\org\apache\hadoop\security\authorize\TestProxyServers.java,14,1,4,1,0,6
hadoop-trunk\hadoop-trunk\hadoop-tools\hadoop-distcp\src\test\java\org\apache\hadoop\tools\TestDistCpSyncReverseFromTarget.java,0,1,0,1,0,2
hadoop-trunk\hadoop-trunk\hadoop-yarn-project\hadoop-yarn\hadoop-yarn-common\src\main\java\org\apache\hadoop\yarn\util\WindowsBasedProcessTree.java,242,34,3,3,0,40
hadoop-trunk\hadoop-trunk\hadoop-yarn-project\hadoop-yarn\hadoop-yarn-api\src\main\java\org\apache\hadoop\yarn\api\protocolrecords\GetClusterNodeLabelsRequest.java,6,1,0,1,0,2
hadoop-trunk\hadoop-trunk\hadoop-common-project\hadoop-common\src\test\java\org\apache\hadoop\util\TestNativeCodeLoader.java,31,8,7,1,0,16
hadoop-trunk\hadoop-trunk\hadoop-yarn-project\hadoop-yarn\hadoop-yarn-api\src\main\java\org\apache\hadoop\yarn\api\protocolrecords\IncreaseContainersResourceRequest.java,40,5,0,2,0,7
hadoop-trunk\hadoop-trunk\hadoop-yarn-project\hadoop-yarn\hadoop-yarn-server\hadoop-yarn-server-web-proxy\src\test\java\org\apache\hadoop\yarn\server\webproxy\amfilter\TestSecureAmFilter.java,115,12,0,1,0,13
hadoop-trunk\hadoop-trunk\hadoop-hdfs-project\hadoop-hdfs\src\test\java\org\apache\hadoop\hdfs\web\TestWebHdfsTokens.java,497,65,33,20,0,118
hadoop-trunk\hadoop-trunk\hadoop-common-project\hadoop-nfs\src\main\java\org\apache\hadoop\portmap\PortmapRequest.java,18,7,1,1,0,9
hadoop-trunk\hadoop-trunk\hadoop-hdfs-project\hadoop-hdfs\src\main\java\org\apache\hadoop\hdfs\server\datanode\StorageLocation.java,254,38,3,1,0,42
hadoop-trunk\hadoop-trunk\hadoop-hdfs-project\hadoop-hdfs-rbf\src\main\java\org\apache\hadoop\hdfs\server\federation\fairness\NoRouterRpcFairnessPolicyController.java,27,7,1,1,0,9
hadoop-trunk\hadoop-trunk\hadoop-tools\hadoop-azure\src\test\java\org\apache\hadoop\fs\azure\ITestNativeFileSystemStatistics.java,62,23,3,11,0,37
hadoop-trunk\hadoop-trunk\hadoop-yarn-project\hadoop-yarn\hadoop-yarn-server\hadoop-yarn-server-resourcemanager\src\test\java\org\apache\hadoop\yarn\server\resourcemanager\recovery\TestProtos.java,22,5,8,3,0,16
hadoop-trunk\hadoop-trunk\hadoop-hdfs-project\hadoop-hdfs\src\main\java\org\apache\hadoop\hdfs\server\datanode\erasurecode\StripedBlockChecksumMd5CrcReconstructor.java,0,13,1,1,0,15
hadoop-trunk\hadoop-trunk\hadoop-tools\hadoop-dynamometer\hadoop-dynamometer-workload\src\main\java\org\apache\hadoop\tools\dynamometer\workloadgenerator\audit\AuditReplayCommand.java,0,26,0,1,0,27
hadoop-trunk\hadoop-trunk\hadoop-hdfs-project\hadoop-hdfs\src\main\java\org\apache\hadoop\hdfs\util\Diff.java,0,130,9,2,0,141
hadoop-trunk\hadoop-trunk\hadoop-tools\hadoop-rumen\src\main\java\org\apache\hadoop\tools\rumen\CurrentJHParser.java,57,9,2,1,0,12
hadoop-trunk\hadoop-trunk\hadoop-yarn-project\hadoop-yarn\hadoop-yarn-applications\hadoop-yarn-services\hadoop-yarn-services-core\src\test\java\org\apache\hadoop\yarn\service\client\TestServiceClient.java,266,25,34,6,0,65
hadoop-trunk\hadoop-trunk\hadoop-cloud-storage-project\hadoop-cos\src\test\java\org\apache\hadoop\fs\cosn\contract\CosNContract.java,19,4,0,1,0,5
hadoop-trunk\hadoop-trunk\hadoop-hdfs-project\hadoop-hdfs\src\test\java\org\apache\hadoop\hdfs\TestSmallBlock.java,74,40,1,2,0,43
hadoop-trunk\hadoop-trunk\hadoop-tools\hadoop-aws\src\main\java\org\apache\hadoop\fs\s3a\audit\impl\AbstractAuditSpanImpl.java,71,9,0,1,0,10
hadoop-trunk\hadoop-trunk\hadoop-yarn-project\hadoop-yarn\hadoop-yarn-server\hadoop-yarn-server-resourcemanager\src\main\java\org\apache\hadoop\yarn\server\resourcemanager\webapp\dao\LogAggregationContextInfo.java,76,46,2,1,0,49
hadoop-trunk\hadoop-trunk\hadoop-hdfs-project\hadoop-hdfs-nfs\src\main\java\org\apache\hadoop\hdfs\nfs\conf\NfsConfigKeys.java,76,72,0,12,0,84
hadoop-trunk\hadoop-trunk\hadoop-yarn-project\hadoop-yarn\hadoop-yarn-server\hadoop-yarn-server-resourcemanager\src\main\java\org\apache\hadoop\yarn\server\resourcemanager\rmapp\attempt\event\RMAppAttemptUnregistrationEvent.java,23,12,0,3,0,15
hadoop-trunk\hadoop-trunk\hadoop-hdfs-project\hadoop-hdfs-httpfs\src\main\java\org\apache\hadoop\lib\wsrs\JSONMapProvider.java,26,25,3,6,0,34
hadoop-trunk\hadoop-trunk\hadoop-yarn-project\hadoop-yarn\hadoop-yarn-server\hadoop-yarn-server-resourcemanager\src\main\java\org\apache\hadoop\yarn\server\resourcemanager\scheduler\event\NodeResourceUpdateSchedulerEvent.java,22,12,0,1,0,13
hadoop-trunk\hadoop-trunk\hadoop-hdfs-project\hadoop-hdfs-client\src\main\java\org\apache\hadoop\hdfs\web\resources\Param.java,0,22,0,1,0,23
hadoop-trunk\hadoop-trunk\hadoop-yarn-project\hadoop-yarn\hadoop-yarn-common\src\main\java\org\apache\hadoop\yarn\api\records\impl\pb\QueueInfoPBImpl.java,510,110,115,3,0,228
hadoop-trunk\hadoop-trunk\hadoop-yarn-project\hadoop-yarn\hadoop-yarn-server\hadoop-yarn-server-common\src\test\java\org\apache\hadoop\yarn\server\federation\policies\manager\TestHomePolicyManager.java,14,1,0,3,0,4
hadoop-trunk\hadoop-trunk\hadoop-mapreduce-project\hadoop-mapreduce-client\hadoop-mapreduce-client-common\src\main\java\org\apache\hadoop\mapreduce\v2\api\protocolrecords\impl\pb\GetDelegationTokenRequestPBImpl.java,69,33,28,5,0,66
hadoop-trunk\hadoop-trunk\hadoop-yarn-project\hadoop-yarn\hadoop-yarn-server\hadoop-yarn-server-nodemanager\src\main\java\org\apache\hadoop\yarn\server\nodemanager\containermanager\runtime\ContainerRuntime.java,0,1,0,2,0,3
hadoop-trunk\hadoop-trunk\hadoop-common-project\hadoop-common\src\main\java\org\apache\hadoop\io\WritableFactories.java,0,22,6,2,0,30
hadoop-trunk\hadoop-trunk\hadoop-yarn-project\hadoop-yarn\hadoop-yarn-common\src\test\java\org\apache\hadoop\yarn\client\TestClientRMProxy.java,157,9,9,1,0,19
hadoop-trunk\hadoop-trunk\hadoop-common-project\hadoop-common\src\main\java\org\apache\hadoop\security\alias\JavaKeyStoreProvider.java,0,8,0,1,0,9
hadoop-trunk\hadoop-trunk\hadoop-yarn-project\hadoop-yarn\hadoop-yarn-server\hadoop-yarn-server-common\src\test\java\org\apache\hadoop\yarn\server\federation\policies\router\TestRejectRouterPolicy.java,33,2,0,3,0,5
hadoop-trunk\hadoop-trunk\hadoop-hdfs-project\hadoop-hdfs\src\test\java\org\apache\hadoop\hdfs\server\namenode\TestNameCache.java,61,13,1,2,0,16
hadoop-trunk\hadoop-trunk\hadoop-hdfs-project\hadoop-hdfs\src\main\java\org\apache\hadoop\hdfs\server\namenode\StoragePolicySummary.java,221,78,6,4,0,88
hadoop-trunk\hadoop-trunk\hadoop-hdfs-project\hadoop-hdfs-rbf\src\main\java\org\apache\hadoop\hdfs\server\federation\store\driver\impl\StateStoreBaseImpl.java,45,14,0,2,0,16
hadoop-trunk\hadoop-trunk\hadoop-yarn-project\hadoop-yarn\hadoop-yarn-common\src\main\java\org\apache\hadoop\yarn\server\api\protocolrecords\impl\pb\ReplaceLabelsOnNodeRequestPBImpl.java,143,29,46,6,0,81
hadoop-trunk\hadoop-trunk\hadoop-hdfs-project\hadoop-hdfs\src\main\java\org\apache\hadoop\hdfs\server\datanode\FaultInjectorFileIoEvents.java,23,10,4,1,0,15
hadoop-trunk\hadoop-trunk\hadoop-yarn-project\hadoop-yarn\hadoop-yarn-server\hadoop-yarn-server-router\src\test\java\org\apache\hadoop\yarn\server\router\rmadmin\PassThroughRMAdminRequestInterceptor.java,0,31,0,26,0,57
hadoop-trunk\hadoop-trunk\hadoop-common-project\hadoop-common\src\test\java\org\apache\hadoop\fs\FileSystemContractBaseTest.java,963,131,20,4,0,155
hadoop-trunk\hadoop-trunk\hadoop-hdfs-project\hadoop-hdfs\src\main\java\org\apache\hadoop\hdfs\web\JsonUtil.java,662,95,16,2,0,113
hadoop-trunk\hadoop-trunk\hadoop-hdfs-project\hadoop-hdfs-rbf\src\test\java\org\apache\hadoop\hdfs\server\federation\RouterConfigBuilder.java,184,77,3,4,0,84
hadoop-trunk\hadoop-trunk\hadoop-tools\hadoop-resourceestimator\src\main\java\org\apache\hadoop\resourceestimator\skylinestore\validator\SkylineStoreValidator.java,80,2,4,7,0,13
hadoop-trunk\hadoop-trunk\hadoop-common-project\hadoop-common\src\test\java\org\apache\hadoop\conf\TestConfigurationSubclass.java,80,13,6,2,0,21
hadoop-trunk\hadoop-trunk\hadoop-common-project\hadoop-auth\src\main\java\org\apache\hadoop\security\authentication\server\MultiSchemeAuthenticationHandler.java,151,28,8,2,0,38
hadoop-trunk\hadoop-trunk\hadoop-yarn-project\hadoop-yarn\hadoop-yarn-server\hadoop-yarn-server-resourcemanager\src\main\java\org\apache\hadoop\yarn\server\resourcemanager\scheduler\fair\allocation\AllocationFileParser.java,213,72,5,6,0,83
hadoop-trunk\hadoop-trunk\hadoop-hdfs-project\hadoop-hdfs\src\test\java\org\apache\hadoop\hdfs\TestErasureCodingAddConfig.java,44,11,0,1,0,12
hadoop-trunk\hadoop-trunk\hadoop-yarn-project\hadoop-yarn\hadoop-yarn-server\hadoop-yarn-server-resourcemanager\src\main\java\org\apache\hadoop\yarn\server\resourcemanager\scheduler\policy\IteratorSelector.java,25,3,0,1,0,4
hadoop-trunk\hadoop-trunk\hadoop-tools\hadoop-openstack\src\main\java\org\apache\hadoop\fs\swift\http\HttpInputStreamWithRelease.java,191,36,5,3,0,44
hadoop-trunk\hadoop-trunk\hadoop-hdfs-project\hadoop-hdfs-client\src\main\java\org\apache\hadoop\hdfs\protocol\datatransfer\sasl\SaslResponseWithNegotiatedCipherOption.java,11,9,0,1,0,10
hadoop-trunk\hadoop-trunk\hadoop-yarn-project\hadoop-yarn\hadoop-yarn-server\hadoop-yarn-server-common\src\main\java\org\apache\hadoop\yarn\server\federation\store\records\impl\pb\SetSubClusterPolicyConfigurationRequestPBImpl.java,0,19,36,6,0,61
hadoop-trunk\hadoop-trunk\hadoop-common-project\hadoop-common\src\main\java\org\apache\hadoop\metrics2\sink\ganglia\GangliaMetricVisitor.java,0,17,0,1,0,18
hadoop-trunk\hadoop-trunk\hadoop-common-project\hadoop-common\src\test\java\org\apache\hadoop\fs\shell\TestCopyToLocal.java,169,46,5,2,0,53
hadoop-trunk\hadoop-trunk\hadoop-yarn-project\hadoop-yarn\hadoop-yarn-server\hadoop-yarn-server-common\src\main\java\org\apache\hadoop\yarn\server\api\protocolrecords\SCMUploaderNotifyRequest.java,35,0,0,1,0,1
hadoop-trunk\hadoop-trunk\hadoop-tools\hadoop-azure\src\main\java\org\apache\hadoop\fs\azurebfs\commit\AbfsManifestStoreOperations.java,83,8,0,6,0,14
hadoop-trunk\hadoop-trunk\hadoop-common-project\hadoop-common\src\test\java\org\apache\hadoop\http\TestProfileServlet.java,53,14,0,9,0,23
hadoop-trunk\hadoop-trunk\hadoop-hdfs-project\hadoop-hdfs\src\test\java\org\apache\hadoop\hdfs\server\datanode\TestBatchIbr.java,211,41,5,4,0,50
hadoop-trunk\hadoop-trunk\hadoop-yarn-project\hadoop-yarn\hadoop-yarn-server\hadoop-yarn-server-nodemanager\src\main\java\org\apache\hadoop\yarn\server\nodemanager\containermanager\logaggregation\FailedOrKilledContainerLogAggregationPolicy.java,6,4,0,2,0,6
hadoop-trunk\hadoop-trunk\hadoop-yarn-project\hadoop-yarn\hadoop-yarn-server\hadoop-yarn-server-resourcemanager\src\main\java\org\apache\hadoop\yarn\server\resourcemanager\webapp\dao\NodeToLabelsInfo.java,14,5,3,1,0,9
hadoop-trunk\hadoop-trunk\hadoop-hdfs-project\hadoop-hdfs-client\src\main\java\org\apache\hadoop\hdfs\server\protocol\DatanodeStorage.java,103,29,1,1,0,31
hadoop-trunk\hadoop-trunk\hadoop-yarn-project\hadoop-yarn\hadoop-yarn-server\hadoop-yarn-server-resourcemanager\src\test\java\org\apache\hadoop\yarn\server\resourcemanager\scheduler\TestQueueMetrics.java,757,206,3,26,0,235
hadoop-trunk\hadoop-trunk\hadoop-tools\hadoop-azure\src\test\java\org\apache\hadoop\fs\azurebfs\utils\AclTestHelpers.java,0,16,0,1,0,17
hadoop-trunk\hadoop-trunk\hadoop-tools\hadoop-resourceestimator\src\test\java\org\apache\hadoop\resourceestimator\common\serialization\TestResourceSerDe.java,30,7,0,1,0,8
hadoop-trunk\hadoop-trunk\hadoop-tools\hadoop-aws\src\main\java\org\apache\hadoop\fs\s3a\NoVersionAttributeException.java,14,2,1,1,0,4
hadoop-trunk\hadoop-trunk\hadoop-hdfs-project\hadoop-hdfs\src\test\java\org\apache\hadoop\hdfs\TestWriteConfigurationToDFS.java,30,8,1,2,0,11
hadoop-trunk\hadoop-trunk\hadoop-yarn-project\hadoop-yarn\hadoop-yarn-server\hadoop-yarn-server-web-proxy\src\main\java\org\apache\hadoop\yarn\server\webproxy\amfilter\AmIpServletRequestWrapper.java,27,10,0,1,0,11
hadoop-trunk\hadoop-trunk\hadoop-mapreduce-project\hadoop-mapreduce-client\hadoop-mapreduce-client-core\src\main\java\org\apache\hadoop\mapreduce\lib\reduce\WrappedReducer.java,0,79,8,3,0,90
hadoop-trunk\hadoop-trunk\hadoop-yarn-project\hadoop-yarn\hadoop-yarn-server\hadoop-yarn-server-resourcemanager\src\main\java\org\apache\hadoop\yarn\server\resourcemanager\scheduler\capacity\QueueStateHelper.java,0,22,1,12,0,35
hadoop-trunk\hadoop-trunk\hadoop-common-project\hadoop-common\src\main\java\org\apache\hadoop\net\SocketOutputStream.java,0,95,0,2,0,97
hadoop-trunk\hadoop-trunk\hadoop-tools\hadoop-rumen\src\main\java\org\apache\hadoop\tools\rumen\datatypes\DataType.java,0,2,0,1,0,3
hadoop-trunk\hadoop-trunk\hadoop-mapreduce-project\hadoop-mapreduce-client\hadoop-mapreduce-client-core\src\main\java\org\apache\hadoop\mapred\JobConfigurable.java,0,0,0,1,0,1
hadoop-trunk\hadoop-trunk\hadoop-yarn-project\hadoop-yarn\hadoop-yarn-server\hadoop-yarn-server-resourcemanager\src\main\java\org\apache\hadoop\yarn\server\resourcemanager\webapp\dao\LabelsToNodesInfo.java,17,9,1,1,0,11
hadoop-trunk\hadoop-trunk\hadoop-mapreduce-project\hadoop-mapreduce-client\hadoop-mapreduce-client-app\src\test\java\org\apache\hadoop\mapreduce\v2\app\speculate\TestDataStatistics.java,51,25,0,1,0,26
hadoop-trunk\hadoop-trunk\hadoop-common-project\hadoop-common\src\main\java\org\apache\hadoop\util\DiskValidatorFactory.java,0,5,2,1,0,8
hadoop-trunk\hadoop-trunk\hadoop-yarn-project\hadoop-yarn\hadoop-yarn-common\src\main\java\org\apache\hadoop\yarn\nodelabels\store\op\ReplaceNodeToAttributeLogOp.java,0,13,3,4,0,20
hadoop-trunk\hadoop-trunk\hadoop-mapreduce-project\hadoop-mapreduce-client\hadoop-mapreduce-client-core\src\main\java\org\apache\hadoop\mapreduce\lib\join\MultiFilterRecordReader.java,0,36,2,1,0,39
hadoop-trunk\hadoop-trunk\hadoop-tools\hadoop-aws\src\test\java\org\apache\hadoop\fs\s3a\ITestS3AEndpointRegion.java,147,13,0,2,0,15
hadoop-trunk\hadoop-trunk\hadoop-common-project\hadoop-common\src\test\java\org\apache\hadoop\fs\TestFileStatus.java,269,92,9,7,0,108
hadoop-trunk\hadoop-trunk\hadoop-hdfs-project\hadoop-hdfs\src\main\java\org\apache\hadoop\hdfs\server\namenode\snapshot\SnapshotStatsMXBean.java,0,5,2,1,0,8
hadoop-trunk\hadoop-trunk\hadoop-hdfs-project\hadoop-hdfs\src\main\java\org\apache\hadoop\hdfs\server\datanode\erasurecode\StripedReconstructor.java,230,35,0,1,0,36
hadoop-trunk\hadoop-trunk\hadoop-yarn-project\hadoop-yarn\hadoop-yarn-server\hadoop-yarn-server-timelineservice-hbase\hadoop-yarn-server-timelineservice-hbase-server\hadoop-yarn-server-timelineservice-hbase-server-2\src\main\java\org\apache\hadoop\yarn\server\timelineservice\storage\package-info.java,0,0,0,1,0,1
hadoop-trunk\hadoop-trunk\hadoop-yarn-project\hadoop-yarn\hadoop-yarn-client\src\test\java\org\apache\hadoop\yarn\client\cli\TestClusterCLI.java,148,50,1,26,0,77
hadoop-trunk\hadoop-trunk\hadoop-yarn-project\hadoop-yarn\hadoop-yarn-common\src\main\java\org\apache\hadoop\yarn\api\records\impl\pb\RejectedSchedulingRequestPBImpl.java,121,23,38,1,0,62
hadoop-trunk\hadoop-trunk\hadoop-mapreduce-project\hadoop-mapreduce-client\hadoop-mapreduce-client-nativetask\src\main\java\org\apache\hadoop\mapred\nativetask\buffer\ByteBufferDataReader.java,121,36,2,1,0,39
hadoop-trunk\hadoop-trunk\hadoop-yarn-project\hadoop-yarn\hadoop-yarn-server\hadoop-yarn-server-nodemanager\src\main\java\org\apache\hadoop\yarn\server\nodemanager\containermanager\launcher\ContainersLauncherEventType.java,0,9,0,1,0,10
hadoop-trunk\hadoop-trunk\hadoop-yarn-project\hadoop-yarn\hadoop-yarn-server\hadoop-yarn-server-resourcemanager\src\main\java\org\apache\hadoop\yarn\server\resourcemanager\scheduler\capacity\AbstractLeafQueue.java,2387,441,40,87,0,568
hadoop-trunk\hadoop-trunk\hadoop-hdfs-project\hadoop-hdfs\src\test\java\org\apache\hadoop\hdfs\TestWriteRead.java,478,133,37,13,0,183
hadoop-trunk\hadoop-trunk\hadoop-mapreduce-project\hadoop-mapreduce-client\hadoop-mapreduce-client-jobclient\src\test\java\org\apache\hadoop\mapred\ClusterMapReduceTestCase.java,137,9,1,2,0,12
hadoop-trunk\hadoop-trunk\hadoop-hdfs-project\hadoop-hdfs\src\test\java\org\apache\hadoop\cli\TestErasureCodingCLI.java,91,16,3,1,0,20
hadoop-trunk\hadoop-trunk\hadoop-yarn-project\hadoop-yarn\hadoop-yarn-server\hadoop-yarn-server-resourcemanager\src\main\java\org\apache\hadoop\yarn\server\resourcemanager\federation\FederationStateStoreHeartbeat.java,65,15,2,4,0,21
hadoop-trunk\hadoop-trunk\hadoop-tools\hadoop-aws\src\main\java\org\apache\hadoop\fs\s3a\commit\magic\package-info.java,0,0,0,1,0,1
hadoop-trunk\hadoop-trunk\hadoop-yarn-project\hadoop-yarn\hadoop-yarn-server\hadoop-yarn-server-common\src\main\java\org\apache\hadoop\yarn\server\timeline\security\TimelineDelgationTokenSecretManagerService.java,53,11,0,2,0,13
hadoop-trunk\hadoop-trunk\hadoop-yarn-project\hadoop-yarn\hadoop-yarn-server\hadoop-yarn-server-timelineservice\src\main\java\org\apache\hadoop\yarn\server\timelineservice\reader\security\TimelineReaderWhitelistAuthorizationFilter.java,80,11,3,2,0,16
hadoop-trunk\hadoop-trunk\hadoop-hdfs-project\hadoop-hdfs\src\test\java\org\apache\hadoop\hdfs\TestMiniDFSCluster.java,0,37,4,3,0,44
hadoop-trunk\hadoop-trunk\hadoop-tools\hadoop-aws\src\test\java\org\apache\hadoop\fs\s3a\select\ITestS3SelectMRJob.java,136,13,2,3,0,18
hadoop-trunk\hadoop-trunk\hadoop-yarn-project\hadoop-yarn\hadoop-yarn-common\src\main\java\org\apache\hadoop\yarn\nodelabels\NodeLabelUtil.java,0,24,0,1,0,25
hadoop-trunk\hadoop-trunk\hadoop-mapreduce-project\hadoop-mapreduce-client\hadoop-mapreduce-client-app\src\main\java\org\apache\hadoop\mapreduce\v2\app\TaskAttemptListener.java,0,5,0,1,0,6
hadoop-trunk\hadoop-trunk\hadoop-tools\hadoop-aliyun\src\test\java\org\apache\hadoop\fs\aliyun\oss\contract\TestAliyunOSSContractMkdir.java,8,2,0,1,0,3
hadoop-trunk\hadoop-trunk\hadoop-common-project\hadoop-common\src\test\java\org\apache\hadoop\net\TestNetworkTopologyWithNodeGroup.java,185,76,13,2,0,91
hadoop-trunk\hadoop-trunk\hadoop-tools\hadoop-azure\src\test\java\org\apache\hadoop\fs\azure\ITestNativeAzureFSAuthWithBlobSpecificKeys.java,0,1,0,2,0,3
hadoop-trunk\hadoop-trunk\hadoop-yarn-project\hadoop-yarn\hadoop-yarn-server\hadoop-yarn-server-resourcemanager\src\test\java\org\apache\hadoop\yarn\server\resourcemanager\placement\TestPlacementFactory.java,47,0,0,1,0,1
hadoop-trunk\hadoop-trunk\hadoop-hdfs-project\hadoop-hdfs\src\test\java\org\apache\hadoop\hdfs\TestGetBlocks.java,470,66,9,4,0,79
hadoop-trunk\hadoop-trunk\hadoop-mapreduce-project\hadoop-mapreduce-client\hadoop-mapreduce-client-common\src\main\java\org\apache\hadoop\mapreduce\v2\api\protocolrecords\impl\pb\KillTaskRequestPBImpl.java,79,33,33,4,0,70
hadoop-trunk\hadoop-trunk\hadoop-mapreduce-project\hadoop-mapreduce-client\hadoop-mapreduce-client-core\src\main\java\org\apache\hadoop\mapreduce\task\reduce\EventFetcher.java,0,40,8,1,0,49
hadoop-trunk\hadoop-trunk\hadoop-mapreduce-project\hadoop-mapreduce-client\hadoop-mapreduce-client-core\src\test\java\org\apache\hadoop\mapreduce\TestJobSubmissionFiles.java,105,26,1,1,0,28
hadoop-trunk\hadoop-trunk\hadoop-yarn-project\hadoop-yarn\hadoop-yarn-server\hadoop-yarn-server-resourcemanager\src\main\java\org\apache\hadoop\yarn\server\resourcemanager\webapp\dao\AppAttemptInfo.java,103,45,8,4,0,57
hadoop-trunk\hadoop-trunk\hadoop-tools\hadoop-rumen\src\main\java\org\apache\hadoop\tools\rumen\DefaultOutputter.java,36,13,1,1,0,15
hadoop-trunk\hadoop-trunk\hadoop-common-project\hadoop-common\src\test\java\org\apache\hadoop\service\launcher\testservices\StringConstructorOnlyService.java,13,6,0,2,0,8
hadoop-trunk\hadoop-trunk\hadoop-tools\hadoop-aws\src\test\java\org\apache\hadoop\fs\s3a\AbstractTestS3AEncryption.java,146,19,3,5,0,27
hadoop-trunk\hadoop-trunk\hadoop-yarn-project\hadoop-yarn\hadoop-yarn-server\hadoop-yarn-server-nodemanager\src\main\java\org\apache\hadoop\yarn\server\nodemanager\containermanager\resourceplugin\gpu\GpuDiscoverer.java,307,38,4,7,0,49
hadoop-trunk\hadoop-trunk\hadoop-common-project\hadoop-common\src\main\java\org\apache\hadoop\security\JniBasedUnixGroupsMapping.java,75,17,5,1,0,23
hadoop-trunk\hadoop-trunk\hadoop-yarn-project\hadoop-yarn\hadoop-yarn-server\hadoop-yarn-server-resourcemanager\src\test\java\org\apache\hadoop\yarn\server\resourcemanager\rmapp\MockRMApp.java,313,151,5,3,0,159
hadoop-trunk\hadoop-trunk\hadoop-yarn-project\hadoop-yarn\hadoop-yarn-server\hadoop-yarn-server-nodemanager\src\main\java\org\apache\hadoop\yarn\server\nodemanager\webapp\ContainerPage.java,58,10,0,3,0,13
hadoop-trunk\hadoop-trunk\hadoop-common-project\hadoop-common\src\main\java\org\apache\hadoop\crypto\random\OsSecureRandom.java,0,33,4,3,0,40
hadoop-trunk\hadoop-trunk\hadoop-yarn-project\hadoop-yarn\hadoop-yarn-server\hadoop-yarn-server-timelineservice\src\main\java\org\apache\hadoop\yarn\server\timelineservice\storage\TimelineAggregationTrack.java,0,4,0,1,0,5
hadoop-trunk\hadoop-trunk\hadoop-tools\hadoop-resourceestimator\src\main\java\org\apache\hadoop\resourceestimator\translator\api\LogParser.java,0,0,0,3,0,3
hadoop-trunk\hadoop-trunk\hadoop-tools\hadoop-distcp\src\test\java\org\apache\hadoop\tools\TestFileBasedCopyListing.java,510,73,1,15,0,89
hadoop-trunk\hadoop-trunk\hadoop-yarn-project\hadoop-yarn\hadoop-yarn-csi\src\test\java\org\apache\hadoop\yarn\csi\adaptor\TestValidateVolumeCapabilityResponse.java,34,3,6,3,0,12
hadoop-trunk\hadoop-trunk\hadoop-yarn-project\hadoop-yarn\hadoop-yarn-server\hadoop-yarn-server-resourcemanager\src\test\java\org\apache\hadoop\yarn\server\resourcemanager\reservation\TestPeriodicRLESparseResourceAllocation.java,143,135,2,2,0,139
hadoop-trunk\hadoop-trunk\hadoop-hdfs-project\hadoop-hdfs\src\test\java\org\apache\hadoop\hdfs\TestHDFSServerPorts.java,352,111,21,10,0,142
hadoop-trunk\hadoop-trunk\hadoop-hdfs-project\hadoop-hdfs\src\test\java\org\apache\hadoop\hdfs\tools\TestStoragePolicyCommands.java,0,17,0,2,0,19
hadoop-trunk\hadoop-trunk\hadoop-hdfs-project\hadoop-hdfs-rbf\src\main\java\org\apache\hadoop\hdfs\server\federation\router\RBFConfigKeys.java,344,149,1,10,0,160
hadoop-trunk\hadoop-trunk\hadoop-cloud-storage-project\hadoop-huaweicloud\src\test\java\org\apache\hadoop\fs\obs\TestOBSContractCreate.java,18,3,0,1,0,4
hadoop-trunk\hadoop-trunk\hadoop-hdfs-project\hadoop-hdfs-client\src\main\java\org\apache\hadoop\hdfs\server\datanode\DiskBalancerWorkStatus.java,252,60,2,1,0,63
hadoop-trunk\hadoop-trunk\hadoop-yarn-project\hadoop-yarn\hadoop-yarn-server\hadoop-yarn-server-nodemanager\src\test\java\org\apache\hadoop\yarn\server\nodemanager\amrmproxy\TestFederationInterceptor.java,885,52,12,13,0,77
hadoop-trunk\hadoop-trunk\hadoop-yarn-project\hadoop-yarn\hadoop-yarn-server\hadoop-yarn-server-nodemanager\src\main\java\org\apache\hadoop\yarn\server\nodemanager\containermanager\scheduler\ResourceUtilizationTracker.java,0,0,0,2,0,2
hadoop-trunk\hadoop-trunk\hadoop-tools\hadoop-resourceestimator\src\main\java\org\apache\hadoop\resourceestimator\translator\impl\BaseLogParser.java,75,10,0,5,0,15
hadoop-trunk\hadoop-trunk\hadoop-mapreduce-project\hadoop-mapreduce-client\hadoop-mapreduce-client-core\src\main\java\org\apache\hadoop\mapreduce\lib\join\CompositeInputSplit.java,124,28,5,1,0,34
hadoop-trunk\hadoop-trunk\hadoop-mapreduce-project\hadoop-mapreduce-client\hadoop-mapreduce-client-jobclient\src\test\java\org\apache\hadoop\mapreduce\lib\input\TestFixedLengthInputFormat.java,418,109,26,1,0,136
hadoop-trunk\hadoop-trunk\hadoop-yarn-project\hadoop-yarn\hadoop-yarn-server\hadoop-yarn-server-nodemanager\src\main\java\org\apache\hadoop\yarn\server\nodemanager\api\protocolrecords\impl\pb\LocalizerHeartbeatResponsePBImpl.java,0,32,49,8,0,89
hadoop-trunk\hadoop-trunk\hadoop-yarn-project\hadoop-yarn\hadoop-yarn-server\hadoop-yarn-server-tests\src\test\java\org\apache\hadoop\yarn\server\timelineservice\TestTimelineServiceClientIntegration.java,131,10,0,7,0,17
hadoop-trunk\hadoop-trunk\hadoop-hdfs-project\hadoop-hdfs\src\main\java\org\apache\hadoop\hdfs\server\diskbalancer\command\PlanCommand.java,225,35,4,1,0,40
hadoop-trunk\hadoop-trunk\hadoop-tools\hadoop-azure\src\main\java\org\apache\hadoop\fs\azure\BlockBlobAppendStream.java,1055,67,21,3,0,91
hadoop-trunk\hadoop-trunk\hadoop-hdfs-project\hadoop-hdfs\src\test\java\org\apache\hadoop\hdfs\server\namenode\ha\TestConsistentReadsObserver.java,442,53,5,2,0,60
hadoop-trunk\hadoop-trunk\hadoop-hdfs-project\hadoop-hdfs-client\src\main\java\org\apache\hadoop\hdfs\protocol\ECBlockGroupStats.java,0,40,0,1,0,41
hadoop-trunk\hadoop-trunk\hadoop-common-project\hadoop-nfs\src\main\java\org\apache\hadoop\oncrpc\XDR.java,0,67,4,1,0,72
hadoop-trunk\hadoop-trunk\hadoop-hdfs-project\hadoop-hdfs\src\test\java\org\apache\hadoop\hdfs\server\datanode\TestProvidedReplicaImpl.java,118,41,7,1,0,49
hadoop-trunk\hadoop-trunk\hadoop-yarn-project\hadoop-yarn\hadoop-yarn-server\hadoop-yarn-server-nodemanager\src\main\java\org\apache\hadoop\yarn\server\nodemanager\api\deviceplugin\DeviceRegisterRequest.java,0,16,0,1,0,17
hadoop-trunk\hadoop-trunk\hadoop-hdfs-project\hadoop-hdfs\src\test\java\org\apache\hadoop\hdfs\server\datanode\TestDataNodeTcpNoDelay.java,405,105,8,2,0,115
hadoop-trunk\hadoop-trunk\hadoop-mapreduce-project\hadoop-mapreduce-client\hadoop-mapreduce-client-core\src\main\java\org\apache\hadoop\mapred\RamManager.java,0,5,0,1,0,6
hadoop-trunk\hadoop-trunk\hadoop-hdfs-project\hadoop-hdfs\src\main\java\org\apache\hadoop\hdfs\security\token\delegation\DelegationTokenSecretManager.java,0,101,28,12,0,141
hadoop-trunk\hadoop-trunk\hadoop-tools\hadoop-aws\src\main\java\org\apache\hadoop\fs\s3a\UnknownStoreException.java,28,2,0,1,0,3
hadoop-trunk\hadoop-trunk\hadoop-yarn-project\hadoop-yarn\hadoop-yarn-server\hadoop-yarn-server-resourcemanager\src\main\java\org\apache\hadoop\yarn\server\resourcemanager\monitor\capacity\TempSchedulerNode.java,87,47,0,2,0,49
hadoop-trunk\hadoop-trunk\hadoop-yarn-project\hadoop-yarn\hadoop-yarn-server\hadoop-yarn-server-resourcemanager\src\test\java\org\apache\hadoop\yarn\server\resourcemanager\scheduler\capacity\TestApplicationPriorityACLs.java,165,33,5,3,0,41
hadoop-trunk\hadoop-trunk\hadoop-yarn-project\hadoop-yarn\hadoop-yarn-server\hadoop-yarn-server-common\src\main\java\org\apache\hadoop\yarn\server\api\protocolrecords\impl\pb\DistributedSchedulingAllocateRequestPBImpl.java,0,22,41,4,0,67
hadoop-trunk\hadoop-trunk\hadoop-yarn-project\hadoop-yarn\hadoop-yarn-server\hadoop-yarn-server-resourcemanager\src\main\java\org\apache\hadoop\yarn\server\resourcemanager\rmapp\RMAppLogAggregation.java,345,56,2,1,0,59
hadoop-trunk\hadoop-trunk\hadoop-hdfs-project\hadoop-hdfs\src\main\java\org\apache\hadoop\hdfs\server\blockmanagement\BlockInfoContiguous.java,104,32,0,1,0,33
hadoop-trunk\hadoop-trunk\hadoop-mapreduce-project\hadoop-mapreduce-client\hadoop-mapreduce-client-jobclient\src\test\java\org\apache\hadoop\fs\slive\OperationFactory.java,0,11,1,1,0,13
hadoop-trunk\hadoop-trunk\hadoop-yarn-project\hadoop-yarn\hadoop-yarn-api\src\main\java\org\apache\hadoop\yarn\api\ApplicationConstants.java,0,31,5,1,0,37
hadoop-trunk\hadoop-trunk\hadoop-hdfs-project\hadoop-hdfs\src\test\java\org\apache\hadoop\hdfs\util\TestMD5FileUtils.java,76,23,3,3,0,29
hadoop-trunk\hadoop-trunk\hadoop-yarn-project\hadoop-yarn\hadoop-yarn-common\src\test\java\org\apache\hadoop\yarn\logaggregation\TestContainerLogsUtils.java,0,25,1,4,0,30
hadoop-trunk\hadoop-trunk\hadoop-yarn-project\hadoop-yarn\hadoop-yarn-server\hadoop-yarn-server-resourcemanager\src\test\java\org\apache\hadoop\yarn\server\resourcemanager\scheduler\fair\FairSchedulerWithMockPreemption.java,40,6,0,1,0,7
hadoop-trunk\hadoop-trunk\hadoop-yarn-project\hadoop-yarn\hadoop-yarn-server\hadoop-yarn-server-router\src\main\java\org\apache\hadoop\yarn\server\router\rmadmin\package-info.java,0,0,0,1,0,1
hadoop-trunk\hadoop-trunk\hadoop-yarn-project\hadoop-yarn\hadoop-yarn-server\hadoop-yarn-server-common\src\main\java\org\apache\hadoop\yarn\server\webapp\dao\ContainersInfo.java,18,9,3,1,0,13
hadoop-trunk\hadoop-trunk\hadoop-yarn-project\hadoop-yarn\hadoop-yarn-server\hadoop-yarn-server-common\src\main\java\org\apache\hadoop\yarn\server\api\protocolrecords\UnRegisterNodeManagerRequest.java,13,4,0,1,0,5
hadoop-trunk\hadoop-trunk\hadoop-common-project\hadoop-common\src\test\java\org\apache\hadoop\fs\contract\AbstractContractMultipartUploaderTest.java,774,27,6,2,0,35
hadoop-trunk\hadoop-trunk\hadoop-common-project\hadoop-common\src\main\java\org\apache\hadoop\io\VersionedWritable.java,22,8,1,1,0,10
hadoop-trunk\hadoop-trunk\hadoop-yarn-project\hadoop-yarn\hadoop-yarn-server\hadoop-yarn-server-resourcemanager\src\test\java\org\apache\hadoop\yarn\server\resourcemanager\scheduler\fair\TestContinuousScheduling.java,351,67,24,7,0,98
hadoop-trunk\hadoop-trunk\hadoop-mapreduce-project\hadoop-mapreduce-client\hadoop-mapreduce-client-core\src\main\java\org\apache\hadoop\mapred\SpillRecord.java,112,36,5,1,0,42
hadoop-trunk\hadoop-trunk\hadoop-common-project\hadoop-common\src\test\java\org\apache\hadoop\util\TestProtoUtil.java,52,6,5,2,0,13
hadoop-trunk\hadoop-trunk\hadoop-common-project\hadoop-common\src\main\java\org\apache\hadoop\io\compress\bzip2\Bzip2Factory.java,113,52,5,1,0,58
hadoop-trunk\hadoop-trunk\hadoop-hdfs-project\hadoop-hdfs\src\test\java\org\apache\hadoop\hdfs\TestDataTransferProtocol.java,578,176,50,11,0,237
hadoop-trunk\hadoop-trunk\hadoop-common-project\hadoop-common\src\main\java\org\apache\hadoop\security\SaslRpcServer.java,308,102,6,1,0,109
hadoop-trunk\hadoop-trunk\hadoop-hdfs-project\hadoop-hdfs\src\test\java\org\apache\hadoop\hdfs\server\datanode\fsdataset\impl\TestLazyPersistReplicaPlacement.java,139,17,8,2,0,27
hadoop-trunk\hadoop-trunk\hadoop-yarn-project\hadoop-yarn\hadoop-yarn-common\src\main\java\org\apache\hadoop\yarn\nodelabels\StringAttributeValue.java,37,9,0,1,0,10
hadoop-trunk\hadoop-trunk\hadoop-yarn-project\hadoop-yarn\hadoop-yarn-server\hadoop-yarn-server-timelineservice\src\test\java\org\apache\hadoop\yarn\server\timelineservice\collector\TestTimelineCollectorManager.java,45,8,1,2,0,11
hadoop-trunk\hadoop-trunk\hadoop-yarn-project\hadoop-yarn\hadoop-yarn-server\hadoop-yarn-server-nodemanager\src\main\java\org\apache\hadoop\yarn\server\nodemanager\containermanager\localizer\ResourceState.java,0,4,0,1,0,5
hadoop-trunk\hadoop-trunk\hadoop-yarn-project\hadoop-yarn\hadoop-yarn-server\hadoop-yarn-server-nodemanager\src\main\java\org\apache\hadoop\yarn\server\nodemanager\containermanager\linux\resources\CGroupsHandlerImpl.java,0,75,18,6,0,99
hadoop-trunk\hadoop-trunk\hadoop-tools\hadoop-aws\src\test\java\org\apache\hadoop\fs\s3a\ITestS3AClosedFS.java,70,12,1,2,0,15
hadoop-trunk\hadoop-trunk\hadoop-yarn-project\hadoop-yarn\hadoop-yarn-common\src\main\java\org\apache\hadoop\yarn\api\pb\PlacementConstraintToProtoConverter.java,0,25,41,7,0,73
hadoop-trunk\hadoop-trunk\hadoop-yarn-project\hadoop-yarn\hadoop-yarn-server\hadoop-yarn-server-resourcemanager\src\main\java\org\apache\hadoop\yarn\server\resourcemanager\reservation\AbstractSchedulerPlanFollower.java,415,95,3,6,0,104
hadoop-trunk\hadoop-trunk\hadoop-yarn-project\hadoop-yarn\hadoop-yarn-server\hadoop-yarn-server-resourcemanager\src\test\java\org\apache\hadoop\yarn\server\resourcemanager\scheduler\fair\allocationfile\UserSettings.java,50,18,0,2,0,20
hadoop-trunk\hadoop-trunk\hadoop-tools\hadoop-openstack\src\test\java\org\apache\hadoop\fs\swift\contract\TestSwiftContractRootDir.java,8,3,0,1,0,4
hadoop-trunk\hadoop-trunk\hadoop-mapreduce-project\hadoop-mapreduce-client\hadoop-mapreduce-client-app\src\main\java\org\apache\hadoop\mapreduce\v2\app\rm\preemption\AMPreemptionPolicy.java,0,13,9,1,0,23
hadoop-trunk\hadoop-trunk\hadoop-hdfs-project\hadoop-hdfs\src\test\java\org\apache\hadoop\hdfs\shortcircuit\TestShortCircuitCache.java,910,199,35,18,0,252
hadoop-trunk\hadoop-trunk\hadoop-common-project\hadoop-common\src\main\java\org\apache\hadoop\fs\GlobalStorageStatistics.java,0,11,1,1,0,13
hadoop-trunk\hadoop-trunk\hadoop-hdfs-project\hadoop-hdfs\src\main\java\org\apache\hadoop\hdfs\DFSConfigKeys.java,1972,1613,1,477,0,2091
hadoop-trunk\hadoop-trunk\hadoop-yarn-project\hadoop-yarn\hadoop-yarn-common\src\main\java\org\apache\hadoop\yarn\util\YarnVersionInfo.java,81,16,1,1,0,18
hadoop-trunk\hadoop-trunk\hadoop-yarn-project\hadoop-yarn\hadoop-yarn-server\hadoop-yarn-server-nodemanager\src\main\java\org\apache\hadoop\yarn\server\nodemanager\containermanager\linux\resources\CGroupsMountConfig.java,49,20,0,2,0,22
hadoop-trunk\hadoop-trunk\hadoop-hdfs-project\hadoop-hdfs\src\test\java\org\apache\hadoop\hdfs\TestDFSStripedOutputStream.java,272,60,12,2,0,74
hadoop-trunk\hadoop-trunk\hadoop-yarn-project\hadoop-yarn\hadoop-yarn-api\src\main\java\org\apache\hadoop\yarn\api\protocolrecords\ResourceTypes.java,0,1,0,1,0,2
hadoop-trunk\hadoop-trunk\hadoop-hdfs-project\hadoop-hdfs\src\main\java\org\apache\hadoop\hdfs\server\namenode\FSTreeTraverser.java,297,20,0,3,0,23
hadoop-trunk\hadoop-trunk\hadoop-yarn-project\hadoop-yarn\hadoop-yarn-common\src\main\java\org\apache\hadoop\yarn\client\api\TimelineReaderClient.java,81,3,0,1,0,4
hadoop-trunk\hadoop-trunk\hadoop-common-project\hadoop-common\src\main\java\org\apache\hadoop\fs\BBUploadHandle.java,0,6,0,1,0,7
hadoop-trunk\hadoop-trunk\hadoop-mapreduce-project\hadoop-mapreduce-client\hadoop-mapreduce-client-jobclient\src\test\java\org\apache\hadoop\mapreduce\v2\TestMROldApiJobs.java,168,56,12,15,0,83
hadoop-trunk\hadoop-trunk\hadoop-yarn-project\hadoop-yarn\hadoop-yarn-server\hadoop-yarn-server-resourcemanager\src\test\java\org\apache\hadoop\yarn\server\resourcemanager\applicationsmanager\TestAMRMRPCNodeUpdates.java,274,45,0,3,0,48
hadoop-trunk\hadoop-trunk\hadoop-tools\hadoop-dynamometer\hadoop-dynamometer-workload\src\main\java\org\apache\hadoop\tools\dynamometer\workloadgenerator\package-info.java,0,0,0,1,0,1
hadoop-trunk\hadoop-trunk\hadoop-hdfs-project\hadoop-hdfs-client\src\main\java\org\apache\hadoop\hdfs\protocol\datatransfer\Sender.java,244,30,76,15,0,121
hadoop-trunk\hadoop-trunk\hadoop-yarn-project\hadoop-yarn\hadoop-yarn-api\src\main\java\org\apache\hadoop\yarn\conf\ConfigurationProvider.java,34,8,0,1,0,9
hadoop-trunk\hadoop-trunk\hadoop-common-project\hadoop-common\src\main\java\org\apache\hadoop\util\functional\CommonCallableSupplier.java,0,6,1,1,0,8
hadoop-trunk\hadoop-trunk\hadoop-mapreduce-project\hadoop-mapreduce-client\hadoop-mapreduce-client-core\src\main\java\org\apache\hadoop\mapreduce\lib\output\BindingPathOutputCommitter.java,123,32,0,1,0,33
hadoop-trunk\hadoop-trunk\hadoop-mapreduce-project\hadoop-mapreduce-client\hadoop-mapreduce-client-jobclient\src\test\java\org\apache\hadoop\fs\slive\OperationWeight.java,0,10,0,1,0,11
hadoop-trunk\hadoop-trunk\hadoop-yarn-project\hadoop-yarn\hadoop-yarn-csi\src\test\java\org\apache\hadoop\yarn\csi\client\FakeCsiDriver.java,33,10,2,1,0,13
hadoop-trunk\hadoop-trunk\hadoop-yarn-project\hadoop-yarn\hadoop-yarn-client\src\main\java\org\apache\hadoop\yarn\client\util\YarnClientUtils.java,207,11,6,1,0,18
hadoop-trunk\hadoop-trunk\hadoop-hdfs-project\hadoop-hdfs\src\main\java\org\apache\hadoop\hdfs\tools\offlineImageViewer\OfflineImageViewerPB.java,230,20,6,5,0,31
hadoop-trunk\hadoop-trunk\hadoop-hdfs-project\hadoop-hdfs\src\test\java\org\apache\hadoop\hdfs\server\namenode\TestAddBlock.java,117,23,1,1,0,25
hadoop-trunk\hadoop-trunk\hadoop-tools\hadoop-azure\src\test\java\org\apache\hadoop\fs\azurebfs\utils\package-info.java,0,2,1,1,0,4
hadoop-trunk\hadoop-trunk\hadoop-yarn-project\hadoop-yarn\hadoop-yarn-common\src\main\java\org\apache\hadoop\yarn\api\records\impl\pb\ResourceRequestPBImpl.java,221,62,77,1,0,140
hadoop-trunk\hadoop-trunk\hadoop-yarn-project\hadoop-yarn\hadoop-yarn-server\hadoop-yarn-server-resourcemanager\src\main\java\org\apache\hadoop\yarn\server\resourcemanager\webapp\dao\ContainerLaunchContextInfo.java,77,50,8,1,0,59
hadoop-trunk\hadoop-trunk\hadoop-common-project\hadoop-common\src\main\java\org\apache\hadoop\io\compress\zlib\BuiltInGzipCompressor.java,218,65,0,6,0,71
hadoop-trunk\hadoop-trunk\hadoop-mapreduce-project\hadoop-mapreduce-client\hadoop-mapreduce-client-app\src\main\java\org\apache\hadoop\mapreduce\v2\app\client\ClientService.java,0,6,2,1,0,9
hadoop-trunk\hadoop-trunk\hadoop-mapreduce-project\hadoop-mapreduce-client\hadoop-mapreduce-client-app\src\test\java\org\apache\hadoop\mapreduce\v2\app\webapp\AppForTest.java,15,8,2,1,0,11
hadoop-trunk\hadoop-trunk\hadoop-yarn-project\hadoop-yarn\hadoop-yarn-common\src\main\java\org\apache\hadoop\yarn\webapp\BadRequestException.java,17,5,1,1,0,7
hadoop-trunk\hadoop-trunk\hadoop-mapreduce-project\hadoop-mapreduce-client\hadoop-mapreduce-client-app\src\main\java\org\apache\hadoop\mapreduce\v2\app\job\event\TaskAttemptStatusUpdateEvent.java,31,28,0,1,0,29
hadoop-trunk\hadoop-trunk\hadoop-yarn-project\hadoop-yarn\hadoop-yarn-applications\hadoop-yarn-services\hadoop-yarn-services-core\src\main\java\org\apache\hadoop\yarn\service\utils\SerializedApplicationReport.java,59,43,2,3,0,48
hadoop-trunk\hadoop-trunk\hadoop-common-project\hadoop-common\src\test\java\org\apache\hadoop\io\file\tfile\TestTFileJClassComparatorByteArrays.java,0,13,0,1,0,14
hadoop-trunk\hadoop-trunk\hadoop-common-project\hadoop-common\src\test\java\org\apache\hadoop\metrics2\util\TestSampleQuantiles.java,91,16,0,1,0,17
hadoop-trunk\hadoop-trunk\hadoop-hdfs-project\hadoop-hdfs\src\test\java\org\apache\hadoop\hdfs\server\datanode\TestDNUsageReport.java,87,25,7,1,0,33
hadoop-trunk\hadoop-trunk\hadoop-common-project\hadoop-common\src\main\java\org\apache\hadoop\security\token\delegation\ZKDelegationTokenSecretManager.java,0,142,37,7,0,186
hadoop-trunk\hadoop-trunk\hadoop-common-project\hadoop-common\src\test\java\org\apache\hadoop\util\TestIndexedSort.java,339,118,21,1,0,140
hadoop-trunk\hadoop-trunk\hadoop-yarn-project\hadoop-yarn\hadoop-yarn-common\src\test\java\org\apache\hadoop\yarn\security\TestYARNTokenIdentifier.java,516,107,8,16,0,131
hadoop-trunk\hadoop-trunk\hadoop-common-project\hadoop-common\src\main\java\org\apache\hadoop\fs\sftp\SFTPFileSystem.java,694,128,16,1,0,145
hadoop-trunk\hadoop-trunk\hadoop-mapreduce-project\hadoop-mapreduce-client\hadoop-mapreduce-client-core\src\main\java\org\apache\hadoop\mapreduce\lib\output\committer\manifest\files\ManifestSuccessData.java,0,92,7,1,0,100
hadoop-trunk\hadoop-trunk\hadoop-common-project\hadoop-common\src\main\java\org\apache\hadoop\metrics2\util\MetricsCache.java,160,34,2,1,0,37
hadoop-trunk\hadoop-trunk\hadoop-tools\hadoop-aws\src\test\java\org\apache\hadoop\fs\s3a\performance\ITestS3AMkdirCost.java,141,4,3,4,0,11
hadoop-trunk\hadoop-trunk\hadoop-yarn-project\hadoop-yarn\hadoop-yarn-applications\hadoop-yarn-services\hadoop-yarn-services-core\src\main\java\org\apache\hadoop\yarn\service\component\instance\ComponentInstanceEvent.java,0,18,0,1,0,19
hadoop-trunk\hadoop-trunk\hadoop-mapreduce-project\hadoop-mapreduce-client\hadoop-mapreduce-client-app\src\main\java\org\apache\hadoop\mapreduce\v2\app\metrics\package-info.java,0,1,0,1,0,2
hadoop-trunk\hadoop-trunk\hadoop-hdfs-project\hadoop-hdfs\src\test\java\org\apache\hadoop\hdfs\server\namenode\TestNameNodeRpcServerMethods.java,77,15,0,2,0,17
hadoop-trunk\hadoop-trunk\hadoop-common-project\hadoop-common\src\test\java\org\apache\hadoop\security\TestAuthenticationFilter.java,44,5,2,1,0,8
hadoop-trunk\hadoop-trunk\hadoop-yarn-project\hadoop-yarn\hadoop-yarn-server\hadoop-yarn-server-timelineservice-hbase\hadoop-yarn-server-timelineservice-hbase-client\src\main\java\org\apache\hadoop\yarn\server\timelineservice\storage\apptoflow\package-info.java,0,1,0,1,0,2
hadoop-trunk\hadoop-trunk\hadoop-common-project\hadoop-nfs\src\main\java\org\apache\hadoop\nfs\nfs3\request\FSSTAT3Request.java,16,10,0,1,0,11
hadoop-trunk\hadoop-trunk\hadoop-yarn-project\hadoop-yarn\hadoop-yarn-api\src\main\java\org\apache\hadoop\yarn\api\protocolrecords\GetNewApplicationResponse.java,42,14,0,1,0,15
hadoop-trunk\hadoop-trunk\hadoop-mapreduce-project\hadoop-mapreduce-client\hadoop-mapreduce-client-common\src\main\java\org\apache\hadoop\mapreduce\v2\jobhistory\FileNameIndexUtils.java,332,58,9,1,0,68
hadoop-trunk\hadoop-trunk\hadoop-common-project\hadoop-common\src\main\java\org\apache\hadoop\fs\Path.java,0,120,17,3,0,140
hadoop-trunk\hadoop-trunk\hadoop-common-project\hadoop-common\src\main\java\org\apache\hadoop\tracing\TraceConfiguration.java,5,1,2,1,0,4
hadoop-trunk\hadoop-trunk\hadoop-mapreduce-project\hadoop-mapreduce-client\hadoop-mapreduce-client-hs\src\main\java\org\apache\hadoop\mapreduce\v2\hs\JobHistoryServer.java,181,41,5,2,0,48
hadoop-trunk\hadoop-trunk\hadoop-mapreduce-project\hadoop-mapreduce-client\hadoop-mapreduce-client-core\src\main\java\org\apache\hadoop\mapred\lib\ChainReducer.java,134,38,5,1,0,44
hadoop-trunk\hadoop-trunk\hadoop-tools\hadoop-distcp\src\test\java\org\apache\hadoop\tools\util\DistCpTestUtils.java,61,16,1,1,0,18
hadoop-trunk\hadoop-trunk\hadoop-common-project\hadoop-common\src\main\java\org\apache\hadoop\util\concurrent\HadoopScheduledThreadPoolExecutor.java,40,19,0,1,0,20
hadoop-trunk\hadoop-trunk\hadoop-yarn-project\hadoop-yarn\hadoop-yarn-server\hadoop-yarn-server-common\src\test\java\org\apache\hadoop\yarn\server\webapp\TestLogServlet.java,25,0,2,2,0,4
hadoop-trunk\hadoop-trunk\hadoop-yarn-project\hadoop-yarn\hadoop-yarn-server\hadoop-yarn-server-resourcemanager\src\test\java\org\apache\hadoop\yarn\server\resourcemanager\scheduler\TestAppSchedulingInfo.java,189,21,1,3,0,25
hadoop-trunk\hadoop-trunk\hadoop-yarn-project\hadoop-yarn\hadoop-yarn-server\hadoop-yarn-server-router\src\main\java\org\apache\hadoop\yarn\server\router\webapp\AboutBlock.java,60,8,0,2,0,10
hadoop-trunk\hadoop-trunk\hadoop-tools\hadoop-resourceestimator\src\main\java\org\apache\hadoop\resourceestimator\solver\exceptions\package-info.java,0,0,0,1,0,1
hadoop-trunk\hadoop-trunk\hadoop-yarn-project\hadoop-yarn\hadoop-yarn-api\src\main\java\org\apache\hadoop\yarn\server\api\ContainerInitializationContext.java,18,10,0,1,0,11
hadoop-trunk\hadoop-trunk\hadoop-yarn-project\hadoop-yarn\hadoop-yarn-server\hadoop-yarn-server-resourcemanager\src\main\java\org\apache\hadoop\yarn\server\resourcemanager\security\FairQueueACLsManager.java,37,17,1,3,0,21
hadoop-trunk\hadoop-trunk\hadoop-common-project\hadoop-common\src\main\java\org\apache\hadoop\fs\audit\package-info.java,0,1,0,1,0,2
hadoop-trunk\hadoop-trunk\hadoop-common-project\hadoop-common\src\main\java\org\apache\hadoop\fs\PathCapabilities.java,0,0,0,1,0,1
hadoop-trunk\hadoop-trunk\hadoop-common-project\hadoop-common\src\main\java\org\apache\hadoop\io\WritableUtils.java,0,190,20,13,0,223
hadoop-trunk\hadoop-trunk\hadoop-hdfs-project\hadoop-hdfs-rbf\src\main\java\org\apache\hadoop\hdfs\server\federation\store\protocol\impl\pb\EnableNameserviceResponsePBImpl.java,0,12,29,5,0,46
hadoop-trunk\hadoop-trunk\hadoop-mapreduce-project\hadoop-mapreduce-client\hadoop-mapreduce-client-jobclient\src\test\java\org\apache\hadoop\mapred\TestWritableJobConf.java,76,10,1,1,0,12
hadoop-trunk\hadoop-trunk\hadoop-yarn-project\hadoop-yarn\hadoop-yarn-common\src\test\java\org\apache\hadoop\yarn\util\TestLog4jWarningErrorMetricsAppender.java,232,70,1,7,0,78
hadoop-trunk\hadoop-trunk\hadoop-common-project\hadoop-common\src\test\java\org\apache\hadoop\io\erasurecode\coder\TestErasureCoderBase.java,282,46,0,4,0,50
hadoop-trunk\hadoop-trunk\hadoop-yarn-project\hadoop-yarn\hadoop-yarn-server\hadoop-yarn-server-timelineservice-documentstore\src\main\java\org\apache\hadoop\yarn\server\timelineservice\documentstore\collection\document\flowactivity\package-info.java,0,0,0,2,0,2
hadoop-trunk\hadoop-trunk\hadoop-common-project\hadoop-common\src\test\java\org\apache\hadoop\http\TestHtmlQuoting.java,65,16,1,2,0,19
hadoop-trunk\hadoop-trunk\hadoop-mapreduce-project\hadoop-mapreduce-client\hadoop-mapreduce-client-nativetask\src\test\java\org\apache\hadoop\mapred\nativetask\utils\TestBytesUtil.java,43,13,0,1,0,14
hadoop-trunk\hadoop-trunk\hadoop-tools\hadoop-sls\src\test\java\org\apache\hadoop\yarn\sls\nodemanager\TestNMSimulator.java,190,52,6,3,0,61
hadoop-trunk\hadoop-trunk\hadoop-yarn-project\hadoop-yarn\hadoop-yarn-api\src\main\java\org\apache\hadoop\yarn\api\ContainerManagementProtocol.java,0,18,0,6,0,24
hadoop-trunk\hadoop-trunk\hadoop-common-project\hadoop-common\src\main\java\org\apache\hadoop\fs\InvalidPathHandleException.java,13,5,0,1,0,6
hadoop-trunk\hadoop-trunk\hadoop-hdfs-project\hadoop-hdfs\src\main\java\org\apache\hadoop\hdfs\server\blockmanagement\ReplicationWork.java,0,13,1,1,0,15
hadoop-trunk\hadoop-trunk\hadoop-common-project\hadoop-common\src\main\java\org\apache\hadoop\util\SequentialNumber.java,68,21,0,1,0,22
hadoop-trunk\hadoop-trunk\hadoop-common-project\hadoop-common\src\main\java\org\apache\hadoop\security\token\delegation\web\MultiSchemeDelegationTokenAuthenticationHandler.java,105,11,0,4,0,15
hadoop-trunk\hadoop-trunk\hadoop-mapreduce-project\hadoop-mapreduce-client\hadoop-mapreduce-client-nativetask\src\main\java\org\apache\hadoop\mapred\nativetask\util\NativeTaskOutput.java,0,40,12,4,0,56
hadoop-trunk\hadoop-trunk\hadoop-hdfs-project\hadoop-hdfs-client\src\main\java\org\apache\hadoop\hdfs\server\datanode\CachingStrategy.java,55,30,0,1,0,31
hadoop-trunk\hadoop-trunk\hadoop-hdfs-project\hadoop-hdfs-rbf\src\main\java\org\apache\hadoop\hdfs\server\federation\metrics\package-info.java,0,2,0,1,0,3
hadoop-trunk\hadoop-trunk\hadoop-common-project\hadoop-common\src\main\java\org\apache\hadoop\http\ProfilerDisabledServlet.java,20,6,1,6,0,13
hadoop-trunk\hadoop-trunk\hadoop-mapreduce-project\hadoop-mapreduce-client\hadoop-mapreduce-client-core\src\main\java\org\apache\hadoop\mapred\join\StreamBackedIterator.java,0,1,0,1,0,2
hadoop-trunk\hadoop-trunk\hadoop-yarn-project\hadoop-yarn\hadoop-yarn-api\src\main\java\org\apache\hadoop\yarn\api\records\ContainerUpdateType.java,0,0,0,1,0,1
hadoop-trunk\hadoop-trunk\hadoop-yarn-project\hadoop-yarn\hadoop-yarn-applications\hadoop-yarn-services\hadoop-yarn-services-core\src\main\java\org\apache\hadoop\yarn\service\monitor\probe\DefaultProbe.java,64,15,0,1,0,16
hadoop-trunk\hadoop-trunk\hadoop-mapreduce-project\hadoop-mapreduce-client\hadoop-mapreduce-client-hs\src\test\java\org\apache\hadoop\mapreduce\v2\hs\TestJobHistoryServer.java,155,37,3,10,0,50
hadoop-trunk\hadoop-trunk\hadoop-mapreduce-project\hadoop-mapreduce-client\hadoop-mapreduce-client-core\src\main\java\org\apache\hadoop\mapreduce\lib\chain\ChainMapper.java,0,23,5,1,0,29
hadoop-trunk\hadoop-trunk\hadoop-tools\hadoop-azure\src\main\java\org\apache\hadoop\fs\azure\RemoteWasbAuthorizerImpl.java,0,41,3,10,0,54
hadoop-trunk\hadoop-trunk\hadoop-yarn-project\hadoop-yarn\hadoop-yarn-server\hadoop-yarn-server-resourcemanager\src\main\java\org\apache\hadoop\yarn\server\resourcemanager\scheduler\fair\converter\ConversionException.java,12,5,0,1,0,6
hadoop-trunk\hadoop-trunk\hadoop-tools\hadoop-azure\src\test\java\org\apache\hadoop\fs\azurebfs\services\TestAbfsPerfTracker.java,0,108,7,87,0,202
hadoop-trunk\hadoop-trunk\hadoop-hdfs-project\hadoop-hdfs-client\src\main\java\org\apache\hadoop\hdfs\protocol\datatransfer\DataTransferProtocol.java,0,47,7,1,0,55
hadoop-trunk\hadoop-trunk\hadoop-mapreduce-project\hadoop-mapreduce-client\hadoop-mapreduce-client-nativetask\src\main\java\org\apache\hadoop\mapred\nativetask\handlers\BufferPullee.java,0,30,2,4,0,36
hadoop-trunk\hadoop-trunk\hadoop-yarn-project\hadoop-yarn\hadoop-yarn-server\hadoop-yarn-server-resourcemanager\src\main\java\org\apache\hadoop\yarn\server\resourcemanager\scheduler\capacity\allocator\AbstractContainerAllocator.java,147,36,1,12,0,49
hadoop-trunk\hadoop-trunk\hadoop-yarn-project\hadoop-yarn\hadoop-yarn-server\hadoop-yarn-server-resourcemanager\src\main\java\org\apache\hadoop\yarn\server\resourcemanager\scheduler\constraint\processor\SchedulerPlacementProcessor.java,24,5,0,2,0,7
hadoop-trunk\hadoop-trunk\hadoop-common-project\hadoop-registry\src\main\java\org\apache\hadoop\registry\client\exceptions\NoRecordException.java,13,8,0,1,0,9
hadoop-trunk\hadoop-trunk\hadoop-tools\hadoop-extras\src\main\java\org\apache\hadoop\tools\DistTool.java,0,43,2,2,0,47
hadoop-trunk\hadoop-trunk\hadoop-cloud-storage-project\hadoop-cos\src\main\java\org\apache\hadoop\fs\cosn\BufferPool.java,0,12,3,1,0,16
hadoop-trunk\hadoop-trunk\hadoop-common-project\hadoop-common\src\main\java\org\apache\hadoop\fs\ftp\FtpFs.java,32,8,0,1,0,9
hadoop-trunk\hadoop-trunk\hadoop-hdfs-project\hadoop-hdfs\src\main\java\org\apache\hadoop\hdfs\server\datanode\fsdataset\impl\FsDatasetImpl.java,0,573,87,54,0,714
hadoop-trunk\hadoop-trunk\hadoop-tools\hadoop-distcp\src\test\java\org\apache\hadoop\tools\StubContext.java,113,54,7,3,0,64
hadoop-trunk\hadoop-trunk\hadoop-common-project\hadoop-common\src\main\java\org\apache\hadoop\io\erasurecode\coder\HHXORErasureDecoder.java,58,7,0,1,0,8
hadoop-trunk\hadoop-trunk\hadoop-mapreduce-project\hadoop-mapreduce-client\hadoop-mapreduce-client-common\src\main\java\org\apache\hadoop\mapreduce\v2\api\protocolrecords\FailTaskAttemptRequest.java,0,7,2,1,0,10
hadoop-trunk\hadoop-trunk\hadoop-yarn-project\hadoop-yarn\hadoop-yarn-server\hadoop-yarn-server-nodemanager\src\main\java\org\apache\hadoop\yarn\server\nodemanager\containermanager\linux\resources\CGroupElasticMemoryController.java,419,65,14,12,0,91
hadoop-trunk\hadoop-trunk\hadoop-mapreduce-project\hadoop-mapreduce-client\hadoop-mapreduce-client-core\src\main\java\org\apache\hadoop\mapred\join\ArrayListBackedIterator.java,0,6,1,1,0,8
hadoop-trunk\hadoop-trunk\hadoop-common-project\hadoop-common\src\main\java\org\apache\hadoop\security\CompositeGroupsMapping.java,0,51,4,13,0,68
hadoop-trunk\hadoop-trunk\hadoop-hdfs-project\hadoop-hdfs\src\main\java\org\apache\hadoop\hdfs\server\namenode\XAttrStorage.java,51,11,1,1,0,13
hadoop-trunk\hadoop-trunk\hadoop-mapreduce-project\hadoop-mapreduce-examples\src\main\java\org\apache\hadoop\examples\pi\math\Montgomery.java,0,40,3,1,0,44
hadoop-trunk\hadoop-trunk\hadoop-tools\hadoop-azure\src\main\java\org\apache\hadoop\fs\azurebfs\contracts\annotations\package-info.java,0,2,0,1,0,3
hadoop-trunk\hadoop-trunk\hadoop-hdfs-project\hadoop-hdfs\src\test\java\org\apache\hadoop\hdfs\TestFileCorruption.java,266,46,15,1,0,62
hadoop-trunk\hadoop-trunk\hadoop-hdfs-project\hadoop-hdfs-rbf\src\main\java\org\apache\hadoop\hdfs\server\federation\router\RouterStateManager.java,0,0,0,7,0,7
hadoop-trunk\hadoop-trunk\hadoop-mapreduce-project\hadoop-mapreduce-client\hadoop-mapreduce-client-jobclient\src\test\java\org\apache\hadoop\mapred\TestSpecialCharactersInOutputPath.java,91,31,10,3,0,44
hadoop-trunk\hadoop-trunk\hadoop-common-project\hadoop-common\src\main\java\org\apache\hadoop\fs\FsConstants.java,0,23,12,1,0,36
hadoop-trunk\hadoop-trunk\hadoop-tools\hadoop-azure-datalake\src\test\java\org\apache\hadoop\fs\adl\live\TestAdlContractAppendLive.java,15,2,0,1,0,3
hadoop-trunk\hadoop-trunk\hadoop-yarn-project\hadoop-yarn\hadoop-yarn-server\hadoop-yarn-server-resourcemanager\src\test\java\org\apache\hadoop\yarn\server\resourcemanager\scheduler\fair\policies\TestDominantResourceFairnessPolicy.java,458,210,14,5,0,229
hadoop-trunk\hadoop-trunk\hadoop-common-project\hadoop-registry\src\main\java\org\apache\hadoop\registry\client\impl\zk\ZookeeperConfigOptions.java,0,2,11,1,0,14
hadoop-trunk\hadoop-trunk\hadoop-tools\hadoop-distcp\src\test\java\org\apache\hadoop\tools\mapred\lib\TestDynamicInputFormat.java,165,52,13,3,0,68
hadoop-trunk\hadoop-trunk\hadoop-common-project\hadoop-common\src\test\java\org\apache\hadoop\ipc\TestAsyncIPC.java,494,110,16,4,0,130
hadoop-trunk\hadoop-trunk\hadoop-common-project\hadoop-common\src\main\java\org\apache\hadoop\http\HttpServer2Metrics.java,130,67,0,1,0,68
hadoop-trunk\hadoop-trunk\hadoop-tools\hadoop-azure\src\main\java\org\apache\hadoop\fs\azure\FileMetadata.java,0,20,0,3,0,23
hadoop-trunk\hadoop-trunk\hadoop-mapreduce-project\hadoop-mapreduce-client\hadoop-mapreduce-client-jobclient\src\test\java\org\apache\hadoop\mapred\lib\TestKeyFieldBasedPartitioner.java,31,9,0,1,0,10
hadoop-trunk\hadoop-trunk\hadoop-common-project\hadoop-common\src\main\java\org\apache\hadoop\ipc\protocolPB\GenericRefreshProtocolPB.java,0,3,3,3,0,9
hadoop-trunk\hadoop-trunk\hadoop-hdfs-project\hadoop-hdfs\src\test\java\org\apache\hadoop\hdfs\server\datanode\erasurecode\ErasureCodingTestHelper.java,0,2,0,1,0,3
hadoop-trunk\hadoop-trunk\hadoop-tools\hadoop-aws\src\main\java\org\apache\hadoop\fs\s3a\commit\CommitUtilsWithMR.java,0,23,1,1,0,25
hadoop-trunk\hadoop-trunk\hadoop-hdfs-project\hadoop-hdfs\src\main\java\org\apache\hadoop\hdfs\server\namenode\ha\RemoteNameNodeInfo.java,97,43,7,10,0,60
hadoop-trunk\hadoop-trunk\hadoop-hdfs-project\hadoop-hdfs\src\test\java\org\apache\hadoop\hdfs\server\namenode\ha\TestStateTransitionFailure.java,35,0,0,1,0,1
hadoop-trunk\hadoop-trunk\hadoop-tools\hadoop-aws\src\main\java\org\apache\hadoop\fs\s3a\InconsistentS3ClientFactory.java,18,2,0,2,0,4
hadoop-trunk\hadoop-trunk\hadoop-yarn-project\hadoop-yarn\hadoop-yarn-client\src\test\java\org\apache\hadoop\yarn\client\GetGroupsForTesting.java,47,20,1,3,0,24
hadoop-trunk\hadoop-trunk\hadoop-hdfs-project\hadoop-hdfs\src\test\java\org\apache\hadoop\hdfs\TestTrashWithSecureEncryptionZones.java,370,57,8,1,0,66
hadoop-trunk\hadoop-trunk\hadoop-hdfs-project\hadoop-hdfs\src\test\java\org\apache\hadoop\hdfs\TestSecureEncryptionZoneWithKMS.java,260,44,5,14,0,63
hadoop-trunk\hadoop-trunk\hadoop-yarn-project\hadoop-yarn\hadoop-yarn-server\hadoop-yarn-server-nodemanager\src\test\java\org\apache\hadoop\yarn\server\nodemanager\containermanager\resourceplugin\com\nec\TestVEDeviceDiscoverer.java,228,34,1,2,0,37
hadoop-trunk\hadoop-trunk\hadoop-yarn-project\hadoop-yarn\hadoop-yarn-server\hadoop-yarn-server-applicationhistoryservice\src\main\java\org\apache\hadoop\yarn\server\applicationhistoryservice\ApplicationHistoryStore.java,0,1,0,1,0,2
hadoop-trunk\hadoop-trunk\hadoop-common-project\hadoop-common\src\test\java\org\apache\hadoop\fs\viewfs\TestRegexMountPointInterceptorFactory.java,30,2,0,1,0,3
hadoop-trunk\hadoop-trunk\hadoop-common-project\hadoop-common\src\main\java\org\apache\hadoop\fs\shell\Display.java,0,66,2,1,0,69
hadoop-trunk\hadoop-trunk\hadoop-hdfs-project\hadoop-hdfs\src\main\java\org\apache\hadoop\hdfs\server\datanode\erasurecode\StripedBlockChecksumCompositeCrcReconstructor.java,0,14,0,1,0,15
hadoop-trunk\hadoop-trunk\hadoop-tools\hadoop-azure\src\main\java\org\apache\hadoop\fs\azure\SyncableDataOutputStream.java,0,17,1,10,0,28
hadoop-trunk\hadoop-trunk\hadoop-mapreduce-project\hadoop-mapreduce-client\hadoop-mapreduce-client-app\src\test\java\org\apache\hadoop\mapreduce\v2\app\webapp\TestAMWebServicesAttempts.java,600,83,4,9,0,96
hadoop-trunk\hadoop-trunk\hadoop-yarn-project\hadoop-yarn\hadoop-yarn-server\hadoop-yarn-server-timelineservice\src\main\java\org\apache\hadoop\yarn\server\timelineservice\reader\TimelineParserForExistFilters.java,0,7,0,4,0,11
hadoop-trunk\hadoop-trunk\hadoop-hdfs-project\hadoop-hdfs-client\src\main\java\org\apache\hadoop\hdfs\client\impl\LeaseRenewer.java,449,84,8,2,0,94
hadoop-trunk\hadoop-trunk\hadoop-common-project\hadoop-nfs\src\test\java\org\apache\hadoop\oncrpc\TestRpcDeniedReply.java,23,8,0,1,0,9
hadoop-trunk\hadoop-trunk\hadoop-yarn-project\hadoop-yarn\hadoop-yarn-api\src\main\java\org\apache\hadoop\yarn\api\records\timeline\TimelineEvent.java,139,46,10,1,0,57
hadoop-trunk\hadoop-trunk\hadoop-yarn-project\hadoop-yarn\hadoop-yarn-server\hadoop-yarn-server-timeline-pluginstorage\src\test\java\org\apache\hadoop\yarn\server\timeline\PluginStoreTestUtils.java,202,65,2,6,0,73
hadoop-trunk\hadoop-trunk\hadoop-tools\hadoop-aws\src\main\java\org\apache\hadoop\fs\s3a\commit\files\SuccessData.java,0,76,1,2,0,79
hadoop-trunk\hadoop-trunk\hadoop-yarn-project\hadoop-yarn\hadoop-yarn-applications\hadoop-yarn-services\hadoop-yarn-services-core\src\main\java\org\apache\hadoop\yarn\service\containerlaunch\AbstractLauncher.java,218,88,1,2,0,91
hadoop-trunk\hadoop-trunk\hadoop-mapreduce-project\hadoop-mapreduce-client\hadoop-mapreduce-client-core\src\main\java\org\apache\hadoop\mapred\JobQueueInfo.java,125,39,1,1,0,41
hadoop-trunk\hadoop-trunk\hadoop-yarn-project\hadoop-yarn\hadoop-yarn-server\hadoop-yarn-server-timelineservice-hbase\hadoop-yarn-server-timelineservice-hbase-common\src\main\java\org\apache\hadoop\yarn\server\timelineservice\storage\flow\FlowRunColumnFamily.java,0,3,1,2,0,6
hadoop-trunk\hadoop-trunk\hadoop-yarn-project\hadoop-yarn\hadoop-yarn-server\hadoop-yarn-server-resourcemanager\src\test\java\org\apache\hadoop\yarn\server\resourcemanager\scheduler\capacity\TestChildQueueOrder.java,383,325,21,14,0,360
hadoop-trunk\hadoop-trunk\hadoop-yarn-project\hadoop-yarn\hadoop-yarn-api\src\main\java\org\apache\hadoop\yarn\api\protocolrecords\GetPluginInfoRequest.java,7,1,0,1,0,2
hadoop-trunk\hadoop-trunk\hadoop-yarn-project\hadoop-yarn\hadoop-yarn-server\hadoop-yarn-server-resourcemanager\src\main\java\org\apache\hadoop\yarn\server\resourcemanager\scheduler\fair\converter\weightconversion\CapacityConverterFactory.java,0,3,0,2,0,5
hadoop-trunk\hadoop-trunk\hadoop-common-project\hadoop-common\src\main\java\org\apache\hadoop\fs\FSDataOutputStreamBuilder.java,0,48,0,3,0,51
hadoop-trunk\hadoop-trunk\hadoop-yarn-project\hadoop-yarn\hadoop-yarn-server\hadoop-yarn-server-applicationhistoryservice\src\main\java\org\apache\hadoop\yarn\server\timeline\TimelineWriter.java,0,2,0,1,0,3
hadoop-trunk\hadoop-trunk\hadoop-common-project\hadoop-nfs\src\main\java\org\apache\hadoop\oncrpc\RegistrationClient.java,75,22,4,1,0,27
hadoop-trunk\hadoop-trunk\hadoop-mapreduce-project\hadoop-mapreduce-client\hadoop-mapreduce-client-core\src\main\java\org\apache\hadoop\mapreduce\lib\input\FileInputFormatCounter.java,0,2,0,1,0,3
hadoop-trunk\hadoop-trunk\hadoop-mapreduce-project\hadoop-mapreduce-client\hadoop-mapreduce-client-core\src\main\java\org\apache\hadoop\mapreduce\jobhistory\HistoryViewer.java,375,260,7,1,0,268
hadoop-trunk\hadoop-trunk\hadoop-yarn-project\hadoop-yarn\hadoop-yarn-api\src\main\java\org\apache\hadoop\yarn\api\records\timelineservice\TimelineEntityType.java,0,11,0,1,0,12
hadoop-trunk\hadoop-trunk\hadoop-common-project\hadoop-common\src\main\java\org\apache\hadoop\fs\Options.java,0,140,4,3,0,147
hadoop-trunk\hadoop-trunk\hadoop-hdfs-project\hadoop-hdfs\src\main\java\org\apache\hadoop\hdfs\server\namenode\visitor\NamespaceVisitor.java,0,33,7,3,0,43
hadoop-trunk\hadoop-trunk\hadoop-mapreduce-project\hadoop-mapreduce-client\hadoop-mapreduce-client-jobclient\src\test\java\org\apache\hadoop\mapred\lib\TestMultipleOutputs.java,376,85,27,2,0,114
hadoop-trunk\hadoop-trunk\hadoop-yarn-project\hadoop-yarn\hadoop-yarn-server\hadoop-yarn-server-resourcemanager\src\main\java\org\apache\hadoop\yarn\server\resourcemanager\scheduler\placement\CandidateNodeSetUtils.java,0,2,0,1,0,3
hadoop-trunk\hadoop-trunk\hadoop-tools\hadoop-aws\src\main\java\org\apache\hadoop\fs\s3a\commit\MagicCommitPaths.java,0,13,0,2,0,15
hadoop-trunk\hadoop-trunk\hadoop-hdfs-project\hadoop-hdfs\src\test\java\org\apache\hadoop\hdfs\tools\offlineImageViewer\TestOfflineImageViewer.java,1271,180,62,21,0,263
hadoop-trunk\hadoop-trunk\hadoop-hdfs-project\hadoop-hdfs\src\test\java\org\apache\hadoop\hdfs\server\datanode\TestDataXceiverLazyPersistHint.java,134,19,6,1,0,26
hadoop-trunk\hadoop-trunk\hadoop-tools\hadoop-aws\src\test\java\org\apache\hadoop\fs\s3a\TestStreamChangeTracker.java,401,45,2,2,0,49
hadoop-trunk\hadoop-trunk\hadoop-common-project\hadoop-common\src\test\java\org\apache\hadoop\crypto\key\kms\TestKMSClientProvider.java,92,16,18,2,0,36
hadoop-trunk\hadoop-trunk\hadoop-mapreduce-project\hadoop-mapreduce-client\hadoop-mapreduce-client-core\src\main\java\org\apache\hadoop\mapred\MapTaskCompletionEventsUpdate.java,38,20,1,1,0,22
hadoop-trunk\hadoop-trunk\hadoop-hdfs-project\hadoop-hdfs\src\test\java\org\apache\hadoop\hdfs\server\blockmanagement\TestComputeInvalidateWork.java,247,66,9,1,0,76
hadoop-trunk\hadoop-trunk\hadoop-yarn-project\hadoop-yarn\hadoop-yarn-server\hadoop-yarn-server-timelineservice\src\test\java\org\apache\hadoop\yarn\server\timelineservice\reader\TestTimelineUIDConverter.java,81,9,3,1,0,13
hadoop-trunk\hadoop-trunk\hadoop-hdfs-project\hadoop-hdfs\src\test\java\org\apache\hadoop\hdfs\server\datanode\FsDatasetTestUtils.java,0,40,2,1,0,43
hadoop-trunk\hadoop-trunk\hadoop-yarn-project\hadoop-yarn\hadoop-yarn-common\src\main\java\org\apache\hadoop\yarn\server\api\protocolrecords\impl\pb\CheckForDecommissioningNodesRequestPBImpl.java,44,18,18,4,0,40
hadoop-trunk\hadoop-trunk\hadoop-hdfs-project\hadoop-hdfs-rbf\src\test\java\org\apache\hadoop\fs\contract\router\web\TestRouterWebHDFSContractCreate.java,0,4,0,1,0,5
hadoop-trunk\hadoop-trunk\hadoop-hdfs-project\hadoop-hdfs\src\main\java\org\apache\hadoop\hdfs\server\namenode\SaveNamespaceContext.java,48,20,0,1,0,21
hadoop-trunk\hadoop-trunk\hadoop-mapreduce-project\hadoop-mapreduce-client\hadoop-mapreduce-client-core\src\main\java\org\apache\hadoop\mapred\PeriodicStatsAccumulator.java,171,44,1,1,0,46
hadoop-trunk\hadoop-trunk\hadoop-tools\hadoop-distcp\src\test\java\org\apache\hadoop\tools\TestRegexpInConfigurationFilter.java,25,2,0,1,0,3
hadoop-trunk\hadoop-trunk\hadoop-hdfs-project\hadoop-hdfs-httpfs\src\test\java\org\apache\hadoop\test\TestJettyHelper.java,141,30,3,7,0,40
hadoop-trunk\hadoop-trunk\hadoop-yarn-project\hadoop-yarn\hadoop-yarn-common\src\main\java\org\apache\hadoop\yarn\api\protocolrecords\impl\pb\FailApplicationAttemptRequestPBImpl.java,102,30,37,6,0,73
hadoop-trunk\hadoop-trunk\hadoop-yarn-project\hadoop-yarn\hadoop-yarn-api\src\main\java\org\apache\hadoop\yarn\api\records\timeline\TimelinePutResponse.java,166,41,2,2,0,45
hadoop-trunk\hadoop-trunk\hadoop-yarn-project\hadoop-yarn\hadoop-yarn-common\src\main\java\org\apache\hadoop\yarn\nodelabels\event\NodeLabelsStoreEventType.java,0,3,0,1,0,4
hadoop-trunk\hadoop-trunk\hadoop-yarn-project\hadoop-yarn\hadoop-yarn-server\hadoop-yarn-server-resourcemanager\src\test\java\org\apache\hadoop\yarn\server\resourcemanager\webapp\TestRMWebServicesAppsCustomResourceTypes.java,125,11,0,7,0,18
hadoop-trunk\hadoop-trunk\hadoop-mapreduce-project\hadoop-mapreduce-client\hadoop-mapreduce-client-core\src\main\java\org\apache\hadoop\mapreduce\lib\output\committer\manifest\impl\OutputValidationException.java,12,7,0,1,0,8
hadoop-trunk\hadoop-trunk\hadoop-hdfs-project\hadoop-hdfs-rbf\src\test\java\org\apache\hadoop\fs\contract\router\TestRouterHDFSContractMkdir.java,18,4,0,1,0,5
hadoop-trunk\hadoop-trunk\hadoop-tools\hadoop-streaming\src\test\java\org\apache\hadoop\streaming\TestUnconsumedInput.java,72,35,13,2,0,50
hadoop-trunk\hadoop-trunk\hadoop-common-project\hadoop-common\src\test\java\org\apache\hadoop\io\compress\FakeCompressor.java,0,20,2,1,0,23
hadoop-trunk\hadoop-trunk\hadoop-tools\hadoop-azure\src\test\java\org\apache\hadoop\fs\azurebfs\ITestFileSystemProperties.java,106,18,1,3,0,22
hadoop-trunk\hadoop-trunk\hadoop-common-project\hadoop-common\src\main\java\org\apache\hadoop\ipc\ProcessingDetails.java,65,36,1,1,0,38
hadoop-trunk\hadoop-trunk\hadoop-yarn-project\hadoop-yarn\hadoop-yarn-server\hadoop-yarn-server-resourcemanager\src\main\java\org\apache\hadoop\yarn\server\resourcemanager\scheduler\event\NodeAttributesUpdateSchedulerEvent.java,14,5,0,1,0,6
hadoop-trunk\hadoop-trunk\hadoop-yarn-project\hadoop-yarn\hadoop-yarn-server\hadoop-yarn-server-resourcemanager\src\test\java\org\apache\hadoop\yarn\server\resourcemanager\scheduler\policy\MockSchedulableEntity.java,97,65,2,1,0,68
hadoop-trunk\hadoop-trunk\hadoop-yarn-project\hadoop-yarn\hadoop-yarn-server\hadoop-yarn-server-timelineservice-hbase\hadoop-yarn-server-timelineservice-hbase-common\src\test\java\org\apache\hadoop\yarn\server\timelineservice\storage\common\TestRowKeys.java,267,45,1,10,0,56
hadoop-trunk\hadoop-trunk\hadoop-hdfs-project\hadoop-hdfs\src\test\java\org\apache\hadoop\hdfs\server\datanode\fsdataset\impl\TestPmemCacheRecovery.java,271,38,21,1,0,60
hadoop-trunk\hadoop-trunk\hadoop-tools\hadoop-azure\src\main\java\org\apache\hadoop\fs\azure\AzureException.java,16,8,0,1,0,9
hadoop-trunk\hadoop-trunk\hadoop-yarn-project\hadoop-yarn\hadoop-yarn-common\src\main\java\org\apache\hadoop\yarn\nodelabels\store\op\AddClusterLabelOp.java,0,14,3,1,0,18
hadoop-trunk\hadoop-trunk\hadoop-hdfs-project\hadoop-hdfs\src\main\java\org\apache\hadoop\hdfs\tools\GetConf.java,302,106,0,1,0,107
hadoop-trunk\hadoop-trunk\hadoop-common-project\hadoop-common\src\test\java\org\apache\hadoop\service\launcher\ExitTrackingServiceLauncher.java,28,12,1,1,0,14
hadoop-trunk\hadoop-trunk\hadoop-yarn-project\hadoop-yarn\hadoop-yarn-server\hadoop-yarn-server-resourcemanager\src\main\java\org\apache\hadoop\yarn\server\resourcemanager\scheduler\event\NodeUpdateSchedulerEvent.java,14,6,0,1,0,7
hadoop-trunk\hadoop-trunk\hadoop-hdfs-project\hadoop-hdfs-client\src\main\java\org\apache\hadoop\hdfs\web\resources\PermissionParam.java,72,12,4,1,0,17
hadoop-trunk\hadoop-trunk\hadoop-hdfs-project\hadoop-hdfs\src\test\java\org\apache\hadoop\hdfs\server\namenode\ha\TestQuotasWithHA.java,120,31,0,1,0,32
hadoop-trunk\hadoop-trunk\hadoop-tools\hadoop-azure\src\test\java\org\apache\hadoop\fs\azure\TestClientThrottlingAnalyzer.java,149,23,0,4,0,27
hadoop-trunk\hadoop-trunk\hadoop-hdfs-project\hadoop-hdfs-httpfs\src\test\java\org\apache\hadoop\lib\wsrs\TestJSONMapProvider.java,19,1,0,1,0,2
hadoop-trunk\hadoop-trunk\hadoop-yarn-project\hadoop-yarn\hadoop-yarn-server\hadoop-yarn-server-resourcemanager\src\main\java\org\apache\hadoop\yarn\server\resourcemanager\scheduler\constraint\algorithm\LocalAllocationTagsManager.java,0,35,0,5,0,40
hadoop-trunk\hadoop-trunk\hadoop-common-project\hadoop-registry\src\main\java\org\apache\hadoop\registry\client\binding\JsonSerDeser.java,71,15,0,1,0,16
hadoop-trunk\hadoop-trunk\hadoop-hdfs-project\hadoop-hdfs-client\src\main\java\org\apache\hadoop\hdfs\web\resources\GroupParam.java,22,4,1,1,0,6
hadoop-trunk\hadoop-trunk\hadoop-yarn-project\hadoop-yarn\hadoop-yarn-server\hadoop-yarn-server-router\src\main\java\org\apache\hadoop\yarn\server\router\webapp\FederationInterceptorREST.java,1257,198,18,18,0,234
hadoop-trunk\hadoop-trunk\hadoop-hdfs-project\hadoop-hdfs\src\test\java\org\apache\hadoop\hdfs\server\namenode\TestPersistentStoragePolicySatisfier.java,482,75,8,2,0,85
hadoop-trunk\hadoop-trunk\hadoop-tools\hadoop-azure\src\test\java\org\apache\hadoop\fs\azurebfs\diagnostics\TestConfigurationValidators.java,107,50,0,46,0,96
hadoop-trunk\hadoop-trunk\hadoop-hdfs-project\hadoop-hdfs\src\main\java\org\apache\hadoop\hdfs\web\resources\UriFsPathParam.java,26,5,0,1,0,6
hadoop-trunk\hadoop-trunk\hadoop-yarn-project\hadoop-yarn\hadoop-yarn-server\hadoop-yarn-server-resourcemanager\src\main\java\org\apache\hadoop\yarn\server\resourcemanager\rmnode\RMNodeFinishedContainersPulledByAMEvent.java,15,7,0,1,0,8
hadoop-trunk\hadoop-trunk\hadoop-common-project\hadoop-common\src\main\java\org\apache\hadoop\io\erasurecode\rawcoder\DecodingValidator.java,158,21,0,1,0,22
hadoop-trunk\hadoop-trunk\hadoop-common-project\hadoop-common\src\main\java\org\apache\hadoop\metrics2\impl\MetricCounterInt.java,0,6,0,1,0,7
hadoop-trunk\hadoop-trunk\hadoop-yarn-project\hadoop-yarn\hadoop-yarn-client\src\main\java\org\apache\hadoop\yarn\client\cli\SchedConfCLI.java,419,52,1,1,0,54
hadoop-trunk\hadoop-trunk\hadoop-yarn-project\hadoop-yarn\hadoop-yarn-server\hadoop-yarn-server-nodemanager\src\main\java\org\apache\hadoop\yarn\server\nodemanager\containermanager\scheduler\AllocationBasedResourceUtilizationTracker.java,134,23,2,3,0,28
hadoop-trunk\hadoop-trunk\hadoop-hdfs-project\hadoop-hdfs-client\src\main\java\org\apache\hadoop\hdfs\client\impl\CorruptFileBlockIterator.java,72,17,0,1,0,18
hadoop-trunk\hadoop-trunk\hadoop-tools\hadoop-distcp\src\main\java\org\apache\hadoop\tools\DiffInfo.java,0,26,2,3,0,31
hadoop-trunk\hadoop-trunk\hadoop-mapreduce-project\hadoop-mapreduce-client\hadoop-mapreduce-client-core\src\main\java\org\apache\hadoop\mapred\StatePeriodicStats.java,0,8,0,2,0,10
hadoop-trunk\hadoop-trunk\hadoop-common-project\hadoop-kms\src\main\java\org\apache\hadoop\crypto\key\kms\server\KMSExceptionsProvider.java,79,14,1,1,0,16
hadoop-trunk\hadoop-trunk\hadoop-tools\hadoop-aws\src\test\java\org\apache\hadoop\fs\s3a\test\MinimalListingOperationCallbacks.java,0,13,0,1,0,14
hadoop-trunk\hadoop-trunk\hadoop-common-project\hadoop-kms\src\main\java\org\apache\hadoop\crypto\key\kms\server\EagerKeyGeneratorKeyProviderCryptoExtension.java,0,40,0,1,0,41
hadoop-trunk\hadoop-trunk\hadoop-hdfs-project\hadoop-hdfs\src\main\java\org\apache\hadoop\hdfs\server\datanode\ShortCircuitRegistry.java,331,87,11,5,0,103
hadoop-trunk\hadoop-trunk\hadoop-hdfs-project\hadoop-hdfs-nfs\src\main\java\org\apache\hadoop\hdfs\nfs\nfs3\WriteManager.java,312,63,16,1,0,80
hadoop-trunk\hadoop-trunk\hadoop-hdfs-project\hadoop-hdfs-rbf\src\test\java\org\apache\hadoop\hdfs\server\federation\store\TestStateStoreBase.java,45,7,1,4,0,12
hadoop-trunk\hadoop-trunk\hadoop-tools\hadoop-aws\src\test\java\org\apache\hadoop\fs\s3a\ITestS3ABlockOutputArray.java,163,26,4,1,0,31
hadoop-trunk\hadoop-trunk\hadoop-mapreduce-project\hadoop-mapreduce-client\hadoop-mapreduce-client-nativetask\src\main\java\org\apache\hadoop\mapred\nativetask\CommandDispatcher.java,0,4,1,2,0,7
hadoop-trunk\hadoop-trunk\hadoop-yarn-project\hadoop-yarn\hadoop-yarn-api\src\main\java\org\apache\hadoop\yarn\api\records\QueueUserACLInfo.java,37,9,0,2,0,11
hadoop-trunk\hadoop-trunk\hadoop-hdfs-project\hadoop-hdfs-client\src\main\java\org\apache\hadoop\hdfs\server\protocol\SlowPeerReports.java,0,7,1,1,0,9
hadoop-trunk\hadoop-trunk\hadoop-mapreduce-project\hadoop-mapreduce-client\hadoop-mapreduce-client-core\src\main\java\org\apache\hadoop\mapreduce\jobhistory\JobHistoryParser.java,762,319,36,4,0,359
hadoop-trunk\hadoop-trunk\hadoop-yarn-project\hadoop-yarn\hadoop-yarn-server\hadoop-yarn-server-resourcemanager\src\main\java\org\apache\hadoop\yarn\server\resourcemanager\scheduler\common\QueueEntitlement.java,49,28,4,1,0,33
hadoop-trunk\hadoop-trunk\hadoop-yarn-project\hadoop-yarn\hadoop-yarn-server\hadoop-yarn-server-nodemanager\src\main\java\org\apache\hadoop\yarn\server\nodemanager\containermanager\linux\resources\ResourceHandlerException.java,20,9,0,2,0,11
hadoop-trunk\hadoop-trunk\hadoop-yarn-project\hadoop-yarn\hadoop-yarn-api\src\main\java\org\apache\hadoop\yarn\api\records\NodeState.java,0,24,1,1,0,26
hadoop-trunk\hadoop-trunk\hadoop-yarn-project\hadoop-yarn\hadoop-yarn-server\hadoop-yarn-server-common\src\main\java\org\apache\hadoop\yarn\server\federation\policies\amrmproxy\RejectAMRMProxyPolicy.java,22,5,0,5,0,10
hadoop-trunk\hadoop-trunk\hadoop-yarn-project\hadoop-yarn\hadoop-yarn-server\hadoop-yarn-server-resourcemanager\src\test\java\org\apache\hadoop\yarn\server\resourcemanager\webapp\TestRMWebServicesSchedulerActivitiesWithMultiNodesEnabled.java,0,97,36,26,0,159
hadoop-trunk\hadoop-trunk\hadoop-common-project\hadoop-common\src\test\java\org\apache\hadoop\util\TestGenericsUtil.java,120,26,6,1,0,33
hadoop-trunk\hadoop-trunk\hadoop-yarn-project\hadoop-yarn\hadoop-yarn-server\hadoop-yarn-server-resourcemanager\src\test\java\org\apache\hadoop\yarn\server\resourcemanager\scheduler\constraint\TestAllocationTagsNamespace.java,172,15,5,1,0,21
hadoop-trunk\hadoop-trunk\hadoop-yarn-project\hadoop-yarn\hadoop-yarn-client\src\main\java\org\apache\hadoop\yarn\client\cli\ClusterCLI.java,119,25,2,3,0,30
hadoop-trunk\hadoop-trunk\hadoop-yarn-project\hadoop-yarn\hadoop-yarn-server\hadoop-yarn-server-resourcemanager\src\main\java\org\apache\hadoop\yarn\server\resourcemanager\scheduler\capacity\conf\YarnConfStoreVersionIncompatibleException.java,17,7,0,1,0,8
hadoop-trunk\hadoop-trunk\hadoop-common-project\hadoop-common\src\test\java\org\apache\hadoop\fs\viewfs\TestFSMainOperationsLocalFileSystem.java,35,7,0,2,0,9
hadoop-trunk\hadoop-trunk\hadoop-yarn-project\hadoop-yarn\hadoop-yarn-server\hadoop-yarn-server-common\src\main\java\org\apache\hadoop\yarn\server\federation\policies\manager\AbstractPolicyManager.java,155,26,5,8,0,39
hadoop-trunk\hadoop-trunk\hadoop-hdfs-project\hadoop-hdfs\src\test\java\org\apache\hadoop\hdfs\server\diskbalancer\TestDiskBalancerWithMockMover.java,0,94,11,3,0,108
hadoop-trunk\hadoop-trunk\hadoop-hdfs-project\hadoop-hdfs\src\test\java\org\apache\hadoop\hdfs\crypto\TestHdfsCryptoStreams.java,54,18,1,1,0,20
hadoop-trunk\hadoop-trunk\hadoop-common-project\hadoop-common\src\main\java\org\apache\hadoop\util\LightWeightCache.java,0,57,5,1,0,63
hadoop-trunk\hadoop-trunk\hadoop-common-project\hadoop-common\src\main\java\org\apache\hadoop\net\SocketInputWrapper.java,50,12,0,1,0,13
hadoop-trunk\hadoop-trunk\hadoop-yarn-project\hadoop-yarn\hadoop-yarn-server\hadoop-yarn-server-nodemanager\src\main\java\org\apache\hadoop\yarn\server\nodemanager\containermanager\linux\runtime\docker\package-info.java,0,1,0,2,0,3
hadoop-trunk\hadoop-trunk\hadoop-yarn-project\hadoop-yarn\hadoop-yarn-server\hadoop-yarn-server-resourcemanager\src\test\java\org\apache\hadoop\yarn\server\resourcemanager\recovery\TestZKRMStateStorePerf.java,0,39,8,5,0,52
hadoop-trunk\hadoop-trunk\hadoop-hdfs-project\hadoop-hdfs\src\main\java\org\apache\hadoop\hdfs\server\balancer\Dispatcher.java,1380,380,40,13,0,433
hadoop-trunk\hadoop-trunk\hadoop-hdfs-project\hadoop-hdfs\src\test\java\org\apache\hadoop\hdfs\server\namenode\TestNameNodeRespectsBindHostKeys.java,269,40,20,5,0,65
hadoop-trunk\hadoop-trunk\hadoop-common-project\hadoop-common\src\test\java\org\apache\hadoop\util\TestWinUtils.java,595,79,6,8,0,93
hadoop-trunk\hadoop-trunk\hadoop-hdfs-project\hadoop-hdfs\src\main\java\org\apache\hadoop\hdfs\server\datanode\DNConf.java,441,149,9,48,0,206
hadoop-trunk\hadoop-trunk\hadoop-yarn-project\hadoop-yarn\hadoop-yarn-server\hadoop-yarn-server-common\src\main\java\org\apache\hadoop\yarn\server\federation\policies\amrmproxy\FederationAMRMProxyPolicy.java,0,0,0,2,0,2
hadoop-trunk\hadoop-trunk\hadoop-yarn-project\hadoop-yarn\hadoop-yarn-common\src\main\java\org\apache\hadoop\yarn\client\api\TimelineV2Client.java,96,2,1,1,0,4
hadoop-trunk\hadoop-trunk\hadoop-yarn-project\hadoop-yarn\hadoop-yarn-server\hadoop-yarn-server-resourcemanager\src\test\java\org\apache\hadoop\yarn\server\resourcemanager\scheduler\fair\PrimaryGroupMapping.java,23,7,0,1,0,8
hadoop-trunk\hadoop-trunk\hadoop-tools\hadoop-azure\src\test\java\org\apache\hadoop\fs\azurebfs\TestAbfsErrorTranslation.java,52,8,0,5,0,13
hadoop-trunk\hadoop-trunk\hadoop-mapreduce-project\hadoop-mapreduce-client\hadoop-mapreduce-client-core\src\main\java\org\apache\hadoop\mapreduce\MapContext.java,0,12,5,1,0,18
hadoop-trunk\hadoop-trunk\hadoop-mapreduce-project\hadoop-mapreduce-client\hadoop-mapreduce-client-core\src\main\java\org\apache\hadoop\mapreduce\StatusReporter.java,13,5,0,1,0,6
hadoop-trunk\hadoop-trunk\hadoop-tools\hadoop-azure\src\main\java\org\apache\hadoop\fs\azurebfs\oauth2\AzureADAuthenticator.java,0,75,20,21,0,116
hadoop-trunk\hadoop-trunk\hadoop-yarn-project\hadoop-yarn\hadoop-yarn-api\src\main\java\org\apache\hadoop\yarn\server\api\protocolrecords\RefreshServiceAclsResponse.java,10,1,1,1,0,3
hadoop-trunk\hadoop-trunk\hadoop-yarn-project\hadoop-yarn\hadoop-yarn-server\hadoop-yarn-server-nodemanager\src\main\java\org\apache\hadoop\yarn\server\nodemanager\containermanager\ContainerManagerImpl.java,1847,250,59,62,0,371
hadoop-trunk\hadoop-trunk\hadoop-common-project\hadoop-common\src\main\java\org\apache\hadoop\service\launcher\LauncherExitCodes.java,0,5,21,3,0,29
hadoop-trunk\hadoop-trunk\hadoop-tools\hadoop-gridmix\src\main\java\org\apache\hadoop\mapred\gridmix\IntermediateRecordFactory.java,0,27,1,1,0,29
hadoop-trunk\hadoop-trunk\hadoop-yarn-project\hadoop-yarn\hadoop-yarn-api\src\main\java\org\apache\hadoop\yarn\api\records\ContainerLaunchContext.java,192,33,0,5,0,38
hadoop-trunk\hadoop-trunk\hadoop-yarn-project\hadoop-yarn\hadoop-yarn-server\hadoop-yarn-server-common\src\main\java\org\apache\hadoop\yarn\server\federation\store\records\SubClusterHeartbeatResponse.java,12,1,1,1,0,3
hadoop-trunk\hadoop-trunk\hadoop-tools\hadoop-streaming\src\test\java\org\apache\hadoop\typedbytes\TestTypedBytesWritable.java,35,9,1,1,0,11
hadoop-trunk\hadoop-trunk\hadoop-yarn-project\hadoop-yarn\hadoop-yarn-server\hadoop-yarn-server-applicationhistoryservice\src\main\java\org\apache\hadoop\yarn\server\applicationhistoryservice\records\ContainerHistoryData.java,159,78,0,1,0,79
hadoop-trunk\hadoop-trunk\hadoop-mapreduce-project\hadoop-mapreduce-client\hadoop-mapreduce-client-core\src\main\java\org\apache\hadoop\mapred\FixedLengthRecordReader.java,0,19,2,1,0,22
hadoop-trunk\hadoop-trunk\hadoop-yarn-project\hadoop-yarn\hadoop-yarn-server\hadoop-yarn-server-nodemanager\src\test\java\org\apache\hadoop\yarn\server\nodemanager\webapp\TestNMAppsPage.java,43,12,0,5,0,17
hadoop-trunk\hadoop-trunk\hadoop-yarn-project\hadoop-yarn\hadoop-yarn-server\hadoop-yarn-server-timelineservice-documentstore\src\test\java\org\apache\hadoop\yarn\server\timelineservice\documentstore\TestDocumentStoreTimelineReaderImpl.java,349,24,6,15,0,45
hadoop-trunk\hadoop-trunk\hadoop-yarn-project\hadoop-yarn\hadoop-yarn-server\hadoop-yarn-server-nodemanager\src\main\java\org\apache\hadoop\yarn\server\nodemanager\collectormanager\NMCollectorService.java,109,15,3,8,0,26
hadoop-trunk\hadoop-trunk\hadoop-yarn-project\hadoop-yarn\hadoop-yarn-server\hadoop-yarn-server-sharedcachemanager\src\main\java\org\apache\hadoop\yarn\server\sharedcachemanager\metrics\CleanerMetrics.java,111,26,3,2,0,31
hadoop-trunk\hadoop-trunk\hadoop-tools\hadoop-dynamometer\hadoop-dynamometer-workload\src\test\java\org\apache\hadoop\tools\dynamometer\workloadgenerator\TestWorkloadGenerator.java,111,17,2,6,0,25
hadoop-trunk\hadoop-trunk\hadoop-yarn-project\hadoop-yarn\hadoop-yarn-server\hadoop-yarn-server-common\src\main\java\org\apache\hadoop\yarn\server\federation\store\records\impl\pb\SubClusterDeregisterResponsePBImpl.java,0,13,17,3,0,33
hadoop-trunk\hadoop-trunk\hadoop-yarn-project\hadoop-yarn\hadoop-yarn-server\hadoop-yarn-server-nodemanager\src\test\java\org\apache\hadoop\yarn\server\nodemanager\containermanager\linux\resources\TestCGroupsMemoryResourceHandlerImpl.java,207,22,3,4,0,29
hadoop-trunk\hadoop-trunk\hadoop-yarn-project\hadoop-yarn\hadoop-yarn-server\hadoop-yarn-server-nodemanager\src\main\java\org\apache\hadoop\yarn\server\nodemanager\containermanager\localizer\event\ResourceRecoveredEvent.java,21,12,0,3,0,15
hadoop-trunk\hadoop-trunk\hadoop-hdfs-project\hadoop-hdfs\src\test\java\org\apache\hadoop\hdfs\server\datanode\fsdataset\impl\TestReservedSpaceCalculator.java,150,80,0,7,0,87
hadoop-trunk\hadoop-trunk\hadoop-hdfs-project\hadoop-hdfs\src\test\java\org\apache\hadoop\hdfs\server\blockmanagement\TestPendingInvalidateBlock.java,181,21,15,2,0,38
hadoop-trunk\hadoop-trunk\hadoop-yarn-project\hadoop-yarn\hadoop-yarn-common\src\main\java\org\apache\hadoop\yarn\client\api\impl\TimelineClientImpl.java,403,71,18,10,0,99
hadoop-trunk\hadoop-trunk\hadoop-hdfs-project\hadoop-hdfs\src\test\java\org\apache\hadoop\hdfs\TestFileAppend3.java,540,163,15,23,0,201
hadoop-trunk\hadoop-trunk\hadoop-yarn-project\hadoop-yarn\hadoop-yarn-api\src\main\java\org\apache\hadoop\yarn\api\records\timeline\TimelineDomain.java,149,51,2,1,0,54
hadoop-trunk\hadoop-trunk\hadoop-yarn-project\hadoop-yarn\hadoop-yarn-client\src\main\java\org\apache\hadoop\yarn\client\api\async\impl\NMClientAsyncImpl.java,933,196,68,8,0,272
hadoop-trunk\hadoop-trunk\hadoop-tools\hadoop-openstack\src\main\java\org\apache\hadoop\fs\swift\exceptions\SwiftBadRequestException.java,22,12,0,2,0,14
hadoop-trunk\hadoop-trunk\hadoop-common-project\hadoop-registry\src\main\java\org\apache\hadoop\registry\client\binding\RegistryTypeUtils.java,247,50,5,4,0,59
hadoop-trunk\hadoop-trunk\hadoop-mapreduce-project\hadoop-mapreduce-client\hadoop-mapreduce-client-core\src\main\java\org\apache\hadoop\mapred\TaskID.java,0,90,8,1,0,99
hadoop-trunk\hadoop-trunk\hadoop-hdfs-project\hadoop-hdfs\src\test\java\org\apache\hadoop\hdfs\server\namenode\ha\TestBootstrapAliasmap.java,58,9,2,1,0,12
hadoop-trunk\hadoop-trunk\hadoop-hdfs-project\hadoop-hdfs\src\main\java\org\apache\hadoop\hdfs\server\blockmanagement\AvailableSpaceBlockPlacementPolicy.java,167,60,7,21,0,88
hadoop-trunk\hadoop-trunk\hadoop-tools\hadoop-azure\src\test\java\org\apache\hadoop\fs\azure\ITestFileSystemOperationExceptionMessage.java,0,2,0,3,0,5
hadoop-trunk\hadoop-trunk\hadoop-yarn-project\hadoop-yarn\hadoop-yarn-server\hadoop-yarn-server-common\src\main\java\org\apache\hadoop\yarn\server\federation\store\records\ApplicationHomeSubCluster.java,85,8,0,1,0,9
hadoop-trunk\hadoop-trunk\hadoop-yarn-project\hadoop-yarn\hadoop-yarn-api\src\main\java\org\apache\hadoop\yarn\api\records\ContainerSubState.java,0,5,0,1,0,6
hadoop-trunk\hadoop-trunk\hadoop-common-project\hadoop-auth-examples\src\main\java\org\apache\hadoop\security\authentication\examples\WhoServlet.java,18,10,1,5,0,16
hadoop-trunk\hadoop-trunk\hadoop-mapreduce-project\hadoop-mapreduce-client\hadoop-mapreduce-client-jobclient\src\test\java\org\apache\hadoop\fs\slive\DeleteOp.java,0,9,3,1,0,13
hadoop-trunk\hadoop-trunk\hadoop-tools\hadoop-aws\src\test\java\org\apache\hadoop\fs\s3a\commit\magic\ITestS3AHugeMagicCommits.java,134,13,2,1,0,16
hadoop-trunk\hadoop-trunk\hadoop-tools\hadoop-azure\src\main\java\org\apache\hadoop\fs\azure\security\WasbDelegationTokenIdentifier.java,23,11,0,2,0,13
hadoop-trunk\hadoop-trunk\hadoop-yarn-project\hadoop-yarn\hadoop-yarn-server\hadoop-yarn-server-resourcemanager\src\main\java\org\apache\hadoop\yarn\server\resourcemanager\reservation\planning\ReservationAgent.java,0,14,5,3,0,22
hadoop-trunk\hadoop-trunk\hadoop-hdfs-project\hadoop-hdfs-rbf\src\main\java\org\apache\hadoop\hdfs\server\federation\store\StateStoreUtils.java,0,3,2,1,0,6
hadoop-trunk\hadoop-trunk\hadoop-mapreduce-project\hadoop-mapreduce-client\hadoop-mapreduce-client-jobclient\src\test\java\org\apache\hadoop\mapred\lib\TestChainMapReduce.java,258,66,3,1,0,70
hadoop-trunk\hadoop-trunk\hadoop-mapreduce-project\hadoop-mapreduce-client\hadoop-mapreduce-client-core\src\main\java\org\apache\hadoop\mapred\lib\RegexMapper.java,0,13,0,1,0,14
hadoop-trunk\hadoop-trunk\hadoop-yarn-project\hadoop-yarn\hadoop-yarn-server\hadoop-yarn-server-nodemanager\src\test\java\org\apache\hadoop\yarn\server\nodemanager\containermanager\scheduler\TestContainerSchedulerQueuing.java,1104,103,21,6,0,130
hadoop-trunk\hadoop-trunk\hadoop-common-project\hadoop-common\src\main\java\org\apache\hadoop\io\DataOutputOutputStream.java,41,14,1,1,0,16
hadoop-trunk\hadoop-trunk\hadoop-tools\hadoop-aws\src\main\java\org\apache\hadoop\fs\s3a\auth\RolePolicies.java,0,25,7,1,0,33
hadoop-trunk\hadoop-trunk\hadoop-common-project\hadoop-common\src\test\java\org\apache\hadoop\fs\contract\AbstractContractRenameTest.java,322,55,2,7,0,64
hadoop-trunk\hadoop-trunk\hadoop-yarn-project\hadoop-yarn\hadoop-yarn-client\src\test\java\org\apache\hadoop\yarn\client\cli\TestYarnCLI.java,2330,557,70,207,0,834
hadoop-trunk\hadoop-trunk\hadoop-yarn-project\hadoop-yarn\hadoop-yarn-server\hadoop-yarn-server-common\src\main\java\org\apache\hadoop\yarn\server\federation\store\records\impl\pb\AddApplicationHomeSubClusterRequestPBImpl.java,0,18,35,6,0,59
hadoop-trunk\hadoop-trunk\hadoop-yarn-project\hadoop-yarn\hadoop-yarn-api\src\test\java\org\apache\hadoop\yarn\api\records\TestURL.java,0,15,1,1,0,17
hadoop-trunk\hadoop-trunk\hadoop-hdfs-project\hadoop-hdfs\src\test\java\org\apache\hadoop\hdfs\TestParallelShortCircuitLegacyRead.java,23,6,0,3,0,9
hadoop-trunk\hadoop-trunk\hadoop-tools\hadoop-openstack\src\test\java\org\apache\hadoop\fs\swift\TestFSMainOperationsSwift.java,340,12,0,10,0,22
hadoop-trunk\hadoop-trunk\hadoop-common-project\hadoop-common\src\test\java\org\apache\hadoop\service\launcher\TestServiceLauncherCreationFailures.java,54,9,0,2,0,11
hadoop-trunk\hadoop-trunk\hadoop-hdfs-project\hadoop-hdfs\src\test\java\org\apache\hadoop\cli\util\CryptoAdminCmdExecutor.java,16,10,0,1,0,11
hadoop-trunk\hadoop-trunk\hadoop-cloud-storage-project\hadoop-huaweicloud\src\main\java\org\apache\hadoop\fs\obs\OBSInputStream.java,0,0,4,1,0,5
hadoop-trunk\hadoop-trunk\hadoop-common-project\hadoop-nfs\src\main\java\org\apache\hadoop\nfs\nfs3\response\MKDIR3Response.java,59,28,0,1,0,29
hadoop-trunk\hadoop-trunk\hadoop-hdfs-project\hadoop-hdfs\src\main\java\org\apache\hadoop\hdfs\server\namenode\CachedBlock.java,0,73,3,6,0,82
hadoop-trunk\hadoop-trunk\hadoop-hdfs-project\hadoop-hdfs-httpfs\src\main\java\org\apache\hadoop\lib\wsrs\JSONProvider.java,27,25,0,6,0,31
hadoop-trunk\hadoop-trunk\hadoop-tools\hadoop-aws\src\test\java\org\apache\hadoop\fs\s3a\TestSSEConfiguration.java,267,42,13,1,0,56
hadoop-trunk\hadoop-trunk\hadoop-yarn-project\hadoop-yarn\hadoop-yarn-server\hadoop-yarn-server-nodemanager\src\test\java\org\apache\hadoop\yarn\server\nodemanager\containermanager\linux\resources\TestCGroupsBlkioResourceHandlerImpl.java,78,8,0,4,0,12
hadoop-trunk\hadoop-trunk\hadoop-common-project\hadoop-common\src\main\java\org\apache\hadoop\security\ssl\ReloadingX509KeystoreManager.java,112,54,1,6,0,61
hadoop-trunk\hadoop-trunk\hadoop-hdfs-project\hadoop-hdfs\src\test\java\org\apache\hadoop\fs\viewfs\TestViewFsWithXAttrs.java,110,27,6,3,0,36
hadoop-trunk\hadoop-trunk\hadoop-tools\hadoop-aws\src\main\java\org\apache\hadoop\fs\s3a\audit\impl\S3AInternalAuditConstants.java,0,0,0,1,0,1
hadoop-trunk\hadoop-trunk\hadoop-mapreduce-project\hadoop-mapreduce-client\hadoop-mapreduce-client-jobclient\src\test\java\org\apache\hadoop\mapred\TestConcatenatedCompressedInput.java,672,215,21,15,0,251
hadoop-trunk\hadoop-trunk\hadoop-tools\hadoop-openstack\src\main\java\org\apache\hadoop\fs\swift\http\RestClientBindings.java,0,38,3,4,0,45
hadoop-trunk\hadoop-trunk\hadoop-yarn-project\hadoop-yarn\hadoop-yarn-server\hadoop-yarn-server-resourcemanager\src\main\java\org\apache\hadoop\yarn\server\resourcemanager\webapp\dao\NodeInfo.java,249,127,3,3,0,133
hadoop-trunk\hadoop-trunk\hadoop-yarn-project\hadoop-yarn\hadoop-yarn-server\hadoop-yarn-server-common\src\main\java\org\apache\hadoop\yarn\server\federation\policies\router\RejectRouterPolicy.java,43,4,0,5,0,9
hadoop-trunk\hadoop-trunk\hadoop-tools\hadoop-dynamometer\hadoop-dynamometer-workload\src\main\java\org\apache\hadoop\tools\dynamometer\workloadgenerator\audit\CountTimeWritable.java,53,30,0,1,0,31
hadoop-trunk\hadoop-trunk\hadoop-yarn-project\hadoop-yarn\hadoop-yarn-server\hadoop-yarn-server-timelineservice\src\main\java\org\apache\hadoop\yarn\server\timelineservice\security\TimelineV2DelegationTokenSecretManagerService.java,90,30,1,3,0,34
hadoop-trunk\hadoop-trunk\hadoop-mapreduce-project\hadoop-mapreduce-client\hadoop-mapreduce-client-core\src\main\java\org\apache\hadoop\mapreduce\lib\output\committer\manifest\files\AbstractManifestData.java,0,8,4,1,0,13
hadoop-trunk\hadoop-trunk\hadoop-tools\hadoop-azure-datalake\src\test\java\org\apache\hadoop\fs\adl\TestRelativePathFormation.java,29,1,1,1,0,3
hadoop-trunk\hadoop-trunk\hadoop-yarn-project\hadoop-yarn\hadoop-yarn-server\hadoop-yarn-server-nodemanager\src\main\java\org\apache\hadoop\yarn\server\nodemanager\executor\LocalizerStartContext.java,0,40,2,1,0,43
hadoop-trunk\hadoop-trunk\hadoop-common-project\hadoop-common\src\main\java\org\apache\hadoop\util\BlockingThreadPoolExecutorService.java,0,18,2,2,0,22
hadoop-trunk\hadoop-trunk\hadoop-hdfs-project\hadoop-hdfs\src\main\java\org\apache\hadoop\hdfs\server\namenode\FSEditLog.java,0,547,34,19,0,600
hadoop-trunk\hadoop-trunk\hadoop-tools\hadoop-fs2img\src\test\java\org\apache\hadoop\hdfs\server\namenode\ITestProvidedImplementation.java,0,218,24,11,0,253
hadoop-trunk\hadoop-trunk\hadoop-tools\hadoop-azure\src\main\java\org\apache\hadoop\fs\azurebfs\services\AuthType.java,0,4,0,1,0,5
hadoop-trunk\hadoop-trunk\hadoop-tools\hadoop-aws\src\main\java\org\apache\hadoop\fs\s3a\commit\files\package-info.java,0,0,0,1,0,1
hadoop-trunk\hadoop-trunk\hadoop-yarn-project\hadoop-yarn\hadoop-yarn-server\hadoop-yarn-server-resourcemanager\src\main\java\org\apache\hadoop\yarn\server\resourcemanager\reservation\InMemoryPlan.java,863,182,16,9,0,207
hadoop-trunk\hadoop-trunk\hadoop-yarn-project\hadoop-yarn\hadoop-yarn-common\src\main\java\org\apache\hadoop\yarn\api\protocolrecords\impl\pb\GetApplicationsResponsePBImpl.java,0,31,46,5,0,82
hadoop-trunk\hadoop-trunk\hadoop-common-project\hadoop-common\src\test\java\org\apache\hadoop\fs\TestDelegationTokenRenewer.java,185,57,6,2,0,65
hadoop-trunk\hadoop-trunk\hadoop-tools\hadoop-distcp\src\test\java\org\apache\hadoop\tools\TestDistCpOptions.java,539,49,4,1,0,54
hadoop-trunk\hadoop-trunk\hadoop-tools\hadoop-aws\src\main\java\org\apache\hadoop\fs\s3a\WriteOperationHelper.java,645,64,14,2,0,80
hadoop-trunk\hadoop-trunk\hadoop-common-project\hadoop-common\src\main\java\org\apache\hadoop\security\authorize\AuthorizationException.java,50,14,0,1,0,15
hadoop-trunk\hadoop-trunk\hadoop-hdfs-project\hadoop-hdfs\src\test\java\org\apache\hadoop\hdfs\TestRollingUpgradeDowngrade.java,82,2,2,1,0,5
hadoop-trunk\hadoop-trunk\hadoop-common-project\hadoop-common\src\main\java\org\apache\hadoop\ha\protocolPB\ZKFCProtocolClientSideTranslatorPB.java,0,14,6,2,0,22
hadoop-trunk\hadoop-trunk\hadoop-yarn-project\hadoop-yarn\hadoop-yarn-server\hadoop-yarn-server-resourcemanager\src\main\java\org\apache\hadoop\yarn\server\resourcemanager\rmapp\attempt\event\RMAppAttemptRegistrationEvent.java,27,15,0,3,0,18
hadoop-trunk\hadoop-trunk\hadoop-yarn-project\hadoop-yarn\hadoop-yarn-common\src\main\java\org\apache\hadoop\yarn\api\ContainerManagementProtocolPB.java,0,2,6,5,0,13
hadoop-trunk\hadoop-trunk\hadoop-yarn-project\hadoop-yarn\hadoop-yarn-server\hadoop-yarn-server-common\src\main\java\org\apache\hadoop\yarn\server\api\CollectorNodemanagerProtocolPB.java,0,0,2,2,0,4
hadoop-trunk\hadoop-trunk\hadoop-hdfs-project\hadoop-hdfs\src\main\java\org\apache\hadoop\hdfs\server\namenode\FSDirMkdirOp.java,0,46,1,1,0,48
hadoop-trunk\hadoop-trunk\hadoop-common-project\hadoop-common\src\test\java\org\apache\hadoop\util\TestBasicDiskValidator.java,24,4,0,1,0,5
hadoop-trunk\hadoop-trunk\hadoop-tools\hadoop-aws\src\test\java\org\apache\hadoop\fs\s3a\AbstractS3ATestBase.java,0,17,6,3,0,26
hadoop-trunk\hadoop-trunk\hadoop-mapreduce-project\hadoop-mapreduce-client\hadoop-mapreduce-client-core\src\main\java\org\apache\hadoop\mapreduce\task\reduce\Fetcher.java,0,267,35,7,0,309
hadoop-trunk\hadoop-trunk\hadoop-cloud-storage-project\hadoop-cos\src\main\java\org\apache\hadoop\fs\cosn\CosNCopyFileContext.java,39,21,0,1,0,22
hadoop-trunk\hadoop-trunk\hadoop-yarn-project\hadoop-yarn\hadoop-yarn-common\src\test\java\org\apache\hadoop\yarn\TestContainerResourceIncreaseRPC.java,167,39,3,5,0,47
hadoop-trunk\hadoop-trunk\hadoop-yarn-project\hadoop-yarn\hadoop-yarn-server\hadoop-yarn-server-nodemanager\src\test\java\org\apache\hadoop\yarn\server\nodemanager\health\TestNodeHealthCheckerService.java,206,16,0,1,0,17
hadoop-trunk\hadoop-trunk\hadoop-hdfs-project\hadoop-hdfs\src\test\java\org\apache\hadoop\fs\contract\hdfs\TestHDFSContractGetFileStatus.java,18,4,0,1,0,5
hadoop-trunk\hadoop-trunk\hadoop-tools\hadoop-azure\src\main\java\org\apache\hadoop\fs\azurebfs\oauth2\LocalIdentityTransformer.java,34,17,2,13,0,32
hadoop-trunk\hadoop-trunk\hadoop-common-project\hadoop-common\src\test\java\org\apache\hadoop\ha\TestActiveStandbyElector.java,765,85,5,2,0,92
hadoop-trunk\hadoop-trunk\hadoop-tools\hadoop-azure-datalake\src\test\java\org\apache\hadoop\fs\adl\live\TestAdlContractOpenLive.java,8,3,0,1,0,4
hadoop-trunk\hadoop-trunk\hadoop-tools\hadoop-aws\src\main\java\org\apache\hadoop\fs\s3a\impl\MultiObjectDeleteSupport.java,0,3,3,2,0,8
hadoop-trunk\hadoop-trunk\hadoop-hdfs-project\hadoop-hdfs-client\src\main\java\org\apache\hadoop\hdfs\protocol\HdfsPathHandle.java,0,17,5,1,0,23
hadoop-trunk\hadoop-trunk\hadoop-yarn-project\hadoop-yarn\hadoop-yarn-server\hadoop-yarn-server-resourcemanager\src\main\java\org\apache\hadoop\yarn\server\resourcemanager\rmapp\RMAppMetrics.java,67,42,0,1,0,43
hadoop-trunk\hadoop-trunk\hadoop-yarn-project\hadoop-yarn\hadoop-yarn-applications\hadoop-yarn-services\hadoop-yarn-services-core\src\main\java\org\apache\hadoop\yarn\service\component\AlwaysRestartPolicy.java,0,13,1,1,0,15
hadoop-trunk\hadoop-trunk\hadoop-hdfs-project\hadoop-hdfs\src\main\java\org\apache\hadoop\hdfs\protocol\datatransfer\WhitelistBasedTrustedChannelResolver.java,93,45,2,19,0,66
hadoop-trunk\hadoop-trunk\hadoop-common-project\hadoop-common\src\test\java\org\apache\hadoop\fs\contract\AbstractContractContentSummaryTest.java,34,6,0,4,0,10
hadoop-trunk\hadoop-trunk\hadoop-yarn-project\hadoop-yarn\hadoop-yarn-common\src\main\java\org\apache\hadoop\yarn\nodelabels\store\StoreOp.java,0,1,0,1,0,2
hadoop-trunk\hadoop-trunk\hadoop-common-project\hadoop-common\src\main\java\org\apache\hadoop\fs\XAttrSetFlag.java,0,10,1,1,0,12
hadoop-trunk\hadoop-trunk\hadoop-yarn-project\hadoop-yarn\hadoop-yarn-common\src\main\java\org\apache\hadoop\yarn\api\protocolrecords\impl\pb\IncreaseContainersResourceResponsePBImpl.java,198,31,60,5,0,96
hadoop-trunk\hadoop-trunk\hadoop-common-project\hadoop-common\src\main\java\org\apache\hadoop\fs\http\package-info.java,0,1,0,1,0,2
hadoop-trunk\hadoop-trunk\hadoop-yarn-project\hadoop-yarn\hadoop-yarn-server\hadoop-yarn-server-common\src\main\java\org\apache\hadoop\yarn\server\metrics\OpportunisticSchedulerMetrics.java,121,54,1,1,0,56
hadoop-trunk\hadoop-trunk\hadoop-yarn-project\hadoop-yarn\hadoop-yarn-server\hadoop-yarn-server-resourcemanager\src\main\java\org\apache\hadoop\yarn\server\resourcemanager\scheduler\capacity\ConfigurationProperties.java,185,21,0,1,0,22
hadoop-trunk\hadoop-trunk\hadoop-yarn-project\hadoop-yarn\hadoop-yarn-server\hadoop-yarn-server-timelineservice-hbase\hadoop-yarn-server-timelineservice-hbase-client\src\main\java\org\apache\hadoop\yarn\server\timelineservice\storage\application\ApplicationTableRW.java,102,8,1,2,0,11
hadoop-trunk\hadoop-trunk\hadoop-mapreduce-project\hadoop-mapreduce-client\hadoop-mapreduce-client-core\src\main\java\org\apache\hadoop\mapreduce\lib\aggregate\LongValueMin.java,72,24,2,1,0,27
hadoop-trunk\hadoop-trunk\hadoop-yarn-project\hadoop-yarn\hadoop-yarn-server\hadoop-yarn-server-common\src\main\java\org\apache\hadoop\yarn\server\api\protocolrecords\impl\pb\SCMUploaderNotifyRequestPBImpl.java,70,19,33,4,0,56
hadoop-trunk\hadoop-trunk\hadoop-yarn-project\hadoop-yarn\hadoop-yarn-server\hadoop-yarn-server-router\src\main\java\org\apache\hadoop\yarn\server\router\package-info.java,0,0,0,1,0,1
hadoop-trunk\hadoop-trunk\hadoop-common-project\hadoop-common\src\test\java\org\apache\hadoop\io\TestArrayWritable.java,76,19,1,3,0,23
hadoop-trunk\hadoop-trunk\hadoop-common-project\hadoop-common\src\main\java\org\apache\hadoop\util\concurrent\package-info.java,0,1,0,1,0,2
hadoop-trunk\hadoop-trunk\hadoop-hdfs-project\hadoop-hdfs\src\test\java\org\apache\hadoop\hdfs\TestFileCreationEmpty.java,55,18,1,5,0,24
hadoop-trunk\hadoop-trunk\hadoop-hdfs-project\hadoop-hdfs\src\test\java\org\apache\hadoop\hdfs\TestFSInputChecker.java,337,199,6,3,0,208
hadoop-trunk\hadoop-trunk\hadoop-yarn-project\hadoop-yarn\hadoop-yarn-server\hadoop-yarn-server-resourcemanager\src\test\java\org\apache\hadoop\yarn\server\resourcemanager\applicationsmanager\TestApplicationMasterExpiry.java,127,6,0,9,0,15
hadoop-trunk\hadoop-trunk\hadoop-yarn-project\hadoop-yarn\hadoop-yarn-server\hadoop-yarn-server-resourcemanager\src\test\java\org\apache\hadoop\yarn\server\resourcemanager\reservation\TestInMemoryReservationAllocation.java,177,60,5,2,0,67
hadoop-trunk\hadoop-trunk\hadoop-cloud-storage-project\hadoop-cos\src\main\java\org\apache\hadoop\fs\cosn\PartialListing.java,0,9,0,1,0,10
hadoop-trunk\hadoop-trunk\hadoop-mapreduce-project\hadoop-mapreduce-client\hadoop-mapreduce-client-jobclient\src\test\java\org\apache\hadoop\mapred\TestYARNRunner.java,903,204,28,40,0,272
hadoop-trunk\hadoop-trunk\hadoop-mapreduce-project\hadoop-mapreduce-client\hadoop-mapreduce-client-jobclient\src\test\java\org\apache\hadoop\mapred\TestGetSplitHosts.java,84,86,7,1,0,94
hadoop-trunk\hadoop-trunk\hadoop-yarn-project\hadoop-yarn\hadoop-yarn-api\src\main\java\org\apache\hadoop\yarn\exceptions\YARNFeatureNotEnabledException.java,17,7,0,1,0,8
hadoop-trunk\hadoop-trunk\hadoop-yarn-project\hadoop-yarn\hadoop-yarn-server\hadoop-yarn-server-resourcemanager\src\main\java\org\apache\hadoop\yarn\server\resourcemanager\scheduler\event\AutoCreatedQueueDeletionEvent.java,12,7,0,1,0,8
hadoop-trunk\hadoop-trunk\hadoop-common-project\hadoop-common\src\main\java\org\apache\hadoop\io\file\tfile\BCFile.java,0,190,8,2,0,200
hadoop-trunk\hadoop-trunk\hadoop-hdfs-project\hadoop-hdfs\src\test\java\org\apache\hadoop\hdfs\TestDataStream.java,53,20,0,1,0,21
hadoop-trunk\hadoop-trunk\hadoop-yarn-project\hadoop-yarn\hadoop-yarn-server\hadoop-yarn-server-resourcemanager\src\main\java\org\apache\hadoop\yarn\server\resourcemanager\scheduler\common\ResourceCommitRequest.java,136,37,2,3,0,42
hadoop-trunk\hadoop-trunk\hadoop-yarn-project\hadoop-yarn\hadoop-yarn-server\hadoop-yarn-server-nodemanager\src\main\java\org\apache\hadoop\yarn\server\nodemanager\api\protocolrecords\LocalizerHeartbeatResponse.java,0,10,5,1,0,16
hadoop-trunk\hadoop-trunk\hadoop-yarn-project\hadoop-yarn\hadoop-yarn-server\hadoop-yarn-server-nodemanager\src\main\java\org\apache\hadoop\yarn\server\nodemanager\containermanager\resourceplugin\fpga\discovery\DeviceSpecParser.java,0,6,1,4,0,11
hadoop-trunk\hadoop-trunk\hadoop-common-project\hadoop-common\src\main\java\org\apache\hadoop\fs\store\audit\AuditSpanSource.java,0,1,0,1,0,2
hadoop-trunk\hadoop-trunk\hadoop-tools\hadoop-azure\src\main\java\org\apache\hadoop\fs\azure\WasbAuthorizationException.java,17,8,0,1,0,9
hadoop-trunk\hadoop-trunk\hadoop-hdfs-project\hadoop-hdfs-client\src\main\java\org\apache\hadoop\hdfs\web\oauth2\package-info.java,0,0,0,1,0,1
hadoop-trunk\hadoop-trunk\hadoop-hdfs-project\hadoop-hdfs-client\src\main\java\org\apache\hadoop\hdfs\protocol\DatanodeVolumeInfo.java,93,30,0,1,0,31
hadoop-trunk\hadoop-trunk\hadoop-hdfs-project\hadoop-hdfs-rbf\src\test\java\org\apache\hadoop\fs\contract\router\web\TestRouterWebHDFSContractRootDirectory.java,48,4,0,1,0,5
hadoop-trunk\hadoop-trunk\hadoop-tools\hadoop-extras\src\test\java\org\apache\hadoop\tools\TestDistCh.java,181,102,5,10,0,117
hadoop-trunk\hadoop-trunk\hadoop-yarn-project\hadoop-yarn\hadoop-yarn-server\hadoop-yarn-server-nodemanager\src\main\java\org\apache\hadoop\yarn\server\nodemanager\containermanager\linux\resources\ResourceHandlerModule.java,344,48,20,8,0,76
hadoop-trunk\hadoop-trunk\hadoop-yarn-project\hadoop-yarn\hadoop-yarn-common\src\main\java\org\apache\hadoop\yarn\api\protocolrecords\impl\pb\ReleaseSharedCacheResourceRequestPBImpl.java,95,23,38,4,0,65
hadoop-trunk\hadoop-trunk\hadoop-common-project\hadoop-common\src\test\java\org\apache\hadoop\fs\TestQuotaUsage.java,124,31,4,1,0,36
hadoop-trunk\hadoop-trunk\hadoop-hdfs-project\hadoop-hdfs-client\src\main\java\org\apache\hadoop\hdfs\protocol\SnapshotAccessControlException.java,12,2,0,1,0,3
hadoop-trunk\hadoop-trunk\hadoop-mapreduce-project\hadoop-mapreduce-client\hadoop-mapreduce-client-core\src\main\java\org\apache\hadoop\mapred\JobACLsManager.java,94,21,5,1,0,27
hadoop-trunk\hadoop-trunk\hadoop-mapreduce-project\hadoop-mapreduce-client\hadoop-mapreduce-client-core\src\main\java\org\apache\hadoop\mapreduce\JobID.java,0,70,9,1,0,80
hadoop-trunk\hadoop-trunk\hadoop-mapreduce-project\hadoop-mapreduce-client\hadoop-mapreduce-client-core\src\main\java\org\apache\hadoop\mapreduce\lib\db\OracleDataDrivenDBInputFormat.java,0,24,36,3,0,63
hadoop-trunk\hadoop-trunk\hadoop-common-project\hadoop-common\src\test\java\org\apache\hadoop\io\TestBoundedByteArrayOutputStream.java,123,35,9,1,0,45
hadoop-trunk\hadoop-trunk\hadoop-mapreduce-project\hadoop-mapreduce-client\hadoop-mapreduce-client-jobclient\src\test\java\org\apache\hadoop\mapred\pipes\TestPipesNonJavaInputFormat.java,55,10,5,3,0,18
hadoop-trunk\hadoop-trunk\hadoop-mapreduce-project\hadoop-mapreduce-client\hadoop-mapreduce-client-jobclient\src\test\java\org\apache\hadoop\fs\DistributedFSCheck.java,306,122,27,9,0,158
hadoop-trunk\hadoop-trunk\hadoop-hdfs-project\hadoop-hdfs\src\test\java\org\apache\hadoop\hdfs\server\namenode\TestParallelImageWrite.java,0,21,2,5,0,28
hadoop-trunk\hadoop-trunk\hadoop-mapreduce-project\hadoop-mapreduce-client\hadoop-mapreduce-client-nativetask\src\main\java\org\apache\hadoop\mapred\nativetask\serde\INativeSerializer.java,0,12,3,4,0,19
hadoop-trunk\hadoop-trunk\hadoop-hdfs-project\hadoop-hdfs\src\test\java\org\apache\hadoop\hdfs\server\namenode\TestGetContentSummaryWithPermission.java,158,32,1,1,0,34
hadoop-trunk\hadoop-trunk\hadoop-yarn-project\hadoop-yarn\hadoop-yarn-server\hadoop-yarn-server-nodemanager\src\test\java\org\apache\hadoop\yarn\server\nodemanager\containermanager\monitor\MockResourceCalculatorPlugin.java,57,11,0,1,0,12
hadoop-trunk\hadoop-trunk\hadoop-common-project\hadoop-common\src\main\java\org\apache\hadoop\fs\PathHandle.java,0,0,0,1,0,1
hadoop-trunk\hadoop-trunk\hadoop-yarn-project\hadoop-yarn\hadoop-yarn-api\src\main\java\org\apache\hadoop\yarn\server\api\protocolrecords\NodesToAttributesMappingRequest.java,39,10,0,1,0,11
hadoop-trunk\hadoop-trunk\hadoop-yarn-project\hadoop-yarn\hadoop-yarn-server\hadoop-yarn-server-resourcemanager\src\main\java\org\apache\hadoop\yarn\server\resourcemanager\ahs\WritingApplicationHistoryEvent.java,8,3,0,1,0,4
hadoop-trunk\hadoop-trunk\hadoop-yarn-project\hadoop-yarn\hadoop-yarn-common\src\main\java\org\apache\hadoop\yarn\nodelabels\RMNodeLabel.java,0,44,1,1,0,46
hadoop-trunk\hadoop-trunk\hadoop-mapreduce-project\hadoop-mapreduce-client\hadoop-mapreduce-client-core\src\test\java\org\apache\hadoop\mapreduce\lib\output\committer\manifest\AbstractManifestCommitterTest.java,0,85,3,33,0,121
hadoop-trunk\hadoop-trunk\hadoop-yarn-project\hadoop-yarn\hadoop-yarn-server\hadoop-yarn-server-timelineservice-hbase-tests\src\test\java\org\apache\hadoop\yarn\server\timelineservice\storage\TestTimelineReaderHBaseDown.java,195,31,0,6,0,37
hadoop-trunk\hadoop-trunk\hadoop-yarn-project\hadoop-yarn\hadoop-yarn-server\hadoop-yarn-server-router\src\main\java\org\apache\hadoop\yarn\server\router\rmadmin\RouterRMAdminService.java,0,49,3,27,0,79
hadoop-trunk\hadoop-trunk\hadoop-common-project\hadoop-common\src\main\java\org\apache\hadoop\security\token\TokenInfo.java,0,5,0,1,0,6
hadoop-trunk\hadoop-trunk\hadoop-hdfs-project\hadoop-hdfs-rbf\src\main\java\org\apache\hadoop\hdfs\server\federation\store\protocol\impl\pb\RefreshSuperUserGroupsConfigurationRequestPBImpl.java,0,9,26,5,0,40
hadoop-trunk\hadoop-trunk\hadoop-tools\hadoop-azure\src\main\java\org\apache\hadoop\fs\azurebfs\oauth2\MsiTokenProvider.java,63,14,0,2,0,16
hadoop-trunk\hadoop-trunk\hadoop-common-project\hadoop-common\src\test\java\org\apache\hadoop\fs\contract\rawlocal\TestRawlocalContractOpen.java,8,2,0,1,0,3
hadoop-trunk\hadoop-trunk\hadoop-yarn-project\hadoop-yarn\hadoop-yarn-common\src\main\java\org\apache\hadoop\yarn\api\impl\pb\service\ApplicationHistoryProtocolPBServiceImpl.java,154,31,55,39,0,125
hadoop-trunk\hadoop-trunk\hadoop-common-project\hadoop-common\src\test\java\org\apache\hadoop\jmx\TestJMXJsonServlet.java,62,28,0,2,0,30
hadoop-trunk\hadoop-trunk\hadoop-tools\hadoop-sls\src\test\java\org\apache\hadoop\yarn\sls\TestReservationSystemInvariants.java,36,4,2,5,0,11
hadoop-trunk\hadoop-trunk\hadoop-yarn-project\hadoop-yarn\hadoop-yarn-server\hadoop-yarn-server-applicationhistoryservice\src\test\java\org\apache\hadoop\yarn\server\timeline\webapp\TestTimelineWebServices.java,982,73,84,8,0,165
hadoop-trunk\hadoop-trunk\hadoop-common-project\hadoop-common\src\test\java\org\apache\hadoop\fs\contract\AbstractFSContract.java,165,30,2,3,0,35
hadoop-trunk\hadoop-trunk\hadoop-yarn-project\hadoop-yarn\hadoop-yarn-server\hadoop-yarn-server-resourcemanager\src\test\java\org\apache\hadoop\yarn\server\resourcemanager\webapp\TestNodesPage.java,173,29,15,3,0,47
hadoop-trunk\hadoop-trunk\hadoop-yarn-project\hadoop-yarn\hadoop-yarn-server\hadoop-yarn-server-resourcemanager\src\main\java\org\apache\hadoop\yarn\server\resourcemanager\recovery\NullRMStateStore.java,150,39,4,10,0,53
hadoop-trunk\hadoop-trunk\hadoop-common-project\hadoop-common\src\main\java\org\apache\hadoop\fs\ParentNotDirectoryException.java,12,3,0,1,0,4
hadoop-trunk\hadoop-trunk\hadoop-yarn-project\hadoop-yarn\hadoop-yarn-applications\hadoop-yarn-services\hadoop-yarn-services-api\src\test\java\org\apache\hadoop\yarn\service\client\TestSecureApiServiceClient.java,133,40,3,1,0,44
hadoop-trunk\hadoop-trunk\hadoop-yarn-project\hadoop-yarn\hadoop-yarn-applications\hadoop-yarn-services\hadoop-yarn-services-core\src\main\java\org\apache\hadoop\yarn\service\api\records\KerberosPrincipal.java,0,26,4,4,0,34
hadoop-trunk\hadoop-trunk\hadoop-tools\hadoop-dynamometer\hadoop-dynamometer-workload\src\main\java\org\apache\hadoop\tools\dynamometer\workloadgenerator\audit\AuditLogHiveTableParser.java,21,8,0,1,0,9
hadoop-trunk\hadoop-trunk\hadoop-yarn-project\hadoop-yarn\hadoop-yarn-common\src\main\java\org\apache\hadoop\yarn\server\api\impl\pb\client\ResourceManagerAdministrationProtocolPBClientImpl.java,0,60,47,75,0,182
hadoop-trunk\hadoop-trunk\hadoop-mapreduce-project\hadoop-mapreduce-client\hadoop-mapreduce-client-app\src\main\java\org\apache\hadoop\mapred\WrappedPeriodicStatsAccumulator.java,13,9,0,1,0,10
hadoop-trunk\hadoop-trunk\hadoop-hdfs-project\hadoop-hdfs\src\test\java\org\apache\hadoop\hdfs\TestMissingBlocksAlert.java,134,36,4,2,0,42
hadoop-trunk\hadoop-trunk\hadoop-common-project\hadoop-common\src\test\java\org\apache\hadoop\util\TestInstrumentedLock.java,234,40,2,2,0,44
hadoop-trunk\hadoop-trunk\hadoop-yarn-project\hadoop-yarn\hadoop-yarn-server\hadoop-yarn-server-common\src\main\java\org\apache\hadoop\yarn\server\federation\store\records\impl\pb\GetApplicationsHomeSubClusterRequestPBImpl.java,0,13,17,3,0,33
hadoop-trunk\hadoop-trunk\hadoop-hdfs-project\hadoop-hdfs\src\test\java\org\apache\hadoop\hdfs\server\namenode\ha\TestUpdateBlockTailing.java,217,32,0,2,0,34
hadoop-trunk\hadoop-trunk\hadoop-yarn-project\hadoop-yarn\hadoop-yarn-server\hadoop-yarn-server-nodemanager\src\test\java\org\apache\hadoop\yarn\server\nodemanager\containermanager\linux\runtime\docker\TestDockerVolumeCommand.java,22,1,0,2,0,3
hadoop-trunk\hadoop-trunk\hadoop-yarn-project\hadoop-yarn\hadoop-yarn-api\src\main\java\org\apache\hadoop\yarn\api\records\NodeToAttributeValue.java,27,7,0,1,0,8
hadoop-trunk\hadoop-trunk\hadoop-mapreduce-project\hadoop-mapreduce-client\hadoop-mapreduce-client-jobclient\src\test\java\org\apache\hadoop\cli\util\CLICommandMRAdmin.java,3,0,0,1,0,1
hadoop-trunk\hadoop-trunk\hadoop-yarn-project\hadoop-yarn\hadoop-yarn-client\src\test\java\org\apache\hadoop\yarn\client\ApplicationMasterServiceProtoTestBase.java,0,8,1,1,0,10
hadoop-trunk\hadoop-trunk\hadoop-common-project\hadoop-common\src\test\java\org\apache\hadoop\net\StaticMapping.java,121,19,1,2,0,22
hadoop-trunk\hadoop-trunk\hadoop-hdfs-project\hadoop-hdfs\src\main\java\org\apache\hadoop\hdfs\server\namenode\FSDirSymlinkOp.java,0,33,2,1,0,36
hadoop-trunk\hadoop-trunk\hadoop-tools\hadoop-streaming\src\main\java\org\apache\hadoop\streaming\PathFinder.java,74,20,1,1,0,22
hadoop-trunk\hadoop-trunk\hadoop-common-project\hadoop-common\src\main\java\org\apache\hadoop\http\PrometheusServlet.java,17,5,0,1,0,6
hadoop-trunk\hadoop-trunk\hadoop-tools\hadoop-aws\src\main\java\org\apache\hadoop\fs\s3a\statistics\impl\package-info.java,0,1,0,1,0,2
hadoop-trunk\hadoop-trunk\hadoop-common-project\hadoop-common\src\test\java\org\apache\hadoop\fs\contract\localfs\TestLocalFSContractStreamIOStatistics.java,42,5,0,8,0,13
hadoop-trunk\hadoop-trunk\hadoop-hdfs-project\hadoop-hdfs\src\test\java\org\apache\hadoop\hdfs\TestClose.java,34,6,2,2,0,10
hadoop-trunk\hadoop-trunk\hadoop-mapreduce-project\hadoop-mapreduce-client\hadoop-mapreduce-client-jobclient\src\test\java\org\apache\hadoop\mapreduce\GenericMRLoadGenerator.java,664,183,15,2,0,200
hadoop-trunk\hadoop-trunk\hadoop-common-project\hadoop-common\src\main\java\org\apache\hadoop\fs\AvroFSInput.java,0,17,1,1,0,19
hadoop-trunk\hadoop-trunk\hadoop-yarn-project\hadoop-yarn\hadoop-yarn-server\hadoop-yarn-server-resourcemanager\src\main\java\org\apache\hadoop\yarn\server\resourcemanager\webapp\dao\package-info.java,0,1,0,1,0,2
hadoop-trunk\hadoop-trunk\hadoop-common-project\hadoop-nfs\src\test\java\org\apache\hadoop\oncrpc\security\TestRpcAuthInfo.java,16,11,2,1,0,14
hadoop-trunk\hadoop-trunk\hadoop-hdfs-project\hadoop-hdfs\src\main\java\org\apache\hadoop\hdfs\server\datanode\ProfilingFileIoEvents.java,0,25,3,1,0,29
hadoop-trunk\hadoop-trunk\hadoop-hdfs-project\hadoop-hdfs\src\main\java\org\apache\hadoop\hdfs\server\namenode\INodeAttributes.java,0,42,15,2,0,59
hadoop-trunk\hadoop-trunk\hadoop-hdfs-project\hadoop-hdfs\src\test\java\org\apache\hadoop\hdfs\server\namenode\TestNamenodeCapacityReport.java,398,88,16,4,0,108
hadoop-trunk\hadoop-trunk\hadoop-mapreduce-project\hadoop-mapreduce-client\hadoop-mapreduce-client-jobclient\src\test\java\testjar\CustomOutputCommitter.java,4,0,0,1,0,1
hadoop-trunk\hadoop-trunk\hadoop-yarn-project\hadoop-yarn\hadoop-yarn-common\src\main\java\org\apache\hadoop\yarn\api\protocolrecords\impl\pb\ResourceLocalizationRequestPBImpl.java,0,28,52,2,0,82
hadoop-trunk\hadoop-trunk\hadoop-common-project\hadoop-common\src\test\java\org\apache\hadoop\util\TestClasspath.java,137,27,13,2,0,42
hadoop-trunk\hadoop-trunk\hadoop-yarn-project\hadoop-yarn\hadoop-yarn-common\src\main\java\org\apache\hadoop\yarn\api\records\impl\pb\PreemptionResourceRequestPBImpl.java,98,25,36,2,0,63
hadoop-trunk\hadoop-trunk\hadoop-hdfs-project\hadoop-hdfs-rbf\src\test\java\org\apache\hadoop\hdfs\server\federation\router\TestRouterWebHdfsMethods.java,124,17,2,3,0,22
hadoop-trunk\hadoop-trunk\hadoop-yarn-project\hadoop-yarn\hadoop-yarn-api\src\main\java\org\apache\hadoop\yarn\server\api\protocolrecords\RefreshQueuesResponse.java,10,1,1,1,0,3
hadoop-trunk\hadoop-trunk\hadoop-common-project\hadoop-common\src\test\java\org\apache\hadoop\io\compress\zlib\TestZlibCompressorDecompressor.java,417,138,39,13,0,190
hadoop-trunk\hadoop-trunk\hadoop-common-project\hadoop-common\src\test\java\org\apache\hadoop\fs\contract\localfs\TestLocalFSContractMkdir.java,8,2,0,1,0,3
hadoop-trunk\hadoop-trunk\hadoop-hdfs-project\hadoop-hdfs-client\src\main\java\org\apache\hadoop\hdfs\protocol\ClientDatanodeProtocol.java,0,15,0,1,0,16
hadoop-trunk\hadoop-trunk\hadoop-hdfs-project\hadoop-hdfs-client\src\main\java\org\apache\hadoop\hdfs\client\impl\metrics\BlockReaderLocalMetrics.java,44,12,0,1,0,13
hadoop-trunk\hadoop-trunk\hadoop-yarn-project\hadoop-yarn\hadoop-yarn-server\hadoop-yarn-server-resourcemanager\src\main\java\org\apache\hadoop\yarn\server\resourcemanager\scheduler\policy\OrderingPolicy.java,0,11,10,1,0,22
hadoop-trunk\hadoop-trunk\hadoop-common-project\hadoop-common\src\test\java\org\apache\hadoop\conf\TestConfigurationFieldsBase.java,634,72,41,4,0,117
hadoop-trunk\hadoop-trunk\hadoop-hdfs-project\hadoop-hdfs\src\main\java\org\apache\hadoop\hdfs\server\namenode\snapshot\AbstractINodeDiff.java,0,29,2,3,0,34
hadoop-trunk\hadoop-trunk\hadoop-tools\hadoop-azure\src\test\java\org\apache\hadoop\fs\azurebfs\TestAccountConfiguration.java,446,66,22,45,0,133
hadoop-trunk\hadoop-trunk\hadoop-hdfs-project\hadoop-hdfs\src\main\java\org\apache\hadoop\hdfs\server\datanode\fsdataset\impl\FsVolumeList.java,0,73,19,4,0,96
hadoop-trunk\hadoop-trunk\hadoop-hdfs-project\hadoop-hdfs\src\test\java\org\apache\hadoop\hdfs\server\namenode\TestSecondaryNameNodeUpgrade.java,79,17,3,9,0,29
hadoop-trunk\hadoop-trunk\hadoop-common-project\hadoop-common\src\main\java\org\apache\hadoop\util\StringUtils.java,1222,398,30,8,0,436
hadoop-trunk\hadoop-trunk\hadoop-hdfs-project\hadoop-hdfs\src\main\java\org\apache\hadoop\hdfs\server\datanode\web\webhdfs\WebHdfsHandler.java,258,47,34,8,0,89
hadoop-trunk\hadoop-trunk\hadoop-yarn-project\hadoop-yarn\hadoop-yarn-server\hadoop-yarn-server-nodemanager\src\test\java\org\apache\hadoop\yarn\server\nodemanager\containermanager\linux\runtime\MockLinuxContainerRuntime.java,47,28,6,6,0,40
hadoop-trunk\hadoop-trunk\hadoop-common-project\hadoop-common\src\test\java\org\apache\hadoop\http\TestGlobalFilter.java,109,44,11,2,0,57
hadoop-trunk\hadoop-trunk\hadoop-hdfs-project\hadoop-hdfs-rbf\src\main\java\org\apache\hadoop\hdfs\server\federation\fairness\package-info.java,0,1,0,1,0,2
hadoop-trunk\hadoop-trunk\hadoop-tools\hadoop-aws\src\test\java\org\apache\hadoop\fs\s3a\commit\staging\TestDirectoryCommitterScale.java,0,31,4,6,0,41
hadoop-trunk\hadoop-trunk\hadoop-common-project\hadoop-common\src\main\java\org\apache\hadoop\fs\CreateFlag.java,0,26,1,4,0,31
hadoop-trunk\hadoop-trunk\hadoop-hdfs-project\hadoop-hdfs-rbf\src\main\java\org\apache\hadoop\hdfs\server\federation\store\protocol\GetSafeModeResponse.java,22,6,0,2,0,8
hadoop-trunk\hadoop-trunk\hadoop-hdfs-project\hadoop-hdfs\src\test\java\org\apache\hadoop\hdfs\server\namenode\TestFileContextAcl.java,65,22,0,1,0,23
hadoop-trunk\hadoop-trunk\hadoop-tools\hadoop-openstack\src\main\java\org\apache\hadoop\fs\swift\snative\SwiftFileStatus.java,75,43,9,1,0,53
hadoop-trunk\hadoop-trunk\hadoop-hdfs-project\hadoop-hdfs-client\src\main\java\org\apache\hadoop\hdfs\server\namenode\ha\InMemoryAliasMapFailoverProxyProvider.java,0,6,0,2,0,8
hadoop-trunk\hadoop-trunk\hadoop-common-project\hadoop-common\src\test\java\org\apache\hadoop\fs\TestDefaultUri.java,69,10,1,1,0,12
hadoop-trunk\hadoop-trunk\hadoop-hdfs-project\hadoop-hdfs\src\test\java\org\apache\hadoop\hdfs\TestDFSRemove.java,61,24,4,3,0,31
hadoop-trunk\hadoop-trunk\hadoop-tools\hadoop-rumen\src\main\java\org\apache\hadoop\tools\rumen\Version20LogInterfaceUtils.java,20,1,0,1,0,2
hadoop-trunk\hadoop-trunk\hadoop-hdfs-project\hadoop-hdfs-httpfs\src\main\java\org\apache\hadoop\lib\wsrs\EnumParam.java,0,9,0,1,0,10
hadoop-trunk\hadoop-trunk\hadoop-hdfs-project\hadoop-hdfs\src\main\java\org\apache\hadoop\hdfs\tools\offlineEditsViewer\OfflineEditsLoader.java,0,13,6,3,0,22
hadoop-trunk\hadoop-trunk\hadoop-yarn-project\hadoop-yarn\hadoop-yarn-server\hadoop-yarn-server-resourcemanager\src\main\java\org\apache\hadoop\yarn\server\resourcemanager\scheduler\activities\ActivityState.java,0,7,0,1,0,8
hadoop-trunk\hadoop-trunk\hadoop-yarn-project\hadoop-yarn\hadoop-yarn-server\hadoop-yarn-server-applicationhistoryservice\src\test\java\org\apache\hadoop\yarn\server\timeline\TestRollingLevelDBTimelineStore.java,409,42,21,7,0,70
hadoop-trunk\hadoop-trunk\hadoop-common-project\hadoop-common\src\test\java\org\apache\hadoop\fs\statistics\TestDurationTracking.java,313,22,2,4,0,28
hadoop-trunk\hadoop-trunk\hadoop-yarn-project\hadoop-yarn\hadoop-yarn-server\hadoop-yarn-server-nodemanager\src\test\java\org\apache\hadoop\yarn\server\nodemanager\containermanager\linux\resources\numa\TestNumaResourceHandlerImpl.java,135,27,0,7,0,34
hadoop-trunk\hadoop-trunk\hadoop-yarn-project\hadoop-yarn\hadoop-yarn-server\hadoop-yarn-server-router\src\main\java\org\apache\hadoop\yarn\server\router\clientrm\DefaultClientRequestInterceptor.java,0,78,0,15,0,93
hadoop-trunk\hadoop-trunk\hadoop-common-project\hadoop-common\src\main\java\org\apache\hadoop\fs\FsServerDefaults.java,150,122,1,1,0,124
hadoop-trunk\hadoop-trunk\hadoop-common-project\hadoop-common\src\main\java\org\apache\hadoop\security\JniBasedUnixGroupsNetgroupMapping.java,0,21,5,2,0,28
hadoop-trunk\hadoop-trunk\hadoop-yarn-project\hadoop-yarn\hadoop-yarn-server\hadoop-yarn-server-common\src\main\java\org\apache\hadoop\yarn\server\api\CollectorNodemanagerProtocol.java,0,1,0,5,0,6
hadoop-trunk\hadoop-trunk\hadoop-yarn-project\hadoop-yarn\hadoop-yarn-server\hadoop-yarn-server-resourcemanager\src\main\java\org\apache\hadoop\yarn\server\resourcemanager\scheduler\capacity\UserWeights.java,0,20,2,7,0,29
hadoop-trunk\hadoop-trunk\hadoop-hdfs-project\hadoop-hdfs-rbf\src\main\java\org\apache\hadoop\hdfs\server\federation\store\protocol\impl\pb\LeaveSafeModeRequestPBImpl.java,0,9,23,5,0,37
hadoop-trunk\hadoop-trunk\hadoop-hdfs-project\hadoop-hdfs\src\test\java\org\apache\hadoop\hdfs\server\namenode\snapshot\TestSnapshotFileLength.java,183,22,15,2,0,39
hadoop-trunk\hadoop-trunk\hadoop-mapreduce-project\hadoop-mapreduce-client\hadoop-mapreduce-client-jobclient\src\test\java\org\apache\hadoop\mapred\TestFileInputFormatPathFilter.java,117,24,6,2,0,32
hadoop-trunk\hadoop-trunk\hadoop-yarn-project\hadoop-yarn\hadoop-yarn-server\hadoop-yarn-server-common\src\main\java\org\apache\hadoop\yarn\server\federation\policies\router\WeightedRandomRouterPolicy.java,46,3,0,2,0,5
hadoop-trunk\hadoop-trunk\hadoop-mapreduce-project\hadoop-mapreduce-client\hadoop-mapreduce-client-core\src\main\java\org\apache\hadoop\mapreduce\jobhistory\EventReader.java,164,18,41,33,0,92
hadoop-trunk\hadoop-trunk\hadoop-common-project\hadoop-common\src\test\java\org\apache\hadoop\service\TestCompositeService.java,1037,166,25,4,0,195
hadoop-trunk\hadoop-trunk\hadoop-yarn-project\hadoop-yarn\hadoop-yarn-server\hadoop-yarn-server-resourcemanager\src\main\java\org\apache\hadoop\yarn\server\resourcemanager\webapp\dao\AppPriority.java,20,11,1,1,0,13
hadoop-trunk\hadoop-trunk\hadoop-hdfs-project\hadoop-hdfs-client\src\main\java\org\apache\hadoop\hdfs\CannotObtainBlockLengthException.java,36,7,0,1,0,8
hadoop-trunk\hadoop-trunk\hadoop-mapreduce-project\hadoop-mapreduce-client\hadoop-mapreduce-client-core\src\test\java\org\apache\hadoop\mapreduce\split\TestJobSplitWriterWithEC.java,79,13,1,1,0,15
hadoop-trunk\hadoop-trunk\hadoop-hdfs-project\hadoop-hdfs\src\main\java\org\apache\hadoop\hdfs\util\ByteArray.java,29,17,0,1,0,18
hadoop-trunk\hadoop-trunk\hadoop-yarn-project\hadoop-yarn\hadoop-yarn-server\hadoop-yarn-server-nodemanager\src\main\java\org\apache\hadoop\yarn\server\nodemanager\containermanager\loghandler\event\LogHandlerContainerFinishedEvent.java,28,16,0,2,0,18
hadoop-trunk\hadoop-trunk\hadoop-common-project\hadoop-common\src\main\java\org\apache\hadoop\security\AccessControlException.java,34,9,0,1,0,10
hadoop-trunk\hadoop-trunk\hadoop-tools\hadoop-aws\src\main\java\org\apache\hadoop\fs\s3a\impl\ErrorTranslation.java,49,3,0,1,0,4
hadoop-trunk\hadoop-trunk\hadoop-mapreduce-project\hadoop-mapreduce-client\hadoop-mapreduce-client-core\src\main\java\org\apache\hadoop\mapred\MapReduceBase.java,0,4,4,1,0,9
hadoop-trunk\hadoop-trunk\hadoop-hdfs-project\hadoop-hdfs\src\main\java\org\apache\hadoop\hdfs\server\namenode\UnsupportedActionException.java,9,3,0,1,0,4
hadoop-trunk\hadoop-trunk\hadoop-yarn-project\hadoop-yarn\hadoop-yarn-common\src\main\java\org\apache\hadoop\yarn\nodelabels\event\UpdateNodeToLabelsMappingsEvent.java,13,7,0,2,0,9
hadoop-trunk\hadoop-trunk\hadoop-hdfs-project\hadoop-hdfs-client\src\main\java\org\apache\hadoop\hdfs\ExceptionLastSeen.java,0,6,0,1,0,7
hadoop-trunk\hadoop-trunk\hadoop-common-project\hadoop-common\src\main\java\org\apache\hadoop\util\hash\JenkinsHash.java,223,123,5,29,0,157
hadoop-trunk\hadoop-trunk\hadoop-hdfs-project\hadoop-hdfs\src\test\java\org\apache\hadoop\hdfs\server\datanode\extdataset\ExternalReplica.java,48,9,0,1,0,10
hadoop-trunk\hadoop-trunk\hadoop-hdfs-project\hadoop-hdfs-rbf\src\test\java\org\apache\hadoop\fs\contract\router\TestRouterHDFSContractAppend.java,18,4,0,1,0,5
hadoop-trunk\hadoop-trunk\hadoop-hdfs-project\hadoop-hdfs-rbf\src\test\java\org\apache\hadoop\hdfs\server\federation\router\TestRouterQuota.java,1197,112,7,11,0,130
hadoop-trunk\hadoop-trunk\hadoop-yarn-project\hadoop-yarn\hadoop-yarn-api\src\main\java\org\apache\hadoop\yarn\api\records\ContainerRetryContext.java,42,24,0,1,0,25
hadoop-trunk\hadoop-trunk\hadoop-yarn-project\hadoop-yarn\hadoop-yarn-common\src\main\java\org\apache\hadoop\yarn\event\package-info.java,0,1,0,1,0,2
hadoop-trunk\hadoop-trunk\hadoop-yarn-project\hadoop-yarn\hadoop-yarn-server\hadoop-yarn-server-timelineservice\src\main\java\org\apache\hadoop\yarn\server\timelineservice\storage\TimelineReader.java,0,9,1,4,0,14
hadoop-trunk\hadoop-trunk\hadoop-common-project\hadoop-registry\src\main\java\org\apache\hadoop\registry\client\types\RegistryPathStatus.java,0,18,1,1,0,20
hadoop-trunk\hadoop-trunk\hadoop-yarn-project\hadoop-yarn\hadoop-yarn-common\src\main\java\org\apache\hadoop\yarn\util\ResourceCalculatorPlugin.java,207,11,3,2,0,16
hadoop-trunk\hadoop-trunk\hadoop-hdfs-project\hadoop-hdfs\src\test\java\org\apache\hadoop\hdfs\server\namenode\TestFSImageStorageInspector.java,30,14,0,4,0,18
hadoop-trunk\hadoop-trunk\hadoop-common-project\hadoop-common\src\main\java\org\apache\hadoop\conf\ReconfigurationTaskStatus.java,42,21,0,1,0,22
hadoop-trunk\hadoop-trunk\hadoop-common-project\hadoop-common\src\main\java\org\apache\hadoop\fs\viewfs\package-info.java,0,0,0,1,0,1
hadoop-trunk\hadoop-trunk\hadoop-mapreduce-project\hadoop-mapreduce-client\hadoop-mapreduce-client-core\src\main\java\org\apache\hadoop\mapred\MapRunnable.java,0,12,4,2,0,18
hadoop-trunk\hadoop-trunk\hadoop-mapreduce-project\hadoop-mapreduce-client\hadoop-mapreduce-client-jobclient\src\test\java\org\apache\hadoop\mapred\TestReduceFetchFromPartialMem.java,261,115,15,2,0,132
hadoop-trunk\hadoop-trunk\hadoop-hdfs-project\hadoop-hdfs\src\test\java\org\apache\hadoop\hdfs\server\datanode\TestTriggerBlockReport.java,0,25,0,9,0,34
hadoop-trunk\hadoop-trunk\hadoop-yarn-project\hadoop-yarn\hadoop-yarn-server\hadoop-yarn-server-resourcemanager\src\test\java\org\apache\hadoop\yarn\server\resourcemanager\TestMoveApplication.java,149,38,0,7,0,45
hadoop-trunk\hadoop-trunk\hadoop-mapreduce-project\hadoop-mapreduce-client\hadoop-mapreduce-client-core\src\main\java\org\apache\hadoop\mapreduce\lib\output\committer\manifest\package-info.java,0,0,0,1,0,1
hadoop-trunk\hadoop-trunk\hadoop-yarn-project\hadoop-yarn\hadoop-yarn-server\hadoop-yarn-server-resourcemanager\src\main\java\org\apache\hadoop\yarn\server\resourcemanager\scheduler\common\ResourceAllocationCommitter.java,0,1,1,1,0,3
hadoop-trunk\hadoop-trunk\hadoop-hdfs-project\hadoop-hdfs\src\test\java\org\apache\hadoop\hdfs\server\namenode\TestMalformedURLs.java,31,6,0,1,0,7
hadoop-trunk\hadoop-trunk\hadoop-tools\hadoop-aws\src\test\java\org\apache\hadoop\fs\contract\s3a\ITestS3AContractMultipartUploader.java,77,11,0,4,0,15
hadoop-trunk\hadoop-trunk\hadoop-yarn-project\hadoop-yarn\hadoop-yarn-api\src\main\java\org\apache\hadoop\yarn\util\package-info.java,0,1,0,1,0,2
hadoop-trunk\hadoop-trunk\hadoop-tools\hadoop-azure\src\main\java\org\apache\hadoop\fs\azurebfs\services\AbfsAclHelper.java,0,65,6,38,0,109
hadoop-trunk\hadoop-trunk\hadoop-yarn-project\hadoop-yarn\hadoop-yarn-server\hadoop-yarn-server-nodemanager\src\test\java\org\apache\hadoop\yarn\server\nodemanager\containermanager\linux\resources\numa\TestNumaResourceAllocator.java,233,43,23,5,0,71
hadoop-trunk\hadoop-trunk\hadoop-yarn-project\hadoop-yarn\hadoop-yarn-server\hadoop-yarn-server-tests\src\test\java\org\apache\hadoop\yarn\server\TestMiniYarnCluster.java,124,17,9,1,0,27
hadoop-trunk\hadoop-trunk\hadoop-hdfs-project\hadoop-hdfs-rbf\src\main\java\org\apache\hadoop\hdfs\server\federation\resolver\MultipleDestinationMountTableResolver.java,61,11,1,3,0,15
hadoop-trunk\hadoop-trunk\hadoop-yarn-project\hadoop-yarn\hadoop-yarn-server\hadoop-yarn-server-nodemanager\src\main\java\org\apache\hadoop\yarn\server\nodemanager\util\CgroupsLCEResourcesHandler.java,424,82,13,7,0,102
hadoop-trunk\hadoop-trunk\hadoop-yarn-project\hadoop-yarn\hadoop-yarn-client\src\test\java\org\apache\hadoop\yarn\client\TestYarnApiClasses.java,79,11,11,12,0,34
hadoop-trunk\hadoop-trunk\hadoop-hdfs-project\hadoop-hdfs-client\src\main\java\org\apache\hadoop\hdfs\DFSClientFaultInjector.java,38,30,5,1,0,36
hadoop-trunk\hadoop-trunk\hadoop-yarn-project\hadoop-yarn\hadoop-yarn-server\hadoop-yarn-server-resourcemanager\src\test\java\org\apache\hadoop\yarn\server\resourcemanager\scheduler\TestSchedulerUtils.java,1145,112,38,35,0,185
hadoop-trunk\hadoop-trunk\hadoop-yarn-project\hadoop-yarn\hadoop-yarn-applications\hadoop-yarn-services\hadoop-yarn-services-core\src\main\java\org\apache\hadoop\yarn\service\ServiceContext.java,34,31,2,1,0,34
hadoop-trunk\hadoop-trunk\hadoop-yarn-project\hadoop-yarn\hadoop-yarn-server\hadoop-yarn-server-nodemanager\src\main\java\org\apache\hadoop\yarn\server\nodemanager\amrmproxy\AMRMProxyService.java,813,63,39,11,0,113
hadoop-trunk\hadoop-trunk\hadoop-hdfs-project\hadoop-hdfs\src\test\java\org\apache\hadoop\hdfs\TestFileChecksum.java,596,106,14,2,0,122
hadoop-trunk\hadoop-trunk\hadoop-common-project\hadoop-common\src\test\java\org\apache\hadoop\conf\TestConfigRedactor.java,69,5,0,1,0,6
hadoop-trunk\hadoop-trunk\hadoop-mapreduce-project\hadoop-mapreduce-client\hadoop-mapreduce-client-app\src\test\java\org\apache\hadoop\mapreduce\v2\app\rm\ContainerRequestCreator.java,0,13,0,1,0,14
hadoop-trunk\hadoop-trunk\hadoop-yarn-project\hadoop-yarn\hadoop-yarn-common\src\main\java\org\apache\hadoop\yarn\nodelabels\store\package-info.java,0,1,0,1,0,2
hadoop-trunk\hadoop-trunk\hadoop-yarn-project\hadoop-yarn\hadoop-yarn-server\hadoop-yarn-server-resourcemanager\src\main\java\org\apache\hadoop\yarn\server\resourcemanager\recovery\RMStateStoreEventType.java,0,16,0,1,0,17
hadoop-trunk\hadoop-trunk\hadoop-tools\hadoop-federation-balance\src\main\java\org\apache\hadoop\tools\fedbalance\FedBalanceConfigs.java,0,13,0,1,0,14
hadoop-trunk\hadoop-trunk\hadoop-yarn-project\hadoop-yarn\hadoop-yarn-server\hadoop-yarn-server-resourcemanager\src\test\java\org\apache\hadoop\yarn\server\resourcemanager\ParameterizedSchedulerTestBase.java,98,24,2,5,0,31
hadoop-trunk\hadoop-trunk\hadoop-common-project\hadoop-common\src\test\java\org\apache\hadoop\security\TestUGIWithMiniKdc.java,70,12,12,2,0,26
hadoop-trunk\hadoop-trunk\hadoop-yarn-project\hadoop-yarn\hadoop-yarn-server\hadoop-yarn-server-timelineservice\src\main\java\org\apache\hadoop\yarn\server\timelineservice\storage\NoOpTimelineReaderImpl.java,0,16,0,4,0,20
hadoop-trunk\hadoop-trunk\hadoop-mapreduce-project\hadoop-mapreduce-client\hadoop-mapreduce-client-jobclient\src\test\java\org\apache\hadoop\mapred\lib\TestMultithreadedMapRunner.java,0,33,5,1,0,39
hadoop-trunk\hadoop-trunk\hadoop-mapreduce-project\hadoop-mapreduce-client\hadoop-mapreduce-client-jobclient\src\test\java\org\apache\hadoop\fs\slive\Range.java,0,14,1,1,0,16
hadoop-trunk\hadoop-trunk\hadoop-common-project\hadoop-common\src\test\java\org\apache\hadoop\fs\contract\ContractOptions.java,0,15,36,3,0,54
hadoop-trunk\hadoop-trunk\hadoop-common-project\hadoop-auth\src\main\java\org\apache\hadoop\security\authentication\client\ConnectionConfigurator.java,0,2,1,1,0,4
hadoop-trunk\hadoop-trunk\hadoop-yarn-project\hadoop-yarn\hadoop-yarn-server\hadoop-yarn-server-timelineservice-documentstore\src\test\java\org\apache\hadoop\yarn\server\timelineservice\documentstore\TestDocumentStoreTimelineWriterImpl.java,49,6,2,6,0,14
hadoop-trunk\hadoop-trunk\hadoop-yarn-project\hadoop-yarn\hadoop-yarn-common\src\main\java\org\apache\hadoop\yarn\security\ContainerTokenSelector.java,25,7,0,1,0,8
hadoop-trunk\hadoop-trunk\hadoop-common-project\hadoop-common\src\main\java\org\apache\hadoop\io\compress\SnappyCodec.java,0,16,2,5,0,23
hadoop-trunk\hadoop-trunk\hadoop-hdfs-project\hadoop-hdfs\src\main\java\org\apache\hadoop\hdfs\server\datanode\fsdataset\impl\ProvidedVolumeImpl.java,0,118,12,3,0,133
hadoop-trunk\hadoop-trunk\hadoop-common-project\hadoop-common\src\main\java\org\apache\hadoop\io\DoubleWritable.java,0,40,1,1,0,42
hadoop-trunk\hadoop-trunk\hadoop-common-project\hadoop-common\src\main\java\org\apache\hadoop\fs\MD5MD5CRC32GzipFileChecksum.java,17,11,0,2,0,13
hadoop-trunk\hadoop-trunk\hadoop-tools\hadoop-aws\src\main\java\org\apache\hadoop\fs\s3a\audit\AWSRequestAnalyzer.java,238,9,0,14,0,23
hadoop-trunk\hadoop-trunk\hadoop-cloud-storage-project\hadoop-huaweicloud\src\main\java\org\apache\hadoop\fs\obs\OBS.java,0,0,0,1,0,1
hadoop-trunk\hadoop-trunk\hadoop-yarn-project\hadoop-yarn\hadoop-yarn-api\src\main\java\org\apache\hadoop\yarn\util\constraint\package-info.java,0,1,0,1,0,2
hadoop-trunk\hadoop-trunk\hadoop-common-project\hadoop-nfs\src\main\java\org\apache\hadoop\nfs\nfs3\request\SetAttr3.java,149,64,2,1,0,67
hadoop-trunk\hadoop-trunk\hadoop-yarn-project\hadoop-yarn\hadoop-yarn-common\src\test\java\org\apache\hadoop\yarn\ipc\TestRPCUtil.java,141,18,4,1,0,23
hadoop-trunk\hadoop-trunk\hadoop-hdfs-project\hadoop-hdfs\src\test\java\org\apache\hadoop\hdfs\server\namenode\TestLeaseManager.java,425,52,19,2,0,73
hadoop-trunk\hadoop-trunk\hadoop-yarn-project\hadoop-yarn\hadoop-yarn-common\src\main\java\org\apache\hadoop\yarn\event\AbstractEvent.java,0,15,1,1,0,17
hadoop-trunk\hadoop-trunk\hadoop-yarn-project\hadoop-yarn\hadoop-yarn-server\hadoop-yarn-server-nodemanager\src\main\java\org\apache\hadoop\yarn\server\nodemanager\containermanager\linux\resources\fpga\FpgaResourceAllocator.java,238,58,4,13,0,75
hadoop-trunk\hadoop-trunk\hadoop-yarn-project\hadoop-yarn\hadoop-yarn-server\hadoop-yarn-server-resourcemanager\src\main\java\org\apache\hadoop\yarn\server\resourcemanager\recovery\RMStateStoreUtils.java,34,3,1,2,0,6
hadoop-trunk\hadoop-trunk\hadoop-yarn-project\hadoop-yarn\hadoop-yarn-server\hadoop-yarn-server-resourcemanager\src\test\java\org\apache\hadoop\yarn\server\resourcemanager\TestResourceTrackerService.java,3056,415,217,43,0,675
hadoop-trunk\hadoop-trunk\hadoop-mapreduce-project\hadoop-mapreduce-client\hadoop-mapreduce-client-hs\src\test\java\org\apache\hadoop\mapreduce\v2\hs\TestHistoryFileManager.java,350,45,2,4,0,51
hadoop-trunk\hadoop-trunk\hadoop-hdfs-project\hadoop-hdfs\src\main\java\org\apache\hadoop\hdfs\tools\DebugAdmin.java,614,102,17,20,0,139
hadoop-trunk\hadoop-trunk\hadoop-hdfs-project\hadoop-hdfs-httpfs\src\test\java\org\apache\hadoop\fs\http\server\TestHttpFSAccessControlled.java,307,53,9,6,0,68
hadoop-trunk\hadoop-trunk\hadoop-yarn-project\hadoop-yarn\hadoop-yarn-server\hadoop-yarn-server-timelineservice-hbase\hadoop-yarn-server-timelineservice-hbase-client\src\main\java\org\apache\hadoop\yarn\server\timelineservice\storage\flow\package-info.java,0,0,0,1,0,1
hadoop-trunk\hadoop-trunk\hadoop-common-project\hadoop-common\src\main\java\org\apache\hadoop\fs\impl\FutureDataInputStreamBuilderImpl.java,0,20,0,4,0,24
hadoop-trunk\hadoop-trunk\hadoop-hdfs-project\hadoop-hdfs-client\src\main\java\org\apache\hadoop\hdfs\shortcircuit\ShortCircuitReplica.java,286,42,9,4,0,55
hadoop-trunk\hadoop-trunk\hadoop-common-project\hadoop-common\src\main\java\org\apache\hadoop\util\bloom\RemoveScheme.java,0,39,8,2,0,49
hadoop-trunk\hadoop-trunk\hadoop-common-project\hadoop-common\src\test\java\org\apache\hadoop\crypto\key\kms\TestLoadBalancingKMSClientProvider.java,915,42,40,2,0,84
hadoop-trunk\hadoop-trunk\hadoop-tools\hadoop-azure\src\main\java\org\apache\hadoop\fs\azurebfs\services\ExponentialRetryPolicy.java,147,26,2,13,0,41
hadoop-trunk\hadoop-trunk\hadoop-tools\hadoop-aws\src\main\java\org\apache\hadoop\fs\s3a\statistics\StatisticsFromAwsSdk.java,0,1,0,1,0,2
hadoop-trunk\hadoop-trunk\hadoop-hdfs-project\hadoop-hdfs\src\main\java\org\apache\hadoop\hdfs\server\mover\MoverMetrics.java,0,12,0,1,0,13
hadoop-trunk\hadoop-trunk\hadoop-hdfs-project\hadoop-hdfs\src\test\java\org\apache\hadoop\hdfs\TestDFSFinalize.java,0,54,5,9,0,68
hadoop-trunk\hadoop-trunk\hadoop-yarn-project\hadoop-yarn\hadoop-yarn-api\src\main\java\org\apache\hadoop\yarn\api\records\NMToken.java,72,22,7,4,0,33
hadoop-trunk\hadoop-trunk\hadoop-common-project\hadoop-common\src\main\java\org\apache\hadoop\metrics2\impl\MetricGaugeDouble.java,0,6,0,1,0,7
hadoop-trunk\hadoop-trunk\hadoop-hdfs-project\hadoop-hdfs-client\src\main\java\org\apache\hadoop\hdfs\web\resources\LengthParam.java,35,4,0,1,0,5
hadoop-trunk\hadoop-trunk\hadoop-tools\hadoop-streaming\src\main\java\org\apache\hadoop\streaming\io\InputWriter.java,0,9,0,1,0,10
hadoop-trunk\hadoop-trunk\hadoop-tools\hadoop-azure\src\main\java\org\apache\hadoop\fs\azure\metrics\RollingWindowAverage.java,0,15,0,1,0,16
hadoop-trunk\hadoop-trunk\hadoop-common-project\hadoop-common\src\main\java\org\apache\hadoop\io\compress\DoNotPool.java,0,2,0,1,0,3
hadoop-trunk\hadoop-trunk\hadoop-tools\hadoop-azure\src\test\java\org\apache\hadoop\fs\azurebfs\services\ITestAbfsOutputStream.java,56,8,0,3,0,11
hadoop-trunk\hadoop-trunk\hadoop-yarn-project\hadoop-yarn\hadoop-yarn-server\hadoop-yarn-server-nodemanager\src\main\java\org\apache\hadoop\yarn\server\nodemanager\api\impl\pb\NMProtoUtils.java,0,12,6,7,0,25
hadoop-trunk\hadoop-trunk\hadoop-hdfs-project\hadoop-hdfs\src\main\java\org\apache\hadoop\hdfs\server\namenode\snapshot\FileDiff.java,0,38,2,2,0,42
hadoop-trunk\hadoop-trunk\hadoop-mapreduce-project\hadoop-mapreduce-client\hadoop-mapreduce-client-jobclient\src\test\java\org\apache\hadoop\mapreduce\lib\output\TestMRMultipleOutputs.java,326,116,42,2,0,160
hadoop-trunk\hadoop-trunk\hadoop-yarn-project\hadoop-yarn\hadoop-yarn-api\src\main\java\org\apache\hadoop\yarn\api\records\ApplicationAttemptReport.java,165,44,0,1,0,45
hadoop-trunk\hadoop-trunk\hadoop-mapreduce-project\hadoop-mapreduce-client\hadoop-mapreduce-client-core\src\main\java\org\apache\hadoop\mapred\lib\ChainMapper.java,90,24,3,1,0,28
hadoop-trunk\hadoop-trunk\hadoop-tools\hadoop-azure\src\test\java\org\apache\hadoop\fs\azure\TestOutOfBandAzureBlobOperations.java,0,19,5,1,0,25
hadoop-trunk\hadoop-trunk\hadoop-hdfs-project\hadoop-hdfs-rbf\src\test\java\org\apache\hadoop\hdfs\server\federation\router\TestRouterAdminGenericRefresh.java,209,29,0,1,0,30
hadoop-trunk\hadoop-trunk\hadoop-hdfs-project\hadoop-hdfs-rbf\src\test\java\org\apache\hadoop\hdfs\server\federation\store\driver\TestStateStoreFileSystem.java,62,10,0,3,0,13
hadoop-trunk\hadoop-trunk\hadoop-common-project\hadoop-common\src\test\java\org\apache\hadoop\fs\TestFileSystemTokens.java,245,51,2,7,0,60
hadoop-trunk\hadoop-trunk\hadoop-common-project\hadoop-nfs\src\main\java\org\apache\hadoop\nfs\nfs3\Nfs3Constant.java,178,119,2,4,0,125
hadoop-trunk\hadoop-trunk\hadoop-yarn-project\hadoop-yarn\hadoop-yarn-server\hadoop-yarn-server-timelineservice-hbase\hadoop-yarn-server-timelineservice-hbase-client\src\main\java\org\apache\hadoop\yarn\server\timelineservice\storage\common\HBaseTimelineStorageUtils.java,0,10,3,1,0,14
hadoop-trunk\hadoop-trunk\hadoop-mapreduce-project\hadoop-mapreduce-client\hadoop-mapreduce-client-core\src\test\java\org\apache\hadoop\mapreduce\lib\output\TestMapFileOutputFormat.java,37,9,3,1,0,13
hadoop-trunk\hadoop-trunk\hadoop-tools\hadoop-aws\src\test\java\org\apache\hadoop\fs\contract\s3a\ITestS3AContractCreate.java,9,2,0,1,0,3
hadoop-trunk\hadoop-trunk\hadoop-common-project\hadoop-common\src\main\java\org\apache\hadoop\metrics2\MetricsVisitor.java,0,13,6,1,0,20
hadoop-trunk\hadoop-trunk\hadoop-yarn-project\hadoop-yarn\hadoop-yarn-common\src\main\java\org\apache\hadoop\yarn\api\protocolrecords\impl\pb\ReservationDeleteRequestPBImpl.java,99,25,36,3,0,64
hadoop-trunk\hadoop-trunk\hadoop-hdfs-project\hadoop-hdfs-httpfs\src\test\java\org\apache\hadoop\test\TestException.java,0,2,0,1,0,3
hadoop-trunk\hadoop-trunk\hadoop-common-project\hadoop-common\src\main\java\org\apache\hadoop\fs\PathIOException.java,107,37,0,1,0,38
hadoop-trunk\hadoop-trunk\hadoop-common-project\hadoop-common\src\main\java\org\apache\hadoop\fs\PathIsDirectoryException.java,8,3,0,1,0,4
hadoop-trunk\hadoop-trunk\hadoop-hdfs-project\hadoop-hdfs\src\test\java\org\apache\hadoop\hdfs\server\namenode\TestNameEditsConfigs.java,569,119,9,25,0,153
hadoop-trunk\hadoop-trunk\hadoop-tools\hadoop-streaming\src\main\java\org\apache\hadoop\record\BinaryRecordInput.java,128,50,1,1,0,52
hadoop-trunk\hadoop-trunk\hadoop-yarn-project\hadoop-yarn\hadoop-yarn-applications\hadoop-yarn-services\hadoop-yarn-services-core\src\main\java\org\apache\hadoop\yarn\service\exceptions\BadClusterStateException.java,12,10,2,1,0,13
hadoop-trunk\hadoop-trunk\hadoop-hdfs-project\hadoop-hdfs\src\main\java\org\apache\hadoop\hdfs\server\datanode\checker\DatasetVolumeChecker.java,401,46,12,12,0,70
hadoop-trunk\hadoop-trunk\hadoop-common-project\hadoop-common\src\main\java\org\apache\hadoop\io\erasurecode\rawcoder\DecodingState.java,0,9,0,1,0,10
hadoop-trunk\hadoop-trunk\hadoop-mapreduce-project\hadoop-mapreduce-client\hadoop-mapreduce-client-app\src\main\java\org\apache\hadoop\mapreduce\v2\app\package-info.java,0,1,0,1,0,2
hadoop-trunk\hadoop-trunk\hadoop-tools\hadoop-distcp\src\test\java\org\apache\hadoop\tools\contract\TestLocalContractDistCp.java,8,2,0,1,0,3
hadoop-trunk\hadoop-trunk\hadoop-yarn-project\hadoop-yarn\hadoop-yarn-server\hadoop-yarn-server-common\src\main\java\org\apache\hadoop\yarn\server\api\protocolrecords\impl\pb\SCMUploaderCanUploadRequestPBImpl.java,0,16,27,4,0,47
hadoop-trunk\hadoop-trunk\hadoop-common-project\hadoop-common\src\test\java\org\apache\hadoop\net\TestMockDomainNameResolver.java,32,4,0,1,0,5
hadoop-trunk\hadoop-trunk\hadoop-yarn-project\hadoop-yarn\hadoop-yarn-server\hadoop-yarn-server-resourcemanager\src\test\java\org\apache\hadoop\yarn\server\resourcemanager\scheduler\fair\converter\weightconversion\WeightConverterTestBase.java,30,7,0,3,0,10
hadoop-trunk\hadoop-trunk\hadoop-common-project\hadoop-common\src\main\java\org\apache\hadoop\fs\MultipartUploaderBuilder.java,0,16,0,2,0,18
hadoop-trunk\hadoop-trunk\hadoop-yarn-project\hadoop-yarn\hadoop-yarn-server\hadoop-yarn-server-resourcemanager\src\main\java\org\apache\hadoop\yarn\server\resourcemanager\webapp\dao\FairSchedulerQueueInfo.java,0,86,2,5,0,93
hadoop-trunk\hadoop-trunk\hadoop-yarn-project\hadoop-yarn\hadoop-yarn-server\hadoop-yarn-server-resourcemanager\src\main\java\org\apache\hadoop\yarn\server\resourcemanager\scheduler\fair\VisitedResourceRequestTracker.java,0,13,2,2,0,17
hadoop-trunk\hadoop-trunk\hadoop-yarn-project\hadoop-yarn\hadoop-yarn-server\hadoop-yarn-server-resourcemanager\src\main\java\org\apache\hadoop\yarn\server\resourcemanager\scheduler\capacity\QueueAllocationSettings.java,62,15,2,4,0,21
hadoop-trunk\hadoop-trunk\hadoop-common-project\hadoop-common\src\main\java\org\apache\hadoop\ipc\RefreshHandler.java,0,0,0,1,0,1
hadoop-trunk\hadoop-trunk\hadoop-mapreduce-project\hadoop-mapreduce-examples\src\main\java\org\apache\hadoop\examples\pi\math\ArithmeticProgression.java,105,65,11,3,0,79
hadoop-trunk\hadoop-trunk\hadoop-tools\hadoop-streaming\src\main\java\org\apache\hadoop\streaming\io\IdentifierResolver.java,102,36,15,1,0,52
hadoop-trunk\hadoop-trunk\hadoop-hdfs-project\hadoop-hdfs-client\src\main\java\org\apache\hadoop\hdfs\security\token\delegation\DelegationTokenIdentifier.java,0,19,3,2,0,24
hadoop-trunk\hadoop-trunk\hadoop-yarn-project\hadoop-yarn\hadoop-yarn-server\hadoop-yarn-server-timelineservice\src\main\java\org\apache\hadoop\yarn\server\timelineservice\collector\PerNodeTimelineCollectorsAuxService.java,220,36,8,1,0,45
hadoop-trunk\hadoop-trunk\hadoop-yarn-project\hadoop-yarn\hadoop-yarn-applications\hadoop-yarn-services\hadoop-yarn-services-core\src\main\java\org\apache\hadoop\yarn\service\provider\defaultImpl\DefaultClientProvider.java,23,10,4,1,0,15
hadoop-trunk\hadoop-trunk\hadoop-yarn-project\hadoop-yarn\hadoop-yarn-server\hadoop-yarn-server-resourcemanager\src\main\java\org\apache\hadoop\yarn\server\resourcemanager\scheduler\CSQueueMetricsForCustomResources.java,0,13,0,1,0,14
hadoop-trunk\hadoop-trunk\hadoop-hdfs-project\hadoop-hdfs\src\test\java\org\apache\hadoop\hdfs\server\datanode\TestDataNodeVolumeFailure.java,883,214,14,10,0,238
hadoop-trunk\hadoop-trunk\hadoop-mapreduce-project\hadoop-mapreduce-client\hadoop-mapreduce-client-core\src\main\java\org\apache\hadoop\mapreduce\lib\input\CombineSequenceFileInputFormat.java,0,20,0,1,0,21
hadoop-trunk\hadoop-trunk\hadoop-yarn-project\hadoop-yarn\hadoop-yarn-server\hadoop-yarn-server-resourcemanager\src\test\java\org\apache\hadoop\yarn\server\resourcemanager\reservation\planning\TestSimpleCapacityReplanner.java,129,45,0,10,0,55
hadoop-trunk\hadoop-trunk\hadoop-tools\hadoop-aliyun\src\test\java\org\apache\hadoop\fs\aliyun\oss\yarn\TestOSS.java,45,9,0,1,0,10
hadoop-trunk\hadoop-trunk\hadoop-hdfs-project\hadoop-hdfs-rbf\src\test\java\org\apache\hadoop\hdfs\server\federation\security\TestRouterHttpDelegationToken.java,169,22,1,4,0,27
hadoop-trunk\hadoop-trunk\hadoop-yarn-project\hadoop-yarn\hadoop-yarn-client\src\main\java\org\apache\hadoop\yarn\client\api\YarnClient.java,893,64,1,12,0,77
hadoop-trunk\hadoop-trunk\hadoop-yarn-project\hadoop-yarn\hadoop-yarn-server\hadoop-yarn-server-timelineservice\src\main\java\org\apache\hadoop\yarn\server\timelineservice\reader\TimelineParserForRelationFilters.java,37,9,0,4,0,13
hadoop-trunk\hadoop-trunk\hadoop-yarn-project\hadoop-yarn\hadoop-yarn-server\hadoop-yarn-server-resourcemanager\src\test\java\org\apache\hadoop\yarn\server\resourcemanager\volume\csi\TestVolumeCapabilityRange.java,41,10,0,2,0,12
hadoop-trunk\hadoop-trunk\hadoop-mapreduce-project\hadoop-mapreduce-client\hadoop-mapreduce-client-jobclient\src\test\java\org\apache\hadoop\mapreduce\MapReduceTestUtil.java,407,170,21,1,0,192
hadoop-trunk\hadoop-trunk\hadoop-mapreduce-project\hadoop-mapreduce-client\hadoop-mapreduce-client-app\src\main\java\org\apache\hadoop\mapreduce\v2\app\commit\CommitterJobAbortEvent.java,27,16,0,1,0,17
hadoop-trunk\hadoop-trunk\hadoop-yarn-project\hadoop-yarn\hadoop-yarn-api\src\main\java\org\apache\hadoop\yarn\server\api\protocolrecords\RunSharedCacheCleanerTaskRequest.java,3,1,1,1,0,3
hadoop-trunk\hadoop-trunk\hadoop-yarn-project\hadoop-yarn\hadoop-yarn-server\hadoop-yarn-server-nodemanager\src\main\java\org\apache\hadoop\yarn\server\nodemanager\containermanager\application\ApplicationInitedEvent.java,8,2,0,1,0,3
hadoop-trunk\hadoop-trunk\hadoop-common-project\hadoop-common\src\main\java\org\apache\hadoop\fs\shell\TouchCommands.java,160,41,1,3,0,45
hadoop-trunk\hadoop-trunk\hadoop-common-project\hadoop-kms\src\main\java\org\apache\hadoop\crypto\key\kms\server\KMSAudit.java,221,56,3,4,0,63
hadoop-trunk\hadoop-trunk\hadoop-tools\hadoop-resourceestimator\src\main\java\org\apache\hadoop\resourceestimator\skylinestore\exceptions\package-info.java,0,0,0,1,0,1
hadoop-trunk\hadoop-trunk\hadoop-tools\hadoop-sls\src\main\java\org\apache\hadoop\yarn\sls\scheduler\SLSCapacityScheduler.java,0,46,2,6,0,54
hadoop-trunk\hadoop-trunk\hadoop-yarn-project\hadoop-yarn\hadoop-yarn-server\hadoop-yarn-server-nodemanager\src\main\java\org\apache\hadoop\yarn\server\nodemanager\containermanager\monitor\ContainersMonitor.java,0,5,0,1,0,6
hadoop-trunk\hadoop-trunk\hadoop-hdfs-project\hadoop-hdfs-rbf\src\main\java\org\apache\hadoop\hdfs\server\federation\router\RemoteResult.java,0,18,0,1,0,19
hadoop-trunk\hadoop-trunk\hadoop-hdfs-project\hadoop-hdfs\src\main\java\org\apache\hadoop\hdfs\server\namenode\NameNodeMXBean.java,0,37,0,1,0,38
hadoop-trunk\hadoop-trunk\hadoop-yarn-project\hadoop-yarn\hadoop-yarn-server\hadoop-yarn-server-timelineservice\src\main\java\org\apache\hadoop\yarn\server\timelineservice\reader\TimelineReaderUtils.java,0,4,1,1,0,6
hadoop-trunk\hadoop-trunk\hadoop-yarn-project\hadoop-yarn\hadoop-yarn-server\hadoop-yarn-server-resourcemanager\src\test\java\org\apache\hadoop\yarn\server\resourcemanager\scheduler\capacity\queuemanagement\TestDeactivatedLeafQueuesByLabel.java,20,12,1,2,0,15
hadoop-trunk\hadoop-trunk\hadoop-common-project\hadoop-common\src\main\java\org\apache\hadoop\security\SecurityInfo.java,20,3,0,2,0,5
hadoop-trunk\hadoop-trunk\hadoop-tools\hadoop-gridmix\src\main\java\org\apache\hadoop\mapred\gridmix\emulators\resourceusage\ResourceUsageMatcher.java,74,27,3,1,0,31
hadoop-trunk\hadoop-trunk\hadoop-yarn-project\hadoop-yarn\hadoop-yarn-server\hadoop-yarn-server-nodemanager\src\main\java\org\apache\hadoop\yarn\server\nodemanager\containermanager\resourceplugin\fpga\discovery\SettingsBasedFPGADiscoveryStrategy.java,0,7,0,4,0,11
hadoop-trunk\hadoop-trunk\hadoop-yarn-project\hadoop-yarn\hadoop-yarn-server\hadoop-yarn-server-resourcemanager\src\main\java\org\apache\hadoop\yarn\server\resourcemanager\NodesListManager.java,683,151,24,4,0,179
hadoop-trunk\hadoop-trunk\hadoop-hdfs-project\hadoop-hdfs\src\test\java\org\apache\hadoop\hdfs\server\namenode\TestINodeFile.java,1188,362,37,15,0,414
hadoop-trunk\hadoop-trunk\hadoop-tools\hadoop-azure\src\main\java\org\apache\hadoop\fs\azurebfs\diagnostics\LongConfigurationBasicValidator.java,37,10,2,6,0,18
hadoop-trunk\hadoop-trunk\hadoop-yarn-project\hadoop-yarn\hadoop-yarn-applications\hadoop-yarn-services\hadoop-yarn-services-core\src\main\java\org\apache\hadoop\yarn\service\component\ComponentEventType.java,0,9,0,1,0,10
hadoop-trunk\hadoop-trunk\hadoop-common-project\hadoop-kms\src\main\java\org\apache\hadoop\crypto\key\kms\server\KMSACLs.java,0,74,12,5,0,91
hadoop-trunk\hadoop-trunk\hadoop-hdfs-project\hadoop-hdfs\src\main\java\org\apache\hadoop\hdfs\tools\offlineImageViewer\FSImageHandler.java,0,20,14,6,0,40
hadoop-trunk\hadoop-trunk\hadoop-yarn-project\hadoop-yarn\hadoop-yarn-server\hadoop-yarn-server-timelineservice-hbase-tests\src\test\java\org\apache\hadoop\yarn\server\timelineservice\storage\flow\TestHBaseStorageFlowActivity.java,436,46,10,10,0,66
hadoop-trunk\hadoop-trunk\hadoop-common-project\hadoop-common\src\test\java\org\apache\hadoop\test\TestGenericTestUtils.java,130,16,1,1,0,18
hadoop-trunk\hadoop-trunk\hadoop-common-project\hadoop-common\src\test\java\org\apache\hadoop\fs\contract\AbstractContractConcatTest.java,67,17,3,4,0,24
hadoop-trunk\hadoop-trunk\hadoop-tools\hadoop-sls\src\main\java\org\apache\hadoop\yarn\sls\nodemanager\NMSimulator.java,0,73,9,3,0,85
hadoop-trunk\hadoop-trunk\hadoop-hdfs-project\hadoop-hdfs\src\test\java\org\apache\hadoop\hdfs\server\namenode\TestFsLimits.java,256,60,7,4,0,71
hadoop-trunk\hadoop-trunk\hadoop-tools\hadoop-azure\src\test\java\org\apache\hadoop\fs\azurebfs\utils\TestMockHelpers.java,0,3,2,1,0,6
hadoop-trunk\hadoop-trunk\hadoop-hdfs-project\hadoop-hdfs\src\test\java\org\apache\hadoop\hdfs\server\namenode\TestCacheDirectives.java,1598,413,81,10,0,504
hadoop-trunk\hadoop-trunk\hadoop-mapreduce-project\hadoop-mapreduce-client\hadoop-mapreduce-client-nativetask\src\test\java\org\apache\hadoop\mapred\nativetask\compresstest\CompressMapper.java,32,12,1,2,0,15
hadoop-trunk\hadoop-trunk\hadoop-tools\hadoop-distcp\src\test\java\org\apache\hadoop\tools\util\TestThrottledInputStream.java,130,39,2,4,0,45
hadoop-trunk\hadoop-trunk\hadoop-hdfs-project\hadoop-hdfs\src\main\java\org\apache\hadoop\hdfs\server\datanode\fsdataset\impl\RamDiskAsyncLazyPersistService.java,0,68,3,6,0,77
hadoop-trunk\hadoop-trunk\hadoop-hdfs-project\hadoop-hdfs\src\main\java\org\apache\hadoop\hdfs\util\BestEffortLongFile.java,73,28,2,1,0,31
hadoop-trunk\hadoop-trunk\hadoop-yarn-project\hadoop-yarn\hadoop-yarn-server\hadoop-yarn-server-applicationhistoryservice\src\main\java\org\apache\hadoop\yarn\server\timeline\RollingLevelDB.java,0,29,15,1,0,45
hadoop-trunk\hadoop-trunk\hadoop-hdfs-project\hadoop-hdfs\src\main\java\org\apache\hadoop\hdfs\server\namenode\snapshot\DirectorySnapshottableFeature.java,587,78,7,3,0,88
hadoop-trunk\hadoop-trunk\hadoop-mapreduce-project\hadoop-mapreduce-client\hadoop-mapreduce-client-nativetask\src\main\java\org\apache\hadoop\mapred\nativetask\NativeBatchProcessor.java,243,61,8,2,0,71
hadoop-trunk\hadoop-trunk\hadoop-hdfs-project\hadoop-hdfs\src\test\java\org\apache\hadoop\hdfs\server\datanode\TestRefreshNamenodes.java,89,15,4,1,0,20
hadoop-trunk\hadoop-trunk\hadoop-yarn-project\hadoop-yarn\hadoop-yarn-server\hadoop-yarn-server-timelineservice-documentstore\src\test\java\org\apache\hadoop\yarn\server\timelineservice\documentstore\writer\cosmosdb\TestCosmosDBDocumentStoreWriter.java,54,3,1,6,0,10
hadoop-trunk\hadoop-trunk\hadoop-mapreduce-project\hadoop-mapreduce-client\hadoop-mapreduce-client-core\src\main\java\org\apache\hadoop\mapreduce\QueueInfo.java,192,74,0,1,0,75
hadoop-trunk\hadoop-trunk\hadoop-mapreduce-project\hadoop-mapreduce-client\hadoop-mapreduce-client-core\src\main\java\org\apache\hadoop\mapreduce\jobhistory\JobSubmittedEvent.java,229,98,41,2,0,141
hadoop-trunk\hadoop-trunk\hadoop-mapreduce-project\hadoop-mapreduce-client\hadoop-mapreduce-client-core\src\main\java\org\apache\hadoop\mapreduce\lib\output\committer\manifest\ManifestCommitterConstants.java,0,3,0,5,0,8
hadoop-trunk\hadoop-trunk\hadoop-tools\hadoop-streaming\src\main\java\org\apache\hadoop\streaming\io\KeyOnlyTextOutputReader.java,0,18,2,1,0,21
hadoop-trunk\hadoop-trunk\hadoop-common-project\hadoop-common\src\main\java\org\apache\hadoop\io\erasurecode\coder\HHErasureCodingStep.java,0,11,1,1,0,13
hadoop-trunk\hadoop-trunk\hadoop-mapreduce-project\hadoop-mapreduce-client\hadoop-mapreduce-client-core\src\test\java\org\apache\hadoop\mapreduce\lib\input\TestLineRecordReader.java,599,106,18,5,0,129
hadoop-trunk\hadoop-trunk\hadoop-yarn-project\hadoop-yarn\hadoop-yarn-server\hadoop-yarn-server-resourcemanager\src\test\java\org\apache\hadoop\yarn\server\resourcemanager\webapp\TestRedirectionErrorPage.java,29,3,0,1,0,4
hadoop-trunk\hadoop-trunk\hadoop-common-project\hadoop-common\src\main\java\org\apache\hadoop\fs\statistics\impl\StubDurationTracker.java,0,1,2,1,0,4
hadoop-trunk\hadoop-trunk\hadoop-yarn-project\hadoop-yarn\hadoop-yarn-server\hadoop-yarn-server-nodemanager\src\main\java\org\apache\hadoop\yarn\server\nodemanager\containermanager\linux\resources\MemoryResourceHandler.java,0,0,0,2,0,2
hadoop-trunk\hadoop-trunk\hadoop-mapreduce-project\hadoop-mapreduce-client\hadoop-mapreduce-client-jobclient\src\test\java\org\apache\hadoop\mapreduce\lib\input\TestMRSequenceFileInputFilter.java,156,53,8,4,0,65
hadoop-trunk\hadoop-trunk\hadoop-yarn-project\hadoop-yarn\hadoop-yarn-server\hadoop-yarn-server-timelineservice\src\main\java\org\apache\hadoop\yarn\server\timelineservice\reader\filter\TimelineFilter.java,41,4,0,1,0,5
hadoop-trunk\hadoop-trunk\hadoop-common-project\hadoop-common\src\test\java\org\apache\hadoop\fs\viewfs\TestChRootedFileSystem.java,514,127,26,10,0,163
hadoop-trunk\hadoop-trunk\hadoop-yarn-project\hadoop-yarn\hadoop-yarn-applications\hadoop-yarn-applications-mawo\hadoop-yarn-applications-mawo-core\src\main\java\org\apache\hadoop\applications\mawo\server\worker\WorkerId.java,138,2,0,1,0,3
hadoop-trunk\hadoop-trunk\hadoop-yarn-project\hadoop-yarn\hadoop-yarn-api\src\main\java\org\apache\hadoop\yarn\server\api\ContainerTerminationContext.java,18,10,0,1,0,11
hadoop-trunk\hadoop-trunk\hadoop-yarn-project\hadoop-yarn\hadoop-yarn-common\src\main\java\org\apache\hadoop\yarn\nodelabels\event\RemoveClusterNodeLabels.java,13,8,0,1,0,9
hadoop-trunk\hadoop-trunk\hadoop-yarn-project\hadoop-yarn\hadoop-yarn-api\src\main\java\org\apache\hadoop\yarn\api\records\timelineservice\TimelineMetric.java,250,55,6,1,0,62
hadoop-trunk\hadoop-trunk\hadoop-yarn-project\hadoop-yarn\hadoop-yarn-csi\src\main\java\org\apache\hadoop\yarn\csi\utils\package-info.java,0,0,0,1,0,1
hadoop-trunk\hadoop-trunk\hadoop-yarn-project\hadoop-yarn\hadoop-yarn-server\hadoop-yarn-server-resourcemanager\src\main\java\org\apache\hadoop\yarn\server\resourcemanager\scheduler\capacity\CapacityHeadroomProvider.java,48,23,1,4,0,28
hadoop-trunk\hadoop-trunk\hadoop-common-project\hadoop-common\src\test\java\org\apache\hadoop\metrics2\sink\TestRollingFileSystemSink.java,224,47,20,1,0,68
hadoop-trunk\hadoop-trunk\hadoop-tools\hadoop-rumen\src\main\java\org\apache\hadoop\tools\rumen\datatypes\QueueName.java,19,10,0,1,0,11
hadoop-trunk\hadoop-trunk\hadoop-hdfs-project\hadoop-hdfs\src\main\java\org\apache\hadoop\hdfs\tools\HDFSConcat.java,25,21,1,1,0,23
hadoop-trunk\hadoop-trunk\hadoop-hdfs-project\hadoop-hdfs\src\test\java\org\apache\hadoop\hdfs\server\namenode\snapshot\TestSnapshot.java,1107,245,13,16,0,274
hadoop-trunk\hadoop-trunk\hadoop-yarn-project\hadoop-yarn\hadoop-yarn-api\src\main\java\org\apache\hadoop\yarn\api\protocolrecords\SubmitApplicationRequest.java,31,13,0,2,0,15
hadoop-trunk\hadoop-trunk\hadoop-common-project\hadoop-registry\src\test\java\org\apache\hadoop\registry\client\impl\CuratorEventCatcher.java,35,11,0,1,0,12
hadoop-trunk\hadoop-trunk\hadoop-hdfs-project\hadoop-hdfs\src\main\java\org\apache\hadoop\hdfs\server\blockmanagement\BlockPlacementStatus.java,0,7,2,1,0,10
hadoop-trunk\hadoop-trunk\hadoop-hdfs-project\hadoop-hdfs\src\main\java\org\apache\hadoop\hdfs\server\common\IncorrectVersionException.java,30,28,2,2,0,32
hadoop-trunk\hadoop-trunk\hadoop-hdfs-project\hadoop-hdfs-rbf\src\main\java\org\apache\hadoop\hdfs\server\federation\router\RouterSnapshot.java,206,40,3,2,0,45
hadoop-trunk\hadoop-trunk\hadoop-yarn-project\hadoop-yarn\hadoop-yarn-server\hadoop-yarn-server-nodemanager\src\test\java\org\apache\hadoop\yarn\server\nodemanager\TestNodeManagerResync.java,0,148,29,10,0,187
hadoop-trunk\hadoop-trunk\hadoop-yarn-project\hadoop-yarn\hadoop-yarn-server\hadoop-yarn-server-resourcemanager\src\test\java\org\apache\hadoop\yarn\server\resourcemanager\monitor\capacity\mockframework\ContainerSpecification.java,85,36,0,3,0,39
hadoop-trunk\hadoop-trunk\hadoop-yarn-project\hadoop-yarn\hadoop-yarn-common\src\main\java\org\apache\hadoop\yarn\util\Clock.java,0,2,0,1,0,3
hadoop-trunk\hadoop-trunk\hadoop-yarn-project\hadoop-yarn\hadoop-yarn-api\src\main\java\org\apache\hadoop\yarn\api\protocolrecords\GetApplicationAttemptReportResponse.java,33,9,1,2,0,12
hadoop-trunk\hadoop-trunk\hadoop-hdfs-project\hadoop-hdfs\src\main\java\org\apache\hadoop\hdfs\tools\offlineImageViewer\PBImageTextWriter.java,931,180,85,15,0,280
hadoop-trunk\hadoop-trunk\hadoop-hdfs-project\hadoop-hdfs\src\test\java\org\apache\hadoop\hdfs\TestErasureCodingPolicyWithSnapshot.java,267,22,2,2,0,26
hadoop-trunk\hadoop-trunk\hadoop-common-project\hadoop-common\src\main\java\org\apache\hadoop\ipc\Server.java,3886,1035,202,43,0,1280
hadoop-trunk\hadoop-trunk\hadoop-common-project\hadoop-common\src\main\java\org\apache\hadoop\io\compress\lz4\package-info.java,0,1,0,1,0,2
hadoop-trunk\hadoop-trunk\hadoop-yarn-project\hadoop-yarn\hadoop-yarn-server\hadoop-yarn-server-resourcemanager\src\main\java\org\apache\hadoop\yarn\server\resourcemanager\ahs\WritingApplicationAttemptFinishEvent.java,28,13,1,2,0,16
hadoop-trunk\hadoop-trunk\hadoop-hdfs-project\hadoop-hdfs-rbf\src\main\java\org\apache\hadoop\hdfs\server\federation\router\RouterHeartbeatService.java,129,9,1,3,0,13
hadoop-trunk\hadoop-trunk\hadoop-tools\hadoop-aws\src\test\java\org\apache\hadoop\fs\s3a\ITestS3AUnbuffer.java,157,15,0,4,0,19
hadoop-trunk\hadoop-trunk\hadoop-hdfs-project\hadoop-hdfs\src\main\java\org\apache\hadoop\hdfs\server\diskbalancer\planner\package-info.java,0,2,0,1,0,3
hadoop-trunk\hadoop-trunk\hadoop-yarn-project\hadoop-yarn\hadoop-yarn-server\hadoop-yarn-server-resourcemanager\src\main\java\org\apache\hadoop\yarn\server\resourcemanager\scheduler\fair\Schedulable.java,0,13,0,3,0,16
hadoop-trunk\hadoop-trunk\hadoop-yarn-project\hadoop-yarn\hadoop-yarn-server\hadoop-yarn-server-timelineservice-hbase\hadoop-yarn-server-timelineservice-hbase-client\src\main\java\org\apache\hadoop\yarn\server\timelineservice\storage\reader\FlowRunEntityReader.java,0,16,1,14,0,31
hadoop-trunk\hadoop-trunk\hadoop-common-project\hadoop-kms\src\test\java\org\apache\hadoop\crypto\key\kms\server\TestKMSAudit.java,195,18,7,1,0,26
hadoop-trunk\hadoop-trunk\hadoop-yarn-project\hadoop-yarn\hadoop-yarn-api\src\main\java\org\apache\hadoop\yarn\api\records\NodeAttributeInfo.java,33,9,0,1,0,10
hadoop-trunk\hadoop-trunk\hadoop-common-project\hadoop-common\src\main\java\org\apache\hadoop\io\serializer\WritableSerialization.java,0,26,0,1,0,27
hadoop-trunk\hadoop-trunk\hadoop-mapreduce-project\hadoop-mapreduce-client\hadoop-mapreduce-client-app\src\test\java\org\apache\hadoop\mapreduce\v2\app\webapp\TestBlocks.java,331,46,10,1,0,57
hadoop-trunk\hadoop-trunk\hadoop-yarn-project\hadoop-yarn\hadoop-yarn-server\hadoop-yarn-server-timelineservice-documentstore\src\main\java\org\apache\hadoop\yarn\server\timelineservice\documentstore\DocumentStoreCollectionCreator.java,33,6,2,5,0,13
hadoop-trunk\hadoop-trunk\hadoop-yarn-project\hadoop-yarn\hadoop-yarn-server\hadoop-yarn-server-applicationhistoryservice\src\main\java\org\apache\hadoop\yarn\server\applicationhistoryservice\ApplicationHistoryManager.java,0,8,0,1,0,9
hadoop-trunk\hadoop-trunk\hadoop-mapreduce-project\hadoop-mapreduce-client\hadoop-mapreduce-client-core\src\main\java\org\apache\hadoop\mapred\lib\aggregate\UserDefinedValueAggregatorDescriptor.java,0,13,1,1,0,15
hadoop-trunk\hadoop-trunk\hadoop-common-project\hadoop-common\src\test\java\org\apache\hadoop\fs\permission\TestAcl.java,184,32,20,3,0,55
hadoop-trunk\hadoop-trunk\hadoop-hdfs-project\hadoop-hdfs\src\main\java\org\apache\hadoop\hdfs\server\protocol\RegisterCommand.java,9,5,0,2,0,7
hadoop-trunk\hadoop-trunk\hadoop-hdfs-project\hadoop-hdfs-rbf\src\main\java\org\apache\hadoop\hdfs\server\federation\store\protocol\EnableNameserviceRequest.java,21,5,0,2,0,7
hadoop-trunk\hadoop-trunk\hadoop-mapreduce-project\hadoop-mapreduce-client\hadoop-mapreduce-client-jobclient\src\test\java\org\apache\hadoop\mapreduce\lib\input\TestMRSequenceFileAsTextInputFormat.java,82,18,3,2,0,23
hadoop-trunk\hadoop-trunk\hadoop-common-project\hadoop-common\src\test\java\org\apache\hadoop\fs\statistics\TestDynamicIOStatistics.java,259,24,2,11,0,37
hadoop-trunk\hadoop-trunk\hadoop-hdfs-project\hadoop-hdfs\src\test\java\org\apache\hadoop\hdfs\server\datanode\TestDataNodeMetricsLogger.java,166,34,5,2,0,41
hadoop-trunk\hadoop-trunk\hadoop-common-project\hadoop-common\src\main\java\org\apache\hadoop\io\file\tfile\SimpleBufferedOutputStream.java,51,21,0,1,0,22
hadoop-trunk\hadoop-trunk\hadoop-common-project\hadoop-common\src\main\java\org\apache\hadoop\io\file\tfile\RawComparable.java,0,12,3,1,0,16
hadoop-trunk\hadoop-trunk\hadoop-yarn-project\hadoop-yarn\hadoop-yarn-server\hadoop-yarn-server-nodemanager\src\main\java\org\apache\hadoop\yarn\server\nodemanager\recovery\RecoveryIterator.java,0,3,0,1,0,4
hadoop-trunk\hadoop-trunk\hadoop-hdfs-project\hadoop-hdfs\src\main\java\org\apache\hadoop\hdfs\protocolPB\NamenodeProtocolPB.java,0,2,3,2,0,7
hadoop-trunk\hadoop-trunk\hadoop-mapreduce-project\hadoop-mapreduce-client\hadoop-mapreduce-client-core\src\main\java\org\apache\hadoop\mapreduce\TaskCounter.java,0,28,0,1,0,29
hadoop-trunk\hadoop-trunk\hadoop-tools\hadoop-distcp\src\test\java\org\apache\hadoop\tools\TestRegexCopyFilter.java,85,5,2,1,0,8
hadoop-trunk\hadoop-trunk\hadoop-yarn-project\hadoop-yarn\hadoop-yarn-api\src\main\java\org\apache\hadoop\yarn\api\protocolrecords\GetContainerStatusesRequest.java,36,9,0,2,0,11
hadoop-trunk\hadoop-trunk\hadoop-yarn-project\hadoop-yarn\hadoop-yarn-server\hadoop-yarn-server-resourcemanager\src\test\java\org\apache\hadoop\yarn\server\resourcemanager\scheduler\fair\converter\TestFSYarnSiteConverter.java,260,36,0,9,0,45
hadoop-trunk\hadoop-trunk\hadoop-hdfs-project\hadoop-hdfs-rbf\src\main\java\org\apache\hadoop\hdfs\server\federation\store\protocol\GetRouterRegistrationsRequest.java,8,2,0,2,0,4
hadoop-trunk\hadoop-trunk\hadoop-mapreduce-project\hadoop-mapreduce-client\hadoop-mapreduce-client-jobclient\src\test\java\org\apache\hadoop\fs\slive\PathFinder.java,0,21,8,1,0,30
hadoop-trunk\hadoop-trunk\hadoop-hdfs-project\hadoop-hdfs\src\main\java\org\apache\hadoop\hdfs\tools\offlineEditsViewer\OfflineEditsBinaryLoader.java,0,24,6,2,0,32
hadoop-trunk\hadoop-trunk\hadoop-tools\hadoop-azure\src\test\java\org\apache\hadoop\fs\azurebfs\extensions\TestCustomOauthTokenProvider.java,37,2,3,1,0,6
hadoop-trunk\hadoop-trunk\hadoop-tools\hadoop-aws\src\test\java\org\apache\hadoop\fs\s3a\s3guard\TestS3GuardCLI.java,54,8,2,1,0,11
hadoop-trunk\hadoop-trunk\hadoop-yarn-project\hadoop-yarn\hadoop-yarn-applications\hadoop-yarn-services\hadoop-yarn-services-core\src\main\java\org\apache\hadoop\yarn\service\monitor\probe\Probe.java,81,23,2,1,0,26
hadoop-trunk\hadoop-trunk\hadoop-yarn-project\hadoop-yarn\hadoop-yarn-server\hadoop-yarn-server-nodemanager\src\main\java\org\apache\hadoop\yarn\server\nodemanager\api\protocolrecords\impl\pb\LocalizerStatusPBImpl.java,0,35,47,6,0,88
hadoop-trunk\hadoop-trunk\hadoop-mapreduce-project\hadoop-mapreduce-client\hadoop-mapreduce-client-jobclient\src\test\java\org\apache\hadoop\mapreduce\TimelineServicePerformance.java,202,53,4,1,0,58
hadoop-trunk\hadoop-trunk\hadoop-tools\hadoop-rumen\src\main\java\org\apache\hadoop\tools\rumen\LoggedTask.java,331,133,18,1,0,152
hadoop-trunk\hadoop-trunk\hadoop-yarn-project\hadoop-yarn\hadoop-yarn-server\hadoop-yarn-server-resourcemanager\src\main\java\org\apache\hadoop\yarn\server\resourcemanager\recovery\ZKRMStateStore.java,1289,180,47,13,0,240
hadoop-trunk\hadoop-trunk\hadoop-mapreduce-project\hadoop-mapreduce-client\hadoop-mapreduce-client-app\src\test\java\org\apache\hadoop\mapred\TestTaskAttemptListenerImpl.java,499,86,11,5,0,102
hadoop-trunk\hadoop-trunk\hadoop-yarn-project\hadoop-yarn\hadoop-yarn-server\hadoop-yarn-server-resourcemanager\src\test\java\org\apache\hadoop\yarn\server\resourcemanager\resourcetracker\TestNMExpiry.java,132,36,2,10,0,48
hadoop-trunk\hadoop-trunk\hadoop-hdfs-project\hadoop-hdfs\src\test\java\org\apache\hadoop\hdfs\qjournal\TestMiniJournalCluster.java,115,37,1,14,0,52
hadoop-trunk\hadoop-trunk\hadoop-hdfs-project\hadoop-hdfs\src\test\java\org\apache\hadoop\hdfs\server\namenode\web\resources\TestWebHdfsDataLocality.java,219,42,7,2,0,51
hadoop-trunk\hadoop-trunk\hadoop-tools\hadoop-aws\src\main\java\org\apache\hadoop\fs\s3a\S3A.java,23,6,1,1,0,8
hadoop-trunk\hadoop-trunk\hadoop-yarn-project\hadoop-yarn\hadoop-yarn-api\src\main\java\org\apache\hadoop\yarn\api\records\timelineservice\TimelineEntities.java,26,13,2,1,0,16
hadoop-trunk\hadoop-trunk\hadoop-yarn-project\hadoop-yarn\hadoop-yarn-server\hadoop-yarn-server-resourcemanager\src\main\java\org\apache\hadoop\yarn\server\resourcemanager\scheduler\fair\FifoAppComparator.java,0,5,1,2,0,8
hadoop-trunk\hadoop-trunk\hadoop-yarn-project\hadoop-yarn\hadoop-yarn-server\hadoop-yarn-server-resourcemanager\src\main\java\org\apache\hadoop\yarn\server\resourcemanager\webapp\AppLogAggregationStatusPage.java,18,4,0,1,0,5
hadoop-trunk\hadoop-trunk\hadoop-common-project\hadoop-common\src\test\java\org\apache\hadoop\service\launcher\testservices\FailInStartService.java,15,4,0,1,0,5
hadoop-trunk\hadoop-trunk\hadoop-mapreduce-project\hadoop-mapreduce-client\hadoop-mapreduce-client-core\src\main\java\org\apache\hadoop\mapred\lib\aggregate\ValueAggregator.java,0,2,0,1,0,3
hadoop-trunk\hadoop-trunk\hadoop-mapreduce-project\hadoop-mapreduce-client\hadoop-mapreduce-client-core\src\main\java\org\apache\hadoop\mapreduce\task\reduce\OnDiskMapOutput.java,0,63,6,2,0,71
hadoop-trunk\hadoop-trunk\hadoop-common-project\hadoop-common\src\main\java\org\apache\hadoop\metrics2\MetricsCollector.java,0,5,2,1,0,8
hadoop-trunk\hadoop-trunk\hadoop-common-project\hadoop-common\src\main\java\org\apache\hadoop\util\HeapSort.java,0,11,6,1,0,18
hadoop-trunk\hadoop-trunk\hadoop-yarn-project\hadoop-yarn\hadoop-yarn-api\src\main\java\org\apache\hadoop\yarn\api\protocolrecords\ReInitializeContainerResponse.java,9,1,0,1,0,2
hadoop-trunk\hadoop-trunk\hadoop-tools\hadoop-azure\src\test\java\org\apache\hadoop\fs\azurebfs\contract\ITestAbfsFileSystemContractRename.java,31,7,0,2,0,9
hadoop-trunk\hadoop-trunk\hadoop-common-project\hadoop-common\src\main\java\org\apache\hadoop\io\erasurecode\ECChunk.java,86,24,1,1,0,26
hadoop-trunk\hadoop-trunk\hadoop-common-project\hadoop-common\src\main\java\org\apache\hadoop\util\CombinedIPWhiteList.java,40,12,1,1,0,14
hadoop-trunk\hadoop-trunk\hadoop-tools\hadoop-aliyun\src\main\java\org\apache\hadoop\fs\aliyun\oss\AliyunOSSCopyFileTask.java,41,18,1,1,0,20
hadoop-trunk\hadoop-trunk\hadoop-mapreduce-project\hadoop-mapreduce-client\hadoop-mapreduce-client-core\src\main\java\org\apache\hadoop\mapreduce\lib\db\TextSplitter.java,181,47,3,23,0,73
hadoop-trunk\hadoop-trunk\hadoop-common-project\hadoop-common\src\main\java\org\apache\hadoop\fs\CanUnbuffer.java,0,1,1,1,0,3
hadoop-trunk\hadoop-trunk\hadoop-yarn-project\hadoop-yarn\hadoop-yarn-server\hadoop-yarn-server-nodemanager\src\test\java\org\apache\hadoop\yarn\server\nodemanager\webapp\TestNMWebServicesAuxServices.java,255,44,7,4,0,55
hadoop-trunk\hadoop-trunk\hadoop-hdfs-project\hadoop-hdfs\src\main\java\org\apache\hadoop\hdfs\server\blockmanagement\BlockPlacementStatusWithNodeGroup.java,63,14,0,1,0,15
hadoop-trunk\hadoop-trunk\hadoop-yarn-project\hadoop-yarn\hadoop-yarn-server\hadoop-yarn-server-timelineservice\src\main\java\org\apache\hadoop\yarn\server\timelineservice\reader\security\package-info.java,0,1,0,1,0,2
hadoop-trunk\hadoop-trunk\hadoop-yarn-project\hadoop-yarn\hadoop-yarn-server\hadoop-yarn-server-common\src\main\java\org\apache\hadoop\yarn\server\api\ResourceTrackerPB.java,0,1,2,2,0,5
hadoop-trunk\hadoop-trunk\hadoop-yarn-project\hadoop-yarn\hadoop-yarn-server\hadoop-yarn-server-timelineservice\src\main\java\org\apache\hadoop\yarn\server\timelineservice\reader\filter\package-info.java,0,1,0,1,0,2
hadoop-trunk\hadoop-trunk\hadoop-tools\hadoop-azure\src\test\java\org\apache\hadoop\fs\azurebfs\commit\ITestAbfsManifestStoreOperations.java,125,14,0,12,0,26
hadoop-trunk\hadoop-trunk\hadoop-common-project\hadoop-common\src\main\java\org\apache\hadoop\fs\FSInputStream.java,0,22,0,1,0,23
hadoop-trunk\hadoop-trunk\hadoop-yarn-project\hadoop-yarn\hadoop-yarn-server\hadoop-yarn-server-resourcemanager\src\main\java\org\apache\hadoop\yarn\server\resourcemanager\scheduler\fair\allocation\AllocationFileQueueParser.java,254,46,4,1,0,51
hadoop-trunk\hadoop-trunk\hadoop-yarn-project\hadoop-yarn\hadoop-yarn-server\hadoop-yarn-server-common\src\main\java\org\apache\hadoop\yarn\server\federation\policies\RouterPolicyFacade.java,220,19,1,7,0,27
hadoop-trunk\hadoop-trunk\hadoop-common-project\hadoop-common\src\test\java\org\apache\hadoop\util\TestIntrusiveCollection.java,153,16,4,1,0,21
hadoop-trunk\hadoop-trunk\hadoop-hdfs-project\hadoop-hdfs-client\src\test\java\org\apache\hadoop\hdfs\protocol\TestBlockType.java,34,29,1,1,0,31
hadoop-trunk\hadoop-trunk\hadoop-mapreduce-project\hadoop-mapreduce-client\hadoop-mapreduce-client-app\src\main\java\org\apache\hadoop\mapreduce\v2\app\job\event\JobSetupFailedEvent.java,14,7,0,1,0,8
hadoop-trunk\hadoop-trunk\hadoop-yarn-project\hadoop-yarn\hadoop-yarn-api\src\main\java\org\apache\hadoop\yarn\api\records\LocalResourceVisibility.java,0,10,0,2,0,12
hadoop-trunk\hadoop-trunk\hadoop-hdfs-project\hadoop-hdfs\src\main\java\org\apache\hadoop\hdfs\server\blockmanagement\BlockManager.java,5349,1085,171,48,0,1304
hadoop-trunk\hadoop-trunk\hadoop-yarn-project\hadoop-yarn\hadoop-yarn-common\src\main\java\org\apache\hadoop\yarn\api\protocolrecords\impl\pb\RegisterApplicationMasterRequestPBImpl.java,0,34,53,4,0,91
hadoop-trunk\hadoop-trunk\hadoop-common-project\hadoop-common\src\test\java\org\apache\hadoop\util\curator\TestZKCuratorManager.java,117,11,4,1,0,16
hadoop-trunk\hadoop-trunk\hadoop-tools\hadoop-aws\src\main\java\org\apache\hadoop\fs\s3a\impl\StoreContextBuilder.java,163,51,0,1,0,52
hadoop-trunk\hadoop-trunk\hadoop-tools\hadoop-dynamometer\hadoop-dynamometer-blockgen\src\main\java\org\apache\hadoop\tools\dynamometer\blockgenerator\BlockInfo.java,69,25,0,1,0,26
hadoop-trunk\hadoop-trunk\hadoop-yarn-project\hadoop-yarn\hadoop-yarn-applications\hadoop-yarn-applications-catalog\hadoop-yarn-applications-catalog-webapp\src\main\java\org\apache\hadoop\yarn\appcatalog\utils\package-info.java,0,0,0,1,0,1
hadoop-trunk\hadoop-trunk\hadoop-yarn-project\hadoop-yarn\hadoop-yarn-server\hadoop-yarn-server-resourcemanager\src\main\java\org\apache\hadoop\yarn\server\resourcemanager\rmapp\attempt\RMAppStartAttemptEvent.java,15,7,0,1,0,8
hadoop-trunk\hadoop-trunk\hadoop-yarn-project\hadoop-yarn\hadoop-yarn-server\hadoop-yarn-server-timelineservice-documentstore\src\test\java\org\apache\hadoop\yarn\server\timelineservice\documentstore\reader\DummyDocumentStoreReader.java,0,21,3,7,0,31
hadoop-trunk\hadoop-trunk\hadoop-common-project\hadoop-common\src\test\java\org\apache\hadoop\cli\util\CLICommandFS.java,3,0,0,1,0,1
hadoop-trunk\hadoop-trunk\hadoop-hdfs-project\hadoop-hdfs-client\src\main\java\org\apache\hadoop\hdfs\protocol\datatransfer\sasl\DataEncryptionKeyFactory.java,0,1,0,1,0,2
hadoop-trunk\hadoop-trunk\hadoop-mapreduce-project\hadoop-mapreduce-client\hadoop-mapreduce-client-jobclient\src\test\java\org\apache\hadoop\mapred\TestResourceMgrDelegate.java,105,7,0,3,0,10
hadoop-trunk\hadoop-trunk\hadoop-hdfs-project\hadoop-hdfs\src\main\java\org\apache\hadoop\hdfs\server\namenode\FSImageTransactionalStorageInspector.java,0,24,6,1,0,31
hadoop-trunk\hadoop-trunk\hadoop-yarn-project\hadoop-yarn\hadoop-yarn-common\src\main\java\org\apache\hadoop\yarn\api\records\impl\pb\ResourcePBImpl.java,232,44,39,1,0,84
hadoop-trunk\hadoop-trunk\hadoop-hdfs-project\hadoop-hdfs\src\main\java\org\apache\hadoop\hdfs\server\datanode\BPServiceActorActionException.java,17,6,0,1,0,7
hadoop-trunk\hadoop-trunk\hadoop-tools\hadoop-aws\src\main\java\org\apache\hadoop\fs\s3a\S3AInputPolicy.java,0,9,2,1,0,12
hadoop-trunk\hadoop-trunk\hadoop-yarn-project\hadoop-yarn\hadoop-yarn-server\hadoop-yarn-server-common\src\main\java\org\apache\hadoop\yarn\server\api\protocolrecords\ReportNewCollectorInfoResponse.java,11,1,1,1,0,3
hadoop-trunk\hadoop-trunk\hadoop-common-project\hadoop-common\src\main\java\org\apache\hadoop\io\TwoDArrayWritable.java,0,26,9,1,0,36
hadoop-trunk\hadoop-trunk\hadoop-mapreduce-project\hadoop-mapreduce-examples\src\main\java\org\apache\hadoop\examples\pi\Util.java,283,234,32,19,0,285
hadoop-trunk\hadoop-trunk\hadoop-tools\hadoop-fs2img\src\main\java\org\apache\hadoop\hdfs\server\namenode\BlockResolver.java,67,10,9,1,0,20
hadoop-trunk\hadoop-trunk\hadoop-hdfs-project\hadoop-hdfs\src\test\java\org\apache\hadoop\hdfs\server\namenode\TestQuotaCounts.java,107,26,0,1,0,27
hadoop-trunk\hadoop-trunk\hadoop-hdfs-project\hadoop-hdfs-rbf\src\test\java\org\apache\hadoop\hdfs\server\federation\store\driver\TestStateStoreFileBase.java,17,2,0,2,0,4
hadoop-trunk\hadoop-trunk\hadoop-tools\hadoop-distcp\src\main\java\org\apache\hadoop\tools\SimpleCopyListing.java,745,138,27,9,0,174
hadoop-trunk\hadoop-trunk\hadoop-yarn-project\hadoop-yarn\hadoop-yarn-server\hadoop-yarn-server-sharedcachemanager\src\test\java\org\apache\hadoop\yarn\server\sharedcachemanager\store\SCMStoreBaseTest.java,15,4,1,1,0,6
hadoop-trunk\hadoop-trunk\hadoop-hdfs-project\hadoop-hdfs\src\main\java\org\apache\hadoop\hdfs\server\namenode\FSEditLogAsync.java,0,75,4,1,0,80
hadoop-trunk\hadoop-trunk\hadoop-yarn-project\hadoop-yarn\hadoop-yarn-server\hadoop-yarn-server-resourcemanager\src\main\java\org\apache\hadoop\yarn\server\resourcemanager\placement\QueuePlacementRuleUtils.java,0,29,0,6,0,35
hadoop-trunk\hadoop-trunk\hadoop-tools\hadoop-azure\src\test\java\org\apache\hadoop\fs\azure\ITestReadAndSeekPageBlobAfterWrite.java,300,82,21,18,0,121
hadoop-trunk\hadoop-trunk\hadoop-yarn-project\hadoop-yarn\hadoop-yarn-server\hadoop-yarn-server-nodemanager\src\test\java\org\apache\hadoop\yarn\server\nodemanager\containermanager\linux\runtime\TestDockerContainerRuntime.java,2459,199,63,47,0,309
hadoop-trunk\hadoop-trunk\hadoop-hdfs-project\hadoop-hdfs-httpfs\src\test\java\org\apache\hadoop\fs\http\server\TestHttpFSServerNoXAttrs.java,196,14,6,1,0,21
hadoop-trunk\hadoop-trunk\hadoop-yarn-project\hadoop-yarn\hadoop-yarn-client\src\test\java\org\apache\hadoop\yarn\client\TestApplicationMasterServiceProtocolForTimelineV2.java,0,8,0,2,0,10
hadoop-trunk\hadoop-trunk\hadoop-yarn-project\hadoop-yarn\hadoop-yarn-common\src\main\java\org\apache\hadoop\yarn\client\AHSProxy.java,24,6,2,2,0,10
hadoop-trunk\hadoop-trunk\hadoop-tools\hadoop-streaming\src\main\java\org\apache\hadoop\streaming\io\TextInputWriter.java,0,16,0,1,0,17
hadoop-trunk\hadoop-trunk\hadoop-yarn-project\hadoop-yarn\hadoop-yarn-server\hadoop-yarn-server-nodemanager\src\main\java\org\apache\hadoop\yarn\server\nodemanager\containermanager\container\SlidingWindowRetryPolicy.java,145,25,1,1,0,27
hadoop-trunk\hadoop-trunk\hadoop-yarn-project\hadoop-yarn\hadoop-yarn-server\hadoop-yarn-server-resourcemanager\src\main\java\org\apache\hadoop\yarn\server\resourcemanager\scheduler\constraint\AllocationTags.java,0,22,0,1,0,23
hadoop-trunk\hadoop-trunk\hadoop-yarn-project\hadoop-yarn\hadoop-yarn-applications\hadoop-yarn-services\hadoop-yarn-services-core\src\main\java\org\apache\hadoop\yarn\service\api\records\PlacementType.java,0,3,0,1,0,4
hadoop-trunk\hadoop-trunk\hadoop-common-project\hadoop-common\src\main\java\org\apache\hadoop\fs\TrashPolicyDefault.java,354,89,26,6,0,121
hadoop-trunk\hadoop-trunk\hadoop-hdfs-project\hadoop-hdfs\src\main\java\org\apache\hadoop\hdfs\server\namenode\StreamLimiter.java,0,5,2,1,0,8
hadoop-trunk\hadoop-trunk\hadoop-tools\hadoop-aws\src\test\java\org\apache\hadoop\fs\s3a\TestS3AGetFileStatus.java,130,14,1,1,0,16
hadoop-trunk\hadoop-trunk\hadoop-yarn-project\hadoop-yarn\hadoop-yarn-server\hadoop-yarn-server-timelineservice-documentstore\src\main\java\org\apache\hadoop\yarn\server\timelineservice\documentstore\reader\TimelineCollectionReader.java,174,18,3,10,0,31
hadoop-trunk\hadoop-trunk\hadoop-common-project\hadoop-common\src\main\java\org\apache\hadoop\fs\FSDataOutputStream.java,0,34,1,1,0,36
hadoop-trunk\hadoop-trunk\hadoop-hdfs-project\hadoop-hdfs\src\main\java\org\apache\hadoop\hdfs\SWebHdfsDtFetcher.java,12,3,2,1,0,6
hadoop-trunk\hadoop-trunk\hadoop-hdfs-project\hadoop-hdfs\src\main\java\org\apache\hadoop\hdfs\server\namenode\INodeReference.java,810,203,2,2,0,207
hadoop-trunk\hadoop-trunk\hadoop-common-project\hadoop-common\src\main\java\org\apache\hadoop\ha\HAAdmin.java,497,132,1,6,0,139
hadoop-trunk\hadoop-trunk\hadoop-hdfs-project\hadoop-hdfs\src\main\java\org\apache\hadoop\hdfs\server\namenode\snapshot\Snapshot.java,235,69,0,6,0,75
hadoop-trunk\hadoop-trunk\hadoop-tools\hadoop-openstack\src\test\java\org\apache\hadoop\fs\swift\contract\TestSwiftContractDelete.java,8,2,0,1,0,3
hadoop-trunk\hadoop-trunk\hadoop-tools\hadoop-distcp\src\test\java\org\apache\hadoop\tools\util\TestProducerConsumer.java,162,49,14,2,0,65
hadoop-trunk\hadoop-trunk\hadoop-common-project\hadoop-common\src\test\java\org\apache\hadoop\service\launcher\testservices\NoArgsAllowedService.java,32,8,3,1,0,12
hadoop-trunk\hadoop-trunk\hadoop-mapreduce-project\hadoop-mapreduce-client\hadoop-mapreduce-client-core\src\main\java\org\apache\hadoop\mapreduce\CustomJobEndNotifier.java,0,0,0,1,0,1
hadoop-trunk\hadoop-trunk\hadoop-yarn-project\hadoop-yarn\hadoop-yarn-server\hadoop-yarn-server-nodemanager\src\test\java\org\apache\hadoop\yarn\server\nodemanager\containermanager\deletion\task\FileDeletionMatcher.java,57,19,3,2,0,24
hadoop-trunk\hadoop-trunk\hadoop-yarn-project\hadoop-yarn\hadoop-yarn-common\src\main\java\org\apache\hadoop\yarn\api\ApplicationMasterProtocolPB.java,0,2,2,4,0,8
hadoop-trunk\hadoop-trunk\hadoop-yarn-project\hadoop-yarn\hadoop-yarn-server\hadoop-yarn-server-router\src\main\java\org\apache\hadoop\yarn\server\router\webapp\AbstractRESTRequestInterceptor.java,0,8,0,1,0,9
hadoop-trunk\hadoop-trunk\hadoop-mapreduce-project\hadoop-mapreduce-client\hadoop-mapreduce-client-common\src\test\java\org\apache\hadoop\mapreduce\v2\api\records\TestIds.java,111,36,25,1,0,62
hadoop-trunk\hadoop-trunk\hadoop-common-project\hadoop-common\src\main\java\org\apache\hadoop\fs\MD5MD5CRC32CastagnoliFileChecksum.java,18,11,0,2,0,13
hadoop-trunk\hadoop-trunk\hadoop-hdfs-project\hadoop-hdfs\src\test\java\org\apache\hadoop\hdfs\server\datanode\fsdataset\impl\TestLazyPersistLockedMemory.java,156,14,12,2,0,28
hadoop-trunk\hadoop-trunk\hadoop-common-project\hadoop-common\src\test\java\org\apache\hadoop\fs\TestDU.java,0,33,9,3,0,45
hadoop-trunk\hadoop-trunk\hadoop-hdfs-project\hadoop-hdfs\src\main\java\org\apache\hadoop\hdfs\tools\DFSAdmin.java,2527,667,32,40,0,739
hadoop-trunk\hadoop-trunk\hadoop-yarn-project\hadoop-yarn\hadoop-yarn-server\hadoop-yarn-server-nodemanager\src\test\java\org\apache\hadoop\yarn\server\nodemanager\containermanager\TestContainerManagerRecovery.java,992,91,17,26,0,134
hadoop-trunk\hadoop-trunk\hadoop-yarn-project\hadoop-yarn\hadoop-yarn-server\hadoop-yarn-server-nodemanager\src\main\java\org\apache\hadoop\yarn\server\nodemanager\containermanager\linux\runtime\runc\RuncImageTagToManifestPlugin.java,0,3,0,3,0,6
hadoop-trunk\hadoop-trunk\hadoop-common-project\hadoop-common\src\main\java\org\apache\hadoop\util\Progress.java,224,70,6,2,0,78
hadoop-trunk\hadoop-trunk\hadoop-yarn-project\hadoop-yarn\hadoop-yarn-server\hadoop-yarn-server-nodemanager\src\main\java\org\apache\hadoop\yarn\server\nodemanager\containermanager\localizer\event\ResourceRequestEvent.java,22,12,0,4,0,16
hadoop-trunk\hadoop-trunk\hadoop-hdfs-project\hadoop-hdfs\src\test\java\org\apache\hadoop\hdfs\qjournal\client\TestQuorumJournalManager.java,1131,318,19,9,0,346
hadoop-trunk\hadoop-trunk\hadoop-common-project\hadoop-common\src\main\java\org\apache\hadoop\fs\MultipartUploader.java,71,1,0,2,0,3
hadoop-trunk\hadoop-trunk\hadoop-tools\hadoop-sls\src\main\java\org\apache\hadoop\yarn\sls\RumenToSLSConverter.java,186,29,31,3,0,63
hadoop-trunk\hadoop-trunk\hadoop-tools\hadoop-aws\src\test\java\org\apache\hadoop\fs\s3a\commit\magic\ITestMagicCommitProtocol.java,214,32,7,1,0,40
hadoop-trunk\hadoop-trunk\hadoop-yarn-project\hadoop-yarn\hadoop-yarn-server\hadoop-yarn-server-nodemanager\src\main\java\org\apache\hadoop\yarn\server\nodemanager\containermanager\application\ApplicationEvent.java,16,6,0,1,0,7
hadoop-trunk\hadoop-trunk\hadoop-mapreduce-project\hadoop-mapreduce-client\hadoop-mapreduce-client-app\src\main\java\org\apache\hadoop\mapreduce\v2\app\job\Task.java,0,11,0,1,0,12
hadoop-trunk\hadoop-trunk\hadoop-mapreduce-project\hadoop-mapreduce-client\hadoop-mapreduce-client-core\src\main\java\org\apache\hadoop\mapreduce\MarkableIteratorInterface.java,0,8,1,1,0,10
hadoop-trunk\hadoop-trunk\hadoop-common-project\hadoop-common\src\main\java\org\apache\hadoop\crypto\JceSm4CtrCryptoCodec.java,37,10,2,1,0,13
hadoop-trunk\hadoop-trunk\hadoop-hdfs-project\hadoop-hdfs\src\test\java\org\apache\hadoop\fs\loadGenerator\TestLoadGenerator.java,229,74,18,7,0,99
hadoop-trunk\hadoop-trunk\hadoop-common-project\hadoop-common\src\test\java\org\apache\hadoop\io\compress\CompressDecompressTester.java,0,116,20,7,0,143
hadoop-trunk\hadoop-trunk\hadoop-yarn-project\hadoop-yarn\hadoop-yarn-server\hadoop-yarn-server-timelineservice\src\main\java\org\apache\hadoop\yarn\server\timelineservice\storage\FileSystemTimelineWriterImpl.java,0,48,6,3,0,57
hadoop-trunk\hadoop-trunk\hadoop-hdfs-project\hadoop-hdfs\src\test\java\org\apache\hadoop\hdfs\server\datanode\fsdataset\TestRoundRobinVolumeChoosingPolicy.java,176,35,3,3,0,41
hadoop-trunk\hadoop-trunk\hadoop-mapreduce-project\hadoop-mapreduce-client\hadoop-mapreduce-client-core\src\main\java\org\apache\hadoop\mapreduce\lib\input\KeyValueLineRecordReader.java,0,47,2,2,0,51
hadoop-trunk\hadoop-trunk\hadoop-yarn-project\hadoop-yarn\hadoop-yarn-common\src\main\java\org\apache\hadoop\yarn\server\api\protocolrecords\impl\pb\RefreshAdminAclsResponsePBImpl.java,42,23,18,4,0,45
hadoop-trunk\hadoop-trunk\hadoop-tools\hadoop-rumen\src\main\java\org\apache\hadoop\tools\rumen\TaskInfo.java,92,60,0,1,0,61
hadoop-trunk\hadoop-trunk\hadoop-hdfs-project\hadoop-hdfs\src\main\java\org\apache\hadoop\hdfs\server\datanode\fsdataset\impl\MappableBlockLoaderFactory.java,0,3,0,1,0,4
hadoop-trunk\hadoop-trunk\hadoop-cloud-storage-project\hadoop-cos\src\main\java\org\apache\hadoop\fs\cosn\auth\NoAuthWithCOSException.java,14,7,0,1,0,8
hadoop-trunk\hadoop-trunk\hadoop-tools\hadoop-distcp\src\main\java\org\apache\hadoop\tools\GlobbedCopyListing.java,69,16,3,5,0,24
hadoop-trunk\hadoop-trunk\hadoop-yarn-project\hadoop-yarn\hadoop-yarn-common\src\test\java\org\apache\hadoop\yarn\nodelabels\TestNodeLabelUtil.java,93,2,1,1,0,4
hadoop-trunk\hadoop-trunk\hadoop-hdfs-project\hadoop-hdfs\src\test\java\org\apache\hadoop\hdfs\server\datanode\TestBlockPoolManager.java,179,35,6,2,0,43
hadoop-trunk\hadoop-trunk\hadoop-common-project\hadoop-common\src\test\java\org\apache\hadoop\fs\loadGenerator\DataGenerator.java,115,58,6,1,0,65
hadoop-trunk\hadoop-trunk\hadoop-mapreduce-project\hadoop-mapreduce-client\hadoop-mapreduce-client-hs\src\main\java\org\apache\hadoop\mapreduce\v2\hs\HSProxies.java,60,24,2,7,0,33
hadoop-trunk\hadoop-trunk\hadoop-yarn-project\hadoop-yarn\hadoop-yarn-api\src\main\java\org\apache\hadoop\yarn\api\protocolrecords\GetContainerReportRequest.java,31,6,0,1,0,7
hadoop-trunk\hadoop-trunk\hadoop-common-project\hadoop-common\src\test\java\org\apache\hadoop\fs\TestFsOptions.java,43,17,1,3,0,21
hadoop-trunk\hadoop-trunk\hadoop-yarn-project\hadoop-yarn\hadoop-yarn-server\hadoop-yarn-server-resourcemanager\src\test\java\org\apache\hadoop\yarn\server\resourcemanager\scheduler\placement\TestSingleConstraintAppPlacementAllocator.java,471,72,13,11,0,96
hadoop-trunk\hadoop-trunk\hadoop-yarn-project\hadoop-yarn\hadoop-yarn-server\hadoop-yarn-server-common\src\main\java\org\apache\hadoop\yarn\server\RMNMSecurityInfoClass.java,33,6,0,1,0,7
hadoop-trunk\hadoop-trunk\hadoop-hdfs-project\hadoop-hdfs-rbf\src\main\java\org\apache\hadoop\hdfs\server\federation\store\protocol\RefreshMountTableEntriesResponse.java,17,4,0,2,0,6
hadoop-trunk\hadoop-trunk\hadoop-yarn-project\hadoop-yarn\hadoop-yarn-api\src\main\java\org\apache\hadoop\yarn\api\records\ContainerExitStatus.java,59,4,0,1,0,5
hadoop-trunk\hadoop-trunk\hadoop-common-project\hadoop-common\src\test\java\org\apache\hadoop\io\nativeio\TestSharedFileDescriptorFactory.java,80,36,4,1,0,41
hadoop-trunk\hadoop-trunk\hadoop-hdfs-project\hadoop-hdfs\src\test\java\org\apache\hadoop\hdfs\server\blockmanagement\BlockManagerTestUtil.java,400,114,11,9,0,134
hadoop-trunk\hadoop-trunk\hadoop-hdfs-project\hadoop-hdfs-client\src\main\java\org\apache\hadoop\hdfs\web\resources\EnumParam.java,0,6,2,1,0,9
hadoop-trunk\hadoop-trunk\hadoop-yarn-project\hadoop-yarn\hadoop-yarn-server\hadoop-yarn-server-nodemanager\src\main\java\org\apache\hadoop\yarn\server\nodemanager\nodelabels\NodeDescriptorsProvider.java,0,2,0,1,0,3
hadoop-trunk\hadoop-trunk\hadoop-tools\hadoop-aliyun\src\main\java\org\apache\hadoop\fs\aliyun\oss\AliyunOSSInputStream.java,279,53,2,3,0,58
hadoop-trunk\hadoop-trunk\hadoop-yarn-project\hadoop-yarn\hadoop-yarn-common\src\main\java\org\apache\hadoop\yarn\api\protocolrecords\impl\pb\StartContainerRequestPBImpl.java,132,51,47,9,0,107
hadoop-trunk\hadoop-trunk\hadoop-yarn-project\hadoop-yarn\hadoop-yarn-server\hadoop-yarn-server-resourcemanager\src\main\java\org\apache\hadoop\yarn\server\resourcemanager\scheduler\NodeType.java,0,6,0,1,0,7
hadoop-trunk\hadoop-trunk\hadoop-hdfs-project\hadoop-hdfs\src\test\java\org\apache\hadoop\hdfs\server\namenode\TestAuditLoggerWithCommands.java,1233,152,58,2,0,212
hadoop-trunk\hadoop-trunk\hadoop-yarn-project\hadoop-yarn\hadoop-yarn-common\src\main\java\org\apache\hadoop\yarn\api\records\impl\pb\ResourceOptionPBImpl.java,86,31,38,1,0,70
hadoop-trunk\hadoop-trunk\hadoop-tools\hadoop-resourceestimator\src\main\java\org\apache\hadoop\resourceestimator\translator\exceptions\package-info.java,0,1,0,1,0,2
hadoop-trunk\hadoop-trunk\hadoop-yarn-project\hadoop-yarn\hadoop-yarn-server\hadoop-yarn-server-resourcemanager\src\main\java\org\apache\hadoop\yarn\server\resourcemanager\rmapp\RMAppRecoverEvent.java,14,7,0,2,0,9
hadoop-trunk\hadoop-trunk\hadoop-hdfs-project\hadoop-hdfs\src\test\java\org\apache\hadoop\hdfs\server\namenode\TestEditLog.java,1775,453,54,28,0,535
hadoop-trunk\hadoop-trunk\hadoop-yarn-project\hadoop-yarn\hadoop-yarn-server\hadoop-yarn-server-common\src\test\java\org\apache\hadoop\yarn\server\federation\policies\manager\TestHashBasedBroadcastPolicyManager.java,15,1,0,3,0,4
hadoop-trunk\hadoop-trunk\hadoop-common-project\hadoop-common\src\test\java\org\apache\hadoop\service\TestServiceLifecycle.java,439,51,20,3,0,74
hadoop-trunk\hadoop-trunk\hadoop-common-project\hadoop-common\src\main\java\org\apache\hadoop\io\serializer\DeserializerComparator.java,33,20,0,1,0,21
hadoop-trunk\hadoop-trunk\hadoop-yarn-project\hadoop-yarn\hadoop-yarn-server\hadoop-yarn-server-common\src\main\java\org\apache\hadoop\yarn\server\federation\resolver\SubClusterResolver.java,0,0,0,1,0,1
hadoop-trunk\hadoop-trunk\hadoop-common-project\hadoop-common\src\main\java\org\apache\hadoop\util\bloom\DynamicBloomFilter.java,207,62,5,7,0,74
hadoop-trunk\hadoop-trunk\hadoop-yarn-project\hadoop-yarn\hadoop-yarn-common\src\test\java\org\apache\hadoop\yarn\util\TestResourceCalculatorProcessTree.java,64,31,8,3,0,42
hadoop-trunk\hadoop-trunk\hadoop-common-project\hadoop-common\src\test\java\org\apache\hadoop\ipc\TestRpcWritable.java,0,11,8,1,0,20
hadoop-trunk\hadoop-trunk\hadoop-common-project\hadoop-common\src\test\java\org\apache\hadoop\util\ClassLoaderCheckSecond.java,0,3,0,1,0,4
hadoop-trunk\hadoop-trunk\hadoop-mapreduce-project\hadoop-mapreduce-client\hadoop-mapreduce-client-core\src\main\java\org\apache\hadoop\mapreduce\lib\db\DBSplitter.java,0,7,0,4,0,11
hadoop-trunk\hadoop-trunk\hadoop-yarn-project\hadoop-yarn\hadoop-yarn-server\hadoop-yarn-server-applicationhistoryservice\src\main\java\org\apache\hadoop\yarn\server\applicationhistoryservice\webapp\AHSWebApp.java,41,13,0,2,0,15
hadoop-trunk\hadoop-trunk\hadoop-yarn-project\hadoop-yarn\hadoop-yarn-server\hadoop-yarn-server-timelineservice-hbase-tests\src\test\java\org\apache\hadoop\yarn\server\timelineservice\storage\TestTimelineWriterHBaseDown.java,80,20,2,3,0,25
hadoop-trunk\hadoop-trunk\hadoop-tools\hadoop-sls\src\main\java\org\apache\hadoop\yarn\sls\NMRunner.java,191,66,1,2,0,69
hadoop-trunk\hadoop-trunk\hadoop-mapreduce-project\hadoop-mapreduce-client\hadoop-mapreduce-client-jobclient\src\test\java\org\apache\hadoop\mapreduce\RandomWriter.java,221,150,8,2,0,160
hadoop-trunk\hadoop-trunk\hadoop-tools\hadoop-azure\src\main\java\org\apache\hadoop\fs\azure\PageBlobOutputStream.java,0,41,17,8,0,66
hadoop-trunk\hadoop-trunk\hadoop-common-project\hadoop-common\src\main\java\org\apache\hadoop\util\Classpath.java,0,9,3,2,0,14
hadoop-trunk\hadoop-trunk\hadoop-hdfs-project\hadoop-hdfs\src\test\java\org\apache\hadoop\hdfs\tools\TestDFSAdminWithHA.java,751,120,1,2,0,123
hadoop-trunk\hadoop-trunk\hadoop-tools\hadoop-gridmix\src\main\java\org\apache\hadoop\mapred\gridmix\EchoUserResolver.java,28,9,0,1,0,10
hadoop-trunk\hadoop-trunk\hadoop-common-project\hadoop-common\src\test\java\org\apache\hadoop\test\MockitoUtil.java,39,4,0,1,0,5
hadoop-trunk\hadoop-trunk\hadoop-hdfs-project\hadoop-hdfs-rbf\src\main\java\org\apache\hadoop\hdfs\server\federation\store\records\impl\pb\package-info.java,0,2,0,1,0,3
hadoop-trunk\hadoop-trunk\hadoop-common-project\hadoop-common\src\main\java\org\apache\hadoop\io\retry\DefaultFailoverProxyProvider.java,32,16,0,2,0,18
hadoop-trunk\hadoop-trunk\hadoop-hdfs-project\hadoop-hdfs\src\test\java\org\apache\hadoop\hdfs\server\namenode\TestBackupNode.java,0,107,23,7,0,137
hadoop-trunk\hadoop-trunk\hadoop-common-project\hadoop-common\src\main\java\org\apache\hadoop\crypto\CipherOption.java,41,39,0,1,0,40
hadoop-trunk\hadoop-trunk\hadoop-mapreduce-project\hadoop-mapreduce-client\hadoop-mapreduce-client-core\src\test\java\org\apache\hadoop\mapreduce\lib\jobcontrol\TestJobControl.java,0,3,3,1,0,7
hadoop-trunk\hadoop-trunk\hadoop-mapreduce-project\hadoop-mapreduce-client\hadoop-mapreduce-client-app\src\main\java\org\apache\hadoop\mapreduce\v2\app\rm\ResourceCalculatorUtils.java,37,17,1,4,0,22
hadoop-trunk\hadoop-trunk\hadoop-mapreduce-project\hadoop-mapreduce-client\hadoop-mapreduce-client-core\src\test\java\org\apache\hadoop\mapreduce\task\reduce\TestMerger.java,336,84,5,11,0,100
hadoop-trunk\hadoop-trunk\hadoop-yarn-project\hadoop-yarn\hadoop-yarn-server\hadoop-yarn-server-resourcemanager\src\main\java\org\apache\hadoop\yarn\server\resourcemanager\webapp\RMAppBlock.java,167,22,1,2,0,25
hadoop-trunk\hadoop-trunk\hadoop-tools\hadoop-azure\src\test\java\org\apache\hadoop\fs\azurebfs\commit\ITestAbfsCommitTaskStage.java,26,5,0,2,0,7
hadoop-trunk\hadoop-trunk\hadoop-hdfs-project\hadoop-hdfs-rbf\src\main\java\org\apache\hadoop\hdfs\server\federation\store\protocol\GetMountTableEntriesRequest.java,22,6,0,2,0,8
hadoop-trunk\hadoop-trunk\hadoop-yarn-project\hadoop-yarn\hadoop-yarn-server\hadoop-yarn-server-resourcemanager\src\main\java\org\apache\hadoop\yarn\server\resourcemanager\scheduler\capacity\UserInfo.java,64,49,1,1,0,51
hadoop-trunk\hadoop-trunk\hadoop-hdfs-project\hadoop-hdfs\src\main\java\org\apache\hadoop\hdfs\server\namenode\MetaRecoveryContext.java,0,40,4,1,0,45
hadoop-trunk\hadoop-trunk\hadoop-tools\hadoop-gridmix\src\test\java\org\apache\hadoop\mapred\gridmix\TestRandomAlgorithm.java,101,27,4,2,0,33
hadoop-trunk\hadoop-trunk\hadoop-hdfs-project\hadoop-hdfs\src\test\java\org\apache\hadoop\hdfs\server\datanode\TestDataNodeInitStorage.java,50,16,7,1,0,24
hadoop-trunk\hadoop-trunk\hadoop-common-project\hadoop-common\src\main\java\org\apache\hadoop\util\UTF8ByteArrayUtils.java,0,53,1,4,0,58
hadoop-trunk\hadoop-trunk\hadoop-common-project\hadoop-common\src\main\java\org\apache\hadoop\security\token\TokenIdentifier.java,48,7,0,1,0,8
hadoop-trunk\hadoop-trunk\hadoop-common-project\hadoop-common\src\test\java\org\apache\hadoop\fs\TestDelegateToFsCheckPath.java,117,27,0,1,0,28
hadoop-trunk\hadoop-trunk\hadoop-tools\hadoop-aws\src\test\java\org\apache\hadoop\fs\s3a\ITestS3ACopyFromLocalFile.java,27,4,0,1,0,5
hadoop-trunk\hadoop-trunk\hadoop-yarn-project\hadoop-yarn\hadoop-yarn-server\hadoop-yarn-server-resourcemanager\src\test\java\org\apache\hadoop\yarn\server\resourcemanager\nodelabels\NullRMNodeLabelsManager.java,69,20,1,1,0,22
hadoop-trunk\hadoop-trunk\hadoop-tools\hadoop-azure\src\main\java\org\apache\hadoop\fs\azurebfs\contracts\exceptions\SASTokenProviderException.java,12,5,0,1,0,6
hadoop-trunk\hadoop-trunk\hadoop-mapreduce-project\hadoop-mapreduce-client\hadoop-mapreduce-client-app\src\main\java\org\apache\hadoop\mapreduce\v2\app\webapp\dao\JobCounterInfo.java,70,17,4,1,0,22
hadoop-trunk\hadoop-trunk\hadoop-tools\hadoop-aws\src\main\java\org\apache\hadoop\fs\s3a\Retries.java,78,8,0,1,0,9
hadoop-trunk\hadoop-trunk\hadoop-yarn-project\hadoop-yarn\hadoop-yarn-common\src\main\java\org\apache\hadoop\yarn\webapp\dao\ConfInfo.java,48,22,3,1,0,26
hadoop-trunk\hadoop-trunk\hadoop-yarn-project\hadoop-yarn\hadoop-yarn-api\src\main\java\org\apache\hadoop\yarn\api\protocolrecords\GetClusterMetricsRequest.java,10,4,1,1,0,6
hadoop-trunk\hadoop-trunk\hadoop-yarn-project\hadoop-yarn\hadoop-yarn-api\src\main\java\org\apache\hadoop\yarn\api\records\ApplicationAttemptId.java,134,30,7,2,0,39
hadoop-trunk\hadoop-trunk\hadoop-yarn-project\hadoop-yarn\hadoop-yarn-server\hadoop-yarn-server-common\src\main\java\org\apache\hadoop\yarn\server\federation\store\records\DeleteApplicationHomeSubClusterRequest.java,35,2,0,1,0,3
hadoop-trunk\hadoop-trunk\hadoop-yarn-project\hadoop-yarn\hadoop-yarn-api\src\main\java\org\apache\hadoop\yarn\api\protocolrecords\GetClusterNodeAttributesRequest.java,12,3,2,1,0,6
hadoop-trunk\hadoop-trunk\hadoop-hdfs-project\hadoop-hdfs-httpfs\src\test\java\org\apache\hadoop\fs\http\client\TestHttpFSFWithWebhdfsFileSystem.java,0,3,2,1,0,6
hadoop-trunk\hadoop-trunk\hadoop-tools\hadoop-archives\src\test\java\org\apache\hadoop\tools\TestHadoopArchives.java,748,153,21,17,0,191
hadoop-trunk\hadoop-trunk\hadoop-yarn-project\hadoop-yarn\hadoop-yarn-common\src\main\java\org\apache\hadoop\yarn\security\AMRMTokenSelector.java,32,7,1,1,0,9
hadoop-trunk\hadoop-trunk\hadoop-cloud-storage-project\hadoop-cos\src\main\java\org\apache\hadoop\fs\cosn\auth\package-info.java,0,0,0,1,0,1
hadoop-trunk\hadoop-trunk\hadoop-mapreduce-project\hadoop-mapreduce-client\hadoop-mapreduce-client-hs\src\main\java\org\apache\hadoop\mapreduce\v2\hs\webapp\dao\AMAttemptsInfo.java,18,8,4,1,0,13
hadoop-trunk\hadoop-trunk\hadoop-common-project\hadoop-common\src\main\java\org\apache\hadoop\crypto\key\KeyProviderTokenIssuer.java,0,3,0,1,0,4
hadoop-trunk\hadoop-trunk\hadoop-yarn-project\hadoop-yarn\hadoop-yarn-server\hadoop-yarn-server-common\src\test\java\org\apache\hadoop\yarn\server\federation\policies\manager\TestRejectAllPolicyManager.java,15,1,0,3,0,4
hadoop-trunk\hadoop-trunk\hadoop-common-project\hadoop-common\src\main\java\org\apache\hadoop\fs\viewfs\ConfigUtil.java,223,51,3,1,0,55
hadoop-trunk\hadoop-trunk\hadoop-hdfs-project\hadoop-hdfs\src\test\java\org\apache\hadoop\hdfs\server\datanode\TestBlockScanner.java,1096,260,52,10,0,322
hadoop-trunk\hadoop-trunk\hadoop-yarn-project\hadoop-yarn\hadoop-yarn-server\hadoop-yarn-server-resourcemanager\src\main\java\org\apache\hadoop\yarn\server\resourcemanager\reservation\ReservationSystem.java,0,18,0,3,0,21
hadoop-trunk\hadoop-trunk\hadoop-mapreduce-project\hadoop-mapreduce-client\hadoop-mapreduce-client-core\src\main\java\org\apache\hadoop\mapred\Merger.java,0,535,19,5,0,559
hadoop-trunk\hadoop-trunk\hadoop-tools\hadoop-aliyun\src\test\java\org\apache\hadoop\fs\aliyun\oss\contract\TestAliyunOSSContractSeek.java,27,17,0,1,0,18
hadoop-trunk\hadoop-trunk\hadoop-common-project\hadoop-common\src\test\java\org\apache\hadoop\metrics2\impl\ConfigUtil.java,0,16,4,1,0,21
hadoop-trunk\hadoop-trunk\hadoop-yarn-project\hadoop-yarn\hadoop-yarn-server\hadoop-yarn-server-resourcemanager\src\main\java\org\apache\hadoop\yarn\server\resourcemanager\scheduler\activities\GenericDiagnosticsCollector.java,57,29,0,1,0,30
hadoop-trunk\hadoop-trunk\hadoop-hdfs-project\hadoop-hdfs-client\src\main\java\org\apache\hadoop\fs\WebHdfs.java,30,5,0,1,0,6
hadoop-trunk\hadoop-trunk\hadoop-yarn-project\hadoop-yarn\hadoop-yarn-applications\hadoop-yarn-services\hadoop-yarn-services-core\src\main\java\org\apache\hadoop\yarn\service\conf\SliderExitCodes.java,0,15,12,1,0,28
hadoop-trunk\hadoop-trunk\hadoop-yarn-project\hadoop-yarn\hadoop-yarn-server\hadoop-yarn-server-resourcemanager\src\main\java\org\apache\hadoop\yarn\server\resourcemanager\scheduler\policy\AbstractComparatorOrderingPolicy.java,112,56,5,2,0,63
hadoop-trunk\hadoop-trunk\hadoop-yarn-project\hadoop-yarn\hadoop-yarn-common\src\main\java\org\apache\hadoop\yarn\factory\providers\package-info.java,0,1,0,1,0,2
hadoop-trunk\hadoop-trunk\hadoop-yarn-project\hadoop-yarn\hadoop-yarn-server\hadoop-yarn-server-router\src\test\java\org\apache\hadoop\yarn\server\router\clientrm\TestRouterClientRMService.java,223,6,1,3,0,10
hadoop-trunk\hadoop-trunk\hadoop-mapreduce-project\hadoop-mapreduce-client\hadoop-mapreduce-client-jobclient\src\test\java\org\apache\hadoop\fs\slive\SliveTest.java,268,38,9,2,0,49
hadoop-trunk\hadoop-trunk\hadoop-yarn-project\hadoop-yarn\hadoop-yarn-applications\hadoop-yarn-services\hadoop-yarn-services-core\src\main\java\org\apache\hadoop\yarn\service\timelineservice\ServiceTimelineEvent.java,0,7,0,1,0,8
hadoop-trunk\hadoop-trunk\hadoop-tools\hadoop-federation-balance\src\main\java\org\apache\hadoop\tools\fedbalance\procedure\BalanceProcedureScheduler.java,386,52,31,4,0,87
hadoop-trunk\hadoop-trunk\hadoop-yarn-project\hadoop-yarn\hadoop-yarn-server\hadoop-yarn-server-nodemanager\src\test\java\org\apache\hadoop\yarn\server\nodemanager\containermanager\localizer\MockLocalizerHeartbeatResponse.java,0,18,0,3,0,21
hadoop-trunk\hadoop-trunk\hadoop-yarn-project\hadoop-yarn\hadoop-yarn-client\src\test\java\org\apache\hadoop\yarn\client\TestResourceTrackerOnHA.java,56,12,0,2,0,14
hadoop-trunk\hadoop-trunk\hadoop-mapreduce-project\hadoop-mapreduce-client\hadoop-mapreduce-client-core\src\main\java\org\apache\hadoop\mapreduce\task\reduce\MergeManager.java,0,16,25,1,0,42
hadoop-trunk\hadoop-trunk\hadoop-mapreduce-project\hadoop-mapreduce-client\hadoop-mapreduce-client-jobclient\src\test\java\org\apache\hadoop\mapreduce\lib\join\TestJoinTupleWritable.java,266,106,5,1,0,112
hadoop-trunk\hadoop-trunk\hadoop-hdfs-project\hadoop-hdfs-client\src\main\java\org\apache\hadoop\hdfs\util\CombinedHostsFileWriter.java,0,0,0,1,0,1
hadoop-trunk\hadoop-trunk\hadoop-yarn-project\hadoop-yarn\hadoop-yarn-server\hadoop-yarn-server-common\src\main\java\org\apache\hadoop\yarn\server\federation\store\records\SetSubClusterPolicyConfigurationResponse.java,6,2,0,1,0,3
hadoop-trunk\hadoop-trunk\hadoop-hdfs-project\hadoop-hdfs-client\src\main\java\org\apache\hadoop\hdfs\server\namenode\ha\ObserverReadProxyProvider.java,0,45,12,2,0,59
hadoop-trunk\hadoop-trunk\hadoop-yarn-project\hadoop-yarn\hadoop-yarn-server\hadoop-yarn-server-timelineservice-hbase\hadoop-yarn-server-timelineservice-hbase-client\src\main\java\org\apache\hadoop\yarn\server\timelineservice\storage\common\TimelineHBaseSchemaConstants.java,0,3,1,1,0,5
hadoop-trunk\hadoop-trunk\hadoop-hdfs-project\hadoop-hdfs\src\test\java\org\apache\hadoop\hdfs\server\blockmanagement\TestAvailableSpaceBPPBalanceLocal.java,123,36,1,4,0,41
hadoop-trunk\hadoop-trunk\hadoop-tools\hadoop-azure\src\main\java\org\apache\hadoop\fs\azurebfs\services\AbfsClientContext.java,28,15,0,1,0,16
hadoop-trunk\hadoop-trunk\hadoop-common-project\hadoop-annotations\src\main\java\org\apache\hadoop\classification\tools\IncludePublicAnnotationsJDiffDoclet.java,29,10,1,2,0,13
hadoop-trunk\hadoop-trunk\hadoop-cloud-storage-project\hadoop-cos\src\test\java\org\apache\hadoop\fs\cosn\contract\TestCosNContractDistCp.java,27,7,0,1,0,8
hadoop-trunk\hadoop-trunk\hadoop-tools\hadoop-streaming\src\main\java\org\apache\hadoop\streaming\StreamJob.java,1026,281,43,35,0,359
hadoop-trunk\hadoop-trunk\hadoop-common-project\hadoop-common\src\main\java\org\apache\hadoop\io\compress\SplittableCompressionCodec.java,0,5,2,1,0,8
hadoop-trunk\hadoop-trunk\hadoop-yarn-project\hadoop-yarn\hadoop-yarn-api\src\main\java\org\apache\hadoop\yarn\api\protocolrecords\package-info.java,0,1,0,1,0,2
hadoop-trunk\hadoop-trunk\hadoop-yarn-project\hadoop-yarn\hadoop-yarn-server\hadoop-yarn-server-common\src\main\java\org\apache\hadoop\yarn\server\metrics\package-info.java,0,1,0,1,0,2
hadoop-trunk\hadoop-trunk\hadoop-yarn-project\hadoop-yarn\hadoop-yarn-server\hadoop-yarn-server-resourcemanager\src\main\java\org\apache\hadoop\yarn\server\resourcemanager\scheduler\fair\converter\DryRunResultHolder.java,60,19,0,1,0,20
hadoop-trunk\hadoop-trunk\hadoop-yarn-project\hadoop-yarn\hadoop-yarn-common\src\main\java\org\apache\hadoop\yarn\api\records\impl\pb\ResourceTypeInfoPBImpl.java,118,28,37,1,0,66
hadoop-trunk\hadoop-trunk\hadoop-tools\hadoop-aws\src\main\java\org\apache\hadoop\fs\s3a\auth\delegation\EncryptionSecretOperations.java,0,2,0,2,0,4
hadoop-trunk\hadoop-trunk\hadoop-yarn-project\hadoop-yarn\hadoop-yarn-common\src\test\java\org\apache\hadoop\yarn\webapp\TestWebApp.java,377,81,6,2,0,89
hadoop-trunk\hadoop-trunk\hadoop-common-project\hadoop-common\src\main\java\org\apache\hadoop\fs\shell\PrintableString.java,0,3,0,1,0,4
hadoop-trunk\hadoop-trunk\hadoop-tools\hadoop-federation-balance\src\main\java\org\apache\hadoop\tools\fedbalance\procedure\BalanceJob.java,0,44,18,1,0,63
hadoop-trunk\hadoop-trunk\hadoop-tools\hadoop-gridmix\src\main\java\org\apache\hadoop\mapred\gridmix\ReplayJobFactory.java,0,15,3,2,0,20
hadoop-trunk\hadoop-trunk\hadoop-yarn-project\hadoop-yarn\hadoop-yarn-applications\hadoop-yarn-services\hadoop-yarn-services-core\src\main\java\org\apache\hadoop\yarn\service\api\records\Service.java,423,204,4,12,0,220
hadoop-trunk\hadoop-trunk\hadoop-mapreduce-project\hadoop-mapreduce-client\hadoop-mapreduce-client-core\src\main\java\org\apache\hadoop\mapreduce\lib\map\TokenCounterMapper.java,0,12,0,1,0,13
hadoop-trunk\hadoop-trunk\hadoop-common-project\hadoop-common\src\main\java\org\apache\hadoop\fs\statistics\impl\StatisticDurationTracker.java,0,8,1,1,0,10
hadoop-trunk\hadoop-trunk\hadoop-mapreduce-project\hadoop-mapreduce-client\hadoop-mapreduce-client-core\src\main\java\org\apache\hadoop\mapreduce\task\reduce\ShuffleClientMetrics.java,62,23,1,1,0,25
hadoop-trunk\hadoop-trunk\hadoop-tools\hadoop-aws\src\test\java\org\apache\hadoop\fs\s3a\ITestLocatedFileStatusFetcher.java,197,14,7,5,0,26
hadoop-trunk\hadoop-trunk\hadoop-mapreduce-project\hadoop-mapreduce-client\hadoop-mapreduce-client-core\src\main\java\org\apache\hadoop\mapreduce\checkpoint\FSCheckpointID.java,43,17,1,1,0,19
hadoop-trunk\hadoop-trunk\hadoop-tools\hadoop-resourceestimator\src\main\java\org\apache\hadoop\resourceestimator\skylinestore\exceptions\NullRLESparseResourceAllocationException.java,0,1,0,1,0,2
hadoop-trunk\hadoop-trunk\hadoop-yarn-project\hadoop-yarn\hadoop-yarn-client\src\main\java\org\apache\hadoop\yarn\client\api\async\impl\package-info.java,0,1,0,1,0,2
hadoop-trunk\hadoop-trunk\hadoop-yarn-project\hadoop-yarn\hadoop-yarn-server\hadoop-yarn-server-resourcemanager\src\main\java\org\apache\hadoop\yarn\server\resourcemanager\webapp\dao\CapacitySchedulerLeafQueueInfo.java,153,85,1,7,0,93
hadoop-trunk\hadoop-trunk\hadoop-yarn-project\hadoop-yarn\hadoop-yarn-server\hadoop-yarn-server-web-proxy\src\main\java\org\apache\hadoop\yarn\server\webproxy\amfilter\AmIpPrincipal.java,13,7,0,1,0,8
hadoop-trunk\hadoop-trunk\hadoop-hdfs-project\hadoop-hdfs-rbf\src\test\java\org\apache\hadoop\hdfs\server\federation\store\driver\TestStateStoreDriverBase.java,578,85,10,4,0,99
hadoop-trunk\hadoop-trunk\hadoop-yarn-project\hadoop-yarn\hadoop-yarn-applications\hadoop-yarn-services\hadoop-yarn-services-core\src\main\java\org\apache\hadoop\yarn\service\exceptions\LauncherExitCodes.java,0,22,23,1,0,46
hadoop-trunk\hadoop-trunk\hadoop-common-project\hadoop-common\src\test\java\org\apache\hadoop\util\TestLineReader.java,139,0,2,1,0,3
hadoop-trunk\hadoop-trunk\hadoop-yarn-project\hadoop-yarn\hadoop-yarn-server\hadoop-yarn-server-resourcemanager\src\main\java\org\apache\hadoop\yarn\server\resourcemanager\scheduler\fair\ConfigurableResource.java,111,17,0,1,0,18
hadoop-trunk\hadoop-trunk\hadoop-hdfs-project\hadoop-hdfs-client\src\main\java\org\apache\hadoop\hdfs\client\HdfsUtils.java,42,3,1,1,0,5
hadoop-trunk\hadoop-trunk\hadoop-common-project\hadoop-common\src\main\java\org\apache\hadoop\metrics2\impl\MetricGaugeLong.java,0,6,0,1,0,7
hadoop-trunk\hadoop-trunk\hadoop-yarn-project\hadoop-yarn\hadoop-yarn-server\hadoop-yarn-server-resourcemanager\src\main\java\org\apache\hadoop\yarn\server\resourcemanager\scheduler\capacity\CapacitySchedulerConfigValidator.java,0,40,4,15,0,59
hadoop-trunk\hadoop-trunk\hadoop-yarn-project\hadoop-yarn\hadoop-yarn-applications\hadoop-yarn-applications-catalog\hadoop-yarn-applications-catalog-webapp\src\main\java\org\apache\hadoop\yarn\appcatalog\model\Application.java,53,23,1,1,0,25
hadoop-trunk\hadoop-trunk\hadoop-common-project\hadoop-common\src\main\java\org\apache\hadoop\service\launcher\InterruptEscalator.java,0,21,6,2,0,29
hadoop-trunk\hadoop-trunk\hadoop-common-project\hadoop-common\src\main\java\org\apache\hadoop\fs\LocalFileSystemPathHandle.java,72,23,5,1,0,29
hadoop-trunk\hadoop-trunk\hadoop-yarn-project\hadoop-yarn\hadoop-yarn-common\src\main\java\org\apache\hadoop\yarn\nodelabels\store\op\NodeLabelMirrorOp.java,0,9,6,1,0,16
hadoop-trunk\hadoop-trunk\hadoop-hdfs-project\hadoop-hdfs\src\main\java\org\apache\hadoop\hdfs\server\datanode\fsdataset\LengthInputStream.java,24,8,0,1,0,9
hadoop-trunk\hadoop-trunk\hadoop-yarn-project\hadoop-yarn\hadoop-yarn-server\hadoop-yarn-server-nodemanager\src\main\java\org\apache\hadoop\yarn\server\nodemanager\webapp\ContainerShellWebSocketServlet.java,8,5,0,1,0,6
hadoop-trunk\hadoop-trunk\hadoop-mapreduce-project\hadoop-mapreduce-client\hadoop-mapreduce-client-core\src\main\java\org\apache\hadoop\mapreduce\lib\output\FilterOutputFormat.java,0,44,0,1,0,45
hadoop-trunk\hadoop-trunk\hadoop-mapreduce-project\hadoop-mapreduce-examples\src\main\java\org\apache\hadoop\examples\MultiFileWordCount.java,209,89,4,4,0,97
hadoop-trunk\hadoop-trunk\hadoop-tools\hadoop-openstack\src\test\java\org\apache\hadoop\fs\swift\scale\SwiftScaleTestBase.java,11,7,0,2,0,9
hadoop-trunk\hadoop-trunk\hadoop-yarn-project\hadoop-yarn\hadoop-yarn-server\hadoop-yarn-server-resourcemanager\src\main\java\org\apache\hadoop\yarn\server\resourcemanager\scheduler\fair\converter\ConversionOptions.java,86,47,0,1,0,48
hadoop-trunk\hadoop-trunk\hadoop-yarn-project\hadoop-yarn\hadoop-yarn-server\hadoop-yarn-server-router\src\main\java\org\apache\hadoop\yarn\server\router\webapp\NavBlock.java,22,2,0,1,0,3
hadoop-trunk\hadoop-trunk\hadoop-tools\hadoop-azure\src\main\java\org\apache\hadoop\fs\azurebfs\services\AbfsInputStreamStatistics.java,0,1,0,2,0,3
hadoop-trunk\hadoop-trunk\hadoop-hdfs-project\hadoop-hdfs\src\main\java\org\apache\hadoop\hdfs\server\datanode\erasurecode\StripedBlockChecksumReconstructor.java,0,22,0,1,0,23
hadoop-trunk\hadoop-trunk\hadoop-yarn-project\hadoop-yarn\hadoop-yarn-server\hadoop-yarn-server-nodemanager\src\test\java\org\apache\hadoop\yarn\server\nodemanager\webapp\TestNMContainerWebSocket.java,129,12,5,4,0,21
hadoop-trunk\hadoop-trunk\hadoop-yarn-project\hadoop-yarn\hadoop-yarn-server\hadoop-yarn-server-nodemanager\src\main\java\org\apache\hadoop\yarn\server\nodemanager\timelineservice\NMTimelineEvent.java,13,10,0,1,0,11
hadoop-trunk\hadoop-trunk\hadoop-common-project\hadoop-common\src\main\java\org\apache\hadoop\io\ArrayPrimitiveWritable.java,0,134,16,3,0,153
hadoop-trunk\hadoop-trunk\hadoop-common-project\hadoop-common\src\main\java\org\apache\hadoop\fs\local\RawLocalFs.java,47,12,0,1,0,13
hadoop-trunk\hadoop-trunk\hadoop-hdfs-project\hadoop-hdfs-rbf\src\main\java\org\apache\hadoop\hdfs\server\federation\router\Quota.java,325,29,3,1,0,33
hadoop-trunk\hadoop-trunk\hadoop-mapreduce-project\hadoop-mapreduce-client\hadoop-mapreduce-client-app\src\test\java\org\apache\hadoop\mapreduce\v2\app\speculate\forecast\TestSimpleExponentialForecast.java,92,41,3,1,0,45
hadoop-trunk\hadoop-trunk\hadoop-common-project\hadoop-common\src\test\java\org\apache\hadoop\http\TestAuthenticationSessionCookie.java,149,29,3,1,0,33
hadoop-trunk\hadoop-trunk\hadoop-tools\hadoop-aws\src\main\java\org\apache\hadoop\fs\s3a\select\SelectInputStream.java,394,25,4,1,0,30
hadoop-trunk\hadoop-trunk\hadoop-hdfs-project\hadoop-hdfs\src\test\java\org\apache\hadoop\hdfs\server\namenode\ha\TestInitializeSharedEdits.java,139,33,0,2,0,35
hadoop-trunk\hadoop-trunk\hadoop-common-project\hadoop-common\src\main\java\org\apache\hadoop\fs\FileStatus.java,0,205,22,2,0,229
hadoop-trunk\hadoop-trunk\hadoop-hdfs-project\hadoop-hdfs\src\main\java\org\apache\hadoop\hdfs\server\blockmanagement\PendingDataNodeMessages.java,0,32,0,1,0,33
hadoop-trunk\hadoop-trunk\hadoop-tools\hadoop-rumen\src\main\java\org\apache\hadoop\tools\rumen\DeepCompare.java,0,2,1,1,0,4
hadoop-trunk\hadoop-trunk\hadoop-hdfs-project\hadoop-hdfs\src\main\java\org\apache\hadoop\hdfs\server\namenode\CheckableNameNodeResource.java,0,9,2,2,0,13
hadoop-trunk\hadoop-trunk\hadoop-hdfs-project\hadoop-hdfs\src\test\java\org\apache\hadoop\hdfs\server\datanode\TestStartSecureDataNode.java,112,8,1,4,0,13
hadoop-trunk\hadoop-trunk\hadoop-yarn-project\hadoop-yarn\hadoop-yarn-api\src\main\java\org\apache\hadoop\yarn\api\records\timeline\TimelineDelegationTokenResponse.java,29,16,2,1,0,19
hadoop-trunk\hadoop-trunk\hadoop-yarn-project\hadoop-yarn\hadoop-yarn-common\src\main\java\org\apache\hadoop\yarn\api\records\impl\pb\ApplicationReportPBImpl.java,753,165,115,16,0,296
hadoop-trunk\hadoop-trunk\hadoop-tools\hadoop-rumen\src\main\java\org\apache\hadoop\tools\rumen\ClusterStory.java,0,14,6,1,0,21
hadoop-trunk\hadoop-trunk\hadoop-yarn-project\hadoop-yarn\hadoop-yarn-server\hadoop-yarn-server-common\src\main\java\org\apache\hadoop\yarn\server\api\protocolrecords\UnRegisterNodeManagerResponse.java,6,1,0,1,0,2
hadoop-trunk\hadoop-trunk\hadoop-yarn-project\hadoop-yarn\hadoop-yarn-server\hadoop-yarn-server-resourcemanager\src\test\java\org\apache\hadoop\yarn\server\resourcemanager\metrics\TestSystemMetricsPublisher.java,571,53,0,13,0,66
hadoop-trunk\hadoop-trunk\hadoop-tools\hadoop-aws\src\test\java\org\apache\hadoop\fs\s3a\ITestS3AFailureHandling.java,132,15,8,3,0,26
hadoop-trunk\hadoop-trunk\hadoop-common-project\hadoop-common\src\test\java\org\apache\hadoop\test\StatUtils.java,88,31,5,2,0,38
hadoop-trunk\hadoop-trunk\hadoop-yarn-project\hadoop-yarn\hadoop-yarn-applications\hadoop-yarn-services\hadoop-yarn-services-core\src\main\java\org\apache\hadoop\yarn\service\exceptions\BadConfigException.java,17,10,0,1,0,11
hadoop-trunk\hadoop-trunk\hadoop-tools\hadoop-aws\src\main\java\org\apache\hadoop\fs\s3a\audit\AuditIntegration.java,0,5,0,3,0,8
hadoop-trunk\hadoop-trunk\hadoop-mapreduce-project\hadoop-mapreduce-client\hadoop-mapreduce-client-jobclient\src\test\java\org\apache\hadoop\io\FileBench.java,566,128,28,1,0,157
hadoop-trunk\hadoop-trunk\hadoop-common-project\hadoop-common\src\main\java\org\apache\hadoop\fs\PathFilter.java,0,0,0,1,0,1
hadoop-trunk\hadoop-trunk\hadoop-hdfs-project\hadoop-hdfs\src\main\java\org\apache\hadoop\hdfs\server\protocol\CheckpointCommand.java,34,11,0,1,0,12
hadoop-trunk\hadoop-trunk\hadoop-yarn-project\hadoop-yarn\hadoop-yarn-server\hadoop-yarn-server-timelineservice-hbase\hadoop-yarn-server-timelineservice-hbase-server\hadoop-yarn-server-timelineservice-hbase-server-2\src\main\java\org\apache\hadoop\yarn\server\timelineservice\storage\flow\package-info.java,0,0,0,1,0,1
hadoop-trunk\hadoop-trunk\hadoop-mapreduce-project\hadoop-mapreduce-client\hadoop-mapreduce-client-app\src\test\java\org\apache\hadoop\mapreduce\v2\app\commit\TestCommitterEventHandler.java,257,61,6,6,0,73
hadoop-trunk\hadoop-trunk\hadoop-yarn-project\hadoop-yarn\hadoop-yarn-server\hadoop-yarn-server-resourcemanager\src\main\java\org\apache\hadoop\yarn\server\resourcemanager\reservation\planning\StageAllocatorLowCostAligned.java,431,99,3,5,0,107
hadoop-trunk\hadoop-trunk\hadoop-common-project\hadoop-common\src\main\java\org\apache\hadoop\ipc\ExternalCall.java,66,16,4,2,0,22
hadoop-trunk\hadoop-trunk\hadoop-yarn-project\hadoop-yarn\hadoop-yarn-server\hadoop-yarn-server-common\src\main\java\org\apache\hadoop\yarn\server\scheduler\OpportunisticContainerAllocator.java,442,110,3,1,0,114
hadoop-trunk\hadoop-trunk\hadoop-yarn-project\hadoop-yarn\hadoop-yarn-server\hadoop-yarn-server-resourcemanager\src\main\java\org\apache\hadoop\yarn\server\resourcemanager\scheduler\capacity\conf\YarnConfigurationStore.java,156,10,1,2,0,13
hadoop-trunk\hadoop-trunk\hadoop-yarn-project\hadoop-yarn\hadoop-yarn-server\hadoop-yarn-server-resourcemanager\src\main\java\org\apache\hadoop\yarn\server\resourcemanager\recovery\RMStateStoreRemoveAppAttemptEvent.java,13,5,0,1,0,6
hadoop-trunk\hadoop-trunk\hadoop-mapreduce-project\hadoop-mapreduce-client\hadoop-mapreduce-client-core\src\main\java\org\apache\hadoop\mapreduce\jobhistory\HistoryViewerPrinter.java,0,0,0,1,0,1
hadoop-trunk\hadoop-trunk\hadoop-common-project\hadoop-common\src\test\java\org\apache\hadoop\ipc\metrics\TestRpcMetrics.java,30,5,1,1,0,7
hadoop-trunk\hadoop-trunk\hadoop-hdfs-project\hadoop-hdfs\src\main\java\org\apache\hadoop\hdfs\server\namenode\DefaultINodeAttributesProvider.java,23,7,0,1,0,8
hadoop-trunk\hadoop-trunk\hadoop-mapreduce-project\hadoop-mapreduce-client\hadoop-mapreduce-client-core\src\main\java\org\apache\hadoop\mapreduce\lib\aggregate\ValueHistogram.java,144,20,3,1,0,24
hadoop-trunk\hadoop-trunk\hadoop-hdfs-project\hadoop-hdfs\src\test\java\org\apache\hadoop\metrics2\sink\TestRollingFileSystemSinkWithHdfs.java,0,8,3,3,0,14
hadoop-trunk\hadoop-trunk\hadoop-hdfs-project\hadoop-hdfs-rbf\src\main\java\org\apache\hadoop\hdfs\server\federation\metrics\FederationMBean.java,0,0,0,1,0,1
hadoop-trunk\hadoop-trunk\hadoop-yarn-project\hadoop-yarn\hadoop-yarn-applications\hadoop-yarn-services\hadoop-yarn-services-core\src\main\java\org\apache\hadoop\yarn\service\api\records\ResourceInformation.java,0,40,6,3,0,49
hadoop-trunk\hadoop-trunk\hadoop-yarn-project\hadoop-yarn\hadoop-yarn-server\hadoop-yarn-server-timelineservice-hbase\hadoop-yarn-server-timelineservice-hbase-client\src\main\java\org\apache\hadoop\yarn\server\timelineservice\reader\filter\package-info.java,0,1,0,1,0,2
hadoop-trunk\hadoop-trunk\hadoop-common-project\hadoop-common\src\main\java\org\apache\hadoop\fs\DU.java,72,13,1,1,0,15
hadoop-trunk\hadoop-trunk\hadoop-hdfs-project\hadoop-hdfs-client\src\main\java\org\apache\hadoop\hdfs\protocol\BlockStoragePolicy.java,239,61,2,1,0,64
hadoop-trunk\hadoop-trunk\hadoop-hdfs-project\hadoop-hdfs-httpfs\src\main\java\org\apache\hadoop\lib\service\instrumentation\InstrumentationService.java,369,98,19,12,0,129
hadoop-trunk\hadoop-trunk\hadoop-common-project\hadoop-nfs\src\main\java\org\apache\hadoop\nfs\nfs3\Nfs3Status.java,141,65,0,1,0,66
hadoop-trunk\hadoop-trunk\hadoop-common-project\hadoop-common\src\main\java\org\apache\hadoop\fs\impl\package-info.java,0,0,0,1,0,1
hadoop-trunk\hadoop-trunk\hadoop-common-project\hadoop-common\src\main\java\org\apache\hadoop\io\compress\zlib\ZlibDecompressor.java,360,121,9,2,0,132
hadoop-trunk\hadoop-trunk\hadoop-hdfs-project\hadoop-hdfs\src\main\java\org\apache\hadoop\hdfs\server\diskbalancer\connectors\JsonNodeConnector.java,45,6,1,1,0,8
hadoop-trunk\hadoop-trunk\hadoop-yarn-project\hadoop-yarn\hadoop-yarn-api\src\main\java\org\apache\hadoop\yarn\api\protocolrecords\GetContainersResponse.java,38,9,0,1,0,10
hadoop-trunk\hadoop-trunk\hadoop-hdfs-project\hadoop-hdfs-httpfs\src\test\java\org\apache\hadoop\lib\server\TestServer.java,763,163,21,32,0,216
hadoop-trunk\hadoop-trunk\hadoop-common-project\hadoop-common\src\main\java\org\apache\hadoop\fs\GlobFilter.java,53,17,0,1,0,18
hadoop-trunk\hadoop-trunk\hadoop-mapreduce-project\hadoop-mapreduce-client\hadoop-mapreduce-client-app\src\main\java\org\apache\hadoop\mapreduce\v2\app\JobEndNotifier.java,191,43,2,1,0,46
hadoop-trunk\hadoop-trunk\hadoop-yarn-project\hadoop-yarn\hadoop-yarn-server\hadoop-yarn-server-resourcemanager\src\main\java\org\apache\hadoop\yarn\server\resourcemanager\rmcontainer\RMContainerImpl.java,868,209,10,11,0,230
hadoop-trunk\hadoop-trunk\hadoop-common-project\hadoop-common\src\test\java\org\apache\hadoop\io\TestIOUtils.java,298,47,31,5,0,83
hadoop-trunk\hadoop-trunk\hadoop-hdfs-project\hadoop-hdfs\src\test\java\org\apache\hadoop\hdfs\server\datanode\metrics\TestSlowNodeDetector.java,292,130,3,1,0,134
hadoop-trunk\hadoop-trunk\hadoop-tools\hadoop-rumen\src\main\java\org\apache\hadoop\tools\rumen\ReduceAttempt20LineHistoryEventEmitter.java,0,15,8,1,0,24
hadoop-trunk\hadoop-trunk\hadoop-mapreduce-project\hadoop-mapreduce-client\hadoop-mapreduce-client-jobclient\src\test\java\org\apache\hadoop\mapred\lib\db\TestConstructQuery.java,41,22,0,2,0,24
hadoop-trunk\hadoop-trunk\hadoop-hdfs-project\hadoop-hdfs\src\test\java\org\apache\hadoop\hdfs\qjournal\client\TestSegmentRecoveryComparator.java,62,15,21,4,0,40
hadoop-trunk\hadoop-trunk\hadoop-yarn-project\hadoop-yarn\hadoop-yarn-server\hadoop-yarn-server-resourcemanager\src\test\java\org\apache\hadoop\yarn\server\resourcemanager\webapp\TestRMWebServicesConfigurationMutation.java,956,156,29,66,0,251
hadoop-trunk\hadoop-trunk\hadoop-yarn-project\hadoop-yarn\hadoop-yarn-server\hadoop-yarn-server-resourcemanager\src\main\java\org\apache\hadoop\yarn\server\resourcemanager\placement\QueueMapping.java,186,49,4,2,0,55
hadoop-trunk\hadoop-trunk\hadoop-common-project\hadoop-common\src\test\java\org\apache\hadoop\fs\statistics\TestEmptyIOStatistics.java,75,10,0,6,0,16
hadoop-trunk\hadoop-trunk\hadoop-hdfs-project\hadoop-hdfs\src\main\java\org\apache\hadoop\hdfs\protocolPB\InterDatanodeProtocolTranslatorPB.java,0,24,13,5,0,42
hadoop-trunk\hadoop-trunk\hadoop-hdfs-project\hadoop-hdfs\src\test\java\org\apache\hadoop\hdfs\server\namenode\TestAuditLogAtDebug.java,87,24,3,4,0,31
hadoop-trunk\hadoop-trunk\hadoop-hdfs-project\hadoop-hdfs-rbf\src\main\java\org\apache\hadoop\hdfs\server\federation\store\records\impl\pb\StateStoreVersionPBImpl.java,0,13,35,5,0,53
hadoop-trunk\hadoop-trunk\hadoop-mapreduce-project\hadoop-mapreduce-client\hadoop-mapreduce-client-core\src\main\java\org\apache\hadoop\mapred\OutputCommitter.java,0,80,15,2,0,97
hadoop-trunk\hadoop-trunk\hadoop-hdfs-project\hadoop-hdfs-client\src\main\java\org\apache\hadoop\hdfs\protocol\LocatedBlocks.java,167,52,3,2,0,57
hadoop-trunk\hadoop-trunk\hadoop-yarn-project\hadoop-yarn\hadoop-yarn-server\hadoop-yarn-server-nodemanager\src\test\java\org\apache\hadoop\yarn\server\nodemanager\webapp\TestNMWebServices.java,792,108,21,13,0,142
hadoop-trunk\hadoop-trunk\hadoop-hdfs-project\hadoop-hdfs\src\main\java\org\apache\hadoop\hdfs\server\common\HttpGetFailedException.java,15,6,0,1,0,7
hadoop-trunk\hadoop-trunk\hadoop-hdfs-project\hadoop-hdfs\src\main\java\org\apache\hadoop\hdfs\util\LightWeightLinkedSet.java,267,21,1,1,0,23
hadoop-trunk\hadoop-trunk\hadoop-yarn-project\hadoop-yarn\hadoop-yarn-server\hadoop-yarn-server-resourcemanager\src\main\java\org\apache\hadoop\yarn\server\resourcemanager\recovery\records\AMRMTokenSecretManagerState.java,44,16,2,3,0,21
hadoop-trunk\hadoop-trunk\hadoop-mapreduce-project\hadoop-mapreduce-client\hadoop-mapreduce-client-app\src\main\java\org\apache\hadoop\mapreduce\v2\app\webapp\dao\JobInfo.java,319,147,4,5,0,156
hadoop-trunk\hadoop-trunk\hadoop-yarn-project\hadoop-yarn\hadoop-yarn-api\src\main\java\org\apache\hadoop\yarn\api\package-info.java,0,1,0,1,0,2
hadoop-trunk\hadoop-trunk\hadoop-yarn-project\hadoop-yarn\hadoop-yarn-api\src\main\java\org\apache\hadoop\yarn\server\api\protocolrecords\AddToClusterNodeLabelsRequest.java,19,5,0,2,0,7
hadoop-trunk\hadoop-trunk\hadoop-yarn-project\hadoop-yarn\hadoop-yarn-common\src\main\java\org\apache\hadoop\yarn\api\protocolrecords\impl\pb\GetContainerReportRequestPBImpl.java,97,25,36,3,0,64
hadoop-trunk\hadoop-trunk\hadoop-common-project\hadoop-auth\src\main\java\org\apache\hadoop\security\authentication\client\KerberosAuthenticator.java,348,57,8,21,0,86
hadoop-trunk\hadoop-trunk\hadoop-yarn-project\hadoop-yarn\hadoop-yarn-applications\hadoop-yarn-applications-catalog\hadoop-yarn-applications-catalog-webapp\src\main\java\org\apache\hadoop\yarn\appcatalog\application\AppCatalog.java,30,2,0,1,0,3
hadoop-trunk\hadoop-trunk\hadoop-yarn-project\hadoop-yarn\hadoop-yarn-server\hadoop-yarn-server-nodemanager\src\test\java\org\apache\hadoop\yarn\server\nodemanager\TestNodeManagerMXBean.java,23,2,0,1,0,3
hadoop-trunk\hadoop-trunk\hadoop-hdfs-project\hadoop-hdfs\src\main\java\org\apache\hadoop\hdfs\server\diskbalancer\command\package-info.java,0,0,0,1,0,1
hadoop-trunk\hadoop-trunk\hadoop-hdfs-project\hadoop-hdfs\src\test\java\org\apache\hadoop\hdfs\server\namenode\TestNameNodeMXBean.java,1090,110,30,3,0,143
hadoop-trunk\hadoop-trunk\hadoop-mapreduce-project\hadoop-mapreduce-client\hadoop-mapreduce-client-jobclient\src\test\java\org\apache\hadoop\mapreduce\SimpleEntityWriterV2.java,0,14,1,4,0,19
hadoop-trunk\hadoop-trunk\hadoop-yarn-project\hadoop-yarn\hadoop-yarn-applications\hadoop-yarn-services\hadoop-yarn-services-core\src\test\java\org\apache\hadoop\yarn\service\provider\TestProviderUtils.java,139,10,8,1,0,19
hadoop-trunk\hadoop-trunk\hadoop-yarn-project\hadoop-yarn\hadoop-yarn-server\hadoop-yarn-server-resourcemanager\src\main\java\org\apache\hadoop\yarn\server\resourcemanager\scheduler\capacity\SchedulingMode.java,0,4,0,1,0,5
hadoop-trunk\hadoop-trunk\hadoop-yarn-project\hadoop-yarn\hadoop-yarn-server\hadoop-yarn-server-nodemanager\src\main\java\org\apache\hadoop\yarn\server\nodemanager\containermanager\resourceplugin\deviceframework\DeviceResourceDockerRuntimePluginImpl.java,0,33,13,11,0,57
hadoop-trunk\hadoop-trunk\hadoop-common-project\hadoop-common\src\main\java\org\apache\hadoop\security\token\delegation\web\KerberosDelegationTokenAuthenticationHandler.java,0,3,0,2,0,5
hadoop-trunk\hadoop-trunk\hadoop-hdfs-project\hadoop-hdfs\src\main\java\org\apache\hadoop\hdfs\server\blockmanagement\ExcessRedundancyMap.java,0,21,0,1,0,22
hadoop-trunk\hadoop-trunk\hadoop-tools\hadoop-azure\src\main\java\org\apache\hadoop\fs\azurebfs\contracts\exceptions\TrileanConversionException.java,0,1,0,1,0,2
hadoop-trunk\hadoop-trunk\hadoop-hdfs-project\hadoop-hdfs-httpfs\src\main\java\org\apache\hadoop\fs\http\server\metrics\HttpFSServerMetrics.java,116,67,0,1,0,68
hadoop-trunk\hadoop-trunk\hadoop-hdfs-project\hadoop-hdfs\src\test\java\org\apache\hadoop\hdfs\server\namenode\ha\TestPendingCorruptDnMessages.java,95,31,1,3,0,35
hadoop-trunk\hadoop-trunk\hadoop-mapreduce-project\hadoop-mapreduce-client\hadoop-mapreduce-client-hs\src\main\java\org\apache\hadoop\mapreduce\v2\hs\webapp\HsAboutPage.java,27,5,0,2,0,7
hadoop-trunk\hadoop-trunk\hadoop-yarn-project\hadoop-yarn\hadoop-yarn-client\src\main\java\org\apache\hadoop\yarn\client\api\AHSClient.java,139,15,0,1,0,16
hadoop-trunk\hadoop-trunk\hadoop-yarn-project\hadoop-yarn\hadoop-yarn-server\hadoop-yarn-server-nodemanager\src\test\java\org\apache\hadoop\yarn\server\nodemanager\containermanager\monitor\TestContainersMonitor.java,484,70,24,10,0,104
hadoop-trunk\hadoop-trunk\hadoop-mapreduce-project\hadoop-mapreduce-client\hadoop-mapreduce-client-jobclient\src\test\java\org\apache\hadoop\mapred\TestTaskStatus.java,183,46,4,2,0,52
hadoop-trunk\hadoop-trunk\hadoop-yarn-project\hadoop-yarn\hadoop-yarn-server\hadoop-yarn-server-sharedcachemanager\src\main\java\org\apache\hadoop\yarn\server\sharedcachemanager\webapp\SCMMetricsInfo.java,33,34,1,3,0,38
hadoop-trunk\hadoop-trunk\hadoop-tools\hadoop-gridmix\src\main\java\org\apache\hadoop\mapred\gridmix\DistributedCacheEmulator.java,0,53,30,8,0,91
hadoop-trunk\hadoop-trunk\hadoop-hdfs-project\hadoop-hdfs-client\src\main\java\org\apache\hadoop\hdfs\web\resources\FsActionParam.java,35,9,1,1,0,11
hadoop-trunk\hadoop-trunk\hadoop-tools\hadoop-openstack\src\test\java\org\apache\hadoop\fs\swift\AcceptAllFilter.java,7,4,0,1,0,5
hadoop-trunk\hadoop-trunk\hadoop-hdfs-project\hadoop-hdfs\src\test\java\org\apache\hadoop\hdfs\server\namenode\startupprogress\StartupProgressTestHelper.java,79,28,3,2,0,33
hadoop-trunk\hadoop-trunk\hadoop-yarn-project\hadoop-yarn\hadoop-yarn-server\hadoop-yarn-server-nodemanager\src\main\java\org\apache\hadoop\yarn\server\nodemanager\containermanager\linux\runtime\LinuxContainerRuntimeConstants.java,0,32,11,3,0,46
hadoop-trunk\hadoop-trunk\hadoop-hdfs-project\hadoop-hdfs\src\test\java\org\apache\hadoop\hdfs\server\namenode\TestStripedINodeFile.java,396,76,10,3,0,89
hadoop-trunk\hadoop-trunk\hadoop-hdfs-project\hadoop-hdfs-client\src\main\java\org\apache\hadoop\hdfs\protocol\EncryptionZoneIterator.java,0,11,0,1,0,12
hadoop-trunk\hadoop-trunk\hadoop-mapreduce-project\hadoop-mapreduce-client\hadoop-mapreduce-client-core\src\main\java\org\apache\hadoop\mapred\Operation.java,0,16,0,1,0,17
hadoop-trunk\hadoop-trunk\hadoop-common-project\hadoop-common\src\main\java\org\apache\hadoop\util\JsonSerialization.java,287,35,2,1,0,38
hadoop-trunk\hadoop-trunk\hadoop-tools\hadoop-aws\src\main\java\org\apache\hadoop\fs\s3a\audit\AuditFailureException.java,12,2,0,1,0,3
hadoop-trunk\hadoop-trunk\hadoop-yarn-project\hadoop-yarn\hadoop-yarn-common\src\main\java\org\apache\hadoop\yarn\api\records\impl\pb\ApplicationResourceUsageReportPBImpl.java,0,82,97,3,0,182
hadoop-trunk\hadoop-trunk\hadoop-yarn-project\hadoop-yarn\hadoop-yarn-server\hadoop-yarn-server-resourcemanager\src\main\java\org\apache\hadoop\yarn\server\resourcemanager\scheduler\capacity\AutoCreatedQueueManagementPolicy.java,0,4,0,2,0,6
hadoop-trunk\hadoop-trunk\hadoop-mapreduce-project\hadoop-mapreduce-client\hadoop-mapreduce-client-app\src\main\java\org\apache\hadoop\mapreduce\v2\app\rm\RMCommunicator.java,0,70,11,7,0,88
hadoop-trunk\hadoop-trunk\hadoop-yarn-project\hadoop-yarn\hadoop-yarn-server\hadoop-yarn-server-resourcemanager\src\main\java\org\apache\hadoop\yarn\server\resourcemanager\webapp\dao\PartitionInfo.java,17,7,1,1,0,9
hadoop-trunk\hadoop-trunk\hadoop-yarn-project\hadoop-yarn\hadoop-yarn-server\hadoop-yarn-server-resourcemanager\src\test\java\org\apache\hadoop\yarn\server\resourcemanager\MockRMAppSubmissionData.java,0,143,0,1,0,144
hadoop-trunk\hadoop-trunk\hadoop-yarn-project\hadoop-yarn\hadoop-yarn-server\hadoop-yarn-server-resourcemanager\src\main\java\org\apache\hadoop\yarn\server\resourcemanager\reservation\exceptions\PlanningQuotaException.java,18,7,0,1,0,8
hadoop-trunk\hadoop-trunk\hadoop-tools\hadoop-gridmix\src\main\java\org\apache\hadoop\mapred\gridmix\PseudoLocalFs.java,0,71,2,3,0,76
hadoop-trunk\hadoop-trunk\hadoop-hdfs-project\hadoop-hdfs\src\test\java\org\apache\hadoop\hdfs\TestEncryptedTransfer.java,481,89,5,6,0,100
hadoop-trunk\hadoop-trunk\hadoop-hdfs-project\hadoop-hdfs\src\main\java\org\apache\hadoop\hdfs\server\datanode\fsdataset\impl\RamDiskReplicaLruTracker.java,205,31,2,7,0,40
hadoop-trunk\hadoop-trunk\hadoop-common-project\hadoop-common\src\main\java\org\apache\hadoop\fs\impl\FsLinkResolution.java,60,4,1,1,0,6
hadoop-trunk\hadoop-trunk\hadoop-hdfs-project\hadoop-hdfs-client\src\main\java\org\apache\hadoop\hdfs\web\resources\NoRedirectParam.java,30,3,0,1,0,4
hadoop-trunk\hadoop-trunk\hadoop-tools\hadoop-sls\src\main\java\org\apache\hadoop\yarn\sls\utils\package-info.java,0,1,0,1,0,2
hadoop-trunk\hadoop-trunk\hadoop-yarn-project\hadoop-yarn\hadoop-yarn-common\src\main\java\org\apache\hadoop\yarn\api\protocolrecords\impl\pb\FailApplicationAttemptResponsePBImpl.java,41,20,18,6,0,44
hadoop-trunk\hadoop-trunk\hadoop-hdfs-project\hadoop-hdfs-rbf\src\main\java\org\apache\hadoop\hdfs\server\federation\store\protocol\GetNamenodeRegistrationsRequest.java,24,6,0,2,0,8
hadoop-trunk\hadoop-trunk\hadoop-yarn-project\hadoop-yarn\hadoop-yarn-api\src\main\java\org\apache\hadoop\yarn\api\CsiAdaptorPlugin.java,0,0,0,1,0,1
hadoop-trunk\hadoop-trunk\hadoop-yarn-project\hadoop-yarn\hadoop-yarn-server\hadoop-yarn-server-sharedcachemanager\src\main\java\org\apache\hadoop\yarn\server\sharedcachemanager\AppChecker.java,32,7,0,1,0,8
hadoop-trunk\hadoop-trunk\hadoop-mapreduce-project\hadoop-mapreduce-client\hadoop-mapreduce-client-hs\src\main\java\org\apache\hadoop\mapreduce\v2\hs\HistoryContext.java,0,4,0,2,0,6
hadoop-trunk\hadoop-trunk\hadoop-yarn-project\hadoop-yarn\hadoop-yarn-server\hadoop-yarn-server-resourcemanager\src\test\java\org\apache\hadoop\yarn\server\resourcemanager\scheduler\capacity\TestCapacitySchedulerNewQueueAutoCreation.java,0,243,5,24,0,272
hadoop-trunk\hadoop-trunk\hadoop-tools\hadoop-aws\src\test\java\org\apache\hadoop\fs\s3a\fileContext\ITestS3AFileContextUtil.java,11,1,1,1,0,3
hadoop-trunk\hadoop-trunk\hadoop-mapreduce-project\hadoop-mapreduce-client\hadoop-mapreduce-client-jobclient\src\test\java\org\apache\hadoop\mapred\ThreadedMapBenchmark.java,241,134,18,2,0,154
hadoop-trunk\hadoop-trunk\hadoop-yarn-project\hadoop-yarn\hadoop-yarn-applications\hadoop-yarn-applications-catalog\hadoop-yarn-applications-catalog-webapp\src\test\java\org\apache\hadoop\yarn\appcatalog\controller\AppDetailsControllerTest.java,116,11,7,1,0,19
hadoop-trunk\hadoop-trunk\hadoop-tools\hadoop-azure\src\test\java\org\apache\hadoop\fs\azurebfs\contract\package-info.java,0,2,0,1,0,3
hadoop-trunk\hadoop-trunk\hadoop-hdfs-project\hadoop-hdfs\src\main\java\org\apache\hadoop\hdfs\server\datanode\ReplicaInPipeline.java,0,27,5,1,0,33
hadoop-trunk\hadoop-trunk\hadoop-common-project\hadoop-common\src\main\java\org\apache\hadoop\io\erasurecode\ECBlock.java,56,10,0,1,0,11
hadoop-trunk\hadoop-trunk\hadoop-yarn-project\hadoop-yarn\hadoop-yarn-common\src\test\java\org\apache\hadoop\yarn\util\TestYarnVersionInfo.java,30,3,0,2,0,5
hadoop-trunk\hadoop-trunk\hadoop-hdfs-project\hadoop-hdfs-client\src\main\java\org\apache\hadoop\hdfs\web\resources\DelegationParam.java,22,4,1,1,0,6
hadoop-trunk\hadoop-trunk\hadoop-yarn-project\hadoop-yarn\hadoop-yarn-server\hadoop-yarn-server-resourcemanager\src\main\java\org\apache\hadoop\yarn\server\resourcemanager\scheduler\capacity\preemption\PreemptionManager.java,133,40,2,2,0,44
hadoop-trunk\hadoop-trunk\hadoop-hdfs-project\hadoop-hdfs\src\main\java\org\apache\hadoop\hdfs\server\blockmanagement\FSClusterStats.java,0,5,4,1,0,10
hadoop-trunk\hadoop-trunk\hadoop-tools\hadoop-sls\src\test\java\org\apache\hadoop\yarn\sls\TestSynthJobGeneration.java,221,20,25,3,0,48
hadoop-trunk\hadoop-trunk\hadoop-yarn-project\hadoop-yarn\hadoop-yarn-api\src\main\java\org\apache\hadoop\yarn\api\records\ReservationId.java,129,29,6,1,0,36
hadoop-trunk\hadoop-trunk\hadoop-mapreduce-project\hadoop-mapreduce-client\hadoop-mapreduce-client-jobclient\src\test\java\org\apache\hadoop\mapreduce\v2\TestSpeculativeExecOnCluster.java,862,164,31,3,0,198
hadoop-trunk\hadoop-trunk\hadoop-tools\hadoop-distcp\src\test\java\org\apache\hadoop\tools\TestDistCpWithXAttrs.java,235,107,1,3,0,111
hadoop-trunk\hadoop-trunk\hadoop-yarn-project\hadoop-yarn\hadoop-yarn-server\hadoop-yarn-server-timelineservice-hbase\hadoop-yarn-server-timelineservice-hbase-client\src\main\java\org\apache\hadoop\yarn\server\timelineservice\storage\reader\FlowActivityEntityReader.java,0,17,5,11,0,33
hadoop-trunk\hadoop-trunk\hadoop-tools\hadoop-aws\src\main\java\org\apache\hadoop\fs\s3a\commit\staging\ConflictResolution.java,0,0,0,1,0,1
hadoop-trunk\hadoop-trunk\hadoop-yarn-project\hadoop-yarn\hadoop-yarn-common\src\main\java\org\apache\hadoop\yarn\state\InvalidStateTransitionException.java,9,3,0,1,0,4
hadoop-trunk\hadoop-trunk\hadoop-hdfs-project\hadoop-hdfs\src\main\java\org\apache\hadoop\hdfs\net\DomainPeerServer.java,64,20,1,1,0,22
hadoop-trunk\hadoop-trunk\hadoop-hdfs-project\hadoop-hdfs\src\test\java\org\apache\hadoop\hdfs\server\blockmanagement\TestAvailableSpaceRackFaultTolerantBPP.java,215,50,12,5,0,67
hadoop-trunk\hadoop-trunk\hadoop-hdfs-project\hadoop-hdfs-client\src\main\java\org\apache\hadoop\hdfs\web\resources\SnapshotNameParam.java,19,3,1,1,0,5
hadoop-trunk\hadoop-trunk\hadoop-tools\hadoop-aws\src\test\java\org\apache\hadoop\fs\s3a\ITestS3AMetrics.java,55,2,1,2,0,5
hadoop-trunk\hadoop-trunk\hadoop-common-project\hadoop-common\src\main\java\org\apache\hadoop\fs\http\AbstractHttpFileSystem.java,132,40,1,3,0,44
hadoop-trunk\hadoop-trunk\hadoop-hdfs-project\hadoop-hdfs\src\main\java\org\apache\hadoop\hdfs\server\datanode\fsdataset\impl\FsVolumeImplBuilder.java,65,26,0,1,0,27
hadoop-trunk\hadoop-trunk\hadoop-common-project\hadoop-common\src\main\java\org\apache\hadoop\fs\statistics\impl\PairedDurationTrackerFactory.java,0,8,0,1,0,9
hadoop-trunk\hadoop-trunk\hadoop-hdfs-project\hadoop-hdfs\src\main\java\org\apache\hadoop\hdfs\server\datanode\checker\VolumeCheckResult.java,0,6,0,1,0,7
hadoop-trunk\hadoop-trunk\hadoop-yarn-project\hadoop-yarn\hadoop-yarn-server\hadoop-yarn-server-nodemanager\src\test\java\org\apache\hadoop\yarn\server\nodemanager\TestNodeStatusUpdaterForLabels.java,347,56,7,10,0,73
hadoop-trunk\hadoop-trunk\hadoop-common-project\hadoop-common\src\test\java\org\apache\hadoop\metrics2\impl\TestGangliaMetrics.java,181,29,0,3,0,32
hadoop-trunk\hadoop-trunk\hadoop-mapreduce-project\hadoop-mapreduce-client\hadoop-mapreduce-client-jobclient\src\test\java\org\apache\hadoop\mapreduce\lib\chain\TestChainErrors.java,194,28,7,1,0,36
hadoop-trunk\hadoop-trunk\hadoop-yarn-project\hadoop-yarn\hadoop-yarn-applications\hadoop-yarn-services\hadoop-yarn-services-core\src\main\java\org\apache\hadoop\yarn\service\component\ComponentState.java,0,5,0,1,0,6
hadoop-trunk\hadoop-trunk\hadoop-hdfs-project\hadoop-hdfs\src\main\java\org\apache\hadoop\hdfs\WebHdfsDtFetcher.java,12,3,2,1,0,6
hadoop-trunk\hadoop-trunk\hadoop-tools\hadoop-azure\src\test\java\org\apache\hadoop\fs\azurebfs\services\TestQueryParams.java,44,6,0,2,0,8
hadoop-trunk\hadoop-trunk\hadoop-tools\hadoop-streaming\src\test\java\org\apache\hadoop\streaming\TestStreamingSeparator.java,0,45,14,9,0,68
hadoop-trunk\hadoop-trunk\hadoop-yarn-project\hadoop-yarn\hadoop-yarn-server\hadoop-yarn-server-resourcemanager\src\main\java\org\apache\hadoop\yarn\server\resourcemanager\reservation\AbstractReservationSystem.java,0,76,13,16,0,105
hadoop-trunk\hadoop-trunk\hadoop-hdfs-project\hadoop-hdfs\src\test\java\org\apache\hadoop\hdfs\TestDFSStorageStateRecovery.java,417,147,19,20,0,186
hadoop-trunk\hadoop-trunk\hadoop-yarn-project\hadoop-yarn\hadoop-yarn-api\src\main\java\org\apache\hadoop\yarn\util\csi\CsiConfigUtils.java,0,8,1,1,0,10
hadoop-trunk\hadoop-trunk\hadoop-tools\hadoop-gridmix\src\test\java\org\apache\hadoop\mapred\gridmix\TestPseudoLocalFs.java,200,21,3,2,0,26
hadoop-trunk\hadoop-trunk\hadoop-tools\hadoop-azure\src\main\java\org\apache\hadoop\fs\azurebfs\contracts\exceptions\AzureBlobFileSystemException.java,31,7,0,4,0,11
hadoop-trunk\hadoop-trunk\hadoop-common-project\hadoop-common\src\test\java\org\apache\hadoop\util\TestUTF8ByteArrayUtils.java,32,8,1,1,0,10
hadoop-trunk\hadoop-trunk\hadoop-yarn-project\hadoop-yarn\hadoop-yarn-server\hadoop-yarn-server-resourcemanager\src\test\java\org\apache\hadoop\yarn\server\resourcemanager\scheduler\fair\converter\TestQueuePlacementConverter.java,451,48,0,14,0,62
hadoop-trunk\hadoop-trunk\hadoop-common-project\hadoop-common\src\main\java\org\apache\hadoop\fs\RemoteIterator.java,0,3,0,1,0,4
hadoop-trunk\hadoop-trunk\hadoop-common-project\hadoop-common\src\main\java\org\apache\hadoop\metrics2\util\Metrics2Util.java,79,26,0,1,0,27
hadoop-trunk\hadoop-trunk\hadoop-tools\hadoop-aws\src\test\java\org\apache\hadoop\fs\s3a\performance\OperationCostValidator.java,0,40,5,2,0,47
hadoop-trunk\hadoop-trunk\hadoop-common-project\hadoop-auth\src\main\java\org\apache\hadoop\security\authentication\util\RandomSignerSecretProvider.java,28,5,0,1,0,6
hadoop-trunk\hadoop-trunk\hadoop-yarn-project\hadoop-yarn\hadoop-yarn-server\hadoop-yarn-server-nodemanager\src\main\java\org\apache\hadoop\yarn\server\nodemanager\containermanager\localizer\ResourceLocalizationService.java,688,285,64,58,0,407
hadoop-trunk\hadoop-trunk\hadoop-yarn-project\hadoop-yarn\hadoop-yarn-server\hadoop-yarn-server-resourcemanager\src\main\java\org\apache\hadoop\yarn\server\resourcemanager\rmcontainer\RMContainerRecoverEvent.java,15,7,0,1,0,8
hadoop-trunk\hadoop-trunk\hadoop-mapreduce-project\hadoop-mapreduce-client\hadoop-mapreduce-client-core\src\main\java\org\apache\hadoop\mapred\Counters.java,0,149,14,5,0,168
hadoop-trunk\hadoop-trunk\hadoop-hdfs-project\hadoop-hdfs-client\src\main\java\org\apache\hadoop\hdfs\web\oauth2\Utils.java,0,9,0,1,0,10
hadoop-trunk\hadoop-trunk\hadoop-tools\hadoop-azure\src\test\java\org\apache\hadoop\fs\azure\ITestNativeAzureFileSystemLive.java,266,16,2,7,0,25
hadoop-trunk\hadoop-trunk\hadoop-mapreduce-project\hadoop-mapreduce-client\hadoop-mapreduce-client-common\src\main\java\org\apache\hadoop\yarn\proto\HSClientProtocol.java,0,6,5,2,0,13
hadoop-trunk\hadoop-trunk\hadoop-common-project\hadoop-common\src\test\java\org\apache\hadoop\http\TestSSLHttpServer.java,458,93,6,1,0,100
hadoop-trunk\hadoop-trunk\hadoop-hdfs-project\hadoop-hdfs\src\test\java\org\apache\hadoop\fs\contract\hdfs\HDFSContract.java,60,13,2,1,0,16
hadoop-trunk\hadoop-trunk\hadoop-mapreduce-project\hadoop-mapreduce-client\hadoop-mapreduce-client-core\src\main\java\org\apache\hadoop\mapreduce\jobhistory\HistoryEvent.java,0,3,1,1,0,5
hadoop-trunk\hadoop-trunk\hadoop-hdfs-project\hadoop-hdfs\src\main\java\org\apache\hadoop\hdfs\DFSUtil.java,1824,400,49,37,0,486
hadoop-trunk\hadoop-trunk\hadoop-yarn-project\hadoop-yarn\hadoop-yarn-server\hadoop-yarn-server-nodemanager\src\main\java\org\apache\hadoop\yarn\server\nodemanager\containermanager\logaggregation\AppLogAggregator.java,0,7,0,2,0,9
hadoop-trunk\hadoop-trunk\hadoop-tools\hadoop-resourceestimator\src\main\java\org\apache\hadoop\resourceestimator\skylinestore\exceptions\NullResourceSkylineException.java,8,1,0,1,0,2
hadoop-trunk\hadoop-trunk\hadoop-hdfs-project\hadoop-hdfs\src\main\java\org\apache\hadoop\hdfs\server\protocol\ServerCommand.java,32,7,0,1,0,8
hadoop-trunk\hadoop-trunk\hadoop-yarn-project\hadoop-yarn\hadoop-yarn-server\hadoop-yarn-server-resourcemanager\src\main\java\org\apache\hadoop\yarn\server\resourcemanager\scheduler\SchedulerQueueManager.java,42,2,0,2,0,4
hadoop-trunk\hadoop-trunk\hadoop-hdfs-project\hadoop-hdfs-client\src\main\java\org\apache\hadoop\hdfs\protocol\UnresolvedPathException.java,0,16,4,1,0,21
hadoop-trunk\hadoop-trunk\hadoop-yarn-project\hadoop-yarn\hadoop-yarn-common\src\main\java\org\apache\hadoop\yarn\client\RequestHedgingRMFailoverProxyProvider.java,0,24,7,2,0,33
hadoop-trunk\hadoop-trunk\hadoop-common-project\hadoop-common\src\test\java\org\apache\hadoop\security\TestFixKerberosTicketOrder.java,191,13,0,1,0,14
hadoop-trunk\hadoop-trunk\hadoop-hdfs-project\hadoop-hdfs-client\src\test\java\org\apache\hadoop\hdfs\protocol\TestErasureCodingPolicy.java,79,14,4,1,0,19
hadoop-trunk\hadoop-trunk\hadoop-mapreduce-project\hadoop-mapreduce-client\hadoop-mapreduce-client-app\src\test\java\org\apache\hadoop\yarn\webapp\view\BlockForTest.java,0,9,1,1,0,11
hadoop-trunk\hadoop-trunk\hadoop-tools\hadoop-azure\src\test\java\org\apache\hadoop\fs\azurebfs\utils\Parallelized.java,30,7,1,1,0,9
hadoop-trunk\hadoop-trunk\hadoop-yarn-project\hadoop-yarn\hadoop-yarn-common\src\main\java\org\apache\hadoop\yarn\util\ConverterUtils.java,163,37,1,1,0,39
hadoop-trunk\hadoop-trunk\hadoop-tools\hadoop-aws\src\main\java\org\apache\hadoop\fs\s3a\impl\HeaderProcessing.java,478,13,0,3,0,16
hadoop-trunk\hadoop-trunk\hadoop-common-project\hadoop-common\src\main\java\org\apache\hadoop\io\erasurecode\grouper\BlockGrouper.java,64,12,1,1,0,14
hadoop-trunk\hadoop-trunk\hadoop-yarn-project\hadoop-yarn\hadoop-yarn-applications\hadoop-yarn-services\hadoop-yarn-services-api\src\main\java\org\apache\hadoop\yarn\service\webapp\package-info.java,0,1,0,1,0,2
hadoop-trunk\hadoop-trunk\hadoop-hdfs-project\hadoop-hdfs-client\src\main\java\org\apache\hadoop\hdfs\protocol\datatransfer\InvalidEncryptionKeyException.java,12,4,0,1,0,5
hadoop-trunk\hadoop-trunk\hadoop-yarn-project\hadoop-yarn\hadoop-yarn-server\hadoop-yarn-server-timelineservice-hbase\hadoop-yarn-server-timelineservice-hbase-common\src\main\java\org\apache\hadoop\yarn\server\timelineservice\storage\application\ApplicationRowKeyPrefix.java,44,8,0,2,0,10
hadoop-trunk\hadoop-trunk\hadoop-common-project\hadoop-common\src\main\java\org\apache\hadoop\http\HttpRequestLog.java,29,8,1,1,0,10
hadoop-trunk\hadoop-trunk\hadoop-yarn-project\hadoop-yarn\hadoop-yarn-common\src\main\java\org\apache\hadoop\yarn\webapp\hamlet2\HamletSpec.java,3055,438,390,4,0,832
hadoop-trunk\hadoop-trunk\hadoop-hdfs-project\hadoop-hdfs\src\test\java\org\apache\hadoop\hdfs\qjournal\client\TestQuorumCall.java,84,35,3,2,0,40
hadoop-trunk\hadoop-trunk\hadoop-hdfs-project\hadoop-hdfs-client\src\test\java\org\apache\hadoop\hdfs\util\TestECPolicyLoader.java,279,10,6,1,0,17
hadoop-trunk\hadoop-trunk\hadoop-hdfs-project\hadoop-hdfs\src\test\java\org\apache\hadoop\hdfs\TestRollingUpgrade.java,698,107,8,12,0,127
hadoop-trunk\hadoop-trunk\hadoop-hdfs-project\hadoop-hdfs\src\test\java\org\apache\hadoop\hdfs\qjournal\server\TestJournalNodeMXBean.java,87,19,0,5,0,24
hadoop-trunk\hadoop-trunk\hadoop-tools\hadoop-aws\src\test\java\org\apache\hadoop\fs\s3a\scale\ILoadTestS3ABulkDeleteThrottling.java,299,40,9,4,0,53
hadoop-trunk\hadoop-trunk\hadoop-yarn-project\hadoop-yarn\hadoop-yarn-server\hadoop-yarn-server-nodemanager\src\main\java\org\apache\hadoop\yarn\server\nodemanager\CMgrUpdateContainersEvent.java,22,3,0,1,0,4
hadoop-trunk\hadoop-trunk\hadoop-yarn-project\hadoop-yarn\hadoop-yarn-applications\hadoop-yarn-services\hadoop-yarn-services-core\src\main\java\org\apache\hadoop\yarn\service\component\Component.java,1212,233,62,14,0,309
hadoop-trunk\hadoop-trunk\hadoop-tools\hadoop-aws\src\main\java\org\apache\hadoop\fs\s3a\impl\ListingOperationCallbacks.java,0,1,0,1,0,2
hadoop-trunk\hadoop-trunk\hadoop-common-project\hadoop-common\src\main\java\org\apache\hadoop\fs\FSBuilder.java,0,37,0,1,0,38
hadoop-trunk\hadoop-trunk\hadoop-tools\hadoop-sls\src\main\java\org\apache\hadoop\yarn\sls\scheduler\ContainerSimulator.java,116,86,0,1,0,87
hadoop-trunk\hadoop-trunk\hadoop-yarn-project\hadoop-yarn\hadoop-yarn-common\src\main\java\org\apache\hadoop\yarn\api\protocolrecords\impl\pb\AllocateResponsePBImpl.java,902,144,109,5,0,258
hadoop-trunk\hadoop-trunk\hadoop-yarn-project\hadoop-yarn\hadoop-yarn-applications\hadoop-yarn-applications-mawo\hadoop-yarn-applications-mawo-core\src\main\java\org\apache\hadoop\applications\mawo\server\master\job\JobId.java,98,2,2,1,0,5
hadoop-trunk\hadoop-trunk\hadoop-common-project\hadoop-common\src\main\java\org\apache\hadoop\util\NativeCrc32.java,0,41,2,2,0,45
hadoop-trunk\hadoop-trunk\hadoop-cloud-storage-project\hadoop-cos\src\test\java\org\apache\hadoop\fs\cosn\CosNTestUtils.java,0,4,1,1,0,6
hadoop-trunk\hadoop-trunk\hadoop-hdfs-project\hadoop-hdfs-httpfs\src\main\java\org\apache\hadoop\fs\http\server\HttpFSParametersProvider.java,716,21,2,2,0,25
hadoop-trunk\hadoop-trunk\hadoop-tools\hadoop-aws\src\main\java\org\apache\hadoop\fs\s3a\auth\delegation\DelegationTokenProvider.java,0,1,0,1,0,2
hadoop-trunk\hadoop-trunk\hadoop-hdfs-project\hadoop-hdfs\src\test\java\org\apache\hadoop\hdfs\server\namenode\TestEnabledECPolicies.java,209,23,4,1,0,28
hadoop-trunk\hadoop-trunk\hadoop-yarn-project\hadoop-yarn\hadoop-yarn-server\hadoop-yarn-server-resourcemanager\src\main\java\org\apache\hadoop\yarn\server\resourcemanager\rmcontainer\RMContainerUpdatesAcquiredEvent.java,14,10,0,1,0,11
hadoop-trunk\hadoop-trunk\hadoop-hdfs-project\hadoop-hdfs\src\main\java\org\apache\hadoop\hdfs\server\datanode\VolumeScanner.java,735,87,16,3,0,106
hadoop-trunk\hadoop-trunk\hadoop-yarn-project\hadoop-yarn\hadoop-yarn-server\hadoop-yarn-server-resourcemanager\src\main\java\org\apache\hadoop\yarn\server\resourcemanager\scheduler\QueueMetricsForCustomResources.java,51,33,0,1,0,34
hadoop-trunk\hadoop-trunk\hadoop-hdfs-project\hadoop-hdfs\src\test\java\org\apache\hadoop\hdfs\server\namenode\ha\TestHAMetrics.java,136,33,0,1,0,34
hadoop-trunk\hadoop-trunk\hadoop-mapreduce-project\hadoop-mapreduce-client\hadoop-mapreduce-client-core\src\main\java\org\apache\hadoop\mapreduce\TaskTrackerInfo.java,76,30,1,1,0,32
hadoop-trunk\hadoop-trunk\hadoop-mapreduce-project\hadoop-mapreduce-client\hadoop-mapreduce-client-core\src\test\java\org\apache\hadoop\mapreduce\lib\output\committer\manifest\ThreadLeakTracker.java,53,6,1,2,0,9
hadoop-trunk\hadoop-trunk\hadoop-yarn-project\hadoop-yarn\hadoop-yarn-server\hadoop-yarn-server-nodemanager\src\main\java\org\apache\hadoop\yarn\server\nodemanager\containermanager\deletion\task\package-info.java,0,1,0,2,0,3
hadoop-trunk\hadoop-trunk\hadoop-hdfs-project\hadoop-hdfs\src\test\java\org\apache\hadoop\hdfs\server\namenode\TestFileJournalManager.java,466,170,10,10,0,190
hadoop-trunk\hadoop-trunk\hadoop-yarn-project\hadoop-yarn\hadoop-yarn-server\hadoop-yarn-server-nodemanager\src\test\java\org\apache\hadoop\yarn\server\nodemanager\containermanager\linux\resources\TestDefaultOOMHandler.java,1234,82,2,8,0,92
hadoop-trunk\hadoop-trunk\hadoop-tools\hadoop-azure\src\test\java\org\apache\hadoop\fs\azurebfs\services\TestAbfsInputStream.java,786,148,8,67,0,223
hadoop-trunk\hadoop-trunk\hadoop-mapreduce-project\hadoop-mapreduce-client\hadoop-mapreduce-client-core\src\main\java\org\apache\hadoop\mapreduce\protocol\package-info.java,0,1,0,1,0,2
hadoop-trunk\hadoop-trunk\hadoop-yarn-project\hadoop-yarn\hadoop-yarn-common\src\main\java\org\apache\hadoop\yarn\api\protocolrecords\impl\pb\UseSharedCacheResourceResponsePBImpl.java,55,16,27,4,0,47
hadoop-trunk\hadoop-trunk\hadoop-common-project\hadoop-common\src\main\java\org\apache\hadoop\ipc\Schedulable.java,0,3,1,1,0,5
hadoop-trunk\hadoop-trunk\hadoop-hdfs-project\hadoop-hdfs-rbf\src\main\java\org\apache\hadoop\hdfs\protocolPB\RouterAdminProtocolPB.java,0,1,3,2,0,6
hadoop-trunk\hadoop-trunk\hadoop-common-project\hadoop-common\src\main\java\org\apache\hadoop\fs\statistics\impl\AbstractIOStatisticsImpl.java,5,0,1,1,0,2
hadoop-trunk\hadoop-trunk\hadoop-common-project\hadoop-common\src\main\java\org\apache\hadoop\ipc\WritableRpcEngine.java,541,234,19,5,0,258
hadoop-trunk\hadoop-trunk\hadoop-common-project\hadoop-registry\src\main\java\org\apache\hadoop\registry\server\dns\ApplicationServiceRecordProcessor.java,332,37,7,1,0,45
hadoop-trunk\hadoop-trunk\hadoop-hdfs-project\hadoop-hdfs\src\main\java\org\apache\hadoop\hdfs\server\blockmanagement\BlockCollection.java,0,14,0,1,0,15
hadoop-trunk\hadoop-trunk\hadoop-hdfs-project\hadoop-hdfs\src\test\java\org\apache\hadoop\hdfs\server\blockmanagement\TestHeartbeatHandling.java,236,80,7,19,0,106
hadoop-trunk\hadoop-trunk\hadoop-tools\hadoop-distcp\src\main\java\org\apache\hadoop\tools\DistCpOptions.java,0,216,2,3,0,221
hadoop-trunk\hadoop-trunk\hadoop-hdfs-project\hadoop-hdfs\src\main\java\org\apache\hadoop\hdfs\server\namenode\top\window\RollingWindow.java,139,22,3,4,0,29
hadoop-trunk\hadoop-trunk\hadoop-mapreduce-project\hadoop-mapreduce-client\hadoop-mapreduce-client-common\src\main\java\org\apache\hadoop\mapreduce\v2\api\protocolrecords\impl\pb\FailTaskAttemptResponsePBImpl.java,29,18,19,5,0,42
hadoop-trunk\hadoop-trunk\hadoop-common-project\hadoop-common\src\test\java\org\apache\hadoop\fs\TestHarFileSystemBasics.java,364,44,25,8,0,77
hadoop-trunk\hadoop-trunk\hadoop-mapreduce-project\hadoop-mapreduce-client\hadoop-mapreduce-client-core\src\main\java\org\apache\hadoop\mapreduce\lib\aggregate\LongValueSum.java,0,22,1,1,0,24
hadoop-trunk\hadoop-trunk\hadoop-hdfs-project\hadoop-hdfs-client\src\main\java\org\apache\hadoop\hdfs\client\impl\ExternalBlockReader.java,0,21,0,1,0,22
hadoop-trunk\hadoop-trunk\hadoop-mapreduce-project\hadoop-mapreduce-client\hadoop-mapreduce-client-core\src\main\java\org\apache\hadoop\mapreduce\lib\chain\ChainReduceContextImpl.java,0,23,7,2,0,32
hadoop-trunk\hadoop-trunk\hadoop-mapreduce-project\hadoop-mapreduce-client\hadoop-mapreduce-client-jobclient\src\test\java\org\apache\hadoop\fs\JHLogAnalyzer.java,986,564,175,8,0,747
hadoop-trunk\hadoop-trunk\hadoop-yarn-project\hadoop-yarn\hadoop-yarn-server\hadoop-yarn-server-applicationhistoryservice\src\main\java\org\apache\hadoop\yarn\server\applicationhistoryservice\ApplicationHistoryManagerOnTimelineStore.java,711,77,4,15,0,96
hadoop-trunk\hadoop-trunk\hadoop-yarn-project\hadoop-yarn\hadoop-yarn-common\src\main\java\org\apache\hadoop\yarn\security\client\TimelineDelegationTokenOperation.java,0,14,2,1,0,17
hadoop-trunk\hadoop-trunk\hadoop-yarn-project\hadoop-yarn\hadoop-yarn-server\hadoop-yarn-server-nodemanager\src\main\java\org\apache\hadoop\yarn\server\nodemanager\containermanager\resourceplugin\fpga\AbstractFpgaVendorPlugin.java,0,11,0,9,0,20
hadoop-trunk\hadoop-trunk\hadoop-hdfs-project\hadoop-hdfs-rbf\src\main\java\org\apache\hadoop\hdfs\server\federation\router\PeriodicService.java,164,8,2,2,0,12
hadoop-trunk\hadoop-trunk\hadoop-yarn-project\hadoop-yarn\hadoop-yarn-api\src\main\java\org\apache\hadoop\yarn\conf\ConfigurationProviderFactory.java,29,3,2,1,0,6
hadoop-trunk\hadoop-trunk\hadoop-yarn-project\hadoop-yarn\hadoop-yarn-server\hadoop-yarn-server-resourcemanager\src\test\java\org\apache\hadoop\yarn\server\resourcemanager\scheduler\fair\TestFairScheduler.java,0,1014,200,148,0,1362
hadoop-trunk\hadoop-trunk\hadoop-yarn-project\hadoop-yarn\hadoop-yarn-server\hadoop-yarn-server-applicationhistoryservice\src\main\java\org\apache\hadoop\yarn\server\timeline\security\TimelineACLsManager.java,143,40,3,1,0,44
hadoop-trunk\hadoop-trunk\hadoop-mapreduce-project\hadoop-mapreduce-examples\src\test\java\org\apache\hadoop\examples\TestBaileyBorweinPlouffe.java,29,13,2,1,0,16
hadoop-trunk\hadoop-trunk\hadoop-common-project\hadoop-common\src\main\java\org\apache\hadoop\fs\viewfs\ViewFileSystem.java,1844,328,37,12,0,377
hadoop-trunk\hadoop-trunk\hadoop-hdfs-project\hadoop-hdfs-client\src\main\java\org\apache\hadoop\hdfs\ViewDistributedFileSystem.java,2194,328,33,5,0,366
hadoop-trunk\hadoop-trunk\hadoop-tools\hadoop-azure\src\test\java\org\apache\hadoop\fs\azurebfs\commit\ITestAbfsLoadManifestsStage.java,26,5,0,2,0,7
hadoop-trunk\hadoop-trunk\hadoop-common-project\hadoop-common\src\test\java\org\apache\hadoop\io\file\tfile\TestTFileLzoCodecsByteArrays.java,18,4,2,1,0,7
hadoop-trunk\hadoop-trunk\hadoop-common-project\hadoop-common\src\main\java\org\apache\hadoop\crypto\key\KeyProvider.java,649,149,4,5,0,158
hadoop-trunk\hadoop-trunk\hadoop-hdfs-project\hadoop-hdfs\src\main\java\org\apache\hadoop\hdfs\server\protocol\BlockECReconstructionCommand.java,102,58,0,1,0,59
hadoop-trunk\hadoop-trunk\hadoop-yarn-project\hadoop-yarn\hadoop-yarn-server\hadoop-yarn-server-nodemanager\src\main\java\org\apache\hadoop\yarn\server\nodemanager\containermanager\linux\privileged\PrivilegedOperationExecutor.java,289,36,12,6,0,54
hadoop-trunk\hadoop-trunk\hadoop-yarn-project\hadoop-yarn\hadoop-yarn-server\hadoop-yarn-server-resourcemanager\src\test\java\org\apache\hadoop\yarn\server\resourcemanager\scheduler\capacity\TestApplicationPriority.java,811,115,25,16,0,156
hadoop-trunk\hadoop-trunk\hadoop-hdfs-project\hadoop-hdfs\src\test\java\org\apache\hadoop\hdfs\server\diskbalancer\DiskBalancerTestUtil.java,317,52,10,3,0,65
hadoop-trunk\hadoop-trunk\hadoop-mapreduce-project\hadoop-mapreduce-client\hadoop-mapreduce-client-core\src\main\java\org\apache\hadoop\mapred\KeyValueTextInputFormat.java,0,16,0,1,0,17
hadoop-trunk\hadoop-trunk\hadoop-yarn-project\hadoop-yarn\hadoop-yarn-common\src\main\java\org\apache\hadoop\yarn\util\FSDownload.java,427,116,16,4,0,136
hadoop-trunk\hadoop-trunk\hadoop-tools\hadoop-azure\src\main\java\org\apache\hadoop\fs\azurebfs\contracts\exceptions\FileSystemOperationUnhandledException.java,0,5,0,3,0,8
hadoop-trunk\hadoop-trunk\hadoop-tools\hadoop-streaming\src\main\java\org\apache\hadoop\record\RecordComparator.java,23,11,2,2,0,15
hadoop-trunk\hadoop-trunk\hadoop-mapreduce-project\hadoop-mapreduce-client\hadoop-mapreduce-client-jobclient\src\test\java\org\apache\hadoop\fs\slive\ReportWriter.java,0,33,6,2,0,41
hadoop-trunk\hadoop-trunk\hadoop-tools\hadoop-azure\src\test\java\org\apache\hadoop\fs\azure\AzureBlobStorageTestAccount.java,890,210,16,29,0,255
hadoop-trunk\hadoop-trunk\hadoop-hdfs-project\hadoop-hdfs\src\test\java\org\apache\hadoop\hdfs\server\datanode\metrics\TestDataNodeOutlierDetectionViaMetrics.java,120,18,2,1,0,21
hadoop-trunk\hadoop-trunk\hadoop-yarn-project\hadoop-yarn\hadoop-yarn-server\hadoop-yarn-server-common\src\main\java\org\apache\hadoop\yarn\server\federation\store\records\AddApplicationHomeSubClusterRequest.java,35,2,0,1,0,3
hadoop-trunk\hadoop-trunk\hadoop-common-project\hadoop-common\src\main\java\org\apache\hadoop\metrics2\impl\MetricsConfig.java,0,54,2,1,0,57
hadoop-trunk\hadoop-trunk\hadoop-mapreduce-project\hadoop-mapreduce-client\hadoop-mapreduce-client-core\src\main\java\org\apache\hadoop\mapreduce\jobhistory\NormalizedResourceEvent.java,60,19,4,1,0,24
hadoop-trunk\hadoop-trunk\hadoop-mapreduce-project\hadoop-mapreduce-client\hadoop-mapreduce-client-jobclient\src\test\java\org\apache\hadoop\mapreduce\lib\jobcontrol\TestMapReduceJobControl.java,0,65,10,1,0,76
hadoop-trunk\hadoop-trunk\hadoop-yarn-project\hadoop-yarn\hadoop-yarn-server\hadoop-yarn-server-resourcemanager\src\main\java\org\apache\hadoop\yarn\server\resourcemanager\security\authorize\RMPolicyProvider.java,50,21,3,8,0,32
hadoop-trunk\hadoop-trunk\hadoop-mapreduce-project\hadoop-mapreduce-client\hadoop-mapreduce-client-jobclient\src\test\java\org\apache\hadoop\mapreduce\TimelineEntityConverterV2.java,0,24,5,1,0,30
hadoop-trunk\hadoop-trunk\hadoop-hdfs-project\hadoop-hdfs-client\src\main\java\org\apache\hadoop\hdfs\server\datanode\DiskBalancerWorkItem.java,255,38,1,1,0,40
hadoop-trunk\hadoop-trunk\hadoop-hdfs-project\hadoop-hdfs\src\main\java\org\apache\hadoop\hdfs\server\blockmanagement\BlockStoragePolicySuite.java,154,30,1,1,0,32
hadoop-trunk\hadoop-trunk\hadoop-mapreduce-project\hadoop-mapreduce-client\hadoop-mapreduce-client-jobclient\src\test\java\org\apache\hadoop\fs\slive\DataVerifier.java,0,75,1,2,0,78
hadoop-trunk\hadoop-trunk\hadoop-tools\hadoop-azure\src\test\java\org\apache\hadoop\fs\azurebfs\ITestAzureBlobFileSystemPermission.java,69,18,1,7,0,26
hadoop-trunk\hadoop-trunk\hadoop-tools\hadoop-resourceestimator\src\main\java\org\apache\hadoop\resourceestimator\common\config\ResourceEstimatorConfiguration.java,0,9,0,9,0,18
hadoop-trunk\hadoop-trunk\hadoop-hdfs-project\hadoop-hdfs\src\test\java\org\apache\hadoop\hdfs\TestDecommission.java,1793,364,35,58,0,457
hadoop-trunk\hadoop-trunk\hadoop-hdfs-project\hadoop-hdfs\src\main\java\org\apache\hadoop\hdfs\server\datanode\ChunkChecksum.java,19,14,0,1,0,15
hadoop-trunk\hadoop-trunk\hadoop-yarn-project\hadoop-yarn\hadoop-yarn-common\src\main\java\org\apache\hadoop\yarn\webapp\view\FooterBlock.java,8,2,0,1,0,3
hadoop-trunk\hadoop-trunk\hadoop-hdfs-project\hadoop-hdfs\src\main\java\org\apache\hadoop\hdfs\server\namenode\metrics\NameNodeMetrics.java,443,295,0,1,0,296
hadoop-trunk\hadoop-trunk\hadoop-yarn-project\hadoop-yarn\hadoop-yarn-server\hadoop-yarn-server-timelineservice-hbase\hadoop-yarn-server-timelineservice-hbase-common\src\main\java\org\apache\hadoop\yarn\server\timelineservice\storage\common\package-info.java,0,0,0,1,0,1
hadoop-trunk\hadoop-trunk\hadoop-yarn-project\hadoop-yarn\hadoop-yarn-common\src\main\java\org\apache\hadoop\yarn\state\SingleArcTransition.java,0,6,3,1,0,10
hadoop-trunk\hadoop-trunk\hadoop-tools\hadoop-azure\src\main\java\org\apache\hadoop\fs\azurebfs\constants\FileSystemUriSchemes.java,0,11,0,1,0,12
hadoop-trunk\hadoop-trunk\hadoop-common-project\hadoop-common\src\main\java\org\apache\hadoop\fs\permission\ChmodParser.java,25,10,1,1,0,12
hadoop-trunk\hadoop-trunk\hadoop-yarn-project\hadoop-yarn\hadoop-yarn-applications\hadoop-yarn-services\hadoop-yarn-services-core\src\main\java\org\apache\hadoop\yarn\service\api\ServiceApiConstants.java,0,19,16,1,0,36
hadoop-trunk\hadoop-trunk\hadoop-yarn-project\hadoop-yarn\hadoop-yarn-server\hadoop-yarn-server-resourcemanager\src\main\java\org\apache\hadoop\yarn\server\resourcemanager\reservation\ReservationAllocation.java,0,19,0,1,0,20
hadoop-trunk\hadoop-trunk\hadoop-common-project\hadoop-common\src\test\java\org\apache\hadoop\fs\impl\TestFutureIO.java,44,8,0,1,0,9
hadoop-trunk\hadoop-trunk\hadoop-tools\hadoop-azure\src\test\java\org\apache\hadoop\fs\azure\ITestBlobTypeSpeedDifference.java,126,57,1,4,0,62
hadoop-trunk\hadoop-trunk\hadoop-yarn-project\hadoop-yarn\hadoop-yarn-server\hadoop-yarn-server-resourcemanager\src\main\java\org\apache\hadoop\yarn\server\resourcemanager\monitor\SchedulingMonitor.java,90,23,5,1,0,29
hadoop-trunk\hadoop-trunk\hadoop-yarn-project\hadoop-yarn\hadoop-yarn-server\hadoop-yarn-server-common\src\main\java\org\apache\hadoop\yarn\server\utils\BuilderUtils.java,447,278,4,2,0,284
hadoop-trunk\hadoop-trunk\hadoop-yarn-project\hadoop-yarn\hadoop-yarn-server\hadoop-yarn-server-timelineservice-documentstore\src\test\java\org\apache\hadoop\yarn\server\timelineservice\documentstore\reader\cosmosdb\TestCosmosDBDocumentStoreReader.java,30,4,3,4,0,11
hadoop-trunk\hadoop-trunk\hadoop-yarn-project\hadoop-yarn\hadoop-yarn-server\hadoop-yarn-server-timelineservice-hbase\hadoop-yarn-server-timelineservice-hbase-common\src\main\java\org\apache\hadoop\yarn\server\timelineservice\storage\common\Range.java,36,11,0,1,0,12
hadoop-trunk\hadoop-trunk\hadoop-common-project\hadoop-common\src\test\java\org\apache\hadoop\fs\TestSymlinkLocalFSFileSystem.java,64,31,4,1,0,36
hadoop-trunk\hadoop-trunk\hadoop-mapreduce-project\hadoop-mapreduce-client\hadoop-mapreduce-client-nativetask\src\main\java\org\apache\hadoop\mapred\nativetask\serde\BytesWritableSerializer.java,0,11,0,2,0,13
hadoop-trunk\hadoop-trunk\hadoop-yarn-project\hadoop-yarn\hadoop-yarn-common\src\main\java\org\apache\hadoop\yarn\api\protocolrecords\impl\pb\NodeUnpublishVolumeResponsePBImpl.java,35,9,12,1,0,22
hadoop-trunk\hadoop-trunk\hadoop-yarn-project\hadoop-yarn\hadoop-yarn-server\hadoop-yarn-server-resourcemanager\src\main\java\org\apache\hadoop\yarn\server\resourcemanager\reservation\FairSchedulerPlanFollower.java,92,35,4,4,0,43
hadoop-trunk\hadoop-trunk\hadoop-tools\hadoop-openstack\src\main\java\org\apache\hadoop\fs\swift\util\Duration.java,38,18,2,1,0,21
hadoop-trunk\hadoop-trunk\hadoop-tools\hadoop-sls\src\main\java\org\apache\hadoop\yarn\sls\appmaster\MRAMSimulator.java,359,59,20,3,0,82
hadoop-trunk\hadoop-trunk\hadoop-tools\hadoop-aws\src\main\java\org\apache\hadoop\fs\s3a\commit\staging\StagingCommitterFactory.java,0,5,0,1,0,6
hadoop-trunk\hadoop-trunk\hadoop-yarn-project\hadoop-yarn\hadoop-yarn-api\src\main\java\org\apache\hadoop\yarn\server\api\protocolrecords\RefreshAdminAclsRequest.java,10,1,1,1,0,3
hadoop-trunk\hadoop-trunk\hadoop-hdfs-project\hadoop-hdfs\src\main\java\org\apache\hadoop\hdfs\server\namenode\SaveNamespaceCancelledException.java,8,1,0,1,0,2
hadoop-trunk\hadoop-trunk\hadoop-yarn-project\hadoop-yarn\hadoop-yarn-server\hadoop-yarn-server-resourcemanager\src\test\java\org\apache\hadoop\yarn\server\resourcemanager\monitor\capacity\TestProportionalCapacityPreemptionPolicyForReservedContainers.java,0,68,0,9,0,77
hadoop-trunk\hadoop-trunk\hadoop-hdfs-project\hadoop-hdfs\src\main\java\org\apache\hadoop\hdfs\server\blockmanagement\BlockInfo.java,0,126,3,5,0,134
hadoop-trunk\hadoop-trunk\hadoop-hdfs-project\hadoop-hdfs\src\test\java\org\apache\hadoop\hdfs\server\namenode\ha\TestHAFsck.java,70,12,0,1,0,13
hadoop-trunk\hadoop-trunk\hadoop-common-project\hadoop-common\src\main\java\org\apache\hadoop\service\AbstractService.java,450,42,7,2,0,51
hadoop-trunk\hadoop-trunk\hadoop-common-project\hadoop-common\src\main\java\org\apache\hadoop\ipc\RpcNoSuchProtocolException.java,21,6,6,3,0,15
hadoop-trunk\hadoop-trunk\hadoop-hdfs-project\hadoop-hdfs-rbf\src\main\java\org\apache\hadoop\hdfs\protocolPB\RouterAdminProtocolTranslatorPB.java,215,39,66,72,0,177
hadoop-trunk\hadoop-trunk\hadoop-mapreduce-project\hadoop-mapreduce-client\hadoop-mapreduce-client-core\src\main\java\org\apache\hadoop\mapred\JobPriority.java,0,8,0,1,0,9
hadoop-trunk\hadoop-trunk\hadoop-common-project\hadoop-common\src\main\java\org\apache\hadoop\io\compress\bzip2\CBZip2OutputStream.java,1957,443,137,23,0,603
hadoop-trunk\hadoop-trunk\hadoop-yarn-project\hadoop-yarn\hadoop-yarn-server\hadoop-yarn-server-resourcemanager\src\test\java\org\apache\hadoop\yarn\server\resourcemanager\scheduler\capacity\TestQueueManagementDynamicEditPolicy.java,95,17,0,2,0,19
hadoop-trunk\hadoop-trunk\hadoop-yarn-project\hadoop-yarn\hadoop-yarn-server\hadoop-yarn-server-nodemanager\src\main\java\org\apache\hadoop\yarn\server\nodemanager\containermanager\resourceplugin\deviceframework\DevicePluginAdapter.java,96,32,3,9,0,44
hadoop-trunk\hadoop-trunk\hadoop-yarn-project\hadoop-yarn\hadoop-yarn-server\hadoop-yarn-server-resourcemanager\src\main\java\org\apache\hadoop\yarn\server\resourcemanager\scheduler\fair\QueueManager.java,609,114,6,2,0,122
hadoop-trunk\hadoop-trunk\hadoop-common-project\hadoop-common\src\main\java\org\apache\hadoop\net\TableMapping.java,112,23,6,3,0,32
hadoop-trunk\hadoop-trunk\hadoop-common-project\hadoop-common\src\main\java\org\apache\hadoop\io\WritableFactory.java,0,1,0,1,0,2
hadoop-trunk\hadoop-trunk\hadoop-mapreduce-project\hadoop-mapreduce-client\hadoop-mapreduce-client-core\src\test\java\org\apache\hadoop\mapreduce\task\reduce\TestShuffleClientMetrics.java,44,6,0,1,0,7
hadoop-trunk\hadoop-trunk\hadoop-common-project\hadoop-common\src\main\java\org\apache\hadoop\fs\impl\PathCapabilitiesSupport.java,20,2,1,1,0,4
hadoop-trunk\hadoop-trunk\hadoop-hdfs-project\hadoop-hdfs\src\test\java\org\apache\hadoop\hdfs\TestReservedRawPaths.java,313,49,4,1,0,54
hadoop-trunk\hadoop-trunk\hadoop-tools\hadoop-sls\src\main\java\org\apache\hadoop\yarn\sls\utils\NodeUsageRanges.java,0,31,1,1,0,33
hadoop-trunk\hadoop-trunk\hadoop-common-project\hadoop-common\src\main\java\org\apache\hadoop\metrics2\impl\MetricsSinkAdapter.java,0,90,15,1,0,106
hadoop-trunk\hadoop-trunk\hadoop-hdfs-project\hadoop-hdfs\src\main\java\org\apache\hadoop\hdfs\server\datanode\fsdataset\impl\FsVolumeImpl.java,1498,318,25,5,0,348
hadoop-trunk\hadoop-trunk\hadoop-mapreduce-project\hadoop-mapreduce-client\hadoop-mapreduce-client-common\src\main\java\org\apache\hadoop\mapreduce\v2\api\protocolrecords\GetTaskReportRequest.java,0,8,2,1,0,11
hadoop-trunk\hadoop-trunk\hadoop-mapreduce-project\hadoop-mapreduce-client\hadoop-mapreduce-client-core\src\main\java\org\apache\hadoop\mapreduce\lib\input\DelegatingMapper.java,0,14,5,1,0,20
hadoop-trunk\hadoop-trunk\hadoop-hdfs-project\hadoop-hdfs-rbf\src\test\java\org\apache\hadoop\hdfs\server\federation\router\TestRouterRpcStoragePolicySatisfier.java,0,9,2,1,0,12
hadoop-trunk\hadoop-trunk\hadoop-yarn-project\hadoop-yarn\hadoop-yarn-server\hadoop-yarn-server-resourcemanager\src\test\java\org\apache\hadoop\yarn\server\resourcemanager\rmapp\attempt\TestRMAppAttemptImplDiagnostics.java,73,6,1,1,0,8
hadoop-trunk\hadoop-trunk\hadoop-yarn-project\hadoop-yarn\hadoop-yarn-api\src\main\java\org\apache\hadoop\yarn\api\protocolrecords\GetAttributesToNodesResponse.java,26,4,0,1,0,5
hadoop-trunk\hadoop-trunk\hadoop-hdfs-project\hadoop-hdfs-client\src\main\java\org\apache\hadoop\hdfs\HdfsKMSUtil.java,0,34,0,5,0,39
hadoop-trunk\hadoop-trunk\hadoop-hdfs-project\hadoop-hdfs\src\test\java\org\apache\hadoop\hdfs\TestViewDistributedFileSystemContract.java,0,8,1,1,0,10
hadoop-trunk\hadoop-trunk\hadoop-mapreduce-project\hadoop-mapreduce-client\hadoop-mapreduce-client-core\src\main\java\org\apache\hadoop\mapreduce\lib\output\committer\manifest\stages\CommitTaskStage.java,0,8,1,5,0,14
hadoop-trunk\hadoop-trunk\hadoop-tools\hadoop-rumen\src\main\java\org\apache\hadoop\tools\rumen\JobBuilder.java,734,100,44,10,0,154
hadoop-trunk\hadoop-trunk\hadoop-mapreduce-project\hadoop-mapreduce-client\hadoop-mapreduce-client-hs\src\main\java\org\apache\hadoop\mapreduce\v2\hs\JHSDelegationTokenSecretManager.java,0,27,6,3,0,36
hadoop-trunk\hadoop-trunk\hadoop-mapreduce-project\hadoop-mapreduce-client\hadoop-mapreduce-client-common\src\main\java\org\apache\hadoop\mapreduce\v2\api\records\impl\pb\TaskAttemptCompletionEventPBImpl.java,145,50,62,10,0,122
hadoop-trunk\hadoop-trunk\hadoop-tools\hadoop-aws\src\test\java\org\apache\hadoop\fs\s3a\fileContext\ITestS3AFileContextMainOperations.java,0,6,1,1,0,8
hadoop-trunk\hadoop-trunk\hadoop-yarn-project\hadoop-yarn\hadoop-yarn-server\hadoop-yarn-server-common\src\main\java\org\apache\hadoop\yarn\server\volume\csi\exception\VolumeException.java,11,5,0,1,0,6
hadoop-trunk\hadoop-trunk\hadoop-mapreduce-project\hadoop-mapreduce-client\hadoop-mapreduce-client-core\src\main\java\org\apache\hadoop\mapred\Reducer.java,0,78,6,15,0,99
hadoop-trunk\hadoop-trunk\hadoop-yarn-project\hadoop-yarn\hadoop-yarn-server\hadoop-yarn-server-common\src\main\java\org\apache\hadoop\yarn\server\federation\policies\router\LoadBasedRouterPolicy.java,76,7,0,4,0,11
hadoop-trunk\hadoop-trunk\hadoop-common-project\hadoop-common\src\main\java\org\apache\hadoop\fs\audit\AuditConstants.java,0,0,0,1,0,1
hadoop-trunk\hadoop-trunk\hadoop-common-project\hadoop-common\src\test\java\org\apache\hadoop\test\CoreTestDriver.java,38,19,2,1,0,22
hadoop-trunk\hadoop-trunk\hadoop-tools\hadoop-azure-datalake\src\test\java\org\apache\hadoop\fs\adl\live\AdlStorageConfiguration.java,0,18,0,1,0,19
hadoop-trunk\hadoop-trunk\hadoop-yarn-project\hadoop-yarn\hadoop-yarn-server\hadoop-yarn-server-nodemanager\src\main\java\org\apache\hadoop\yarn\server\nodemanager\LocalDirsHandlerService.java,0,114,17,9,0,140
hadoop-trunk\hadoop-trunk\hadoop-common-project\hadoop-common\src\main\java\org\apache\hadoop\io\nativeio\NativeIOException.java,0,17,2,1,0,20
hadoop-trunk\hadoop-trunk\hadoop-hdfs-project\hadoop-hdfs\src\test\java\org\apache\hadoop\hdfs\server\namenode\TestXAttrConfigFlag.java,113,19,5,2,0,26
hadoop-trunk\hadoop-trunk\hadoop-tools\hadoop-azure\src\main\java\org\apache\hadoop\fs\azurebfs\diagnostics\BooleanConfigurationBasicValidator.java,22,9,2,6,0,17
hadoop-trunk\hadoop-trunk\hadoop-yarn-project\hadoop-yarn\hadoop-yarn-server\hadoop-yarn-server-applicationhistoryservice\src\main\java\org\apache\hadoop\yarn\server\applicationhistoryservice\webapp\AppPage.java,36,4,0,1,0,5
hadoop-trunk\hadoop-trunk\hadoop-hdfs-project\hadoop-hdfs\src\main\java\org\apache\hadoop\hdfs\qjournal\client\QuorumOutputStream.java,0,23,1,4,0,28
hadoop-trunk\hadoop-trunk\hadoop-mapreduce-project\hadoop-mapreduce-client\hadoop-mapreduce-client-core\src\test\java\org\apache\hadoop\mapreduce\jobhistory\TestHistoryViewerPrinter.java,1128,1055,1,103,0,1159
hadoop-trunk\hadoop-trunk\hadoop-yarn-project\hadoop-yarn\hadoop-yarn-server\hadoop-yarn-server-nodemanager\src\main\java\org\apache\hadoop\yarn\server\nodemanager\webapp\ContainerShellWebSocket.java,0,30,9,2,0,41
hadoop-trunk\hadoop-trunk\hadoop-yarn-project\hadoop-yarn\hadoop-yarn-server\hadoop-yarn-server-timelineservice\src\main\java\org\apache\hadoop\yarn\server\timelineservice\reader\TimelineReaderServer.java,0,25,3,4,0,32
hadoop-trunk\hadoop-trunk\hadoop-yarn-project\hadoop-yarn\hadoop-yarn-server\hadoop-yarn-server-resourcemanager\src\test\java\org\apache\hadoop\yarn\server\resourcemanager\scheduler\capacity\TestCSMaxRunningAppsEnforcer.java,241,33,1,8,0,42
hadoop-trunk\hadoop-trunk\hadoop-mapreduce-project\hadoop-mapreduce-client\hadoop-mapreduce-client-core\src\main\java\org\apache\hadoop\mapred\lib\aggregate\ValueAggregatorJobBase.java,0,16,10,4,0,30
hadoop-trunk\hadoop-trunk\hadoop-common-project\hadoop-common\src\main\java\org\apache\hadoop\fs\viewfs\RegexMountPointInterceptorType.java,0,8,0,1,0,9
hadoop-trunk\hadoop-trunk\hadoop-mapreduce-project\hadoop-mapreduce-client\hadoop-mapreduce-client-core\src\main\java\org\apache\hadoop\mapred\TaskReport.java,0,65,10,1,0,76
hadoop-trunk\hadoop-trunk\hadoop-mapreduce-project\hadoop-mapreduce-examples\src\main\java\org\apache\hadoop\examples\pi\SummationWritable.java,0,72,6,3,0,81
hadoop-trunk\hadoop-trunk\hadoop-hdfs-project\hadoop-hdfs-rbf\src\main\java\org\apache\hadoop\hdfs\server\federation\store\protocol\impl\pb\RefreshMountTableEntriesRequestPBImpl.java,0,10,26,5,0,41
hadoop-trunk\hadoop-trunk\hadoop-tools\hadoop-resourceestimator\src\main\java\org\apache\hadoop\resourceestimator\skylinestore\impl\InMemoryStore.java,212,12,13,7,0,32
hadoop-trunk\hadoop-trunk\hadoop-yarn-project\hadoop-yarn\hadoop-yarn-common\src\main\java\org\apache\hadoop\yarn\webapp\view\TwoColumnLayout.java,101,10,2,2,0,14
hadoop-trunk\hadoop-trunk\hadoop-hdfs-project\hadoop-hdfs-rbf\src\main\java\org\apache\hadoop\hdfs\server\federation\store\driver\impl\StateStoreSerializerPBImpl.java,0,15,4,2,0,21
hadoop-trunk\hadoop-trunk\hadoop-yarn-project\hadoop-yarn\hadoop-yarn-csi\src\main\java\org\apache\hadoop\yarn\csi\translator\ValidationVolumeCapabilitiesResponseProtoTranslator.java,0,4,6,2,0,12
hadoop-trunk\hadoop-trunk\hadoop-common-project\hadoop-common\src\main\java\org\apache\hadoop\util\LambdaUtils.java,0,0,1,1,0,2
hadoop-trunk\hadoop-trunk\hadoop-tools\hadoop-streaming\src\main\java\org\apache\hadoop\streaming\io\RawBytesOutputReader.java,0,17,0,1,0,18
hadoop-trunk\hadoop-trunk\hadoop-common-project\hadoop-common\src\main\java\org\apache\hadoop\io\erasurecode\rawcoder\XORRawErasureCoderFactory.java,25,7,0,1,0,8
hadoop-trunk\hadoop-trunk\hadoop-hdfs-project\hadoop-hdfs-rbf\src\test\java\org\apache\hadoop\fs\contract\router\TestRouterHDFSContractDeleteSecure.java,0,4,0,1,0,5
hadoop-trunk\hadoop-trunk\hadoop-tools\hadoop-aws\src\main\java\org\apache\hadoop\fs\s3a\statistics\S3AStatisticInterface.java,5,0,0,1,0,1
hadoop-trunk\hadoop-trunk\hadoop-mapreduce-project\hadoop-mapreduce-client\hadoop-mapreduce-client-common\src\test\java\org\apache\hadoop\mapred\TestJobClientGetJob.java,34,9,2,1,0,12
hadoop-trunk\hadoop-trunk\hadoop-mapreduce-project\hadoop-mapreduce-client\hadoop-mapreduce-client-jobclient\src\test\java\org\apache\hadoop\mapred\TestFieldSelection.java,77,14,9,1,0,24
hadoop-trunk\hadoop-trunk\hadoop-mapreduce-project\hadoop-mapreduce-client\hadoop-mapreduce-client-core\src\main\java\org\apache\hadoop\mapreduce\jobhistory\JSONHistoryViewerPrinter.java,0,21,5,1,0,27
hadoop-trunk\hadoop-trunk\hadoop-mapreduce-project\hadoop-mapreduce-client\hadoop-mapreduce-client-core\src\main\java\org\apache\hadoop\mapreduce\task\reduce\ShuffleScheduler.java,0,5,3,1,0,9
hadoop-trunk\hadoop-trunk\hadoop-yarn-project\hadoop-yarn\hadoop-yarn-server\hadoop-yarn-server-timelineservice-documentstore\src\main\java\org\apache\hadoop\yarn\server\timelineservice\documentstore\collection\document\flowactivity\FlowActivitySubDoc.java,51,22,1,2,0,25
hadoop-trunk\hadoop-trunk\hadoop-yarn-project\hadoop-yarn\hadoop-yarn-common\src\test\java\org\apache\hadoop\yarn\util\resource\TestResourceCalculator.java,0,120,2,1,0,123
hadoop-trunk\hadoop-trunk\hadoop-yarn-project\hadoop-yarn\hadoop-yarn-server\hadoop-yarn-server-nodemanager\src\test\java\org\apache\hadoop\yarn\server\nodemanager\containermanager\launcher\TestContainersLauncher.java,227,27,44,5,0,76
hadoop-trunk\hadoop-trunk\hadoop-hdfs-project\hadoop-hdfs-client\src\main\java\org\apache\hadoop\hdfs\web\resources\HttpOpParam.java,0,18,0,1,0,19
hadoop-trunk\hadoop-trunk\hadoop-yarn-project\hadoop-yarn\hadoop-yarn-server\hadoop-yarn-server-resourcemanager\src\main\java\org\apache\hadoop\yarn\server\resourcemanager\scheduler\capacity\queuemanagement\DeactivatedLeafQueuesByLabel.java,81,51,2,8,0,61
hadoop-trunk\hadoop-trunk\hadoop-tools\hadoop-aws\src\main\java\org\apache\hadoop\fs\s3a\impl\AbstractStoreOperation.java,57,3,0,1,0,4
hadoop-trunk\hadoop-trunk\hadoop-yarn-project\hadoop-yarn\hadoop-yarn-server\hadoop-yarn-server-nodemanager\src\main\java\org\apache\hadoop\yarn\server\nodemanager\nodelabels\ConfigurationNodeLabelsProvider.java,47,6,0,1,0,7
hadoop-trunk\hadoop-trunk\hadoop-hdfs-project\hadoop-hdfs\src\main\java\org\apache\hadoop\hdfs\server\namenode\FSDirAttrOp.java,472,105,14,3,0,122
hadoop-trunk\hadoop-trunk\hadoop-hdfs-project\hadoop-hdfs-client\src\main\java\org\apache\hadoop\hdfs\protocolPB\ReconfigurationProtocolPB.java,0,0,3,2,0,5
hadoop-trunk\hadoop-trunk\hadoop-common-project\hadoop-common\src\main\java\org\apache\hadoop\fs\FSExceptionMessages.java,37,9,0,1,0,10
hadoop-trunk\hadoop-trunk\hadoop-tools\hadoop-streaming\src\test\java\org\apache\hadoop\streaming\TestStreamingStderr.java,0,44,12,6,0,62
hadoop-trunk\hadoop-trunk\hadoop-yarn-project\hadoop-yarn\hadoop-yarn-server\hadoop-yarn-server-nodemanager\src\main\java\org\apache\hadoop\yarn\server\nodemanager\amrmproxy\AMRMProxyApplicationContext.java,0,1,0,1,0,2
hadoop-trunk\hadoop-trunk\hadoop-yarn-project\hadoop-yarn\hadoop-yarn-server\hadoop-yarn-server-resourcemanager\src\main\java\org\apache\hadoop\yarn\server\resourcemanager\scheduler\constraint\MemoryPlacementConstraintManager.java,0,40,4,1,0,45
hadoop-trunk\hadoop-trunk\hadoop-hdfs-project\hadoop-hdfs\src\test\java\org\apache\hadoop\hdfs\server\namenode\TestEditLogJournalFailures.java,303,59,1,2,0,62
hadoop-trunk\hadoop-trunk\hadoop-tools\hadoop-streaming\src\main\java\org\apache\hadoop\streaming\Environment.java,97,18,6,4,0,28
hadoop-trunk\hadoop-trunk\hadoop-hdfs-project\hadoop-hdfs\src\main\java\org\apache\hadoop\hdfs\server\namenode\INodeWithAdditionalFields.java,0,112,3,2,0,117
hadoop-trunk\hadoop-trunk\hadoop-common-project\hadoop-common\src\test\java\org\apache\hadoop\fs\FileContextURIBase.java,0,65,12,5,0,82
hadoop-trunk\hadoop-trunk\hadoop-mapreduce-project\hadoop-mapreduce-client\hadoop-mapreduce-client-common\src\main\java\org\apache\hadoop\mapreduce\v2\api\protocolrecords\impl\pb\RenewDelegationTokenResponsePBImpl.java,44,20,23,4,0,47
hadoop-trunk\hadoop-trunk\hadoop-mapreduce-project\hadoop-mapreduce-client\hadoop-mapreduce-client-jobclient\src\test\java\org\apache\hadoop\mapred\SortValidator.java,545,300,24,6,0,330
hadoop-trunk\hadoop-trunk\hadoop-mapreduce-project\hadoop-mapreduce-client\hadoop-mapreduce-client-core\src\main\java\org\apache\hadoop\mapreduce\QueueState.java,0,11,0,1,0,12
hadoop-trunk\hadoop-trunk\hadoop-tools\hadoop-azure\src\main\java\org\apache\hadoop\fs\azure\metrics\ErrorMetricUpdater.java,0,11,0,2,0,13
hadoop-trunk\hadoop-trunk\hadoop-hdfs-project\hadoop-hdfs\src\main\java\org\apache\hadoop\hdfs\server\datanode\ErrorReportAction.java,57,20,1,1,0,22
hadoop-trunk\hadoop-trunk\hadoop-yarn-project\hadoop-yarn\hadoop-yarn-server\hadoop-yarn-server-nodemanager\src\test\java\org\apache\hadoop\yarn\server\nodemanager\scheduler\TestDistributedScheduler.java,228,59,2,9,0,70
hadoop-trunk\hadoop-trunk\hadoop-yarn-project\hadoop-yarn\hadoop-yarn-server\hadoop-yarn-server-resourcemanager\src\main\java\org\apache\hadoop\yarn\server\resourcemanager\scheduler\capacity\ManagedParentQueue.java,429,49,5,13,0,67
hadoop-trunk\hadoop-trunk\hadoop-yarn-project\hadoop-yarn\hadoop-yarn-server\hadoop-yarn-server-resourcemanager\src\main\java\org\apache\hadoop\yarn\server\resourcemanager\webapp\dao\ResourceInfo.java,71,27,1,1,0,29
hadoop-trunk\hadoop-trunk\hadoop-yarn-project\hadoop-yarn\hadoop-yarn-server\hadoop-yarn-server-common\src\main\java\org\apache\hadoop\yarn\server\api\SCMUploaderProtocolPB.java,0,1,2,3,0,6
hadoop-trunk\hadoop-trunk\hadoop-yarn-project\hadoop-yarn\hadoop-yarn-server\hadoop-yarn-server-resourcemanager\src\main\java\org\apache\hadoop\yarn\server\resourcemanager\webapp\dao\AppTimeoutInfo.java,41,20,0,1,0,21
hadoop-trunk\hadoop-trunk\hadoop-common-project\hadoop-common\src\main\java\org\apache\hadoop\io\erasurecode\rawcoder\ByteBufferEncodingState.java,0,19,1,1,0,21
hadoop-trunk\hadoop-trunk\hadoop-hdfs-project\hadoop-hdfs-client\src\main\java\org\apache\hadoop\fs\CacheFlag.java,0,4,0,1,0,5
hadoop-trunk\hadoop-trunk\hadoop-hdfs-project\hadoop-hdfs\src\main\java\org\apache\hadoop\hdfs\server\namenode\FSImage.java,1477,375,66,21,0,462
hadoop-trunk\hadoop-trunk\hadoop-yarn-project\hadoop-yarn\hadoop-yarn-common\src\main\java\org\apache\hadoop\yarn\logaggregation\filecontroller\ifile\IndexedFileAggregatedLogsBlock.java,187,26,12,5,0,43
hadoop-trunk\hadoop-trunk\hadoop-yarn-project\hadoop-yarn\hadoop-yarn-server\hadoop-yarn-server-nodemanager\src\main\java\org\apache\hadoop\yarn\server\nodemanager\containermanager\loghandler\event\LogHandlerTokenUpdatedEvent.java,8,1,0,2,0,3
hadoop-trunk\hadoop-trunk\hadoop-yarn-project\hadoop-yarn\hadoop-yarn-server\hadoop-yarn-server-resourcemanager\src\test\java\org\apache\hadoop\yarn\server\resourcemanager\scheduler\capacity\TestCapacitySchedulerSchedulingRequestUpdate.java,253,61,0,8,0,69
hadoop-trunk\hadoop-trunk\hadoop-yarn-project\hadoop-yarn\hadoop-yarn-applications\hadoop-yarn-services\hadoop-yarn-services-core\src\main\java\org\apache\hadoop\yarn\service\exceptions\RestApiErrorMessages.java,0,57,47,2,0,106
hadoop-trunk\hadoop-trunk\hadoop-yarn-project\hadoop-yarn\hadoop-yarn-applications\hadoop-yarn-services\hadoop-yarn-services-core\src\test\java\org\apache\hadoop\yarn\service\TestDefaultUpgradeComponentsFinder.java,90,7,0,1,0,8
hadoop-trunk\hadoop-trunk\hadoop-tools\hadoop-azure\src\main\java\org\apache\hadoop\fs\azure\metrics\BandwidthGaugeUpdater.java,0,58,5,4,0,67
hadoop-trunk\hadoop-trunk\hadoop-yarn-project\hadoop-yarn\hadoop-yarn-server\hadoop-yarn-server-timelineservice-hbase\hadoop-yarn-server-timelineservice-hbase-common\src\main\java\org\apache\hadoop\yarn\server\timelineservice\storage\flow\FlowActivityTable.java,0,0,0,1,0,1
hadoop-trunk\hadoop-trunk\hadoop-hdfs-project\hadoop-hdfs\src\main\java\org\apache\hadoop\hdfs\qjournal\server\JNStorage.java,0,65,4,1,0,70
hadoop-trunk\hadoop-trunk\hadoop-yarn-project\hadoop-yarn\hadoop-yarn-api\src\main\java\org\apache\hadoop\yarn\api\records\Resource.java,480,57,6,2,0,65
hadoop-trunk\hadoop-trunk\hadoop-yarn-project\hadoop-yarn\hadoop-yarn-server\hadoop-yarn-server-resourcemanager\src\main\java\org\apache\hadoop\yarn\server\resourcemanager\scheduler\activities\ActivityLevel.java,0,4,0,1,0,5
hadoop-trunk\hadoop-trunk\hadoop-common-project\hadoop-common\src\main\java\org\apache\hadoop\util\FindClass.java,0,63,19,3,0,85
hadoop-trunk\hadoop-trunk\hadoop-common-project\hadoop-common\src\test\java\org\apache\hadoop\fs\shell\TestPathExceptions.java,49,14,2,4,0,20
hadoop-trunk\hadoop-trunk\hadoop-hdfs-project\hadoop-hdfs-client\src\main\java\org\apache\hadoop\hdfs\DFSUtilClient.java,1101,295,27,21,0,343
hadoop-trunk\hadoop-trunk\hadoop-yarn-project\hadoop-yarn\hadoop-yarn-common\src\main\java\org\apache\hadoop\yarn\api\records\impl\pb\ReservationRequestsPBImpl.java,173,32,55,3,0,90
hadoop-trunk\hadoop-trunk\hadoop-common-project\hadoop-common\src\main\java\org\apache\hadoop\ipc\RpcNoSuchMethodException.java,21,7,6,3,0,16
hadoop-trunk\hadoop-trunk\hadoop-mapreduce-project\hadoop-mapreduce-client\hadoop-mapreduce-client-core\src\main\java\org\apache\hadoop\mapred\lib\CombineTextInputFormat.java,0,14,0,1,0,15
hadoop-trunk\hadoop-trunk\hadoop-yarn-project\hadoop-yarn\hadoop-yarn-server\hadoop-yarn-server-resourcemanager\src\test\java\org\apache\hadoop\yarn\server\resourcemanager\scheduler\TestResourceUsage.java,117,31,3,1,0,35
hadoop-trunk\hadoop-trunk\hadoop-common-project\hadoop-common\src\main\java\org\apache\hadoop\metrics2\lib\MutableQuantiles.java,138,39,0,2,0,41
hadoop-trunk\hadoop-trunk\hadoop-common-project\hadoop-common\src\test\java\org\apache\hadoop\ipc\MiniRPCBenchmark.java,339,169,22,10,0,201
hadoop-trunk\hadoop-trunk\hadoop-yarn-project\hadoop-yarn\hadoop-yarn-server\hadoop-yarn-server-resourcemanager\src\test\java\org\apache\hadoop\yarn\server\resourcemanager\monitor\capacity\TestProportionalCapacityPreemptionPolicyForNodePartitions.java,0,165,1,10,0,176
hadoop-trunk\hadoop-trunk\hadoop-hdfs-project\hadoop-hdfs-client\src\main\java\org\apache\hadoop\hdfs\protocolPB\ClientDatanodeProtocolTranslatorPB.java,0,81,80,29,0,190
hadoop-trunk\hadoop-trunk\hadoop-common-project\hadoop-common\src\test\java\org\apache\hadoop\conf\TestConfServlet.java,197,32,4,2,0,38
hadoop-trunk\hadoop-trunk\hadoop-hdfs-project\hadoop-hdfs-client\src\main\java\org\apache\hadoop\hdfs\protocol\OpenFilesIterator.java,0,24,0,1,0,25
hadoop-trunk\hadoop-trunk\hadoop-tools\hadoop-azure-datalake\src\test\java\org\apache\hadoop\fs\adl\live\TestAdlContractDistCpLive.java,9,2,0,1,0,3
hadoop-trunk\hadoop-trunk\hadoop-yarn-project\hadoop-yarn\hadoop-yarn-common\src\main\java\org\apache\hadoop\yarn\nodelabels\AbstractLabel.java,45,28,0,1,0,29
hadoop-trunk\hadoop-trunk\hadoop-common-project\hadoop-common\src\main\java\org\apache\hadoop\metrics2\lib\MutableCounter.java,17,6,1,1,0,8
hadoop-trunk\hadoop-trunk\hadoop-mapreduce-project\hadoop-mapreduce-client\hadoop-mapreduce-client-common\src\main\java\org\apache\hadoop\mapreduce\v2\api\HSClientProtocol.java,0,0,0,1,0,1
hadoop-trunk\hadoop-trunk\hadoop-yarn-project\hadoop-yarn\hadoop-yarn-server\hadoop-yarn-server-resourcemanager\src\main\java\org\apache\hadoop\yarn\server\resourcemanager\webapp\RMWebServiceProtocol.java,0,9,0,15,0,24
hadoop-trunk\hadoop-trunk\hadoop-common-project\hadoop-common\src\main\java\org\apache\hadoop\crypto\key\CachingKeyProvider.java,0,29,4,1,0,34
hadoop-trunk\hadoop-trunk\hadoop-common-project\hadoop-common\src\main\java\org\apache\hadoop\fs\viewfs\MountTableConfigLoader.java,0,0,0,1,0,1
hadoop-trunk\hadoop-trunk\hadoop-tools\hadoop-aws\src\main\java\org\apache\hadoop\fs\s3a\audit\impl\AbstractOperationAuditor.java,0,1,0,1,0,2
hadoop-trunk\hadoop-trunk\hadoop-mapreduce-project\hadoop-mapreduce-client\hadoop-mapreduce-client-common\src\main\java\org\apache\hadoop\mapreduce\v2\api\protocolrecords\GetTaskReportsResponse.java,0,22,7,1,0,30
hadoop-trunk\hadoop-trunk\hadoop-hdfs-project\hadoop-hdfs\src\main\java\org\apache\hadoop\hdfs\server\namenode\NNStorage.java,1113,265,22,5,0,292
hadoop-trunk\hadoop-trunk\hadoop-hdfs-project\hadoop-hdfs\src\test\java\org\apache\hadoop\hdfs\server\datanode\TestDirectoryScanner.java,1225,219,40,15,0,274
hadoop-trunk\hadoop-trunk\hadoop-yarn-project\hadoop-yarn\hadoop-yarn-server\hadoop-yarn-server-resourcemanager\src\main\java\org\apache\hadoop\yarn\server\resourcemanager\webapp\dao\NodeToLabelsEntry.java,26,13,3,1,0,17
hadoop-trunk\hadoop-trunk\hadoop-hdfs-project\hadoop-hdfs\src\main\java\org\apache\hadoop\hdfs\server\namenode\LeaseExpiredException.java,8,2,0,1,0,3
hadoop-trunk\hadoop-trunk\hadoop-hdfs-project\hadoop-hdfs\src\test\java\org\apache\hadoop\hdfs\server\datanode\TestDataNodeVolumeFailureReporting.java,719,133,19,7,0,159
hadoop-trunk\hadoop-trunk\hadoop-tools\hadoop-gridmix\src\main\java\org\apache\hadoop\mapred\gridmix\Summarizer.java,0,27,2,1,0,30
hadoop-trunk\hadoop-trunk\hadoop-yarn-project\hadoop-yarn\hadoop-yarn-server\hadoop-yarn-server-nodemanager\src\main\java\org\apache\hadoop\yarn\server\nodemanager\nodelabels\NodeDescriptorsScriptRunner.java,50,12,6,1,0,19
hadoop-trunk\hadoop-trunk\hadoop-mapreduce-project\hadoop-mapreduce-client\hadoop-mapreduce-client-jobclient\src\test\java\org\apache\hadoop\fs\slive\ConfigExtractor.java,0,64,29,4,0,97
hadoop-trunk\hadoop-trunk\hadoop-mapreduce-project\hadoop-mapreduce-client\hadoop-mapreduce-client-jobclient\src\test\java\org\apache\hadoop\mapred\TestMRCJCFileInputFormat.java,282,113,13,3,0,129
hadoop-trunk\hadoop-trunk\hadoop-yarn-project\hadoop-yarn\hadoop-yarn-server\hadoop-yarn-server-resourcemanager\src\main\java\org\apache\hadoop\yarn\server\resourcemanager\scheduler\capacity\QueueManagementChange.java,119,44,5,1,0,50
hadoop-trunk\hadoop-trunk\hadoop-hdfs-project\hadoop-hdfs\src\main\java\org\apache\hadoop\hdfs\server\common\GenerationStamp.java,14,0,0,1,0,1
hadoop-trunk\hadoop-trunk\hadoop-yarn-project\hadoop-yarn\hadoop-yarn-server\hadoop-yarn-server-common\src\main\java\org\apache\hadoop\yarn\server\federation\store\records\impl\pb\SubClusterRegisterResponsePBImpl.java,0,13,17,3,0,33
hadoop-trunk\hadoop-trunk\hadoop-common-project\hadoop-common\src\main\java\org\apache\hadoop\security\FastSaslServerFactory.java,42,12,0,1,0,13
hadoop-trunk\hadoop-trunk\hadoop-common-project\hadoop-common\src\main\java\org\apache\hadoop\io\erasurecode\coder\package-info.java,0,1,0,1,0,2
hadoop-trunk\hadoop-trunk\hadoop-mapreduce-project\hadoop-mapreduce-client\hadoop-mapreduce-client-app\src\main\java\org\apache\hadoop\mapreduce\v2\app\job\event\TaskTAttemptEvent.java,15,6,0,1,0,7
hadoop-trunk\hadoop-trunk\hadoop-common-project\hadoop-registry\src\test\java\org\apache\hadoop\registry\AbstractRegistryTest.java,84,23,3,3,0,29
hadoop-trunk\hadoop-trunk\hadoop-yarn-project\hadoop-yarn\hadoop-yarn-server\hadoop-yarn-server-router\src\main\java\org\apache\hadoop\yarn\server\router\clientrm\ClientMethod.java,45,10,2,1,0,13
hadoop-trunk\hadoop-trunk\hadoop-yarn-project\hadoop-yarn\hadoop-yarn-server\hadoop-yarn-server-timelineservice-hbase\hadoop-yarn-server-timelineservice-hbase-common\src\main\java\org\apache\hadoop\yarn\server\timelineservice\storage\common\RowKeyPrefix.java,0,1,0,1,0,2
hadoop-trunk\hadoop-trunk\hadoop-mapreduce-project\hadoop-mapreduce-client\hadoop-mapreduce-client-nativetask\src\main\java\org\apache\hadoop\mapred\nativetask\buffer\BufferType.java,0,4,1,1,0,6
hadoop-trunk\hadoop-trunk\hadoop-mapreduce-project\hadoop-mapreduce-client\hadoop-mapreduce-client-core\src\test\java\org\apache\hadoop\mapreduce\lib\output\committer\manifest\StubStoreOperations.java,73,11,2,5,0,18
hadoop-trunk\hadoop-trunk\hadoop-tools\hadoop-gridmix\src\main\java\org\apache\hadoop\mapred\gridmix\StressJobFactory.java,0,150,18,2,0,170
hadoop-trunk\hadoop-trunk\hadoop-common-project\hadoop-common\src\test\java\org\apache\hadoop\security\authentication\server\TestProxyUserAuthenticationFilter.java,84,10,2,1,0,13
hadoop-trunk\hadoop-trunk\hadoop-common-project\hadoop-common\src\main\java\org\apache\hadoop\fs\MD5MD5CRC32FileChecksum.java,76,37,0,2,0,39
hadoop-trunk\hadoop-trunk\hadoop-hdfs-project\hadoop-hdfs-client\src\main\java\org\apache\hadoop\hdfs\client\impl\BlockReaderRemote.java,394,109,21,7,0,137
hadoop-trunk\hadoop-trunk\hadoop-yarn-project\hadoop-yarn\hadoop-yarn-server\hadoop-yarn-server-nodemanager\src\test\java\org\apache\hadoop\yarn\server\nodemanager\containermanager\linux\runtime\docker\TestDockerRunCommand.java,70,10,0,2,0,12
hadoop-trunk\hadoop-trunk\hadoop-yarn-project\hadoop-yarn\hadoop-yarn-server\hadoop-yarn-server-resourcemanager\src\test\java\org\apache\hadoop\yarn\server\resourcemanager\scheduler\capacity\TestCapacitySchedulerAmbiguousLeafs.java,91,19,1,6,0,26
hadoop-trunk\hadoop-trunk\hadoop-common-project\hadoop-common\src\main\java\org\apache\hadoop\security\alias\AbstractJavaKeyStoreProvider.java,304,66,1,1,0,68
hadoop-trunk\hadoop-trunk\hadoop-hdfs-project\hadoop-hdfs-client\src\main\java\org\apache\hadoop\hdfs\web\resources\StorageTypeParam.java,18,3,1,1,0,5
hadoop-trunk\hadoop-trunk\hadoop-tools\hadoop-aws\src\main\java\org\apache\hadoop\fs\s3a\S3AFileStatus.java,213,45,3,1,0,49
hadoop-trunk\hadoop-trunk\hadoop-yarn-project\hadoop-yarn\hadoop-yarn-common\src\test\java\org\apache\hadoop\yarn\util\resource\TestResourceUtils.java,551,83,9,1,0,93
hadoop-trunk\hadoop-trunk\hadoop-yarn-project\hadoop-yarn\hadoop-yarn-server\hadoop-yarn-server-resourcemanager\src\main\java\org\apache\hadoop\yarn\server\resourcemanager\recovery\RMStateStoreRMDTMasterKeyEvent.java,18,9,0,1,0,10
hadoop-trunk\hadoop-trunk\hadoop-yarn-project\hadoop-yarn\hadoop-yarn-applications\hadoop-yarn-applications-catalog\hadoop-yarn-applications-catalog-webapp\src\main\java\org\apache\hadoop\yarn\appcatalog\controller\AppListController.java,138,8,2,2,0,12
hadoop-trunk\hadoop-trunk\hadoop-yarn-project\hadoop-yarn\hadoop-yarn-server\hadoop-yarn-server-resourcemanager\src\test\java\org\apache\hadoop\yarn\server\resourcemanager\scheduler\fair\converter\weightconversion\TestWeightToPercentageConverter.java,0,19,0,3,0,22
hadoop-trunk\hadoop-trunk\hadoop-mapreduce-project\hadoop-mapreduce-client\hadoop-mapreduce-client-core\src\main\java\org\apache\hadoop\mapreduce\QueueAclsInfo.java,59,21,1,1,0,23
hadoop-trunk\hadoop-trunk\hadoop-hdfs-project\hadoop-hdfs\src\test\java\org\apache\hadoop\hdfs\server\namenode\TestDefaultBlockPlacementPolicy.java,185,24,2,3,0,29
hadoop-trunk\hadoop-trunk\hadoop-yarn-project\hadoop-yarn\hadoop-yarn-server\hadoop-yarn-server-common\src\main\java\org\apache\hadoop\yarn\server\api\impl\pb\service\DistributedSchedulingAMProtocolPBServiceImpl.java,102,19,25,14,0,58
hadoop-trunk\hadoop-trunk\hadoop-common-project\hadoop-common\src\main\java\org\apache\hadoop\fs\DelegationTokenRenewer.java,0,54,8,7,0,69
hadoop-trunk\hadoop-trunk\hadoop-yarn-project\hadoop-yarn\hadoop-yarn-server\hadoop-yarn-server-nodemanager\src\test\java\org\apache\hadoop\yarn\server\nodemanager\TestNodeManagerShutdown.java,0,83,7,9,0,99
hadoop-trunk\hadoop-trunk\hadoop-mapreduce-project\hadoop-mapreduce-client\hadoop-mapreduce-client-app\src\test\java\org\apache\hadoop\mapreduce\v2\app\MRApp.java,0,356,30,7,0,393
hadoop-trunk\hadoop-trunk\hadoop-common-project\hadoop-common\src\test\java\org\apache\hadoop\ipc\TestWeightedRoundRobinMultiplexer.java,115,24,0,2,0,26
hadoop-trunk\hadoop-trunk\hadoop-hdfs-project\hadoop-hdfs\src\main\java\org\apache\hadoop\hdfs\server\namenode\VersionInfoMXBean.java,0,2,2,1,0,5
hadoop-trunk\hadoop-trunk\hadoop-yarn-project\hadoop-yarn\hadoop-yarn-common\src\main\java\org\apache\hadoop\yarn\security\client\TimelineDelegationTokenSelector.java,0,5,1,1,0,7
hadoop-trunk\hadoop-trunk\hadoop-common-project\hadoop-common\src\test\java\org\apache\hadoop\net\TestScriptBasedMapping.java,53,8,3,1,0,12
hadoop-trunk\hadoop-trunk\hadoop-yarn-project\hadoop-yarn\hadoop-yarn-server\hadoop-yarn-server-resourcemanager\src\main\java\org\apache\hadoop\yarn\server\resourcemanager\webapp\NodeLabelsPage.java,61,10,1,2,0,13
hadoop-trunk\hadoop-trunk\hadoop-common-project\hadoop-common\src\test\java\org\apache\hadoop\fs\FCStatisticsBaseTest.java,152,45,4,4,0,53
hadoop-trunk\hadoop-trunk\hadoop-common-project\hadoop-common\src\test\java\org\apache\hadoop\fs\TestLocalFileSystemPermission.java,234,34,6,1,0,41
hadoop-trunk\hadoop-trunk\hadoop-yarn-project\hadoop-yarn\hadoop-yarn-common\src\main\java\org\apache\hadoop\yarn\util\SystemClock.java,0,5,1,1,0,7
hadoop-trunk\hadoop-trunk\hadoop-tools\hadoop-azure\src\main\java\org\apache\hadoop\fs\azurebfs\contracts\exceptions\InvalidAclOperationException.java,0,4,0,2,0,6
hadoop-trunk\hadoop-trunk\hadoop-yarn-project\hadoop-yarn\hadoop-yarn-api\src\main\java\org\apache\hadoop\yarn\api\protocolrecords\RenewDelegationTokenResponse.java,20,4,0,1,0,5
hadoop-trunk\hadoop-trunk\hadoop-yarn-project\hadoop-yarn\hadoop-yarn-server\hadoop-yarn-server-resourcemanager\src\test\java\org\apache\hadoop\yarn\server\resourcemanager\scheduler\fifo\TestFifoScheduler.java,1242,332,144,50,0,526
hadoop-trunk\hadoop-trunk\hadoop-yarn-project\hadoop-yarn\hadoop-yarn-server\hadoop-yarn-server-router\src\test\java\org\apache\hadoop\yarn\server\router\TestRouterAuditLogger.java,129,15,2,1,0,18
hadoop-trunk\hadoop-trunk\hadoop-common-project\hadoop-common\src\test\java\org\apache\hadoop\util\TestStringInterner.java,48,17,2,1,0,20
hadoop-trunk\hadoop-trunk\hadoop-hdfs-project\hadoop-hdfs-rbf\src\main\java\org\apache\hadoop\hdfs\server\federation\store\DisabledNameserviceStore.java,0,3,0,2,0,5
hadoop-trunk\hadoop-trunk\hadoop-common-project\hadoop-common\src\main\java\org\apache\hadoop\io\compress\snappy\package-info.java,0,1,0,1,0,2
hadoop-trunk\hadoop-trunk\hadoop-common-project\hadoop-common\src\test\java\org\apache\hadoop\metrics2\impl\MetricsRecords.java,83,30,1,1,0,32
hadoop-trunk\hadoop-trunk\hadoop-tools\hadoop-rumen\src\main\java\org\apache\hadoop\tools\rumen\SingleEventEmitter.java,5,0,0,1,0,1
hadoop-trunk\hadoop-trunk\hadoop-common-project\hadoop-common\src\main\java\org\apache\hadoop\util\DurationInfo.java,0,16,2,1,0,19
hadoop-trunk\hadoop-trunk\hadoop-hdfs-project\hadoop-hdfs\src\main\java\org\apache\hadoop\hdfs\server\datanode\erasurecode\package-info.java,0,0,0,1,0,1
hadoop-trunk\hadoop-trunk\hadoop-common-project\hadoop-common\src\main\java\org\apache\hadoop\util\InstrumentedWriteLock.java,18,12,0,1,0,13
hadoop-trunk\hadoop-trunk\hadoop-hdfs-project\hadoop-hdfs\src\test\java\org\apache\hadoop\hdfs\protocol\TestAnnotations.java,13,2,0,1,0,3
hadoop-trunk\hadoop-trunk\hadoop-hdfs-project\hadoop-hdfs-rbf\src\test\java\org\apache\hadoop\hdfs\server\federation\router\TestRouterRPCClientRetries.java,187,19,1,6,0,26
hadoop-trunk\hadoop-trunk\hadoop-yarn-project\hadoop-yarn\hadoop-yarn-server\hadoop-yarn-server-common\src\main\java\org\apache\hadoop\yarn\server\federation\store\metrics\FederationStateStoreClientMetrics.java,0,27,0,1,0,28
hadoop-trunk\hadoop-trunk\hadoop-yarn-project\hadoop-yarn\hadoop-yarn-server\hadoop-yarn-server-resourcemanager\src\test\java\org\apache\hadoop\yarn\server\resourcemanager\scheduler\capacity\placement\TestMappingRuleCreator.java,432,61,1,10,0,72
hadoop-trunk\hadoop-trunk\hadoop-hdfs-project\hadoop-hdfs\src\test\java\org\apache\hadoop\fs\contract\hdfs\TestHDFSContractOpen.java,18,4,0,1,0,5
hadoop-trunk\hadoop-trunk\hadoop-common-project\hadoop-common\src\main\java\org\apache\hadoop\io\erasurecode\rawcoder\NativeRSRawDecoder.java,49,11,0,1,0,12
hadoop-trunk\hadoop-trunk\hadoop-cloud-storage-project\hadoop-huaweicloud\src\main\java\org\apache\hadoop\fs\obs\OBSDataBlocks.java,0,0,9,1,0,10
hadoop-trunk\hadoop-trunk\hadoop-hdfs-project\hadoop-hdfs\src\main\java\org\apache\hadoop\hdfs\server\datanode\fsdataset\impl\FsDatasetUtil.java,185,52,8,1,0,61
hadoop-trunk\hadoop-trunk\hadoop-mapreduce-project\hadoop-mapreduce-client\hadoop-mapreduce-client-core\src\main\java\org\apache\hadoop\mapred\OutputCollector.java,0,8,0,2,0,10
hadoop-trunk\hadoop-trunk\hadoop-yarn-project\hadoop-yarn\hadoop-yarn-applications\hadoop-yarn-applications-mawo\hadoop-yarn-applications-mawo-core\src\main\java\org\apache\hadoop\applications\mawo\server\common\SimpleTask.java,32,0,0,1,0,1
hadoop-trunk\hadoop-trunk\hadoop-hdfs-project\hadoop-hdfs\src\test\java\org\apache\hadoop\hdfs\server\datanode\TestNNHandlesBlockReportPerStorage.java,16,6,1,2,0,9
hadoop-trunk\hadoop-trunk\hadoop-tools\hadoop-aws\src\test\java\org\apache\hadoop\fs\s3a\auth\ITestAssumeRole.java,0,49,11,5,0,65
hadoop-trunk\hadoop-trunk\hadoop-yarn-project\hadoop-yarn\hadoop-yarn-api\src\main\java\org\apache\hadoop\yarn\api\records\QueueConfigurations.java,189,6,0,1,0,7
hadoop-trunk\hadoop-trunk\hadoop-mapreduce-project\hadoop-mapreduce-client\hadoop-mapreduce-client-hs\src\test\java\org\apache\hadoop\mapreduce\v2\hs\webapp\TestHsWebServicesJobConf.java,206,22,4,4,0,30
hadoop-trunk\hadoop-trunk\hadoop-common-project\hadoop-common\src\test\java\org\apache\hadoop\http\TestDisabledProfileServlet.java,64,14,0,9,0,23
hadoop-trunk\hadoop-trunk\hadoop-yarn-project\hadoop-yarn\hadoop-yarn-server\hadoop-yarn-server-common\src\main\java\org\apache\hadoop\yarn\server\federation\store\records\SubClusterRegisterResponse.java,12,1,1,1,0,3
hadoop-trunk\hadoop-trunk\hadoop-hdfs-project\hadoop-hdfs-client\src\main\java\org\apache\hadoop\hdfs\inotify\EventBatchList.java,31,21,0,1,0,22
hadoop-trunk\hadoop-trunk\hadoop-yarn-project\hadoop-yarn\hadoop-yarn-server\hadoop-yarn-server-nodemanager\src\test\java\org\apache\hadoop\yarn\server\nodemanager\containermanager\linux\privileged\MockPrivilegedOperationCaptor.java,0,7,0,2,0,9
hadoop-trunk\hadoop-trunk\hadoop-mapreduce-project\hadoop-mapreduce-client\hadoop-mapreduce-client-common\src\main\java\org\apache\hadoop\mapreduce\v2\util\MRProtoUtils.java,68,46,25,9,0,80
hadoop-trunk\hadoop-trunk\hadoop-yarn-project\hadoop-yarn\hadoop-yarn-server\hadoop-yarn-server-router\src\main\java\org\apache\hadoop\yarn\server\router\webapp\NodesPage.java,0,2,0,1,0,3
hadoop-trunk\hadoop-trunk\hadoop-common-project\hadoop-common\src\main\java\org\apache\hadoop\crypto\key\KeyProviderCryptoExtension.java,0,62,18,2,0,82
hadoop-trunk\hadoop-trunk\hadoop-yarn-project\hadoop-yarn\hadoop-yarn-common\src\main\java\org\apache\hadoop\yarn\api\protocolrecords\impl\pb\GetLabelsToNodesRequestPBImpl.java,92,26,33,3,0,62
hadoop-trunk\hadoop-trunk\hadoop-hdfs-project\hadoop-hdfs-client\src\main\java\org\apache\hadoop\hdfs\AddBlockFlag.java,0,12,3,1,0,16
hadoop-trunk\hadoop-trunk\hadoop-tools\hadoop-gridmix\src\test\java\org\apache\hadoop\mapred\gridmix\TestGridmixSummary.java,0,141,6,1,0,148
hadoop-trunk\hadoop-trunk\hadoop-yarn-project\hadoop-yarn\hadoop-yarn-server\hadoop-yarn-server-nodemanager\src\main\java\org\apache\hadoop\yarn\server\nodemanager\api\impl\pb\service\LocalizationProtocolPBServiceImpl.java,24,11,7,7,0,25
hadoop-trunk\hadoop-trunk\hadoop-yarn-project\hadoop-yarn\hadoop-yarn-applications\hadoop-yarn-services\hadoop-yarn-services-core\src\test\java\org\apache\hadoop\yarn\service\TestYarnNativeServices.java,951,118,7,11,0,136
hadoop-trunk\hadoop-trunk\hadoop-tools\hadoop-rumen\src\test\java\org\apache\hadoop\tools\rumen\ConcatenatedInputFilesDemuxer.java,313,44,3,1,0,48
hadoop-trunk\hadoop-trunk\hadoop-yarn-project\hadoop-yarn\hadoop-yarn-api\src\main\java\org\apache\hadoop\yarn\api\protocolrecords\GetQueueUserAclsInfoRequest.java,10,4,1,1,0,6
hadoop-trunk\hadoop-trunk\hadoop-tools\hadoop-dynamometer\hadoop-dynamometer-blockgen\src\test\java\org\apache\hadoop\tools\dynamometer\blockgenerator\TestXMLParser.java,68,14,2,1,0,17
hadoop-trunk\hadoop-trunk\hadoop-tools\hadoop-openstack\src\main\java\org\apache\hadoop\fs\swift\exceptions\SwiftException.java,18,8,0,1,0,9
hadoop-trunk\hadoop-trunk\hadoop-tools\hadoop-streaming\src\test\java\org\apache\hadoop\streaming\TestStreaming.java,0,68,5,7,0,80
hadoop-trunk\hadoop-trunk\hadoop-mapreduce-project\hadoop-mapreduce-client\hadoop-mapreduce-client-jobclient\src\test\java\org\apache\hadoop\mapreduce\v2\TestMRJobs.java,1340,232,49,12,0,293
hadoop-trunk\hadoop-trunk\hadoop-yarn-project\hadoop-yarn\hadoop-yarn-server\hadoop-yarn-server-resourcemanager\src\main\java\org\apache\hadoop\yarn\server\resourcemanager\scheduler\capacity\conf\MutableCSConfigurationProvider.java,328,54,1,7,0,62
hadoop-trunk\hadoop-trunk\hadoop-tools\hadoop-streaming\src\main\java\org\apache\hadoop\typedbytes\TypedBytesInput.java,474,65,37,1,0,103
hadoop-trunk\hadoop-trunk\hadoop-tools\hadoop-aws\src\test\java\org\apache\hadoop\fs\s3a\impl\TestDirectoryMarkerPolicy.java,125,25,0,3,0,28
hadoop-trunk\hadoop-trunk\hadoop-yarn-project\hadoop-yarn\hadoop-yarn-server\hadoop-yarn-server-resourcemanager\src\test\java\org\apache\hadoop\yarn\server\resourcemanager\monitor\capacity\TestProportionalCapacityPreemptionPolicyInterQueueWithDRF.java,0,30,1,4,0,35
hadoop-trunk\hadoop-trunk\hadoop-hdfs-project\hadoop-hdfs\src\test\java\org\apache\hadoop\hdfs\TestDatanodeRegistration.java,0,69,15,11,0,95
hadoop-trunk\hadoop-trunk\hadoop-tools\hadoop-resourceestimator\src\main\java\org\apache\hadoop\resourceestimator\skylinestore\api\HistorySkylineStore.java,0,0,0,2,0,2
hadoop-trunk\hadoop-trunk\hadoop-yarn-project\hadoop-yarn\hadoop-yarn-applications\hadoop-yarn-services\hadoop-yarn-services-core\src\main\java\org\apache\hadoop\yarn\service\provider\tarball\TarballProviderFactory.java,30,5,0,1,0,6
hadoop-trunk\hadoop-trunk\hadoop-mapreduce-project\hadoop-mapreduce-client\hadoop-mapreduce-client-jobclient\src\test\java\org\apache\hadoop\mapreduce\lib\aggregate\TestMapReduceAggregates.java,92,12,7,1,0,20
hadoop-trunk\hadoop-trunk\hadoop-yarn-project\hadoop-yarn\hadoop-yarn-server\hadoop-yarn-server-resourcemanager\src\test\java\org\apache\hadoop\yarn\server\resourcemanager\TestResourceManager.java,326,76,14,17,0,107
hadoop-trunk\hadoop-trunk\hadoop-hdfs-project\hadoop-hdfs\src\main\java\org\apache\hadoop\hdfs\server\namenode\FSDirDeleteOp.java,0,30,2,3,0,35
hadoop-trunk\hadoop-trunk\hadoop-yarn-project\hadoop-yarn\hadoop-yarn-server\hadoop-yarn-server-resourcemanager\src\main\java\org\apache\hadoop\yarn\server\resourcemanager\webapp\RmController.java,128,34,2,6,0,42
hadoop-trunk\hadoop-trunk\hadoop-mapreduce-project\hadoop-mapreduce-client\hadoop-mapreduce-client-jobclient\src\test\java\org\apache\hadoop\mapreduce\TestLocalRunner.java,0,117,21,1,0,139
hadoop-trunk\hadoop-trunk\hadoop-tools\hadoop-rumen\src\main\java\org\apache\hadoop\tools\rumen\ParsedJob.java,143,28,2,1,0,31
hadoop-trunk\hadoop-trunk\hadoop-tools\hadoop-openstack\src\test\java\org\apache\hadoop\fs\swift\TestSwiftConfig.java,151,34,10,20,0,64
hadoop-trunk\hadoop-trunk\hadoop-yarn-project\hadoop-yarn\hadoop-yarn-api\src\main\java\org\apache\hadoop\yarn\api\records\timelineservice\QueueEntity.java,14,3,0,1,0,4
hadoop-trunk\hadoop-trunk\hadoop-mapreduce-project\hadoop-mapreduce-client\hadoop-mapreduce-client-core\src\main\java\org\apache\hadoop\mapreduce\lib\join\ComposableRecordReader.java,0,17,2,1,0,20
hadoop-trunk\hadoop-trunk\hadoop-tools\hadoop-datajoin\src\main\java\org\apache\hadoop\contrib\utils\join\ResetableIterator.java,0,6,4,1,0,11
hadoop-trunk\hadoop-trunk\hadoop-cloud-storage-project\hadoop-cos\src\main\java\org\apache\hadoop\fs\cosn\Constants.java,0,8,0,1,0,9
hadoop-trunk\hadoop-trunk\hadoop-yarn-project\hadoop-yarn\hadoop-yarn-client\src\test\java\org\apache\hadoop\yarn\client\api\impl\BaseAMRMClientTest.java,154,54,0,3,0,57
hadoop-trunk\hadoop-trunk\hadoop-common-project\hadoop-common\src\main\java\org\apache\hadoop\security\HttpCrossOriginFilterInitializer.java,45,10,1,1,0,12
hadoop-trunk\hadoop-trunk\hadoop-yarn-project\hadoop-yarn\hadoop-yarn-server\hadoop-yarn-server-resourcemanager\src\main\java\org\apache\hadoop\yarn\server\resourcemanager\reservation\planning\StageAllocatorGreedy.java,121,11,2,5,0,18
hadoop-trunk\hadoop-trunk\hadoop-yarn-project\hadoop-yarn\hadoop-yarn-server\hadoop-yarn-server-nodemanager\src\main\java\org\apache\hadoop\yarn\server\nodemanager\containermanager\resourceplugin\gpu\package-info.java,0,0,0,2,0,2
hadoop-trunk\hadoop-trunk\hadoop-common-project\hadoop-common\src\main\java\org\apache\hadoop\fs\permission\FsAction.java,0,29,1,2,0,32
hadoop-trunk\hadoop-trunk\hadoop-hdfs-project\hadoop-hdfs-rbf\src\test\java\org\apache\hadoop\fs\contract\router\TestRouterHDFSContractCreate.java,18,4,0,1,0,5
hadoop-trunk\hadoop-trunk\hadoop-hdfs-project\hadoop-hdfs\src\main\java\org\apache\hadoop\hdfs\server\datanode\ReplicaBuilder.java,355,111,0,1,0,112
hadoop-trunk\hadoop-trunk\hadoop-yarn-project\hadoop-yarn\hadoop-yarn-server\hadoop-yarn-server-nodemanager\src\main\java\org\apache\hadoop\yarn\server\nodemanager\amrmproxy\RequestInterceptor.java,57,2,0,1,0,3
hadoop-trunk\hadoop-trunk\hadoop-yarn-project\hadoop-yarn\hadoop-yarn-server\hadoop-yarn-server-resourcemanager\src\main\java\org\apache\hadoop\yarn\server\resourcemanager\RMServerUtils.java,559,88,11,3,0,102
hadoop-trunk\hadoop-trunk\hadoop-hdfs-project\hadoop-hdfs-client\src\main\java\org\apache\hadoop\hdfs\web\TokenAspect.java,0,28,5,3,0,36
hadoop-trunk\hadoop-trunk\hadoop-yarn-project\hadoop-yarn\hadoop-yarn-server\hadoop-yarn-server-resourcemanager\src\main\java\org\apache\hadoop\yarn\server\resourcemanager\webapp\NodesPage.java,0,14,5,4,0,23
hadoop-trunk\hadoop-trunk\hadoop-yarn-project\hadoop-yarn\hadoop-yarn-common\src\main\java\org\apache\hadoop\yarn\state\InvalidStateTransitonException.java,22,11,0,1,0,12
hadoop-trunk\hadoop-trunk\hadoop-hdfs-project\hadoop-hdfs\src\main\java\org\apache\hadoop\hdfs\server\datanode\erasurecode\StripedBlockWriter.java,0,32,5,2,0,39
hadoop-trunk\hadoop-trunk\hadoop-mapreduce-project\hadoop-mapreduce-client\hadoop-mapreduce-client-hs\src\test\java\org\apache\hadoop\mapreduce\v2\hs\TestJobHistoryParsing.java,961,122,98,8,0,228
hadoop-trunk\hadoop-trunk\hadoop-yarn-project\hadoop-yarn\hadoop-yarn-server\hadoop-yarn-server-resourcemanager\src\test\java\org\apache\hadoop\yarn\server\resourcemanager\applicationsmanager\TestASMStateMachine.java,174,8,0,12,0,20
hadoop-trunk\hadoop-trunk\hadoop-yarn-project\hadoop-yarn\hadoop-yarn-server\hadoop-yarn-server-resourcemanager\src\test\java\org\apache\hadoop\yarn\server\resourcemanager\webapp\TestApplicationsRequestBuilder.java,494,61,10,2,0,73
hadoop-trunk\hadoop-trunk\hadoop-yarn-project\hadoop-yarn\hadoop-yarn-server\hadoop-yarn-server-resourcemanager\src\main\java\org\apache\hadoop\yarn\server\resourcemanager\scheduler\constraint\algorithm\iterators\SerialIterator.java,24,7,1,2,0,10
hadoop-trunk\hadoop-trunk\hadoop-hdfs-project\hadoop-hdfs\src\test\java\org\apache\hadoop\hdfs\server\namenode\ha\HATestUtil.java,322,144,4,8,0,156
hadoop-trunk\hadoop-trunk\hadoop-common-project\hadoop-common\src\test\java\org\apache\hadoop\fs\TestHarFileSystem.java,347,194,102,10,0,306
hadoop-trunk\hadoop-trunk\hadoop-yarn-project\hadoop-yarn\hadoop-yarn-server\hadoop-yarn-server-timelineservice-hbase\hadoop-yarn-server-timelineservice-hbase-common\src\main\java\org\apache\hadoop\yarn\server\timelineservice\storage\flow\FlowRunRowKey.java,203,33,1,4,0,38
hadoop-trunk\hadoop-trunk\hadoop-yarn-project\hadoop-yarn\hadoop-yarn-common\src\main\java\org\apache\hadoop\yarn\security\client\RMDelegationTokenSelector.java,33,7,1,1,0,9
hadoop-trunk\hadoop-trunk\hadoop-yarn-project\hadoop-yarn\hadoop-yarn-server\hadoop-yarn-server-resourcemanager\src\main\java\org\apache\hadoop\yarn\server\resourcemanager\scheduler\placement\PendingAskUpdateResult.java,40,23,0,3,0,26
hadoop-trunk\hadoop-trunk\hadoop-yarn-project\hadoop-yarn\hadoop-yarn-server\hadoop-yarn-server-nodemanager\src\main\java\org\apache\hadoop\yarn\server\nodemanager\webapp\NMWebAppFilter.java,102,17,1,2,0,20
hadoop-trunk\hadoop-trunk\hadoop-hdfs-project\hadoop-hdfs-rbf\src\main\java\org\apache\hadoop\hdfs\server\federation\store\driver\impl\StateStoreFileImpl.java,120,20,4,1,0,25
hadoop-trunk\hadoop-trunk\hadoop-mapreduce-project\hadoop-mapreduce-client\hadoop-mapreduce-client-common\src\main\java\org\apache\hadoop\mapreduce\v2\api\protocolrecords\impl\pb\CancelDelegationTokenResponsePBImpl.java,20,9,9,3,0,21
hadoop-trunk\hadoop-trunk\hadoop-tools\hadoop-gridmix\src\main\java\org\apache\hadoop\mapred\gridmix\GridmixSplit.java,0,40,1,1,0,42
hadoop-trunk\hadoop-trunk\hadoop-hdfs-project\hadoop-hdfs-rbf\src\test\java\org\apache\hadoop\hdfs\server\federation\router\TestRouterMountTableCacheRefresh.java,332,24,4,11,0,39
hadoop-trunk\hadoop-trunk\hadoop-yarn-project\hadoop-yarn\hadoop-yarn-api\src\main\java\org\apache\hadoop\yarn\api\protocolrecords\UpdateApplicationPriorityResponse.java,24,5,0,2,0,7
hadoop-trunk\hadoop-trunk\hadoop-mapreduce-project\hadoop-mapreduce-client\hadoop-mapreduce-client-nativetask\src\main\java\org\apache\hadoop\mapred\nativetask\serde\TextSerializer.java,0,11,1,2,0,14
hadoop-trunk\hadoop-trunk\hadoop-yarn-project\hadoop-yarn\hadoop-yarn-server\hadoop-yarn-server-resourcemanager\src\main\java\org\apache\hadoop\yarn\server\resourcemanager\placement\csmappingrule\MappingRule.java,110,25,1,1,0,27
hadoop-trunk\hadoop-trunk\hadoop-tools\hadoop-azure\src\main\java\org\apache\hadoop\fs\azure\StorageInterfaceImpl.java,0,121,2,23,0,146
hadoop-trunk\hadoop-trunk\hadoop-common-project\hadoop-common\src\test\java\org\apache\hadoop\test\UnitTestcaseTimeLimit.java,7,4,1,1,0,6
hadoop-trunk\hadoop-trunk\hadoop-common-project\hadoop-common\src\main\java\org\apache\hadoop\io\erasurecode\coder\ErasureCoder.java,0,1,0,1,0,2
hadoop-trunk\hadoop-trunk\hadoop-yarn-project\hadoop-yarn\hadoop-yarn-server\hadoop-yarn-server-resourcemanager\src\test\java\org\apache\hadoop\yarn\server\resourcemanager\scheduler\TestSchedulerHealth.java,304,74,21,7,0,102
hadoop-trunk\hadoop-trunk\hadoop-common-project\hadoop-common\src\main\java\org\apache\hadoop\io\GenericWritable.java,0,43,3,8,0,54
hadoop-trunk\hadoop-trunk\hadoop-hdfs-project\hadoop-hdfs\src\test\java\org\apache\hadoop\hdfs\TestDFSClientExcludedNodes.java,112,31,1,1,0,33
hadoop-trunk\hadoop-trunk\hadoop-yarn-project\hadoop-yarn\hadoop-yarn-common\src\main\java\org\apache\hadoop\yarn\event\EventDispatcher.java,125,33,11,1,0,45
hadoop-trunk\hadoop-trunk\hadoop-yarn-project\hadoop-yarn\hadoop-yarn-common\src\main\java\org\apache\hadoop\yarn\server\api\protocolrecords\impl\pb\RefreshServiceAclsResponsePBImpl.java,44,20,18,3,0,41
hadoop-trunk\hadoop-trunk\hadoop-mapreduce-project\hadoop-mapreduce-client\hadoop-mapreduce-client-core\src\main\java\org\apache\hadoop\mapreduce\lib\output\committer\manifest\files\TaskManifest.java,301,60,3,2,0,65
hadoop-trunk\hadoop-trunk\hadoop-yarn-project\hadoop-yarn\hadoop-yarn-api\src\main\java\org\apache\hadoop\yarn\server\api\protocolrecords\UpdateNodeResourceResponse.java,9,6,1,1,0,8
hadoop-trunk\hadoop-trunk\hadoop-yarn-project\hadoop-yarn\hadoop-yarn-server\hadoop-yarn-server-resourcemanager\src\test\java\org\apache\hadoop\yarn\server\resourcemanager\scheduler\fair\TestFSParentQueue.java,48,4,2,1,0,7
hadoop-trunk\hadoop-trunk\hadoop-mapreduce-project\hadoop-mapreduce-client\hadoop-mapreduce-client-jobclient\src\test\java\org\apache\hadoop\fs\slive\BadFileException.java,0,3,0,1,0,4
hadoop-trunk\hadoop-trunk\hadoop-yarn-project\hadoop-yarn\hadoop-yarn-api\src\main\java\org\apache\hadoop\yarn\server\api\ContainerLogContext.java,43,10,0,1,0,11
hadoop-trunk\hadoop-trunk\hadoop-yarn-project\hadoop-yarn\hadoop-yarn-server\hadoop-yarn-server-resourcemanager\src\main\java\org\apache\hadoop\yarn\server\resourcemanager\rmapp\attempt\RMAppAttemptMetrics.java,203,80,4,2,0,86
hadoop-trunk\hadoop-trunk\hadoop-tools\hadoop-resourceestimator\src\main\java\org\apache\hadoop\resourceestimator\translator\validator\package-info.java,0,1,0,1,0,2
hadoop-trunk\hadoop-trunk\hadoop-hdfs-project\hadoop-hdfs\src\main\java\org\apache\hadoop\hdfs\server\namenode\metrics\FSNamesystemMBean.java,0,60,23,1,0,84
hadoop-trunk\hadoop-trunk\hadoop-mapreduce-project\hadoop-mapreduce-client\hadoop-mapreduce-client-common\src\main\java\org\apache\hadoop\mapreduce\v2\api\protocolrecords\impl\pb\KillTaskAttemptRequestPBImpl.java,79,34,33,6,0,73
hadoop-trunk\hadoop-trunk\hadoop-yarn-project\hadoop-yarn\hadoop-yarn-server\hadoop-yarn-server-nodemanager\src\main\java\org\apache\hadoop\yarn\server\nodemanager\webapp\AggregatedLogsPage.java,0,0,0,1,0,1
hadoop-trunk\hadoop-trunk\hadoop-yarn-project\hadoop-yarn\hadoop-yarn-server\hadoop-yarn-server-resourcemanager\src\test\java\org\apache\hadoop\yarn\server\resourcemanager\scheduler\capacity\TestSchedulingRequestContainerAllocationAsync.java,0,30,1,4,0,35
hadoop-trunk\hadoop-trunk\hadoop-mapreduce-project\hadoop-mapreduce-client\hadoop-mapreduce-client-jobclient\src\test\java\org\apache\hadoop\fs\slive\ArgumentParser.java,0,24,1,1,0,26
hadoop-trunk\hadoop-trunk\hadoop-hdfs-project\hadoop-hdfs\src\main\java\org\apache\hadoop\hdfs\server\namenode\ha\EditLogTailer.java,570,84,12,20,0,116
hadoop-trunk\hadoop-trunk\hadoop-mapreduce-project\hadoop-mapreduce-client\hadoop-mapreduce-client-app\src\main\java\org\apache\hadoop\mapreduce\v2\app\launcher\ContainerLauncherImpl.java,369,78,11,8,0,97
hadoop-trunk\hadoop-trunk\hadoop-hdfs-project\hadoop-hdfs-rbf\src\test\java\org\apache\hadoop\hdfs\server\federation\security\TestRouterSecurityManager.java,220,17,14,8,0,39
hadoop-trunk\hadoop-trunk\hadoop-mapreduce-project\hadoop-mapreduce-client\hadoop-mapreduce-client-core\src\main\java\org\apache\hadoop\mapred\Partitioner.java,0,11,2,1,0,14
hadoop-trunk\hadoop-trunk\hadoop-hdfs-project\hadoop-hdfs\src\test\java\org\apache\hadoop\hdfs\server\namenode\TestFSImageWithSnapshot.java,775,156,8,4,0,168
hadoop-trunk\hadoop-trunk\hadoop-yarn-project\hadoop-yarn\hadoop-yarn-common\src\main\java\org\apache\hadoop\yarn\webapp\view\TextPage.java,11,1,0,1,0,2
hadoop-trunk\hadoop-trunk\hadoop-common-project\hadoop-common\src\test\java\org\apache\hadoop\ha\TestHealthMonitorWithDedicatedHealthAddress.java,0,1,2,1,0,4
hadoop-trunk\hadoop-trunk\hadoop-hdfs-project\hadoop-hdfs\src\test\java\org\apache\hadoop\hdfs\server\namenode\TestFsck.java,2393,303,71,4,0,378
hadoop-trunk\hadoop-trunk\hadoop-tools\hadoop-gridmix\src\main\java\org\apache\hadoop\mapred\gridmix\GridmixJobSubmissionPolicy.java,0,30,3,1,0,34
hadoop-trunk\hadoop-trunk\hadoop-yarn-project\hadoop-yarn\hadoop-yarn-client\src\test\java\org\apache\hadoop\yarn\client\api\impl\BaseAMRMProxyE2ETest.java,134,14,1,4,0,19
hadoop-trunk\hadoop-trunk\hadoop-yarn-project\hadoop-yarn\hadoop-yarn-server\hadoop-yarn-server-resourcemanager\src\main\java\org\apache\hadoop\yarn\server\resourcemanager\scheduler\fair\FSStarvedApps.java,0,6,0,1,0,7
hadoop-trunk\hadoop-trunk\hadoop-yarn-project\hadoop-yarn\hadoop-yarn-server\hadoop-yarn-server-resourcemanager\src\test\java\org\apache\hadoop\yarn\server\resourcemanager\scheduler\fair\converter\TestFSConfigToCSConfigConverter.java,660,75,3,25,0,103
hadoop-trunk\hadoop-trunk\hadoop-hdfs-project\hadoop-hdfs\src\main\java\org\apache\hadoop\hdfs\server\namenode\InotifyFSEditLogOpTranslator.java,158,15,1,1,0,17
hadoop-trunk\hadoop-trunk\hadoop-common-project\hadoop-common\src\test\java\org\apache\hadoop\util\TestCrcUtil.java,201,82,1,1,0,84
hadoop-trunk\hadoop-trunk\hadoop-tools\hadoop-aws\src\main\java\org\apache\hadoop\fs\s3a\audit\AuditSpanS3A.java,3,0,0,1,0,1
hadoop-trunk\hadoop-trunk\hadoop-hdfs-project\hadoop-hdfs\src\main\java\org\apache\hadoop\hdfs\server\datanode\BlockSender.java,0,200,25,11,0,236
hadoop-trunk\hadoop-trunk\hadoop-common-project\hadoop-common\src\main\java\org\apache\hadoop\io\retry\RetryPolicies.java,721,330,9,25,0,364
hadoop-trunk\hadoop-trunk\hadoop-tools\hadoop-federation-balance\src\main\java\org\apache\hadoop\tools\fedbalance\procedure\BalanceJournalInfoHDFS.java,157,20,11,2,0,33
hadoop-trunk\hadoop-trunk\hadoop-yarn-project\hadoop-yarn\hadoop-yarn-applications\hadoop-yarn-services\hadoop-yarn-services-core\src\main\java\org\apache\hadoop\yarn\service\client\ServiceClient.java,1673,245,112,13,0,370
hadoop-trunk\hadoop-trunk\hadoop-tools\hadoop-aws\src\main\java\org\apache\hadoop\fs\s3a\AWSCredentialProviderList.java,273,20,6,1,0,27
hadoop-trunk\hadoop-trunk\hadoop-hdfs-project\hadoop-hdfs-rbf\src\main\java\org\apache\hadoop\hdfs\server\federation\router\FederationUtil.java,0,21,8,5,0,34
hadoop-trunk\hadoop-trunk\hadoop-mapreduce-project\hadoop-mapreduce-client\hadoop-mapreduce-client-core\src\main\java\org\apache\hadoop\mapred\JvmTask.java,39,22,1,1,0,24
hadoop-trunk\hadoop-trunk\hadoop-tools\hadoop-aws\src\main\java\org\apache\hadoop\fs\s3a\SharedInstanceCredentialProvider.java,3,1,0,1,0,2
hadoop-trunk\hadoop-trunk\hadoop-yarn-project\hadoop-yarn\hadoop-yarn-common\src\main\java\org\apache\hadoop\yarn\webapp\ResponseInfo.java,0,57,5,1,0,63
hadoop-trunk\hadoop-trunk\hadoop-yarn-project\hadoop-yarn\hadoop-yarn-server\hadoop-yarn-server-nodemanager\src\main\java\org\apache\hadoop\yarn\server\nodemanager\webapp\dao\AppInfo.java,41,20,5,3,0,28
hadoop-trunk\hadoop-trunk\hadoop-tools\hadoop-openstack\src\test\java\org\apache\hadoop\fs\swift\TestSwiftFileSystemDelete.java,63,9,0,2,0,11
hadoop-trunk\hadoop-trunk\hadoop-yarn-project\hadoop-yarn\hadoop-yarn-common\src\main\java\org\apache\hadoop\yarn\server\api\protocolrecords\impl\pb\ReplaceLabelsOnNodeResponsePBImpl.java,44,17,18,3,0,38
hadoop-trunk\hadoop-trunk\hadoop-common-project\hadoop-common\src\main\java\org\apache\hadoop\crypto\key\kms\ValueQueue.java,0,68,11,2,0,81
hadoop-trunk\hadoop-trunk\hadoop-hdfs-project\hadoop-hdfs-client\src\main\java\org\apache\hadoop\hdfs\server\namenode\ha\ConfiguredFailoverProxyProvider.java,61,19,0,2,0,21
hadoop-trunk\hadoop-trunk\hadoop-yarn-project\hadoop-yarn\hadoop-yarn-common\src\main\java\org\apache\hadoop\yarn\util\AdHocLogDumper.java,96,20,6,1,0,27
hadoop-trunk\hadoop-trunk\hadoop-common-project\hadoop-common\src\main\java\org\apache\hadoop\crypto\CryptoStreamUtils.java,53,26,1,3,0,30
hadoop-trunk\hadoop-trunk\hadoop-mapreduce-project\hadoop-mapreduce-client\hadoop-mapreduce-client-core\src\main\java\org\apache\hadoop\mapreduce\lib\output\committer\manifest\stages\RenameFilesStage.java,120,6,2,9,0,17
hadoop-trunk\hadoop-trunk\hadoop-hdfs-project\hadoop-hdfs\src\main\java\org\apache\hadoop\hdfs\server\namenode\visitor\INodeCountVisitor.java,79,22,0,1,0,23
hadoop-trunk\hadoop-trunk\hadoop-hdfs-project\hadoop-hdfs\src\test\java\org\apache\hadoop\hdfs\server\namenode\TestFsImageValidation.java,66,21,0,1,0,22
hadoop-trunk\hadoop-trunk\hadoop-hdfs-project\hadoop-hdfs-client\src\test\java\org\apache\hadoop\fs\TestUrlStreamHandlerFactory.java,64,10,2,1,0,13
hadoop-trunk\hadoop-trunk\hadoop-common-project\hadoop-common\src\main\java\org\apache\hadoop\metrics2\filter\package-info.java,0,2,0,1,0,3
hadoop-trunk\hadoop-trunk\hadoop-yarn-project\hadoop-yarn\hadoop-yarn-server\hadoop-yarn-server-resourcemanager\src\main\java\org\apache\hadoop\yarn\server\resourcemanager\webapp\dao\NewReservation.java,19,10,0,1,0,11
hadoop-trunk\hadoop-trunk\hadoop-hdfs-project\hadoop-hdfs-httpfs\src\test\java\org\apache\hadoop\test\TestHdfsHelper.java,186,47,1,13,0,61
hadoop-trunk\hadoop-trunk\hadoop-yarn-project\hadoop-yarn\hadoop-yarn-server\hadoop-yarn-server-nodemanager\src\main\java\org\apache\hadoop\yarn\server\nodemanager\containermanager\linux\runtime\docker\DockerExecCommand.java,35,13,4,2,0,19
hadoop-trunk\hadoop-trunk\hadoop-common-project\hadoop-common\src\main\java\org\apache\hadoop\ha\HealthMonitor.java,271,65,14,2,0,81
hadoop-trunk\hadoop-trunk\hadoop-tools\hadoop-aws\src\main\java\org\apache\hadoop\fs\s3a\impl\DirMarkerTracker.java,300,34,3,1,0,38
hadoop-trunk\hadoop-trunk\hadoop-yarn-project\hadoop-yarn\hadoop-yarn-server\hadoop-yarn-server-nodemanager\src\test\java\org\apache\hadoop\yarn\server\nodemanager\amrmproxy\TestAMRMProxyTokenSecretManager.java,103,7,2,2,0,11
hadoop-trunk\hadoop-trunk\hadoop-tools\hadoop-streaming\src\test\java\org\apache\hadoop\streaming\TestRawBytesStreaming.java,66,28,3,6,0,37
hadoop-trunk\hadoop-trunk\hadoop-common-project\hadoop-common\src\main\java\org\apache\hadoop\fs\PathExistsException.java,12,6,0,1,0,7
hadoop-trunk\hadoop-trunk\hadoop-mapreduce-project\hadoop-mapreduce-client\hadoop-mapreduce-client-jobclient\src\test\java\org\apache\hadoop\hdfs\NNBench.java,924,328,56,1,0,385
hadoop-trunk\hadoop-trunk\hadoop-tools\hadoop-streaming\src\test\java\org\apache\hadoop\streaming\TypedBytesMapApp.java,33,14,0,3,0,17
hadoop-trunk\hadoop-trunk\hadoop-common-project\hadoop-common\src\main\java\org\apache\hadoop\fs\store\LogExactlyOnce.java,26,19,0,1,0,20
hadoop-trunk\hadoop-trunk\hadoop-yarn-project\hadoop-yarn\hadoop-yarn-server\hadoop-yarn-server-nodemanager\src\test\java\org\apache\hadoop\yarn\server\nodemanager\amrmproxy\PassThroughRequestInterceptor.java,23,7,0,5,0,12
hadoop-trunk\hadoop-trunk\hadoop-mapreduce-project\hadoop-mapreduce-client\hadoop-mapreduce-client-hs\src\main\java\org\apache\hadoop\mapreduce\v2\hs\webapp\dao\JobsInfo.java,17,8,4,1,0,13
hadoop-trunk\hadoop-trunk\hadoop-common-project\hadoop-registry\src\main\java\org\apache\hadoop\registry\client\binding\RegistryPathUtils.java,198,23,3,1,0,27
hadoop-trunk\hadoop-trunk\hadoop-hdfs-project\hadoop-hdfs\src\test\java\org\apache\hadoop\hdfs\server\namenode\snapshot\TestSnapshottableDirListing.java,199,55,4,3,0,62
hadoop-trunk\hadoop-trunk\hadoop-yarn-project\hadoop-yarn\hadoop-yarn-server\hadoop-yarn-server-resourcemanager\src\main\java\org\apache\hadoop\yarn\server\resourcemanager\webapp\NodeIDsInfo.java,32,15,3,1,0,19
hadoop-trunk\hadoop-trunk\hadoop-common-project\hadoop-common\src\test\java\org\apache\hadoop\metrics2\lib\TestUniqNames.java,20,3,1,1,0,5
hadoop-trunk\hadoop-trunk\hadoop-tools\hadoop-aliyun\src\test\java\org\apache\hadoop\fs\aliyun\oss\contract\TestAliyunOSSContractDistCp.java,17,5,1,1,0,7
hadoop-trunk\hadoop-trunk\hadoop-hdfs-project\hadoop-hdfs\src\main\java\org\apache\hadoop\hdfs\server\blockmanagement\ErasureCodingWork.java,0,31,2,1,0,34
hadoop-trunk\hadoop-trunk\hadoop-yarn-project\hadoop-yarn\hadoop-yarn-server\hadoop-yarn-server-resourcemanager\src\main\java\org\apache\hadoop\yarn\server\resourcemanager\scheduler\capacity\AbstractCSQueue.java,1351,339,17,82,0,438
hadoop-trunk\hadoop-trunk\hadoop-mapreduce-project\hadoop-mapreduce-client\hadoop-mapreduce-client-core\src\main\java\org\apache\hadoop\mapreduce\security\SecureShuffleUtils.java,112,66,8,3,0,77
hadoop-trunk\hadoop-trunk\hadoop-mapreduce-project\hadoop-mapreduce-client\hadoop-mapreduce-client-common\src\main\java\org\apache\hadoop\mapreduce\v2\api\records\impl\pb\TaskAttemptIdPBImpl.java,89,36,40,3,0,79
hadoop-trunk\hadoop-trunk\hadoop-yarn-project\hadoop-yarn\hadoop-yarn-server\hadoop-yarn-server-nodemanager\src\test\java\org\apache\hadoop\yarn\server\nodemanager\containermanager\linux\runtime\docker\TestDockerImagesCommand.java,35,6,0,2,0,8
hadoop-trunk\hadoop-trunk\hadoop-common-project\hadoop-common\src\main\java\org\apache\hadoop\fs\PathOperationException.java,8,3,0,1,0,4
hadoop-trunk\hadoop-trunk\hadoop-hdfs-project\hadoop-hdfs\src\main\java\org\apache\hadoop\hdfs\protocolPB\NamenodeProtocolTranslatorPB.java,0,50,62,22,0,134
hadoop-trunk\hadoop-trunk\hadoop-yarn-project\hadoop-yarn\hadoop-yarn-server\hadoop-yarn-server-common\src\test\java\org\apache\hadoop\yarn\server\federation\policies\router\TestWeightedRandomRouterPolicy.java,102,15,2,2,0,19
hadoop-trunk\hadoop-trunk\hadoop-common-project\hadoop-auth\src\main\java\org\apache\hadoop\security\authentication\client\Authenticator.java,0,4,2,3,0,9
hadoop-trunk\hadoop-trunk\hadoop-mapreduce-project\hadoop-mapreduce-client\hadoop-mapreduce-client-app\src\test\java\org\apache\hadoop\mapreduce\v2\app\TestMRAppComponentDependencies.java,83,24,0,1,0,25
hadoop-trunk\hadoop-trunk\hadoop-common-project\hadoop-common\src\test\java\org\apache\hadoop\security\ssl\TestReloadingX509TrustManager.java,186,52,10,12,0,74
hadoop-trunk\hadoop-trunk\hadoop-mapreduce-project\hadoop-mapreduce-client\hadoop-mapreduce-client-nativetask\src\test\java\org\apache\hadoop\mapred\nativetask\kvtest\HashSumReducer.java,0,10,2,2,0,14
hadoop-trunk\hadoop-trunk\hadoop-tools\hadoop-azure\src\main\java\org\apache\hadoop\fs\azurebfs\contracts\package-info.java,0,2,0,1,0,3
hadoop-trunk\hadoop-trunk\hadoop-common-project\hadoop-minikdc\src\main\java\org\apache\hadoop\minikdc\KerberosSecurityTestcase.java,50,13,0,1,0,14
hadoop-trunk\hadoop-trunk\hadoop-hdfs-project\hadoop-hdfs\src\test\java\org\apache\hadoop\hdfs\server\namenode\ha\TestHAAppend.java,102,24,0,1,0,25
hadoop-trunk\hadoop-trunk\hadoop-hdfs-project\hadoop-hdfs-rbf\src\main\java\org\apache\hadoop\hdfs\server\federation\store\protocol\RemoveMountTableEntryRequest.java,22,6,0,2,0,8
hadoop-trunk\hadoop-trunk\hadoop-yarn-project\hadoop-yarn\hadoop-yarn-server\hadoop-yarn-server-nodemanager\src\test\java\org\apache\hadoop\yarn\server\nodemanager\TestNodeManager.java,165,28,9,6,0,43
hadoop-trunk\hadoop-trunk\hadoop-yarn-project\hadoop-yarn\hadoop-yarn-server\hadoop-yarn-server-resourcemanager\src\main\java\org\apache\hadoop\yarn\server\resourcemanager\scheduler\SchedulerAppUtils.java,22,5,3,1,0,9
hadoop-trunk\hadoop-trunk\hadoop-common-project\hadoop-common\src\main\java\org\apache\hadoop\util\ReflectionUtils.java,349,105,10,3,0,118
hadoop-trunk\hadoop-trunk\hadoop-hdfs-project\hadoop-hdfs-client\src\main\java\org\apache\hadoop\hdfs\protocol\Block.java,0,83,1,1,0,85
hadoop-trunk\hadoop-trunk\hadoop-common-project\hadoop-registry\src\main\java\org\apache\hadoop\registry\server\services\DeleteCompletionCallback.java,25,6,0,1,0,7
hadoop-trunk\hadoop-trunk\hadoop-hdfs-project\hadoop-hdfs\src\test\java\org\apache\hadoop\hdfs\server\datanode\fsdataset\impl\TestScrLazyPersistFiles.java,212,21,10,2,0,33
hadoop-trunk\hadoop-trunk\hadoop-hdfs-project\hadoop-hdfs\src\test\java\org\apache\hadoop\hdfs\server\blockmanagement\TestBlockPlacementStatusWithUpgradeDomain.java,105,25,0,1,0,26
hadoop-trunk\hadoop-trunk\hadoop-tools\hadoop-azure\src\test\java\org\apache\hadoop\fs\azurebfs\ITestAbfsClient.java,0,23,3,12,0,38
hadoop-trunk\hadoop-trunk\hadoop-yarn-project\hadoop-yarn\hadoop-yarn-server\hadoop-yarn-server-resourcemanager\src\main\java\org\apache\hadoop\yarn\server\resourcemanager\rmnode\RMNodeImpl.java,0,314,38,12,0,364
hadoop-trunk\hadoop-trunk\hadoop-cloud-storage-project\hadoop-cos\src\test\java\org\apache\hadoop\fs\cosn\contract\package-info.java,0,1,0,1,0,2
hadoop-trunk\hadoop-trunk\hadoop-tools\hadoop-aws\src\main\java\org\apache\hadoop\fs\s3a\S3ClientFactory.java,0,9,0,1,0,10
hadoop-trunk\hadoop-trunk\hadoop-hdfs-project\hadoop-hdfs\src\test\java\org\apache\hadoop\hdfs\server\mover\TestMover.java,0,201,39,12,0,252
hadoop-trunk\hadoop-trunk\hadoop-hdfs-project\hadoop-hdfs\src\main\java\org\apache\hadoop\hdfs\server\datanode\checker\AsyncChecker.java,0,5,0,2,0,7
hadoop-trunk\hadoop-trunk\hadoop-yarn-project\hadoop-yarn\hadoop-yarn-server\hadoop-yarn-server-resourcemanager\src\test\java\org\apache\hadoop\yarn\server\resourcemanager\monitor\capacity\TestProportionalCapacityPreemptionPolicyMockFramework.java,0,107,0,25,0,132
hadoop-trunk\hadoop-trunk\hadoop-hdfs-project\hadoop-hdfs-client\src\main\java\org\apache\hadoop\hdfs\client\impl\metrics\package-info.java,0,2,0,1,0,3
hadoop-trunk\hadoop-trunk\hadoop-common-project\hadoop-common\src\test\java\org\apache\hadoop\io\AvroTestUtil.java,26,9,1,1,0,11
hadoop-trunk\hadoop-trunk\hadoop-hdfs-project\hadoop-hdfs\src\main\java\org\apache\hadoop\hdfs\server\datanode\web\SimpleHttpProxyHandler.java,0,25,13,2,0,40
hadoop-trunk\hadoop-trunk\hadoop-yarn-project\hadoop-yarn\hadoop-yarn-server\hadoop-yarn-server-nodemanager\src\test\java\org\apache\hadoop\yarn\server\nodemanager\containermanager\linux\resources\TestCGroupsHandlerImpl.java,581,23,21,5,0,49
hadoop-trunk\hadoop-trunk\hadoop-common-project\hadoop-common\src\test\java\org\apache\hadoop\fs\contract\AbstractContractOpenTest.java,0,34,0,1,0,35
hadoop-trunk\hadoop-trunk\hadoop-common-project\hadoop-nfs\src\test\java\org\apache\hadoop\oncrpc\TestFrameDecoder.java,241,87,6,8,0,101
hadoop-trunk\hadoop-trunk\hadoop-yarn-project\hadoop-yarn\hadoop-yarn-server\hadoop-yarn-server-resourcemanager\src\test\java\org\apache\hadoop\yarn\server\resourcemanager\ApplicationMasterServiceTestBase.java,0,119,19,14,0,152
hadoop-trunk\hadoop-trunk\hadoop-yarn-project\hadoop-yarn\hadoop-yarn-applications\hadoop-yarn-services\hadoop-yarn-services-core\src\main\java\org\apache\hadoop\yarn\service\api\records\ServiceState.java,0,13,0,1,0,14
hadoop-trunk\hadoop-trunk\hadoop-common-project\hadoop-common\src\main\java\org\apache\hadoop\io\erasurecode\rawcoder\RSLegacyRawEncoder.java,98,11,1,1,0,13
hadoop-trunk\hadoop-trunk\hadoop-common-project\hadoop-common\src\test\java\org\apache\hadoop\fs\shell\find\TestFind.java,890,72,38,1,0,111
hadoop-trunk\hadoop-trunk\hadoop-yarn-project\hadoop-yarn\hadoop-yarn-api\src\main\java\org\apache\hadoop\yarn\api\ApplicationBaseProtocol.java,0,16,9,4,0,29
hadoop-trunk\hadoop-trunk\hadoop-mapreduce-project\hadoop-mapreduce-client\hadoop-mapreduce-client-app\src\main\java\org\apache\hadoop\mapreduce\v2\app\speculate\LegacyTaskRuntimeEstimator.java,115,19,0,6,0,25
hadoop-trunk\hadoop-trunk\hadoop-tools\hadoop-streaming\src\main\java\org\apache\hadoop\streaming\StreamUtil.java,167,40,8,5,0,53
hadoop-trunk\hadoop-trunk\hadoop-hdfs-project\hadoop-hdfs\src\test\java\org\apache\hadoop\hdfs\util\TestXMLUtils.java,66,14,2,1,0,17
hadoop-trunk\hadoop-trunk\hadoop-tools\hadoop-azure\src\test\java\org\apache\hadoop\fs\azurebfs\utils\SASGenerator.java,68,16,1,2,0,19
hadoop-trunk\hadoop-trunk\hadoop-hdfs-project\hadoop-hdfs\src\test\java\org\apache\hadoop\hdfs\TestDFSInputStream.java,239,59,7,2,0,68
hadoop-trunk\hadoop-trunk\hadoop-common-project\hadoop-common\src\main\java\org\apache\hadoop\ha\FailoverFailedException.java,12,4,0,1,0,5
hadoop-trunk\hadoop-trunk\hadoop-hdfs-project\hadoop-hdfs\src\main\java\org\apache\hadoop\hdfs\server\datanode\metrics\DataNodeDiskMetrics.java,250,60,6,8,0,74
hadoop-trunk\hadoop-trunk\hadoop-yarn-project\hadoop-yarn\hadoop-yarn-server\hadoop-yarn-server-common\src\main\java\org\apache\hadoop\yarn\server\federation\store\utils\FederationMembershipStateStoreInputValidator.java,0,11,5,6,0,22
hadoop-trunk\hadoop-trunk\hadoop-common-project\hadoop-common\src\test\java\org\apache\hadoop\fs\TestLocalFSFileContextMainOperations.java,39,13,3,3,0,19
hadoop-trunk\hadoop-trunk\hadoop-hdfs-project\hadoop-hdfs-client\src\main\java\org\apache\hadoop\hdfs\protocol\DatanodeInfo.java,820,337,5,3,0,345
hadoop-trunk\hadoop-trunk\hadoop-yarn-project\hadoop-yarn\hadoop-yarn-server\hadoop-yarn-server-resourcemanager\src\main\java\org\apache\hadoop\yarn\server\resourcemanager\placement\csmappingrule\MappingRuleValidationContext.java,0,1,0,1,0,2
hadoop-trunk\hadoop-trunk\hadoop-common-project\hadoop-common\src\test\java\org\apache\hadoop\metrics2\impl\TestStatsDMetrics.java,81,21,11,1,0,33
hadoop-trunk\hadoop-trunk\hadoop-yarn-project\hadoop-yarn\hadoop-yarn-common\src\main\java\org\apache\hadoop\yarn\api\protocolrecords\impl\pb\StopContainersRequestPBImpl.java,112,28,43,3,0,74
hadoop-trunk\hadoop-trunk\hadoop-common-project\hadoop-nfs\src\test\java\org\apache\hadoop\nfs\nfs3\TestFileHandle.java,16,6,0,1,0,7
hadoop-trunk\hadoop-trunk\hadoop-yarn-project\hadoop-yarn\hadoop-yarn-common\src\main\java\org\apache\hadoop\yarn\webapp\Controller.java,217,117,2,1,0,120
hadoop-trunk\hadoop-trunk\hadoop-tools\hadoop-aws\src\main\java\org\apache\hadoop\fs\s3a\AWSBadRequestException.java,17,2,0,1,0,3
hadoop-trunk\hadoop-trunk\hadoop-yarn-project\hadoop-yarn\hadoop-yarn-server\hadoop-yarn-server-router\src\test\java\org\apache\hadoop\yarn\server\router\clientrm\TestFederationClientInterceptorRetry.java,0,14,2,6,0,22
hadoop-trunk\hadoop-trunk\hadoop-tools\hadoop-aws\src\main\java\org\apache\hadoop\fs\s3a\Listing.java,751,82,6,10,0,98
hadoop-trunk\hadoop-trunk\hadoop-yarn-project\hadoop-yarn\hadoop-yarn-server\hadoop-yarn-server-resourcemanager\src\test\java\org\apache\hadoop\yarn\server\resourcemanager\webapp\fairscheduler\TestRMWebServicesFairSchedulerCustomResourceTypes.java,0,26,2,5,0,33
hadoop-trunk\hadoop-trunk\hadoop-yarn-project\hadoop-yarn\hadoop-yarn-server\hadoop-yarn-server-resourcemanager\src\main\java\org\apache\hadoop\yarn\server\resourcemanager\rmcontainer\RMContainer.java,83,40,2,2,0,44
hadoop-trunk\hadoop-trunk\hadoop-tools\hadoop-azure\src\main\java\org\apache\hadoop\fs\azure\security\TokenUtils.java,0,6,1,2,0,9
hadoop-trunk\hadoop-trunk\hadoop-yarn-project\hadoop-yarn\hadoop-yarn-server\hadoop-yarn-server-resourcemanager\src\main\java\org\apache\hadoop\yarn\server\resourcemanager\webapp\dao\AllocationTagsInfo.java,27,6,1,1,0,8
hadoop-trunk\hadoop-trunk\hadoop-hdfs-project\hadoop-hdfs\src\main\java\org\apache\hadoop\hdfs\server\blockmanagement\UnresolvedTopologyException.java,9,6,0,1,0,7
hadoop-trunk\hadoop-trunk\hadoop-tools\hadoop-aws\src\main\java\org\apache\hadoop\fs\s3a\S3AUtils.java,0,234,16,13,0,263
hadoop-trunk\hadoop-trunk\hadoop-common-project\hadoop-kms\src\test\java\org\apache\hadoop\crypto\key\kms\server\TestKMSAuthenticationFilter.java,0,1,0,1,0,2
hadoop-trunk\hadoop-trunk\hadoop-mapreduce-project\hadoop-mapreduce-client\hadoop-mapreduce-client-core\src\main\java\org\apache\hadoop\mapreduce\util\CountersStrings.java,236,34,5,6,0,45
hadoop-trunk\hadoop-trunk\hadoop-common-project\hadoop-common\src\main\java\org\apache\hadoop\fs\UploadHandle.java,0,1,0,1,0,2
hadoop-trunk\hadoop-trunk\hadoop-common-project\hadoop-common\src\main\java\org\apache\hadoop\util\functional\TaskPool.java,0,40,3,8,0,51
hadoop-trunk\hadoop-trunk\hadoop-tools\hadoop-aws\src\main\java\org\apache\hadoop\fs\s3a\commit\package-info.java,0,0,0,1,0,1
hadoop-trunk\hadoop-trunk\hadoop-tools\hadoop-rumen\src\main\java\org\apache\hadoop\tools\rumen\JobStoryProducer.java,0,1,0,1,0,2
hadoop-trunk\hadoop-trunk\hadoop-hdfs-project\hadoop-hdfs\src\main\java\org\apache\hadoop\hdfs\server\datanode\checker\AbstractFuture.java,0,186,54,6,0,246
hadoop-trunk\hadoop-trunk\hadoop-mapreduce-project\hadoop-mapreduce-client\hadoop-mapreduce-client-jobclient\src\test\java\org\apache\hadoop\mapreduce\SleepJob.java,261,148,16,2,0,166
hadoop-trunk\hadoop-trunk\hadoop-yarn-project\hadoop-yarn\hadoop-yarn-server\hadoop-yarn-server-common\src\test\java\org\apache\hadoop\yarn\server\metrics\TestAMRMClientRelayerMetrics.java,451,78,10,7,0,95
hadoop-trunk\hadoop-trunk\hadoop-common-project\hadoop-common\src\main\java\org\apache\hadoop\ipc\AsyncCallLimitExceededException.java,8,2,0,1,0,3
hadoop-trunk\hadoop-trunk\hadoop-common-project\hadoop-common\src\main\java\org\apache\hadoop\util\DirectBufferPool.java,65,16,0,2,0,18
hadoop-trunk\hadoop-trunk\hadoop-common-project\hadoop-common\src\main\java\org\apache\hadoop\jmx\package-info.java,0,3,0,1,0,4
hadoop-trunk\hadoop-trunk\hadoop-hdfs-project\hadoop-hdfs-rbf\src\main\java\org\apache\hadoop\hdfs\server\federation\fairness\RouterRpcFairnessPolicyController.java,0,1,0,1,0,2
hadoop-trunk\hadoop-trunk\hadoop-tools\hadoop-azure-datalake\src\test\java\org\apache\hadoop\fs\adl\live\TestAdlContractDeleteLive.java,8,2,0,1,0,3
hadoop-trunk\hadoop-trunk\hadoop-hdfs-project\hadoop-hdfs-rbf\src\main\java\org\apache\hadoop\hdfs\server\federation\store\protocol\impl\pb\GetMountTableEntriesRequestPBImpl.java,0,13,31,4,0,48
hadoop-trunk\hadoop-trunk\hadoop-mapreduce-project\hadoop-mapreduce-client\hadoop-mapreduce-client-core\src\main\java\org\apache\hadoop\mapreduce\protocol\ClientProtocolProvider.java,11,5,0,1,0,6
hadoop-trunk\hadoop-trunk\hadoop-yarn-project\hadoop-yarn\hadoop-yarn-server\hadoop-yarn-server-common\src\main\java\org\apache\hadoop\yarn\server\federation\policies\manager\HomePolicyManager.java,28,2,0,5,0,7
hadoop-trunk\hadoop-trunk\hadoop-mapreduce-project\hadoop-mapreduce-client\hadoop-mapreduce-client-common\src\main\java\org\apache\hadoop\mapreduce\v2\api\protocolrecords\GetTaskAttemptReportRequest.java,0,7,2,1,0,10
hadoop-trunk\hadoop-trunk\hadoop-yarn-project\hadoop-yarn\hadoop-yarn-server\hadoop-yarn-server-resourcemanager\src\main\java\org\apache\hadoop\yarn\server\resourcemanager\scheduler\fair\converter\QueuePlacementConverter.java,0,30,0,13,0,43
hadoop-trunk\hadoop-trunk\hadoop-yarn-project\hadoop-yarn\hadoop-yarn-server\hadoop-yarn-server-nodemanager\src\main\java\org\apache\hadoop\yarn\server\nodemanager\webapp\dao\gpu\NMGpuResourceInfo.java,41,32,0,4,0,36
hadoop-trunk\hadoop-trunk\hadoop-yarn-project\hadoop-yarn\hadoop-yarn-server\hadoop-yarn-server-resourcemanager\src\test\java\org\apache\hadoop\yarn\server\resourcemanager\security\TestAMRMTokens.java,366,48,3,13,0,64
hadoop-trunk\hadoop-trunk\hadoop-common-project\hadoop-common\src\test\java\org\apache\hadoop\ipc\TestMiniRPCBenchmark.java,10,3,0,1,0,4
hadoop-trunk\hadoop-trunk\hadoop-hdfs-project\hadoop-hdfs\src\main\java\org\apache\hadoop\hdfs\server\namenode\FSImageFormatProtobuf.java,0,158,130,13,0,301
hadoop-trunk\hadoop-trunk\hadoop-yarn-project\hadoop-yarn\hadoop-yarn-server\hadoop-yarn-server-resourcemanager\src\test\java\org\apache\hadoop\yarn\server\resourcemanager\MockNM.java,350,143,1,11,0,155
hadoop-trunk\hadoop-trunk\hadoop-yarn-project\hadoop-yarn\hadoop-yarn-server\hadoop-yarn-server-nodemanager\src\main\java\org\apache\hadoop\yarn\server\nodemanager\containermanager\resourceplugin\com\nvidia\NvidiaGPUPluginForRuntimeV2.java,672,110,32,6,0,148
hadoop-trunk\hadoop-trunk\hadoop-hdfs-project\hadoop-hdfs-rbf\src\main\java\org\apache\hadoop\hdfs\server\federation\store\protocol\LeaveSafeModeRequest.java,6,2,0,2,0,4
hadoop-trunk\hadoop-trunk\hadoop-yarn-project\hadoop-yarn\hadoop-yarn-server\hadoop-yarn-server-common\src\main\java\org\apache\hadoop\yarn\server\api\protocolrecords\impl\pb\GetTimelineCollectorContextResponsePBImpl.java,134,25,43,4,0,72
hadoop-trunk\hadoop-trunk\hadoop-yarn-project\hadoop-yarn\hadoop-yarn-common\src\main\java\org\apache\hadoop\yarn\api\records\impl\pb\package-info.java,0,1,0,1,0,2
hadoop-trunk\hadoop-trunk\hadoop-common-project\hadoop-registry\src\main\java\org\apache\hadoop\registry\client\api\package-info.java,0,0,0,1,0,1
hadoop-trunk\hadoop-trunk\hadoop-hdfs-project\hadoop-hdfs-rbf\src\main\java\org\apache\hadoop\hdfs\server\federation\store\protocol\impl\pb\RouterHeartbeatResponsePBImpl.java,0,10,29,5,0,44
hadoop-trunk\hadoop-trunk\hadoop-yarn-project\hadoop-yarn\hadoop-yarn-common\src\main\java\org\apache\hadoop\yarn\webapp\view\HtmlBlock.java,69,15,1,1,0,17
hadoop-trunk\hadoop-trunk\hadoop-yarn-project\hadoop-yarn\hadoop-yarn-server\hadoop-yarn-server-resourcemanager\src\test\java\org\apache\hadoop\yarn\server\resourcemanager\preprocessor\TestContextProcessor.java,28,9,1,1,0,11
hadoop-trunk\hadoop-trunk\hadoop-mapreduce-project\hadoop-mapreduce-client\hadoop-mapreduce-client-jobclient\src\test\java\org\apache\hadoop\mapred\TestNetworkedJob.java,340,44,2,2,0,48
hadoop-trunk\hadoop-trunk\hadoop-common-project\hadoop-nfs\src\main\java\org\apache\hadoop\oncrpc\RpcUtil.java,0,34,4,6,0,44
hadoop-trunk\hadoop-trunk\hadoop-hdfs-project\hadoop-hdfs\src\main\java\org\apache\hadoop\hdfs\security\token\block\BlockPoolTokenSecretManager.java,139,96,0,3,0,99
hadoop-trunk\hadoop-trunk\hadoop-hdfs-project\hadoop-hdfs\src\main\java\org\apache\hadoop\hdfs\server\diskbalancer\command\ExecuteCommand.java,91,9,1,1,0,11
hadoop-trunk\hadoop-trunk\hadoop-hdfs-project\hadoop-hdfs\src\test\java\org\apache\hadoop\hdfs\server\namenode\TestNameNodeHttpServer.java,92,23,2,2,0,27
hadoop-trunk\hadoop-trunk\hadoop-yarn-project\hadoop-yarn\hadoop-yarn-api\src\main\java\org\apache\hadoop\yarn\api\protocolrecords\AllocateRequest.java,350,60,1,2,0,63
hadoop-trunk\hadoop-trunk\hadoop-yarn-project\hadoop-yarn\hadoop-yarn-server\hadoop-yarn-server-nodemanager\src\test\java\org\apache\hadoop\yarn\server\nodemanager\containermanager\linux\runtime\docker\TestDockerRmCommand.java,60,11,0,2,0,13
hadoop-trunk\hadoop-trunk\hadoop-common-project\hadoop-common\src\test\java\org\apache\hadoop\fs\TestFileContext.java,53,13,10,1,0,24
hadoop-trunk\hadoop-trunk\hadoop-mapreduce-project\hadoop-mapreduce-client\hadoop-mapreduce-client-jobclient\src\test\java\org\apache\hadoop\mapreduce\TestMRJobClient.java,0,147,29,5,0,181
hadoop-trunk\hadoop-trunk\hadoop-yarn-project\hadoop-yarn\hadoop-yarn-server\hadoop-yarn-server-common\src\test\java\org\apache\hadoop\yarn\server\federation\resolver\TestDefaultSubClusterResolver.java,155,9,0,1,0,10
hadoop-trunk\hadoop-trunk\hadoop-yarn-project\hadoop-yarn\hadoop-yarn-api\src\main\java\org\apache\hadoop\yarn\api\protocolrecords\ReleaseSharedCacheResourceRequest.java,39,0,0,1,0,1
hadoop-trunk\hadoop-trunk\hadoop-mapreduce-project\hadoop-mapreduce-client\hadoop-mapreduce-client-core\src\main\java\org\apache\hadoop\mapreduce\jobhistory\JobStatusChangedEvent.java,44,24,14,1,0,39
hadoop-trunk\hadoop-trunk\hadoop-tools\hadoop-streaming\src\main\java\org\apache\hadoop\record\Index.java,0,3,0,1,0,4
hadoop-trunk\hadoop-trunk\hadoop-mapreduce-project\hadoop-mapreduce-client\hadoop-mapreduce-client-app\src\main\java\org\apache\hadoop\mapreduce\v2\app\webapp\SingleCounterPage.java,0,13,1,2,0,16
hadoop-trunk\hadoop-trunk\hadoop-yarn-project\hadoop-yarn\hadoop-yarn-common\src\main\java\org\apache\hadoop\yarn\api\protocolrecords\impl\pb\GetDelegationTokenResponsePBImpl.java,99,34,37,4,0,75
hadoop-trunk\hadoop-trunk\hadoop-yarn-project\hadoop-yarn\hadoop-yarn-common\src\main\java\org\apache\hadoop\yarn\api\protocolrecords\impl\pb\GetDelegationTokenRequestPBImpl.java,86,38,32,3,0,73
hadoop-trunk\hadoop-trunk\hadoop-common-project\hadoop-common\src\main\java\org\apache\hadoop\io\erasurecode\coder\ErasureDecoder.java,0,22,2,2,0,26
hadoop-trunk\hadoop-trunk\hadoop-hdfs-project\hadoop-hdfs\src\main\java\org\apache\hadoop\hdfs\server\balancer\NameNodeConnector.java,404,129,13,3,0,145
hadoop-trunk\hadoop-trunk\hadoop-tools\hadoop-extras\src\test\java\org\apache\hadoop\mapred\tools\TestGetGroups.java,22,10,8,1,0,19
hadoop-trunk\hadoop-trunk\hadoop-yarn-project\hadoop-yarn\hadoop-yarn-server\hadoop-yarn-server-resourcemanager\src\main\java\org\apache\hadoop\yarn\server\resourcemanager\placement\csmappingrule\MappingRuleActions.java,0,31,1,1,0,33
hadoop-trunk\hadoop-trunk\hadoop-common-project\hadoop-common\src\test\java\org\apache\hadoop\ipc\RPCCallBenchmark.java,361,77,11,7,0,95
hadoop-trunk\hadoop-trunk\hadoop-yarn-project\hadoop-yarn\hadoop-yarn-csi\src\main\java\org\apache\hadoop\yarn\csi\client\CsiClientImpl.java,48,11,19,1,0,31
hadoop-trunk\hadoop-trunk\hadoop-mapreduce-project\hadoop-mapreduce-client\hadoop-mapreduce-client-nativetask\src\test\java\org\apache\hadoop\mapred\nativetask\serde\TestNativeSerialization.java,86,30,4,6,0,40
hadoop-trunk\hadoop-trunk\hadoop-tools\hadoop-aws\src\test\java\org\apache\hadoop\fs\s3a\scale\ITestS3AHugeFilesSSECDiskBlocks.java,0,4,2,6,0,12
hadoop-trunk\hadoop-trunk\hadoop-yarn-project\hadoop-yarn\hadoop-yarn-server\hadoop-yarn-server-applicationhistoryservice\src\main\java\org\apache\hadoop\yarn\server\applicationhistoryservice\MemoryApplicationHistoryStore.java,222,42,0,18,0,60
hadoop-trunk\hadoop-trunk\hadoop-common-project\hadoop-common\src\main\java\org\apache\hadoop\io\Stringifier.java,0,13,3,1,0,17
hadoop-trunk\hadoop-trunk\hadoop-hdfs-project\hadoop-hdfs-rbf\src\test\java\org\apache\hadoop\hdfs\server\federation\router\TestRouterAdmin.java,440,29,2,18,0,49
hadoop-trunk\hadoop-trunk\hadoop-yarn-project\hadoop-yarn\hadoop-yarn-server\hadoop-yarn-server-common\src\main\java\org\apache\hadoop\yarn\server\security\http\RMAuthenticationFilterInitializer.java,36,8,0,2,0,10
hadoop-trunk\hadoop-trunk\hadoop-yarn-project\hadoop-yarn\hadoop-yarn-server\hadoop-yarn-server-resourcemanager\src\test\java\org\apache\hadoop\yarn\server\resourcemanager\TestRMStoreCommands.java,108,15,0,2,0,17
hadoop-trunk\hadoop-trunk\hadoop-mapreduce-project\hadoop-mapreduce-examples\src\main\java\org\apache\hadoop\examples\pi\math\LongLong.java,0,48,4,4,0,56
hadoop-trunk\hadoop-trunk\hadoop-hdfs-project\hadoop-hdfs-rbf\src\test\java\org\apache\hadoop\hdfs\server\federation\router\TestRouterQuotaManager.java,93,6,0,1,0,7
hadoop-trunk\hadoop-trunk\hadoop-yarn-project\hadoop-yarn\hadoop-yarn-api\src\main\java\org\apache\hadoop\yarn\api\records\LocalizationStatus.java,61,7,0,1,0,8
hadoop-trunk\hadoop-trunk\hadoop-mapreduce-project\hadoop-mapreduce-client\hadoop-mapreduce-client-jobclient\src\test\java\org\apache\hadoop\mapreduce\lib\join\TestJoinProperties.java,359,154,32,1,0,187
hadoop-trunk\hadoop-trunk\hadoop-common-project\hadoop-kms\src\test\java\org\apache\hadoop\crypto\key\kms\server\TestKMSACLs.java,189,7,2,3,0,12
hadoop-trunk\hadoop-trunk\hadoop-hdfs-project\hadoop-hdfs-rbf\src\main\java\org\apache\hadoop\hdfs\server\federation\store\impl\RouterStoreImpl.java,53,8,1,7,0,16
hadoop-trunk\hadoop-trunk\hadoop-hdfs-project\hadoop-hdfs-httpfs\src\main\java\org\apache\hadoop\lib\lang\XException.java,107,17,2,4,0,23
hadoop-trunk\hadoop-trunk\hadoop-yarn-project\hadoop-yarn\hadoop-yarn-common\src\main\java\org\apache\hadoop\yarn\webapp\hamlet2\package-info.java,0,0,0,1,0,1
hadoop-trunk\hadoop-trunk\hadoop-yarn-project\hadoop-yarn\hadoop-yarn-server\hadoop-yarn-server-resourcemanager\src\test\java\org\apache\hadoop\yarn\server\resourcemanager\monitor\capacity\mockframework\MockApplications.java,0,45,4,15,0,64
hadoop-trunk\hadoop-trunk\hadoop-hdfs-project\hadoop-hdfs\src\main\java\org\apache\hadoop\hdfs\server\datanode\BlockRecoveryWorker.java,571,101,18,7,0,126
hadoop-trunk\hadoop-trunk\hadoop-tools\hadoop-rumen\src\main\java\org\apache\hadoop\tools\rumen\LogRecordType.java,0,12,1,2,0,15
hadoop-trunk\hadoop-trunk\hadoop-yarn-project\hadoop-yarn\hadoop-yarn-server\hadoop-yarn-server-resourcemanager\src\test\java\org\apache\hadoop\yarn\server\resourcemanager\security\TestProxyCAManager.java,68,2,2,1,0,5
hadoop-trunk\hadoop-trunk\hadoop-hdfs-project\hadoop-hdfs\src\test\java\org\apache\hadoop\hdfs\server\namenode\TestBlockUnderConstruction.java,182,48,14,2,0,64
hadoop-trunk\hadoop-trunk\hadoop-mapreduce-project\hadoop-mapreduce-client\hadoop-mapreduce-client-core\src\main\java\org\apache\hadoop\mapreduce\MarkableIterator.java,0,15,1,1,0,17
hadoop-trunk\hadoop-trunk\hadoop-tools\hadoop-resourceestimator\src\test\java\org\apache\hadoop\resourceestimator\translator\impl\TestNativeParser.java,69,24,0,6,0,30
hadoop-trunk\hadoop-trunk\hadoop-yarn-project\hadoop-yarn\hadoop-yarn-common\src\main\java\org\apache\hadoop\yarn\api\impl\pb\service\ContainerManagementProtocolPBServiceImpl.java,196,53,71,48,0,172
hadoop-trunk\hadoop-trunk\hadoop-common-project\hadoop-common\src\test\java\org\apache\hadoop\io\TestBytesWritable.java,130,84,17,10,0,111
hadoop-trunk\hadoop-trunk\hadoop-mapreduce-project\hadoop-mapreduce-examples\src\main\java\org\apache\hadoop\examples\terasort\TeraGen.java,245,93,5,1,0,99
hadoop-trunk\hadoop-trunk\hadoop-hdfs-project\hadoop-hdfs-rbf\src\main\java\org\apache\hadoop\hdfs\server\federation\store\protocol\impl\pb\package-info.java,0,2,0,1,0,3
hadoop-trunk\hadoop-trunk\hadoop-yarn-project\hadoop-yarn\hadoop-yarn-server\hadoop-yarn-server-nodemanager\src\main\java\org\apache\hadoop\yarn\server\nodemanager\Context.java,0,31,0,9,0,40
hadoop-trunk\hadoop-trunk\hadoop-yarn-project\hadoop-yarn\hadoop-yarn-server\hadoop-yarn-server-nodemanager\src\test\java\org\apache\hadoop\yarn\server\nodemanager\NodeManagerTestBase.java,115,57,1,11,0,69
hadoop-trunk\hadoop-trunk\hadoop-yarn-project\hadoop-yarn\hadoop-yarn-server\hadoop-yarn-server-common\src\test\java\org\apache\hadoop\yarn\server\api\protocolrecords\TestProtocolRecords.java,156,30,14,5,0,49
hadoop-trunk\hadoop-trunk\hadoop-hdfs-project\hadoop-hdfs-rbf\src\main\java\org\apache\hadoop\hdfs\server\federation\store\protocol\AddMountTableEntryResponse.java,15,4,0,2,0,6
hadoop-trunk\hadoop-trunk\hadoop-yarn-project\hadoop-yarn\hadoop-yarn-api\src\main\java\org\apache\hadoop\yarn\api\records\PreemptionContract.java,0,7,0,2,0,9
hadoop-trunk\hadoop-trunk\hadoop-mapreduce-project\hadoop-mapreduce-client\hadoop-mapreduce-client-jobclient\src\test\java\org\apache\hadoop\mapreduce\lib\partition\TestInputSampler.java,255,83,21,2,0,106
hadoop-trunk\hadoop-trunk\hadoop-yarn-project\hadoop-yarn\hadoop-yarn-api\src\main\java\org\apache\hadoop\yarn\api\protocolrecords\GetAllResourceProfilesResponse.java,29,6,0,1,0,7
hadoop-trunk\hadoop-trunk\hadoop-yarn-project\hadoop-yarn\hadoop-yarn-api\src\main\java\org\apache\hadoop\yarn\exceptions\InvalidLabelResourceRequestException.java,0,10,0,1,0,11
hadoop-trunk\hadoop-trunk\hadoop-yarn-project\hadoop-yarn\hadoop-yarn-server\hadoop-yarn-server-resourcemanager\src\main\java\org\apache\hadoop\yarn\server\resourcemanager\RMFatalEvent.java,68,14,0,1,0,15
hadoop-trunk\hadoop-trunk\hadoop-yarn-project\hadoop-yarn\hadoop-yarn-server\hadoop-yarn-server-common\src\test\java\org\apache\hadoop\yarn\server\utils\TestLeveldbIterator.java,69,19,1,1,0,21
hadoop-trunk\hadoop-trunk\hadoop-common-project\hadoop-nfs\src\main\java\org\apache\hadoop\nfs\nfs3\request\LOOKUP3Request.java,31,17,0,1,0,18
hadoop-trunk\hadoop-trunk\hadoop-common-project\hadoop-annotations\src\main\java\org\apache\hadoop\classification\tools\ExcludePrivateAnnotationsJDiffDoclet.java,28,14,1,2,0,17
hadoop-trunk\hadoop-trunk\hadoop-common-project\hadoop-common\src\main\java\org\apache\hadoop\io\compress\zlib\BuiltInZlibInflater.java,21,10,1,1,0,12
hadoop-trunk\hadoop-trunk\hadoop-common-project\hadoop-common\src\test\java\org\apache\hadoop\fs\TestFileContextDeleteOnExit.java,58,24,2,2,0,28
hadoop-trunk\hadoop-trunk\hadoop-yarn-project\hadoop-yarn\hadoop-yarn-api\src\main\java\org\apache\hadoop\yarn\api\records\ApplicationReport.java,504,180,0,7,0,187
hadoop-trunk\hadoop-trunk\hadoop-hdfs-project\hadoop-hdfs-client\src\main\java\org\apache\hadoop\hdfs\server\protocol\StorageReport.java,71,62,0,1,0,63
hadoop-trunk\hadoop-trunk\hadoop-tools\hadoop-rumen\src\main\java\org\apache\hadoop\tools\rumen\serializers\BlockingSerializer.java,8,9,0,2,0,11
hadoop-trunk\hadoop-trunk\hadoop-yarn-project\hadoop-yarn\hadoop-yarn-api\src\main\java\org\apache\hadoop\yarn\api\protocolrecords\GetResourceProfileResponse.java,39,4,0,1,0,5
hadoop-trunk\hadoop-trunk\hadoop-hdfs-project\hadoop-hdfs\src\main\java\org\apache\hadoop\hdfs\tools\offlineEditsViewer\OfflineEditsViewer.java,228,88,5,2,0,95
hadoop-trunk\hadoop-trunk\hadoop-yarn-project\hadoop-yarn\hadoop-yarn-server\hadoop-yarn-server-common\src\main\java\org\apache\hadoop\yarn\server\federation\policies\router\FederationRouterPolicy.java,0,0,0,2,0,2
hadoop-trunk\hadoop-trunk\hadoop-mapreduce-project\hadoop-mapreduce-client\hadoop-mapreduce-client-core\src\main\java\org\apache\hadoop\mapred\TaskStatus.java,0,286,17,5,0,308
hadoop-trunk\hadoop-trunk\hadoop-common-project\hadoop-common\src\main\java\org\apache\hadoop\io\InputBuffer.java,48,27,0,1,0,28
hadoop-trunk\hadoop-trunk\hadoop-yarn-project\hadoop-yarn\hadoop-yarn-server\hadoop-yarn-server-resourcemanager\src\test\java\org\apache\hadoop\yarn\server\resourcemanager\RMDelegationTokenIdentifierForTest.java,81,24,27,3,0,54
hadoop-trunk\hadoop-trunk\hadoop-common-project\hadoop-common\src\main\java\org\apache\hadoop\util\SignalLogger.java,0,21,19,1,0,41
hadoop-trunk\hadoop-trunk\hadoop-yarn-project\hadoop-yarn\hadoop-yarn-server\hadoop-yarn-server-common\src\main\java\org\apache\hadoop\yarn\server\federation\policies\manager\UniformBroadcastPolicyManager.java,11,1,0,3,0,4
hadoop-trunk\hadoop-trunk\hadoop-mapreduce-project\hadoop-mapreduce-client\hadoop-mapreduce-client-core\src\main\java\org\apache\hadoop\mapred\join\WrappedRecordReader.java,0,68,10,2,0,80
hadoop-trunk\hadoop-trunk\hadoop-tools\hadoop-azure\src\main\java\org\apache\hadoop\fs\azurebfs\services\AbfsLocatedFileStatus.java,44,9,2,2,0,13
hadoop-trunk\hadoop-trunk\hadoop-mapreduce-project\hadoop-mapreduce-client\hadoop-mapreduce-client-core\src\main\java\org\apache\hadoop\mapreduce\MRJobConfig.java,0,1632,786,115,0,2533
hadoop-trunk\hadoop-trunk\hadoop-yarn-project\hadoop-yarn\hadoop-yarn-applications\hadoop-yarn-applications-mawo\hadoop-yarn-applications-mawo-core\src\main\java\org\apache\hadoop\applications\mawo\server\common\TaskStatus.java,0,11,8,1,0,20
hadoop-trunk\hadoop-trunk\hadoop-tools\hadoop-gridmix\src\test\java\org\apache\hadoop\mapred\gridmix\DummyResourceCalculatorPlugin.java,124,13,0,1,0,14
hadoop-trunk\hadoop-trunk\hadoop-tools\hadoop-sls\src\main\java\org\apache\hadoop\yarn\sls\AMDefinitionRumen.java,137,35,0,2,0,37
hadoop-trunk\hadoop-trunk\hadoop-hdfs-project\hadoop-hdfs\src\main\java\org\apache\hadoop\hdfs\server\namenode\sps\ItemInfo.java,56,17,1,1,0,19
hadoop-trunk\hadoop-trunk\hadoop-tools\hadoop-openstack\src\test\java\org\apache\hadoop\fs\swift\contract\TestSwiftContractMkdir.java,8,3,0,1,0,4
hadoop-trunk\hadoop-trunk\hadoop-mapreduce-project\hadoop-mapreduce-client\hadoop-mapreduce-client-jobclient\src\test\java\org\apache\hadoop\mapred\TestKeyValueTextInputFormat.java,226,92,17,4,0,113
hadoop-trunk\hadoop-trunk\hadoop-yarn-project\hadoop-yarn\hadoop-yarn-server\hadoop-yarn-server-nodemanager\src\test\java\org\apache\hadoop\yarn\server\nodemanager\webapp\TestNMWebServer.java,0,29,12,7,0,48
hadoop-trunk\hadoop-trunk\hadoop-mapreduce-project\hadoop-mapreduce-client\hadoop-mapreduce-client-jobclient\src\test\java\testjar\ClassWordCount.java,19,14,22,1,0,37
hadoop-trunk\hadoop-trunk\hadoop-yarn-project\hadoop-yarn\hadoop-yarn-common\src\main\java\org\apache\hadoop\yarn\util\timeline\TimelineEntityV2Converter.java,0,16,2,1,0,19
hadoop-trunk\hadoop-trunk\hadoop-hdfs-project\hadoop-hdfs-rbf\src\main\java\org\apache\hadoop\hdfs\server\federation\store\protocol\impl\pb\GetNamenodeRegistrationsRequestPBImpl.java,0,14,35,6,0,55
hadoop-trunk\hadoop-trunk\hadoop-mapreduce-project\hadoop-mapreduce-client\hadoop-mapreduce-client-core\src\test\java\org\apache\hadoop\mapred\TestTaskLogAppender.java,39,24,0,3,0,27
hadoop-trunk\hadoop-trunk\hadoop-yarn-project\hadoop-yarn\hadoop-yarn-api\src\main\java\org\apache\hadoop\yarn\server\api\protocolrecords\RefreshNodesResponse.java,10,1,1,1,0,3
hadoop-trunk\hadoop-trunk\hadoop-yarn-project\hadoop-yarn\hadoop-yarn-common\src\main\java\org\apache\hadoop\yarn\api\protocolrecords\impl\pb\ReservationSubmissionResponsePBImpl.java,45,17,18,2,0,37
hadoop-trunk\hadoop-trunk\hadoop-common-project\hadoop-common\src\test\java\org\apache\hadoop\fs\TestBlockLocation.java,99,19,0,1,0,20
hadoop-trunk\hadoop-trunk\hadoop-cloud-storage-project\hadoop-huaweicloud\src\main\java\org\apache\hadoop\fs\obs\SseWrapper.java,0,0,1,1,0,2
hadoop-trunk\hadoop-trunk\hadoop-yarn-project\hadoop-yarn\hadoop-yarn-server\hadoop-yarn-server-resourcemanager\src\main\java\org\apache\hadoop\yarn\server\resourcemanager\scheduler\capacity\AutoCreatedQueueDeletionPolicy.java,125,27,8,4,0,39
hadoop-trunk\hadoop-trunk\hadoop-yarn-project\hadoop-yarn\hadoop-yarn-api\src\main\java\org\apache\hadoop\yarn\api\protocolrecords\ApplicationsRequestScope.java,0,4,0,1,0,5
hadoop-trunk\hadoop-trunk\hadoop-mapreduce-project\hadoop-mapreduce-client\hadoop-mapreduce-client-app\src\main\java\org\apache\hadoop\mapreduce\v2\app\webapp\AMParams.java,0,10,9,1,0,20
hadoop-trunk\hadoop-trunk\hadoop-hdfs-project\hadoop-hdfs\src\main\java\org\apache\hadoop\hdfs\server\protocol\DatanodeRegistration.java,0,38,2,1,0,41
hadoop-trunk\hadoop-trunk\hadoop-yarn-project\hadoop-yarn\hadoop-yarn-server\hadoop-yarn-server-resourcemanager\src\main\java\org\apache\hadoop\yarn\server\resourcemanager\scheduler\NodeReport.java,18,11,0,1,0,12
hadoop-trunk\hadoop-trunk\hadoop-hdfs-project\hadoop-hdfs\src\main\java\org\apache\hadoop\hdfs\util\Holder.java,13,9,0,2,0,11
hadoop-trunk\hadoop-trunk\hadoop-hdfs-project\hadoop-hdfs\src\test\java\org\apache\hadoop\hdfs\security\token\block\TestBlockToken.java,865,127,19,9,0,155
hadoop-trunk\hadoop-trunk\hadoop-yarn-project\hadoop-yarn\hadoop-yarn-api\src\main\java\org\apache\hadoop\yarn\server\api\ContainerLogAggregationPolicy.java,0,1,0,1,0,2
hadoop-trunk\hadoop-trunk\hadoop-hdfs-project\hadoop-hdfs-client\src\main\java\org\apache\hadoop\hdfs\protocol\HdfsPartialListing.java,50,26,0,1,0,27
hadoop-trunk\hadoop-trunk\hadoop-common-project\hadoop-common\src\test\java\org\apache\hadoop\util\hash\TestHash.java,67,12,13,2,0,27
hadoop-trunk\hadoop-trunk\hadoop-tools\hadoop-azure\src\main\java\org\apache\hadoop\fs\azurebfs\contracts\exceptions\ConfigurationPropertyNotFoundException.java,6,4,0,2,0,6
hadoop-trunk\hadoop-trunk\hadoop-yarn-project\hadoop-yarn\hadoop-yarn-server\hadoop-yarn-server-resourcemanager\src\main\java\org\apache\hadoop\yarn\server\resourcemanager\nodelabels\RMNodeLabelsMappingProvider.java,16,3,0,1,0,4
hadoop-trunk\hadoop-trunk\hadoop-yarn-project\hadoop-yarn\hadoop-yarn-server\hadoop-yarn-server-nodemanager\src\main\java\org\apache\hadoop\yarn\server\nodemanager\api\deviceplugin\DevicePlugin.java,0,0,0,1,0,1
hadoop-trunk\hadoop-trunk\hadoop-yarn-project\hadoop-yarn\hadoop-yarn-server\hadoop-yarn-server-nodemanager\src\main\java\org\apache\hadoop\yarn\server\nodemanager\containermanager\localizer\ResourceSet.java,216,34,7,1,0,42
hadoop-trunk\hadoop-trunk\hadoop-hdfs-project\hadoop-hdfs-rbf\src\main\java\org\apache\hadoop\hdfs\server\federation\router\RouterClient.java,51,18,1,1,0,20
hadoop-trunk\hadoop-trunk\hadoop-common-project\hadoop-common\src\main\java\org\apache\hadoop\fs\shell\CopyCommands.java,0,76,7,3,0,86
hadoop-trunk\hadoop-trunk\hadoop-yarn-project\hadoop-yarn\hadoop-yarn-server\hadoop-yarn-server-resourcemanager\src\main\java\org\apache\hadoop\yarn\server\resourcemanager\scheduler\ConfigurationMutationACLPolicyFactory.java,0,5,1,1,0,7
hadoop-trunk\hadoop-trunk\hadoop-yarn-project\hadoop-yarn\hadoop-yarn-common\src\main\java\org\apache\hadoop\yarn\api\records\impl\pb\QueueConfigurationsPBImpl.java,242,53,77,2,0,132
hadoop-trunk\hadoop-trunk\hadoop-hdfs-project\hadoop-hdfs-client\src\main\java\org\apache\hadoop\hdfs\protocol\XAttrNotFoundException.java,12,4,0,1,0,5
hadoop-trunk\hadoop-trunk\hadoop-yarn-project\hadoop-yarn\hadoop-yarn-common\src\main\java\org\apache\hadoop\yarn\webapp\GenericExceptionHandler.java,63,5,0,2,0,7
hadoop-trunk\hadoop-trunk\hadoop-hdfs-project\hadoop-hdfs\src\main\java\org\apache\hadoop\hdfs\server\namenode\DirectoryWithQuotaFeature.java,0,71,2,8,0,81
hadoop-trunk\hadoop-trunk\hadoop-hdfs-project\hadoop-hdfs\src\test\java\org\apache\hadoop\hdfs\server\namenode\snapshot\TestNestedSnapshots.java,289,66,9,4,0,79
hadoop-trunk\hadoop-trunk\hadoop-hdfs-project\hadoop-hdfs\src\test\java\org\apache\hadoop\hdfs\TestBlocksScheduledCounter.java,219,30,0,1,0,31
hadoop-trunk\hadoop-trunk\hadoop-yarn-project\hadoop-yarn\hadoop-yarn-server\hadoop-yarn-server-resourcemanager\src\main\java\org\apache\hadoop\yarn\server\resourcemanager\scheduler\SchedulerNode.java,534,69,10,3,0,82
hadoop-trunk\hadoop-trunk\hadoop-yarn-project\hadoop-yarn\hadoop-yarn-applications\hadoop-yarn-services\hadoop-yarn-services-core\src\test\java\org\apache\hadoop\yarn\service\component\instance\TestComponentInstance.java,749,35,12,1,0,48
hadoop-trunk\hadoop-trunk\hadoop-common-project\hadoop-common\src\main\java\org\apache\hadoop\fs\impl\AbstractFSBuilderImpl.java,0,21,2,1,0,24
hadoop-trunk\hadoop-trunk\hadoop-common-project\hadoop-common\src\main\java\org\apache\hadoop\security\authorize\DefaultImpersonationProvider.java,158,58,1,4,0,63
hadoop-trunk\hadoop-trunk\hadoop-tools\hadoop-azure\src\main\java\org\apache\hadoop\fs\azurebfs\services\KeyProvider.java,0,0,0,1,0,1
hadoop-trunk\hadoop-trunk\hadoop-yarn-project\hadoop-yarn\hadoop-yarn-server\hadoop-yarn-server-nodemanager\src\test\java\org\apache\hadoop\yarn\server\nodemanager\containermanager\launcher\TestContainerRelaunch.java,80,3,0,4,0,7
hadoop-trunk\hadoop-trunk\hadoop-common-project\hadoop-common\src\test\java\org\apache\hadoop\util\TestFastNumberFormat.java,20,19,1,1,0,21
hadoop-trunk\hadoop-trunk\hadoop-cloud-storage-project\hadoop-cos\src\main\java\org\apache\hadoop\fs\cosn\CosN.java,12,4,0,1,0,5
hadoop-trunk\hadoop-trunk\hadoop-yarn-project\hadoop-yarn\hadoop-yarn-client\src\test\java\org\apache\hadoop\yarn\client\cli\TestTopCLI.java,68,8,1,1,0,10
hadoop-trunk\hadoop-trunk\hadoop-yarn-project\hadoop-yarn\hadoop-yarn-common\src\test\java\org\apache\hadoop\yarn\webapp\util\TestWebAppUtils.java,200,53,11,15,0,79
hadoop-trunk\hadoop-trunk\hadoop-hdfs-project\hadoop-hdfs\src\test\java\org\apache\hadoop\hdfs\server\namenode\ha\TestNNHealthCheck.java,118,12,0,5,0,17
hadoop-trunk\hadoop-trunk\hadoop-tools\hadoop-streaming\src\main\java\org\apache\hadoop\record\CsvRecordOutput.java,126,71,4,1,0,76
hadoop-trunk\hadoop-trunk\hadoop-yarn-project\hadoop-yarn\hadoop-yarn-common\src\main\java\org\apache\hadoop\yarn\client\api\impl\TimelineWriter.java,115,29,3,2,0,34
hadoop-trunk\hadoop-trunk\hadoop-yarn-project\hadoop-yarn\hadoop-yarn-server\hadoop-yarn-server-resourcemanager\src\test\java\org\apache\hadoop\yarn\server\resourcemanager\scheduler\fair\allocationfile\AllocationFileQueue.java,0,114,1,2,0,117
hadoop-trunk\hadoop-trunk\hadoop-common-project\hadoop-common\src\test\java\org\apache\hadoop\fs\store\TestEtagChecksum.java,55,12,0,1,0,13
hadoop-trunk\hadoop-trunk\hadoop-tools\hadoop-resourceestimator\src\test\java\org\apache\hadoop\resourceestimator\service\TestResourceEstimatorService.java,209,47,8,4,0,59
hadoop-trunk\hadoop-trunk\hadoop-common-project\hadoop-common\src\test\java\org\apache\hadoop\service\launcher\testservices\FailureTestService.java,30,11,0,1,0,12
hadoop-trunk\hadoop-trunk\hadoop-hdfs-project\hadoop-hdfs\src\test\java\org\apache\hadoop\fs\contract\hdfs\TestHDFSContractSetTimes.java,18,4,0,1,0,5
hadoop-trunk\hadoop-trunk\hadoop-hdfs-project\hadoop-hdfs-client\src\main\java\org\apache\hadoop\hdfs\web\resources\StoragePolicyParam.java,24,2,1,1,0,4
hadoop-trunk\hadoop-trunk\hadoop-yarn-project\hadoop-yarn\hadoop-yarn-server\hadoop-yarn-server-resourcemanager\src\test\java\org\apache\hadoop\yarn\server\resourcemanager\scheduler\capacity\TestCapacitySchedulerSurgicalPreemption.java,0,227,4,27,0,258
hadoop-trunk\hadoop-trunk\hadoop-common-project\hadoop-common\src\main\java\org\apache\hadoop\fs\local\package-info.java,0,1,0,1,0,2
hadoop-trunk\hadoop-trunk\hadoop-mapreduce-project\hadoop-mapreduce-client\hadoop-mapreduce-client-common\src\main\java\org\apache\hadoop\mapreduce\v2\api\records\Avataar.java,0,2,0,1,0,3
hadoop-trunk\hadoop-trunk\hadoop-yarn-project\hadoop-yarn\hadoop-yarn-server\hadoop-yarn-server-common\src\main\java\org\apache\hadoop\yarn\server\api\records\ContainerQueuingLimit.java,19,5,0,1,0,6
hadoop-trunk\hadoop-trunk\hadoop-hdfs-project\hadoop-hdfs-rbf\src\main\java\org\apache\hadoop\hdfs\server\federation\store\records\MembershipState.java,0,71,2,7,0,80
hadoop-trunk\hadoop-trunk\hadoop-mapreduce-project\hadoop-mapreduce-client\hadoop-mapreduce-client-core\src\main\java\org\apache\hadoop\mapreduce\counters\Limits.java,100,51,1,2,0,54
hadoop-trunk\hadoop-trunk\hadoop-tools\hadoop-distcp\src\main\java\org\apache\hadoop\tools\DistCpContext.java,179,86,0,1,0,87
hadoop-trunk\hadoop-trunk\hadoop-common-project\hadoop-common\src\test\java\org\apache\hadoop\fs\contract\rawlocal\TestRawlocalContractMkdir.java,8,2,0,1,0,3
hadoop-trunk\hadoop-trunk\hadoop-common-project\hadoop-common\src\test\java\org\apache\hadoop\cli\util\ComparatorData.java,83,18,2,1,0,21
hadoop-trunk\hadoop-trunk\hadoop-yarn-project\hadoop-yarn\hadoop-yarn-common\src\main\java\org\apache\hadoop\yarn\api\protocolrecords\impl\pb\GetAttributesToNodesResponsePBImpl.java,0,20,48,2,0,70
hadoop-trunk\hadoop-trunk\hadoop-common-project\hadoop-common\src\main\java\org\apache\hadoop\io\BooleanWritable.java,94,38,2,1,0,41
hadoop-trunk\hadoop-trunk\hadoop-common-project\hadoop-common\src\main\java\org\apache\hadoop\ipc\ProtocolMetaInfoServerSideTranslatorPB.java,87,23,20,6,0,49
hadoop-trunk\hadoop-trunk\hadoop-tools\hadoop-aws\src\main\java\org\apache\hadoop\fs\s3a\audit\impl\NoopSpan.java,81,9,0,1,0,10
hadoop-trunk\hadoop-trunk\hadoop-hdfs-project\hadoop-hdfs-rbf\src\main\java\org\apache\hadoop\hdfs\rbfbalance\MountTableProcedure.java,196,44,2,6,0,52
hadoop-trunk\hadoop-trunk\hadoop-common-project\hadoop-common\src\test\java\org\apache\hadoop\ipc\TestRpcBase.java,0,142,76,5,0,223
hadoop-trunk\hadoop-trunk\hadoop-yarn-project\hadoop-yarn\hadoop-yarn-server\hadoop-yarn-server-timelineservice-hbase\hadoop-yarn-server-timelineservice-hbase-server\hadoop-yarn-server-timelineservice-hbase-server-2\src\main\java\org\apache\hadoop\yarn\server\timelineservice\storage\common\package-info.java,0,0,0,1,0,1
hadoop-trunk\hadoop-trunk\hadoop-common-project\hadoop-common\src\main\java\org\apache\hadoop\fs\shell\find\ExpressionFactory.java,0,16,4,1,0,21
hadoop-trunk\hadoop-trunk\hadoop-common-project\hadoop-common\src\main\java\org\apache\hadoop\security\http\XFrameOptionsFilter.java,0,32,9,1,0,42
hadoop-trunk\hadoop-trunk\hadoop-mapreduce-project\hadoop-mapreduce-client\hadoop-mapreduce-client-app\src\main\java\org\apache\hadoop\mapreduce\v2\app\webapp\dao\CounterGroupInfo.java,24,10,2,1,0,13
hadoop-trunk\hadoop-trunk\hadoop-common-project\hadoop-common\src\test\java\org\apache\hadoop\fs\shell\TestCpCommand.java,169,46,5,2,0,53
hadoop-trunk\hadoop-trunk\hadoop-yarn-project\hadoop-yarn\hadoop-yarn-api\src\main\java\org\apache\hadoop\yarn\server\api\protocolrecords\RemoveFromClusterNodeLabelsResponse.java,6,1,0,1,0,2
hadoop-trunk\hadoop-trunk\hadoop-common-project\hadoop-common\src\test\java\org\apache\hadoop\fs\permission\TestFsPermission.java,0,103,55,2,0,160
hadoop-trunk\hadoop-trunk\hadoop-hdfs-project\hadoop-hdfs\src\main\java\org\apache\hadoop\hdfs\server\namenode\DefaultAuditLogger.java,55,14,1,2,0,17
hadoop-trunk\hadoop-trunk\hadoop-hdfs-project\hadoop-hdfs\src\main\java\org\apache\hadoop\hdfs\server\protocol\NNHAStatusHeartbeat.java,19,13,0,1,0,14
hadoop-trunk\hadoop-trunk\hadoop-mapreduce-project\hadoop-mapreduce-client\hadoop-mapreduce-client-core\src\main\java\org\apache\hadoop\mapred\lib\aggregate\LongValueMin.java,0,3,0,1,0,4
hadoop-trunk\hadoop-trunk\hadoop-hdfs-project\hadoop-hdfs-rbf\src\test\java\org\apache\hadoop\hdfs\server\federation\MockResolver.java,0,74,7,5,0,86
hadoop-trunk\hadoop-trunk\hadoop-yarn-project\hadoop-yarn\hadoop-yarn-common\src\main\java\org\apache\hadoop\yarn\api\protocolrecords\impl\pb\GetClusterNodeAttributesRequestPBImpl.java,0,15,19,3,0,37
hadoop-trunk\hadoop-trunk\hadoop-cloud-storage-project\hadoop-huaweicloud\src\test\java\org\apache\hadoop\fs\obs\TestOBSFileContextMainOperations.java,43,4,1,1,0,6
hadoop-trunk\hadoop-trunk\hadoop-tools\hadoop-federation-balance\src\test\java\org\apache\hadoop\tools\fedbalance\TestDistCpProcedure.java,418,69,8,5,0,82
hadoop-trunk\hadoop-trunk\hadoop-common-project\hadoop-common\src\test\java\org\apache\hadoop\conf\TestReconfiguration.java,560,82,30,2,0,114
hadoop-trunk\hadoop-trunk\hadoop-tools\hadoop-resourceestimator\src\test\java\org\apache\hadoop\resourceestimator\solver\impl\TestLpSolver.java,59,8,4,6,0,18
hadoop-trunk\hadoop-trunk\hadoop-yarn-project\hadoop-yarn\hadoop-yarn-server\hadoop-yarn-server-resourcemanager\src\main\java\org\apache\hadoop\yarn\server\resourcemanager\recovery\records\impl\pb\ApplicationAttemptStateDataPBImpl.java,424,107,102,11,0,220
hadoop-trunk\hadoop-trunk\hadoop-yarn-project\hadoop-yarn\hadoop-yarn-common\src\main\java\org\apache\hadoop\yarn\security\NMTokenIdentifier.java,129,46,31,3,0,80
hadoop-trunk\hadoop-trunk\hadoop-common-project\hadoop-auth\src\test\java\org\apache\hadoop\security\authentication\server\TestAltKerberosAuthenticationHandler.java,0,16,0,1,0,17
hadoop-trunk\hadoop-trunk\hadoop-yarn-project\hadoop-yarn\hadoop-yarn-server\hadoop-yarn-server-nodemanager\src\main\java\org\apache\hadoop\yarn\server\nodemanager\containermanager\linux\resources\numa\NumaResourceAllocation.java,59,27,0,2,0,29
hadoop-trunk\hadoop-trunk\hadoop-yarn-project\hadoop-yarn\hadoop-yarn-applications\hadoop-yarn-applications-mawo\hadoop-yarn-applications-mawo-core\src\main\java\org\apache\hadoop\applications\mawo\server\common\CompositeTask.java,20,0,0,1,0,1
hadoop-trunk\hadoop-trunk\hadoop-hdfs-project\hadoop-hdfs-rbf\src\main\java\org\apache\hadoop\hdfs\protocolPB\package-info.java,0,1,1,1,0,3
hadoop-trunk\hadoop-trunk\hadoop-tools\hadoop-archive-logs\src\main\java\org\apache\hadoop\tools\HadoopArchiveLogsRunner.java,193,37,9,1,0,47
hadoop-trunk\hadoop-trunk\hadoop-yarn-project\hadoop-yarn\hadoop-yarn-common\src\main\java\org\apache\hadoop\yarn\api\protocolrecords\impl\pb\GetClusterNodesRequestPBImpl.java,124,31,39,4,0,74
hadoop-trunk\hadoop-trunk\hadoop-hdfs-project\hadoop-hdfs\src\test\java\org\apache\hadoop\hdfs\BenchmarkThroughput.java,194,50,7,1,0,58
hadoop-trunk\hadoop-trunk\hadoop-yarn-project\hadoop-yarn\hadoop-yarn-server\hadoop-yarn-server-common\src\main\java\org\apache\hadoop\yarn\server\webapp\AppBlock.java,380,42,3,6,0,51
hadoop-trunk\hadoop-trunk\hadoop-common-project\hadoop-common\src\main\java\org\apache\hadoop\io\erasurecode\rawcoder\util\DumpUtil.java,0,24,1,1,0,26
hadoop-trunk\hadoop-trunk\hadoop-common-project\hadoop-common\src\test\java\org\apache\hadoop\fs\contract\localfs\TestLocalFSContractCreate.java,22,3,0,1,0,4
hadoop-trunk\hadoop-trunk\hadoop-common-project\hadoop-auth\src\main\java\org\apache\hadoop\security\authentication\util\RolloverSignerSecretProvider.java,0,17,1,1,0,19
hadoop-trunk\hadoop-trunk\hadoop-mapreduce-project\hadoop-mapreduce-client\hadoop-mapreduce-client-core\src\test\java\org\apache\hadoop\mapred\TestOldMethodsJobID.java,134,82,1,5,0,88
hadoop-trunk\hadoop-trunk\hadoop-tools\hadoop-azure-datalake\src\main\java\org\apache\hadoop\fs\adl\AdlConfKeys.java,0,38,0,1,0,39
hadoop-trunk\hadoop-trunk\hadoop-common-project\hadoop-common\src\main\java\org\apache\hadoop\fs\ChecksumFs.java,546,186,4,5,0,195
hadoop-trunk\hadoop-trunk\hadoop-common-project\hadoop-common\src\main\java\org\apache\hadoop\service\package-info.java,0,1,0,1,0,2
hadoop-trunk\hadoop-trunk\hadoop-mapreduce-project\hadoop-mapreduce-client\hadoop-mapreduce-client-app\src\test\java\org\apache\hadoop\mapreduce\v2\app\job\impl\TestShuffleProvider.java,101,29,6,12,0,47
hadoop-trunk\hadoop-trunk\hadoop-mapreduce-project\hadoop-mapreduce-client\hadoop-mapreduce-client-jobclient\src\test\java\org\apache\hadoop\mapreduce\v2\TestRMNMInfo.java,121,24,5,2,0,31
hadoop-trunk\hadoop-trunk\hadoop-hdfs-project\hadoop-hdfs\src\test\java\org\apache\hadoop\hdfs\server\diskbalancer\TestDataModels.java,209,38,0,3,0,41
hadoop-trunk\hadoop-trunk\hadoop-tools\hadoop-gridmix\src\main\java\org\apache\hadoop\mapred\gridmix\JobSubmitter.java,0,42,13,1,0,56
hadoop-trunk\hadoop-trunk\hadoop-common-project\hadoop-common\src\main\java\org\apache\hadoop\util\SysInfo.java,117,0,0,1,0,1
hadoop-trunk\hadoop-trunk\hadoop-mapreduce-project\hadoop-mapreduce-client\hadoop-mapreduce-client-app\src\main\java\org\apache\hadoop\mapreduce\v2\app\speculate\TaskRuntimeEstimator.java,0,14,8,2,0,24
hadoop-trunk\hadoop-trunk\hadoop-yarn-project\hadoop-yarn\hadoop-yarn-common\src\test\java\org\apache\hadoop\yarn\util\TestFSDownload.java,702,176,38,4,0,218
hadoop-trunk\hadoop-trunk\hadoop-yarn-project\hadoop-yarn\hadoop-yarn-applications\hadoop-yarn-applications-distributedshell\src\main\java\org\apache\hadoop\yarn\applications\distributedshell\DSConstants.java,25,12,0,6,0,18
hadoop-trunk\hadoop-trunk\hadoop-common-project\hadoop-common\src\test\java\org\apache\hadoop\io\retry\TestDefaultRetryPolicy.java,78,3,0,1,0,4
hadoop-trunk\hadoop-trunk\hadoop-yarn-project\hadoop-yarn\hadoop-yarn-server\hadoop-yarn-server-resourcemanager\src\main\java\org\apache\hadoop\yarn\server\resourcemanager\scheduler\fair\policies\FifoPolicy.java,102,25,2,2,0,29
hadoop-trunk\hadoop-trunk\hadoop-common-project\hadoop-common\src\test\java\org\apache\hadoop\conf\TestCommonConfigurationFields.java,195,8,8,2,0,18
hadoop-trunk\hadoop-trunk\hadoop-mapreduce-project\hadoop-mapreduce-client\hadoop-mapreduce-client-jobclient\src\test\java\org\apache\hadoop\mapred\pipes\TestPipes.java,232,86,13,6,0,105
hadoop-trunk\hadoop-trunk\hadoop-common-project\hadoop-common\src\main\java\org\apache\hadoop\log\Log4Json.java,164,42,3,18,0,63
hadoop-trunk\hadoop-trunk\hadoop-tools\hadoop-sls\src\main\java\org\apache\hadoop\yarn\sls\scheduler\Tracker.java,21,12,0,1,0,13
hadoop-trunk\hadoop-trunk\hadoop-hdfs-project\hadoop-hdfs\src\test\java\org\apache\hadoop\hdfs\server\namenode\snapshot\TestAclWithSnapshot.java,873,202,67,2,0,271
hadoop-trunk\hadoop-trunk\hadoop-yarn-project\hadoop-yarn\hadoop-yarn-server\hadoop-yarn-server-nodemanager\src\test\java\org\apache\hadoop\yarn\server\nodemanager\MockNodeStatusUpdater.java,68,26,5,7,0,38
hadoop-trunk\hadoop-trunk\hadoop-common-project\hadoop-common\src\test\java\org\apache\hadoop\net\unix\TemporarySocketDirectory.java,28,8,0,1,0,9
hadoop-trunk\hadoop-trunk\hadoop-hdfs-project\hadoop-hdfs\src\test\java\org\apache\hadoop\hdfs\TestParallelShortCircuitRead.java,31,9,2,2,0,13
hadoop-trunk\hadoop-trunk\hadoop-hdfs-project\hadoop-hdfs\src\main\java\org\apache\hadoop\hdfs\tools\CryptoAdmin.java,382,39,0,1,0,40
hadoop-trunk\hadoop-trunk\hadoop-yarn-project\hadoop-yarn\hadoop-yarn-api\src\main\java\org\apache\hadoop\yarn\exceptions\InvalidResourceBlacklistRequestException.java,18,13,0,2,0,15
hadoop-trunk\hadoop-trunk\hadoop-mapreduce-project\hadoop-mapreduce-client\hadoop-mapreduce-client-nativetask\src\main\java\org\apache\hadoop\mapred\nativetask\ICombineHandler.java,0,6,3,1,0,10
hadoop-trunk\hadoop-trunk\hadoop-yarn-project\hadoop-yarn\hadoop-yarn-server\hadoop-yarn-server-nodemanager\src\main\java\org\apache\hadoop\yarn\server\nodemanager\util\NodeManagerHardwareUtils.java,346,35,7,2,0,44
hadoop-trunk\hadoop-trunk\hadoop-yarn-project\hadoop-yarn\hadoop-yarn-server\hadoop-yarn-server-resourcemanager\src\main\java\org\apache\hadoop\yarn\server\resourcemanager\reservation\planning\Planner.java,0,2,1,3,0,6
hadoop-trunk\hadoop-trunk\hadoop-yarn-project\hadoop-yarn\hadoop-yarn-server\hadoop-yarn-server-timelineservice-documentstore\src\main\java\org\apache\hadoop\yarn\server\timelineservice\documentstore\DocumentStoreTimelineReaderImpl.java,0,23,2,7,0,32
hadoop-trunk\hadoop-trunk\hadoop-hdfs-project\hadoop-hdfs-client\src\main\java\org\apache\hadoop\hdfs\web\SSLConnectionConfigurator.java,34,13,0,1,0,14
hadoop-trunk\hadoop-trunk\hadoop-tools\hadoop-aws\src\test\java\org\apache\hadoop\fs\s3a\commit\staging\TestPaths.java,94,19,1,1,0,21
hadoop-trunk\hadoop-trunk\hadoop-yarn-project\hadoop-yarn\hadoop-yarn-api\src\main\java\org\apache\hadoop\yarn\api\records\timelineservice\TimelineMetricOperation.java,0,26,0,1,0,27
hadoop-trunk\hadoop-trunk\hadoop-mapreduce-project\hadoop-mapreduce-client\hadoop-mapreduce-client-nativetask\src\test\java\org\apache\hadoop\mapred\nativetask\serde\TestKVSerializer.java,117,35,0,8,0,43
hadoop-trunk\hadoop-trunk\hadoop-tools\hadoop-aws\src\test\java\org\apache\hadoop\fs\s3a\commit\staging\TestStagingPartitionedTaskCommit.java,0,21,5,1,0,27
hadoop-trunk\hadoop-trunk\hadoop-tools\hadoop-gridmix\src\main\java\org\apache\hadoop\mapred\gridmix\JobCreator.java,0,29,3,1,0,33
hadoop-trunk\hadoop-trunk\hadoop-tools\hadoop-openstack\src\test\java\org\apache\hadoop\fs\swift\http\TestSwiftRestClient.java,78,9,7,1,0,17
hadoop-trunk\hadoop-trunk\hadoop-yarn-project\hadoop-yarn\hadoop-yarn-server\hadoop-yarn-server-resourcemanager\src\test\java\org\apache\hadoop\yarn\server\resourcemanager\webapp\TestRMWebServicesContainers.java,117,6,0,4,0,10
hadoop-trunk\hadoop-trunk\hadoop-common-project\hadoop-auth\src\test\java\org\apache\hadoop\security\authentication\util\TestAuthToken.java,109,10,13,1,0,24
hadoop-trunk\hadoop-trunk\hadoop-mapreduce-project\hadoop-mapreduce-client\hadoop-mapreduce-client-core\src\main\java\org\apache\hadoop\mapreduce\task\TaskAttemptContextImpl.java,0,42,2,1,0,45
hadoop-trunk\hadoop-trunk\hadoop-mapreduce-project\hadoop-mapreduce-client\hadoop-mapreduce-client-app\src\main\java\org\apache\hadoop\mapreduce\v2\app\security\authorize\package-info.java,0,1,0,1,0,2
hadoop-trunk\hadoop-trunk\hadoop-tools\hadoop-azure\src\test\java\org\apache\hadoop\fs\azurebfs\TestAbfsNetworkStatistics.java,101,8,1,6,0,15
hadoop-trunk\hadoop-trunk\hadoop-yarn-project\hadoop-yarn\hadoop-yarn-server\hadoop-yarn-server-resourcemanager\src\main\java\org\apache\hadoop\yarn\server\resourcemanager\scheduler\constraint\processor\PlacementDispatcher.java,104,16,7,7,0,30
hadoop-trunk\hadoop-trunk\hadoop-tools\hadoop-gridmix\src\main\java\org\apache\hadoop\mapred\gridmix\Gridmix.java,0,164,30,22,0,216
hadoop-trunk\hadoop-trunk\hadoop-yarn-project\hadoop-yarn\hadoop-yarn-server\hadoop-yarn-server-resourcemanager\src\test\java\org\apache\hadoop\yarn\server\resourcemanager\monitor\capacity\TestProportionalCapacityPreemptionPolicyIntraQueue.java,991,196,0,4,0,200
hadoop-trunk\hadoop-trunk\hadoop-tools\hadoop-aws\src\main\java\org\apache\hadoop\fs\s3a\commit\magic\MagicS3GuardCommitter.java,247,25,9,3,0,37
hadoop-trunk\hadoop-trunk\hadoop-tools\hadoop-openstack\src\main\java\org\apache\hadoop\fs\swift\util\SwiftObjectPath.java,0,26,2,3,0,31
hadoop-trunk\hadoop-trunk\hadoop-tools\hadoop-aws\src\main\java\org\apache\hadoop\fs\s3a\AWSNoResponseException.java,7,3,0,1,0,4
hadoop-trunk\hadoop-trunk\hadoop-yarn-project\hadoop-yarn\hadoop-yarn-server\hadoop-yarn-server-resourcemanager\src\main\java\org\apache\hadoop\yarn\server\resourcemanager\reservation\ReservationInterval.java,92,25,2,1,0,28
hadoop-trunk\hadoop-trunk\hadoop-yarn-project\hadoop-yarn\hadoop-yarn-server\hadoop-yarn-server-nodemanager\src\main\java\org\apache\hadoop\yarn\server\nodemanager\webapp\WebServer.java,143,27,1,1,0,29
hadoop-trunk\hadoop-trunk\hadoop-yarn-project\hadoop-yarn\hadoop-yarn-server\hadoop-yarn-server-resourcemanager\src\main\java\org\apache\hadoop\yarn\server\resourcemanager\scheduler\capacity\conf\QueueCapacityConfigParser.java,171,28,0,9,0,37
hadoop-trunk\hadoop-trunk\hadoop-yarn-project\hadoop-yarn\hadoop-yarn-common\src\main\java\org\apache\hadoop\yarn\api\protocolrecords\impl\pb\GetNewReservationRequestPBImpl.java,43,13,17,2,0,32
hadoop-trunk\hadoop-trunk\hadoop-yarn-project\hadoop-yarn\hadoop-yarn-server\hadoop-yarn-server-common\src\main\java\org\apache\hadoop\yarn\server\federation\store\records\impl\pb\GetApplicationHomeSubClusterRequestPBImpl.java,0,20,34,4,0,58
hadoop-trunk\hadoop-trunk\hadoop-yarn-project\hadoop-yarn\hadoop-yarn-common\src\main\java\org\apache\hadoop\yarn\webapp\view\InfoBlock.java,48,10,0,1,0,11
hadoop-trunk\hadoop-trunk\hadoop-yarn-project\hadoop-yarn\hadoop-yarn-server\hadoop-yarn-server-timelineservice-hbase\hadoop-yarn-server-timelineservice-hbase-server\hadoop-yarn-server-timelineservice-hbase-server-1\src\main\java\org\apache\hadoop\yarn\server\timelineservice\storage\flow\FlowScannerOperation.java,0,0,0,1,0,1
hadoop-trunk\hadoop-trunk\hadoop-hdfs-project\hadoop-hdfs-rbf\src\main\java\org\apache\hadoop\hdfs\server\federation\store\protocol\GetDisabledNameservicesResponse.java,24,5,0,2,0,7
hadoop-trunk\hadoop-trunk\hadoop-tools\hadoop-azure\src\main\java\org\apache\hadoop\fs\azurebfs\diagnostics\StringConfigurationBasicValidator.java,16,8,3,6,0,17
hadoop-trunk\hadoop-trunk\hadoop-hdfs-project\hadoop-hdfs\src\main\java\org\apache\hadoop\hdfs\protocolPB\ReconfigurationProtocolServerSideTranslatorPB.java,50,14,19,7,0,40
hadoop-trunk\hadoop-trunk\hadoop-yarn-project\hadoop-yarn\hadoop-yarn-server\hadoop-yarn-server-nodemanager\src\main\java\org\apache\hadoop\yarn\server\nodemanager\executor\ContainerSignalContext.java,0,41,7,2,0,50
hadoop-trunk\hadoop-trunk\hadoop-yarn-project\hadoop-yarn\hadoop-yarn-server\hadoop-yarn-server-resourcemanager\src\main\java\org\apache\hadoop\yarn\server\resourcemanager\recovery\RMStateStoreRMDTEvent.java,24,15,0,1,0,16
hadoop-trunk\hadoop-trunk\hadoop-mapreduce-project\hadoop-mapreduce-client\hadoop-mapreduce-client-app\src\main\java\org\apache\hadoop\mapreduce\v2\app\commit\CommitterTaskAbortEvent.java,21,11,0,1,0,12
hadoop-trunk\hadoop-trunk\hadoop-common-project\hadoop-common\src\test\java\org\apache\hadoop\net\MockDomainNameResolver.java,67,20,2,1,0,23
hadoop-trunk\hadoop-trunk\hadoop-hdfs-project\hadoop-hdfs\src\test\java\org\apache\hadoop\hdfs\server\datanode\fsdataset\impl\FsDatasetImplTestUtils.java,437,76,13,3,0,92
hadoop-trunk\hadoop-trunk\hadoop-common-project\hadoop-common\src\main\java\org\apache\hadoop\metrics2\sink\PrometheusMetricsSink.java,153,27,7,4,0,38
hadoop-trunk\hadoop-trunk\hadoop-tools\hadoop-azure\src\test\java\org\apache\hadoop\fs\azure\integration\AbstractAzureScaleTest.java,0,6,2,1,0,9
hadoop-trunk\hadoop-trunk\hadoop-yarn-project\hadoop-yarn\hadoop-yarn-server\hadoop-yarn-server-resourcemanager\src\test\java\org\apache\hadoop\yarn\server\resourcemanager\scheduler\capacity\TestQueueState.java,239,33,1,3,0,37
hadoop-trunk\hadoop-trunk\hadoop-common-project\hadoop-common\src\main\java\org\apache\hadoop\io\compress\CompressionInputStream.java,0,20,1,2,0,23
hadoop-trunk\hadoop-trunk\hadoop-yarn-project\hadoop-yarn\hadoop-yarn-server\hadoop-yarn-server-common\src\main\java\org\apache\hadoop\yarn\server\federation\store\records\impl\pb\DeleteApplicationHomeSubClusterResponsePBImpl.java,0,13,17,3,0,33
hadoop-trunk\hadoop-trunk\hadoop-yarn-project\hadoop-yarn\hadoop-yarn-server\hadoop-yarn-server-resourcemanager\src\test\java\org\apache\hadoop\yarn\server\resourcemanager\scheduler\QueueInfo.java,0,24,0,1,0,25
hadoop-trunk\hadoop-trunk\hadoop-yarn-project\hadoop-yarn\hadoop-yarn-applications\hadoop-yarn-applications-distributedshell\src\test\java\org\apache\hadoop\yarn\applications\distributedshell\TestDSTimelineV10.java,774,44,36,1,0,81
hadoop-trunk\hadoop-trunk\hadoop-hdfs-project\hadoop-hdfs-rbf\src\main\java\org\apache\hadoop\hdfs\server\federation\resolver\PathLocation.java,195,13,0,1,0,14
hadoop-trunk\hadoop-trunk\hadoop-yarn-project\hadoop-yarn\hadoop-yarn-server\hadoop-yarn-server-resourcemanager\src\main\java\org\apache\hadoop\yarn\server\resourcemanager\scheduler\common\ContainerRequest.java,23,12,0,1,0,13
hadoop-trunk\hadoop-trunk\hadoop-yarn-project\hadoop-yarn\hadoop-yarn-applications\hadoop-yarn-applications-distributedshell\src\main\java\org\apache\hadoop\yarn\applications\distributedshell\Client.java,1292,276,32,59,0,367
hadoop-trunk\hadoop-trunk\hadoop-mapreduce-project\hadoop-mapreduce-client\hadoop-mapreduce-client-core\src\test\java\org\apache\hadoop\mapreduce\lib\output\TestPathOutputCommitter.java,352,78,7,1,0,86
hadoop-trunk\hadoop-trunk\hadoop-yarn-project\hadoop-yarn\hadoop-yarn-api\src\main\java\org\apache\hadoop\yarn\util\csi\package-info.java,0,0,0,1,0,1
hadoop-trunk\hadoop-trunk\hadoop-yarn-project\hadoop-yarn\hadoop-yarn-server\hadoop-yarn-server-resourcemanager\src\main\java\org\apache\hadoop\yarn\server\resourcemanager\scheduler\fair\converter\weightconversion\WeightToWeightConverter.java,0,7,1,4,0,12
hadoop-trunk\hadoop-trunk\hadoop-yarn-project\hadoop-yarn\hadoop-yarn-server\hadoop-yarn-server-timelineservice-hbase\hadoop-yarn-server-timelineservice-hbase-common\src\main\java\org\apache\hadoop\yarn\server\timelineservice\storage\apptoflow\AppToFlowTable.java,0,0,0,1,0,1
hadoop-trunk\hadoop-trunk\hadoop-yarn-project\hadoop-yarn\hadoop-yarn-common\src\test\java\org\apache\hadoop\yarn\util\TestWindowsBasedProcessTree.java,63,33,20,4,0,57
hadoop-trunk\hadoop-trunk\hadoop-hdfs-project\hadoop-hdfs\src\main\java\org\apache\hadoop\hdfs\server\namenode\FSDirStatAndListingOp.java,0,124,4,5,0,133
hadoop-trunk\hadoop-trunk\hadoop-hdfs-project\hadoop-hdfs-rbf\src\test\java\org\apache\hadoop\fs\contract\router\web\TestRouterWebHDFSContractMkdir.java,18,4,0,1,0,5
hadoop-trunk\hadoop-trunk\hadoop-tools\hadoop-aws\src\main\java\org\apache\hadoop\fs\s3a\package-info.java,0,1,0,1,0,2
hadoop-trunk\hadoop-trunk\hadoop-hdfs-project\hadoop-hdfs-client\src\main\java\org\apache\hadoop\hdfs\server\protocol\package-info.java,0,1,0,1,0,2
hadoop-trunk\hadoop-trunk\hadoop-yarn-project\hadoop-yarn\hadoop-yarn-server\hadoop-yarn-server-nodemanager\src\main\java\org\apache\hadoop\yarn\server\nodemanager\containermanager\linux\resources\DiskResourceHandler.java,0,0,0,2,0,2
hadoop-trunk\hadoop-trunk\hadoop-yarn-project\hadoop-yarn\hadoop-yarn-applications\hadoop-yarn-applications-catalog\hadoop-yarn-applications-catalog-webapp\src\main\java\org\apache\hadoop\yarn\appcatalog\model\AppStoreEntry.java,76,56,0,1,0,57
hadoop-trunk\hadoop-trunk\hadoop-yarn-project\hadoop-yarn\hadoop-yarn-server\hadoop-yarn-server-timelineservice-hbase-tests\src\test\java\org\apache\hadoop\yarn\server\timelineservice\storage\DataGeneratorForTest.java,0,93,0,2,0,95
hadoop-trunk\hadoop-trunk\hadoop-mapreduce-project\hadoop-mapreduce-client\hadoop-mapreduce-client-jobclient\src\main\java\org\apache\hadoop\mapred\ResourceMgrDelegate.java,483,157,5,2,0,164
hadoop-trunk\hadoop-trunk\hadoop-common-project\hadoop-nfs\src\main\java\org\apache\hadoop\oncrpc\SimpleUdpServer.java,69,31,4,2,0,37
hadoop-trunk\hadoop-trunk\hadoop-mapreduce-project\hadoop-mapreduce-client\hadoop-mapreduce-client-jobclient\src\test\java\org\apache\hadoop\fs\slive\ConfigOption.java,0,34,0,1,0,35
hadoop-trunk\hadoop-trunk\hadoop-hdfs-project\hadoop-hdfs\src\main\java\org\apache\hadoop\hdfs\server\namenode\ErasureCodingPolicyManager.java,0,72,11,3,0,86
hadoop-trunk\hadoop-trunk\hadoop-common-project\hadoop-common\src\main\java\org\apache\hadoop\util\ReadWriteDiskValidatorMetrics.java,135,18,2,1,0,21
hadoop-trunk\hadoop-trunk\hadoop-yarn-project\hadoop-yarn\hadoop-yarn-server\hadoop-yarn-server-resourcemanager\src\main\java\org\apache\hadoop\yarn\server\resourcemanager\scheduler\policy\FifoOrderingPolicyWithExclusivePartitions.java,0,41,4,4,0,49
hadoop-trunk\hadoop-trunk\hadoop-common-project\hadoop-nfs\src\main\java\org\apache\hadoop\nfs\nfs3\response\LINK3Response.java,41,25,4,1,0,30
hadoop-trunk\hadoop-trunk\hadoop-hdfs-project\hadoop-hdfs-httpfs\src\test\java\org\apache\hadoop\fs\http\server\TestHttpFSServerNoACLs.java,232,13,5,1,0,19
hadoop-trunk\hadoop-trunk\hadoop-yarn-project\hadoop-yarn\hadoop-yarn-server\hadoop-yarn-server-common\src\main\java\org\apache\hadoop\yarn\server\api\protocolrecords\impl\pb\LogAggregationReportPBImpl.java,149,34,54,3,0,91
hadoop-trunk\hadoop-trunk\hadoop-mapreduce-project\hadoop-mapreduce-client\hadoop-mapreduce-client-core\src\test\java\org\apache\hadoop\mapreduce\lib\output\TestFileOutputFormat.java,52,7,5,1,0,13
hadoop-trunk\hadoop-trunk\hadoop-tools\hadoop-dynamometer\hadoop-dynamometer-workload\src\test\java\org\apache\hadoop\tools\dynamometer\workloadgenerator\audit\TestAuditLogDirectParser.java,125,31,9,1,0,41
hadoop-trunk\hadoop-trunk\hadoop-yarn-project\hadoop-yarn\hadoop-yarn-api\src\main\java\org\apache\hadoop\yarn\api\records\PreemptionResourceRequest.java,24,4,0,1,0,5
hadoop-trunk\hadoop-trunk\hadoop-yarn-project\hadoop-yarn\hadoop-yarn-server\hadoop-yarn-server-nodemanager\src\main\java\org\apache\hadoop\yarn\server\nodemanager\containermanager\linux\runtime\docker\DockerLoadCommand.java,9,3,0,2,0,5
hadoop-trunk\hadoop-trunk\hadoop-tools\hadoop-aws\src\main\java\org\apache\hadoop\fs\s3a\impl\ContextAccessors.java,0,1,0,1,0,2
hadoop-trunk\hadoop-trunk\hadoop-yarn-project\hadoop-yarn\hadoop-yarn-server\hadoop-yarn-server-resourcemanager\src\main\java\org\apache\hadoop\yarn\server\resourcemanager\monitor\capacity\CapacitySchedulerPreemptionContext.java,0,21,1,3,0,25
hadoop-trunk\hadoop-trunk\hadoop-tools\hadoop-azure\src\test\java\org\apache\hadoop\fs\azurebfs\ITestAbfsListStatusRemoteIterator.java,257,45,4,5,0,54
hadoop-trunk\hadoop-trunk\hadoop-yarn-project\hadoop-yarn\hadoop-yarn-server\hadoop-yarn-server-common\src\main\java\org\apache\hadoop\yarn\server\federation\store\records\SubClusterId.java,66,8,0,1,0,9
hadoop-trunk\hadoop-trunk\hadoop-hdfs-project\hadoop-hdfs-client\src\main\java\org\apache\hadoop\hdfs\protocol\BlockLocalPathInfo.java,43,19,0,1,0,20
hadoop-trunk\hadoop-trunk\hadoop-yarn-project\hadoop-yarn\hadoop-yarn-server\hadoop-yarn-server-resourcemanager\src\main\java\org\apache\hadoop\yarn\server\resourcemanager\scheduler\policy\FairOrderingPolicy.java,0,31,5,3,0,39
hadoop-trunk\hadoop-trunk\hadoop-hdfs-project\hadoop-hdfs\src\main\java\org\apache\hadoop\hdfs\server\namenode\EditLogOutputStream.java,144,29,1,1,0,31
hadoop-trunk\hadoop-trunk\hadoop-yarn-project\hadoop-yarn\hadoop-yarn-server\hadoop-yarn-server-common\src\main\java\org\apache\hadoop\yarn\server\api\protocolrecords\impl\pb\ReportNewCollectorInfoResponsePBImpl.java,48,13,17,3,0,33
hadoop-trunk\hadoop-trunk\hadoop-common-project\hadoop-common\src\main\java\org\apache\hadoop\util\concurrent\AsyncGetFuture.java,0,16,1,2,0,19
hadoop-trunk\hadoop-trunk\hadoop-hdfs-project\hadoop-hdfs-httpfs\src\main\java\org\apache\hadoop\lib\service\FileSystemAccessException.java,33,18,0,2,0,20
hadoop-trunk\hadoop-trunk\hadoop-tools\hadoop-datajoin\src\main\java\org\apache\hadoop\contrib\utils\join\ArrayListBackedIterator.java,41,21,4,1,0,26
hadoop-trunk\hadoop-trunk\hadoop-yarn-project\hadoop-yarn\hadoop-yarn-applications\hadoop-yarn-services\hadoop-yarn-services-core\src\main\java\org\apache\hadoop\yarn\service\impl\pb\client\ClientAMProtocolPBClientImpl.java,0,25,45,10,0,80
hadoop-trunk\hadoop-trunk\hadoop-tools\hadoop-dynamometer\hadoop-dynamometer-blockgen\src\main\java\org\apache\hadoop\tools\dynamometer\blockgenerator\GenerateBlockImagesDriver.java,90,16,16,1,0,33
hadoop-trunk\hadoop-trunk\hadoop-hdfs-project\hadoop-hdfs\src\test\java\org\apache\hadoop\hdfs\server\blockmanagement\TestSortLocatedBlock.java,270,68,9,1,0,78
hadoop-trunk\hadoop-trunk\hadoop-hdfs-project\hadoop-hdfs-rbf\src\test\java\org\apache\hadoop\hdfs\server\federation\router\TestRBFConfigFields.java,21,1,0,1,0,2
hadoop-trunk\hadoop-trunk\hadoop-tools\hadoop-azure-datalake\src\main\java\org\apache\hadoop\fs\adl\SdkTokenProviderAdapter.java,0,2,0,1,0,3
hadoop-trunk\hadoop-trunk\hadoop-yarn-project\hadoop-yarn\hadoop-yarn-server\hadoop-yarn-server-common\src\main\java\org\apache\hadoop\yarn\server\utils\YarnServerBuilderUtils.java,97,20,14,2,0,36
hadoop-trunk\hadoop-trunk\hadoop-tools\hadoop-azure\src\main\java\org\apache\hadoop\fs\azure\AzureLinkedStack.java,183,23,2,1,0,26
hadoop-trunk\hadoop-trunk\hadoop-yarn-project\hadoop-yarn\hadoop-yarn-server\hadoop-yarn-server-nodemanager\src\main\java\org\apache\hadoop\yarn\server\nodemanager\containermanager\resourceplugin\com\nec\NECVEPlugin.java,0,47,2,7,0,56
hadoop-trunk\hadoop-trunk\hadoop-yarn-project\hadoop-yarn\hadoop-yarn-server\hadoop-yarn-server-resourcemanager\src\main\java\org\apache\hadoop\yarn\server\resourcemanager\amlauncher\AMLauncherEventType.java,0,3,0,1,0,4
hadoop-trunk\hadoop-trunk\hadoop-mapreduce-project\hadoop-mapreduce-client\hadoop-mapreduce-client-nativetask\src\main\java\org\apache\hadoop\mapred\nativetask\handlers\BufferPusher.java,0,29,2,2,0,33
hadoop-trunk\hadoop-trunk\hadoop-yarn-project\hadoop-yarn\hadoop-yarn-api\src\main\java\org\apache\hadoop\yarn\api\protocolrecords\GetApplicationAttemptsResponse.java,33,8,0,2,0,10
hadoop-trunk\hadoop-trunk\hadoop-tools\hadoop-openstack\src\main\java\org\apache\hadoop\fs\swift\util\DurationStats.java,132,35,3,1,0,39
hadoop-trunk\hadoop-trunk\hadoop-yarn-project\hadoop-yarn\hadoop-yarn-server\hadoop-yarn-server-resourcemanager\src\test\java\org\apache\hadoop\yarn\server\resourcemanager\scheduler\fair\TestFairSchedulerOvercommit.java,18,3,0,3,0,6
hadoop-trunk\hadoop-trunk\hadoop-yarn-project\hadoop-yarn\hadoop-yarn-server\hadoop-yarn-server-resourcemanager\src\main\java\org\apache\hadoop\yarn\server\resourcemanager\scheduler\fair\ReservationQueueConfiguration.java,91,47,0,2,0,49
hadoop-trunk\hadoop-trunk\hadoop-yarn-project\hadoop-yarn\hadoop-yarn-api\src\main\java\org\apache\hadoop\yarn\api\records\UpdateContainerError.java,111,8,0,1,0,9
hadoop-trunk\hadoop-trunk\hadoop-yarn-project\hadoop-yarn\hadoop-yarn-server\hadoop-yarn-server-router\src\main\java\org\apache\hadoop\yarn\server\router\webapp\RouterWebServices.java,867,205,5,21,0,231
hadoop-trunk\hadoop-trunk\hadoop-common-project\hadoop-common\src\main\java\org\apache\hadoop\ipc\protocolPB\GenericRefreshProtocolServerSideTranslatorPB.java,51,9,14,5,0,28
hadoop-trunk\hadoop-trunk\hadoop-common-project\hadoop-common\src\test\java\org\apache\hadoop\cli\util\CLICommandTypes.java,0,0,0,1,0,1
hadoop-trunk\hadoop-trunk\hadoop-yarn-project\hadoop-yarn\hadoop-yarn-applications\hadoop-yarn-services\hadoop-yarn-services-core\src\main\java\org\apache\hadoop\yarn\service\ClientAMService.java,0,32,64,14,0,110
hadoop-trunk\hadoop-trunk\hadoop-mapreduce-project\hadoop-mapreduce-client\hadoop-mapreduce-client-core\src\main\java\org\apache\hadoop\mapreduce\lib\input\TaggedInputSplit.java,0,28,13,1,0,42
hadoop-trunk\hadoop-trunk\hadoop-hdfs-project\hadoop-hdfs\src\test\java\org\apache\hadoop\hdfs\server\blockmanagement\TestReplicationPolicy.java,0,473,15,10,0,498
hadoop-trunk\hadoop-trunk\hadoop-yarn-project\hadoop-yarn\hadoop-yarn-server\hadoop-yarn-server-resourcemanager\src\main\java\org\apache\hadoop\yarn\server\resourcemanager\reservation\PlanFollower.java,0,13,3,4,0,20
hadoop-trunk\hadoop-trunk\hadoop-hdfs-project\hadoop-hdfs\src\test\java\org\apache\hadoop\hdfs\TestStateAlignmentContextWithHA.java,290,61,0,1,0,62
hadoop-trunk\hadoop-trunk\hadoop-hdfs-project\hadoop-hdfs-rbf\src\main\java\org\apache\hadoop\hdfs\server\federation\store\protocol\EnableNameserviceResponse.java,22,5,0,2,0,7
hadoop-trunk\hadoop-trunk\hadoop-tools\hadoop-distcp\src\test\java\org\apache\hadoop\tools\TestTrueCopyFilter.java,13,2,0,1,0,3
hadoop-trunk\hadoop-trunk\hadoop-hdfs-project\hadoop-hdfs-client\src\main\java\org\apache\hadoop\hdfs\protocolPB\ReconfigurationProtocolTranslatorPB.java,90,23,15,5,0,43
hadoop-trunk\hadoop-trunk\hadoop-yarn-project\hadoop-yarn\hadoop-yarn-server\hadoop-yarn-server-resourcemanager\src\main\java\org\apache\hadoop\yarn\server\resourcemanager\scheduler\capacity\QueuePath.java,193,15,1,4,0,20
hadoop-trunk\hadoop-trunk\hadoop-hdfs-project\hadoop-hdfs\src\main\java\org\apache\hadoop\hdfs\server\protocol\JournalInfo.java,49,22,5,1,0,28
hadoop-trunk\hadoop-trunk\hadoop-tools\hadoop-aws\src\test\java\org\apache\hadoop\fs\s3a\s3guard\ITestS3GuardTool.java,0,37,9,2,0,48
hadoop-trunk\hadoop-trunk\hadoop-common-project\hadoop-common\src\main\java\org\apache\hadoop\fs\LocalFileSystem.java,133,52,2,2,0,56
hadoop-trunk\hadoop-trunk\hadoop-common-project\hadoop-common\src\main\java\org\apache\hadoop\fs\store\audit\AuditSpan.java,0,0,1,1,0,2
hadoop-trunk\hadoop-trunk\hadoop-tools\hadoop-azure\src\main\java\org\apache\hadoop\fs\azure\SASKeyGeneratorImpl.java,34,11,0,1,0,12
hadoop-trunk\hadoop-trunk\hadoop-tools\hadoop-aws\src\test\java\org\apache\hadoop\fs\s3a\commit\staging\TestStagingDirectoryOutputCommitter.java,0,15,6,1,0,22
hadoop-trunk\hadoop-trunk\hadoop-tools\hadoop-aws\src\test\java\org\apache\hadoop\fs\s3a\commit\integration\ITestS3ACommitterMRJob.java,475,34,11,5,0,50
hadoop-trunk\hadoop-trunk\hadoop-common-project\hadoop-nfs\src\main\java\org\apache\hadoop\nfs\NfsTime.java,66,35,0,1,0,36
hadoop-trunk\hadoop-trunk\hadoop-tools\hadoop-rumen\src\main\java\org\apache\hadoop\tools\rumen\datatypes\ClassName.java,34,15,0,2,0,17
hadoop-trunk\hadoop-trunk\hadoop-yarn-project\hadoop-yarn\hadoop-yarn-server\hadoop-yarn-server-resourcemanager\src\main\java\org\apache\hadoop\yarn\server\resourcemanager\scheduler\fair\FSQueueType.java,0,5,0,1,0,6
hadoop-trunk\hadoop-trunk\hadoop-yarn-project\hadoop-yarn\hadoop-yarn-api\src\main\java\org\apache\hadoop\yarn\api\protocolrecords\GetNodesToAttributesRequest.java,28,3,0,1,0,4
hadoop-trunk\hadoop-trunk\hadoop-hdfs-project\hadoop-hdfs\src\test\java\org\apache\hadoop\hdfs\TestDecommissionWithBackoffMonitor.java,18,2,0,1,0,3
hadoop-trunk\hadoop-trunk\hadoop-mapreduce-project\hadoop-mapreduce-client\hadoop-mapreduce-client-jobclient\src\test\java\org\apache\hadoop\fs\slive\Formatter.java,0,11,2,1,0,14
hadoop-trunk\hadoop-trunk\hadoop-yarn-project\hadoop-yarn\hadoop-yarn-server\hadoop-yarn-server-common\src\main\java\org\apache\hadoop\yarn\server\federation\store\records\impl\pb\GetSubClustersInfoRequestPBImpl.java,77,16,29,4,0,49
hadoop-trunk\hadoop-trunk\hadoop-tools\hadoop-aws\src\main\java\org\apache\hadoop\fs\s3a\s3guard\package-info.java,0,0,0,1,0,1
hadoop-trunk\hadoop-trunk\hadoop-mapreduce-project\hadoop-mapreduce-client\hadoop-mapreduce-client-jobclient\src\test\java\org\apache\hadoop\fs\slive\ListOp.java,0,9,2,1,0,12
hadoop-trunk\hadoop-trunk\hadoop-mapreduce-project\hadoop-mapreduce-client\hadoop-mapreduce-client-app\src\main\java\org\apache\hadoop\mapreduce\v2\app\commit\CommitterJobSetupEvent.java,20,11,0,1,0,12
hadoop-trunk\hadoop-trunk\hadoop-yarn-project\hadoop-yarn\hadoop-yarn-server\hadoop-yarn-server-nodemanager\src\main\java\org\apache\hadoop\yarn\server\nodemanager\webapp\dao\gpu\GpuDeviceInformationParser.java,52,13,0,1,0,14
hadoop-trunk\hadoop-trunk\hadoop-mapreduce-project\hadoop-mapreduce-client\hadoop-mapreduce-client-hs\src\main\java\org\apache\hadoop\mapreduce\v2\hs\webapp\HsTaskPage.java,0,86,0,8,0,94
hadoop-trunk\hadoop-trunk\hadoop-tools\hadoop-aws\src\test\java\org\apache\hadoop\fs\s3a\auth\ITestCustomSigner.java,267,51,5,4,0,60
hadoop-trunk\hadoop-trunk\hadoop-yarn-project\hadoop-yarn\hadoop-yarn-server\hadoop-yarn-server-timelineservice\src\main\java\org\apache\hadoop\yarn\server\timelineservice\storage\common\TimelineEntityFiltersType.java,0,19,0,2,0,21
hadoop-trunk\hadoop-trunk\hadoop-yarn-project\hadoop-yarn\hadoop-yarn-server\hadoop-yarn-server-web-proxy\src\test\java\org\apache\hadoop\yarn\server\webproxy\TestProxyCA.java,573,50,7,1,0,58
hadoop-trunk\hadoop-trunk\hadoop-yarn-project\hadoop-yarn\hadoop-yarn-common\src\main\java\org\apache\hadoop\yarn\nodelabels\store\op\NodeAttributeMirrorOp.java,0,8,3,4,0,15
hadoop-trunk\hadoop-trunk\hadoop-yarn-project\hadoop-yarn\hadoop-yarn-server\hadoop-yarn-server-resourcemanager\src\main\java\org\apache\hadoop\yarn\server\resourcemanager\scheduler\QueueInvalidException.java,9,2,0,1,0,3
hadoop-trunk\hadoop-trunk\hadoop-yarn-project\hadoop-yarn\hadoop-yarn-server\hadoop-yarn-server-resourcemanager\src\test\java\org\apache\hadoop\yarn\server\resourcemanager\webapp\TestRMWebServicesHttpStaticUserPermissions.java,152,18,3,4,0,25
hadoop-trunk\hadoop-trunk\hadoop-hdfs-project\hadoop-hdfs-client\src\main\java\org\apache\hadoop\hdfs\UnknownCipherSuiteException.java,6,2,0,1,0,3
hadoop-trunk\hadoop-trunk\hadoop-tools\hadoop-gridmix\src\main\java\org\apache\hadoop\mapred\gridmix\GridmixRecord.java,0,81,10,1,0,92
hadoop-trunk\hadoop-trunk\hadoop-yarn-project\hadoop-yarn\hadoop-yarn-server\hadoop-yarn-server-nodemanager\src\test\java\org\apache\hadoop\yarn\server\nodemanager\containermanager\logaggregation\TestAppLogAggregatorImpl.java,403,83,15,9,0,107
hadoop-trunk\hadoop-trunk\hadoop-common-project\hadoop-common\src\main\java\org\apache\hadoop\fs\CommonConfigurationKeys.java,438,146,1,8,0,155
hadoop-trunk\hadoop-trunk\hadoop-tools\hadoop-azure\src\test\java\org\apache\hadoop\fs\azurebfs\ITestAzureBlobFileSystemCopy.java,57,11,0,1,0,12
hadoop-trunk\hadoop-trunk\hadoop-tools\hadoop-azure\src\test\java\org\apache\hadoop\fs\azure\metrics\TestRollingWindowAverage.java,20,9,0,1,0,10
hadoop-trunk\hadoop-trunk\hadoop-common-project\hadoop-common\src\main\java\org\apache\hadoop\io\DataOutputBuffer.java,97,47,0,1,0,48
hadoop-trunk\hadoop-trunk\hadoop-hdfs-project\hadoop-hdfs\src\test\java\org\apache\hadoop\hdfs\qjournal\client\TestQuorumJournalManagerUnit.java,311,63,15,19,0,97
hadoop-trunk\hadoop-trunk\hadoop-mapreduce-project\hadoop-mapreduce-client\hadoop-mapreduce-client-app\src\main\java\org\apache\hadoop\mapreduce\v2\app\job\event\JobDiagnosticsUpdateEvent.java,14,6,0,1,0,7
hadoop-trunk\hadoop-trunk\hadoop-yarn-project\hadoop-yarn\hadoop-yarn-server\hadoop-yarn-server-timelineservice\src\main\java\org\apache\hadoop\yarn\server\timelineservice\reader\TimelineReaderContext.java,105,69,0,1,0,70
hadoop-trunk\hadoop-trunk\hadoop-mapreduce-project\hadoop-mapreduce-client\hadoop-mapreduce-client-app\src\main\java\org\apache\hadoop\mapreduce\v2\app\job\event\TaskAttemptContainerLaunchedEvent.java,24,5,0,1,0,6
hadoop-trunk\hadoop-trunk\hadoop-yarn-project\hadoop-yarn\hadoop-yarn-server\hadoop-yarn-server-nodemanager\src\test\java\org\apache\hadoop\yarn\server\nodemanager\TestRPCFactories.java,77,16,0,3,0,19
hadoop-trunk\hadoop-trunk\hadoop-mapreduce-project\hadoop-mapreduce-client\hadoop-mapreduce-client-nativetask\src\main\java\org\apache\hadoop\mapred\nativetask\TaskContext.java,70,50,0,2,0,52
hadoop-trunk\hadoop-trunk\hadoop-hdfs-project\hadoop-hdfs\src\test\java\org\apache\hadoop\hdfs\TestIsMethodSupported.java,141,33,4,7,0,44
hadoop-trunk\hadoop-trunk\hadoop-common-project\hadoop-common\src\main\java\org\apache\hadoop\fs\FileSystemLinkResolver.java,81,10,5,1,0,16
hadoop-trunk\hadoop-trunk\hadoop-yarn-project\hadoop-yarn\hadoop-yarn-server\hadoop-yarn-server-nodemanager\src\main\java\org\apache\hadoop\yarn\server\nodemanager\api\deviceplugin\DevicePluginScheduler.java,0,0,0,1,0,1
hadoop-trunk\hadoop-trunk\hadoop-yarn-project\hadoop-yarn\hadoop-yarn-server\hadoop-yarn-server-timelineservice-hbase\hadoop-yarn-server-timelineservice-hbase-common\src\main\java\org\apache\hadoop\yarn\server\timelineservice\storage\entity\EntityColumnPrefix.java,0,27,0,7,0,34
hadoop-trunk\hadoop-trunk\hadoop-tools\hadoop-aws\src\test\java\org\apache\hadoop\fs\s3a\ITestS3AMiscOperations.java,373,30,2,6,0,38
hadoop-trunk\hadoop-trunk\hadoop-yarn-project\hadoop-yarn\hadoop-yarn-server\hadoop-yarn-server-resourcemanager\src\main\java\org\apache\hadoop\yarn\server\resourcemanager\scheduler\fair\AllocationConfiguration.java,381,116,4,9,0,129
hadoop-trunk\hadoop-trunk\hadoop-hdfs-project\hadoop-hdfs\src\test\java\org\apache\hadoop\hdfs\server\namenode\ha\TestObserverReadProxyProvider.java,381,56,8,2,0,66
hadoop-trunk\hadoop-trunk\hadoop-hdfs-project\hadoop-hdfs-rbf\src\test\java\org\apache\hadoop\fs\contract\router\web\TestRouterWebHDFSContractDelete.java,0,4,0,1,0,5
hadoop-trunk\hadoop-trunk\hadoop-mapreduce-project\hadoop-mapreduce-client\hadoop-mapreduce-client-app\src\main\java\org\apache\hadoop\mapreduce\v2\app\speculate\SimpleExponentialTaskRuntimeEstimator.java,158,6,1,3,0,10
hadoop-trunk\hadoop-trunk\hadoop-tools\hadoop-azure-datalake\src\main\java\org\apache\hadoop\fs\adl\TokenProviderType.java,0,5,0,1,0,6
hadoop-trunk\hadoop-trunk\hadoop-tools\hadoop-azure\src\test\java\org\apache\hadoop\fs\azurebfs\ITestAzureBlobFileSystemCheckAccess.java,0,34,1,12,0,47
hadoop-trunk\hadoop-trunk\hadoop-hdfs-project\hadoop-hdfs\src\main\java\org\apache\hadoop\hdfs\server\namenode\startupprogress\Step.java,114,39,0,1,0,40
hadoop-trunk\hadoop-trunk\hadoop-mapreduce-project\hadoop-mapreduce-client\hadoop-mapreduce-client-jobclient\src\test\java\org\apache\hadoop\hdfs\NNBenchWithoutMR.java,320,91,14,8,0,113
hadoop-trunk\hadoop-trunk\hadoop-mapreduce-project\hadoop-mapreduce-client\hadoop-mapreduce-client-common\src\test\java\org\apache\hadoop\mapred\TestLocalModeWithNewApis.java,111,41,7,1,0,49
hadoop-trunk\hadoop-trunk\hadoop-yarn-project\hadoop-yarn\hadoop-yarn-server\hadoop-yarn-server-timelineservice\src\main\java\org\apache\hadoop\yarn\server\timelineservice\storage\package-info.java,0,0,0,1,0,1
hadoop-trunk\hadoop-trunk\hadoop-mapreduce-project\hadoop-mapreduce-client\hadoop-mapreduce-client-app\src\main\java\org\apache\hadoop\mapreduce\v2\app\webapp\dao\ReduceTaskAttemptInfo.java,58,26,1,1,0,28
hadoop-trunk\hadoop-trunk\hadoop-common-project\hadoop-common\src\test\java\org\apache\hadoop\util\TestDiskCheckerWithDiskIo.java,0,23,12,1,0,36
hadoop-trunk\hadoop-trunk\hadoop-tools\hadoop-gridmix\src\main\java\org\apache\hadoop\mapred\gridmix\ExecutionSummarizer.java,0,79,4,1,0,84
hadoop-trunk\hadoop-trunk\hadoop-hdfs-project\hadoop-hdfs-rbf\src\test\java\org\apache\hadoop\hdfs\server\federation\resolver\TestInitializeMountTableResolver.java,39,5,0,4,0,9
hadoop-trunk\hadoop-trunk\hadoop-common-project\hadoop-common\src\test\java\org\apache\hadoop\metrics2\lib\TestMetricsAnnotations.java,172,85,6,1,0,92
hadoop-trunk\hadoop-trunk\hadoop-tools\hadoop-azure\src\test\java\org\apache\hadoop\fs\azurebfs\ITestFileSystemRegistration.java,79,18,1,7,0,26
hadoop-trunk\hadoop-trunk\hadoop-yarn-project\hadoop-yarn\hadoop-yarn-server\hadoop-yarn-server-common\src\test\java\org\apache\hadoop\yarn\server\federation\policies\router\BaseRouterPoliciesTest.java,0,4,0,4,0,8
hadoop-trunk\hadoop-trunk\hadoop-hdfs-project\hadoop-hdfs-httpfs\src\main\java\org\apache\hadoop\lib\wsrs\InputStreamEntity.java,33,15,1,1,0,17
hadoop-trunk\hadoop-trunk\hadoop-hdfs-project\hadoop-hdfs-rbf\src\main\java\org\apache\hadoop\hdfs\server\federation\router\NameserviceManager.java,0,0,0,7,0,7
hadoop-trunk\hadoop-trunk\hadoop-yarn-project\hadoop-yarn\hadoop-yarn-server\hadoop-yarn-server-resourcemanager\src\test\java\org\apache\hadoop\yarn\server\resourcemanager\webapp\TestRMWebServicesCustomResourceTypesCommons.java,61,9,3,6,0,18
hadoop-trunk\hadoop-trunk\hadoop-tools\hadoop-fs2img\src\main\java\org\apache\hadoop\hdfs\server\namenode\TreeWalk.java,78,13,0,1,0,14
hadoop-trunk\hadoop-trunk\hadoop-common-project\hadoop-common\src\test\java\org\apache\hadoop\util\TestDiskChecker.java,179,64,22,1,0,87
hadoop-trunk\hadoop-trunk\hadoop-hdfs-project\hadoop-hdfs\src\main\java\org\apache\hadoop\hdfs\protocol\RecoveryInProgressException.java,8,3,0,1,0,4
hadoop-trunk\hadoop-trunk\hadoop-yarn-project\hadoop-yarn\hadoop-yarn-server\hadoop-yarn-server-resourcemanager\src\main\java\org\apache\hadoop\yarn\server\resourcemanager\recovery\RMStateStoreStoreReservationEvent.java,32,18,6,1,0,25
hadoop-trunk\hadoop-trunk\hadoop-hdfs-project\hadoop-hdfs\src\test\java\org\apache\hadoop\hdfs\tools\TestWebHDFSStoragePolicyCommands.java,0,1,0,1,0,2
hadoop-trunk\hadoop-trunk\hadoop-common-project\hadoop-common\src\main\java\org\apache\hadoop\fs\FsUrlStreamHandler.java,0,4,0,1,0,5
hadoop-trunk\hadoop-trunk\hadoop-hdfs-project\hadoop-hdfs\src\test\java\org\apache\hadoop\hdfs\server\namenode\TestMetadataVersionOutput.java,56,8,1,2,0,11
hadoop-trunk\hadoop-trunk\hadoop-mapreduce-project\hadoop-mapreduce-client\hadoop-mapreduce-client-jobclient\src\test\java\org\apache\hadoop\mapreduce\security\TestUmbilicalProtocolWithJobToken.java,69,11,2,5,0,18
hadoop-trunk\hadoop-trunk\hadoop-hdfs-project\hadoop-hdfs\src\test\java\org\apache\hadoop\hdfs\TestReadStripedFileWithDecodingDeletedData.java,49,18,1,3,0,22
hadoop-trunk\hadoop-trunk\hadoop-hdfs-project\hadoop-hdfs-client\src\main\java\org\apache\hadoop\hdfs\protocol\SnapshotDiffReport.java,252,102,2,2,0,106
hadoop-trunk\hadoop-trunk\hadoop-tools\hadoop-aws\src\test\java\org\apache\hadoop\mapreduce\filecache\TestS3AResourceScope.java,28,4,0,1,0,5
hadoop-trunk\hadoop-trunk\hadoop-mapreduce-project\hadoop-mapreduce-client\hadoop-mapreduce-client-jobclient\src\test\java\org\apache\hadoop\mapred\TestMiniMRClasspath.java,181,56,21,2,0,79
hadoop-trunk\hadoop-trunk\hadoop-common-project\hadoop-common\src\test\java\org\apache\hadoop\io\TestWritableUtils.java,65,38,0,1,0,39
hadoop-trunk\hadoop-trunk\hadoop-common-project\hadoop-common\src\main\java\org\apache\hadoop\crypto\key\package-info.java,0,0,0,1,0,1
hadoop-trunk\hadoop-trunk\hadoop-hdfs-project\hadoop-hdfs\src\main\java\org\apache\hadoop\hdfs\util\MD5FileUtils.java,146,37,4,1,0,42
hadoop-trunk\hadoop-trunk\hadoop-yarn-project\hadoop-yarn\hadoop-yarn-server\hadoop-yarn-server-nodemanager\src\main\java\org\apache\hadoop\yarn\server\nodemanager\api\protocolrecords\LocalizerStatus.java,0,8,0,1,0,9
hadoop-trunk\hadoop-trunk\hadoop-common-project\hadoop-common\src\main\java\org\apache\hadoop\io\compress\BZip2Codec.java,0,90,8,8,0,106
hadoop-trunk\hadoop-trunk\hadoop-hdfs-project\hadoop-hdfs\src\main\java\org\apache\hadoop\hdfs\server\namenode\sps\package-info.java,0,1,0,1,0,2
hadoop-trunk\hadoop-trunk\hadoop-tools\hadoop-azure\src\test\java\org\apache\hadoop\fs\azurebfs\ITestGetNameSpaceEnabled.java,164,20,4,10,0,34
hadoop-trunk\hadoop-trunk\hadoop-yarn-project\hadoop-yarn\hadoop-yarn-server\hadoop-yarn-server-resourcemanager\src\main\java\org\apache\hadoop\yarn\server\resourcemanager\scheduler\SchedulerNodeReport.java,43,8,0,1,0,9
hadoop-trunk\hadoop-trunk\hadoop-common-project\hadoop-nfs\src\main\java\org\apache\hadoop\nfs\nfs3\response\MKNOD3Response.java,60,27,0,1,0,28
hadoop-trunk\hadoop-trunk\hadoop-mapreduce-project\hadoop-mapreduce-client\hadoop-mapreduce-client-jobclient\src\test\java\org\apache\hadoop\mapred\TestBadRecords.java,238,165,13,1,0,179
hadoop-trunk\hadoop-trunk\hadoop-mapreduce-project\hadoop-mapreduce-client\hadoop-mapreduce-client-jobclient\src\test\java\org\apache\hadoop\mapred\TestInputPath.java,85,21,4,1,0,26
hadoop-trunk\hadoop-trunk\hadoop-common-project\hadoop-registry\src\main\java\org\apache\hadoop\registry\client\exceptions\NoChildrenForEphemeralsException.java,16,10,0,1,0,11
hadoop-trunk\hadoop-trunk\hadoop-mapreduce-project\hadoop-mapreduce-client\hadoop-mapreduce-client-jobclient\src\test\java\org\apache\hadoop\fs\slive\Helper.java,0,21,2,1,0,24
hadoop-trunk\hadoop-trunk\hadoop-common-project\hadoop-common\src\test\java\org\apache\hadoop\fs\FSMainOperationsBaseTest.java,1116,291,41,20,0,352
hadoop-trunk\hadoop-trunk\hadoop-hdfs-project\hadoop-hdfs\src\test\java\org\apache\hadoop\hdfs\server\namenode\TestCommitBlockWithInvalidGenStamp.java,63,15,4,2,0,21
hadoop-trunk\hadoop-trunk\hadoop-hdfs-project\hadoop-hdfs\src\test\java\org\apache\hadoop\hdfs\TestDFSClientRetries.java,0,384,56,36,0,476
hadoop-trunk\hadoop-trunk\hadoop-tools\hadoop-azure-datalake\src\test\java\org\apache\hadoop\fs\adl\TestADLResponseData.java,0,66,0,1,0,67
hadoop-trunk\hadoop-trunk\hadoop-yarn-project\hadoop-yarn\hadoop-yarn-applications\hadoop-yarn-services\hadoop-yarn-services-core\src\main\java\org\apache\hadoop\yarn\service\api\records\PlacementScope.java,0,6,0,1,0,7
hadoop-trunk\hadoop-trunk\hadoop-yarn-project\hadoop-yarn\hadoop-yarn-server\hadoop-yarn-server-resourcemanager\src\main\java\org\apache\hadoop\yarn\server\resourcemanager\scheduler\capacity\allocator\ContainerAllocation.java,78,39,6,3,0,48
hadoop-trunk\hadoop-trunk\hadoop-yarn-project\hadoop-yarn\hadoop-yarn-server\hadoop-yarn-server-resourcemanager\src\main\java\org\apache\hadoop\yarn\server\resourcemanager\scheduler\capacity\WorkflowPriorityMappingsManager.java,188,49,6,1,0,56
hadoop-trunk\hadoop-trunk\hadoop-tools\hadoop-sls\src\main\java\org\apache\hadoop\yarn\sls\AMRunner.java,244,79,11,6,0,96
hadoop-trunk\hadoop-trunk\hadoop-yarn-project\hadoop-yarn\hadoop-yarn-common\src\main\java\org\apache\hadoop\yarn\server\api\protocolrecords\impl\pb\CheckForDecommissioningNodesResponsePBImpl.java,115,28,43,5,0,76
hadoop-trunk\hadoop-trunk\hadoop-yarn-project\hadoop-yarn\hadoop-yarn-server\hadoop-yarn-server-resourcemanager\src\test\java\org\apache\hadoop\yarn\server\resourcemanager\preprocessor\TestQueueProcessor.java,14,4,1,1,0,6
hadoop-trunk\hadoop-trunk\hadoop-hdfs-project\hadoop-hdfs-client\src\main\java\org\apache\hadoop\hdfs\web\oauth2\AccessTokenTimer.java,75,15,0,1,0,16
hadoop-trunk\hadoop-trunk\hadoop-yarn-project\hadoop-yarn\hadoop-yarn-api\src\main\java\org\apache\hadoop\yarn\api\protocolrecords\ContainerUpdateRequest.java,41,4,0,1,0,5
hadoop-trunk\hadoop-trunk\hadoop-common-project\hadoop-common\src\test\java\org\apache\hadoop\util\TestGSet.java,552,213,10,4,0,227
hadoop-trunk\hadoop-trunk\hadoop-yarn-project\hadoop-yarn\hadoop-yarn-applications\hadoop-yarn-applications-catalog\hadoop-yarn-applications-catalog-webapp\src\test\java\org\apache\hadoop\yarn\appcatalog\application\TestAppCatalogSolrClient.java,112,14,2,1,0,17
hadoop-trunk\hadoop-trunk\hadoop-mapreduce-project\hadoop-mapreduce-client\hadoop-mapreduce-client-core\src\main\java\org\apache\hadoop\mapred\JobConf.java,0,604,47,30,0,681
hadoop-trunk\hadoop-trunk\hadoop-yarn-project\hadoop-yarn\hadoop-yarn-server\hadoop-yarn-server-timelineservice-hbase\hadoop-yarn-server-timelineservice-hbase-common\src\main\java\org\apache\hadoop\yarn\server\timelineservice\storage\flow\FlowRunTable.java,0,0,0,1,0,1
hadoop-trunk\hadoop-trunk\hadoop-yarn-project\hadoop-yarn\hadoop-yarn-server\hadoop-yarn-server-nodemanager\src\main\java\org\apache\hadoop\yarn\server\nodemanager\containermanager\scheduler\ContainerScheduler.java,686,101,21,8,0,130
hadoop-trunk\hadoop-trunk\hadoop-tools\hadoop-azure\src\test\java\org\apache\hadoop\fs\azure\integration\AzureTestUtils.java,0,83,17,12,0,112
hadoop-trunk\hadoop-trunk\hadoop-yarn-project\hadoop-yarn\hadoop-yarn-server\hadoop-yarn-server-applicationhistoryservice\src\main\java\org\apache\hadoop\yarn\server\applicationhistoryservice\records\impl\pb\ApplicationFinishDataPBImpl.java,193,42,66,4,0,112
hadoop-trunk\hadoop-trunk\hadoop-yarn-project\hadoop-yarn\hadoop-yarn-server\hadoop-yarn-server-resourcemanager\src\test\java\org\apache\hadoop\yarn\server\resourcemanager\reservation\TestInMemoryPlan.java,1026,305,15,5,0,325
hadoop-trunk\hadoop-trunk\hadoop-common-project\hadoop-common\src\test\java\org\apache\hadoop\test\TestJUnitSetup.java,16,3,0,1,0,4
hadoop-trunk\hadoop-trunk\hadoop-yarn-project\hadoop-yarn\hadoop-yarn-common\src\test\java\org\apache\hadoop\yarn\webapp\view\TestTwoColumnLayout.java,20,5,0,1,0,6
hadoop-trunk\hadoop-trunk\hadoop-yarn-project\hadoop-yarn\hadoop-yarn-server\hadoop-yarn-server-resourcemanager\src\test\java\org\apache\hadoop\yarn\server\resourcemanager\placement\csmappingrule\TestMappingRule.java,119,21,3,1,0,25
hadoop-trunk\hadoop-trunk\hadoop-yarn-project\hadoop-yarn\hadoop-yarn-server\hadoop-yarn-server-resourcemanager\src\test\java\org\apache\hadoop\yarn\server\resourcemanager\ReservationACLsTestBase.java,535,79,7,5,0,91
hadoop-trunk\hadoop-trunk\hadoop-common-project\hadoop-auth\src\main\java\org\apache\hadoop\security\authentication\util\Signer.java,97,14,2,3,0,19
hadoop-trunk\hadoop-trunk\hadoop-tools\hadoop-aws\src\test\java\org\apache\hadoop\fs\s3a\ITestS3AEmptyDirectory.java,58,6,0,1,0,7
hadoop-trunk\hadoop-trunk\hadoop-hdfs-project\hadoop-hdfs\src\test\java\org\apache\hadoop\hdfs\server\datanode\DataNodeTestUtils.java,219,55,2,2,0,59
hadoop-trunk\hadoop-trunk\hadoop-yarn-project\hadoop-yarn\hadoop-yarn-api\src\main\java\org\apache\hadoop\yarn\api\records\ApplicationResourceUsageReport.java,243,24,6,3,0,33
hadoop-trunk\hadoop-trunk\hadoop-common-project\hadoop-common\src\test\java\org\apache\hadoop\io\TestArrayFile.java,189,63,14,4,0,81
hadoop-trunk\hadoop-trunk\hadoop-mapreduce-project\hadoop-mapreduce-client\hadoop-mapreduce-client-core\src\main\java\org\apache\hadoop\mapreduce\lib\aggregate\ValueAggregatorBaseDescriptor.java,0,59,10,2,0,71
hadoop-trunk\hadoop-trunk\hadoop-mapreduce-project\hadoop-mapreduce-client\hadoop-mapreduce-client-core\src\main\java\org\apache\hadoop\mapreduce\lib\output\committer\manifest\stages\JobOrTaskStage.java,4,0,2,1,0,3
hadoop-trunk\hadoop-trunk\hadoop-common-project\hadoop-common\src\main\java\org\apache\hadoop\fs\BlockStoragePolicySpi.java,0,0,0,1,0,1
hadoop-trunk\hadoop-trunk\hadoop-tools\hadoop-azure\src\main\java\org\apache\hadoop\fs\azurebfs\contracts\exceptions\InvalidAbfsRestOperationException.java,13,2,0,2,0,4
hadoop-trunk\hadoop-trunk\hadoop-hdfs-project\hadoop-hdfs-client\src\main\java\org\apache\hadoop\hdfs\web\resources\AclPermissionParam.java,72,16,3,1,0,20
hadoop-trunk\hadoop-trunk\hadoop-tools\hadoop-rumen\src\main\java\org\apache\hadoop\tools\rumen\DefaultInputDemuxer.java,41,9,1,1,0,11
hadoop-trunk\hadoop-trunk\hadoop-yarn-project\hadoop-yarn\hadoop-yarn-server\hadoop-yarn-server-resourcemanager\src\main\java\org\apache\hadoop\yarn\server\resourcemanager\scheduler\constraint\algorithm\CircularIterator.java,0,10,1,2,0,13
hadoop-trunk\hadoop-trunk\hadoop-hdfs-project\hadoop-hdfs\src\test\java\org\apache\hadoop\hdfs\TestGetFileChecksum.java,64,15,1,1,0,17
hadoop-trunk\hadoop-trunk\hadoop-common-project\hadoop-common\src\test\java\org\apache\hadoop\fs\TestFcLocalFsPermission.java,0,2,0,1,0,3
hadoop-trunk\hadoop-trunk\hadoop-common-project\hadoop-common\src\test\java\org\apache\hadoop\fs\contract\localfs\TestLocalFSContractContentSummary.java,8,3,0,2,0,5
hadoop-trunk\hadoop-trunk\hadoop-yarn-project\hadoop-yarn\hadoop-yarn-server\hadoop-yarn-server-applicationhistoryservice\src\test\java\org\apache\hadoop\yarn\server\applicationhistoryservice\TestApplicationHistoryServer.java,178,22,4,6,0,32
hadoop-trunk\hadoop-trunk\hadoop-yarn-project\hadoop-yarn\hadoop-yarn-server\hadoop-yarn-server-timelineservice\src\main\java\org\apache\hadoop\yarn\server\timelineservice\metrics\package-info.java,0,1,0,1,0,2
hadoop-trunk\hadoop-trunk\hadoop-hdfs-project\hadoop-hdfs\src\main\java\org\apache\hadoop\hdfs\tools\offlineImageViewer\DelimitedImageVisitor.java,0,74,13,1,0,88
hadoop-trunk\hadoop-trunk\hadoop-common-project\hadoop-common\src\main\java\org\apache\hadoop\security\token\delegation\AbstractDelegationTokenSecretManager.java,0,199,23,10,0,232
hadoop-trunk\hadoop-trunk\hadoop-tools\hadoop-aws\src\test\java\org\apache\hadoop\fs\s3a\fileContext\ITestS3AFileContextStatistics.java,66,11,1,3,0,15
hadoop-trunk\hadoop-trunk\hadoop-hdfs-project\hadoop-hdfs-rbf\src\test\java\org\apache\hadoop\hdfs\server\federation\router\TestRouterAllResolver.java,353,20,0,8,0,28
hadoop-trunk\hadoop-trunk\hadoop-hdfs-project\hadoop-hdfs\src\main\java\org\apache\hadoop\hdfs\server\diskbalancer\command\ReportCommand.java,190,21,0,5,0,26
hadoop-trunk\hadoop-trunk\hadoop-hdfs-project\hadoop-hdfs\src\test\java\org\apache\hadoop\hdfs\TestFSOutputSummer.java,133,103,2,2,0,107
hadoop-trunk\hadoop-trunk\hadoop-tools\hadoop-aws\src\main\java\org\apache\hadoop\fs\s3a\impl\S3AMultipartUploaderBuilder.java,0,10,0,2,0,12
hadoop-trunk\hadoop-trunk\hadoop-yarn-project\hadoop-yarn\hadoop-yarn-server\hadoop-yarn-server-resourcemanager\src\main\java\org\apache\hadoop\yarn\server\resourcemanager\recovery\RMStateUpdateAppAttemptEvent.java,15,7,0,2,0,9
hadoop-trunk\hadoop-trunk\hadoop-common-project\hadoop-common\src\main\java\org\apache\hadoop\fs\TrashPolicy.java,119,29,3,2,0,34
hadoop-trunk\hadoop-trunk\hadoop-mapreduce-project\hadoop-mapreduce-client\hadoop-mapreduce-client-core\src\main\java\org\apache\hadoop\mapred\lib\MultipleTextOutputFormat.java,0,8,0,1,0,9
hadoop-trunk\hadoop-trunk\hadoop-yarn-project\hadoop-yarn\hadoop-yarn-server\hadoop-yarn-server-nodemanager\src\main\java\org\apache\hadoop\yarn\server\nodemanager\containermanager\scheduler\ContainerSchedulerEventType.java,0,6,0,1,0,7
hadoop-trunk\hadoop-trunk\hadoop-tools\hadoop-aws\src\main\java\org\apache\hadoop\fs\s3a\auth\delegation\S3ADelegationTokens.java,636,10,9,6,0,25
hadoop-trunk\hadoop-trunk\hadoop-tools\hadoop-aws\src\main\java\org\apache\hadoop\fs\s3a\auth\NoAwsCredentialsException.java,41,0,0,1,0,1
hadoop-trunk\hadoop-trunk\hadoop-yarn-project\hadoop-yarn\hadoop-yarn-common\src\main\java\org\apache\hadoop\yarn\api\records\impl\pb\ContainerIdPBImpl.java,69,24,26,1,0,51
hadoop-trunk\hadoop-trunk\hadoop-yarn-project\hadoop-yarn\hadoop-yarn-server\hadoop-yarn-server-resourcemanager\src\main\java\org\apache\hadoop\yarn\server\resourcemanager\blacklist\DisabledBlacklistManager.java,21,6,2,1,0,9
hadoop-trunk\hadoop-trunk\hadoop-yarn-project\hadoop-yarn\hadoop-yarn-api\src\main\java\org\apache\hadoop\yarn\util\constraint\PlacementConstraintParseException.java,7,2,0,1,0,3
hadoop-trunk\hadoop-trunk\hadoop-common-project\hadoop-common\src\test\java\org\apache\hadoop\fs\statistics\IOStatisticAssertions.java,0,14,3,1,0,18
hadoop-trunk\hadoop-trunk\hadoop-yarn-project\hadoop-yarn\hadoop-yarn-common\src\main\java\org\apache\hadoop\yarn\api\records\impl\pb\LocalResourcePBImpl.java,203,52,81,3,0,136
hadoop-trunk\hadoop-trunk\hadoop-hdfs-project\hadoop-hdfs\src\main\java\org\apache\hadoop\hdfs\server\namenode\snapshot\FileDiffList.java,0,46,7,2,0,55
hadoop-trunk\hadoop-trunk\hadoop-mapreduce-project\hadoop-mapreduce-client\hadoop-mapreduce-client-core\src\main\java\org\apache\hadoop\mapreduce\split\JobSplitWriter.java,0,79,4,3,0,86
hadoop-trunk\hadoop-trunk\hadoop-tools\hadoop-azure\src\test\java\org\apache\hadoop\fs\azure\ITestAzureConcurrentOutOfBandIoWithSecureMode.java,0,2,0,2,0,4
hadoop-trunk\hadoop-trunk\hadoop-tools\hadoop-azure\src\test\java\org\apache\hadoop\fs\azurebfs\commit\AbfsCommitTestHelper.java,0,1,0,2,0,3
hadoop-trunk\hadoop-trunk\hadoop-common-project\hadoop-common\src\test\java\org\apache\hadoop\fs\TestDelegateToFileSystem.java,27,6,0,1,0,7
hadoop-trunk\hadoop-trunk\hadoop-yarn-project\hadoop-yarn\hadoop-yarn-server\hadoop-yarn-server-resourcemanager\src\test\java\org\apache\hadoop\yarn\server\resourcemanager\TestContainerResourceUsage.java,395,47,8,7,0,62
hadoop-trunk\hadoop-trunk\hadoop-hdfs-project\hadoop-hdfs-rbf\src\main\java\org\apache\hadoop\hdfs\server\federation\store\records\impl\pb\MountTablePBImpl.java,317,47,102,10,0,159
hadoop-trunk\hadoop-trunk\hadoop-tools\hadoop-rumen\src\main\java\org\apache\hadoop\tools\rumen\MachineNode.java,0,55,2,3,0,60
hadoop-trunk\hadoop-trunk\hadoop-common-project\hadoop-common\src\test\java\org\apache\hadoop\ipc\TestReuseRpcConnections.java,131,6,4,1,0,11
hadoop-trunk\hadoop-trunk\hadoop-tools\hadoop-aws\src\test\java\org\apache\hadoop\fs\s3a\audit\ITestAuditManager.java,88,4,0,7,0,11
hadoop-trunk\hadoop-trunk\hadoop-tools\hadoop-azure\src\test\java\org\apache\hadoop\fs\azure\metrics\AzureMetricsTestUtil.java,0,31,1,10,0,42
hadoop-trunk\hadoop-trunk\hadoop-tools\hadoop-fs2img\src\test\java\org\apache\hadoop\hdfs\server\namenode\TestSingleUGIResolver.java,139,47,8,1,0,56
hadoop-trunk\hadoop-trunk\hadoop-yarn-project\hadoop-yarn\hadoop-yarn-server\hadoop-yarn-server-nodemanager\src\main\java\org\apache\hadoop\yarn\server\nodemanager\containermanager\loghandler\NonAggregatingLogHandler.java,214,42,15,10,0,67
hadoop-trunk\hadoop-trunk\hadoop-yarn-project\hadoop-yarn\hadoop-yarn-server\hadoop-yarn-server-nodemanager\src\main\java\org\apache\hadoop\yarn\server\nodemanager\containermanager\logaggregation\LimitSizeContainerLogAggregationPolicy.java,7,4,0,2,0,6
hadoop-trunk\hadoop-trunk\hadoop-yarn-project\hadoop-yarn\hadoop-yarn-server\hadoop-yarn-server-resourcemanager\src\main\java\org\apache\hadoop\yarn\server\resourcemanager\scheduler\capacity\placement\package-info.java,0,1,0,2,0,3
hadoop-trunk\hadoop-trunk\hadoop-yarn-project\hadoop-yarn\hadoop-yarn-server\hadoop-yarn-server-resourcemanager\src\test\java\org\apache\hadoop\yarn\server\resourcemanager\scheduler\fair\TestSchedulingUpdate.java,98,13,1,4,0,18
hadoop-trunk\hadoop-trunk\hadoop-mapreduce-project\hadoop-mapreduce-client\hadoop-mapreduce-client-app\src\main\java\org\apache\hadoop\mapreduce\v2\app\webapp\dao\JobTaskAttemptCounterInfo.java,29,10,2,2,0,14
hadoop-trunk\hadoop-trunk\hadoop-hdfs-project\hadoop-hdfs-rbf\src\main\java\org\apache\hadoop\hdfs\server\federation\store\protocol\impl\pb\LeaveSafeModeResponsePBImpl.java,0,12,29,5,0,46
hadoop-trunk\hadoop-trunk\hadoop-mapreduce-project\hadoop-mapreduce-client\hadoop-mapreduce-client-app\src\main\java\org\apache\hadoop\mapreduce\v2\app\job\impl\ReduceTaskImpl.java,36,22,0,1,0,23
hadoop-trunk\hadoop-trunk\hadoop-tools\hadoop-dynamometer\hadoop-dynamometer-blockgen\src\main\java\org\apache\hadoop\tools\dynamometer\blockgenerator\GenerateDNBlockInfosReducer.java,0,12,3,1,0,16
hadoop-trunk\hadoop-trunk\hadoop-common-project\hadoop-common\src\main\java\org\apache\hadoop\ipc\RefreshResponse.java,52,22,0,1,0,23
hadoop-trunk\hadoop-trunk\hadoop-common-project\hadoop-nfs\src\main\java\org\apache\hadoop\nfs\nfs3\request\NFS3Request.java,20,6,0,1,0,7
hadoop-trunk\hadoop-trunk\hadoop-yarn-project\hadoop-yarn\hadoop-yarn-server\hadoop-yarn-server-nodemanager\src\test\java\org\apache\hadoop\yarn\server\nodemanager\containermanager\launcher\TestContainerCleanup.java,72,11,2,4,0,17
hadoop-trunk\hadoop-trunk\hadoop-yarn-project\hadoop-yarn\hadoop-yarn-server\hadoop-yarn-server-sharedcachemanager\src\main\java\org\apache\hadoop\yarn\server\sharedcachemanager\CleanerService.java,168,21,4,4,0,29
hadoop-trunk\hadoop-trunk\hadoop-hdfs-project\hadoop-hdfs\src\main\java\org\apache\hadoop\hdfs\HAUtil.java,315,75,6,18,0,99
hadoop-trunk\hadoop-trunk\hadoop-hdfs-project\hadoop-hdfs\src\main\java\org\apache\hadoop\hdfs\server\namenode\FSNDNCacheOp.java,0,36,1,1,0,38
hadoop-trunk\hadoop-trunk\hadoop-hdfs-project\hadoop-hdfs\src\main\java\org\apache\hadoop\hdfs\server\namenode\top\window\RollingWindowManager.java,305,89,5,1,0,95
hadoop-trunk\hadoop-trunk\hadoop-hdfs-project\hadoop-hdfs\src\main\java\org\apache\hadoop\hdfs\server\namenode\ContentSummaryComputationContext.java,181,69,3,2,0,74
hadoop-trunk\hadoop-trunk\hadoop-yarn-project\hadoop-yarn\hadoop-yarn-server\hadoop-yarn-server-resourcemanager\src\main\java\org\apache\hadoop\yarn\server\resourcemanager\scheduler\fair\converter\UnsupportedPropertyException.java,8,2,0,1,0,3
hadoop-trunk\hadoop-trunk\hadoop-mapreduce-project\hadoop-mapreduce-client\hadoop-mapreduce-client-core\src\main\java\org\apache\hadoop\mapreduce\task\reduce\InMemoryMapOutput.java,0,26,2,1,0,29
hadoop-trunk\hadoop-trunk\hadoop-yarn-project\hadoop-yarn\hadoop-yarn-api\src\main\java\org\apache\hadoop\yarn\api\ClientSCMProtocolPB.java,0,0,2,1,0,3
hadoop-trunk\hadoop-trunk\hadoop-common-project\hadoop-common\src\main\java\org\apache\hadoop\jmx\JMXJsonServlet.java,314,125,22,15,0,162
hadoop-trunk\hadoop-trunk\hadoop-common-project\hadoop-common\src\main\java\org\apache\hadoop\security\SaslRpcClient.java,613,99,59,5,0,163
hadoop-trunk\hadoop-trunk\hadoop-common-project\hadoop-common\src\main\java\org\apache\hadoop\metrics2\impl\package-info.java,0,2,0,1,0,3
hadoop-trunk\hadoop-trunk\hadoop-common-project\hadoop-common\src\test\java\org\apache\hadoop\fs\TestListFiles.java,152,38,1,1,0,40
hadoop-trunk\hadoop-trunk\hadoop-hdfs-project\hadoop-hdfs-httpfs\src\main\java\org\apache\hadoop\lib\service\hadoop\FileSystemAccessService.java,366,97,13,36,0,146
hadoop-trunk\hadoop-trunk\hadoop-mapreduce-project\hadoop-mapreduce-client\hadoop-mapreduce-client-core\src\main\java\org\apache\hadoop\mapred\join\JoinRecordReader.java,0,26,3,1,0,30
hadoop-trunk\hadoop-trunk\hadoop-yarn-project\hadoop-yarn\hadoop-yarn-server\hadoop-yarn-server-resourcemanager\src\main\java\org\apache\hadoop\yarn\server\resourcemanager\security\NMTokenSecretManagerInRM.java,237,51,9,2,0,62
hadoop-trunk\hadoop-trunk\hadoop-yarn-project\hadoop-yarn\hadoop-yarn-server\hadoop-yarn-server-nodemanager\src\main\java\org\apache\hadoop\yarn\server\nodemanager\containermanager\localizer\event\LocalizationEventType.java,0,6,0,2,0,8
hadoop-trunk\hadoop-trunk\hadoop-yarn-project\hadoop-yarn\hadoop-yarn-server\hadoop-yarn-server-applicationhistoryservice\src\main\java\org\apache\hadoop\yarn\server\applicationhistoryservice\webapp\AboutPage.java,11,3,0,1,0,4
hadoop-trunk\hadoop-trunk\hadoop-common-project\hadoop-common\src\test\java\org\apache\hadoop\ipc\TestProtoBufRPCCompatibility.java,135,35,35,4,0,74
hadoop-trunk\hadoop-trunk\hadoop-yarn-project\hadoop-yarn\hadoop-yarn-server\hadoop-yarn-server-nodemanager\src\main\java\org\apache\hadoop\yarn\server\nodemanager\containermanager\resourceplugin\DockerCommandPlugin.java,0,2,0,6,0,8
hadoop-trunk\hadoop-trunk\hadoop-common-project\hadoop-common\src\main\java\org\apache\hadoop\ha\ZKFailoverController.java,949,192,32,11,0,235
hadoop-trunk\hadoop-trunk\hadoop-common-project\hadoop-common\src\main\java\org\apache\hadoop\io\WritableComparator.java,0,170,27,2,0,199
hadoop-trunk\hadoop-trunk\hadoop-common-project\hadoop-common\src\main\java\org\apache\hadoop\util\InstrumentedReadLock.java,56,16,0,1,0,17
hadoop-trunk\hadoop-trunk\hadoop-common-project\hadoop-common\src\test\java\org\apache\hadoop\io\compress\TestCodecPool.java,159,28,1,4,0,33
hadoop-trunk\hadoop-trunk\hadoop-mapreduce-project\hadoop-mapreduce-client\hadoop-mapreduce-client-jobclient\src\test\java\org\apache\hadoop\mapreduce\TestTaskContext.java,231,101,8,1,0,110
hadoop-trunk\hadoop-trunk\hadoop-common-project\hadoop-common\src\test\java\org\apache\hadoop\util\TestFindClass.java,189,38,13,1,0,52
hadoop-trunk\hadoop-trunk\hadoop-hdfs-project\hadoop-hdfs\src\test\java\org\apache\hadoop\hdfs\TestModTime.java,185,31,14,3,0,48
hadoop-trunk\hadoop-trunk\hadoop-yarn-project\hadoop-yarn\hadoop-yarn-server\hadoop-yarn-server-sharedcachemanager\src\test\java\org\apache\hadoop\yarn\server\sharedcachemanager\DummyAppChecker.java,14,5,0,2,0,7
hadoop-trunk\hadoop-trunk\hadoop-hdfs-project\hadoop-hdfs\src\test\java\org\apache\hadoop\hdfs\server\namenode\TestAuditLogs.java,318,97,12,13,0,122
hadoop-trunk\hadoop-trunk\hadoop-tools\hadoop-aws\src\test\java\org\apache\hadoop\fs\s3a\ITestS3AConfiguration.java,495,71,72,5,0,148
hadoop-trunk\hadoop-trunk\hadoop-tools\hadoop-aws\src\test\java\org\apache\hadoop\fs\s3a\select\CsvFile.java,0,13,0,1,0,14
hadoop-trunk\hadoop-trunk\hadoop-common-project\hadoop-common\src\main\java\org\apache\hadoop\ipc\RefreshRegistry.java,101,24,2,3,0,29
hadoop-trunk\hadoop-trunk\hadoop-mapreduce-project\hadoop-mapreduce-client\hadoop-mapreduce-client-jobclient\src\test\java\org\apache\hadoop\fs\slive\CreateOp.java,0,17,5,1,0,23
hadoop-trunk\hadoop-trunk\hadoop-tools\hadoop-dynamometer\hadoop-dynamometer-workload\src\main\java\org\apache\hadoop\tools\dynamometer\workloadgenerator\VirtualInputFormat.java,0,7,0,1,0,8
hadoop-trunk\hadoop-trunk\hadoop-yarn-project\hadoop-yarn\hadoop-yarn-applications\hadoop-yarn-services\hadoop-yarn-services-core\src\main\java\org\apache\hadoop\yarn\service\api\records\Resource.java,150,58,4,6,0,68
hadoop-trunk\hadoop-trunk\hadoop-hdfs-project\hadoop-hdfs\src\main\java\org\apache\hadoop\hdfs\server\datanode\fsdataset\impl\MappableBlock.java,0,1,0,1,0,2
hadoop-trunk\hadoop-trunk\hadoop-hdfs-project\hadoop-hdfs-rbf\src\main\java\org\apache\hadoop\hdfs\server\federation\router\RouterFsck.java,114,21,0,4,0,25
hadoop-trunk\hadoop-trunk\hadoop-common-project\hadoop-common\src\test\java\org\apache\hadoop\util\TestTime.java,22,1,0,1,0,2
hadoop-trunk\hadoop-trunk\hadoop-hdfs-project\hadoop-hdfs\src\test\java\org\apache\hadoop\hdfs\tools\TestECAdmin.java,256,62,2,1,0,65
hadoop-trunk\hadoop-trunk\hadoop-common-project\hadoop-common\src\main\java\org\apache\hadoop\service\CompositeService.java,156,24,2,1,0,27
hadoop-trunk\hadoop-trunk\hadoop-yarn-project\hadoop-yarn\hadoop-yarn-server\hadoop-yarn-server-router\src\test\java\org\apache\hadoop\yarn\server\router\clientrm\PassThroughClientRequestInterceptor.java,0,70,0,15,0,85
hadoop-trunk\hadoop-trunk\hadoop-hdfs-project\hadoop-hdfs-httpfs\src\main\java\org\apache\hadoop\lib\wsrs\IntegerParam.java,17,6,0,1,0,7
hadoop-trunk\hadoop-trunk\hadoop-mapreduce-project\hadoop-mapreduce-client\hadoop-mapreduce-client-core\src\test\java\org\apache\hadoop\mapreduce\filecache\TestClientDistributedCacheManager.java,216,37,6,1,0,44
hadoop-trunk\hadoop-trunk\hadoop-common-project\hadoop-common\src\main\java\org\apache\hadoop\crypto\Decryptor.java,0,15,3,1,0,19
hadoop-trunk\hadoop-trunk\hadoop-yarn-project\hadoop-yarn\hadoop-yarn-common\src\main\java\org\apache\hadoop\yarn\api\protocolrecords\impl\pb\GetClusterNodeAttributesResponsePBImpl.java,0,20,36,3,0,59
hadoop-trunk\hadoop-trunk\hadoop-mapreduce-project\hadoop-mapreduce-client\hadoop-mapreduce-client-core\src\test\java\org\apache\hadoop\mapred\lib\TestCombineFileRecordReader.java,0,34,5,4,0,43
hadoop-trunk\hadoop-trunk\hadoop-yarn-project\hadoop-yarn\hadoop-yarn-server\hadoop-yarn-server-resourcemanager\src\main\java\org\apache\hadoop\yarn\server\resourcemanager\scheduler\ConfigurationMutationACLPolicy.java,0,0,0,1,0,1
hadoop-trunk\hadoop-trunk\hadoop-yarn-project\hadoop-yarn\hadoop-yarn-applications\hadoop-yarn-services\hadoop-yarn-services-core\src\main\java\org\apache\hadoop\yarn\service\monitor\ComponentHealthThresholdMonitor.java,119,20,6,1,0,27
hadoop-trunk\hadoop-trunk\hadoop-common-project\hadoop-common\src\main\java\org\apache\hadoop\metrics2\MetricsFilter.java,34,5,0,1,0,6
hadoop-trunk\hadoop-trunk\hadoop-hdfs-project\hadoop-hdfs\src\test\java\org\apache\hadoop\hdfs\TestEncryptionZonesWithHA.java,85,20,4,1,0,25
hadoop-trunk\hadoop-trunk\hadoop-yarn-project\hadoop-yarn\hadoop-yarn-server\hadoop-yarn-server-nodemanager\src\main\java\org\apache\hadoop\yarn\server\nodemanager\containermanager\linux\runtime\docker\DockerCommandExecutor.java,0,35,5,6,0,46
hadoop-trunk\hadoop-trunk\hadoop-hdfs-project\hadoop-hdfs\src\test\java\org\apache\hadoop\hdfs\protocolPB\TestPBHelper.java,917,217,128,28,0,373
hadoop-trunk\hadoop-trunk\hadoop-hdfs-project\hadoop-hdfs-rbf\src\test\java\org\apache\hadoop\hdfs\server\federation\resolver\TestMountTableResolver.java,683,54,0,4,0,58
hadoop-trunk\hadoop-trunk\hadoop-yarn-project\hadoop-yarn\hadoop-yarn-server\hadoop-yarn-server-resourcemanager\src\main\java\org\apache\hadoop\yarn\server\resourcemanager\webapp\dao\ReservationSubmissionRequestInfo.java,41,22,2,1,0,25
hadoop-trunk\hadoop-trunk\hadoop-common-project\hadoop-common\src\main\java\org\apache\hadoop\util\QuickSort.java,0,39,13,1,0,53
hadoop-trunk\hadoop-trunk\hadoop-yarn-project\hadoop-yarn\hadoop-yarn-common\src\main\java\org\apache\hadoop\yarn\webapp\view\LipsumBlock.java,28,3,0,2,0,5
hadoop-trunk\hadoop-trunk\hadoop-hdfs-project\hadoop-hdfs-rbf\src\main\java\org\apache\hadoop\hdfs\server\federation\router\RouterMetrics.java,37,21,0,1,0,22
hadoop-trunk\hadoop-trunk\hadoop-common-project\hadoop-common\src\main\java\org\apache\hadoop\io\erasurecode\rawcoder\XORRawEncoder.java,55,9,2,1,0,12
hadoop-trunk\hadoop-trunk\hadoop-hdfs-project\hadoop-hdfs\src\test\java\org\apache\hadoop\hdfs\ParameterizedTestDFSStripedOutputStreamWithFailure.java,35,12,0,1,0,13
hadoop-trunk\hadoop-trunk\hadoop-mapreduce-project\hadoop-mapreduce-client\hadoop-mapreduce-client-app\src\main\java\org\apache\hadoop\mapreduce\v2\app\job\event\JobStartEvent.java,18,10,0,1,0,11
hadoop-trunk\hadoop-trunk\hadoop-hdfs-project\hadoop-hdfs\src\test\java\org\apache\hadoop\hdfs\server\datanode\fsdataset\impl\TestFsDatasetCache.java,539,185,16,4,0,205
hadoop-trunk\hadoop-trunk\hadoop-hdfs-project\hadoop-hdfs-rbf\src\main\java\org\apache\hadoop\hdfs\server\federation\metrics\NameserviceRPCMetrics.java,85,32,1,2,0,35
hadoop-trunk\hadoop-trunk\hadoop-tools\hadoop-streaming\src\test\java\org\apache\hadoop\streaming\TestStreamingBackground.java,54,27,3,2,0,32
hadoop-trunk\hadoop-trunk\hadoop-hdfs-project\hadoop-hdfs-client\src\test\java\org\apache\hadoop\hdfs\shortcircuit\TestShortCircuitShm.java,73,24,4,2,0,30
hadoop-trunk\hadoop-trunk\hadoop-tools\hadoop-distcp\src\test\java\org\apache\hadoop\tools\util\TestRetriableCommand.java,55,20,2,2,0,24
hadoop-trunk\hadoop-trunk\hadoop-tools\hadoop-openstack\src\test\java\org\apache\hadoop\fs\swift\TestSwiftFileSystemContract.java,0,11,6,2,0,19
hadoop-trunk\hadoop-trunk\hadoop-yarn-project\hadoop-yarn\hadoop-yarn-api\src\main\java\org\apache\hadoop\yarn\api\protocolrecords\NodeUnpublishVolumeRequest.java,20,7,0,1,0,8
hadoop-trunk\hadoop-trunk\hadoop-cloud-storage-project\hadoop-cos\src\test\java\org\apache\hadoop\fs\cosn\contract\TestCosNContractGetFileStatus.java,0,2,0,1,0,3
hadoop-trunk\hadoop-trunk\hadoop-mapreduce-project\hadoop-mapreduce-client\hadoop-mapreduce-client-hs\src\main\java\org\apache\hadoop\mapreduce\v2\hs\webapp\HsView.java,0,57,1,3,0,61
hadoop-trunk\hadoop-trunk\hadoop-yarn-project\hadoop-yarn\hadoop-yarn-client\src\test\java\org\apache\hadoop\yarn\client\api\impl\TestSharedCacheClientImpl.java,136,23,0,4,0,27
hadoop-trunk\hadoop-trunk\hadoop-mapreduce-project\hadoop-mapreduce-client\hadoop-mapreduce-client-core\src\main\java\org\apache\hadoop\mapred\pipes\BinaryProtocol.java,0,96,16,1,0,113
hadoop-trunk\hadoop-trunk\hadoop-yarn-project\hadoop-yarn\hadoop-yarn-server\hadoop-yarn-server-nodemanager\src\main\java\org\apache\hadoop\yarn\server\nodemanager\containermanager\linux\runtime\docker\DockerStopCommand.java,14,6,0,2,0,8
hadoop-trunk\hadoop-trunk\hadoop-yarn-project\hadoop-yarn\hadoop-yarn-server\hadoop-yarn-server-resourcemanager\src\test\java\org\apache\hadoop\yarn\server\resourcemanager\TestRMHAForNodeLabels.java,57,10,0,1,0,11
hadoop-trunk\hadoop-trunk\hadoop-hdfs-project\hadoop-hdfs-client\src\test\java\org\apache\hadoop\hdfs\protocol\TestHdfsFileStatusMethods.java,68,11,0,1,0,12
hadoop-trunk\hadoop-trunk\hadoop-common-project\hadoop-common\src\main\java\org\apache\hadoop\fs\viewfs\ViewFsFileStatus.java,0,15,2,1,0,18
hadoop-trunk\hadoop-trunk\hadoop-mapreduce-project\hadoop-mapreduce-client\hadoop-mapreduce-client-core\src\main\java\org\apache\hadoop\mapred\Utils.java,32,8,0,1,0,9
hadoop-trunk\hadoop-trunk\hadoop-tools\hadoop-rumen\src\main\java\org\apache\hadoop\tools\rumen\RandomSeedGenerator.java,45,30,4,2,0,36
hadoop-trunk\hadoop-trunk\hadoop-yarn-project\hadoop-yarn\hadoop-yarn-server\hadoop-yarn-server-resourcemanager\src\test\java\org\apache\hadoop\yarn\webapp\TestRMWithXFSFilter.java,77,7,2,3,0,12
hadoop-trunk\hadoop-trunk\hadoop-mapreduce-project\hadoop-mapreduce-client\hadoop-mapreduce-client-core\src\main\java\org\apache\hadoop\mapreduce\task\package-info.java,0,1,0,1,0,2
hadoop-trunk\hadoop-trunk\hadoop-yarn-project\hadoop-yarn\hadoop-yarn-common\src\main\java\org\apache\hadoop\yarn\server\api\protocolrecords\impl\pb\RunSharedCacheCleanerTaskResponsePBImpl.java,42,16,24,5,0,45
hadoop-trunk\hadoop-trunk\hadoop-hdfs-project\hadoop-hdfs-rbf\src\main\java\org\apache\hadoop\hdfs\server\federation\router\IsRouterActiveServlet.java,12,2,0,1,0,3
hadoop-trunk\hadoop-trunk\hadoop-yarn-project\hadoop-yarn\hadoop-yarn-server\hadoop-yarn-server-common\src\main\java\org\apache\hadoop\yarn\server\federation\policies\manager\PriorityBroadcastPolicyManager.java,32,9,0,5,0,14
hadoop-trunk\hadoop-trunk\hadoop-mapreduce-project\hadoop-mapreduce-client\hadoop-mapreduce-client-app\src\main\java\org\apache\hadoop\mapred\MapReduceChildJVM.java,157,26,3,3,0,32
hadoop-trunk\hadoop-trunk\hadoop-mapreduce-project\hadoop-mapreduce-client\hadoop-mapreduce-client-core\src\main\java\org\apache\hadoop\mapreduce\lib\output\committer\manifest\stages\package-info.java,0,0,0,1,0,1
hadoop-trunk\hadoop-trunk\hadoop-tools\hadoop-aws\src\test\java\org\apache\hadoop\fs\s3a\statistics\ITestS3AFileSystemStatistic.java,43,2,0,1,0,3
hadoop-trunk\hadoop-trunk\hadoop-yarn-project\hadoop-yarn\hadoop-yarn-server\hadoop-yarn-server-resourcemanager\src\main\java\org\apache\hadoop\yarn\server\resourcemanager\GenericEventTypeMetricsManager.java,0,3,3,1,0,7
hadoop-trunk\hadoop-trunk\hadoop-common-project\hadoop-common\src\test\java\org\apache\hadoop\fs\TestFileUtil.java,1721,242,99,28,0,369
hadoop-trunk\hadoop-trunk\hadoop-yarn-project\hadoop-yarn\hadoop-yarn-common\src\main\java\org\apache\hadoop\yarn\logaggregation\package-info.java,0,1,0,1,0,2
hadoop-trunk\hadoop-trunk\hadoop-hdfs-project\hadoop-hdfs\src\main\java\org\apache\hadoop\hdfs\tools\offlineEditsViewer\StatisticsEditsVisitor.java,82,22,1,1,0,24
hadoop-trunk\hadoop-trunk\hadoop-tools\hadoop-dynamometer\hadoop-dynamometer-workload\src\main\java\org\apache\hadoop\tools\dynamometer\workloadgenerator\audit\package-info.java,0,0,0,1,0,1
hadoop-trunk\hadoop-trunk\hadoop-common-project\hadoop-common\src\main\java\org\apache\hadoop\util\concurrent\HadoopThreadPoolExecutor.java,0,33,0,1,0,34
hadoop-trunk\hadoop-trunk\hadoop-hdfs-project\hadoop-hdfs\src\test\java\org\apache\hadoop\hdfs\server\blockmanagement\TestReconstructStripedBlocksWithRackAwareness.java,312,38,7,2,0,47
hadoop-trunk\hadoop-trunk\hadoop-mapreduce-project\hadoop-mapreduce-client\hadoop-mapreduce-client-app\src\main\java\org\apache\hadoop\mapreduce\v2\app\rm\RMContainerAllocationException.java,9,7,0,1,0,8
hadoop-trunk\hadoop-trunk\hadoop-tools\hadoop-streaming\src\test\java\org\apache\hadoop\streaming\TestStreamReduceNone.java,0,38,14,5,0,57
hadoop-trunk\hadoop-trunk\hadoop-yarn-project\hadoop-yarn\hadoop-yarn-server\hadoop-yarn-server-nodemanager\src\main\java\org\apache\hadoop\yarn\server\nodemanager\containermanager\monitor\ContainerStopMonitoringEvent.java,20,9,0,1,0,10
hadoop-trunk\hadoop-trunk\hadoop-yarn-project\hadoop-yarn\hadoop-yarn-server\hadoop-yarn-server-common\src\main\java\org\apache\hadoop\yarn\server\federation\store\records\UpdateApplicationHomeSubClusterResponse.java,12,1,1,1,0,3
hadoop-trunk\hadoop-trunk\hadoop-hdfs-project\hadoop-hdfs-client\src\main\java\org\apache\hadoop\hdfs\protocol\BlockType.java,0,10,0,1,0,11
hadoop-trunk\hadoop-trunk\hadoop-yarn-project\hadoop-yarn\hadoop-yarn-common\src\main\java\org\apache\hadoop\yarn\server\api\protocolrecords\impl\pb\AddToClusterNodeLabelsRequestPBImpl.java,125,24,42,4,0,70
hadoop-trunk\hadoop-trunk\hadoop-common-project\hadoop-common\src\main\java\org\apache\hadoop\util\CrcComposer.java,151,49,1,1,0,51
hadoop-trunk\hadoop-trunk\hadoop-tools\hadoop-aws\src\main\java\org\apache\hadoop\fs\s3a\commit\magic\MagicCommitTracker.java,129,22,1,2,0,25
hadoop-trunk\hadoop-trunk\hadoop-tools\hadoop-rumen\src\main\java\org\apache\hadoop\tools\rumen\Pair.java,0,6,2,1,0,9
hadoop-trunk\hadoop-trunk\hadoop-mapreduce-project\hadoop-mapreduce-client\hadoop-mapreduce-client-core\src\main\java\org\apache\hadoop\mapreduce\JobPriority.java,0,8,0,1,0,9
hadoop-trunk\hadoop-trunk\hadoop-yarn-project\hadoop-yarn\hadoop-yarn-server\hadoop-yarn-server-common\src\test\java\org\apache\hadoop\yarn\server\federation\policies\amrmproxy\TestRejectAMRMProxyPolicy.java,0,5,2,4,0,11
hadoop-trunk\hadoop-trunk\hadoop-common-project\hadoop-registry\src\test\java\org\apache\hadoop\registry\client\impl\TestCuratorService.java,207,38,4,1,0,43
hadoop-trunk\hadoop-trunk\hadoop-tools\hadoop-aws\src\main\java\org\apache\hadoop\fs\s3a\S3AInstrumentation.java,0,155,11,8,0,174
hadoop-trunk\hadoop-trunk\hadoop-yarn-project\hadoop-yarn\hadoop-yarn-common\src\test\java\org\apache\hadoop\yarn\api\records\impl\pb\TestApplicationSubmissionContextPBImpl.java,39,6,5,2,0,13
hadoop-trunk\hadoop-trunk\hadoop-hdfs-project\hadoop-hdfs-rbf\src\main\java\org\apache\hadoop\hdfs\server\federation\resolver\order\HashResolver.java,98,10,0,1,0,11
hadoop-trunk\hadoop-trunk\hadoop-yarn-project\hadoop-yarn\hadoop-yarn-server\hadoop-yarn-server-resourcemanager\src\main\java\org\apache\hadoop\yarn\server\resourcemanager\webapp\AppsBlockWithMetrics.java,0,1,0,1,0,2
hadoop-trunk\hadoop-trunk\hadoop-common-project\hadoop-nfs\src\test\java\org\apache\hadoop\nfs\TestNfsTime.java,23,9,2,1,0,12
hadoop-trunk\hadoop-trunk\hadoop-hdfs-project\hadoop-hdfs\src\test\java\org\apache\hadoop\hdfs\server\blockmanagement\TestHostFileManager.java,123,19,26,1,0,46
hadoop-trunk\hadoop-trunk\hadoop-common-project\hadoop-common\src\main\java\org\apache\hadoop\metrics2\source\JvmMetrics.java,233,67,5,13,0,85
hadoop-trunk\hadoop-trunk\hadoop-common-project\hadoop-common\src\main\java\org\apache\hadoop\io\compress\PassthroughCodec.java,0,18,7,1,0,26
hadoop-trunk\hadoop-trunk\hadoop-common-project\hadoop-common\src\main\java\org\apache\hadoop\io\MapFile.java,0,409,87,13,0,509
hadoop-trunk\hadoop-trunk\hadoop-common-project\hadoop-common\src\test\java\org\apache\hadoop\ipc\TestIPCServerResponder.java,0,75,14,1,0,90
hadoop-trunk\hadoop-trunk\hadoop-hdfs-project\hadoop-hdfs\src\test\java\org\apache\hadoop\hdfs\server\datanode\TestDataNodeVolumeFailureToleration.java,257,52,3,3,0,58
hadoop-trunk\hadoop-trunk\hadoop-common-project\hadoop-common\src\main\java\org\apache\hadoop\security\token\delegation\web\DelegationTokenAuthenticatedURL.java,418,60,5,7,0,72
hadoop-trunk\hadoop-trunk\hadoop-mapreduce-project\hadoop-mapreduce-client\hadoop-mapreduce-client-core\src\main\java\org\apache\hadoop\mapreduce\security\token\delegation\DelegationTokenSecretManager.java,0,7,0,2,0,9
hadoop-trunk\hadoop-trunk\hadoop-common-project\hadoop-common\src\main\java\org\apache\hadoop\fs\statistics\IOStatisticsAggregator.java,0,0,0,1,0,1
hadoop-trunk\hadoop-trunk\hadoop-tools\hadoop-sls\src\test\java\org\apache\hadoop\yarn\sls\utils\TestSLSUtils.java,112,31,6,1,0,38
hadoop-trunk\hadoop-trunk\hadoop-hdfs-project\hadoop-hdfs\src\main\java\org\apache\hadoop\hdfs\server\blockmanagement\BlockPlacementPolicies.java,33,13,0,1,0,14
hadoop-trunk\hadoop-trunk\hadoop-yarn-project\hadoop-yarn\hadoop-yarn-applications\hadoop-yarn-applications-distributedshell\src\test\java\org\apache\hadoop\yarn\applications\distributedshell\TestDSWithMultipleNodeManager.java,434,37,6,7,0,50
hadoop-trunk\hadoop-trunk\hadoop-yarn-project\hadoop-yarn\hadoop-yarn-server\hadoop-yarn-server-resourcemanager\src\main\java\org\apache\hadoop\yarn\server\resourcemanager\monitor\SchedulingMonitorManager.java,148,27,4,2,0,33
hadoop-trunk\hadoop-trunk\hadoop-yarn-project\hadoop-yarn\hadoop-yarn-server\hadoop-yarn-server-common\src\main\java\org\apache\hadoop\yarn\server\federation\store\records\UpdateApplicationHomeSubClusterRequest.java,36,2,0,1,0,3
hadoop-trunk\hadoop-trunk\hadoop-common-project\hadoop-common\src\main\java\org\apache\hadoop\security\HadoopKerberosName.java,54,11,0,5,0,16
hadoop-trunk\hadoop-trunk\hadoop-common-project\hadoop-common\src\main\java\org\apache\hadoop\util\NativeCodeLoader.java,0,18,1,1,0,20
hadoop-trunk\hadoop-trunk\hadoop-yarn-project\hadoop-yarn\hadoop-yarn-common\src\main\java\org\apache\hadoop\yarn\util\timeline\TimelineUtils.java,193,38,4,1,0,43
hadoop-trunk\hadoop-trunk\hadoop-yarn-project\hadoop-yarn\hadoop-yarn-server\hadoop-yarn-server-nodemanager\src\test\java\org\apache\hadoop\yarn\server\nodemanager\containermanager\linux\resources\fpga\TestFpgaResourceHandlerImpl.java,534,87,37,19,0,143
hadoop-trunk\hadoop-trunk\hadoop-yarn-project\hadoop-yarn\hadoop-yarn-server\hadoop-yarn-server-nodemanager\src\main\java\org\apache\hadoop\yarn\server\nodemanager\containermanager\linux\resources\CGroupsHandler.java,0,27,0,2,0,29
hadoop-trunk\hadoop-trunk\hadoop-common-project\hadoop-common\src\main\java\org\apache\hadoop\fs\statistics\StoreStatisticNames.java,0,10,0,1,0,11
hadoop-trunk\hadoop-trunk\hadoop-yarn-project\hadoop-yarn\hadoop-yarn-server\hadoop-yarn-server-resourcemanager\src\test\java\org\apache\hadoop\yarn\server\resourcemanager\reservation\planning\TestReservationAgents.java,152,53,13,6,0,72
hadoop-trunk\hadoop-trunk\hadoop-hdfs-project\hadoop-hdfs\src\main\java\org\apache\hadoop\hdfs\server\namenode\EditsDoubleBuffer.java,154,52,3,2,0,57
hadoop-trunk\hadoop-trunk\hadoop-yarn-project\hadoop-yarn\hadoop-yarn-server\hadoop-yarn-server-common\src\main\java\org\apache\hadoop\yarn\server\api\records\impl\pb\MasterKeyPBImpl.java,75,23,31,2,0,56
hadoop-trunk\hadoop-trunk\hadoop-yarn-project\hadoop-yarn\hadoop-yarn-server\hadoop-yarn-server-router\src\main\java\org\apache\hadoop\yarn\server\router\webapp\RouterView.java,25,7,1,1,0,9
hadoop-trunk\hadoop-trunk\hadoop-hdfs-project\hadoop-hdfs\src\main\java\org\apache\hadoop\hdfs\server\namenode\INodeAttributeProvider.java,484,231,1,1,0,233
hadoop-trunk\hadoop-trunk\hadoop-mapreduce-project\hadoop-mapreduce-client\hadoop-mapreduce-client-core\src\main\java\org\apache\hadoop\mapred\JobContext.java,0,7,3,1,0,11
hadoop-trunk\hadoop-trunk\hadoop-tools\hadoop-gridmix\src\test\java\org\apache\hadoop\mapred\gridmix\TestFilePool.java,150,36,4,2,0,42
hadoop-trunk\hadoop-trunk\hadoop-yarn-project\hadoop-yarn\hadoop-yarn-server\hadoop-yarn-server-router\src\main\java\org\apache\hadoop\yarn\server\router\webapp\DefaultRequestInterceptorREST.java,0,189,1,14,0,204
hadoop-trunk\hadoop-trunk\hadoop-yarn-project\hadoop-yarn\hadoop-yarn-server\hadoop-yarn-server-resourcemanager\src\test\java\org\apache\hadoop\yarn\server\resourcemanager\reservation\planning\TestGreedyReservationAgent.java,717,310,32,10,0,352
hadoop-trunk\hadoop-trunk\hadoop-hdfs-project\hadoop-hdfs\src\main\java\org\apache\hadoop\hdfs\server\namenode\NameNodeStatusMXBean.java,0,6,5,1,0,12
hadoop-trunk\hadoop-trunk\hadoop-common-project\hadoop-common\src\main\java\org\apache\hadoop\fs\impl\WrappedIOException.java,19,2,0,1,0,3
hadoop-trunk\hadoop-trunk\hadoop-hdfs-project\hadoop-hdfs\src\main\java\org\apache\hadoop\hdfs\util\Canceler.java,25,8,1,1,0,10
hadoop-trunk\hadoop-trunk\hadoop-hdfs-project\hadoop-hdfs\src\test\java\org\apache\hadoop\hdfs\server\datanode\web\webhdfs\TestParameterParser.java,132,11,5,4,0,20
hadoop-trunk\hadoop-trunk\hadoop-hdfs-project\hadoop-hdfs-rbf\src\test\java\org\apache\hadoop\hdfs\server\federation\fairness\TestRouterHandlersFairness.java,211,20,1,2,0,23
hadoop-trunk\hadoop-trunk\hadoop-tools\hadoop-aws\src\main\java\org\apache\hadoop\fs\s3a\impl\DirectoryPolicyImpl.java,0,3,0,9,0,12
hadoop-trunk\hadoop-trunk\hadoop-common-project\hadoop-nfs\src\main\java\org\apache\hadoop\nfs\nfs3\request\COMMIT3Request.java,33,21,0,1,0,22
hadoop-trunk\hadoop-trunk\hadoop-yarn-project\hadoop-yarn\hadoop-yarn-common\src\test\java\org\apache\hadoop\yarn\util\TestProcfsBasedProcessTree.java,932,184,32,6,0,222
hadoop-trunk\hadoop-trunk\hadoop-common-project\hadoop-common\src\test\java\org\apache\hadoop\io\file\tfile\TestTFileUnsortedByteArrays.java,176,39,6,1,0,46
hadoop-trunk\hadoop-trunk\hadoop-yarn-project\hadoop-yarn\hadoop-yarn-server\hadoop-yarn-server-common\src\main\java\org\apache\hadoop\yarn\server\federation\store\records\SubClusterInfo.java,285,26,0,1,0,27
hadoop-trunk\hadoop-trunk\hadoop-hdfs-project\hadoop-hdfs-client\src\main\java\org\apache\hadoop\hdfs\DFSPacket.java,324,81,1,1,0,83
hadoop-trunk\hadoop-trunk\hadoop-hdfs-project\hadoop-hdfs-client\src\main\java\org\apache\hadoop\hdfs\protocol\FsPermissionExtension.java,73,29,2,1,0,32
hadoop-trunk\hadoop-trunk\hadoop-yarn-project\hadoop-yarn\hadoop-yarn-common\src\test\java\org\apache\hadoop\yarn\api\resource\TestPlacementConstraintTransformations.java,127,12,1,10,0,23
hadoop-trunk\hadoop-trunk\hadoop-hdfs-project\hadoop-hdfs\src\main\java\org\apache\hadoop\hdfs\server\datanode\fsdataset\DataNodeVolumeMetrics.java,312,114,0,1,0,115
hadoop-trunk\hadoop-trunk\hadoop-yarn-project\hadoop-yarn\hadoop-yarn-applications\hadoop-yarn-services\hadoop-yarn-services-core\src\main\java\org\apache\hadoop\yarn\service\api\records\ComponentContainers.java,62,16,0,1,0,17
hadoop-trunk\hadoop-trunk\hadoop-common-project\hadoop-common\src\main\java\org\apache\hadoop\io\retry\MultiException.java,23,7,0,1,0,8
hadoop-trunk\hadoop-trunk\hadoop-hdfs-project\hadoop-hdfs\src\main\java\org\apache\hadoop\hdfs\server\datanode\FinalizedProvidedReplica.java,84,44,3,1,0,48
hadoop-trunk\hadoop-trunk\hadoop-hdfs-project\hadoop-hdfs\src\test\java\org\apache\hadoop\hdfs\TestClientReportBadBlock.java,277,65,4,7,0,76
hadoop-trunk\hadoop-trunk\hadoop-yarn-project\hadoop-yarn\hadoop-yarn-server\hadoop-yarn-server-nodemanager\src\test\java\org\apache\hadoop\yarn\server\nodemanager\containermanager\localizer\TestLocalCacheDirectoryManager.java,138,13,1,5,0,19
hadoop-trunk\hadoop-trunk\hadoop-hdfs-project\hadoop-hdfs\src\test\java\org\apache\hadoop\hdfs\server\blockmanagement\TestNodeCount.java,147,57,4,5,0,66
hadoop-trunk\hadoop-trunk\hadoop-mapreduce-project\hadoop-mapreduce-client\hadoop-mapreduce-client-jobclient\src\test\java\org\apache\hadoop\mapreduce\lib\map\TestMultithreadedMapper.java,77,19,0,1,0,20
hadoop-trunk\hadoop-trunk\hadoop-yarn-project\hadoop-yarn\hadoop-yarn-applications\hadoop-yarn-services\hadoop-yarn-services-core\src\main\java\org\apache\hadoop\yarn\service\exceptions\BadCommandArgumentsException.java,11,7,0,1,0,8
hadoop-trunk\hadoop-trunk\hadoop-common-project\hadoop-common\src\test\java\org\apache\hadoop\http\TestHttpServerLifecycle.java,106,17,4,3,0,24
hadoop-trunk\hadoop-trunk\hadoop-mapreduce-project\hadoop-mapreduce-client\hadoop-mapreduce-client-nativetask\src\main\java\org\apache\hadoop\mapred\nativetask\NativeMapOutputCollectorDelegator.java,0,33,4,12,0,49
hadoop-trunk\hadoop-trunk\hadoop-common-project\hadoop-common\src\main\java\org\apache\hadoop\crypto\Encryptor.java,0,12,3,1,0,16
hadoop-trunk\hadoop-trunk\hadoop-yarn-project\hadoop-yarn\hadoop-yarn-server\hadoop-yarn-server-common\src\main\java\org\apache\hadoop\yarn\server\utils\Lock.java,0,6,1,1,0,8
hadoop-trunk\hadoop-trunk\hadoop-hdfs-project\hadoop-hdfs\src\main\java\org\apache\hadoop\hdfs\server\namenode\ContentCounts.java,121,56,2,2,0,60
hadoop-trunk\hadoop-trunk\hadoop-cloud-storage-project\hadoop-huaweicloud\src\main\java\org\apache\hadoop\fs\obs\OBSWriteOperationHelper.java,0,0,1,1,0,2
hadoop-trunk\hadoop-trunk\hadoop-mapreduce-project\hadoop-mapreduce-client\hadoop-mapreduce-client-core\src\main\java\org\apache\hadoop\mapreduce\jobhistory\JobPriorityChangeEvent.java,47,20,14,1,0,35
hadoop-trunk\hadoop-trunk\hadoop-hdfs-project\hadoop-hdfs\src\test\java\org\apache\hadoop\hdfs\server\namenode\TestAddBlockRetry.java,130,16,2,2,0,20
hadoop-trunk\hadoop-trunk\hadoop-hdfs-project\hadoop-hdfs\src\test\java\org\apache\hadoop\hdfs\server\namenode\TestXAttrFeature.java,91,37,11,1,0,49
hadoop-trunk\hadoop-trunk\hadoop-yarn-project\hadoop-yarn\hadoop-yarn-api\src\main\java\org\apache\hadoop\yarn\api\records\LocalResourceType.java,0,5,0,2,0,7
hadoop-trunk\hadoop-trunk\hadoop-hdfs-project\hadoop-hdfs\src\test\java\org\apache\hadoop\hdfs\TestReadStripedFileWithDecodingCorruptData.java,49,18,1,3,0,22
hadoop-trunk\hadoop-trunk\hadoop-maven-plugins\src\main\java\org\apache\hadoop\maven\plugin\versioninfo\VersionInfoMojo.java,235,59,8,3,0,70
hadoop-trunk\hadoop-trunk\hadoop-common-project\hadoop-common\src\test\java\org\apache\hadoop\ipc\TestRetryCacheMetrics.java,30,9,1,1,0,11
hadoop-trunk\hadoop-trunk\hadoop-hdfs-project\hadoop-hdfs-httpfs\src\test\java\org\apache\hadoop\test\TestHdfs.java,0,4,0,5,0,9
hadoop-trunk\hadoop-trunk\hadoop-yarn-project\hadoop-yarn\hadoop-yarn-server\hadoop-yarn-server-nodemanager\src\main\java\org\apache\hadoop\yarn\server\nodemanager\containermanager\localizer\event\ResourceFailedLocalizationEvent.java,15,7,0,3,0,10
hadoop-trunk\hadoop-trunk\hadoop-yarn-project\hadoop-yarn\hadoop-yarn-server\hadoop-yarn-server-applicationhistoryservice\src\test\java\org\apache\hadoop\yarn\server\timeline\TestTimelineDataManager.java,139,16,0,2,0,18
hadoop-trunk\hadoop-trunk\hadoop-yarn-project\hadoop-yarn\hadoop-yarn-server\hadoop-yarn-server-resourcemanager\src\main\java\org\apache\hadoop\yarn\server\resourcemanager\webapp\dao\NodeLabelsInfo.java,54,20,4,1,0,25
hadoop-trunk\hadoop-trunk\hadoop-mapreduce-project\hadoop-mapreduce-client\hadoop-mapreduce-client-hs\src\main\java\org\apache\hadoop\mapreduce\v2\hs\webapp\HsJobPage.java,24,4,0,2,0,6
hadoop-trunk\hadoop-trunk\hadoop-yarn-project\hadoop-yarn\hadoop-yarn-server\hadoop-yarn-server-common\src\main\java\org\apache\hadoop\yarn\server\api\impl\pb\client\ResourceTrackerPBClientImpl.java,0,22,9,19,0,50
hadoop-trunk\hadoop-trunk\hadoop-mapreduce-project\hadoop-mapreduce-client\hadoop-mapreduce-client-core\src\main\java\org\apache\hadoop\mapreduce\lib\aggregate\StringValueMax.java,60,14,1,1,0,16
hadoop-trunk\hadoop-trunk\hadoop-tools\hadoop-azure\src\test\java\org\apache\hadoop\fs\azure\ITestPageBlobInputStream.java,479,71,13,2,0,86
hadoop-trunk\hadoop-trunk\hadoop-tools\hadoop-aws\src\main\java\org\apache\hadoop\fs\s3a\commit\CommitOperations.java,0,53,10,4,0,67
hadoop-trunk\hadoop-trunk\hadoop-yarn-project\hadoop-yarn\hadoop-yarn-server\hadoop-yarn-server-applicationhistoryservice\src\main\java\org\apache\hadoop\yarn\server\timeline\webapp\TimelineWebServices.java,373,106,18,1,0,125
hadoop-trunk\hadoop-trunk\hadoop-yarn-project\hadoop-yarn\hadoop-yarn-server\hadoop-yarn-server-timelineservice-hbase\hadoop-yarn-server-timelineservice-hbase-common\src\test\java\org\apache\hadoop\yarn\server\timelineservice\storage\common\TestCustomApplicationIdConversion.java,11,2,0,1,0,3
hadoop-trunk\hadoop-trunk\hadoop-hdfs-project\hadoop-hdfs-rbf\src\main\java\org\apache\hadoop\hdfs\server\federation\store\protocol\EnterSafeModeResponse.java,22,6,0,2,0,8
hadoop-trunk\hadoop-trunk\hadoop-mapreduce-project\hadoop-mapreduce-client\hadoop-mapreduce-client-jobclient\src\test\java\org\apache\hadoop\fs\IOMapperBase.java,0,57,5,2,0,64
hadoop-trunk\hadoop-trunk\hadoop-yarn-project\hadoop-yarn\hadoop-yarn-server\hadoop-yarn-server-common\src\main\java\org\apache\hadoop\yarn\server\api\ServerRMProxy.java,76,8,0,1,0,9
hadoop-trunk\hadoop-trunk\hadoop-yarn-project\hadoop-yarn\hadoop-yarn-server\hadoop-yarn-server-resourcemanager\src\test\java\org\apache\hadoop\yarn\server\resourcemanager\rmcontainer\TestRMContainerImpl.java,547,52,14,22,0,88
hadoop-trunk\hadoop-trunk\hadoop-hdfs-project\hadoop-hdfs\src\test\java\org\apache\hadoop\hdfs\server\namenode\NameNodeAdapter.java,0,132,15,5,0,152
hadoop-trunk\hadoop-trunk\hadoop-hdfs-project\hadoop-hdfs-client\src\main\java\org\apache\hadoop\hdfs\protocol\CachePoolInfo.java,210,51,4,1,0,56
hadoop-trunk\hadoop-trunk\hadoop-mapreduce-project\hadoop-mapreduce-client\hadoop-mapreduce-client-core\src\main\java\org\apache\hadoop\mapred\JobContextImpl.java,0,19,3,1,0,23
hadoop-trunk\hadoop-trunk\hadoop-tools\hadoop-resourceestimator\src\main\java\org\apache\hadoop\resourceestimator\skylinestore\api\SkylineStore.java,0,0,0,1,0,1
hadoop-trunk\hadoop-trunk\hadoop-common-project\hadoop-common\src\main\java\org\apache\hadoop\ipc\ProtobufHelper.java,101,16,7,1,0,24
hadoop-trunk\hadoop-trunk\hadoop-hdfs-project\hadoop-hdfs\src\main\java\org\apache\hadoop\hdfs\server\datanode\BPServiceActor.java,0,229,58,13,0,300
hadoop-trunk\hadoop-trunk\hadoop-yarn-project\hadoop-yarn\hadoop-yarn-server\hadoop-yarn-server-nodemanager\src\main\java\org\apache\hadoop\yarn\server\nodemanager\containermanager\container\ContainerKillEvent.java,22,12,0,1,0,13
hadoop-trunk\hadoop-trunk\hadoop-yarn-project\hadoop-yarn\hadoop-yarn-server\hadoop-yarn-server-resourcemanager\src\main\java\org\apache\hadoop\yarn\server\resourcemanager\webapp\dao\FairSchedulerLeafQueueInfo.java,22,15,1,3,0,19
hadoop-trunk\hadoop-trunk\hadoop-yarn-project\hadoop-yarn\hadoop-yarn-server\hadoop-yarn-server-resourcemanager\src\test\java\org\apache\hadoop\yarn\server\resourcemanager\TestRMAuditLogger.java,396,124,11,8,0,143
hadoop-trunk\hadoop-trunk\hadoop-mapreduce-project\hadoop-mapreduce-client\hadoop-mapreduce-client-common\src\main\java\org\apache\hadoop\mapreduce\TypeConverter.java,0,120,34,14,0,168
hadoop-trunk\hadoop-trunk\hadoop-yarn-project\hadoop-yarn\hadoop-yarn-server\hadoop-yarn-server-timelineservice\src\test\java\org\apache\hadoop\yarn\server\timelineservice\collector\TestNMTimelineCollectorManager.java,120,13,2,4,0,19
hadoop-trunk\hadoop-trunk\hadoop-common-project\hadoop-common\src\test\java\org\apache\hadoop\io\erasurecode\rawcoder\RawErasureCoderBenchmark.java,0,89,3,1,0,93
hadoop-trunk\hadoop-trunk\hadoop-hdfs-project\hadoop-hdfs\src\test\java\org\apache\hadoop\hdfs\TestFileStatusSerialization.java,134,17,29,2,0,48
hadoop-trunk\hadoop-trunk\hadoop-hdfs-project\hadoop-hdfs\src\main\java\org\apache\hadoop\hdfs\server\common\AutoCloseDataSetLock.java,49,17,2,1,0,20
hadoop-trunk\hadoop-trunk\hadoop-tools\hadoop-azure\src\test\java\org\apache\hadoop\fs\azurebfs\ITestWasbAbfsCompatibility.java,157,25,1,7,0,33
hadoop-trunk\hadoop-trunk\hadoop-hdfs-project\hadoop-hdfs\src\test\java\org\apache\hadoop\hdfs\TestLeaseRecovery.java,546,75,11,7,0,93
hadoop-trunk\hadoop-trunk\hadoop-yarn-project\hadoop-yarn\hadoop-yarn-server\hadoop-yarn-server-timelineservice\src\main\java\org\apache\hadoop\yarn\server\timelineservice\storage\OfflineAggregationWriter.java,33,1,0,3,0,4
hadoop-trunk\hadoop-trunk\hadoop-hdfs-project\hadoop-hdfs\src\test\java\org\apache\hadoop\hdfs\server\namenode\NNThroughputBenchmark.java,1550,620,117,20,0,757
hadoop-trunk\hadoop-trunk\hadoop-common-project\hadoop-common\src\test\java\org\apache\hadoop\security\TestCredentials.java,378,122,17,1,0,140
hadoop-trunk\hadoop-trunk\hadoop-hdfs-project\hadoop-hdfs\src\main\java\org\apache\hadoop\hdfs\server\namenode\AclStorage.java,0,37,0,7,0,44
hadoop-trunk\hadoop-trunk\hadoop-mapreduce-project\hadoop-mapreduce-client\hadoop-mapreduce-client-core\src\main\java\org\apache\hadoop\mapreduce\v2\LogParams.java,48,35,0,1,0,36
hadoop-trunk\hadoop-trunk\hadoop-mapreduce-project\hadoop-mapreduce-client\hadoop-mapreduce-client-jobclient\src\test\java\org\apache\hadoop\mapreduce\RandomTextWriter.java,687,136,6,3,0,145
hadoop-trunk\hadoop-trunk\hadoop-common-project\hadoop-common\src\main\java\org\apache\hadoop\fs\CachingGetSpaceUsed.java,0,35,1,2,0,38
hadoop-trunk\hadoop-trunk\hadoop-hdfs-project\hadoop-hdfs\src\main\java\org\apache\hadoop\hdfs\server\blockmanagement\AvailableSpaceRackFaultTolerantBlockPlacementPolicy.java,0,39,7,19,0,65
hadoop-trunk\hadoop-trunk\hadoop-tools\hadoop-azure\src\test\java\org\apache\hadoop\fs\azurebfs\contract\ITestAbfsFileSystemContractSetTimes.java,26,7,0,2,0,9
hadoop-trunk\hadoop-trunk\hadoop-mapreduce-project\hadoop-mapreduce-client\hadoop-mapreduce-client-app\src\main\java\org\apache\hadoop\mapreduce\v2\app\speculate\TaskSpeculationPredicate.java,13,3,0,1,0,4
hadoop-trunk\hadoop-trunk\hadoop-mapreduce-project\hadoop-mapreduce-client\hadoop-mapreduce-client-jobclient\src\test\java\testjar\ExternalIdentityReducer.java,0,11,6,1,0,18
hadoop-trunk\hadoop-trunk\hadoop-yarn-project\hadoop-yarn\hadoop-yarn-server\hadoop-yarn-server-nodemanager\src\main\java\org\apache\hadoop\yarn\server\nodemanager\containermanager\container\ContainerReInitEvent.java,47,10,0,2,0,12
hadoop-trunk\hadoop-trunk\hadoop-mapreduce-project\hadoop-mapreduce-client\hadoop-mapreduce-client-core\src\main\java\org\apache\hadoop\mapred\JvmContext.java,0,15,0,1,0,16
hadoop-trunk\hadoop-trunk\hadoop-common-project\hadoop-common\src\main\java\org\apache\hadoop\io\erasurecode\coder\ErasureCodingStep.java,0,0,0,1,0,1
hadoop-trunk\hadoop-trunk\hadoop-common-project\hadoop-common\src\test\java\org\apache\hadoop\fs\contract\AbstractContractSeekTest.java,549,84,17,6,0,107
hadoop-trunk\hadoop-trunk\hadoop-tools\hadoop-azure\src\main\java\org\apache\hadoop\fs\azurebfs\services\AbfsListStatusRemoteIterator.java,0,20,1,3,0,24
hadoop-trunk\hadoop-trunk\hadoop-common-project\hadoop-common\src\main\java\org\apache\hadoop\fs\shell\XAttrCommands.java,0,45,1,1,0,47
hadoop-trunk\hadoop-trunk\hadoop-yarn-project\hadoop-yarn\hadoop-yarn-server\hadoop-yarn-server-common\src\main\java\org\apache\hadoop\yarn\server\api\protocolrecords\impl\pb\SCMUploaderCanUploadResponsePBImpl.java,0,16,27,4,0,47
hadoop-trunk\hadoop-trunk\hadoop-hdfs-project\hadoop-hdfs\src\main\java\org\apache\hadoop\hdfs\server\namenode\XAttrFormat.java,0,44,2,1,0,47
hadoop-trunk\hadoop-trunk\hadoop-yarn-project\hadoop-yarn\hadoop-yarn-server\hadoop-yarn-server-resourcemanager\src\test\java\org\apache\hadoop\yarn\server\resourcemanager\scheduler\fair\allocationfile\AllocationFileQueuePlacementRule.java,79,30,0,2,0,32
hadoop-trunk\hadoop-trunk\hadoop-common-project\hadoop-common\src\test\java\org\apache\hadoop\crypto\TestCryptoStreamsNormal.java,106,83,13,1,0,97
hadoop-trunk\hadoop-trunk\hadoop-tools\hadoop-azure\src\test\java\org\apache\hadoop\fs\azurebfs\ITestAbfsStatistics.java,244,10,1,3,0,14
hadoop-trunk\hadoop-trunk\hadoop-tools\hadoop-rumen\src\main\java\org\apache\hadoop\tools\rumen\LoggedNetworkTopology.java,135,41,1,1,0,43
hadoop-trunk\hadoop-trunk\hadoop-hdfs-project\hadoop-hdfs-rbf\src\main\java\org\apache\hadoop\hdfs\server\federation\store\records\DisabledNameservice.java,53,7,1,2,0,10
hadoop-trunk\hadoop-trunk\hadoop-mapreduce-project\hadoop-mapreduce-client\hadoop-mapreduce-client-jobclient\src\test\java\org\apache\hadoop\mapred\EmptyInputFormat.java,0,20,3,1,0,24
hadoop-trunk\hadoop-trunk\hadoop-yarn-project\hadoop-yarn\hadoop-yarn-common\src\main\java\org\apache\hadoop\yarn\logaggregation\ContainerLogMeta.java,30,19,0,1,0,20
hadoop-trunk\hadoop-trunk\hadoop-yarn-project\hadoop-yarn\hadoop-yarn-server\hadoop-yarn-server-resourcemanager\src\main\java\org\apache\hadoop\yarn\server\resourcemanager\ApplicationMasterService.java,457,88,14,18,0,120
hadoop-trunk\hadoop-trunk\hadoop-yarn-project\hadoop-yarn\hadoop-yarn-server\hadoop-yarn-server-common\src\main\java\org\apache\hadoop\yarn\server\federation\store\records\GetApplicationHomeSubClusterResponse.java,35,2,0,1,0,3
hadoop-trunk\hadoop-trunk\hadoop-common-project\hadoop-nfs\src\main\java\org\apache\hadoop\mount\MountEntry.java,38,16,1,1,0,18
hadoop-trunk\hadoop-trunk\hadoop-mapreduce-project\hadoop-mapreduce-client\hadoop-mapreduce-client-common\src\main\java\org\apache\hadoop\mapreduce\v2\api\records\impl\pb\package-info.java,0,1,0,1,0,2
hadoop-trunk\hadoop-trunk\hadoop-yarn-project\hadoop-yarn\hadoop-yarn-common\src\test\java\org\apache\hadoop\yarn\factories\impl\pb\TestRpcClientFactoryPBImpl.java,17,3,1,1,0,5
hadoop-trunk\hadoop-trunk\hadoop-hdfs-project\hadoop-hdfs\src\main\java\org\apache\hadoop\hdfs\server\namenode\FSNamesystemLock.java,0,64,4,11,0,79
hadoop-trunk\hadoop-trunk\hadoop-hdfs-project\hadoop-hdfs\src\test\java\org\apache\hadoop\hdfs\TestHDFSPolicyProvider.java,68,17,8,1,0,26
hadoop-trunk\hadoop-trunk\hadoop-yarn-project\hadoop-yarn\hadoop-yarn-common\src\main\java\org\apache\hadoop\yarn\api\records\impl\pb\UpdateContainerRequestPBImpl.java,158,26,47,1,0,74
hadoop-trunk\hadoop-trunk\hadoop-cloud-storage-project\hadoop-huaweicloud\src\main\java\org\apache\hadoop\fs\obs\FileConflictException.java,0,0,0,1,0,1
hadoop-trunk\hadoop-trunk\hadoop-common-project\hadoop-common\src\main\java\org\apache\hadoop\security\protocolPB\RefreshUserMappingsProtocolClientSideTranslatorPB.java,0,19,9,3,0,31
hadoop-trunk\hadoop-trunk\hadoop-hdfs-project\hadoop-hdfs\src\test\java\org\apache\hadoop\hdfs\web\TestWebHDFS.java,0,312,152,17,0,481
hadoop-trunk\hadoop-trunk\hadoop-common-project\hadoop-common\src\main\java\org\apache\hadoop\util\SysInfoWindows.java,213,33,3,1,0,37
hadoop-trunk\hadoop-trunk\hadoop-tools\hadoop-azure\src\test\java\org\apache\hadoop\fs\azurebfs\utils\TracingHeaderValidator.java,124,55,0,3,0,58
hadoop-trunk\hadoop-trunk\hadoop-hdfs-project\hadoop-hdfs\src\test\java\org\apache\hadoop\hdfs\server\namenode\snapshot\TestRenameWithSnapshots.java,2475,574,137,16,0,727
hadoop-trunk\hadoop-trunk\hadoop-yarn-project\hadoop-yarn\hadoop-yarn-server\hadoop-yarn-server-common\src\main\java\org\apache\hadoop\yarn\server\api\protocolrecords\impl\pb\RegisterDistributedSchedulingAMResponsePBImpl.java,294,43,70,5,0,118
hadoop-trunk\hadoop-trunk\hadoop-yarn-project\hadoop-yarn\hadoop-yarn-server\hadoop-yarn-server-web-proxy\src\main\java\org\apache\hadoop\yarn\server\webproxy\ProxyUtils.java,90,19,4,1,0,24
hadoop-trunk\hadoop-trunk\hadoop-hdfs-project\hadoop-hdfs\src\test\java\org\apache\hadoop\fs\contract\hdfs\TestHDFSContractSeek.java,19,4,0,1,0,5
hadoop-trunk\hadoop-trunk\hadoop-hdfs-project\hadoop-hdfs\src\main\java\org\apache\hadoop\hdfs\server\namenode\INodeFile.java,0,285,15,11,0,311
hadoop-trunk\hadoop-trunk\hadoop-hdfs-project\hadoop-hdfs-client\src\main\java\org\apache\hadoop\hdfs\client\DfsPathCapabilities.java,0,0,0,2,0,2
hadoop-trunk\hadoop-trunk\hadoop-mapreduce-project\hadoop-mapreduce-client\hadoop-mapreduce-client-common\src\main\java\org\apache\hadoop\mapreduce\v2\api\protocolrecords\RenewDelegationTokenResponse.java,0,2,0,1,0,3
hadoop-trunk\hadoop-trunk\hadoop-yarn-project\hadoop-yarn\hadoop-yarn-applications\hadoop-yarn-applications-distributedshell\src\test\java\org\apache\hadoop\yarn\applications\distributedshell\TestDSAppMaster.java,199,29,1,2,0,32
hadoop-trunk\hadoop-trunk\hadoop-yarn-project\hadoop-yarn\hadoop-yarn-server\hadoop-yarn-server-resourcemanager\src\main\java\org\apache\hadoop\yarn\server\resourcemanager\NodesListManagerEvent.java,13,7,0,1,0,8
hadoop-trunk\hadoop-trunk\hadoop-yarn-project\hadoop-yarn\hadoop-yarn-server\hadoop-yarn-server-resourcemanager\src\main\java\org\apache\hadoop\yarn\server\resourcemanager\rmnode\RMNodeSignalContainerEvent.java,16,7,0,1,0,8
hadoop-trunk\hadoop-trunk\hadoop-mapreduce-project\hadoop-mapreduce-client\hadoop-mapreduce-client-core\src\main\java\org\apache\hadoop\mapreduce\task\reduce\InMemoryReader.java,0,51,0,2,0,53
hadoop-trunk\hadoop-trunk\hadoop-yarn-project\hadoop-yarn\hadoop-yarn-server\hadoop-yarn-server-resourcemanager\src\test\java\org\apache\hadoop\yarn\server\resourcemanager\scheduler\constraint\algorithm\TestCircularIterator.java,55,2,1,2,0,5
hadoop-trunk\hadoop-trunk\hadoop-yarn-project\hadoop-yarn\hadoop-yarn-server\hadoop-yarn-server-sharedcachemanager\src\main\java\org\apache\hadoop\yarn\server\sharedcachemanager\RemoteAppChecker.java,61,11,0,2,0,13
hadoop-trunk\hadoop-trunk\hadoop-mapreduce-project\hadoop-mapreduce-client\hadoop-mapreduce-client-jobclient\src\test\java\org\apache\hadoop\mapreduce\lib\db\TestIntegerSplitter.java,0,71,0,4,0,75
hadoop-trunk\hadoop-trunk\hadoop-hdfs-project\hadoop-hdfs\src\test\java\org\apache\hadoop\hdfs\TestFileConcurrentReader.java,408,71,6,1,0,78
hadoop-trunk\hadoop-trunk\hadoop-tools\hadoop-aws\src\test\java\org\apache\hadoop\fs\s3a\TestInvoker.java,399,64,6,3,0,73
hadoop-trunk\hadoop-trunk\hadoop-hdfs-project\hadoop-hdfs-rbf\src\test\java\org\apache\hadoop\fs\contract\router\TestRouterHDFSContractRename.java,18,4,0,1,0,5
hadoop-trunk\hadoop-trunk\hadoop-hdfs-project\hadoop-hdfs\src\test\java\org\apache\hadoop\hdfs\server\diskbalancer\TestConnectors.java,51,8,2,1,0,11
hadoop-trunk\hadoop-trunk\hadoop-tools\hadoop-azure\src\test\java\org\apache\hadoop\fs\azurebfs\services\TestExponentialRetryPolicy.java,81,15,2,11,0,28
hadoop-trunk\hadoop-trunk\hadoop-hdfs-project\hadoop-hdfs\src\test\java\org\apache\hadoop\hdfs\client\impl\TestBlockReaderLocal.java,0,358,27,1,0,386
hadoop-trunk\hadoop-trunk\hadoop-hdfs-project\hadoop-hdfs\src\main\java\org\apache\hadoop\hdfs\server\namenode\SecondaryNameNodeInfoMXBean.java,0,8,6,1,0,15
hadoop-trunk\hadoop-trunk\hadoop-yarn-project\hadoop-yarn\hadoop-yarn-server\hadoop-yarn-server-nodemanager\src\main\java\org\apache\hadoop\yarn\server\nodemanager\containermanager\logaggregation\AppLogAggregatorImpl.java,619,166,22,13,0,201
hadoop-trunk\hadoop-trunk\hadoop-hdfs-project\hadoop-hdfs-httpfs\src\test\java\org\apache\hadoop\lib\servlet\TestServerWebApp.java,69,8,2,3,0,13
hadoop-trunk\hadoop-trunk\hadoop-common-project\hadoop-common\src\main\java\org\apache\hadoop\tracing\TraceScope.java,38,21,5,1,0,27
hadoop-trunk\hadoop-trunk\hadoop-hdfs-project\hadoop-hdfs-httpfs\src\test\java\org\apache\hadoop\fs\http\server\TestHttpFSServerWebServer.java,204,31,1,9,0,41
hadoop-trunk\hadoop-trunk\hadoop-common-project\hadoop-registry\src\main\java\org\apache\hadoop\registry\server\dns\LookupTask.java,16,8,0,1,0,9
hadoop-trunk\hadoop-trunk\hadoop-common-project\hadoop-common\src\main\java\org\apache\hadoop\ipc\RpcException.java,26,5,0,1,0,6
hadoop-trunk\hadoop-trunk\hadoop-cloud-storage-project\hadoop-cos\src\main\java\org\apache\hadoop\fs\cosn\auth\SimpleCredentialsProvider.java,0,6,2,1,0,9
hadoop-trunk\hadoop-trunk\hadoop-yarn-project\hadoop-yarn\hadoop-yarn-server\hadoop-yarn-server-resourcemanager\src\test\java\org\apache\hadoop\yarn\server\resourcemanager\scheduler\capacity\TestCapacitySchedulerConfigValidator.java,583,93,15,28,0,136
hadoop-trunk\hadoop-trunk\hadoop-yarn-project\hadoop-yarn\hadoop-yarn-server\hadoop-yarn-server-resourcemanager\src\test\java\org\apache\hadoop\yarn\server\resourcemanager\webapp\TestRMWebServicesAppAttempts.java,398,47,3,6,0,56
hadoop-trunk\hadoop-trunk\hadoop-common-project\hadoop-common\src\main\java\org\apache\hadoop\util\ServicePlugin.java,0,3,0,1,0,4
hadoop-trunk\hadoop-trunk\hadoop-common-project\hadoop-common\src\main\java\org\apache\hadoop\util\HttpExceptionUtils.java,140,17,7,1,0,25
hadoop-trunk\hadoop-trunk\hadoop-mapreduce-project\hadoop-mapreduce-client\hadoop-mapreduce-client-app\src\main\java\org\apache\hadoop\mapreduce\jobhistory\JobHistoryEvent.java,25,19,0,1,0,20
hadoop-trunk\hadoop-trunk\hadoop-hdfs-project\hadoop-hdfs-client\src\main\java\org\apache\hadoop\hdfs\protocol\BatchedDirectoryListing.java,35,17,0,1,0,18
hadoop-trunk\hadoop-trunk\hadoop-tools\hadoop-azure\src\test\java\org\apache\hadoop\fs\azure\contract\ITestAzureNativeContractMkdir.java,7,2,0,1,0,3
hadoop-trunk\hadoop-trunk\hadoop-yarn-project\hadoop-yarn\hadoop-yarn-server\hadoop-yarn-server-nodemanager\src\test\java\org\apache\hadoop\yarn\server\nodemanager\recovery\NMMemoryStateStoreService.java,586,157,20,10,0,187
hadoop-trunk\hadoop-trunk\hadoop-yarn-project\hadoop-yarn\hadoop-yarn-server\hadoop-yarn-server-nodemanager\src\test\java\org\apache\hadoop\yarn\server\nodemanager\containermanager\scheduler\TestContainerSchedulerOppContainersByResources.java,0,13,1,4,0,18
hadoop-trunk\hadoop-trunk\hadoop-common-project\hadoop-common\src\test\java\org\apache\hadoop\cli\util\CLICommand.java,0,8,4,1,0,13
hadoop-trunk\hadoop-trunk\hadoop-yarn-project\hadoop-yarn\hadoop-yarn-api\src\main\java\org\apache\hadoop\yarn\server\api\SCMAdminProtocolPB.java,0,1,2,2,0,5
hadoop-trunk\hadoop-trunk\hadoop-common-project\hadoop-common\src\test\java\org\apache\hadoop\io\file\tfile\TestTFileByteArrays.java,726,169,55,12,0,236
hadoop-trunk\hadoop-trunk\hadoop-mapreduce-project\hadoop-mapreduce-client\hadoop-mapreduce-client-shuffle\src\main\java\org\apache\hadoop\mapred\FadvisedFileRegion.java,133,69,2,1,0,72
hadoop-trunk\hadoop-trunk\hadoop-tools\hadoop-azure\src\test\java\org\apache\hadoop\fs\azurebfs\ITestAzureBlobFileSystemInitAndCreate.java,21,4,3,3,0,10
hadoop-trunk\hadoop-trunk\hadoop-yarn-project\hadoop-yarn\hadoop-yarn-server\hadoop-yarn-server-resourcemanager\src\main\java\org\apache\hadoop\yarn\server\resourcemanager\RMAppManagerEventType.java,0,2,0,1,0,3
hadoop-trunk\hadoop-trunk\hadoop-yarn-project\hadoop-yarn\hadoop-yarn-server\hadoop-yarn-server-resourcemanager\src\main\java\org\apache\hadoop\yarn\server\resourcemanager\scheduler\MutableConfigurationProvider.java,0,2,0,2,0,4
hadoop-trunk\hadoop-trunk\hadoop-yarn-project\hadoop-yarn\hadoop-yarn-server\hadoop-yarn-server-common\src\main\java\org\apache\hadoop\yarn\server\federation\store\FederationPolicyStore.java,0,0,0,7,0,7
hadoop-trunk\hadoop-trunk\hadoop-yarn-project\hadoop-yarn\hadoop-yarn-server\hadoop-yarn-server-resourcemanager\src\main\java\org\apache\hadoop\yarn\server\resourcemanager\amlauncher\AMLauncher.java,315,44,10,4,0,58
hadoop-trunk\hadoop-trunk\hadoop-yarn-project\hadoop-yarn\hadoop-yarn-server\hadoop-yarn-server-timelineservice-hbase-tests\src\test\java\org\apache\hadoop\yarn\server\timelineservice\storage\flow\TestHBaseStorageFlowRun.java,1010,90,34,17,0,141
hadoop-trunk\hadoop-trunk\hadoop-tools\hadoop-aws\src\main\java\org\apache\hadoop\fs\s3a\statistics\impl\S3AMultipartUploaderStatisticsImpl.java,0,3,1,4,0,8
hadoop-trunk\hadoop-trunk\hadoop-common-project\hadoop-common\src\main\java\org\apache\hadoop\io\erasurecode\coder\RSErasureDecoder.java,34,6,0,2,0,8
hadoop-trunk\hadoop-trunk\hadoop-common-project\hadoop-registry\src\test\java\org\apache\hadoop\registry\client\impl\TestFSRegistryOperationsService.java,257,16,6,1,0,23
hadoop-trunk\hadoop-trunk\hadoop-hdfs-project\hadoop-hdfs-httpfs\src\test\java\org\apache\hadoop\test\KerberosTestUtils.java,103,23,1,2,0,26
hadoop-trunk\hadoop-trunk\hadoop-yarn-project\hadoop-yarn\hadoop-yarn-server\hadoop-yarn-server-nodemanager\src\test\java\org\apache\hadoop\yarn\server\nodemanager\webapp\dao\gpu\TestGpuDeviceInformationParser.java,148,29,0,1,0,30
hadoop-trunk\hadoop-trunk\hadoop-common-project\hadoop-common\src\test\java\org\apache\hadoop\fs\TestFsShellCopy.java,0,150,16,3,0,169
hadoop-trunk\hadoop-trunk\hadoop-yarn-project\hadoop-yarn\hadoop-yarn-server\hadoop-yarn-server-timelineservice-hbase\hadoop-yarn-server-timelineservice-hbase-common\src\main\java\org\apache\hadoop\yarn\server\timelineservice\storage\entity\EntityColumnFamily.java,0,2,0,2,0,4
hadoop-trunk\hadoop-trunk\hadoop-common-project\hadoop-common\src\test\java\org\apache\hadoop\util\TestRunJar.java,248,38,6,3,0,47
hadoop-trunk\hadoop-trunk\hadoop-yarn-project\hadoop-yarn\hadoop-yarn-server\hadoop-yarn-server-sharedcachemanager\src\main\java\org\apache\hadoop\yarn\server\sharedcachemanager\metrics\SharedCacheUploaderMetrics.java,46,19,1,1,0,21
hadoop-trunk\hadoop-trunk\hadoop-hdfs-project\hadoop-hdfs-httpfs\src\main\java\org\apache\hadoop\lib\wsrs\ByteParam.java,17,6,0,1,0,7
hadoop-trunk\hadoop-trunk\hadoop-tools\hadoop-aws\src\main\java\org\apache\hadoop\fs\s3a\AWSClientIOException.java,23,8,0,1,0,9
hadoop-trunk\hadoop-trunk\hadoop-common-project\hadoop-registry\src\test\java\org\apache\hadoop\registry\server\dns\TestRegistryDNS.java,665,76,41,1,0,118
hadoop-trunk\hadoop-trunk\hadoop-yarn-project\hadoop-yarn\hadoop-yarn-server\hadoop-yarn-server-nodemanager\src\test\java\org\apache\hadoop\yarn\server\nodemanager\containermanager\resourceplugin\gpu\TestNvidiaDockerV2CommandPlugin.java,91,10,3,5,0,18
hadoop-trunk\hadoop-trunk\hadoop-mapreduce-project\hadoop-mapreduce-client\hadoop-mapreduce-client-core\src\main\java\org\apache\hadoop\mapreduce\task\reduce\MapOutput.java,0,44,1,1,0,46
hadoop-trunk\hadoop-trunk\hadoop-common-project\hadoop-common\src\main\java\org\apache\hadoop\conf\Configuration.java,0,975,53,64,0,1092
hadoop-trunk\hadoop-trunk\hadoop-yarn-project\hadoop-yarn\hadoop-yarn-server\hadoop-yarn-server-nodemanager\src\main\java\org\apache\hadoop\yarn\server\nodemanager\amrmproxy\AMRMProxyTokenSecretManager.java,296,48,5,3,0,56
hadoop-trunk\hadoop-trunk\hadoop-yarn-project\hadoop-yarn\hadoop-yarn-server\hadoop-yarn-server-resourcemanager\src\main\java\org\apache\hadoop\yarn\server\resourcemanager\reservation\planning\StageAllocator.java,0,1,0,4,0,5
hadoop-trunk\hadoop-trunk\hadoop-hdfs-project\hadoop-hdfs\src\main\java\org\apache\hadoop\hdfs\server\diskbalancer\datamodel\DiskBalancerCluster.java,325,43,5,1,0,49
hadoop-trunk\hadoop-trunk\hadoop-mapreduce-project\hadoop-mapreduce-examples\src\main\java\org\apache\hadoop\examples\BaileyBorweinPlouffe.java,577,203,30,3,0,236
hadoop-trunk\hadoop-trunk\hadoop-common-project\hadoop-common\src\main\java\org\apache\hadoop\fs\store\audit\AuditEntryPoint.java,0,0,0,1,0,1
hadoop-trunk\hadoop-trunk\hadoop-yarn-project\hadoop-yarn\hadoop-yarn-client\src\test\java\org\apache\hadoop\yarn\client\api\impl\TestYarnClientWithReservation.java,443,54,2,6,0,62
hadoop-trunk\hadoop-trunk\hadoop-yarn-project\hadoop-yarn\hadoop-yarn-server\hadoop-yarn-server-common\src\test\java\org\apache\hadoop\yarn\server\federation\policies\manager\TestPriorityBroadcastPolicyManager.java,39,5,0,3,0,8
hadoop-trunk\hadoop-trunk\hadoop-hdfs-project\hadoop-hdfs\src\main\java\org\apache\hadoop\hdfs\server\blockmanagement\BlocksMap.java,0,51,1,2,0,54
hadoop-trunk\hadoop-trunk\hadoop-tools\hadoop-aws\src\test\java\org\apache\hadoop\fs\s3a\ITestS3ATemporaryCredentials.java,378,31,7,8,0,46
hadoop-trunk\hadoop-trunk\hadoop-yarn-project\hadoop-yarn\hadoop-yarn-server\hadoop-yarn-server-resourcemanager\src\main\java\org\apache\hadoop\yarn\server\resourcemanager\scheduler\activities\ActivitiesLogger.java,344,119,5,3,0,127
hadoop-trunk\hadoop-trunk\hadoop-yarn-project\hadoop-yarn\hadoop-yarn-api\src\main\java\org\apache\hadoop\yarn\api\protocolrecords\GetAttributesToNodesRequest.java,35,4,0,1,0,5
hadoop-trunk\hadoop-trunk\hadoop-yarn-project\hadoop-yarn\hadoop-yarn-api\src\main\java\org\apache\hadoop\yarn\api\records\timelineservice\ContainerEntity.java,15,3,0,1,0,4
hadoop-trunk\hadoop-trunk\hadoop-hdfs-project\hadoop-hdfs\src\test\java\org\apache\hadoop\hdfs\server\blockmanagement\TestPendingRecoveryBlocks.java,58,11,1,1,0,13
hadoop-trunk\hadoop-trunk\hadoop-hdfs-project\hadoop-hdfs-client\src\main\java\org\apache\hadoop\hdfs\DFSStripedInputStream.java,496,72,6,2,0,80
hadoop-trunk\hadoop-trunk\hadoop-yarn-project\hadoop-yarn\hadoop-yarn-api\src\main\java\org\apache\hadoop\yarn\api\protocolrecords\StartContainersResponse.java,89,14,0,1,0,15
hadoop-trunk\hadoop-trunk\hadoop-tools\hadoop-streaming\src\main\java\org\apache\hadoop\typedbytes\Type.java,0,21,0,1,0,22
hadoop-trunk\hadoop-trunk\hadoop-common-project\hadoop-common\src\main\java\org\apache\hadoop\io\erasurecode\CodecRegistry.java,0,15,6,2,0,23
hadoop-trunk\hadoop-trunk\hadoop-mapreduce-project\hadoop-mapreduce-client\hadoop-mapreduce-client-shuffle\src\test\java\org\apache\hadoop\mapred\TestFadvisedFileRegion.java,123,62,5,1,0,68
hadoop-trunk\hadoop-trunk\hadoop-common-project\hadoop-common\src\test\java\org\apache\hadoop\ipc\TestRPC.java,0,280,107,9,0,396
hadoop-trunk\hadoop-trunk\hadoop-mapreduce-project\hadoop-mapreduce-client\hadoop-mapreduce-client-app\src\main\java\org\apache\hadoop\mapreduce\v2\app\MRAppMaster.java,1704,401,57,28,0,486
hadoop-trunk\hadoop-trunk\hadoop-tools\hadoop-azure\src\test\java\org\apache\hadoop\fs\azurebfs\ITestAzureBlobFileSystemRename.java,128,12,0,4,0,16
hadoop-trunk\hadoop-trunk\hadoop-tools\hadoop-aws\src\main\java\org\apache\hadoop\fs\s3a\auth\delegation\S3ADtFetcher.java,43,9,0,1,0,10
hadoop-trunk\hadoop-trunk\hadoop-common-project\hadoop-common\src\test\java\org\apache\hadoop\io\RandomDatum.java,96,74,2,1,0,77
hadoop-trunk\hadoop-trunk\hadoop-yarn-project\hadoop-yarn\hadoop-yarn-server\hadoop-yarn-server-resourcemanager\src\main\java\org\apache\hadoop\yarn\server\resourcemanager\timelineservice\RMTimelineCollectorManager.java,60,8,1,4,0,13
hadoop-trunk\hadoop-trunk\hadoop-common-project\hadoop-common\src\test\java\org\apache\hadoop\io\serializer\avro\Record.java,23,12,5,1,0,18
hadoop-trunk\hadoop-trunk\hadoop-yarn-project\hadoop-yarn\hadoop-yarn-common\src\main\java\org\apache\hadoop\yarn\util\MonotonicClock.java,13,0,0,1,0,1
hadoop-trunk\hadoop-trunk\hadoop-yarn-project\hadoop-yarn\hadoop-yarn-common\src\main\java\org\apache\hadoop\yarn\nodelabels\store\op\FSNodeStoreLogOp.java,0,3,0,2,0,5
hadoop-trunk\hadoop-trunk\hadoop-hdfs-project\hadoop-hdfs\src\main\java\org\apache\hadoop\hdfs\server\common\HostRestrictingAuthorizationFilter.java,393,62,21,2,0,85
hadoop-trunk\hadoop-trunk\hadoop-common-project\hadoop-common\src\test\java\org\apache\hadoop\http\TestHttpServerWithSpnego.java,0,23,2,3,0,28
hadoop-trunk\hadoop-trunk\hadoop-yarn-project\hadoop-yarn\hadoop-yarn-server\hadoop-yarn-server-nodemanager\src\main\java\org\apache\hadoop\yarn\server\nodemanager\NodeResourceMonitor.java,0,1,1,1,0,3
hadoop-trunk\hadoop-trunk\hadoop-mapreduce-project\hadoop-mapreduce-client\hadoop-mapreduce-client-core\src\main\java\org\apache\hadoop\mapred\BasicTypeSorterBase.java,0,104,8,2,0,114
hadoop-trunk\hadoop-trunk\hadoop-yarn-project\hadoop-yarn\hadoop-yarn-csi\src\main\java\org\apache\hadoop\yarn\csi\translator\ProtoTranslatorFactory.java,0,2,16,3,0,21
hadoop-trunk\hadoop-trunk\hadoop-hdfs-project\hadoop-hdfs\src\test\java\org\apache\hadoop\hdfs\server\namenode\TestNameNodeHttpServerXFrame.java,77,9,1,1,0,11
hadoop-trunk\hadoop-trunk\hadoop-common-project\hadoop-common\src\main\java\org\apache\hadoop\io\NullWritable.java,0,26,2,2,0,30
hadoop-trunk\hadoop-trunk\hadoop-tools\hadoop-resourceestimator\src\test\java\org\apache\hadoop\resourceestimator\common\serialization\package-info.java,0,0,1,1,0,2
hadoop-trunk\hadoop-trunk\hadoop-tools\hadoop-azure\src\main\java\org\apache\hadoop\fs\azurebfs\utils\TracingHeaderFormat.java,0,3,0,1,0,4
hadoop-trunk\hadoop-trunk\hadoop-yarn-project\hadoop-yarn\hadoop-yarn-server\hadoop-yarn-server-nodemanager\src\main\java\org\apache\hadoop\yarn\server\nodemanager\containermanager\container\ContainerResumeEvent.java,15,7,0,1,0,8
hadoop-trunk\hadoop-trunk\hadoop-common-project\hadoop-common\src\main\java\org\apache\hadoop\fs\shell\Delete.java,0,59,3,4,0,66
hadoop-trunk\hadoop-trunk\hadoop-tools\hadoop-azure\src\main\java\org\apache\hadoop\fs\azurebfs\contracts\services\AbfsPerfLoggable.java,0,0,0,1,0,1
hadoop-trunk\hadoop-trunk\hadoop-hdfs-project\hadoop-hdfs\src\test\java\org\apache\hadoop\test\PathUtils.java,33,19,1,1,0,21
hadoop-trunk\hadoop-trunk\hadoop-yarn-project\hadoop-yarn\hadoop-yarn-server\hadoop-yarn-server-resourcemanager\src\test\java\org\apache\hadoop\yarn\server\resourcemanager\scheduler\capacity\TestCapacitySchedulerLazyPreemption.java,0,74,0,18,0,92
hadoop-trunk\hadoop-trunk\hadoop-common-project\hadoop-common\src\main\java\org\apache\hadoop\conf\Reconfigurable.java,0,7,0,1,0,8
hadoop-trunk\hadoop-trunk\hadoop-hdfs-project\hadoop-hdfs\src\test\java\org\apache\hadoop\hdfs\client\impl\TestBlockReaderRemote.java,62,16,0,1,0,17
hadoop-trunk\hadoop-trunk\hadoop-mapreduce-project\hadoop-mapreduce-client\hadoop-mapreduce-client-app\src\main\java\org\apache\hadoop\mapreduce\v2\app\AppContext.java,0,21,0,1,0,22
hadoop-trunk\hadoop-trunk\hadoop-common-project\hadoop-common\src\test\java\org\apache\hadoop\io\erasurecode\coder\TestHHErasureCoderBase.java,40,5,0,1,0,6
hadoop-trunk\hadoop-trunk\hadoop-hdfs-project\hadoop-hdfs-nfs\src\test\java\org\apache\hadoop\hdfs\nfs\nfs3\TestNfs3HttpServer.java,58,9,0,1,0,10
hadoop-trunk\hadoop-trunk\hadoop-common-project\hadoop-common\src\main\java\org\apache\hadoop\io\compress\DeflateCodec.java,3,0,0,1,0,1
hadoop-trunk\hadoop-trunk\hadoop-common-project\hadoop-common\src\main\java\org\apache\hadoop\io\retry\RetryPolicy.java,0,39,3,1,0,43
hadoop-trunk\hadoop-trunk\hadoop-common-project\hadoop-common\src\test\java\org\apache\hadoop\security\TestNullGroupsMapping.java,34,3,1,1,0,5
hadoop-trunk\hadoop-trunk\hadoop-common-project\hadoop-common\src\main\java\org\apache\hadoop\io\compress\bzip2\CBZip2InputStream.java,1172,251,45,9,0,305
hadoop-trunk\hadoop-trunk\hadoop-common-project\hadoop-common\src\main\java\org\apache\hadoop\fs\DelegateToFileSystem.java,250,97,0,2,0,99
hadoop-trunk\hadoop-trunk\hadoop-common-project\hadoop-common\src\main\java\org\apache\hadoop\fs\shell\PathData.java,552,127,26,3,0,156
hadoop-trunk\hadoop-trunk\hadoop-tools\hadoop-azure\src\main\java\org\apache\hadoop\fs\azurebfs\utils\Listener.java,0,5,0,1,0,6
hadoop-trunk\hadoop-trunk\hadoop-yarn-project\hadoop-yarn\hadoop-yarn-common\src\main\java\org\apache\hadoop\yarn\server\api\protocolrecords\impl\pb\UpdateNodeResourceRequestPBImpl.java,145,46,50,6,0,102
hadoop-trunk\hadoop-trunk\hadoop-yarn-project\hadoop-yarn\hadoop-yarn-server\hadoop-yarn-server-resourcemanager\src\test\java\org\apache\hadoop\yarn\server\resourcemanager\TestClientRMTokens.java,510,134,24,15,0,173
hadoop-trunk\hadoop-trunk\hadoop-common-project\hadoop-common\src\main\java\org\apache\hadoop\io\compress\BlockCompressorStream.java,127,36,4,1,0,41
hadoop-trunk\hadoop-trunk\hadoop-yarn-project\hadoop-yarn\hadoop-yarn-server\hadoop-yarn-server-resourcemanager\src\test\java\org\apache\hadoop\yarn\server\resourcemanager\scheduler\fair\TestFairSchedulerPreemption.java,521,75,9,5,0,89
hadoop-trunk\hadoop-trunk\hadoop-yarn-project\hadoop-yarn\hadoop-yarn-server\hadoop-yarn-server-resourcemanager\src\test\java\org\apache\hadoop\yarn\server\resourcemanager\webapp\helper\AppInfoJsonVerifications.java,0,10,1,3,0,14
hadoop-trunk\hadoop-trunk\hadoop-yarn-project\hadoop-yarn\hadoop-yarn-server\hadoop-yarn-server-timelineservice-hbase\hadoop-yarn-server-timelineservice-hbase-common\src\main\java\org\apache\hadoop\yarn\server\timelineservice\storage\flow\FlowActivityRowKeyPrefix.java,36,5,0,2,0,7
hadoop-trunk\hadoop-trunk\hadoop-common-project\hadoop-common\src\main\java\org\apache\hadoop\service\LifecycleEvent.java,14,5,0,1,0,6
hadoop-trunk\hadoop-trunk\hadoop-hdfs-project\hadoop-hdfs\src\main\java\org\apache\hadoop\hdfs\tools\offlineImageViewer\FileDistributionCalculator.java,0,35,17,1,0,53
hadoop-trunk\hadoop-trunk\hadoop-mapreduce-project\hadoop-mapreduce-client\hadoop-mapreduce-client-jobclient\src\test\java\org\apache\hadoop\mapred\join\IncomparableKey.java,8,8,3,1,0,12
hadoop-trunk\hadoop-trunk\hadoop-common-project\hadoop-common\src\test\java\org\apache\hadoop\fs\viewfs\TestFcCreateMkdirLocalFs.java,0,3,0,1,0,4
hadoop-trunk\hadoop-trunk\hadoop-hdfs-project\hadoop-hdfs\src\main\java\org\apache\hadoop\hdfs\server\namenode\BackupImage.java,357,61,11,6,0,78
hadoop-trunk\hadoop-trunk\hadoop-common-project\hadoop-common\src\main\java\org\apache\hadoop\fs\statistics\IOStatistics.java,0,0,0,1,0,1
hadoop-trunk\hadoop-trunk\hadoop-common-project\hadoop-common\src\test\java\org\apache\hadoop\net\TestStaticMapping.java,207,23,4,2,0,29
hadoop-trunk\hadoop-trunk\hadoop-common-project\hadoop-common\src\main\java\org\apache\hadoop\io\compress\snappy\SnappyDecompressor.java,312,44,6,2,0,52
hadoop-trunk\hadoop-trunk\hadoop-hdfs-project\hadoop-hdfs\src\test\java\org\apache\hadoop\hdfs\server\datanode\SimulatedFSDataset.java,0,378,33,7,0,418
hadoop-trunk\hadoop-trunk\hadoop-common-project\hadoop-common\src\main\java\org\apache\hadoop\security\token\DtFileOperations.java,0,75,8,2,0,85
hadoop-trunk\hadoop-trunk\hadoop-hdfs-project\hadoop-hdfs-rbf\src\main\java\org\apache\hadoop\hdfs\server\federation\router\security\RouterSecurityManager.java,215,33,7,3,0,43
hadoop-trunk\hadoop-trunk\hadoop-tools\hadoop-azure\src\test\java\org\apache\hadoop\fs\azure\contract\ITestAzureNativeContractRename.java,8,2,0,1,0,3
hadoop-trunk\hadoop-trunk\hadoop-tools\hadoop-distcp\src\main\java\org\apache\hadoop\tools\DistCpSync.java,0,83,16,2,0,101
hadoop-trunk\hadoop-trunk\hadoop-yarn-project\hadoop-yarn\hadoop-yarn-server\hadoop-yarn-server-resourcemanager\src\main\java\org\apache\hadoop\yarn\server\resourcemanager\webapp\dao\ReservationUpdateRequestInfo.java,30,15,2,1,0,18
hadoop-trunk\hadoop-trunk\hadoop-common-project\hadoop-common\src\main\java\org\apache\hadoop\ipc\ProtocolInfo.java,0,3,0,1,0,4
hadoop-trunk\hadoop-trunk\hadoop-yarn-project\hadoop-yarn\hadoop-yarn-server\hadoop-yarn-server-timelineservice-documentstore\src\main\java\org\apache\hadoop\yarn\server\timelineservice\documentstore\collection\document\entity\package-info.java,0,0,0,2,0,2
hadoop-trunk\hadoop-trunk\hadoop-hdfs-project\hadoop-hdfs\src\test\java\org\apache\hadoop\hdfs\server\namenode\TestFileLimit.java,181,53,2,3,0,58
hadoop-trunk\hadoop-trunk\hadoop-mapreduce-project\hadoop-mapreduce-examples\src\main\java\org\apache\hadoop\examples\dancing\OneSidedPentomino.java,45,10,1,1,0,12
hadoop-trunk\hadoop-trunk\hadoop-yarn-project\hadoop-yarn\hadoop-yarn-csi\src\main\java\org\apache\hadoop\yarn\csi\translator\NodeUnpublishVolumeRequestProtoTranslator.java,0,4,6,1,0,11
hadoop-trunk\hadoop-trunk\hadoop-yarn-project\hadoop-yarn\hadoop-yarn-client\src\test\java\org\apache\hadoop\yarn\client\api\impl\TestAHSClient.java,361,88,14,6,0,108
hadoop-trunk\hadoop-trunk\hadoop-yarn-project\hadoop-yarn\hadoop-yarn-server\hadoop-yarn-server-common\src\main\java\org\apache\hadoop\yarn\server\federation\store\utils\FederationApplicationHomeSubClusterStoreInputValidator.java,0,7,0,7,0,14
hadoop-trunk\hadoop-trunk\hadoop-hdfs-project\hadoop-hdfs-rbf\src\test\java\org\apache\hadoop\hdfs\server\federation\store\records\TestRouterState.java,56,11,0,2,0,13
hadoop-trunk\hadoop-trunk\hadoop-mapreduce-project\hadoop-mapreduce-client\hadoop-mapreduce-client-jobclient\src\test\java\org\apache\hadoop\mapred\TestClientRedirect.java,606,99,18,36,0,153
hadoop-trunk\hadoop-trunk\hadoop-hdfs-project\hadoop-hdfs\src\test\java\org\apache\hadoop\hdfs\TestSafeMode.java,0,209,11,6,0,226
hadoop-trunk\hadoop-trunk\hadoop-yarn-project\hadoop-yarn\hadoop-yarn-server\hadoop-yarn-server-resourcemanager\src\test\java\org\apache\hadoop\yarn\server\resourcemanager\scheduler\capacity\TestCapacitySchedulerNodeLabelUpdate.java,897,243,12,23,0,278
hadoop-trunk\hadoop-trunk\hadoop-yarn-project\hadoop-yarn\hadoop-yarn-common\src\main\java\org\apache\hadoop\yarn\server\api\impl\pb\service\ResourceManagerAdministrationProtocolPBServiceImpl.java,257,74,91,80,0,245
hadoop-trunk\hadoop-trunk\hadoop-yarn-project\hadoop-yarn\hadoop-yarn-server\hadoop-yarn-server-nodemanager\src\test\java\org\apache\hadoop\yarn\server\nodemanager\containermanager\TestAuxServices.java,892,149,62,11,0,222
hadoop-trunk\hadoop-trunk\hadoop-tools\hadoop-azure\src\main\java\org\apache\hadoop\fs\azure\KeyProvider.java,0,1,0,1,0,2
hadoop-trunk\hadoop-trunk\hadoop-yarn-project\hadoop-yarn\hadoop-yarn-server\hadoop-yarn-server-resourcemanager\src\main\java\org\apache\hadoop\yarn\server\resourcemanager\placement\DefaultPlacementRule.java,72,13,0,5,0,18
hadoop-trunk\hadoop-trunk\hadoop-mapreduce-project\hadoop-mapreduce-client\hadoop-mapreduce-client-jobclient\src\main\java\org\apache\hadoop\mapred\NotRunningJob.java,174,38,4,18,0,60
hadoop-trunk\hadoop-trunk\hadoop-hdfs-project\hadoop-hdfs-client\src\main\java\org\apache\hadoop\hdfs\protocol\QuotaByStorageTypeExceededException.java,29,21,1,4,0,26
hadoop-trunk\hadoop-trunk\hadoop-hdfs-project\hadoop-hdfs-client\src\main\java\org\apache\hadoop\hdfs\server\namenode\ha\ReadOnly.java,0,0,0,1,0,1
hadoop-trunk\hadoop-trunk\hadoop-hdfs-project\hadoop-hdfs-client\src\main\java\org\apache\hadoop\hdfs\util\ECPolicyLoader.java,277,12,7,1,0,20
hadoop-trunk\hadoop-trunk\hadoop-mapreduce-project\hadoop-mapreduce-client\hadoop-mapreduce-client-core\src\test\java\org\apache\hadoop\mapred\TestJobQueueClient.java,25,1,1,1,0,3
hadoop-trunk\hadoop-trunk\hadoop-yarn-project\hadoop-yarn\hadoop-yarn-api\src\main\java\org\apache\hadoop\yarn\api\protocolrecords\UpdateApplicationTimeoutsRequest.java,42,3,0,1,0,4
hadoop-trunk\hadoop-trunk\hadoop-common-project\hadoop-common\src\main\java\org\apache\hadoop\fs\StreamCapabilities.java,0,5,0,1,0,6
hadoop-trunk\hadoop-trunk\hadoop-hdfs-project\hadoop-hdfs\src\test\java\org\apache\hadoop\hdfs\server\namenode\TestCommitBlockSynchronization.java,170,15,6,1,0,22
hadoop-trunk\hadoop-trunk\hadoop-common-project\hadoop-common\src\test\java\org\apache\hadoop\fs\FileContextMainOperationsBaseTest.java,1474,342,206,12,0,560
hadoop-trunk\hadoop-trunk\hadoop-tools\hadoop-rumen\src\main\java\org\apache\hadoop\tools\rumen\CDFRandomGenerator.java,56,25,0,1,0,26
hadoop-trunk\hadoop-trunk\hadoop-yarn-project\hadoop-yarn\hadoop-yarn-common\src\main\java\org\apache\hadoop\yarn\api\records\impl\pb\YarnClusterMetricsPBImpl.java,138,40,59,1,0,100
hadoop-trunk\hadoop-trunk\hadoop-hdfs-project\hadoop-hdfs-client\src\main\java\org\apache\hadoop\hdfs\shortcircuit\DfsClientShmManager.java,448,64,26,6,0,96
hadoop-trunk\hadoop-trunk\hadoop-mapreduce-project\hadoop-mapreduce-client\hadoop-mapreduce-client-common\src\main\java\org\apache\hadoop\mapreduce\v2\api\protocolrecords\impl\pb\KillTaskResponsePBImpl.java,33,19,19,3,0,41
hadoop-trunk\hadoop-trunk\hadoop-hdfs-project\hadoop-hdfs-client\src\main\java\org\apache\hadoop\hdfs\protocol\ZoneReencryptionStatus.java,230,61,6,1,0,68
hadoop-trunk\hadoop-trunk\hadoop-mapreduce-project\hadoop-mapreduce-client\hadoop-mapreduce-client-common\src\main\java\org\apache\hadoop\mapreduce\v2\api\protocolrecords\impl\pb\GetTaskReportResponsePBImpl.java,79,34,33,5,0,72
hadoop-trunk\hadoop-trunk\hadoop-common-project\hadoop-auth\src\main\java\org\apache\hadoop\security\authentication\util\ZKSignerSecretProvider.java,428,57,8,5,0,70
hadoop-trunk\hadoop-trunk\hadoop-yarn-project\hadoop-yarn\hadoop-yarn-common\src\main\java\org\apache\hadoop\yarn\webapp\hamlet2\HamletGen.java,0,93,36,2,0,131
hadoop-trunk\hadoop-trunk\hadoop-yarn-project\hadoop-yarn\dev-support\jdiff\Null.java,4,2,3,1,0,6
hadoop-trunk\hadoop-trunk\hadoop-hdfs-project\hadoop-hdfs\src\test\java\org\apache\hadoop\hdfs\TestFileCreationDelete.java,64,21,3,2,0,26
hadoop-trunk\hadoop-trunk\hadoop-hdfs-project\hadoop-hdfs\src\test\java\org\apache\hadoop\hdfs\server\namenode\ha\TestFailureToReadEdits.java,0,88,7,3,0,98
hadoop-trunk\hadoop-trunk\hadoop-yarn-project\hadoop-yarn\hadoop-yarn-server\hadoop-yarn-server-nodemanager\src\main\java\org\apache\hadoop\yarn\server\nodemanager\containermanager\linux\resources\NetworkTagMappingJsonManager.java,278,96,5,3,0,104
hadoop-trunk\hadoop-trunk\hadoop-yarn-project\hadoop-yarn\hadoop-yarn-common\src\main\java\org\apache\hadoop\yarn\webapp\SubView.java,0,2,0,1,0,3
hadoop-trunk\hadoop-trunk\hadoop-common-project\hadoop-auth\src\main\java\org\apache\hadoop\security\authentication\server\KerberosAuthenticationHandler.java,340,25,5,1,0,31
hadoop-trunk\hadoop-trunk\hadoop-hdfs-project\hadoop-hdfs-client\src\main\java\org\apache\hadoop\hdfs\StatefulStripeReader.java,0,9,0,1,0,10
hadoop-trunk\hadoop-trunk\hadoop-common-project\hadoop-common\src\main\java\org\apache\hadoop\security\alias\KeyStoreProvider.java,46,12,1,1,0,14
hadoop-trunk\hadoop-trunk\hadoop-common-project\hadoop-common\src\test\java\org\apache\hadoop\security\TestRuleBasedLdapGroupsMapping.java,64,3,0,1,0,4
hadoop-trunk\hadoop-trunk\hadoop-hdfs-project\hadoop-hdfs-client\src\main\java\org\apache\hadoop\hdfs\web\resources\BufferSizeParam.java,38,4,0,1,0,5
hadoop-trunk\hadoop-trunk\hadoop-yarn-project\hadoop-yarn\hadoop-yarn-server\hadoop-yarn-server-timelineservice-hbase\hadoop-yarn-server-timelineservice-hbase-server\hadoop-yarn-server-timelineservice-hbase-server-1\src\main\java\org\apache\hadoop\yarn\server\timelineservice\storage\common\package-info.java,0,0,0,1,0,1
hadoop-trunk\hadoop-trunk\hadoop-hdfs-project\hadoop-hdfs\src\main\java\org\apache\hadoop\hdfs\server\namenode\FSImagePreTransactionalStorageInspector.java,0,64,10,3,0,77
hadoop-trunk\hadoop-trunk\hadoop-tools\hadoop-sls\src\main\java\org\apache\hadoop\yarn\sls\AMDefinitionSynth.java,116,32,1,2,0,35
hadoop-trunk\hadoop-trunk\hadoop-hdfs-project\hadoop-hdfs\src\test\java\org\apache\hadoop\hdfs\server\diskbalancer\TestDiskBalancer.java,734,93,14,3,0,110
hadoop-trunk\hadoop-trunk\hadoop-mapreduce-project\hadoop-mapreduce-client\hadoop-mapreduce-client-core\src\main\java\org\apache\hadoop\mapreduce\lib\output\committer\manifest\impl\package-info.java,0,0,0,1,0,1
hadoop-trunk\hadoop-trunk\hadoop-common-project\hadoop-common\src\main\java\org\apache\hadoop\util\curator\package-info.java,0,2,0,1,0,3
hadoop-trunk\hadoop-trunk\hadoop-yarn-project\hadoop-yarn\hadoop-yarn-server\hadoop-yarn-server-nodemanager\src\main\java\org\apache\hadoop\yarn\server\nodemanager\containermanager\deletion\task\DeletionTaskType.java,0,2,0,2,0,4
hadoop-trunk\hadoop-trunk\hadoop-common-project\hadoop-common\src\test\java\org\apache\hadoop\fs\TestLocalFSFileContextCreateMkdir.java,0,0,0,1,0,1
hadoop-trunk\hadoop-trunk\hadoop-mapreduce-project\hadoop-mapreduce-client\hadoop-mapreduce-client-nativetask\src\main\java\org\apache\hadoop\mapred\nativetask\INativeComparable.java,0,1,0,2,0,3
hadoop-trunk\hadoop-trunk\hadoop-yarn-project\hadoop-yarn\hadoop-yarn-server\hadoop-yarn-server-nodemanager\src\main\java\org\apache\hadoop\yarn\server\nodemanager\security\NMTokenSecretManagerInNM.java,260,48,5,4,0,57
hadoop-trunk\hadoop-trunk\hadoop-yarn-project\hadoop-yarn\hadoop-yarn-server\hadoop-yarn-server-resourcemanager\src\test\java\org\apache\hadoop\yarn\server\resourcemanager\TestNodeBlacklistingOnAMFailures.java,406,51,3,8,0,62
hadoop-trunk\hadoop-trunk\hadoop-yarn-project\hadoop-yarn\hadoop-yarn-server\hadoop-yarn-server-resourcemanager\src\test\java\org\apache\hadoop\yarn\server\resourcemanager\placement\TestPlacementRuleFS.java,164,29,2,5,0,36
hadoop-trunk\hadoop-trunk\hadoop-yarn-project\hadoop-yarn\hadoop-yarn-server\hadoop-yarn-server-nodemanager\src\main\java\org\apache\hadoop\yarn\server\nodemanager\executor\ContainerReapContext.java,0,8,2,2,0,12
hadoop-trunk\hadoop-trunk\hadoop-yarn-project\hadoop-yarn\hadoop-yarn-server\hadoop-yarn-server-resourcemanager\src\main\java\org\apache\hadoop\yarn\server\resourcemanager\scheduler\event\SchedulerEventType.java,0,18,0,1,0,19
hadoop-trunk\hadoop-trunk\hadoop-yarn-project\hadoop-yarn\hadoop-yarn-server\hadoop-yarn-server-applicationhistoryservice\src\main\java\org\apache\hadoop\yarn\server\timeline\util\LeveldbUtils.java,181,54,3,4,0,61
hadoop-trunk\hadoop-trunk\hadoop-yarn-project\hadoop-yarn\hadoop-yarn-api\src\main\java\org\apache\hadoop\yarn\api\records\ApplicationTimeoutType.java,0,0,0,1,0,1
hadoop-trunk\hadoop-trunk\hadoop-mapreduce-project\hadoop-mapreduce-client\hadoop-mapreduce-client-app\src\main\java\org\apache\hadoop\mapreduce\v2\app\job\event\TaskAttemptEvent.java,19,6,0,1,0,7
hadoop-trunk\hadoop-trunk\hadoop-mapreduce-project\hadoop-mapreduce-client\hadoop-mapreduce-client-core\src\main\java\org\apache\hadoop\mapreduce\counters\GenericCounter.java,79,36,0,1,0,37
hadoop-trunk\hadoop-trunk\hadoop-tools\hadoop-aws\src\main\java\org\apache\hadoop\fs\s3a\statistics\impl\BondedS3AStatisticsContext.java,166,13,0,1,0,14
hadoop-trunk\hadoop-trunk\hadoop-yarn-project\hadoop-yarn\hadoop-yarn-applications\hadoop-yarn-services\hadoop-yarn-services-core\src\main\java\org\apache\hadoop\yarn\service\monitor\probe\ProbeStatus.java,0,52,3,3,0,58
hadoop-trunk\hadoop-trunk\hadoop-yarn-project\hadoop-yarn\hadoop-yarn-applications\hadoop-yarn-services\hadoop-yarn-services-core\src\main\java\org\apache\hadoop\yarn\service\utils\ServiceUtils.java,0,110,15,6,0,131
hadoop-trunk\hadoop-trunk\hadoop-tools\hadoop-aws\src\test\java\org\apache\hadoop\fs\s3a\scale\ITestS3AHugeFilesEncryption.java,34,5,0,1,0,6
hadoop-trunk\hadoop-trunk\hadoop-common-project\hadoop-registry\src\main\java\org\apache\hadoop\registry\server\dns\BaseServiceRecordProcessor.java,0,59,10,1,0,70
hadoop-trunk\hadoop-trunk\hadoop-yarn-project\hadoop-yarn\hadoop-yarn-server\hadoop-yarn-server-web-proxy\src\test\java\org\apache\hadoop\yarn\server\webproxy\TestWebAppProxyServlet.java,594,103,16,7,0,126
hadoop-trunk\hadoop-trunk\hadoop-common-project\hadoop-registry\src\main\java\org\apache\hadoop\registry\client\api\RegistryConstants.java,0,3,57,1,0,61
hadoop-trunk\hadoop-trunk\hadoop-yarn-project\hadoop-yarn\hadoop-yarn-server\hadoop-yarn-server-resourcemanager\src\test\java\org\apache\hadoop\yarn\server\resourcemanager\HATestUtil.java,16,12,1,1,0,14
hadoop-trunk\hadoop-trunk\hadoop-mapreduce-project\hadoop-mapreduce-client\hadoop-mapreduce-client-nativetask\src\main\java\org\apache\hadoop\mapred\nativetask\serde\NativeSerialization.java,65,22,1,4,0,27
hadoop-trunk\hadoop-trunk\hadoop-mapreduce-project\hadoop-mapreduce-client\hadoop-mapreduce-client-core\src\main\java\org\apache\hadoop\mapred\pipes\PipesPartitioner.java,0,13,1,1,0,15
hadoop-trunk\hadoop-trunk\hadoop-yarn-project\hadoop-yarn\hadoop-yarn-applications\hadoop-yarn-services\hadoop-yarn-services-core\src\main\java\org\apache\hadoop\yarn\service\utils\ApplicationReportSerDeser.java,0,8,0,1,0,9
hadoop-trunk\hadoop-trunk\hadoop-common-project\hadoop-common\src\main\java\org\apache\hadoop\conf\Configured.java,28,10,0,2,0,12
hadoop-trunk\hadoop-trunk\hadoop-common-project\hadoop-common\src\main\java\org\apache\hadoop\metrics2\MetricsSystem.java,113,26,4,1,0,31
hadoop-trunk\hadoop-trunk\hadoop-hdfs-project\hadoop-hdfs-client\src\main\java\org\apache\hadoop\hdfs\client\impl\metrics\BlockReaderIoProvider.java,55,24,2,1,0,27
hadoop-trunk\hadoop-trunk\hadoop-hdfs-project\hadoop-hdfs-httpfs\src\main\java\org\apache\hadoop\lib\lang\RunnableCallable.java,0,10,0,4,0,14
hadoop-trunk\hadoop-trunk\hadoop-yarn-project\hadoop-yarn\hadoop-yarn-server\hadoop-yarn-server-timelineservice-hbase\hadoop-yarn-server-timelineservice-hbase-common\src\main\java\org\apache\hadoop\yarn\server\timelineservice\storage\apptoflow\AppToFlowColumn.java,0,9,1,4,0,14
hadoop-trunk\hadoop-trunk\hadoop-tools\hadoop-aws\src\test\java\org\apache\hadoop\fs\s3a\EncryptionTestUtils.java,0,8,1,1,0,10
hadoop-trunk\hadoop-trunk\hadoop-hdfs-project\hadoop-hdfs-rbf\src\main\java\org\apache\hadoop\hdfs\server\federation\store\protocol\impl\pb\AddMountTableEntryResponsePBImpl.java,0,13,31,4,0,48
hadoop-trunk\hadoop-trunk\hadoop-mapreduce-project\hadoop-mapreduce-client\hadoop-mapreduce-client-core\src\main\java\org\apache\hadoop\mapreduce\security\SpillCallBackPathsFinder.java,154,22,0,1,0,23
hadoop-trunk\hadoop-trunk\hadoop-yarn-project\hadoop-yarn\hadoop-yarn-client\src\test\java\org\apache\hadoop\yarn\client\TestResourceManagerAdministrationProtocolPBClientImpl.java,155,18,5,17,0,40
hadoop-trunk\hadoop-trunk\hadoop-yarn-project\hadoop-yarn\hadoop-yarn-common\src\main\java\org\apache\hadoop\yarn\security\client\YARNDelegationTokenIdentifier.java,84,29,37,4,0,70
hadoop-trunk\hadoop-trunk\hadoop-yarn-project\hadoop-yarn\hadoop-yarn-server\hadoop-yarn-server-common\src\test\java\org\apache\hadoop\yarn\server\webapp\TestLogWebService.java,90,14,0,1,0,15
hadoop-trunk\hadoop-trunk\hadoop-mapreduce-project\hadoop-mapreduce-client\hadoop-mapreduce-client-hs\src\main\java\org\apache\hadoop\mapreduce\v2\hs\protocolPB\HSAdminRefreshProtocolClientSideTranslatorPB.java,0,31,1,5,0,37
hadoop-trunk\hadoop-trunk\hadoop-yarn-project\hadoop-yarn\hadoop-yarn-server\hadoop-yarn-server-nodemanager\src\main\java\org\apache\hadoop\yarn\server\nodemanager\api\deviceplugin\VolumeSpec.java,0,29,1,1,0,31
hadoop-trunk\hadoop-trunk\hadoop-hdfs-project\hadoop-hdfs\src\test\java\org\apache\hadoop\hdfs\TestDFSClientSocketSize.java,77,7,0,2,0,9
hadoop-trunk\hadoop-trunk\hadoop-mapreduce-project\hadoop-mapreduce-client\hadoop-mapreduce-client-core\src\main\java\org\apache\hadoop\mapreduce\counters\AbstractCounter.java,24,8,1,1,0,10
hadoop-trunk\hadoop-trunk\hadoop-yarn-project\hadoop-yarn\hadoop-yarn-api\src\main\java\org\apache\hadoop\yarn\exceptions\InvalidResourceRequestException.java,54,25,0,1,0,26
hadoop-trunk\hadoop-trunk\hadoop-yarn-project\hadoop-yarn\hadoop-yarn-server\hadoop-yarn-server-nodemanager\src\main\java\org\apache\hadoop\yarn\server\nodemanager\containermanager\linux\privileged\PrivilegedOperationException.java,48,34,0,2,0,36
hadoop-trunk\hadoop-trunk\hadoop-yarn-project\hadoop-yarn\hadoop-yarn-applications\hadoop-yarn-services\hadoop-yarn-services-core\src\main\java\org\apache\hadoop\yarn\service\component\ComponentRestartPolicy.java,0,9,0,1,0,10
hadoop-trunk\hadoop-trunk\hadoop-hdfs-project\hadoop-hdfs\src\main\java\org\apache\hadoop\hdfs\server\datanode\DataNodeMXBean.java,0,27,11,1,0,39
hadoop-trunk\hadoop-trunk\hadoop-yarn-project\hadoop-yarn\hadoop-yarn-server\hadoop-yarn-server-nodemanager\src\test\java\org\apache\hadoop\yarn\server\nodemanager\TestNodeStatusUpdaterForAttributes.java,372,42,9,7,0,58
hadoop-trunk\hadoop-trunk\hadoop-hdfs-project\hadoop-hdfs\src\main\java\org\apache\hadoop\hdfs\server\protocol\DatanodeProtocol.java,0,128,26,7,0,161
hadoop-trunk\hadoop-trunk\hadoop-yarn-project\hadoop-yarn\hadoop-yarn-server\hadoop-yarn-server-tests\src\test\java\org\apache\hadoop\yarn\server\TestMiniYARNClusterForHA.java,24,6,3,1,0,10
hadoop-trunk\hadoop-trunk\hadoop-hdfs-project\hadoop-hdfs\src\main\java\org\apache\hadoop\hdfs\server\namenode\startupprogress\StepTracking.java,0,6,1,1,0,8
hadoop-trunk\hadoop-trunk\hadoop-hdfs-project\hadoop-hdfs\src\main\java\org\apache\hadoop\hdfs\server\protocol\BlocksStorageMoveAttemptFinished.java,20,6,0,1,0,7
hadoop-trunk\hadoop-trunk\hadoop-hdfs-project\hadoop-hdfs\src\main\java\org\apache\hadoop\hdfs\server\blockmanagement\BlockPlacementPolicyWithUpgradeDomain.java,263,46,7,1,0,54
hadoop-trunk\hadoop-trunk\hadoop-yarn-project\hadoop-yarn\hadoop-yarn-server\hadoop-yarn-server-resourcemanager\src\main\java\org\apache\hadoop\yarn\server\resourcemanager\rmcontainer\RMContainerEvent.java,14,7,0,1,0,8
hadoop-trunk\hadoop-trunk\hadoop-hdfs-project\hadoop-hdfs\src\test\java\org\apache\hadoop\hdfs\TestHDFSFileSystemContract.java,43,13,0,1,0,14
hadoop-trunk\hadoop-trunk\hadoop-yarn-project\hadoop-yarn\hadoop-yarn-server\hadoop-yarn-server-web-proxy\src\main\java\org\apache\hadoop\yarn\server\webproxy\WebAppProxyServlet.java,630,82,20,2,0,104
hadoop-trunk\hadoop-trunk\hadoop-hdfs-project\hadoop-hdfs\src\main\java\org\apache\hadoop\hdfs\server\protocol\JournalProtocol.java,0,17,4,1,0,22
hadoop-trunk\hadoop-trunk\hadoop-common-project\hadoop-common\src\main\java\org\apache\hadoop\io\erasurecode\rawcoder\InvalidDecodingException.java,0,3,0,1,0,4
hadoop-trunk\hadoop-trunk\hadoop-mapreduce-project\hadoop-mapreduce-examples\src\main\java\org\apache\hadoop\examples\dancing\DistributedPentomino.java,183,78,9,2,0,89
hadoop-trunk\hadoop-trunk\hadoop-mapreduce-project\hadoop-mapreduce-client\hadoop-mapreduce-client-core\src\main\java\org\apache\hadoop\mapreduce\lib\join\ArrayListBackedIterator.java,0,27,2,1,0,30
hadoop-trunk\hadoop-trunk\hadoop-hdfs-project\hadoop-hdfs-client\src\main\java\org\apache\hadoop\hdfs\DistributedFileSystem.java,0,458,17,20,0,495
hadoop-trunk\hadoop-trunk\hadoop-yarn-project\hadoop-yarn\hadoop-yarn-server\hadoop-yarn-server-nodemanager\src\main\java\org\apache\hadoop\yarn\server\nodemanager\containermanager\resourceplugin\fpga\FpgaNodeResourceUpdateHandler.java,39,8,0,3,0,11
hadoop-trunk\hadoop-trunk\hadoop-common-project\hadoop-common\src\main\java\org\apache\hadoop\ipc\ProtobufRpcEngine2.java,612,163,26,2,0,191
hadoop-trunk\hadoop-trunk\hadoop-yarn-project\hadoop-yarn\hadoop-yarn-api\src\main\java\org\apache\hadoop\yarn\api\protocolrecords\GetContainerReportResponse.java,25,6,0,1,0,7
hadoop-trunk\hadoop-trunk\hadoop-hdfs-project\hadoop-hdfs\src\main\java\org\apache\hadoop\hdfs\server\namenode\BackupJournalManager.java,0,32,5,1,0,38
hadoop-trunk\hadoop-trunk\hadoop-yarn-project\hadoop-yarn\hadoop-yarn-client\src\main\java\org\apache\hadoop\yarn\client\cli\QueueCLI.java,133,18,3,1,0,22
hadoop-trunk\hadoop-trunk\hadoop-yarn-project\hadoop-yarn\hadoop-yarn-server\hadoop-yarn-server-resourcemanager\src\main\java\org\apache\hadoop\yarn\server\resourcemanager\scheduler\distributed\CentralizedOpportunisticContainerAllocator.java,289,74,6,1,0,81
hadoop-trunk\hadoop-trunk\hadoop-common-project\hadoop-common\src\main\java\org\apache\hadoop\util\AsyncDiskService.java,119,43,4,1,0,48
hadoop-trunk\hadoop-trunk\hadoop-common-project\hadoop-common\src\test\java\org\apache\hadoop\metrics2\sink\ganglia\TestGangliaSink.java,51,11,6,6,0,23
hadoop-trunk\hadoop-trunk\hadoop-yarn-project\hadoop-yarn\hadoop-yarn-server\hadoop-yarn-server-resourcemanager\src\test\java\org\apache\hadoop\yarn\server\resourcemanager\TestAppManager.java,0,390,90,111,0,591
hadoop-trunk\hadoop-trunk\hadoop-hdfs-project\hadoop-hdfs\src\main\java\org\apache\hadoop\hdfs\server\namenode\FSDirEncryptionZoneOp.java,0,67,27,4,0,98
hadoop-trunk\hadoop-trunk\hadoop-tools\hadoop-archive-logs\src\test\java\org\apache\hadoop\tools\TestHadoopArchiveLogs.java,395,107,1,4,0,112
hadoop-trunk\hadoop-trunk\hadoop-yarn-project\hadoop-yarn\hadoop-yarn-server\hadoop-yarn-server-nodemanager\src\main\java\org\apache\hadoop\yarn\server\nodemanager\containermanager\loghandler\event\LogHandlerEventType.java,0,4,0,2,0,6
hadoop-trunk\hadoop-trunk\hadoop-tools\hadoop-azure\src\main\java\org\apache\hadoop\fs\azurebfs\services\AbfsOutputStreamContext.java,225,109,0,3,0,112
hadoop-trunk\hadoop-trunk\hadoop-tools\hadoop-azure\src\test\java\org\apache\hadoop\fs\azurebfs\TestAbfsOutputStreamStatistics.java,0,5,1,1,0,7
hadoop-trunk\hadoop-trunk\hadoop-yarn-project\hadoop-yarn\hadoop-yarn-applications\hadoop-yarn-applications-mawo\hadoop-yarn-applications-mawo-core\src\test\java\org\apache\hadoop\applications\mawo\server\common\TestMaWoConfiguration.java,34,6,0,1,0,7
hadoop-trunk\hadoop-trunk\hadoop-mapreduce-project\hadoop-mapreduce-client\hadoop-mapreduce-client-jobclient\src\test\java\org\apache\hadoop\mapreduce\v2\TestMRAppWithCombiner.java,111,25,8,3,0,36
hadoop-trunk\hadoop-trunk\hadoop-tools\hadoop-streaming\src\test\java\org\apache\hadoop\streaming\TestStreamingStatus.java,0,96,6,2,0,104
hadoop-trunk\hadoop-trunk\hadoop-mapreduce-project\hadoop-mapreduce-client\hadoop-mapreduce-client-jobclient\src\test\java\org\apache\hadoop\mapred\TestSortedRanges.java,75,91,2,1,0,94
hadoop-trunk\hadoop-trunk\hadoop-tools\hadoop-openstack\src\test\java\org\apache\hadoop\fs\swift\hdfs2\TestSwiftFileSystemDirectoriesHdfs2.java,17,5,0,2,0,7
hadoop-trunk\hadoop-trunk\hadoop-common-project\hadoop-common\src\main\java\org\apache\hadoop\metrics2\util\SampleQuantiles.java,278,52,4,1,0,57
hadoop-trunk\hadoop-trunk\hadoop-yarn-project\hadoop-yarn\hadoop-yarn-server\hadoop-yarn-server-router\src\main\java\org\apache\hadoop\yarn\server\router\rmadmin\DefaultRMAdminRequestInterceptor.java,0,42,0,27,0,69
hadoop-trunk\hadoop-trunk\hadoop-yarn-project\hadoop-yarn\hadoop-yarn-server\hadoop-yarn-server-resourcemanager\src\test\java\org\apache\hadoop\yarn\server\resourcemanager\RMHATestBase.java,176,51,1,3,0,55
hadoop-trunk\hadoop-trunk\hadoop-yarn-project\hadoop-yarn\hadoop-yarn-server\hadoop-yarn-server-resourcemanager\src\main\java\org\apache\hadoop\yarn\server\resourcemanager\rmapp\attempt\RMAppAttemptImpl.java,0,383,40,57,0,480
hadoop-trunk\hadoop-trunk\hadoop-yarn-project\hadoop-yarn\hadoop-yarn-server\hadoop-yarn-server-resourcemanager\src\test\java\org\apache\hadoop\yarn\server\resourcemanager\security\TestRMAuthenticationFilter.java,0,2,1,1,0,4
hadoop-trunk\hadoop-trunk\hadoop-tools\hadoop-aws\src\main\java\org\apache\hadoop\fs\s3a\audit\AuditManagerS3A.java,44,0,0,1,0,1
hadoop-trunk\hadoop-trunk\hadoop-hdfs-project\hadoop-hdfs\src\test\java\org\apache\hadoop\hdfs\tools\offlineImageViewer\TestOfflineImageViewerForXAttr.java,213,19,3,7,0,29
hadoop-trunk\hadoop-trunk\hadoop-hdfs-project\hadoop-hdfs-rbf\src\main\java\org\apache\hadoop\hdfs\server\federation\store\records\package-info.java,0,1,0,1,0,2
hadoop-trunk\hadoop-trunk\hadoop-tools\hadoop-azure\src\test\java\org\apache\hadoop\fs\azure\ITestNativeAzureFileSystemClientLogging.java,0,11,0,2,0,13
hadoop-trunk\hadoop-trunk\hadoop-hdfs-project\hadoop-hdfs\src\main\java\org\apache\hadoop\hdfs\server\namenode\FSDirAppendOp.java,0,13,2,1,0,16
hadoop-trunk\hadoop-trunk\hadoop-common-project\hadoop-auth\src\main\java\org\apache\hadoop\security\authentication\util\CertificateUtil.java,36,6,3,2,0,11
hadoop-trunk\hadoop-trunk\hadoop-mapreduce-project\hadoop-mapreduce-client\hadoop-mapreduce-client-core\src\main\java\org\apache\hadoop\mapreduce\security\IntermediateEncryptedStream.java,0,31,0,1,0,32
hadoop-trunk\hadoop-trunk\hadoop-mapreduce-project\hadoop-mapreduce-client\hadoop-mapreduce-client-core\src\main\java\org\apache\hadoop\mapred\IFileOutputStream.java,66,21,0,1,0,22
hadoop-trunk\hadoop-trunk\hadoop-mapreduce-project\hadoop-mapreduce-client\hadoop-mapreduce-client-hs\src\test\java\org\apache\hadoop\mapreduce\v2\hs\TestHistoryFileManagerInitWithNonRunningDFS.java,41,2,0,1,0,3
hadoop-trunk\hadoop-trunk\hadoop-yarn-project\hadoop-yarn\hadoop-yarn-server\hadoop-yarn-server-router\src\test\java\org\apache\hadoop\yarn\server\router\webapp\MockRESTRequestInterceptor.java,309,177,0,14,0,191
hadoop-trunk\hadoop-trunk\hadoop-hdfs-project\hadoop-hdfs-rbf\src\main\java\org\apache\hadoop\hdfs\server\federation\store\protocol\impl\pb\RemoveMountTableEntryResponsePBImpl.java,0,13,29,5,0,47
hadoop-trunk\hadoop-trunk\hadoop-hdfs-project\hadoop-hdfs-rbf\src\test\java\org\apache\hadoop\hdfs\server\federation\metrics\TestMetricsBase.java,209,36,0,16,0,52
hadoop-trunk\hadoop-trunk\hadoop-yarn-project\hadoop-yarn\hadoop-yarn-server\hadoop-yarn-server-resourcemanager\src\test\java\org\apache\hadoop\yarn\server\resourcemanager\webapp\TestRMWebServicesNodes.java,993,222,0,14,0,236
hadoop-trunk\hadoop-trunk\hadoop-hdfs-project\hadoop-hdfs\src\test\java\org\apache\hadoop\hdfs\server\blockmanagement\TestRedundancyMonitor.java,68,1,0,1,0,2
hadoop-trunk\hadoop-trunk\hadoop-hdfs-project\hadoop-hdfs-rbf\src\main\java\org\apache\hadoop\hdfs\server\federation\router\RemoteParam.java,50,5,0,1,0,6
hadoop-trunk\hadoop-trunk\hadoop-mapreduce-project\hadoop-mapreduce-client\hadoop-mapreduce-client-core\src\main\java\org\apache\hadoop\mapreduce\RecordReader.java,0,6,2,1,0,9
hadoop-trunk\hadoop-trunk\hadoop-yarn-project\hadoop-yarn\hadoop-yarn-applications\hadoop-yarn-services\hadoop-yarn-services-core\src\main\java\org\apache\hadoop\yarn\service\provider\AbstractProviderService.java,126,45,1,7,0,53
hadoop-trunk\hadoop-trunk\hadoop-mapreduce-project\hadoop-mapreduce-examples\src\main\java\org\apache\hadoop\examples\WordCount.java,57,30,1,2,0,33
hadoop-trunk\hadoop-trunk\hadoop-yarn-project\hadoop-yarn\hadoop-yarn-common\src\main\java\org\apache\hadoop\yarn\api\protocolrecords\impl\pb\GetLocalizationStatusesResponsePBImpl.java,212,30,66,6,0,102
hadoop-trunk\hadoop-trunk\hadoop-hdfs-project\hadoop-hdfs\src\test\java\org\apache\hadoop\hdfs\StripedFileTestUtil.java,551,133,12,5,0,150
hadoop-trunk\hadoop-trunk\hadoop-common-project\hadoop-common\src\main\java\org\apache\hadoop\metrics2\lib\MutableCounterLong.java,37,13,0,1,0,14
hadoop-trunk\hadoop-trunk\hadoop-tools\hadoop-gridmix\src\test\java\org\apache\hadoop\mapred\gridmix\TestUserResolve.java,141,18,2,1,0,21
hadoop-trunk\hadoop-trunk\hadoop-mapreduce-project\hadoop-mapreduce-client\hadoop-mapreduce-client-app\src\test\java\org\apache\hadoop\mapreduce\v2\app\TestStagingCleanup.java,0,121,14,14,0,149
hadoop-trunk\hadoop-trunk\hadoop-yarn-project\hadoop-yarn\hadoop-yarn-server\hadoop-yarn-server-resourcemanager\src\main\java\org\apache\hadoop\yarn\server\resourcemanager\webapp\dao\NodeToLabelsEntryList.java,14,6,3,1,0,10
hadoop-trunk\hadoop-trunk\hadoop-hdfs-project\hadoop-hdfs\src\test\java\org\apache\hadoop\hdfs\TestDFSAddressConfig.java,74,2,0,2,0,4
hadoop-trunk\hadoop-trunk\hadoop-common-project\hadoop-common\src\main\java\org\apache\hadoop\security\token\DelegationTokenIssuer.java,0,12,2,1,0,15
hadoop-trunk\hadoop-trunk\hadoop-tools\hadoop-gridmix\src\test\java\org\apache\hadoop\mapred\gridmix\DebugJobProducer.java,266,93,26,2,0,121
hadoop-trunk\hadoop-trunk\hadoop-mapreduce-project\hadoop-mapreduce-client\hadoop-mapreduce-client-common\src\main\java\org\apache\hadoop\mapreduce\v2\api\protocolrecords\GetJobReportRequest.java,0,7,2,1,0,10
hadoop-trunk\hadoop-trunk\hadoop-hdfs-project\hadoop-hdfs-rbf\src\test\java\org\apache\hadoop\hdfs\server\federation\router\TestRouterAdminCLI.java,1720,88,10,7,0,105
hadoop-trunk\hadoop-trunk\hadoop-yarn-project\hadoop-yarn\hadoop-yarn-api\src\main\java\org\apache\hadoop\yarn\api\records\Container.java,0,45,1,6,0,52
hadoop-trunk\hadoop-trunk\hadoop-hdfs-project\hadoop-hdfs-rbf\src\test\java\org\apache\hadoop\hdfs\server\federation\router\TestRouterMountTableCacheRefreshSecure.java,281,13,1,11,0,25
hadoop-trunk\hadoop-trunk\hadoop-yarn-project\hadoop-yarn\hadoop-yarn-api\src\main\java\org\apache\hadoop\yarn\api\records\timelineservice\ApplicationEntity.java,54,12,2,1,0,15
hadoop-trunk\hadoop-trunk\hadoop-yarn-project\hadoop-yarn\hadoop-yarn-common\src\test\java\org\apache\hadoop\yarn\logaggregation\filecontroller\FakeLogAggregationFileController.java,0,19,8,1,0,28
hadoop-trunk\hadoop-trunk\hadoop-mapreduce-project\hadoop-mapreduce-client\hadoop-mapreduce-client-app\src\main\java\org\apache\hadoop\mapreduce\v2\app\webapp\JAXBContextResolver.java,40,8,0,3,0,11
hadoop-trunk\hadoop-trunk\hadoop-mapreduce-project\hadoop-mapreduce-client\hadoop-mapreduce-client-core\src\main\java\org\apache\hadoop\mapreduce\lib\output\TextOutputFormat.java,0,33,2,2,0,37
hadoop-trunk\hadoop-trunk\hadoop-common-project\hadoop-common\src\main\java\org\apache\hadoop\metrics2\lib\MutableRate.java,7,4,0,1,0,5
hadoop-trunk\hadoop-trunk\hadoop-tools\hadoop-aws\src\main\java\org\apache\hadoop\fs\s3a\commit\staging\PartitionedStagingCommitter.java,167,10,1,2,0,13
hadoop-trunk\hadoop-trunk\hadoop-mapreduce-project\hadoop-mapreduce-examples\src\main\java\org\apache\hadoop\examples\pi\math\Modular.java,93,74,21,2,0,97
hadoop-trunk\hadoop-trunk\hadoop-common-project\hadoop-common\src\test\java\org\apache\hadoop\fs\viewfs\TestRegexMountPointResolvedDstPathReplaceInterceptor.java,73,9,0,2,0,11
hadoop-trunk\hadoop-trunk\hadoop-hdfs-project\hadoop-hdfs\src\test\java\org\apache\hadoop\hdfs\server\namenode\TestNamenodeStorageDirectives.java,0,58,6,2,0,66
hadoop-trunk\hadoop-trunk\hadoop-yarn-project\hadoop-yarn\hadoop-yarn-api\src\main\java\org\apache\hadoop\yarn\api\protocolrecords\GetApplicationAttemptReportRequest.java,33,10,0,2,0,12
hadoop-trunk\hadoop-trunk\hadoop-yarn-project\hadoop-yarn\hadoop-yarn-server\hadoop-yarn-server-common\src\main\java\org\apache\hadoop\yarn\server\federation\store\impl\MemoryFederationStateStore.java,243,38,2,35,0,75
hadoop-trunk\hadoop-trunk\hadoop-yarn-project\hadoop-yarn\hadoop-yarn-server\hadoop-yarn-server-resourcemanager\src\main\java\org\apache\hadoop\yarn\server\resourcemanager\scheduler\placement\CandidateNodeSet.java,0,3,0,1,0,4
hadoop-trunk\hadoop-trunk\hadoop-yarn-project\hadoop-yarn\hadoop-yarn-server\hadoop-yarn-server-resourcemanager\src\main\java\org\apache\hadoop\yarn\server\resourcemanager\RMInfoMXBean.java,0,1,0,1,0,2
hadoop-trunk\hadoop-trunk\hadoop-hdfs-project\hadoop-hdfs\src\test\java\org\apache\hadoop\hdfs\server\namenode\TestNestedEncryptionZones.java,251,37,3,2,0,42
hadoop-trunk\hadoop-trunk\hadoop-tools\hadoop-fs2img\src\main\java\org\apache\hadoop\hdfs\server\namenode\UGIResolver.java,160,43,0,1,0,44
hadoop-trunk\hadoop-trunk\hadoop-yarn-project\hadoop-yarn\hadoop-yarn-server\hadoop-yarn-server-resourcemanager\src\main\java\org\apache\hadoop\yarn\server\resourcemanager\scheduler\common\AssignmentInformation.java,126,63,0,1,0,64
hadoop-trunk\hadoop-trunk\hadoop-common-project\hadoop-common\src\main\java\org\apache\hadoop\io\erasurecode\coder\XORErasureDecoder.java,53,5,0,1,0,6
hadoop-trunk\hadoop-trunk\hadoop-common-project\hadoop-common\src\main\java\org\apache\hadoop\security\protocolPB\RefreshAuthorizationPolicyProtocolServerSideTranslatorPB.java,26,9,9,3,0,21
hadoop-trunk\hadoop-trunk\hadoop-hdfs-project\hadoop-hdfs\src\main\java\org\apache\hadoop\hdfs\server\diskbalancer\command\Command.java,512,53,8,4,0,65
hadoop-trunk\hadoop-trunk\hadoop-common-project\hadoop-common\src\test\java\org\apache\hadoop\ha\TestZKFailoverControllerStress.java,122,36,3,1,0,40
hadoop-trunk\hadoop-trunk\hadoop-mapreduce-project\hadoop-mapreduce-client\hadoop-mapreduce-client-jobclient\src\main\java\org\apache\hadoop\mapred\ClientServiceDelegate.java,469,112,34,34,0,180
hadoop-trunk\hadoop-trunk\hadoop-tools\hadoop-aliyun\src\main\java\org\apache\hadoop\fs\aliyun\oss\OSSFileStatus.java,9,8,0,1,0,9
hadoop-trunk\hadoop-trunk\hadoop-hdfs-project\hadoop-hdfs\src\main\java\org\apache\hadoop\hdfs\server\blockmanagement\DatanodeAdminMonitorInterface.java,0,10,0,1,0,11
hadoop-trunk\hadoop-trunk\hadoop-yarn-project\hadoop-yarn\hadoop-yarn-api\src\main\java\org\apache\hadoop\yarn\util\resource\ResourceUtils.java,0,105,29,9,0,143
hadoop-trunk\hadoop-trunk\hadoop-mapreduce-project\hadoop-mapreduce-client\hadoop-mapreduce-client-app\src\main\java\org\apache\hadoop\mapreduce\v2\app\local\package-info.java,0,1,0,1,0,2
hadoop-trunk\hadoop-trunk\hadoop-tools\hadoop-dynamometer\hadoop-dynamometer-blockgen\src\main\java\org\apache\hadoop\tools\dynamometer\blockgenerator\package-info.java,0,0,0,1,0,1
hadoop-trunk\hadoop-trunk\hadoop-common-project\hadoop-common\src\test\java\org\apache\hadoop\io\TestUTF8.java,153,44,0,1,0,45
hadoop-trunk\hadoop-trunk\hadoop-yarn-project\hadoop-yarn\hadoop-yarn-common\src\test\java\org\apache\hadoop\yarn\webapp\util\TestWebServiceClient.java,68,7,0,1,0,8
hadoop-trunk\hadoop-trunk\hadoop-tools\hadoop-resourceestimator\src\main\java\org\apache\hadoop\resourceestimator\translator\impl\LogParserUtil.java,66,5,2,3,0,10
hadoop-trunk\hadoop-trunk\hadoop-tools\hadoop-azure\src\main\java\org\apache\hadoop\fs\azurebfs\oauth2\IdentityTransformer.java,295,83,6,60,0,149
hadoop-trunk\hadoop-trunk\hadoop-yarn-project\hadoop-yarn\hadoop-yarn-server\hadoop-yarn-server-timelineservice-hbase\hadoop-yarn-server-timelineservice-hbase-common\src\main\java\org\apache\hadoop\yarn\server\timelineservice\storage\common\EventColumnNameConverter.java,0,6,2,1,0,9
hadoop-trunk\hadoop-trunk\hadoop-tools\hadoop-aws\src\main\java\org\apache\hadoop\fs\s3a\SimpleAWSCredentialsProvider.java,50,7,1,1,0,9
hadoop-trunk\hadoop-trunk\hadoop-yarn-project\hadoop-yarn\hadoop-yarn-server\hadoop-yarn-server-resourcemanager\src\main\java\org\apache\hadoop\yarn\server\resourcemanager\rmnode\RMNode.java,0,51,21,1,0,73
hadoop-trunk\hadoop-trunk\hadoop-yarn-project\hadoop-yarn\hadoop-yarn-server\hadoop-yarn-server-router\src\test\java\org\apache\hadoop\yarn\server\router\clientrm\TestableFederationClientInterceptor.java,0,13,0,2,0,15
hadoop-trunk\hadoop-trunk\hadoop-common-project\hadoop-common\src\test\java\org\apache\hadoop\security\authorize\TestProxyUsers.java,632,139,45,21,0,205
hadoop-trunk\hadoop-trunk\hadoop-yarn-project\hadoop-yarn\hadoop-yarn-server\hadoop-yarn-server-resourcemanager\src\main\java\org\apache\hadoop\yarn\server\resourcemanager\rmcontainer\RMContainerReservedEvent.java,29,20,0,1,0,21
hadoop-trunk\hadoop-trunk\hadoop-tools\hadoop-aws\src\test\java\org\apache\hadoop\fs\s3a\statistics\ITestS3AContractStreamIOStatistics.java,47,3,19,1,0,23
hadoop-trunk\hadoop-trunk\hadoop-common-project\hadoop-common\src\test\java\org\apache\hadoop\fs\contract\ftp\TestFTPContractRename.java,40,6,0,2,0,8
hadoop-trunk\hadoop-trunk\hadoop-hdfs-project\hadoop-hdfs\src\test\java\org\apache\hadoop\hdfs\server\blockmanagement\TestBlockInfo.java,177,24,13,2,0,39
hadoop-trunk\hadoop-trunk\hadoop-hdfs-project\hadoop-hdfs\src\test\java\org\apache\hadoop\hdfs\server\namenode\TestNameNodeRecovery.java,622,168,22,2,0,192
hadoop-trunk\hadoop-trunk\hadoop-common-project\hadoop-common\src\main\java\org\apache\hadoop\security\User.java,0,34,6,3,0,43
hadoop-trunk\hadoop-trunk\hadoop-tools\hadoop-resourceestimator\src\main\java\org\apache\hadoop\resourceestimator\skylinestore\impl\package-info.java,0,1,0,1,0,2
hadoop-trunk\hadoop-trunk\hadoop-yarn-project\hadoop-yarn\hadoop-yarn-common\src\main\java\org\apache\hadoop\yarn\api\records\impl\pb\ReservationAllocationStatePBImpl.java,227,42,68,3,0,113
hadoop-trunk\hadoop-trunk\hadoop-mapreduce-project\hadoop-mapreduce-client\hadoop-mapreduce-client-core\src\main\java\org\apache\hadoop\mapreduce\lib\output\committer\manifest\stages\SetupJobStage.java,0,3,1,2,0,6
hadoop-trunk\hadoop-trunk\hadoop-tools\hadoop-azure\src\test\java\org\apache\hadoop\fs\azure\TestNativeAzureFileSystemUploadLogic.java,147,23,1,11,0,35
hadoop-trunk\hadoop-trunk\hadoop-hdfs-project\hadoop-hdfs-client\src\main\java\org\apache\hadoop\hdfs\protocol\datatransfer\BlockConstructionStage.java,0,18,0,1,0,19
hadoop-trunk\hadoop-trunk\hadoop-yarn-project\hadoop-yarn\hadoop-yarn-common\src\main\java\org\apache\hadoop\yarn\factories\impl\pb\RpcClientFactoryPBImpl.java,90,30,6,6,0,42
hadoop-trunk\hadoop-trunk\hadoop-mapreduce-project\hadoop-mapreduce-client\hadoop-mapreduce-client-core\src\test\java\org\apache\hadoop\mapreduce\lib\input\TestCombineFileRecordReader.java,0,34,5,5,0,44
hadoop-trunk\hadoop-trunk\hadoop-hdfs-project\hadoop-hdfs\src\test\java\org\apache\hadoop\hdfs\TestDistributedFileSystem.java,0,350,36,6,0,392
hadoop-trunk\hadoop-trunk\hadoop-cloud-storage-project\hadoop-huaweicloud\src\main\java\org\apache\hadoop\fs\obs\BasicSessionCredential.java,0,0,0,1,0,1
hadoop-trunk\hadoop-trunk\hadoop-common-project\hadoop-common\src\main\java\org\apache\hadoop\security\token\SecretManager.java,150,30,4,3,0,37
hadoop-trunk\hadoop-trunk\hadoop-common-project\hadoop-common\src\main\java\org\apache\hadoop\fs\UnionStorageStatistics.java,100,11,3,1,0,15
hadoop-trunk\hadoop-trunk\hadoop-yarn-project\hadoop-yarn\hadoop-yarn-common\src\main\java\org\apache\hadoop\yarn\server\api\protocolrecords\impl\pb\RefreshAdminAclsRequestPBImpl.java,0,24,18,4,0,46
hadoop-trunk\hadoop-trunk\hadoop-common-project\hadoop-common\src\test\java\org\apache\hadoop\fs\TestFileSystemCaching.java,432,65,3,7,0,75
hadoop-trunk\hadoop-trunk\hadoop-yarn-project\hadoop-yarn\hadoop-yarn-server\hadoop-yarn-server-nodemanager\src\main\java\org\apache\hadoop\yarn\server\nodemanager\containermanager\linux\resources\TrafficController.java,0,100,11,12,0,123
hadoop-trunk\hadoop-trunk\hadoop-common-project\hadoop-common\src\main\java\org\apache\hadoop\fs\Seekable.java,0,8,0,1,0,9
hadoop-trunk\hadoop-trunk\hadoop-tools\hadoop-aws\src\test\java\org\apache\hadoop\fs\s3a\commit\staging\PartitionedCommitterForTesting.java,28,5,0,1,0,6
hadoop-trunk\hadoop-trunk\hadoop-common-project\hadoop-common\src\test\java\org\apache\hadoop\util\TestShell.java,490,94,28,4,0,126
hadoop-trunk\hadoop-trunk\hadoop-hdfs-project\hadoop-hdfs-rbf\src\main\java\org\apache\hadoop\hdfs\server\federation\store\driver\impl\StateStoreFileBaseImpl.java,0,24,4,3,0,31
hadoop-trunk\hadoop-trunk\hadoop-tools\hadoop-azure\src\test\java\org\apache\hadoop\fs\azure\TestShellDecryptionKeyProvider.java,0,6,1,2,0,9
hadoop-trunk\hadoop-trunk\hadoop-hdfs-project\hadoop-hdfs\src\main\java\org\apache\hadoop\hdfs\server\blockmanagement\DatanodeDescriptor.java,1038,289,19,3,0,311
hadoop-trunk\hadoop-trunk\hadoop-common-project\hadoop-common\src\test\java\org\apache\hadoop\fs\viewfs\TestFcPermissionsLocalFs.java,21,3,0,1,0,4
hadoop-trunk\hadoop-trunk\hadoop-common-project\hadoop-common\src\main\java\org\apache\hadoop\fs\statistics\impl\StorageStatisticsFromIOStatistics.java,0,8,0,1,0,9
hadoop-trunk\hadoop-trunk\hadoop-common-project\hadoop-nfs\src\main\java\org\apache\hadoop\oncrpc\RpcDeniedReply.java,52,22,0,1,0,23
hadoop-trunk\hadoop-trunk\hadoop-yarn-project\hadoop-yarn\hadoop-yarn-server\hadoop-yarn-server-resourcemanager\src\test\java\org\apache\hadoop\yarn\server\resourcemanager\scheduler\capacity\TestQueuePath.java,104,20,0,8,0,28
hadoop-trunk\hadoop-trunk\hadoop-common-project\hadoop-common\src\main\java\org\apache\hadoop\security\ssl\SSLHostnameVerifier.java,0,89,27,4,0,120
hadoop-trunk\hadoop-trunk\hadoop-yarn-project\hadoop-yarn\hadoop-yarn-server\hadoop-yarn-server-common\src\main\java\org\apache\hadoop\yarn\server\webapp\LogWebService.java,263,69,9,2,0,80
hadoop-trunk\hadoop-trunk\hadoop-common-project\hadoop-common\src\main\java\org\apache\hadoop\fs\BlockLocation.java,285,153,0,1,0,154
hadoop-trunk\hadoop-trunk\hadoop-yarn-project\hadoop-yarn\hadoop-yarn-common\src\main\java\org\apache\hadoop\yarn\client\api\impl\package-info.java,0,0,0,1,0,1
hadoop-trunk\hadoop-trunk\hadoop-mapreduce-project\hadoop-mapreduce-client\hadoop-mapreduce-client-common\src\main\java\org\apache\hadoop\mapreduce\v2\api\records\TaskId.java,92,22,7,1,0,30
hadoop-trunk\hadoop-trunk\hadoop-hdfs-project\hadoop-hdfs\src\main\java\org\apache\hadoop\hdfs\server\datanode\fsdataset\impl\FsDatasetAsyncDiskService.java,0,82,9,4,0,95
hadoop-trunk\hadoop-trunk\hadoop-yarn-project\hadoop-yarn\hadoop-yarn-server\hadoop-yarn-server-timelineservice\src\main\java\org\apache\hadoop\yarn\server\timelineservice\reader\security\TimelineReaderWhitelistAuthorizationFilterInitializer.java,0,2,0,1,0,3
hadoop-trunk\hadoop-trunk\hadoop-common-project\hadoop-common\src\main\java\org\apache\hadoop\io\OutputBuffer.java,52,21,0,1,0,22
hadoop-trunk\hadoop-trunk\hadoop-yarn-project\hadoop-yarn\hadoop-yarn-server\hadoop-yarn-server-router\src\test\java\org\apache\hadoop\yarn\server\router\clientrm\MockClientRequestInterceptor.java,0,8,0,4,0,12
hadoop-trunk\hadoop-trunk\hadoop-hdfs-project\hadoop-hdfs-rbf\src\test\java\org\apache\hadoop\hdfs\server\federation\router\TestConnectionManager.java,277,88,3,1,0,92
hadoop-trunk\hadoop-trunk\hadoop-hdfs-project\hadoop-hdfs\src\main\java\org\apache\hadoop\hdfs\tools\offlineImageViewer\TextWriterImageVisitor.java,75,18,3,2,0,23
hadoop-trunk\hadoop-trunk\hadoop-hdfs-project\hadoop-hdfs-client\src\main\java\org\apache\hadoop\hdfs\web\resources\ModificationTimeParam.java,30,2,0,1,0,3
hadoop-trunk\hadoop-trunk\hadoop-yarn-project\hadoop-yarn\hadoop-yarn-server\hadoop-yarn-server-nodemanager\src\main\java\org\apache\hadoop\yarn\server\nodemanager\logaggregation\tracker\NMLogAggregationStatusTracker.java,222,44,7,2,0,53
hadoop-trunk\hadoop-trunk\hadoop-common-project\hadoop-common\src\test\java\org\apache\hadoop\util\TestNativeCrc32.java,206,40,3,3,0,46
hadoop-trunk\hadoop-trunk\hadoop-mapreduce-project\hadoop-mapreduce-client\hadoop-mapreduce-client-jobclient\src\test\java\org\apache\hadoop\mapred\TestLineRecordReaderJobs.java,101,20,1,1,0,22
hadoop-trunk\hadoop-trunk\hadoop-common-project\hadoop-common\src\main\java\org\apache\hadoop\io\SetFile.java,84,62,13,3,0,78
hadoop-trunk\hadoop-trunk\hadoop-common-project\hadoop-common\src\test\java\org\apache\hadoop\util\TestGenericOptionsParser.java,342,34,1,3,0,38
hadoop-trunk\hadoop-trunk\hadoop-mapreduce-project\hadoop-mapreduce-client\hadoop-mapreduce-client-core\src\main\java\org\apache\hadoop\mapreduce\Cluster.java,409,88,5,4,0,97
hadoop-trunk\hadoop-trunk\hadoop-yarn-project\hadoop-yarn\hadoop-yarn-api\src\main\java\org\apache\hadoop\yarn\server\api\protocolrecords\RefreshServiceAclsRequest.java,10,1,1,1,0,3
hadoop-trunk\hadoop-trunk\hadoop-yarn-project\hadoop-yarn\hadoop-yarn-server\hadoop-yarn-server-applicationhistoryservice\src\test\java\org\apache\hadoop\yarn\server\timeline\security\TestTimelineAuthenticationFilterForV1.java,295,30,5,4,0,39
hadoop-trunk\hadoop-trunk\hadoop-tools\hadoop-aws\src\test\java\org\apache\hadoop\fs\s3a\ITestS3AFileSystemContract.java,99,15,2,1,0,18
hadoop-trunk\hadoop-trunk\hadoop-hdfs-project\hadoop-hdfs\src\main\java\org\apache\hadoop\hdfs\util\PersistentLongFile.java,72,27,1,1,0,29
hadoop-trunk\hadoop-trunk\hadoop-hdfs-project\hadoop-hdfs\src\main\java\org\apache\hadoop\hdfs\server\datanode\fsdataset\impl\MemoryMappedBlock.java,34,10,0,1,0,11
hadoop-trunk\hadoop-trunk\hadoop-yarn-project\hadoop-yarn\hadoop-yarn-server\hadoop-yarn-server-resourcemanager\src\main\java\org\apache\hadoop\yarn\server\resourcemanager\scheduler\capacity\QueueCapacityVector.java,0,51,1,1,0,53
hadoop-trunk\hadoop-trunk\hadoop-tools\hadoop-aws\src\test\java\org\apache\hadoop\fs\s3a\TestS3AInputPolicies.java,60,31,0,1,0,32
hadoop-trunk\hadoop-trunk\hadoop-hdfs-project\hadoop-hdfs-client\src\main\java\org\apache\hadoop\hdfs\web\resources\CreateFlagParam.java,22,6,0,1,0,7
hadoop-trunk\hadoop-trunk\hadoop-mapreduce-project\hadoop-mapreduce-client\hadoop-mapreduce-client-app\src\main\java\org\apache\hadoop\mapreduce\v2\app\rm\ContainerRequestEvent.java,45,35,0,2,0,37
hadoop-trunk\hadoop-trunk\hadoop-mapreduce-project\hadoop-mapreduce-client\hadoop-mapreduce-client-app\src\test\java\org\apache\hadoop\mapreduce\v2\app\TestKill.java,394,84,2,12,0,98
hadoop-trunk\hadoop-trunk\hadoop-tools\hadoop-aws\src\main\java\org\apache\hadoop\fs\s3a\select\SelectTool.java,286,40,5,1,0,46
hadoop-trunk\hadoop-trunk\hadoop-yarn-project\hadoop-yarn\hadoop-yarn-common\src\main\java\org\apache\hadoop\yarn\webapp\ToJSON.java,0,2,0,1,0,3
hadoop-trunk\hadoop-trunk\hadoop-mapreduce-project\hadoop-mapreduce-client\hadoop-mapreduce-client-core\src\test\java\org\apache\hadoop\mapreduce\lib\output\committer\manifest\TestTaskManifestFileIO.java,146,11,1,7,0,19
hadoop-trunk\hadoop-trunk\hadoop-hdfs-project\hadoop-hdfs-httpfs\src\main\java\org\apache\hadoop\lib\wsrs\ParametersProvider.java,0,21,10,2,0,33
hadoop-trunk\hadoop-trunk\hadoop-common-project\hadoop-common\src\test\java\org\apache\hadoop\fs\viewfs\TestChRootedFs.java,331,102,6,8,0,116
hadoop-trunk\hadoop-trunk\hadoop-yarn-project\hadoop-yarn\hadoop-yarn-server\hadoop-yarn-server-resourcemanager\src\main\java\org\apache\hadoop\yarn\server\resourcemanager\scheduler\fair\InvalidQueueNameException.java,12,5,0,1,0,6
hadoop-trunk\hadoop-trunk\hadoop-hdfs-project\hadoop-hdfs-client\src\main\java\org\apache\hadoop\hdfs\protocol\datatransfer\TrustedChannelResolver.java,46,9,0,1,0,10
hadoop-trunk\hadoop-trunk\hadoop-common-project\hadoop-nfs\src\main\java\org\apache\hadoop\nfs\nfs3\response\WccAttr.java,49,27,0,1,0,28
hadoop-trunk\hadoop-trunk\hadoop-mapreduce-project\hadoop-mapreduce-client\hadoop-mapreduce-client-nativetask\src\main\java\org\apache\hadoop\mapred\nativetask\DataReceiver.java,0,3,1,1,0,5
hadoop-trunk\hadoop-trunk\hadoop-tools\hadoop-aws\src\main\java\org\apache\hadoop\fs\s3a\statistics\impl\AwsStatisticsCollector.java,81,7,0,1,0,8
hadoop-trunk\hadoop-trunk\hadoop-common-project\hadoop-common\src\test\java\org\apache\hadoop\io\erasurecode\codec\TestHHXORErasureCodec.java,18,10,0,1,0,11
hadoop-trunk\hadoop-trunk\hadoop-yarn-project\hadoop-yarn\hadoop-yarn-api\src\main\java\org\apache\hadoop\yarn\api\records\timelineservice\TimelineMetricCalculator.java,0,6,5,1,0,12
hadoop-trunk\hadoop-trunk\hadoop-yarn-project\hadoop-yarn\hadoop-yarn-server\hadoop-yarn-server-timelineservice-hbase\hadoop-yarn-server-timelineservice-hbase-common\src\main\java\org\apache\hadoop\yarn\server\timelineservice\storage\application\package-info.java,0,0,0,1,0,1
hadoop-trunk\hadoop-trunk\hadoop-tools\hadoop-azure-datalake\src\test\java\org\apache\hadoop\fs\adl\live\TestAdlFileContextMainOperationsLive.java,0,10,2,1,0,13
hadoop-trunk\hadoop-trunk\hadoop-yarn-project\hadoop-yarn\hadoop-yarn-server\hadoop-yarn-server-common\src\main\java\org\apache\hadoop\yarn\server\api\protocolrecords\impl\pb\NMContainerStatusPBImpl.java,351,79,107,3,0,189
hadoop-trunk\hadoop-trunk\hadoop-yarn-project\hadoop-yarn\hadoop-yarn-server\hadoop-yarn-server-common\src\main\java\org\apache\hadoop\yarn\server\records\Version.java,52,21,4,1,0,26
hadoop-trunk\hadoop-trunk\hadoop-common-project\hadoop-common\src\main\java\org\apache\hadoop\metrics2\impl\AbstractMetricsRecord.java,30,5,0,1,0,6
hadoop-trunk\hadoop-trunk\hadoop-mapreduce-project\hadoop-mapreduce-client\hadoop-mapreduce-client-core\src\test\java\org\apache\hadoop\mapreduce\lib\output\committer\manifest\ManifestCommitterTestSupport.java,0,38,2,8,0,48
hadoop-trunk\hadoop-trunk\hadoop-yarn-project\hadoop-yarn\hadoop-yarn-server\hadoop-yarn-server-nodemanager\src\test\java\org\apache\hadoop\yarn\server\nodemanager\webapp\TestNMWebServicesApps.java,687,84,11,9,0,104
hadoop-trunk\hadoop-trunk\hadoop-common-project\hadoop-nfs\src\main\java\org\apache\hadoop\nfs\nfs3\response\WccData.java,42,26,0,1,0,27
hadoop-trunk\hadoop-trunk\hadoop-mapreduce-project\hadoop-mapreduce-client\hadoop-mapreduce-client-jobclient\src\test\java\org\apache\hadoop\mapred\TestCombineOutputCollector.java,111,30,7,3,0,40
hadoop-trunk\hadoop-trunk\hadoop-cloud-storage-project\hadoop-cos\src\test\java\org\apache\hadoop\fs\cosn\contract\TestCosNContractOpen.java,7,2,0,1,0,3
hadoop-trunk\hadoop-trunk\hadoop-common-project\hadoop-common\src\test\java\org\apache\hadoop\security\authorize\TestAccessControlList.java,449,52,8,1,0,61
hadoop-trunk\hadoop-trunk\hadoop-yarn-project\hadoop-yarn\hadoop-yarn-common\src\main\java\org\apache\hadoop\yarn\api\protocolrecords\impl\pb\IncreaseContainersResourceRequestPBImpl.java,133,24,42,4,0,70
hadoop-trunk\hadoop-trunk\hadoop-yarn-project\hadoop-yarn\hadoop-yarn-server\hadoop-yarn-server-common\src\main\java\org\apache\hadoop\yarn\server\federation\policies\manager\FederationPolicyManager.java,0,0,0,6,0,6
hadoop-trunk\hadoop-trunk\hadoop-common-project\hadoop-nfs\src\main\java\org\apache\hadoop\oncrpc\RpcAcceptedReply.java,59,36,1,1,0,38
hadoop-trunk\hadoop-trunk\hadoop-hdfs-project\hadoop-hdfs-rbf\src\main\java\org\apache\hadoop\hdfs\server\federation\router\RouterQuotaUpdateService.java,218,14,4,3,0,21
hadoop-trunk\hadoop-trunk\hadoop-common-project\hadoop-common\src\test\java\org\apache\hadoop\fs\contract\AbstractContractGetFileStatusTest.java,671,75,5,1,0,81
hadoop-trunk\hadoop-trunk\hadoop-yarn-project\hadoop-yarn\hadoop-yarn-applications\hadoop-yarn-services\hadoop-yarn-services-api\src\main\java\org\apache\hadoop\yarn\service\webapp\ApiServer.java,903,119,26,2,0,147
hadoop-trunk\hadoop-trunk\hadoop-mapreduce-project\hadoop-mapreduce-client\hadoop-mapreduce-client-jobclient\src\test\java\org\apache\hadoop\mapred\ReliabilityTest.java,438,145,31,6,0,182
hadoop-trunk\hadoop-trunk\hadoop-yarn-project\hadoop-yarn\hadoop-yarn-client\src\test\java\org\apache\hadoop\yarn\client\api\impl\TestYarnClient.java,1172,233,44,25,0,302
hadoop-trunk\hadoop-trunk\hadoop-yarn-project\hadoop-yarn\hadoop-yarn-server\hadoop-yarn-server-nodemanager\src\main\java\org\apache\hadoop\yarn\server\nodemanager\containermanager\logaggregation\LogAggregationService.java,402,74,14,13,0,101
hadoop-trunk\hadoop-trunk\hadoop-yarn-project\hadoop-yarn\hadoop-yarn-server\hadoop-yarn-server-resourcemanager\src\main\java\org\apache\hadoop\yarn\server\resourcemanager\scheduler\fair\converter\package-info.java,0,1,0,1,0,2
hadoop-trunk\hadoop-trunk\hadoop-yarn-project\hadoop-yarn\hadoop-yarn-server\hadoop-yarn-server-resourcemanager\src\main\java\org\apache\hadoop\yarn\server\resourcemanager\scheduler\QueueMetrics.java,1279,435,6,5,0,446
hadoop-trunk\hadoop-trunk\hadoop-hdfs-project\hadoop-hdfs\src\test\java\org\apache\hadoop\hdfs\server\balancer\TestKeyManager.java,48,4,10,1,0,15
hadoop-trunk\hadoop-trunk\hadoop-yarn-project\hadoop-yarn\hadoop-yarn-server\hadoop-yarn-server-resourcemanager\src\main\java\org\apache\hadoop\yarn\server\resourcemanager\scheduler\capacity\CapacitySchedulerMetrics.java,92,47,1,1,0,49
hadoop-trunk\hadoop-trunk\hadoop-mapreduce-project\hadoop-mapreduce-client\hadoop-mapreduce-client-jobclient\src\test\java\org\apache\hadoop\mapred\NotificationTestCase.java,198,51,9,2,0,62
hadoop-trunk\hadoop-trunk\hadoop-tools\hadoop-aws\src\main\java\org\apache\hadoop\fs\s3a\auth\delegation\AWSPolicyProvider.java,0,0,0,1,0,1
hadoop-trunk\hadoop-trunk\hadoop-common-project\hadoop-common\src\main\java\org\apache\hadoop\fs\shell\Stat.java,0,22,4,3,0,29
hadoop-trunk\hadoop-trunk\hadoop-yarn-project\hadoop-yarn\hadoop-yarn-server\hadoop-yarn-server-timelineservice\src\main\java\org\apache\hadoop\yarn\server\timelineservice\collector\TimelineCollector.java,361,53,4,2,0,59
hadoop-trunk\hadoop-trunk\hadoop-common-project\hadoop-common\src\main\java\org\apache\hadoop\tools\CommandShell.java,91,22,0,1,0,23
hadoop-trunk\hadoop-trunk\hadoop-yarn-project\hadoop-yarn\hadoop-yarn-common\src\main\java\org\apache\hadoop\yarn\webapp\YarnWebParams.java,0,26,21,1,0,48
hadoop-trunk\hadoop-trunk\hadoop-yarn-project\hadoop-yarn\hadoop-yarn-api\src\main\java\org\apache\hadoop\yarn\server\api\protocolrecords\AddToClusterNodeLabelsResponse.java,6,1,0,1,0,2
hadoop-trunk\hadoop-trunk\hadoop-yarn-project\hadoop-yarn\hadoop-yarn-api\src\main\java\org\apache\hadoop\yarn\api\records\package-info.java,0,1,0,1,0,2
hadoop-trunk\hadoop-trunk\hadoop-yarn-project\hadoop-yarn\hadoop-yarn-applications\hadoop-yarn-services\hadoop-yarn-services-core\src\main\java\org\apache\hadoop\yarn\service\utils\ZookeeperUtils.java,120,31,3,5,0,39
hadoop-trunk\hadoop-trunk\hadoop-mapreduce-project\hadoop-mapreduce-client\hadoop-mapreduce-client-common\src\main\java\org\apache\hadoop\mapreduce\v2\api\package-info.java,0,1,0,1,0,2
hadoop-trunk\hadoop-trunk\hadoop-yarn-project\hadoop-yarn\hadoop-yarn-server\hadoop-yarn-server-resourcemanager\src\test\java\org\apache\hadoop\yarn\server\resourcemanager\scheduler\fair\TestFairSchedulerQueueACLs.java,88,8,0,1,0,9
hadoop-trunk\hadoop-trunk\hadoop-common-project\hadoop-common\src\test\java\org\apache\hadoop\util\TestMachineList.java,278,59,73,4,0,136
hadoop-trunk\hadoop-trunk\hadoop-yarn-project\hadoop-yarn\hadoop-yarn-server\hadoop-yarn-server-resourcemanager\src\test\java\org\apache\hadoop\yarn\server\resourcemanager\scheduler\constraint\TestPlacementConstraintsUtil.java,1026,163,46,7,0,216
hadoop-trunk\hadoop-trunk\hadoop-yarn-project\hadoop-yarn\hadoop-yarn-common\src\main\java\org\apache\hadoop\yarn\api\records\impl\pb\ContainerRetryContextPBImpl.java,159,39,52,2,0,93
hadoop-trunk\hadoop-trunk\hadoop-yarn-project\hadoop-yarn\hadoop-yarn-server\hadoop-yarn-server-resourcemanager\src\main\java\org\apache\hadoop\yarn\server\resourcemanager\recovery\LeveldbRMStateStore.java,724,115,36,12,0,163
hadoop-trunk\hadoop-trunk\hadoop-yarn-project\hadoop-yarn\hadoop-yarn-server\hadoop-yarn-server-resourcemanager\src\main\java\org\apache\hadoop\yarn\server\resourcemanager\scheduler\NodeFilter.java,0,2,0,1,0,3
hadoop-trunk\hadoop-trunk\hadoop-mapreduce-project\hadoop-mapreduce-client\hadoop-mapreduce-client-app\src\main\java\org\apache\hadoop\mapreduce\v2\app\webapp\AMWebApp.java,24,6,0,3,0,9
hadoop-trunk\hadoop-trunk\hadoop-common-project\hadoop-common\src\test\java\org\apache\hadoop\fs\viewfs\TestViewFileSystemDelegation.java,0,44,4,2,0,50
hadoop-trunk\hadoop-trunk\hadoop-yarn-project\hadoop-yarn\hadoop-yarn-server\hadoop-yarn-server-resourcemanager\src\test\java\org\apache\hadoop\yarn\server\resourcemanager\TestWorkPreservingUnmanagedAM.java,0,18,3,3,0,24
hadoop-trunk\hadoop-trunk\hadoop-yarn-project\hadoop-yarn\hadoop-yarn-common\src\main\java\org\apache\hadoop\yarn\api\protocolrecords\impl\pb\GetApplicationsRequestPBImpl.java,390,92,88,7,0,187
hadoop-trunk\hadoop-trunk\hadoop-hdfs-project\hadoop-hdfs\src\main\java\org\apache\hadoop\hdfs\server\namenode\XAttrFeature.java,0,9,0,1,0,10
hadoop-trunk\hadoop-trunk\hadoop-hdfs-project\hadoop-hdfs\src\test\java\org\apache\hadoop\hdfs\TestFileAppend.java,0,85,18,5,0,108
hadoop-trunk\hadoop-trunk\hadoop-tools\hadoop-aws\src\main\java\org\apache\hadoop\fs\s3a\S3ListRequest.java,0,8,0,1,0,9
hadoop-trunk\hadoop-trunk\hadoop-tools\hadoop-streaming\src\test\java\org\apache\hadoop\streaming\TestStreamXmlRecordReader.java,33,6,1,1,0,8
hadoop-trunk\hadoop-trunk\hadoop-common-project\hadoop-common\src\main\java\org\apache\hadoop\ipc\RetryCache.java,340,126,2,1,0,129
hadoop-trunk\hadoop-trunk\hadoop-hdfs-project\hadoop-hdfs\src\main\java\org\apache\hadoop\hdfs\protocol\datatransfer\BlackListBasedTrustedChannelResolver.java,114,15,0,1,0,16
hadoop-trunk\hadoop-trunk\hadoop-yarn-project\hadoop-yarn\hadoop-yarn-server\hadoop-yarn-server-common\src\main\java\org\apache\hadoop\yarn\server\federation\policies\dao\package-info.java,0,0,0,1,0,1
hadoop-trunk\hadoop-trunk\hadoop-tools\hadoop-streaming\src\test\java\org\apache\hadoop\streaming\TestStreamJob.java,53,12,1,3,0,16
hadoop-trunk\hadoop-trunk\hadoop-yarn-project\hadoop-yarn\hadoop-yarn-applications\hadoop-yarn-services\hadoop-yarn-services-core\src\main\java\org\apache\hadoop\yarn\service\provider\AbstractClientProvider.java,114,18,2,1,0,21
hadoop-trunk\hadoop-trunk\hadoop-hdfs-project\hadoop-hdfs\src\test\java\org\apache\hadoop\fs\shell\TestHdfsTextCommand.java,0,377,3,3,0,383
hadoop-trunk\hadoop-trunk\hadoop-hdfs-project\hadoop-hdfs-client\src\main\java\org\apache\hadoop\hdfs\protocol\HdfsConstants.java,0,85,1,1,0,87
hadoop-trunk\hadoop-trunk\hadoop-yarn-project\hadoop-yarn\hadoop-yarn-server\hadoop-yarn-server-nodemanager\src\test\java\org\apache\hadoop\yarn\server\nodemanager\containermanager\linux\runtime\docker\TestDockerKillCommand.java,31,8,0,2,0,10
hadoop-trunk\hadoop-trunk\hadoop-common-project\hadoop-auth\src\test\java\org\apache\hadoop\security\authentication\server\TestAuthenticationToken.java,13,1,0,1,0,2
hadoop-trunk\hadoop-trunk\hadoop-common-project\hadoop-common\src\test\java\org\apache\hadoop\io\serializer\avro\TestAvroSerialization.java,95,35,13,1,0,49
hadoop-trunk\hadoop-trunk\hadoop-cloud-storage-project\hadoop-cos\src\main\java\org\apache\hadoop\fs\cosn\ByteBufferWrapper.java,71,17,1,1,0,19
hadoop-trunk\hadoop-trunk\hadoop-common-project\hadoop-common\src\test\java\org\apache\hadoop\fs\contract\ftp\FTPContract.java,31,11,9,1,0,21
hadoop-trunk\hadoop-trunk\hadoop-tools\hadoop-resourceestimator\src\main\java\org\apache\hadoop\resourceestimator\solver\impl\LpSolver.java,289,16,5,6,0,27
hadoop-trunk\hadoop-trunk\hadoop-yarn-project\hadoop-yarn\hadoop-yarn-server\hadoop-yarn-server-resourcemanager\src\test\java\org\apache\hadoop\yarn\server\resourcemanager\nodelabels\TestNodeLabelFileReplication.java,34,2,0,1,0,3
hadoop-trunk\hadoop-trunk\hadoop-hdfs-project\hadoop-hdfs\src\main\java\org\apache\hadoop\hdfs\server\namenode\FileJournalManager.java,652,214,24,9,0,247
hadoop-trunk\hadoop-trunk\hadoop-hdfs-project\hadoop-hdfs-rbf\src\main\java\org\apache\hadoop\hdfs\server\federation\store\protocol\impl\pb\RefreshMountTableEntriesResponsePBImpl.java,0,13,29,5,0,47
hadoop-trunk\hadoop-trunk\hadoop-hdfs-project\hadoop-hdfs\src\main\java\org\apache\hadoop\hdfs\server\protocol\StorageReceivedDeletedBlocks.java,43,15,0,1,0,16
hadoop-trunk\hadoop-trunk\hadoop-yarn-project\hadoop-yarn\hadoop-yarn-server\hadoop-yarn-server-nodemanager\src\test\java\org\apache\hadoop\yarn\server\nodemanager\containermanager\resourceplugin\deviceframework\FakeTestDevicePlugin1.java,0,14,2,2,0,18
hadoop-trunk\hadoop-trunk\hadoop-yarn-project\hadoop-yarn\hadoop-yarn-server\hadoop-yarn-server-timelineservice-hbase\hadoop-yarn-server-timelineservice-hbase-common\src\main\java\org\apache\hadoop\yarn\server\timelineservice\storage\common\LongConverter.java,65,12,2,1,0,15
hadoop-trunk\hadoop-trunk\hadoop-mapreduce-project\hadoop-mapreduce-client\hadoop-mapreduce-client-core\src\test\java\org\apache\hadoop\mapreduce\task\reduce\TestShuffleScheduler.java,331,146,7,28,0,181
hadoop-trunk\hadoop-trunk\hadoop-yarn-project\hadoop-yarn\hadoop-yarn-common\src\main\java\org\apache\hadoop\yarn\api\protocolrecords\impl\pb\GetNewApplicationResponsePBImpl.java,134,50,47,6,0,103
hadoop-trunk\hadoop-trunk\hadoop-mapreduce-project\hadoop-mapreduce-client\hadoop-mapreduce-client-core\src\main\java\org\apache\hadoop\mapreduce\TaskReport.java,202,104,2,1,0,107
hadoop-trunk\hadoop-trunk\hadoop-common-project\hadoop-common\src\main\java\org\apache\hadoop\io\compress\CodecPool.java,212,73,4,7,0,84
hadoop-trunk\hadoop-trunk\hadoop-yarn-project\hadoop-yarn\hadoop-yarn-client\src\test\java\org\apache\hadoop\yarn\client\api\impl\TestAMRMClientContainerRequest.java,248,52,5,1,0,58
hadoop-trunk\hadoop-trunk\hadoop-hdfs-project\hadoop-hdfs\src\test\java\org\apache\hadoop\hdfs\client\impl\TestBlockReaderLocalMetrics.java,179,35,3,1,0,39
hadoop-trunk\hadoop-trunk\hadoop-mapreduce-project\hadoop-mapreduce-client\hadoop-mapreduce-client-core\src\main\java\org\apache\hadoop\mapreduce\TaskType.java,0,5,0,1,0,6
hadoop-trunk\hadoop-trunk\hadoop-yarn-project\hadoop-yarn\hadoop-yarn-server\hadoop-yarn-server-common\src\main\java\org\apache\hadoop\yarn\server\federation\store\records\impl\pb\package-info.java,0,1,0,1,0,2
hadoop-trunk\hadoop-trunk\hadoop-tools\hadoop-azure\src\main\java\org\apache\hadoop\fs\azure\BlobOperationDescriptor.java,0,24,6,1,0,31
hadoop-trunk\hadoop-trunk\hadoop-tools\hadoop-gridmix\src\test\java\org\apache\hadoop\mapred\gridmix\TestDistCacheEmulation.java,375,138,10,16,0,164
hadoop-trunk\hadoop-trunk\hadoop-tools\hadoop-distcp\src\main\java\org\apache\hadoop\tools\util\RetriableCommand.java,80,18,1,3,0,22
hadoop-trunk\hadoop-trunk\hadoop-mapreduce-project\hadoop-mapreduce-client\hadoop-mapreduce-client-nativetask\src\main\java\org\apache\hadoop\mapred\nativetask\NativeRuntime.java,156,63,15,5,0,83
hadoop-trunk\hadoop-trunk\hadoop-yarn-project\hadoop-yarn\hadoop-yarn-server\hadoop-yarn-server-common\src\main\java\org\apache\hadoop\yarn\server\federation\store\records\impl\pb\GetSubClustersInfoResponsePBImpl.java,0,19,42,5,0,66
hadoop-trunk\hadoop-trunk\hadoop-tools\hadoop-azure\src\main\java\org\apache\hadoop\fs\azurebfs\services\AbfsHttpHeader.java,18,9,0,1,0,10
hadoop-trunk\hadoop-trunk\hadoop-tools\hadoop-aws\src\test\java\org\apache\hadoop\fs\s3a\ITestS3ABucketExistence.java,161,23,0,7,0,30
hadoop-trunk\hadoop-trunk\hadoop-yarn-project\hadoop-yarn\hadoop-yarn-server\hadoop-yarn-server-nodemanager\src\test\java\org\apache\hadoop\yarn\server\nodemanager\containermanager\container\TestSlidingWindowRetryPolicy.java,72,17,0,1,0,18
hadoop-trunk\hadoop-trunk\hadoop-tools\hadoop-openstack\src\test\java\org\apache\hadoop\fs\swift\contract\TestSwiftContractSeek.java,8,2,0,1,0,3
hadoop-trunk\hadoop-trunk\hadoop-hdfs-project\hadoop-hdfs\src\test\java\org\apache\hadoop\hdfs\server\blockmanagement\TestPendingReconstruction.java,0,71,10,7,0,88
hadoop-trunk\hadoop-trunk\hadoop-mapreduce-project\hadoop-mapreduce-client\hadoop-mapreduce-client-core\src\main\java\org\apache\hadoop\mapreduce\counters\AbstractCounters.java,0,52,1,5,0,58
hadoop-trunk\hadoop-trunk\hadoop-common-project\hadoop-common\src\test\java\org\apache\hadoop\fs\contract\sftp\TestSFTPContractSeek.java,8,2,0,1,0,3
hadoop-trunk\hadoop-trunk\hadoop-yarn-project\hadoop-yarn\hadoop-yarn-server\hadoop-yarn-server-timelineservice-documentstore\src\main\java\org\apache\hadoop\yarn\server\timelineservice\documentstore\collection\document\entity\TimelineEventSubDoc.java,63,30,0,2,0,32
hadoop-trunk\hadoop-trunk\hadoop-common-project\hadoop-common\src\main\java\org\apache\hadoop\fs\permission\PermissionParser.java,0,85,4,1,0,90
hadoop-trunk\hadoop-trunk\hadoop-hdfs-project\hadoop-hdfs\src\main\java\org\apache\hadoop\hdfs\protocol\LayoutVersion.java,298,132,1,9,0,142
hadoop-trunk\hadoop-trunk\hadoop-mapreduce-project\hadoop-mapreduce-client\hadoop-mapreduce-client-jobclient\src\test\java\org\apache\hadoop\mapred\TestMapOutputType.java,134,47,10,2,0,59
hadoop-trunk\hadoop-trunk\hadoop-yarn-project\hadoop-yarn\hadoop-yarn-server\hadoop-yarn-server-resourcemanager\src\main\java\org\apache\hadoop\yarn\server\resourcemanager\ahs\RMApplicationHistoryWriter.java,295,57,24,16,0,97
hadoop-trunk\hadoop-trunk\hadoop-yarn-project\hadoop-yarn\hadoop-yarn-api\src\main\java\org\apache\hadoop\yarn\api\records\EnhancedHeadroom.java,44,4,0,1,0,5
hadoop-trunk\hadoop-trunk\hadoop-mapreduce-project\hadoop-mapreduce-client\hadoop-mapreduce-client-app\src\main\java\org\apache\hadoop\mapreduce\v2\app\webapp\dao\JobTaskAttemptState.java,20,11,1,1,0,13
hadoop-trunk\hadoop-trunk\hadoop-tools\hadoop-resourceestimator\src\test\java\org\apache\hadoop\resourceestimator\common\serialization\TestResourceSkylineSerDe.java,72,20,1,3,0,24
hadoop-trunk\hadoop-trunk\hadoop-yarn-project\hadoop-yarn\hadoop-yarn-server\hadoop-yarn-server-nodemanager\src\main\java\org\apache\hadoop\yarn\server\nodemanager\api\deviceplugin\DeviceRuntimeSpec.java,0,29,0,1,0,30
hadoop-trunk\hadoop-trunk\hadoop-yarn-project\hadoop-yarn\hadoop-yarn-server\hadoop-yarn-server-resourcemanager\src\test\java\org\apache\hadoop\yarn\server\resourcemanager\scheduler\capacity\conf\TestZKConfigurationStore.java,357,40,1,5,0,46
hadoop-trunk\hadoop-trunk\hadoop-hdfs-project\hadoop-hdfs\src\test\java\org\apache\hadoop\hdfs\server\namenode\metrics\TestNameNodeMetrics.java,1033,180,8,6,0,194
hadoop-trunk\hadoop-trunk\hadoop-yarn-project\hadoop-yarn\hadoop-yarn-api\src\main\java\org\apache\hadoop\yarn\server\api\protocolrecords\AttributeMappingOperationType.java,0,0,0,1,0,1
hadoop-trunk\hadoop-trunk\hadoop-yarn-project\hadoop-yarn\hadoop-yarn-applications\hadoop-yarn-services\hadoop-yarn-services-core\src\test\java\org\apache\hadoop\yarn\service\monitor\TestServiceMonitor.java,84,11,1,1,0,13
hadoop-trunk\hadoop-trunk\hadoop-tools\hadoop-aws\src\test\java\org\apache\hadoop\fs\s3a\scale\ITestS3AConcurrentOps.java,163,26,6,1,0,33
hadoop-trunk\hadoop-trunk\hadoop-common-project\hadoop-common\src\main\java\org\apache\hadoop\metrics2\util\QuantileEstimator.java,0,4,0,1,0,5
hadoop-trunk\hadoop-trunk\hadoop-yarn-project\hadoop-yarn\hadoop-yarn-common\src\main\java\org\apache\hadoop\yarn\server\api\protocolrecords\impl\pb\RefreshQueuesResponsePBImpl.java,42,20,18,3,0,41
hadoop-trunk\hadoop-trunk\hadoop-mapreduce-project\hadoop-mapreduce-examples\src\main\java\org\apache\hadoop\examples\QuasiMonteCarlo.java,294,98,5,4,0,107
hadoop-trunk\hadoop-trunk\hadoop-yarn-project\hadoop-yarn\hadoop-yarn-server\hadoop-yarn-server-timelineservice-hbase\hadoop-yarn-server-timelineservice-hbase-common\src\main\java\org\apache\hadoop\yarn\server\timelineservice\storage\common\HBaseTimelineSchemaUtils.java,0,14,4,2,0,20
hadoop-trunk\hadoop-trunk\hadoop-tools\hadoop-azure\src\test\java\org\apache\hadoop\fs\azurebfs\services\TestAbfsHttpOperation.java,87,6,0,5,0,11
hadoop-trunk\hadoop-trunk\hadoop-hdfs-project\hadoop-hdfs\src\test\java\org\apache\hadoop\fs\contract\hdfs\TestHDFSContractDelete.java,18,4,0,1,0,5
hadoop-trunk\hadoop-trunk\hadoop-tools\hadoop-azure\src\test\java\org\apache\hadoop\fs\azure\TestNativeAzureFileSystemBlockCompaction.java,228,31,2,16,0,49
hadoop-trunk\hadoop-trunk\hadoop-common-project\hadoop-common\src\main\java\org\apache\hadoop\http\ProfileOutputServlet.java,51,18,0,13,0,31
hadoop-trunk\hadoop-trunk\hadoop-mapreduce-project\hadoop-mapreduce-client\hadoop-mapreduce-client-common\src\main\java\org\apache\hadoop\mapred\LocalClientProtocolProvider.java,26,7,0,1,0,8
hadoop-trunk\hadoop-trunk\hadoop-yarn-project\hadoop-yarn\hadoop-yarn-server\hadoop-yarn-server-resourcemanager\src\test\java\org\apache\hadoop\yarn\server\resourcemanager\scheduler\capacity\TestCapacitySchedulerQueueACLs.java,152,23,0,1,0,24
hadoop-trunk\hadoop-trunk\hadoop-common-project\hadoop-common\src\test\java\org\apache\hadoop\fs\TestChecksumFileSystem.java,273,111,15,4,0,130
hadoop-trunk\hadoop-trunk\hadoop-hdfs-project\hadoop-hdfs-client\src\main\java\org\apache\hadoop\hdfs\net\BasicInetPeer.java,103,24,0,1,0,25
hadoop-trunk\hadoop-trunk\hadoop-tools\hadoop-sls\src\test\java\org\apache\hadoop\yarn\sls\TestSLSRunner.java,87,7,2,3,0,12
hadoop-trunk\hadoop-trunk\hadoop-common-project\hadoop-common\src\main\java\org\apache\hadoop\service\launcher\ServiceLauncher.java,0,85,8,1,0,94
hadoop-trunk\hadoop-trunk\hadoop-common-project\hadoop-common\src\main\java\org\apache\hadoop\io\MD5Hash.java,222,126,14,1,0,141
hadoop-trunk\hadoop-trunk\hadoop-yarn-project\hadoop-yarn\hadoop-yarn-server\hadoop-yarn-server-nodemanager\src\main\java\org\apache\hadoop\yarn\server\nodemanager\containermanager\application\ApplicationInitEvent.java,27,15,0,1,0,16
hadoop-trunk\hadoop-trunk\hadoop-hdfs-project\hadoop-hdfs\src\main\java\org\apache\hadoop\hdfs\server\datanode\DataNode.java,0,824,122,125,0,1071
hadoop-trunk\hadoop-trunk\hadoop-yarn-project\hadoop-yarn\hadoop-yarn-server\hadoop-yarn-server-resourcemanager\src\main\java\org\apache\hadoop\yarn\server\resourcemanager\scheduler\constraint\AllocationTagsManager.java,624,77,49,1,0,127
hadoop-trunk\hadoop-trunk\hadoop-hdfs-project\hadoop-hdfs\src\main\java\org\apache\hadoop\hdfs\server\blockmanagement\LowRedundancyBlocks.java,0,123,2,2,0,127
hadoop-trunk\hadoop-trunk\hadoop-mapreduce-project\hadoop-mapreduce-client\hadoop-mapreduce-client-core\src\main\java\org\apache\hadoop\mapred\CumulativePeriodicStats.java,0,9,0,1,0,10
hadoop-trunk\hadoop-trunk\hadoop-yarn-project\hadoop-yarn\hadoop-yarn-common\src\test\java\org\apache\hadoop\yarn\nodelabels\TestFileSystemNodeLabelsStore.java,325,50,1,1,0,52
hadoop-trunk\hadoop-trunk\hadoop-yarn-project\hadoop-yarn\hadoop-yarn-applications\hadoop-yarn-applications-catalog\hadoop-yarn-applications-catalog-webapp\src\main\java\org\apache\hadoop\yarn\appcatalog\utils\RandomWord.java,0,23,5,1,0,29
hadoop-trunk\hadoop-trunk\hadoop-yarn-project\hadoop-yarn\hadoop-yarn-server\hadoop-yarn-server-resourcemanager\src\test\java\org\apache\hadoop\yarn\server\resourcemanager\scheduler\capacity\TestCapacitySchedulerAutoCreatedQueuePreemption.java,0,43,0,1,0,44
hadoop-trunk\hadoop-trunk\hadoop-yarn-project\hadoop-yarn\hadoop-yarn-server\hadoop-yarn-server-resourcemanager\src\main\java\org\apache\hadoop\yarn\server\resourcemanager\webapp\dao\ReservationListInfo.java,24,8,0,1,0,9
hadoop-trunk\hadoop-trunk\hadoop-common-project\hadoop-common\src\test\java\org\apache\hadoop\util\TestNativeLibraryChecker.java,57,11,4,3,0,18
hadoop-trunk\hadoop-trunk\hadoop-mapreduce-project\hadoop-mapreduce-client\hadoop-mapreduce-client-hs\src\main\java\org\apache\hadoop\mapreduce\v2\hs\HistoryStorage.java,0,8,0,1,0,9
hadoop-trunk\hadoop-trunk\hadoop-yarn-project\hadoop-yarn\hadoop-yarn-applications\hadoop-yarn-applications-distributedshell\src\main\java\org\apache\hadoop\yarn\applications\distributedshell\package-info.java,0,1,0,1,0,2
hadoop-trunk\hadoop-trunk\hadoop-tools\hadoop-distcp\src\main\java\org\apache\hadoop\tools\util\WorkReport.java,54,21,0,1,0,22
hadoop-trunk\hadoop-trunk\hadoop-common-project\hadoop-common\src\main\java\org\apache\hadoop\fs\shell\Head.java,0,10,0,1,0,11
hadoop-trunk\hadoop-trunk\hadoop-tools\hadoop-fs2img\src\main\java\org\apache\hadoop\hdfs\server\namenode\SingleUGIResolver.java,62,19,2,1,0,22
hadoop-trunk\hadoop-trunk\hadoop-yarn-project\hadoop-yarn\hadoop-yarn-server\hadoop-yarn-server-timelineservice-hbase\hadoop-yarn-server-timelineservice-hbase-common\src\main\java\org\apache\hadoop\yarn\server\timelineservice\storage\common\AppIdKeyConverter.java,0,3,2,1,0,6
hadoop-trunk\hadoop-trunk\hadoop-common-project\hadoop-common\src\main\java\org\apache\hadoop\fs\shell\SetReplication.java,0,38,2,1,0,41
hadoop-trunk\hadoop-trunk\hadoop-common-project\hadoop-common\src\test\java\org\apache\hadoop\io\compress\zstd\TestZStandardCompressorDecompressor.java,479,84,6,4,0,94
hadoop-trunk\hadoop-trunk\hadoop-mapreduce-project\hadoop-mapreduce-client\hadoop-mapreduce-client-app\src\test\java\org\apache\hadoop\mapreduce\v2\app\job\impl\TestMapReduceChildJVM.java,284,92,2,4,0,98
hadoop-trunk\hadoop-trunk\hadoop-cloud-storage-project\hadoop-huaweicloud\src\main\java\org\apache\hadoop\fs\obs\OBSCommonUtils.java,0,0,12,1,0,13
hadoop-trunk\hadoop-trunk\hadoop-hdfs-project\hadoop-hdfs-client\src\main\java\org\apache\hadoop\hdfs\ClientContext.java,314,50,7,8,0,65
hadoop-trunk\hadoop-trunk\hadoop-mapreduce-project\hadoop-mapreduce-client\hadoop-mapreduce-client-jobclient\src\test\java\org\apache\hadoop\test\MapredTestDriver.java,0,25,2,2,0,29
hadoop-trunk\hadoop-trunk\hadoop-common-project\hadoop-common\src\test\java\org\apache\hadoop\service\launcher\TestServiceLauncherInnerMethods.java,61,6,0,2,0,8
hadoop-trunk\hadoop-trunk\hadoop-hdfs-project\hadoop-hdfs\src\main\java\org\apache\hadoop\hdfs\server\datanode\UnexpectedReplicaStateException.java,17,8,0,1,0,9
hadoop-trunk\hadoop-trunk\hadoop-common-project\hadoop-common\src\main\java\org\apache\hadoop\fs\EmptyStorageStatistics.java,0,3,1,1,0,5
hadoop-trunk\hadoop-trunk\hadoop-mapreduce-project\hadoop-mapreduce-client\hadoop-mapreduce-client-core\src\main\java\org\apache\hadoop\mapred\RecordWriter.java,0,11,0,2,0,13
hadoop-trunk\hadoop-trunk\hadoop-tools\hadoop-azure\src\main\java\org\apache\hadoop\fs\azurebfs\services\AbfsPerfInfo.java,0,46,0,7,0,53
hadoop-trunk\hadoop-trunk\hadoop-yarn-project\hadoop-yarn\hadoop-yarn-common\src\main\java\org\apache\hadoop\yarn\logaggregation\AggregatedLogFormat.java,1002,210,32,4,0,246
hadoop-trunk\hadoop-trunk\hadoop-yarn-project\hadoop-yarn\hadoop-yarn-common\src\main\java\org\apache\hadoop\yarn\api\protocolrecords\impl\pb\ResourceLocalizationResponsePBImpl.java,44,16,18,2,0,36
hadoop-trunk\hadoop-trunk\hadoop-cloud-storage-project\hadoop-huaweicloud\src\test\java\org\apache\hadoop\fs\obs\TestOBSContractAppend.java,13,2,0,1,0,3
hadoop-trunk\hadoop-trunk\hadoop-tools\hadoop-azure\src\test\java\org\apache\hadoop\fs\azurebfs\extensions\package-info.java,0,2,1,1,0,4
hadoop-trunk\hadoop-trunk\hadoop-hdfs-project\hadoop-hdfs\src\test\java\org\apache\hadoop\hdfs\server\datanode\TestDataNodeExit.java,81,22,0,1,0,23
hadoop-trunk\hadoop-trunk\hadoop-common-project\hadoop-registry\src\test\java\org\apache\hadoop\registry\client\impl\TestMicroZookeeperService.java,26,6,1,1,0,8
hadoop-trunk\hadoop-trunk\hadoop-yarn-project\hadoop-yarn\hadoop-yarn-common\src\test\java\org\apache\hadoop\yarn\util\TestTimelineServiceHelper.java,56,1,0,1,0,2
hadoop-trunk\hadoop-trunk\hadoop-yarn-project\hadoop-yarn\hadoop-yarn-server\hadoop-yarn-server-timelineservice-hbase\hadoop-yarn-server-timelineservice-hbase-server\hadoop-yarn-server-timelineservice-hbase-server-1\src\main\java\org\apache\hadoop\yarn\server\timelineservice\storage\package-info.java,0,0,0,1,0,1
hadoop-trunk\hadoop-trunk\hadoop-tools\hadoop-openstack\src\main\java\org\apache\hadoop\fs\swift\http\SwiftProtocolConstants.java,245,78,0,6,0,84
hadoop-trunk\hadoop-trunk\hadoop-hdfs-project\hadoop-hdfs\src\test\java\org\apache\hadoop\hdfs\server\namenode\snapshot\TestDisallowModifyROSnapshot.java,0,71,6,1,0,78
hadoop-trunk\hadoop-trunk\hadoop-mapreduce-project\hadoop-mapreduce-client\hadoop-mapreduce-client-core\src\main\java\org\apache\hadoop\mapreduce\JobSubmitter.java,0,93,17,3,0,113
hadoop-trunk\hadoop-trunk\hadoop-yarn-project\hadoop-yarn\hadoop-yarn-server\hadoop-yarn-server-resourcemanager\src\main\java\org\apache\hadoop\yarn\server\resourcemanager\scheduler\constraint\processor\PlacementConstraintProcessor.java,285,44,7,10,0,61
hadoop-trunk\hadoop-trunk\hadoop-mapreduce-project\hadoop-mapreduce-client\hadoop-mapreduce-client-core\src\main\java\org\apache\hadoop\mapreduce\lib\output\SequenceFileAsBinaryOutputFormat.java,0,86,1,3,0,90
hadoop-trunk\hadoop-trunk\hadoop-tools\hadoop-aws\src\test\java\org\apache\hadoop\fs\s3a\AbstractS3AMockTest.java,45,14,5,1,0,20
hadoop-trunk\hadoop-trunk\hadoop-hdfs-project\hadoop-hdfs\src\main\java\org\apache\hadoop\hdfs\server\namenode\snapshot\SnapshotDeletionGc.java,78,14,4,3,0,21
hadoop-trunk\hadoop-trunk\hadoop-tools\hadoop-gridmix\src\test\java\org\apache\hadoop\mapred\gridmix\TestRecordFactory.java,52,19,3,2,0,24
hadoop-trunk\hadoop-trunk\hadoop-mapreduce-project\hadoop-mapreduce-client\hadoop-mapreduce-client-core\src\main\java\org\apache\hadoop\mapreduce\lib\jobcontrol\ControlledJob.java,0,89,7,3,0,99
hadoop-trunk\hadoop-trunk\hadoop-tools\hadoop-openstack\src\test\java\org\apache\hadoop\fs\swift\hdfs2\TestV2LsOperations.java,100,11,1,2,0,14
hadoop-trunk\hadoop-trunk\hadoop-yarn-project\hadoop-yarn\hadoop-yarn-common\src\main\java\org\apache\hadoop\yarn\api\pb\package-info.java,0,0,0,1,0,1
hadoop-trunk\hadoop-trunk\hadoop-hdfs-project\hadoop-hdfs\src\main\java\org\apache\hadoop\hdfs\server\namenode\FSDirAclOp.java,0,30,1,1,0,32
hadoop-trunk\hadoop-trunk\hadoop-mapreduce-project\hadoop-mapreduce-client\hadoop-mapreduce-client-core\src\main\java\org\apache\hadoop\mapred\join\CompositeRecordReader.java,0,107,7,1,0,115
hadoop-trunk\hadoop-trunk\hadoop-mapreduce-project\hadoop-mapreduce-client\hadoop-mapreduce-client-core\src\main\java\org\apache\hadoop\mapreduce\security\token\package-info.java,0,1,0,1,0,2
hadoop-trunk\hadoop-trunk\hadoop-yarn-project\hadoop-yarn\hadoop-yarn-api\src\main\java\org\apache\hadoop\yarn\api\protocolrecords\GetClusterNodeAttributesResponse.java,35,2,0,1,0,3
hadoop-trunk\hadoop-trunk\hadoop-hdfs-project\hadoop-hdfs-client\src\test\java\org\apache\hadoop\hdfs\web\oauth2\TestRefreshTokenTimeBasedTokenRefresher.java,83,14,3,5,0,22
hadoop-trunk\hadoop-trunk\hadoop-yarn-project\hadoop-yarn\hadoop-yarn-server\hadoop-yarn-server-nodemanager\src\main\java\org\apache\hadoop\yarn\server\nodemanager\webapp\dao\gpu\PerGpuTemperature.java,48,22,0,4,0,26
hadoop-trunk\hadoop-trunk\hadoop-maven-plugins\src\main\java\org\apache\hadoop\maven\plugin\shade\resource\ServicesResourceTransformer.java,0,19,4,1,0,24
hadoop-trunk\hadoop-trunk\hadoop-yarn-project\hadoop-yarn\hadoop-yarn-server\hadoop-yarn-server-nodemanager\src\test\java\org\apache\hadoop\yarn\server\nodemanager\amrmproxy\BaseAMRMProxyTest.java,744,161,33,25,0,219
hadoop-trunk\hadoop-trunk\hadoop-hdfs-project\hadoop-hdfs\src\test\java\org\apache\hadoop\hdfs\TestApplyingStoragePolicy.java,236,14,12,1,0,27
hadoop-trunk\hadoop-trunk\hadoop-yarn-project\hadoop-yarn\hadoop-yarn-server\hadoop-yarn-server-resourcemanager\src\main\java\org\apache\hadoop\yarn\server\resourcemanager\webapp\dao\AppActivitiesInfo.java,65,27,3,2,0,32
hadoop-trunk\hadoop-trunk\hadoop-hdfs-project\hadoop-hdfs\src\test\java\org\apache\hadoop\hdfs\server\datanode\InternalDataNodeTestUtils.java,127,21,2,1,0,24
hadoop-trunk\hadoop-trunk\hadoop-hdfs-project\hadoop-hdfs\src\main\java\org\apache\hadoop\hdfs\util\ReadOnlyList.java,0,42,4,1,0,47
hadoop-trunk\hadoop-trunk\hadoop-common-project\hadoop-common\src\main\java\org\apache\hadoop\crypto\JceAesCtrCryptoCodec.java,37,10,2,1,0,13
hadoop-trunk\hadoop-trunk\hadoop-common-project\hadoop-common\src\main\java\org\apache\hadoop\net\InnerNode.java,0,7,0,1,0,8
hadoop-trunk\hadoop-trunk\hadoop-common-project\hadoop-registry\src\main\java\org\apache\hadoop\registry\client\types\Endpoint.java,0,53,3,1,0,57
hadoop-trunk\hadoop-trunk\hadoop-hdfs-project\hadoop-hdfs\src\test\java\org\apache\hadoop\hdfs\server\namenode\snapshot\TestXAttrWithSnapshot.java,368,57,56,2,0,115
hadoop-trunk\hadoop-trunk\hadoop-hdfs-project\hadoop-hdfs-rbf\src\test\java\org\apache\hadoop\fs\contract\router\TestRouterHDFSContractRootDirectorySecure.java,0,4,0,1,0,5
hadoop-trunk\hadoop-trunk\hadoop-tools\hadoop-gridmix\src\main\java\org\apache\hadoop\mapred\gridmix\GridmixKey.java,0,67,6,1,0,74
hadoop-trunk\hadoop-trunk\hadoop-cloud-storage-project\hadoop-huaweicloud\src\test\java\org\apache\hadoop\fs\obs\OBSTestConstants.java,0,1,0,1,0,2
hadoop-trunk\hadoop-trunk\hadoop-hdfs-project\hadoop-hdfs-client\src\main\java\org\apache\hadoop\hdfs\HdfsConfiguration.java,132,7,1,1,0,9
hadoop-trunk\hadoop-trunk\hadoop-hdfs-project\hadoop-hdfs\src\main\java\org\apache\hadoop\hdfs\qjournal\client\QuorumJournalManager.java,756,207,62,12,0,281
hadoop-trunk\hadoop-trunk\hadoop-mapreduce-project\hadoop-mapreduce-client\hadoop-mapreduce-client-core\src\main\java\org\apache\hadoop\mapreduce\SharedCacheConfig.java,69,21,1,1,0,23
hadoop-trunk\hadoop-trunk\hadoop-cloud-storage-project\hadoop-huaweicloud\src\main\java\org\apache\hadoop\fs\obs\OBSFileSystem.java,0,1,10,1,0,12
hadoop-trunk\hadoop-trunk\hadoop-tools\hadoop-azure\src\test\java\org\apache\hadoop\fs\azurebfs\ITestAzureBlobFileSystemE2E.java,191,35,0,12,0,47
hadoop-trunk\hadoop-trunk\hadoop-mapreduce-project\hadoop-mapreduce-client\hadoop-mapreduce-client-jobclient\src\test\java\org\apache\hadoop\fs\slive\RouletteSelector.java,0,3,0,1,0,4
hadoop-trunk\hadoop-trunk\hadoop-tools\hadoop-resourceestimator\src\main\java\org\apache\hadoop\resourceestimator\skylinestore\exceptions\RecurrenceIdNotFoundException.java,8,1,0,1,0,2
hadoop-trunk\hadoop-trunk\hadoop-hdfs-project\hadoop-hdfs-rbf\src\main\java\org\apache\hadoop\hdfs\protocolPB\RouterAdminProtocolServerSideTranslatorPB.java,237,44,67,77,0,188
hadoop-trunk\hadoop-trunk\hadoop-yarn-project\hadoop-yarn\hadoop-yarn-server\hadoop-yarn-server-resourcemanager\src\main\java\org\apache\hadoop\yarn\server\resourcemanager\resource\DynamicResourceConfiguration.java,113,45,10,1,0,56
hadoop-trunk\hadoop-trunk\hadoop-mapreduce-project\hadoop-mapreduce-client\hadoop-mapreduce-client-core\src\main\java\org\apache\hadoop\mapred\lib\KeyFieldBasedPartitioner.java,0,10,2,1,0,13
hadoop-trunk\hadoop-trunk\hadoop-yarn-project\hadoop-yarn\hadoop-yarn-server\hadoop-yarn-server-resourcemanager\src\main\java\org\apache\hadoop\yarn\server\resourcemanager\scheduler\constraint\TargetApplicationsNamespace.java,282,37,2,5,0,44
hadoop-trunk\hadoop-trunk\hadoop-yarn-project\hadoop-yarn\hadoop-yarn-common\src\main\java\org\apache\hadoop\yarn\api\protocolrecords\impl\pb\GetAllResourceTypeInfoRequestPBImpl.java,0,12,16,2,0,30
hadoop-trunk\hadoop-trunk\hadoop-hdfs-project\hadoop-hdfs\src\main\java\org\apache\hadoop\hdfs\server\namenode\JournalSet.java,712,146,12,7,0,165
hadoop-trunk\hadoop-trunk\hadoop-tools\hadoop-azure\src\test\java\org\apache\hadoop\fs\azurebfs\ITestSmallWriteOptimization.java,458,142,6,22,0,170
hadoop-trunk\hadoop-trunk\hadoop-yarn-project\hadoop-yarn\hadoop-yarn-common\src\main\java\org\apache\hadoop\yarn\api\protocolrecords\impl\pb\GetResourceProfileRequestPBImpl.java,66,13,24,3,0,40
hadoop-trunk\hadoop-trunk\hadoop-yarn-project\hadoop-yarn\hadoop-yarn-common\src\main\java\org\apache\hadoop\yarn\webapp\view\HtmlPage.java,0,15,1,1,0,17
hadoop-trunk\hadoop-trunk\hadoop-hdfs-project\hadoop-hdfs\src\main\java\org\apache\hadoop\hdfs\qjournal\client\IPCLoggerChannel.java,705,161,45,15,0,221
hadoop-trunk\hadoop-trunk\hadoop-common-project\hadoop-common\src\test\java\org\apache\hadoop\metrics2\impl\TestSinkQueue.java,248,38,9,1,0,48
hadoop-trunk\hadoop-trunk\hadoop-hdfs-project\hadoop-hdfs\src\test\java\org\apache\hadoop\hdfs\server\namenode\TestDeleteRace.java,0,79,21,6,0,106
hadoop-trunk\hadoop-trunk\hadoop-mapreduce-project\hadoop-mapreduce-client\hadoop-mapreduce-client-app\src\main\java\org\apache\hadoop\mapreduce\v2\app\TaskHeartbeatHandler.java,190,70,7,2,0,79
hadoop-trunk\hadoop-trunk\hadoop-yarn-project\hadoop-yarn\hadoop-yarn-server\hadoop-yarn-server-timelineservice-hbase\hadoop-yarn-server-timelineservice-hbase-client\src\main\java\org\apache\hadoop\yarn\server\timelineservice\storage\entity\EntityTableRW.java,101,8,1,2,0,11
hadoop-trunk\hadoop-trunk\hadoop-yarn-project\hadoop-yarn\hadoop-yarn-server\hadoop-yarn-server-resourcemanager\src\main\java\org\apache\hadoop\yarn\server\resourcemanager\recovery\MemoryRMStateStore.java,285,66,27,5,0,98
hadoop-trunk\hadoop-trunk\hadoop-hdfs-project\hadoop-hdfs\src\test\java\org\apache\hadoop\hdfs\TestMultipleNNPortQOP.java,252,29,1,8,0,38
hadoop-trunk\hadoop-trunk\hadoop-mapreduce-project\hadoop-mapreduce-client\hadoop-mapreduce-client-nativetask\src\test\java\org\apache\hadoop\mapred\nativetask\buffer\TestByteBufferReadWrite.java,138,49,7,3,0,59
hadoop-trunk\hadoop-trunk\hadoop-tools\hadoop-azure\src\test\java\org\apache\hadoop\fs\azure\integration\AzureTestConstants.java,0,21,42,3,0,66
hadoop-trunk\hadoop-trunk\hadoop-yarn-project\hadoop-yarn\hadoop-yarn-server\hadoop-yarn-server-nodemanager\src\main\java\org\apache\hadoop\yarn\server\nodemanager\containermanager\linux\runtime\DockerLinuxContainerRuntime.java,1236,135,30,28,0,193
hadoop-trunk\hadoop-trunk\hadoop-hdfs-project\hadoop-hdfs\src\test\java\org\apache\hadoop\hdfs\server\namenode\snapshot\TestRenameWithOrderedSnapshotDeletion.java,74,10,0,3,0,13
hadoop-trunk\hadoop-trunk\hadoop-hdfs-project\hadoop-hdfs-nfs\src\main\java\org\apache\hadoop\hdfs\nfs\nfs3\OpenFileCtxCache.java,0,30,1,1,0,32
hadoop-trunk\hadoop-trunk\hadoop-hdfs-project\hadoop-hdfs-rbf\src\test\java\org\apache\hadoop\hdfs\server\federation\router\TestRouterRpc.java,1860,163,7,13,0,183
hadoop-trunk\hadoop-trunk\hadoop-common-project\hadoop-common\src\main\java\org\apache\hadoop\util\ThreadUtil.java,102,13,1,1,0,15
hadoop-trunk\hadoop-trunk\hadoop-yarn-project\hadoop-yarn\hadoop-yarn-server\hadoop-yarn-server-nodemanager\src\main\java\org\apache\hadoop\yarn\server\nodemanager\api\deviceplugin\Device.java,0,34,2,2,0,38
hadoop-trunk\hadoop-trunk\hadoop-yarn-project\hadoop-yarn\hadoop-yarn-server\hadoop-yarn-server-nodemanager\src\main\java\org\apache\hadoop\yarn\server\nodemanager\LinuxContainerExecutor.java,958,134,36,51,0,221
hadoop-trunk\hadoop-trunk\hadoop-yarn-project\hadoop-yarn\hadoop-yarn-server\hadoop-yarn-server-nodemanager\src\main\java\org\apache\hadoop\yarn\server\nodemanager\containermanager\container\ContainerResourceFailedEvent.java,15,8,0,2,0,10
hadoop-trunk\hadoop-trunk\hadoop-yarn-project\hadoop-yarn\hadoop-yarn-api\src\test\java\org\apache\hadoop\yarn\conf\TestYarnConfigurationFields.java,203,9,0,7,0,16
hadoop-trunk\hadoop-trunk\hadoop-yarn-project\hadoop-yarn\hadoop-yarn-api\src\main\java\org\apache\hadoop\yarn\server\api\protocolrecords\UpdateNodeResourceRequest.java,31,11,0,2,0,13
hadoop-trunk\hadoop-trunk\hadoop-yarn-project\hadoop-yarn\hadoop-yarn-common\src\main\java\org\apache\hadoop\yarn\server\api\protocolrecords\impl\pb\RefreshSuperUserGroupsConfigurationResponsePBImpl.java,42,22,18,6,0,46
hadoop-trunk\hadoop-trunk\hadoop-yarn-project\hadoop-yarn\hadoop-yarn-server\hadoop-yarn-server-resourcemanager\src\test\java\org\apache\hadoop\yarn\server\resourcemanager\recovery\TestLeveldbRMStateStore.java,176,38,0,1,0,39
hadoop-trunk\hadoop-trunk\hadoop-hdfs-project\hadoop-hdfs\src\test\java\org\apache\hadoop\hdfs\ErasureCodeBenchmarkThroughput.java,0,110,15,1,0,126
hadoop-trunk\hadoop-trunk\hadoop-yarn-project\hadoop-yarn\hadoop-yarn-api\src\main\java\org\apache\hadoop\yarn\server\api\protocolrecords\RefreshNodesResourcesResponse.java,10,1,1,1,0,3
hadoop-trunk\hadoop-trunk\hadoop-yarn-project\hadoop-yarn\hadoop-yarn-common\src\main\java\org\apache\hadoop\yarn\server\security\ApplicationACLsManager.java,107,30,4,3,0,37
hadoop-trunk\hadoop-trunk\hadoop-yarn-project\hadoop-yarn\hadoop-yarn-server\hadoop-yarn-server-resourcemanager\src\main\java\org\apache\hadoop\yarn\server\resourcemanager\reservation\CapacityOverTimePolicy.java,275,39,6,5,0,50
hadoop-trunk\hadoop-trunk\hadoop-yarn-project\hadoop-yarn\hadoop-yarn-server\hadoop-yarn-server-nodemanager\src\main\java\org\apache\hadoop\yarn\server\nodemanager\util\LCEResourcesHandler.java,0,3,0,1,0,4
hadoop-trunk\hadoop-trunk\hadoop-tools\hadoop-aws\src\test\java\org\apache\hadoop\fs\s3a\audit\SimpleAWSRequestHandler.java,0,1,0,1,0,2
hadoop-trunk\hadoop-trunk\hadoop-common-project\hadoop-common\src\test\java\org\apache\hadoop\fs\contract\localfs\LocalFSContract.java,78,15,1,3,0,19
hadoop-trunk\hadoop-trunk\hadoop-mapreduce-project\hadoop-mapreduce-client\hadoop-mapreduce-client-app\src\main\java\org\apache\hadoop\mapreduce\v2\app\job\event\TaskAttemptDiagnosticsUpdateEvent.java,15,7,0,1,0,8
hadoop-trunk\hadoop-trunk\hadoop-tools\hadoop-sls\src\main\java\org\apache\hadoop\yarn\sls\RMRunner.java,98,33,1,6,0,40
hadoop-trunk\hadoop-trunk\hadoop-yarn-project\hadoop-yarn\hadoop-yarn-api\src\main\java\org\apache\hadoop\yarn\exceptions\YarnException.java,22,9,0,1,0,10
hadoop-trunk\hadoop-trunk\hadoop-mapreduce-project\hadoop-mapreduce-client\hadoop-mapreduce-client-app\src\main\java\org\apache\hadoop\mapreduce\v2\app\webapp\CountersPage.java,30,11,1,1,0,13
hadoop-trunk\hadoop-trunk\hadoop-common-project\hadoop-common\src\main\java\org\apache\hadoop\fs\RawLocalFileSystem.java,1116,246,17,13,0,276
hadoop-trunk\hadoop-trunk\hadoop-tools\hadoop-azure\src\main\java\org\apache\hadoop\fs\azurebfs\utils\TextFileBasedIdentityHandler.java,133,33,9,18,0,60
hadoop-trunk\hadoop-trunk\hadoop-common-project\hadoop-common\src\main\java\org\apache\hadoop\util\WeakReferenceMap.java,0,20,0,3,0,23
hadoop-trunk\hadoop-trunk\hadoop-mapreduce-project\hadoop-mapreduce-client\hadoop-mapreduce-client-app\src\main\java\org\apache\hadoop\mapreduce\v2\app\job\event\JobEventType.java,0,22,0,1,0,23
hadoop-trunk\hadoop-trunk\hadoop-tools\hadoop-openstack\src\main\java\org\apache\hadoop\fs\swift\util\JSONUtil.java,93,12,3,2,0,17
hadoop-trunk\hadoop-trunk\hadoop-hdfs-project\hadoop-hdfs-client\src\main\java\org\apache\hadoop\hdfs\server\namenode\ha\WrappedFailoverProxyProvider.java,42,9,0,1,0,10
hadoop-trunk\hadoop-trunk\hadoop-yarn-project\hadoop-yarn\hadoop-yarn-api\src\main\java\org\apache\hadoop\yarn\api\records\timelineservice\TimelineDomain.java,135,22,2,1,0,25
hadoop-trunk\hadoop-trunk\hadoop-hdfs-project\hadoop-hdfs\src\test\java\org\apache\hadoop\hdfs\TestDFSStripedOutputStreamWithRandomECPolicy.java,18,4,1,1,0,6
hadoop-trunk\hadoop-trunk\hadoop-mapreduce-project\hadoop-mapreduce-client\hadoop-mapreduce-client-jobclient\src\test\java\org\apache\hadoop\mapreduce\v2\TestSpeculativeExecutionWithMRApp.java,279,43,0,4,0,47
hadoop-trunk\hadoop-trunk\hadoop-hdfs-project\hadoop-hdfs\src\test\java\org\apache\hadoop\hdfs\server\namenode\TestFSPermissionChecker.java,387,89,28,4,0,121
hadoop-trunk\hadoop-trunk\hadoop-yarn-project\hadoop-yarn\hadoop-yarn-server\hadoop-yarn-server-nodemanager\src\test\java\org\apache\hadoop\yarn\server\nodemanager\containermanager\scheduler\TestAllocationBasedResourceUtilizationTracker.java,39,7,0,4,0,11
hadoop-trunk\hadoop-trunk\hadoop-common-project\hadoop-common\src\main\java\org\apache\hadoop\fs\QuotaUsage.java,331,106,2,1,0,109
hadoop-trunk\hadoop-trunk\hadoop-common-project\hadoop-nfs\src\main\java\org\apache\hadoop\oncrpc\RpcMessage.java,48,26,0,1,0,27
hadoop-trunk\hadoop-trunk\hadoop-yarn-project\hadoop-yarn\hadoop-yarn-applications\hadoop-yarn-services\hadoop-yarn-services-core\src\main\java\org\apache\hadoop\yarn\service\provider\docker\DockerKeys.java,0,3,2,1,0,6
hadoop-trunk\hadoop-trunk\hadoop-mapreduce-project\hadoop-mapreduce-client\hadoop-mapreduce-client-core\src\test\java\org\apache\hadoop\mapreduce\lib\input\TestFileInputFormat.java,455,112,22,11,0,145
hadoop-trunk\hadoop-trunk\hadoop-common-project\hadoop-common\src\main\java\org\apache\hadoop\metrics2\sink\GraphiteSink.java,0,44,3,7,0,54
hadoop-trunk\hadoop-trunk\hadoop-mapreduce-project\hadoop-mapreduce-client\hadoop-mapreduce-client-core\src\main\java\org\apache\hadoop\mapreduce\jobhistory\ReduceAttemptFinishedEvent.java,243,131,44,1,0,176
hadoop-trunk\hadoop-trunk\hadoop-yarn-project\hadoop-yarn\hadoop-yarn-api\src\main\java\org\apache\hadoop\yarn\exceptions\ConfigurationException.java,17,7,0,1,0,8
hadoop-trunk\hadoop-trunk\hadoop-hdfs-project\hadoop-hdfs\src\main\java\org\apache\hadoop\hdfs\server\datanode\erasurecode\ErasureCodingWorker.java,0,23,2,2,0,27
hadoop-trunk\hadoop-trunk\hadoop-tools\hadoop-aliyun\src\test\java\org\apache\hadoop\fs\aliyun\oss\TestAliyunCredentials.java,53,8,0,1,0,9
hadoop-trunk\hadoop-trunk\hadoop-yarn-project\hadoop-yarn\hadoop-yarn-server\hadoop-yarn-server-resourcemanager\src\test\java\org\apache\hadoop\yarn\server\resourcemanager\scheduler\capacity\TestCapacitySchedulerQueues.java,815,84,12,34,0,130
hadoop-trunk\hadoop-trunk\hadoop-yarn-project\hadoop-yarn\hadoop-yarn-server\hadoop-yarn-server-resourcemanager\src\main\java\org\apache\hadoop\yarn\server\resourcemanager\webapp\dao\QueueAclInfo.java,23,14,0,1,0,15
hadoop-trunk\hadoop-trunk\hadoop-yarn-project\hadoop-yarn\hadoop-yarn-server\hadoop-yarn-server-resourcemanager\src\main\java\org\apache\hadoop\yarn\server\resourcemanager\scheduler\constraint\processor\BatchedRequests.java,0,20,0,5,0,25
hadoop-trunk\hadoop-trunk\hadoop-tools\hadoop-aliyun\src\main\java\org\apache\hadoop\fs\aliyun\oss\AliyunOSSCopyFileContext.java,44,22,0,1,0,23
hadoop-trunk\hadoop-trunk\hadoop-yarn-project\hadoop-yarn\hadoop-yarn-api\src\main\java\org\apache\hadoop\yarn\ams\ApplicationMasterServiceContext.java,0,0,0,1,0,1
hadoop-trunk\hadoop-trunk\hadoop-yarn-project\hadoop-yarn\hadoop-yarn-server\hadoop-yarn-server-resourcemanager\src\main\java\org\apache\hadoop\yarn\server\resourcemanager\webapp\dao\NodeLabelInfo.java,69,28,1,1,0,30
hadoop-trunk\hadoop-trunk\hadoop-common-project\hadoop-common\src\main\java\org\apache\hadoop\fs\shell\Test.java,0,16,2,1,0,19
hadoop-trunk\hadoop-trunk\hadoop-common-project\hadoop-common\src\test\java\org\apache\hadoop\fs\TestFsShell.java,74,6,4,1,0,11
hadoop-trunk\hadoop-trunk\hadoop-common-project\hadoop-common\src\main\java\org\apache\hadoop\util\PrintJarMainClass.java,24,6,3,1,0,10
hadoop-trunk\hadoop-trunk\hadoop-hdfs-project\hadoop-hdfs\src\main\java\org\apache\hadoop\hdfs\server\protocol\BlockStorageMovementCommand.java,99,36,0,1,0,37
hadoop-trunk\hadoop-trunk\hadoop-yarn-project\hadoop-yarn\hadoop-yarn-server\hadoop-yarn-server-nodemanager\src\main\java\org\apache\hadoop\yarn\server\nodemanager\containermanager\localizer\security\LocalizerTokenIdentifier.java,30,7,4,2,0,13
hadoop-trunk\hadoop-trunk\hadoop-hdfs-project\hadoop-hdfs\src\main\java\org\apache\hadoop\hdfs\server\namenode\sps\SPSService.java,0,1,0,1,0,2
hadoop-trunk\hadoop-trunk\hadoop-yarn-project\hadoop-yarn\hadoop-yarn-server\hadoop-yarn-server-timelineservice-hbase\hadoop-yarn-server-timelineservice-hbase-server\hadoop-yarn-server-timelineservice-hbase-server-1\src\main\java\org\apache\hadoop\yarn\server\timelineservice\storage\flow\FlowScanner.java,0,64,16,6,0,86
hadoop-trunk\hadoop-trunk\hadoop-yarn-project\hadoop-yarn\hadoop-yarn-common\src\main\java\org\apache\hadoop\yarn\logaggregation\LogAggregationWebUtils.java,0,15,0,1,0,16
hadoop-trunk\hadoop-trunk\hadoop-hdfs-project\hadoop-hdfs-rbf\src\main\java\org\apache\hadoop\hdfs\server\federation\store\CachedRecordStore.java,0,13,3,1,0,17
hadoop-trunk\hadoop-trunk\hadoop-mapreduce-project\hadoop-mapreduce-client\hadoop-mapreduce-client-core\src\main\java\org\apache\hadoop\mapred\JobClient.java,0,300,21,16,0,337
hadoop-trunk\hadoop-trunk\hadoop-hdfs-project\hadoop-hdfs-client\src\main\java\org\apache\hadoop\hdfs\protocol\ReconfigurationProtocol.java,0,3,0,1,0,4
hadoop-trunk\hadoop-trunk\hadoop-common-project\hadoop-common\src\test\java\org\apache\hadoop\fs\shell\TestPathData.java,248,78,9,1,0,88
hadoop-trunk\hadoop-trunk\hadoop-mapreduce-project\hadoop-mapreduce-client\hadoop-mapreduce-client-hs\src\test\java\org\apache\hadoop\mapreduce\v2\hs\server\TestHSAdminServer.java,304,45,9,1,0,55
hadoop-trunk\hadoop-trunk\hadoop-yarn-project\hadoop-yarn\hadoop-yarn-server\hadoop-yarn-server-resourcemanager\src\main\java\org\apache\hadoop\yarn\server\resourcemanager\recovery\records\impl\pb\EpochPBImpl.java,42,15,22,3,0,40
hadoop-trunk\hadoop-trunk\hadoop-common-project\hadoop-common\src\main\java\org\apache\hadoop\io\retry\RetryUtils.java,173,41,4,1,0,46
hadoop-trunk\hadoop-trunk\hadoop-tools\hadoop-azure\src\test\java\org\apache\hadoop\fs\azurebfs\contract\ITestAbfsFileSystemContractOpen.java,26,6,0,1,0,7
hadoop-trunk\hadoop-trunk\hadoop-yarn-project\hadoop-yarn\hadoop-yarn-common\src\test\java\org\apache\hadoop\yarn\util\TestConverterUtils.java,91,24,1,1,0,26
hadoop-trunk\hadoop-trunk\hadoop-hdfs-project\hadoop-hdfs-httpfs\src\main\java\org\apache\hadoop\lib\wsrs\EnumSetParam.java,0,15,0,2,0,17
hadoop-trunk\hadoop-trunk\hadoop-hdfs-project\hadoop-hdfs-rbf\src\main\java\org\apache\hadoop\hdfs\protocolPB\RouterPolicyProvider.java,21,5,2,1,0,8
hadoop-trunk\hadoop-trunk\hadoop-hdfs-project\hadoop-hdfs-rbf\src\main\java\org\apache\hadoop\hdfs\server\federation\store\impl\package-info.java,0,2,0,1,0,3
hadoop-trunk\hadoop-trunk\hadoop-tools\hadoop-aliyun\src\test\java\org\apache\hadoop\fs\aliyun\oss\contract\TestAliyunOSSContractRootDir.java,38,6,0,1,0,7
hadoop-trunk\hadoop-trunk\hadoop-hdfs-project\hadoop-hdfs\src\test\java\org\apache\hadoop\hdfs\security\TestDelegationTokenForProxyUser.java,133,50,10,6,0,66
hadoop-trunk\hadoop-trunk\hadoop-yarn-project\hadoop-yarn\hadoop-yarn-server\hadoop-yarn-server-resourcemanager\src\main\java\org\apache\hadoop\yarn\server\resourcemanager\reservation\ReservationSchedulerConfiguration.java,147,45,0,5,0,50
hadoop-trunk\hadoop-trunk\hadoop-mapreduce-project\hadoop-mapreduce-client\hadoop-mapreduce-client-core\src\main\java\org\apache\hadoop\mapreduce\MRConfig.java,0,180,76,1,0,257
hadoop-trunk\hadoop-trunk\hadoop-yarn-project\hadoop-yarn\hadoop-yarn-server\hadoop-yarn-server-nodemanager\src\main\java\org\apache\hadoop\yarn\server\nodemanager\DirectoryCollection.java,640,123,10,8,0,141
hadoop-trunk\hadoop-trunk\hadoop-common-project\hadoop-common\dev-support\jdiff\Null.java,4,2,3,1,0,6
hadoop-trunk\hadoop-trunk\hadoop-yarn-project\hadoop-yarn\hadoop-yarn-server\hadoop-yarn-server-applicationhistoryservice\src\main\java\org\apache\hadoop\yarn\server\applicationhistoryservice\ApplicationHistoryServer.java,278,40,7,6,0,53
hadoop-trunk\hadoop-trunk\hadoop-common-project\hadoop-common\src\main\java\org\apache\hadoop\io\VIntWritable.java,0,27,4,2,0,33
hadoop-trunk\hadoop-trunk\hadoop-tools\hadoop-aws\src\test\java\org\apache\hadoop\fs\s3a\scale\NanoTimerStats.java,162,23,2,1,0,26
hadoop-trunk\hadoop-trunk\hadoop-mapreduce-project\hadoop-mapreduce-client\hadoop-mapreduce-client-nativetask\src\main\java\org\apache\hadoop\mapred\nativetask\buffer\InputBuffer.java,108,33,2,1,0,36
hadoop-trunk\hadoop-trunk\hadoop-yarn-project\hadoop-yarn\hadoop-yarn-server\hadoop-yarn-server-resourcemanager\src\test\java\org\apache\hadoop\yarn\server\resourcemanager\scheduler\capacity\TestCapacitySchedulerMaxParallelApps.java,260,55,2,4,0,61
hadoop-trunk\hadoop-trunk\hadoop-mapreduce-project\hadoop-mapreduce-client\hadoop-mapreduce-client-common\src\main\java\org\apache\hadoop\mapreduce\v2\api\protocolrecords\impl\pb\GetCountersResponsePBImpl.java,79,34,33,5,0,72
hadoop-trunk\hadoop-trunk\hadoop-yarn-project\hadoop-yarn\hadoop-yarn-csi\src\test\java\org\apache\hadoop\yarn\csi\adaptor\MockCsiAdaptor.java,43,14,0,3,0,17
hadoop-trunk\hadoop-trunk\hadoop-common-project\hadoop-common\src\test\java\org\apache\hadoop\cli\util\FSCmdExecutor.java,16,11,0,1,0,12
hadoop-trunk\hadoop-trunk\hadoop-hdfs-project\hadoop-hdfs\src\test\java\org\apache\hadoop\hdfs\TestSeekBug.java,180,68,3,2,0,73
hadoop-trunk\hadoop-trunk\hadoop-yarn-project\hadoop-yarn\hadoop-yarn-server\hadoop-yarn-server-resourcemanager\src\test\java\org\apache\hadoop\yarn\server\resourcemanager\scheduler\activities\TestActivitiesManager.java,428,63,9,10,0,82
hadoop-trunk\hadoop-trunk\hadoop-common-project\hadoop-common\src\main\java\org\apache\hadoop\conf\Configurable.java,0,0,0,1,0,1
hadoop-trunk\hadoop-trunk\hadoop-common-project\hadoop-common\src\main\java\org\apache\hadoop\io\erasurecode\rawcoder\NativeXORRawErasureCoderFactory.java,25,7,0,1,0,8
hadoop-trunk\hadoop-trunk\hadoop-hdfs-project\hadoop-hdfs\src\main\java\org\apache\hadoop\hdfs\server\blockmanagement\BlockPlacementStatusDefault.java,38,19,0,1,0,20
hadoop-trunk\hadoop-trunk\hadoop-mapreduce-project\hadoop-mapreduce-client\hadoop-mapreduce-client-common\src\main\java\org\apache\hadoop\mapreduce\v2\api\protocolrecords\KillJobRequest.java,0,7,2,1,0,10
hadoop-trunk\hadoop-trunk\hadoop-mapreduce-project\hadoop-mapreduce-client\hadoop-mapreduce-client-jobclient\src\test\java\org\apache\hadoop\ipc\TestMRCJCSocketFactory.java,0,26,13,1,0,40
hadoop-trunk\hadoop-trunk\hadoop-yarn-project\hadoop-yarn\hadoop-yarn-server\hadoop-yarn-server-resourcemanager\src\test\java\org\apache\hadoop\yarn\server\resourcemanager\scheduler\capacity\conf\TestFSSchedulerConfigurationStore.java,189,16,1,1,0,18
hadoop-trunk\hadoop-trunk\hadoop-yarn-project\hadoop-yarn\hadoop-yarn-common\src\main\java\org\apache\hadoop\yarn\webapp\RemoteExceptionData.java,29,15,1,1,0,17
hadoop-trunk\hadoop-trunk\hadoop-yarn-project\hadoop-yarn\hadoop-yarn-server\hadoop-yarn-server-nodemanager\src\test\java\org\apache\hadoop\yarn\server\nodemanager\containermanager\resourceplugin\deviceframework\FakeTestDevicePlugin3.java,33,7,1,5,0,13
hadoop-trunk\hadoop-trunk\hadoop-hdfs-project\hadoop-hdfs\src\test\java\org\apache\hadoop\hdfs\AppendTestUtil.java,231,150,7,9,0,166
hadoop-trunk\hadoop-trunk\hadoop-hdfs-project\hadoop-hdfs-client\src\main\java\org\apache\hadoop\hdfs\protocol\datatransfer\IOStreamPair.java,16,10,0,1,0,11
hadoop-trunk\hadoop-trunk\hadoop-yarn-project\hadoop-yarn\hadoop-yarn-server\hadoop-yarn-server-common\src\main\java\org\apache\hadoop\yarn\server\federation\store\records\package-info.java,0,1,0,1,0,2
hadoop-trunk\hadoop-trunk\hadoop-hdfs-project\hadoop-hdfs\src\main\java\org\apache\hadoop\hdfs\tools\snapshot\LsSnapshottableDir.java,36,14,2,3,0,19
hadoop-trunk\hadoop-trunk\hadoop-hdfs-project\hadoop-hdfs-client\src\main\java\org\apache\hadoop\hdfs\web\resources\XAttrValueParam.java,23,6,1,1,0,8
hadoop-trunk\hadoop-trunk\hadoop-tools\hadoop-sls\src\main\java\org\apache\hadoop\yarn\sls\nodemanager\NodeInfo.java,222,61,8,3,0,72
hadoop-trunk\hadoop-trunk\hadoop-yarn-project\hadoop-yarn\hadoop-yarn-applications\hadoop-yarn-services\hadoop-yarn-services-core\src\main\java\org\apache\hadoop\yarn\service\utils\PatternValidator.java,34,11,0,1,0,12
hadoop-trunk\hadoop-trunk\hadoop-yarn-project\hadoop-yarn\hadoop-yarn-server\hadoop-yarn-server-timelineservice-hbase-tests\src\test\java\org\apache\hadoop\yarn\server\timelineservice\storage\TestHBaseTimelineStorageEntities.java,1797,239,39,31,0,309
hadoop-trunk\hadoop-trunk\hadoop-mapreduce-project\hadoop-mapreduce-client\hadoop-mapreduce-client-core\src\test\java\org\apache\hadoop\mapreduce\task\reduce\TestFetcher.java,769,302,15,14,0,331
hadoop-trunk\hadoop-trunk\hadoop-yarn-project\hadoop-yarn\hadoop-yarn-server\hadoop-yarn-server-nodemanager\src\test\java\org\apache\hadoop\yarn\server\nodemanager\api\impl\pb\TestNMProtoUtils.java,78,7,12,7,0,26
hadoop-trunk\hadoop-trunk\hadoop-yarn-project\hadoop-yarn\hadoop-yarn-server\hadoop-yarn-server-common\src\main\java\org\apache\hadoop\yarn\server\federation\policies\exceptions\package-info.java,0,0,0,1,0,1
hadoop-trunk\hadoop-trunk\hadoop-tools\hadoop-streaming\src\test\java\org\apache\hadoop\streaming\TrApp.java,0,37,5,1,0,43
hadoop-trunk\hadoop-trunk\hadoop-common-project\hadoop-registry\src\main\java\org\apache\hadoop\registry\client\api\DNSOperations.java,0,0,0,1,0,1
hadoop-trunk\hadoop-trunk\hadoop-tools\hadoop-azure-datalake\src\test\java\org\apache\hadoop\fs\adl\live\TestAdlContractGetFileStatusLive.java,8,2,0,1,0,3
hadoop-trunk\hadoop-trunk\hadoop-tools\hadoop-openstack\src\main\java\org\apache\hadoop\fs\swift\exceptions\SwiftOperationFailedException.java,11,5,0,1,0,6
hadoop-trunk\hadoop-trunk\hadoop-yarn-project\hadoop-yarn\hadoop-yarn-common\src\main\java\org\apache\hadoop\yarn\api\records\impl\pb\CollectorInfoPBImpl.java,122,24,39,1,0,64
hadoop-trunk\hadoop-trunk\hadoop-common-project\hadoop-registry\src\test\java\org\apache\hadoop\registry\secure\TestRegistrySecurityHelper.java,172,45,3,1,0,49
hadoop-trunk\hadoop-trunk\hadoop-tools\hadoop-aws\src\main\java\org\apache\hadoop\fs\s3a\impl\StatusProbeEnum.java,0,0,0,1,0,1
hadoop-trunk\hadoop-trunk\hadoop-yarn-project\hadoop-yarn\hadoop-yarn-common\src\main\java\org\apache\hadoop\yarn\api\protocolrecords\impl\pb\SubmitApplicationResponsePBImpl.java,41,21,18,3,0,42
hadoop-trunk\hadoop-trunk\hadoop-tools\hadoop-rumen\src\main\java\org\apache\hadoop\tools\rumen\Job20LineHistoryEventEmitter.java,240,40,2,2,0,44
hadoop-trunk\hadoop-trunk\hadoop-common-project\hadoop-common\src\main\java\org\apache\hadoop\metrics2\lib\MetricsAnnotations.java,17,4,1,1,0,6
hadoop-trunk\hadoop-trunk\hadoop-mapreduce-project\hadoop-mapreduce-client\hadoop-mapreduce-client-jobclient\src\test\java\org\apache\hadoop\mapred\TestLocalJobSubmission.java,172,13,11,1,0,25
hadoop-trunk\hadoop-trunk\hadoop-yarn-project\hadoop-yarn\hadoop-yarn-server\hadoop-yarn-server-nodemanager\src\main\java\org\apache\hadoop\yarn\server\nodemanager\containermanager\linux\resources\NetworkTagMappingManagerFactory.java,0,5,1,2,0,8
hadoop-trunk\hadoop-trunk\hadoop-yarn-project\hadoop-yarn\hadoop-yarn-common\src\main\java\org\apache\hadoop\yarn\api\protocolrecords\impl\pb\ReservationSubmissionRequestPBImpl.java,150,34,53,4,0,91
hadoop-trunk\hadoop-trunk\hadoop-common-project\hadoop-common\src\main\java\org\apache\hadoop\security\RuleBasedLdapGroupsMapping.java,70,14,1,1,0,16
hadoop-trunk\hadoop-trunk\hadoop-yarn-project\hadoop-yarn\hadoop-yarn-server\hadoop-yarn-server-resourcemanager\src\main\java\org\apache\hadoop\yarn\server\resourcemanager\scheduler\capacity\conf\ZKConfigurationStore.java,296,66,6,1,0,73
hadoop-trunk\hadoop-trunk\hadoop-hdfs-project\hadoop-hdfs-client\src\main\java\org\apache\hadoop\hdfs\XAttrHelper.java,141,38,3,1,0,42
hadoop-trunk\hadoop-trunk\hadoop-common-project\hadoop-common\src\main\java\org\apache\hadoop\io\file\tfile\Chunk.java,0,71,7,1,0,79
hadoop-trunk\hadoop-trunk\hadoop-hdfs-project\hadoop-hdfs\src\main\java\org\apache\hadoop\hdfs\server\namenode\ha\StandbyCheckpointer.java,452,95,8,16,0,119
hadoop-trunk\hadoop-trunk\hadoop-yarn-project\hadoop-yarn\hadoop-yarn-server\hadoop-yarn-server-resourcemanager\src\test\java\org\apache\hadoop\yarn\server\resourcemanager\ahs\TestRMApplicationHistoryWriter.java,488,79,9,12,0,100
hadoop-trunk\hadoop-trunk\hadoop-tools\hadoop-aws\src\test\java\org\apache\hadoop\fs\contract\s3a\ITestS3AContractOpen.java,17,2,0,1,0,3
hadoop-trunk\hadoop-trunk\hadoop-yarn-project\hadoop-yarn\hadoop-yarn-applications\hadoop-yarn-services\hadoop-yarn-services-core\src\main\java\org\apache\hadoop\yarn\service\registry\CustomRegistryConstants.java,35,16,0,1,0,17
hadoop-trunk\hadoop-trunk\hadoop-hdfs-project\hadoop-hdfs-client\src\main\java\org\apache\hadoop\hdfs\protocol\datatransfer\BlockPinningException.java,10,2,0,1,0,3
hadoop-trunk\hadoop-trunk\hadoop-yarn-project\hadoop-yarn\hadoop-yarn-csi\src\test\java\org\apache\hadoop\yarn\csi\client\TestCsiClient.java,46,9,4,2,0,15
hadoop-trunk\hadoop-trunk\hadoop-mapreduce-project\hadoop-mapreduce-client\hadoop-mapreduce-client-common\src\main\java\org\apache\hadoop\mapreduce\v2\api\MRClientProtocol.java,0,41,15,27,0,83
hadoop-trunk\hadoop-trunk\hadoop-common-project\hadoop-common\src\main\java\org\apache\hadoop\http\WebServlet.java,28,5,1,1,0,7
hadoop-trunk\hadoop-trunk\hadoop-tools\hadoop-rumen\src\main\java\org\apache\hadoop\tools\rumen\serializers\DefaultAnonymizingRumenSerializer.java,0,19,3,1,0,23
hadoop-trunk\hadoop-trunk\hadoop-yarn-project\hadoop-yarn\hadoop-yarn-server\hadoop-yarn-server-resourcemanager\src\main\java\org\apache\hadoop\yarn\server\resourcemanager\rmcontainer\RMContainerEventType.java,0,18,0,1,0,19
hadoop-trunk\hadoop-trunk\hadoop-yarn-project\hadoop-yarn\hadoop-yarn-server\hadoop-yarn-server-resourcemanager\src\main\java\org\apache\hadoop\yarn\server\resourcemanager\scheduler\AbstractYarnScheduler.java,0,261,45,23,0,329
hadoop-trunk\hadoop-trunk\hadoop-tools\hadoop-azure-datalake\src\test\java\org\apache\hadoop\fs\adl\live\TestAdlSupportedCharsetInPath.java,291,33,1,2,0,36
hadoop-trunk\hadoop-trunk\hadoop-tools\hadoop-azure\src\test\java\org\apache\hadoop\fs\azure\ITestNativeAzureFileSystemContractPageBlobLive.java,77,16,7,2,0,25
hadoop-trunk\hadoop-trunk\hadoop-yarn-project\hadoop-yarn\hadoop-yarn-server\hadoop-yarn-server-nodemanager\src\test\java\org\apache\hadoop\yarn\server\nodemanager\security\TestNMContainerTokenSecretManager.java,103,10,2,2,0,14
hadoop-trunk\hadoop-trunk\hadoop-yarn-project\hadoop-yarn\hadoop-yarn-api\src\main\java\org\apache\hadoop\yarn\api\records\ResourceRequest.java,612,93,10,3,0,106
hadoop-trunk\hadoop-trunk\hadoop-yarn-project\hadoop-yarn\hadoop-yarn-common\src\test\java\org\apache\hadoop\yarn\api\TestContainerId.java,57,39,0,1,0,40
hadoop-trunk\hadoop-trunk\hadoop-tools\hadoop-openstack\src\test\java\org\apache\hadoop\fs\swift\TestReadPastBuffer.java,0,18,5,1,0,24
hadoop-trunk\hadoop-trunk\hadoop-common-project\hadoop-common\src\main\java\org\apache\hadoop\io\erasurecode\codec\DummyErasureCodec.java,16,5,0,1,0,6
hadoop-trunk\hadoop-trunk\hadoop-hdfs-project\hadoop-hdfs\src\test\java\org\apache\hadoop\hdfs\server\datanode\checker\TestStorageLocationChecker.java,199,32,7,4,0,43
hadoop-trunk\hadoop-trunk\hadoop-mapreduce-project\hadoop-mapreduce-client\hadoop-mapreduce-client-common\src\main\java\org\apache\hadoop\mapreduce\v2\api\protocolrecords\FailTaskAttemptResponse.java,0,0,0,1,0,1
hadoop-trunk\hadoop-trunk\hadoop-yarn-project\hadoop-yarn\hadoop-yarn-server\hadoop-yarn-server-timelineservice-documentstore\src\main\java\org\apache\hadoop\yarn\server\timelineservice\documentstore\collection\document\NoDocumentFoundException.java,11,3,0,3,0,6
hadoop-trunk\hadoop-trunk\hadoop-mapreduce-project\hadoop-mapreduce-client\hadoop-mapreduce-client-jobclient\src\main\java\org\apache\hadoop\mapred\ClientCache.java,85,22,3,2,0,27
hadoop-trunk\hadoop-trunk\hadoop-yarn-project\hadoop-yarn\hadoop-yarn-server\hadoop-yarn-server-resourcemanager\src\main\java\org\apache\hadoop\yarn\server\resourcemanager\recovery\RMStateStoreRemoveAppEvent.java,13,8,0,2,0,10
hadoop-trunk\hadoop-trunk\hadoop-hdfs-project\hadoop-hdfs\src\test\java\org\apache\hadoop\hdfs\TestDataTransferKeepalive.java,216,71,5,10,0,86
hadoop-trunk\hadoop-trunk\hadoop-common-project\hadoop-common\src\test\java\org\apache\hadoop\util\TestInstrumentedReadWriteLock.java,202,34,0,1,0,35
hadoop-trunk\hadoop-trunk\hadoop-yarn-project\hadoop-yarn\hadoop-yarn-common\src\main\java\org\apache\hadoop\yarn\sharedcache\SharedCacheChecksumFactory.java,48,10,1,1,0,12
hadoop-trunk\hadoop-trunk\hadoop-common-project\hadoop-common\src\test\java\org\apache\hadoop\fs\contract\rawlocal\TestRawlocalContractSetTimes.java,9,2,0,1,0,3
hadoop-trunk\hadoop-trunk\hadoop-yarn-project\hadoop-yarn\hadoop-yarn-applications\hadoop-yarn-services\hadoop-yarn-services-core\src\main\java\org\apache\hadoop\yarn\service\registry\YarnRegistryViewForProviders.java,209,43,5,2,0,50
hadoop-trunk\hadoop-trunk\hadoop-common-project\hadoop-common\src\main\java\org\apache\hadoop\io\erasurecode\ErasureCoderOptions.java,0,19,0,1,0,20
hadoop-trunk\hadoop-trunk\hadoop-hdfs-project\hadoop-hdfs\src\test\java\org\apache\hadoop\hdfs\server\namenode\snapshot\TestSnapshotBlocksMap.java,367,84,1,4,0,89
hadoop-trunk\hadoop-trunk\hadoop-hdfs-project\hadoop-hdfs\src\test\java\org\apache\hadoop\hdfs\server\namenode\TestEncryptionZoneManager.java,125,19,0,1,0,20
hadoop-trunk\hadoop-trunk\hadoop-hdfs-project\hadoop-hdfs\src\main\java\org\apache\hadoop\hdfs\server\namenode\EditLogInputException.java,18,11,0,1,0,12
hadoop-trunk\hadoop-trunk\hadoop-yarn-project\hadoop-yarn\hadoop-yarn-server\hadoop-yarn-server-timelineservice\src\test\java\org\apache\hadoop\yarn\server\timelineservice\storage\TestFileSystemTimelineWriterImpl.java,235,38,9,3,0,50
hadoop-trunk\hadoop-trunk\hadoop-common-project\hadoop-common\src\main\java\org\apache\hadoop\crypto\OpensslSm4CtrCryptoCodec.java,47,12,0,2,0,14
hadoop-trunk\hadoop-trunk\hadoop-yarn-project\hadoop-yarn\hadoop-yarn-server\hadoop-yarn-server-common\src\main\java\org\apache\hadoop\yarn\server\volume\csi\VolumeId.java,34,10,0,1,0,11
hadoop-trunk\hadoop-trunk\hadoop-yarn-project\hadoop-yarn\hadoop-yarn-common\src\test\java\org\apache\hadoop\yarn\webapp\view\HtmlBlockForTest.java,8,2,0,1,0,3
hadoop-trunk\hadoop-trunk\hadoop-common-project\hadoop-minikdc\src\test\java\org\apache\hadoop\minikdc\TestMiniKdc.java,137,18,0,1,0,19
hadoop-trunk\hadoop-trunk\hadoop-hdfs-project\hadoop-hdfs-rbf\src\main\java\org\apache\hadoop\hdfs\server\federation\store\protocol\GetMountTableEntriesResponse.java,24,6,0,2,0,8
hadoop-trunk\hadoop-trunk\hadoop-tools\hadoop-openstack\src\test\java\org\apache\hadoop\fs\swift\TestSwiftFileSystemPartitionedUploads.java,397,40,20,3,0,63
hadoop-trunk\hadoop-trunk\hadoop-hdfs-project\hadoop-hdfs\src\test\java\org\apache\hadoop\hdfs\TestReadStripedFileWithDNFailure.java,64,18,2,7,0,27
hadoop-trunk\hadoop-trunk\hadoop-mapreduce-project\hadoop-mapreduce-client\hadoop-mapreduce-client-common\src\main\java\org\apache\hadoop\mapreduce\v2\api\protocolrecords\GetDelegationTokenResponse.java,0,2,0,1,0,3
hadoop-trunk\hadoop-trunk\hadoop-tools\hadoop-azure-datalake\src\test\java\org\apache\hadoop\fs\adl\TestAzureADTokenProvider.java,266,25,15,1,0,41
hadoop-trunk\hadoop-trunk\hadoop-mapreduce-project\hadoop-mapreduce-client\hadoop-mapreduce-client-app\src\main\java\org\apache\hadoop\mapreduce\v2\app\client\MRClientService.java,345,87,6,21,0,114
hadoop-trunk\hadoop-trunk\hadoop-tools\hadoop-azure\src\test\java\org\apache\hadoop\fs\azurebfs\ITestAbfsStreamStatistics.java,139,12,1,4,0,17
hadoop-trunk\hadoop-trunk\hadoop-yarn-project\hadoop-yarn\hadoop-yarn-common\src\main\java\org\apache\hadoop\yarn\util\AsyncCallback.java,0,0,0,1,0,1
hadoop-trunk\hadoop-trunk\hadoop-yarn-project\hadoop-yarn\hadoop-yarn-server\hadoop-yarn-server-resourcemanager\src\test\java\org\apache\hadoop\yarn\server\resourcemanager\scheduler\capacity\TestCapacitySchedulerConfiguration.java,129,51,0,12,0,63
hadoop-trunk\hadoop-trunk\hadoop-hdfs-project\hadoop-hdfs\src\main\java\org\apache\hadoop\hdfs\server\datanode\fsdataset\impl\MappableBlockLoader.java,155,23,0,1,0,24
hadoop-trunk\hadoop-trunk\hadoop-mapreduce-project\hadoop-mapreduce-client\hadoop-mapreduce-client-app\src\test\java\org\apache\hadoop\mapreduce\v2\app\rm\TestResourceCalculatorUtils.java,48,11,1,1,0,13
hadoop-trunk\hadoop-trunk\hadoop-tools\hadoop-rumen\src\main\java\org\apache\hadoop\tools\rumen\ZombieJob.java,890,185,48,11,0,244
hadoop-trunk\hadoop-trunk\hadoop-tools\hadoop-azure-datalake\src\main\java\org\apache\hadoop\fs\adl\oauth2\package-info.java,0,1,0,1,0,2
hadoop-trunk\hadoop-trunk\hadoop-yarn-project\hadoop-yarn\hadoop-yarn-server\hadoop-yarn-server-resourcemanager\src\main\java\org\apache\hadoop\yarn\server\resourcemanager\scheduler\SchedulerDynamicEditException.java,10,2,0,1,0,3
hadoop-trunk\hadoop-trunk\hadoop-yarn-project\hadoop-yarn\hadoop-yarn-server\hadoop-yarn-server-resourcemanager\src\main\java\org\apache\hadoop\yarn\server\resourcemanager\reservation\ReservationSystemUtil.java,0,32,29,1,0,62
hadoop-trunk\hadoop-trunk\hadoop-tools\hadoop-azure\src\main\java\org\apache\hadoop\fs\azurebfs\extensions\ExtensionHelper.java,0,11,0,2,0,13
hadoop-trunk\hadoop-trunk\hadoop-tools\hadoop-azure\src\main\java\org\apache\hadoop\fs\azurebfs\Abfss.java,13,2,0,2,0,4
hadoop-trunk\hadoop-trunk\hadoop-yarn-project\hadoop-yarn\hadoop-yarn-client\src\test\java\org\apache\hadoop\yarn\client\api\impl\AMRMTokenIdentifierForTest.java,93,58,38,3,0,99
hadoop-trunk\hadoop-trunk\hadoop-mapreduce-project\hadoop-mapreduce-client\hadoop-mapreduce-client-common\src\main\java\org\apache\hadoop\mapred\LocalDistributedCacheManager.java,0,41,11,2,0,54
hadoop-trunk\hadoop-trunk\hadoop-hdfs-project\hadoop-hdfs\src\test\java\org\apache\hadoop\hdfs\server\namenode\snapshot\TestINodeFileUnderConstructionWithSnapshot.java,254,74,1,4,0,79
hadoop-trunk\hadoop-trunk\hadoop-yarn-project\hadoop-yarn\hadoop-yarn-server\hadoop-yarn-server-resourcemanager\src\test\java\org\apache\hadoop\yarn\server\resourcemanager\volume\csi\TestVolumeLifecycle.java,151,10,8,7,0,25
hadoop-trunk\hadoop-trunk\hadoop-tools\hadoop-sls\src\main\java\org\apache\hadoop\yarn\sls\AMDefinition.java,83,64,1,1,0,66
hadoop-trunk\hadoop-trunk\hadoop-hdfs-project\hadoop-hdfs-rbf\src\main\java\org\apache\hadoop\hdfs\server\federation\store\records\MountTable.java,428,31,2,2,0,35
hadoop-trunk\hadoop-trunk\hadoop-tools\hadoop-aws\src\test\java\org\apache\hadoop\fs\contract\s3a\ITestS3AContractEtag.java,8,2,0,1,0,3
hadoop-trunk\hadoop-trunk\hadoop-tools\hadoop-distcp\src\test\java\org\apache\hadoop\tools\contract\TestHDFSContractDistCp.java,28,4,0,1,0,5
hadoop-trunk\hadoop-trunk\hadoop-tools\hadoop-azure\src\test\java\org\apache\hadoop\fs\azurebfs\utils\AbfsTestUtils.java,0,8,2,6,0,16
hadoop-trunk\hadoop-trunk\hadoop-common-project\hadoop-common\src\main\java\org\apache\hadoop\fs\shell\find\Print.java,0,14,0,1,0,15
hadoop-trunk\hadoop-trunk\hadoop-common-project\hadoop-nfs\src\main\java\org\apache\hadoop\oncrpc\security\RpcAuthInfo.java,56,27,0,1,0,28
hadoop-trunk\hadoop-trunk\hadoop-hdfs-project\hadoop-hdfs\src\main\java\org\apache\hadoop\hdfs\server\common\FileRegion.java,53,29,0,1,0,30
hadoop-trunk\hadoop-trunk\hadoop-common-project\hadoop-common\src\main\java\org\apache\hadoop\io\compress\bzip2\CRC.java,0,16,2,1,0,19
hadoop-trunk\hadoop-trunk\hadoop-hdfs-project\hadoop-hdfs-httpfs\src\main\java\org\apache\hadoop\fs\http\server\HttpFSReleaseFilter.java,15,1,0,2,0,3
hadoop-trunk\hadoop-trunk\hadoop-yarn-project\hadoop-yarn\hadoop-yarn-client\src\main\java\org\apache\hadoop\yarn\client\api\SharedCacheClient.java,78,6,1,1,0,8
hadoop-trunk\hadoop-trunk\hadoop-common-project\hadoop-common\src\test\java\org\apache\hadoop\io\TestGenericWritable.java,156,62,8,4,0,74
hadoop-trunk\hadoop-trunk\hadoop-mapreduce-project\hadoop-mapreduce-client\hadoop-mapreduce-client-jobclient\src\test\java\org\apache\hadoop\util\Hello.java,13,6,3,1,0,10
hadoop-trunk\hadoop-trunk\hadoop-tools\hadoop-distcp\src\main\java\org\apache\hadoop\tools\mapred\DeletedDirTracker.java,0,6,0,1,0,7
hadoop-trunk\hadoop-trunk\hadoop-common-project\hadoop-common\src\main\java\org\apache\hadoop\io\ArrayWritable.java,0,38,3,2,0,43
hadoop-trunk\hadoop-trunk\hadoop-yarn-project\hadoop-yarn\hadoop-yarn-api\src\main\java\org\apache\hadoop\yarn\ams\ApplicationMasterServiceProcessor.java,0,0,0,3,0,3
hadoop-trunk\hadoop-trunk\hadoop-common-project\hadoop-common\src\main\java\org\apache\hadoop\fs\http\HttpsFileSystem.java,7,1,0,1,0,2
hadoop-trunk\hadoop-trunk\hadoop-common-project\hadoop-nfs\src\test\java\org\apache\hadoop\oncrpc\security\TestCredentialsSys.java,61,17,2,1,0,20
hadoop-trunk\hadoop-trunk\hadoop-yarn-project\hadoop-yarn\hadoop-yarn-common\src\main\java\org\apache\hadoop\yarn\api\protocolrecords\impl\pb\FinishApplicationMasterRequestPBImpl.java,121,36,47,9,0,92
hadoop-trunk\hadoop-trunk\hadoop-yarn-project\hadoop-yarn\hadoop-yarn-server\hadoop-yarn-server-timelineservice\src\main\java\org\apache\hadoop\yarn\server\timelineservice\collector\AppLevelTimelineCollectorWithAgg.java,0,16,0,2,0,18
hadoop-trunk\hadoop-trunk\hadoop-common-project\hadoop-common\src\main\java\org\apache\hadoop\conf\ReconfigurationUtil.java,48,25,0,1,0,26
hadoop-trunk\hadoop-trunk\hadoop-yarn-project\hadoop-yarn\hadoop-yarn-applications\hadoop-yarn-services\hadoop-yarn-services-core\src\test\java\org\apache\hadoop\yarn\service\conf\TestLoadExampleAppJson.java,33,6,2,1,0,9
hadoop-trunk\hadoop-trunk\hadoop-yarn-project\hadoop-yarn\hadoop-yarn-server\hadoop-yarn-server-resourcemanager\src\main\java\org\apache\hadoop\yarn\server\resourcemanager\rmnode\RMNodeCleanContainerEvent.java,14,7,0,1,0,8
hadoop-trunk\hadoop-trunk\hadoop-mapreduce-project\hadoop-mapreduce-client\hadoop-mapreduce-client-jobclient\src\test\java\org\apache\hadoop\mapred\TestMiniMRClientCluster.java,190,39,5,2,0,46
hadoop-trunk\hadoop-trunk\hadoop-yarn-project\hadoop-yarn\hadoop-yarn-server\hadoop-yarn-server-nodemanager\src\main\java\org\apache\hadoop\yarn\server\nodemanager\containermanager\deletion\task\FileDeletionTask.java,162,20,12,3,0,35
hadoop-trunk\hadoop-trunk\hadoop-common-project\hadoop-common\src\main\java\org\apache\hadoop\fs\statistics\impl\package-info.java,0,0,0,1,0,1
hadoop-trunk\hadoop-trunk\hadoop-yarn-project\hadoop-yarn\hadoop-yarn-common\src\main\java\org\apache\hadoop\yarn\webapp\view\TextView.java,57,9,2,1,0,12
hadoop-trunk\hadoop-trunk\hadoop-yarn-project\hadoop-yarn\hadoop-yarn-server\hadoop-yarn-server-timeline-pluginstorage\src\main\java\org\apache\hadoop\yarn\server\timeline\LogInfo.java,0,52,6,1,0,59
hadoop-trunk\hadoop-trunk\hadoop-yarn-project\hadoop-yarn\hadoop-yarn-common\src\main\java\org\apache\hadoop\yarn\factories\impl\pb\RecordFactoryPBImpl.java,67,20,6,3,0,29
hadoop-trunk\hadoop-trunk\hadoop-common-project\hadoop-common\src\main\java\org\apache\hadoop\io\compress\zlib\package-info.java,0,1,0,1,0,2
hadoop-trunk\hadoop-trunk\hadoop-common-project\hadoop-common\src\test\java\org\apache\hadoop\service\launcher\testservices\ExceptionInExecuteLaunchableService.java,63,24,0,2,0,26
hadoop-trunk\hadoop-trunk\hadoop-yarn-project\hadoop-yarn\hadoop-yarn-api\src\main\java\org\apache\hadoop\yarn\api\ApplicationClientProtocol.java,0,89,17,14,0,120
hadoop-trunk\hadoop-trunk\hadoop-mapreduce-project\hadoop-mapreduce-client\hadoop-mapreduce-client-app\src\test\java\org\apache\hadoop\mapreduce\v2\app\webapp\TestAMWebServicesAttempt.java,205,13,0,2,0,15
hadoop-trunk\hadoop-trunk\hadoop-yarn-project\hadoop-yarn\hadoop-yarn-server\hadoop-yarn-server-resourcemanager\src\main\java\org\apache\hadoop\yarn\server\resourcemanager\rmcontainer\RMContainerFinishedEvent.java,15,7,0,1,0,8
hadoop-trunk\hadoop-trunk\hadoop-common-project\hadoop-common\src\main\java\org\apache\hadoop\fs\ftp\FTPException.java,17,7,0,1,0,8
hadoop-trunk\hadoop-trunk\hadoop-tools\hadoop-azure\src\test\java\org\apache\hadoop\fs\azurebfs\TestAbfsInputStreamStatistics.java,32,2,1,1,0,4
hadoop-trunk\hadoop-trunk\hadoop-yarn-project\hadoop-yarn\hadoop-yarn-api\src\main\java\org\apache\hadoop\yarn\api\records\SignalContainerCommand.java,0,0,0,1,0,1
hadoop-trunk\hadoop-trunk\hadoop-yarn-project\hadoop-yarn\hadoop-yarn-api\src\main\java\org\apache\hadoop\yarn\api\ClientSCMProtocol.java,0,4,2,5,0,11
hadoop-trunk\hadoop-trunk\hadoop-yarn-project\hadoop-yarn\hadoop-yarn-server\hadoop-yarn-server-resourcemanager\src\main\java\org\apache\hadoop\yarn\server\resourcemanager\placement\csmappingrule\MappingRuleAction.java,0,0,0,1,0,1
hadoop-trunk\hadoop-trunk\hadoop-mapreduce-project\hadoop-mapreduce-client\hadoop-mapreduce-client-app\src\test\java\org\apache\hadoop\mapreduce\v2\app\rm\TestRMContainerAllocator.java,3572,625,223,32,0,880
hadoop-trunk\hadoop-trunk\hadoop-yarn-project\hadoop-yarn\hadoop-yarn-server\hadoop-yarn-server-common\src\main\java\org\apache\hadoop\yarn\server\metrics\AMRMClientRelayerMetrics.java,0,86,11,1,0,98
hadoop-trunk\hadoop-trunk\hadoop-common-project\hadoop-common\src\test\java\org\apache\hadoop\crypto\random\TestOsSecureRandom.java,113,45,2,1,0,48
hadoop-trunk\hadoop-trunk\hadoop-yarn-project\hadoop-yarn\hadoop-yarn-applications\hadoop-yarn-services\hadoop-yarn-services-core\src\test\java\org\apache\hadoop\yarn\service\TestServiceManager.java,386,44,3,2,0,49
hadoop-trunk\hadoop-trunk\hadoop-mapreduce-project\hadoop-mapreduce-client\hadoop-mapreduce-client-core\src\main\java\org\apache\hadoop\mapreduce\Job.java,0,382,42,12,0,436
hadoop-trunk\hadoop-trunk\hadoop-hdfs-project\hadoop-hdfs-rbf\src\main\java\org\apache\hadoop\hdfs\server\federation\resolver\MountTableManager.java,0,1,0,13,0,14
hadoop-trunk\hadoop-trunk\hadoop-hdfs-project\hadoop-hdfs\src\main\java\org\apache\hadoop\hdfs\server\blockmanagement\DatanodeStatistics.java,0,25,16,3,0,44
hadoop-trunk\hadoop-trunk\hadoop-cloud-storage-project\hadoop-huaweicloud\src\main\java\org\apache\hadoop\fs\obs\DefaultOBSClientFactory.java,0,0,12,1,0,13
hadoop-trunk\hadoop-trunk\hadoop-tools\hadoop-rumen\src\main\java\org\apache\hadoop\tools\rumen\serializers\ObjectStringSerializer.java,7,9,0,2,0,11
hadoop-trunk\hadoop-trunk\hadoop-tools\hadoop-openstack\src\test\java\org\apache\hadoop\fs\swift\TestSwiftFileSystemExtendedContract.java,108,10,1,2,0,13
hadoop-trunk\hadoop-trunk\hadoop-yarn-project\hadoop-yarn\hadoop-yarn-api\src\main\java\org\apache\hadoop\yarn\api\protocolrecords\UseSharedCacheResourceResponse.java,25,0,0,1,0,1
hadoop-trunk\hadoop-trunk\hadoop-common-project\hadoop-common\src\main\java\org\apache\hadoop\tracing\NullTraceScope.java,8,3,0,1,0,4
hadoop-trunk\hadoop-trunk\hadoop-tools\hadoop-azure-datalake\src\test\java\org\apache\hadoop\fs\adl\TestValidateConfiguration.java,201,18,1,1,0,20
hadoop-trunk\hadoop-trunk\hadoop-yarn-project\hadoop-yarn\hadoop-yarn-common\src\main\java\org\apache\hadoop\yarn\security\client\ClientToAMTokenIdentifier.java,84,29,21,2,0,52
hadoop-trunk\hadoop-trunk\hadoop-common-project\hadoop-common\src\test\java\org\apache\hadoop\crypto\random\TestOpensslSecureRandom.java,92,43,0,1,0,44
hadoop-trunk\hadoop-trunk\hadoop-yarn-project\hadoop-yarn\hadoop-yarn-server\hadoop-yarn-server-resourcemanager\src\test\java\org\apache\hadoop\yarn\server\resourcemanager\scheduler\fair\TestFSAppAttempt.java,338,52,2,7,0,61
hadoop-trunk\hadoop-trunk\hadoop-tools\hadoop-aws\src\main\java\org\apache\hadoop\fs\s3a\statistics\ChangeTrackerStatistics.java,0,0,0,1,0,1
hadoop-trunk\hadoop-trunk\hadoop-tools\hadoop-distcp\src\test\java\org\apache\hadoop\tools\TestDistCpSync.java,1222,104,24,5,0,133
hadoop-trunk\hadoop-trunk\hadoop-yarn-project\hadoop-yarn\hadoop-yarn-server\hadoop-yarn-server-common\src\test\java\org\apache\hadoop\yarn\server\federation\policies\router\TestLocalityRouterPolicy.java,0,17,4,5,0,26
hadoop-trunk\hadoop-trunk\hadoop-common-project\hadoop-common\src\main\java\org\apache\hadoop\io\erasurecode\rawcoder\NativeXORRawDecoder.java,47,16,0,1,0,17
hadoop-trunk\hadoop-trunk\hadoop-common-project\hadoop-common\src\test\java\org\apache\hadoop\service\launcher\testservices\NullBindLaunchableService.java,19,8,0,2,0,10
hadoop-trunk\hadoop-trunk\hadoop-yarn-project\hadoop-yarn\hadoop-yarn-server\hadoop-yarn-server-common\src\main\java\org\apache\hadoop\yarn\server\api\protocolrecords\SCMUploaderNotifyResponse.java,20,0,0,1,0,1
hadoop-trunk\hadoop-trunk\hadoop-maven-plugins\src\main\java\org\apache\hadoop\maven\plugin\protoc\package-info.java,0,0,0,58,0,58
hadoop-trunk\hadoop-trunk\hadoop-common-project\hadoop-common\src\test\java\org\apache\hadoop\io\erasurecode\TestCodecRawCoderMapping.java,113,12,0,1,0,13
hadoop-trunk\hadoop-trunk\hadoop-tools\hadoop-azure\src\test\java\org\apache\hadoop\fs\azure\ITestBlobDataValidation.java,190,40,6,5,0,51
hadoop-trunk\hadoop-trunk\hadoop-yarn-project\hadoop-yarn\hadoop-yarn-server\hadoop-yarn-server-nodemanager\src\main\java\org\apache\hadoop\yarn\server\nodemanager\containermanager\linux\runtime\docker\DockerClient.java,0,14,1,4,0,19
hadoop-trunk\hadoop-trunk\hadoop-common-project\hadoop-auth\src\main\java\org\apache\hadoop\security\authentication\server\LdapAuthenticationHandler.java,281,31,5,1,0,37
hadoop-trunk\hadoop-trunk\hadoop-yarn-project\hadoop-yarn\hadoop-yarn-server\hadoop-yarn-server-resourcemanager\src\main\java\org\apache\hadoop\yarn\server\resourcemanager\scheduler\fair\converter\FSConfigToCSConfigConverterParams.java,0,73,0,1,0,74
hadoop-trunk\hadoop-trunk\hadoop-tools\hadoop-resourceestimator\src\main\java\org\apache\hadoop\resourceestimator\translator\api\SingleLineParser.java,0,0,0,2,0,2
hadoop-trunk\hadoop-trunk\hadoop-yarn-project\hadoop-yarn\hadoop-yarn-server\hadoop-yarn-server-nodemanager\src\test\java\org\apache\hadoop\yarn\server\nodemanager\containermanager\deletion\task\TestDockerContainerDeletionTask.java,37,9,4,2,0,15
hadoop-trunk\hadoop-trunk\hadoop-hdfs-project\hadoop-hdfs\src\main\java\org\apache\hadoop\hdfs\protocol\FSLimitException.java,74,33,5,1,0,39
hadoop-trunk\hadoop-trunk\hadoop-mapreduce-project\hadoop-mapreduce-client\hadoop-mapreduce-client-core\src\main\java\org\apache\hadoop\mapreduce\lib\join\ComposableInputFormat.java,0,6,0,1,0,7
hadoop-trunk\hadoop-trunk\hadoop-common-project\hadoop-common\src\test\java\org\apache\hadoop\io\erasurecode\BufferAllocator.java,67,21,0,1,0,22
hadoop-trunk\hadoop-trunk\hadoop-hdfs-project\hadoop-hdfs-rbf\src\test\java\org\apache\hadoop\hdfs\server\federation\MockNamenode.java,492,22,14,7,0,43
hadoop-trunk\hadoop-trunk\hadoop-hdfs-project\hadoop-hdfs\src\main\java\org\apache\hadoop\hdfs\server\common\sps\BlockMovementAttemptFinished.java,69,17,0,1,0,18
hadoop-trunk\hadoop-trunk\hadoop-yarn-project\hadoop-yarn\hadoop-yarn-server\hadoop-yarn-server-resourcemanager\src\main\java\org\apache\hadoop\yarn\server\resourcemanager\scheduler\capacity\AutoCreatedLeafQueue.java,137,29,2,11,0,42
hadoop-trunk\hadoop-trunk\hadoop-yarn-project\hadoop-yarn\hadoop-yarn-server\hadoop-yarn-server-resourcemanager\src\test\java\org\apache\hadoop\yarn\server\resourcemanager\recovery\TestMemoryRMStateStore.java,39,3,1,1,0,5
hadoop-trunk\hadoop-trunk\hadoop-mapreduce-project\hadoop-mapreduce-client\hadoop-mapreduce-client-jobclient\src\test\java\org\apache\hadoop\mapreduce\v2\MiniMRYarnCluster.java,241,46,11,5,0,62
hadoop-trunk\hadoop-trunk\hadoop-tools\hadoop-streaming\src\test\java\org\apache\hadoop\streaming\TestStreamingCounters.java,22,5,1,1,0,7
hadoop-trunk\hadoop-trunk\hadoop-yarn-project\hadoop-yarn\hadoop-yarn-server\hadoop-yarn-server-common\src\main\java\org\apache\hadoop\yarn\server\federation\policies\exceptions\FederationPolicyInitializationException.java,0,4,0,1,0,5
hadoop-trunk\hadoop-trunk\hadoop-mapreduce-project\hadoop-mapreduce-client\hadoop-mapreduce-client-common\src\main\java\org\apache\hadoop\mapreduce\v2\api\protocolrecords\impl\pb\GetTaskReportsResponsePBImpl.java,144,46,41,6,0,93
hadoop-trunk\hadoop-trunk\hadoop-yarn-project\hadoop-yarn\hadoop-yarn-csi\src\main\java\org\apache\hadoop\yarn\csi\translator\package-info.java,0,1,0,1,0,2
hadoop-trunk\hadoop-trunk\hadoop-tools\hadoop-openstack\src\test\java\org\apache\hadoop\fs\swift\TestSwiftFileSystemBlocksize.java,32,6,0,1,0,7
hadoop-trunk\hadoop-trunk\hadoop-hdfs-project\hadoop-hdfs\src\test\java\org\apache\hadoop\hdfs\server\common\TestGetUriFromString.java,66,16,3,2,0,21
hadoop-trunk\hadoop-trunk\hadoop-tools\hadoop-distcp\src\test\java\org\apache\hadoop\tools\mapred\TestCopyOutputFormat.java,0,12,8,7,0,27
hadoop-trunk\hadoop-trunk\hadoop-common-project\hadoop-common\src\test\java\org\apache\hadoop\ha\TestActiveStandbyElectorRealZK.java,242,68,1,1,0,70
hadoop-trunk\hadoop-trunk\hadoop-yarn-project\hadoop-yarn\hadoop-yarn-server\hadoop-yarn-server-resourcemanager\src\test\java\org\apache\hadoop\yarn\server\resourcemanager\reservation\TestReservationInputValidator.java,796,169,0,16,0,185
hadoop-trunk\hadoop-trunk\hadoop-tools\hadoop-resourceestimator\src\test\java\org\apache\hadoop\resourceestimator\skylinestore\impl\TestSkylineStore.java,415,37,5,11,0,53
hadoop-trunk\hadoop-trunk\hadoop-hdfs-project\hadoop-hdfs\src\test\java\org\apache\hadoop\fs\TestHdfsNativeCodeLoader.java,27,9,7,1,0,17
hadoop-trunk\hadoop-trunk\hadoop-common-project\hadoop-auth\src\test\java\org\apache\hadoop\security\authentication\util\TestSigner.java,143,16,10,4,0,30
hadoop-trunk\hadoop-trunk\hadoop-common-project\hadoop-common\src\main\java\org\apache\hadoop\util\IdGenerator.java,0,2,1,1,0,4
hadoop-trunk\hadoop-trunk\hadoop-mapreduce-project\hadoop-mapreduce-client\hadoop-mapreduce-client-core\src\main\java\org\apache\hadoop\mapred\join\Parser.java,438,146,26,6,0,178
hadoop-trunk\hadoop-trunk\hadoop-common-project\hadoop-common\src\test\java\org\apache\hadoop\fs\contract\rawlocal\TestRawlocalContractCreate.java,9,2,0,1,0,3
hadoop-trunk\hadoop-trunk\hadoop-hdfs-project\hadoop-hdfs\src\main\java\org\apache\hadoop\hdfs\server\blockmanagement\StorageTypeStats.java,140,54,0,1,0,55
hadoop-trunk\hadoop-trunk\hadoop-yarn-project\hadoop-yarn\hadoop-yarn-server\hadoop-yarn-server-applicationhistoryservice\src\main\java\org\apache\hadoop\yarn\server\timeline\TimelineDataManager.java,447,123,3,2,0,128
hadoop-trunk\hadoop-trunk\hadoop-common-project\hadoop-common\src\test\java\org\apache\hadoop\crypto\key\TestValueQueue.java,283,117,3,2,0,122
hadoop-trunk\hadoop-trunk\hadoop-hdfs-project\hadoop-hdfs\src\main\java\org\apache\hadoop\hdfs\server\protocol\BlockIdCommand.java,22,22,0,1,0,23
hadoop-trunk\hadoop-trunk\hadoop-common-project\hadoop-common\src\main\java\org\apache\hadoop\util\LogAdapter.java,0,22,6,1,0,29
hadoop-trunk\hadoop-trunk\hadoop-hdfs-project\hadoop-hdfs\src\test\java\org\apache\hadoop\hdfs\server\namenode\TestFSImageWithAcl.java,218,22,5,1,0,28
hadoop-trunk\hadoop-trunk\hadoop-common-project\hadoop-common\src\test\java\org\apache\hadoop\net\unix\TestDomainSocketWatcher.java,248,43,10,2,0,55
hadoop-trunk\hadoop-trunk\hadoop-hdfs-project\hadoop-hdfs-rbf\src\main\java\org\apache\hadoop\hdfs\server\federation\store\protocol\GetNamespaceInfoResponse.java,23,6,0,3,0,9
hadoop-trunk\hadoop-trunk\hadoop-yarn-project\hadoop-yarn\hadoop-yarn-server\hadoop-yarn-server-resourcemanager\src\main\java\org\apache\hadoop\yarn\server\resourcemanager\monitor\capacity\PreemptionCandidatesSelector.java,59,17,0,2,0,19
hadoop-trunk\hadoop-trunk\hadoop-mapreduce-project\hadoop-mapreduce-client\hadoop-mapreduce-client-hs\src\main\java\org\apache\hadoop\mapreduce\v2\hs\webapp\HsTasksBlock.java,169,34,3,5,0,42
hadoop-trunk\hadoop-trunk\hadoop-hdfs-project\hadoop-hdfs\src\test\java\org\apache\hadoop\hdfs\server\namenode\FSXAttrBaseTest.java,1328,203,114,8,0,325
hadoop-trunk\hadoop-trunk\hadoop-yarn-project\hadoop-yarn\hadoop-yarn-api\src\main\java\org\apache\hadoop\yarn\server\api\protocolrecords\RefreshNodesRequest.java,56,11,1,1,0,13
hadoop-trunk\hadoop-trunk\hadoop-tools\hadoop-azure\src\main\java\org\apache\hadoop\fs\azurebfs\constants\AbfsHttpConstants.java,0,78,0,4,0,82
hadoop-trunk\hadoop-trunk\hadoop-hdfs-project\hadoop-hdfs\src\main\java\org\apache\hadoop\hdfs\web\resources\NamenodeAddressParam.java,29,6,1,1,0,8
hadoop-trunk\hadoop-trunk\hadoop-hdfs-project\hadoop-hdfs\src\test\java\org\apache\hadoop\hdfs\server\datanode\fsdataset\impl\TestInterDatanodeProtocol.java,0,116,14,24,0,154
hadoop-trunk\hadoop-trunk\hadoop-yarn-project\hadoop-yarn\hadoop-yarn-api\src\main\java\org\apache\hadoop\yarn\api\records\ContainerReport.java,208,51,0,1,0,52
hadoop-trunk\hadoop-trunk\hadoop-mapreduce-project\hadoop-mapreduce-client\hadoop-mapreduce-client-hs\src\main\java\org\apache\hadoop\mapreduce\v2\hs\HistoryClientService.java,364,66,3,37,0,106
hadoop-trunk\hadoop-trunk\hadoop-common-project\hadoop-registry\src\main\java\org\apache\hadoop\registry\server\services\package-info.java,0,3,0,4,0,7
hadoop-trunk\hadoop-trunk\hadoop-common-project\hadoop-common\src\main\java\org\apache\hadoop\ipc\RetriableException.java,12,6,0,1,0,7
hadoop-trunk\hadoop-trunk\hadoop-yarn-project\hadoop-yarn\hadoop-yarn-server\hadoop-yarn-server-nodemanager\src\main\java\org\apache\hadoop\yarn\server\nodemanager\containermanager\linux\resources\numa\NumaNodeResource.java,175,35,3,2,0,40
hadoop-trunk\hadoop-trunk\hadoop-yarn-project\hadoop-yarn\hadoop-yarn-server\hadoop-yarn-server-nodemanager\src\test\java\org\apache\hadoop\yarn\server\nodemanager\containermanager\localizer\MockLocalizerStatus.java,56,29,0,3,0,32
hadoop-trunk\hadoop-trunk\hadoop-mapreduce-project\hadoop-mapreduce-client\hadoop-mapreduce-client-jobclient\src\test\java\org\apache\hadoop\mapred\TestMapRed.java,713,166,42,7,0,215
hadoop-trunk\hadoop-trunk\hadoop-common-project\hadoop-common\src\test\java\org\apache\hadoop\security\TestLdapGroupsMappingWithBindUserSwitch.java,0,21,1,4,0,26
hadoop-trunk\hadoop-trunk\hadoop-yarn-project\hadoop-yarn\hadoop-yarn-common\src\test\java\org\apache\hadoop\yarn\util\TestAdHocLogDumper.java,52,5,4,3,0,12
hadoop-trunk\hadoop-trunk\hadoop-hdfs-project\hadoop-hdfs\src\test\java\org\apache\hadoop\hdfs\server\namenode\FSImageTestUtil.java,574,166,24,8,0,198
hadoop-trunk\hadoop-trunk\hadoop-hdfs-project\hadoop-hdfs-rbf\src\main\java\org\apache\hadoop\hdfs\server\federation\store\RouterStore.java,38,2,0,7,0,9
hadoop-trunk\hadoop-trunk\hadoop-hdfs-project\hadoop-hdfs\src\test\java\org\apache\hadoop\hdfs\server\namenode\snapshot\TestUpdatePipelineWithSnapshots.java,73,13,0,1,0,14
hadoop-trunk\hadoop-trunk\hadoop-common-project\hadoop-common\src\test\java\org\apache\hadoop\net\ServerSocketUtil.java,104,17,5,1,0,23
hadoop-trunk\hadoop-trunk\hadoop-yarn-project\hadoop-yarn\hadoop-yarn-server\hadoop-yarn-server-resourcemanager\src\test\java\org\apache\hadoop\yarn\server\resourcemanager\rmapp\TestNodesListManager.java,180,27,25,2,0,54
hadoop-trunk\hadoop-trunk\hadoop-common-project\hadoop-common\src\main\java\org\apache\hadoop\io\erasurecode\coder\ErasureDecodingStep.java,44,18,1,1,0,20
hadoop-trunk\hadoop-trunk\hadoop-common-project\hadoop-common\src\test\java\org\apache\hadoop\util\TestPreconditions.java,299,16,0,2,0,18
hadoop-trunk\hadoop-trunk\hadoop-tools\hadoop-azure\src\main\java\org\apache\hadoop\fs\azurebfs\services\AbfsRestOperation.java,304,78,3,13,0,94
hadoop-trunk\hadoop-trunk\hadoop-hdfs-project\hadoop-hdfs\src\main\java\org\apache\hadoop\hdfs\protocolPB\InterDatanodeProtocolPB.java,0,2,3,2,0,7
hadoop-trunk\hadoop-trunk\hadoop-mapreduce-project\hadoop-mapreduce-client\hadoop-mapreduce-client-common\src\main\java\org\apache\hadoop\mapreduce\v2\api\records\impl\pb\JobReportPBImpl.java,354,97,122,1,0,220
hadoop-trunk\hadoop-trunk\hadoop-hdfs-project\hadoop-hdfs\src\test\java\org\apache\hadoop\hdfs\server\namenode\snapshot\TestOrderedSnapshotDeletionGc.java,183,32,7,6,0,45
hadoop-trunk\hadoop-trunk\hadoop-yarn-project\hadoop-yarn\hadoop-yarn-common\src\test\java\org\apache\hadoop\yarn\resourcetypes\ResourceTypesTestHelper.java,0,28,0,1,0,29
hadoop-trunk\hadoop-trunk\hadoop-yarn-project\hadoop-yarn\hadoop-yarn-server\hadoop-yarn-server-nodemanager\src\main\java\org\apache\hadoop\yarn\server\nodemanager\containermanager\resourceplugin\gpu\GpuNodeResourceUpdateHandler.java,88,14,3,5,0,22
hadoop-trunk\hadoop-trunk\hadoop-mapreduce-project\hadoop-mapreduce-client\hadoop-mapreduce-client-core\src\main\java\org\apache\hadoop\mapreduce\jobhistory\AMStartedEvent.java,156,41,23,1,0,65
hadoop-trunk\hadoop-trunk\hadoop-mapreduce-project\hadoop-mapreduce-client\hadoop-mapreduce-client-jobclient\src\test\java\org\apache\hadoop\mapreduce\util\MRAsyncDiskService.java,336,112,12,4,0,128
hadoop-trunk\hadoop-trunk\hadoop-yarn-project\hadoop-yarn\hadoop-yarn-applications\hadoop-yarn-applications-catalog\hadoop-yarn-applications-catalog-webapp\src\main\java\org\apache\hadoop\yarn\appcatalog\application\package-info.java,0,0,0,1,0,1
hadoop-trunk\hadoop-trunk\hadoop-yarn-project\hadoop-yarn\hadoop-yarn-api\src\test\java\org\apache\hadoop\yarn\api\records\TestResource.java,0,1,0,1,0,2
hadoop-trunk\hadoop-trunk\hadoop-common-project\hadoop-common\src\main\java\org\apache\hadoop\io\erasurecode\codec\ErasureCodec.java,60,19,3,1,0,23
hadoop-trunk\hadoop-trunk\hadoop-tools\hadoop-azure\src\main\java\org\apache\hadoop\fs\azure\WasbRemoteCallException.java,17,8,0,1,0,9
hadoop-trunk\hadoop-trunk\hadoop-hdfs-project\hadoop-hdfs-rbf\src\main\java\org\apache\hadoop\hdfs\server\federation\resolver\order\LocalResolver.java,0,9,6,3,0,18
hadoop-trunk\hadoop-trunk\hadoop-hdfs-project\hadoop-hdfs\src\test\java\org\apache\hadoop\hdfs\server\datanode\TestDataNodeRollingUpgrade.java,429,118,10,14,0,142
hadoop-trunk\hadoop-trunk\hadoop-mapreduce-project\hadoop-mapreduce-client\hadoop-mapreduce-client-jobclient\src\test\java\org\apache\hadoop\mapred\pipes\PipeApplicationRunnableStub.java,58,7,0,2,0,9
hadoop-trunk\hadoop-trunk\hadoop-yarn-project\hadoop-yarn\hadoop-yarn-server\hadoop-yarn-server-resourcemanager\src\main\java\org\apache\hadoop\yarn\server\resourcemanager\NodesListManagerEventType.java,0,3,0,1,0,4
hadoop-trunk\hadoop-trunk\hadoop-yarn-project\hadoop-yarn\hadoop-yarn-client\src\test\java\org\apache\hadoop\yarn\client\TestHedgingRequestRMFailoverProxyProvider.java,90,12,1,1,0,14
hadoop-trunk\hadoop-trunk\hadoop-yarn-project\hadoop-yarn\hadoop-yarn-server\hadoop-yarn-server-common\src\test\java\org\apache\hadoop\yarn\server\api\protocolrecords\TestRegisterNodeManagerRequest.java,50,13,2,3,0,18
hadoop-trunk\hadoop-trunk\hadoop-yarn-project\hadoop-yarn\hadoop-yarn-api\src\main\java\org\apache\hadoop\yarn\api\protocolrecords\GetNewReservationRequest.java,10,1,1,1,0,3
hadoop-trunk\hadoop-trunk\hadoop-common-project\hadoop-common\src\main\java\org\apache\hadoop\fs\CanSetReadahead.java,0,2,1,1,0,4
hadoop-trunk\hadoop-trunk\hadoop-hdfs-project\hadoop-hdfs\src\main\java\org\apache\hadoop\hdfs\server\namenode\INodeReferenceValidation.java,186,48,10,1,0,59
hadoop-trunk\hadoop-trunk\hadoop-yarn-project\hadoop-yarn\hadoop-yarn-common\src\main\java\org\apache\hadoop\yarn\api\records\impl\pb\NodeIdPBImpl.java,47,19,20,1,0,40
hadoop-trunk\hadoop-trunk\hadoop-yarn-project\hadoop-yarn\hadoop-yarn-server\hadoop-yarn-server-resourcemanager\src\main\java\org\apache\hadoop\yarn\server\resourcemanager\monitor\capacity\TempQueuePerPartition.java,371,113,4,5,0,122
hadoop-trunk\hadoop-trunk\hadoop-hdfs-project\hadoop-hdfs-rbf\src\main\java\org\apache\hadoop\hdfs\server\federation\metrics\NullStateStoreMetrics.java,34,41,7,1,0,49
hadoop-trunk\hadoop-trunk\hadoop-mapreduce-project\hadoop-mapreduce-client\hadoop-mapreduce-client-core\src\main\java\org\apache\hadoop\mapreduce\lib\output\committer\manifest\ManifestCommitterFactory.java,21,1,0,2,0,3
hadoop-trunk\hadoop-trunk\hadoop-hdfs-project\hadoop-hdfs-client\src\test\java\org\apache\hadoop\hdfs\web\TestTokenAspect.java,256,44,16,3,0,63
hadoop-trunk\hadoop-trunk\hadoop-tools\hadoop-distcp\src\test\java\org\apache\hadoop\tools\util\TestDistCpUtils.java,1362,324,186,128,0,638
hadoop-trunk\hadoop-trunk\hadoop-common-project\hadoop-nfs\src\main\java\org\apache\hadoop\nfs\nfs3\response\GETATTR3Response.java,32,22,0,2,0,24
hadoop-trunk\hadoop-trunk\hadoop-mapreduce-project\hadoop-mapreduce-client\hadoop-mapreduce-client-app\src\main\java\org\apache\hadoop\mapreduce\v2\app\job\event\TaskAttemptRecoverEvent.java,27,16,0,1,0,17
hadoop-trunk\hadoop-trunk\hadoop-tools\hadoop-aws\src\test\java\org\apache\hadoop\fs\s3a\statistics\ITestAggregateIOStatistics.java,59,6,0,1,0,7
hadoop-trunk\hadoop-trunk\hadoop-tools\hadoop-datajoin\src\main\java\org\apache\hadoop\contrib\utils\join\TaggedMapOutput.java,23,18,0,1,0,19
hadoop-trunk\hadoop-trunk\hadoop-mapreduce-project\hadoop-mapreduce-client\hadoop-mapreduce-client-app\src\main\java\org\apache\hadoop\mapreduce\v2\app\rm\preemption\KillAMPreemptionPolicy.java,79,19,1,1,0,21
hadoop-trunk\hadoop-trunk\hadoop-yarn-project\hadoop-yarn\hadoop-yarn-server\hadoop-yarn-server-common\src\main\java\org\apache\hadoop\yarn\server\federation\store\records\SubClusterRegisterRequest.java,34,2,0,1,0,3
hadoop-trunk\hadoop-trunk\hadoop-yarn-project\hadoop-yarn\hadoop-yarn-server\hadoop-yarn-server-resourcemanager\src\main\java\org\apache\hadoop\yarn\server\resourcemanager\security\AMRMTokenSecretManager.java,278,51,6,5,0,62
hadoop-trunk\hadoop-trunk\hadoop-hdfs-project\hadoop-hdfs-rbf\src\main\java\org\apache\hadoop\hdfs\server\federation\store\protocol\package-info.java,0,1,0,1,0,2
hadoop-trunk\hadoop-trunk\hadoop-mapreduce-project\hadoop-mapreduce-client\hadoop-mapreduce-client-app\src\main\java\org\apache\hadoop\mapred\MapTaskAttemptImpl.java,30,22,0,2,0,24
hadoop-trunk\hadoop-trunk\hadoop-mapreduce-project\hadoop-mapreduce-client\hadoop-mapreduce-client-hs-plugins\src\main\java\org\apache\hadoop\mapreduce\v2\hs\webapp\MapReduceTrackingUriPlugin.java,29,6,1,1,0,8
hadoop-trunk\hadoop-trunk\hadoop-yarn-project\hadoop-yarn\hadoop-yarn-server\hadoop-yarn-server-router\src\test\java\org\apache\hadoop\yarn\server\router\rmadmin\TestRouterRMAdminService.java,232,6,1,13,0,20
hadoop-trunk\hadoop-trunk\hadoop-hdfs-project\hadoop-hdfs-rbf\src\test\java\org\apache\hadoop\hdfs\server\federation\router\TestRouterRPCMultipleDestinationMountTableResolver.java,839,91,4,10,0,105
hadoop-trunk\hadoop-trunk\hadoop-yarn-project\hadoop-yarn\hadoop-yarn-common\src\main\java\org\apache\hadoop\yarn\util\resource\DefaultResourceCalculator.java,144,73,3,2,0,78
hadoop-trunk\hadoop-trunk\hadoop-hdfs-project\hadoop-hdfs\src\test\java\org\apache\hadoop\hdfs\TestFileStatus.java,300,65,4,1,0,70
hadoop-trunk\hadoop-trunk\hadoop-yarn-project\hadoop-yarn\hadoop-yarn-server\hadoop-yarn-server-resourcemanager\src\test\java\org\apache\hadoop\yarn\server\resourcemanager\applicationsmanager\TestAMRestart.java,1253,141,38,26,0,205
hadoop-trunk\hadoop-trunk\hadoop-hdfs-project\hadoop-hdfs\src\main\java\org\apache\hadoop\hdfs\server\blockmanagement\BlockToMarkCorrupt.java,0,19,3,2,0,24
hadoop-trunk\hadoop-trunk\hadoop-common-project\hadoop-common\src\main\java\org\apache\hadoop\io\erasurecode\rawcoder\RSRawEncoder.java,49,8,1,1,0,10
hadoop-trunk\hadoop-trunk\hadoop-hdfs-project\hadoop-hdfs\src\test\java\org\apache\hadoop\hdfs\server\namenode\snapshot\TestCheckpointsWithSnapshots.java,95,19,1,4,0,24
hadoop-trunk\hadoop-trunk\hadoop-yarn-project\hadoop-yarn\hadoop-yarn-server\hadoop-yarn-server-resourcemanager\src\main\java\org\apache\hadoop\yarn\server\resourcemanager\placement\csmappingrule\MappingRuleActionBase.java,58,0,0,1,0,1
hadoop-trunk\hadoop-trunk\hadoop-yarn-project\hadoop-yarn\hadoop-yarn-server\hadoop-yarn-server-resourcemanager\src\main\java\org\apache\hadoop\yarn\server\resourcemanager\nodelabels\NodeAttributesStoreEvent.java,0,11,0,2,0,13
hadoop-trunk\hadoop-trunk\hadoop-yarn-project\hadoop-yarn\hadoop-yarn-server\hadoop-yarn-server-common\src\test\java\org\apache\hadoop\yarn\server\webapp\ContainerBlockTest.java,46,9,1,4,0,14
hadoop-trunk\hadoop-trunk\hadoop-yarn-project\hadoop-yarn\hadoop-yarn-server\hadoop-yarn-server-resourcemanager\src\test\java\org\apache\hadoop\yarn\server\resourcemanager\security\TestRMDelegationTokens.java,252,44,4,4,0,52
hadoop-trunk\hadoop-trunk\hadoop-hdfs-project\hadoop-hdfs\src\test\java\org\apache\hadoop\hdfs\server\blockmanagement\TestSlowDiskTracker.java,426,150,16,4,0,170
hadoop-trunk\hadoop-trunk\hadoop-hdfs-project\hadoop-hdfs\src\test\java\org\apache\hadoop\hdfs\server\namenode\TestNameNodeReconfigure.java,434,55,3,20,0,78
hadoop-trunk\hadoop-trunk\hadoop-mapreduce-project\hadoop-mapreduce-client\hadoop-mapreduce-client-core\src\main\java\org\apache\hadoop\mapreduce\lib\output\committer\manifest\ManifestCommitterStatisticNames.java,0,3,0,4,0,7
hadoop-trunk\hadoop-trunk\hadoop-mapreduce-project\hadoop-mapreduce-client\hadoop-mapreduce-client-app\src\test\java\org\apache\hadoop\mapreduce\v2\app\TestMRAppMaster.java,0,90,25,2,0,117
hadoop-trunk\hadoop-trunk\hadoop-yarn-project\hadoop-yarn\hadoop-yarn-api\src\main\java\org\apache\hadoop\yarn\server\api\protocolrecords\RemoveFromClusterNodeLabelsRequest.java,18,4,0,1,0,5
hadoop-trunk\hadoop-trunk\hadoop-mapreduce-project\hadoop-mapreduce-client\hadoop-mapreduce-client-core\src\main\java\org\apache\hadoop\mapreduce\lib\output\committer\manifest\impl\ManifestCommitterSupport.java,0,38,0,24,0,62
hadoop-trunk\hadoop-trunk\hadoop-yarn-project\hadoop-yarn\hadoop-yarn-applications\hadoop-yarn-services\hadoop-yarn-services-core\src\main\java\org\apache\hadoop\yarn\service\timelineservice\ServiceTimelineMetricsConstants.java,0,26,0,2,0,28
hadoop-trunk\hadoop-trunk\hadoop-common-project\hadoop-common\src\test\java\org\apache\hadoop\metrics2\sink\TestPrometheusMetricsSink.java,0,31,0,11,0,42
hadoop-trunk\hadoop-trunk\hadoop-tools\hadoop-azure\src\test\java\org\apache\hadoop\fs\azure\ExceptionHandlingTestHelper.java,43,14,1,5,0,20
hadoop-trunk\hadoop-trunk\hadoop-yarn-project\hadoop-yarn\hadoop-yarn-applications\hadoop-yarn-services\hadoop-yarn-services-core\src\main\java\org\apache\hadoop\yarn\service\containerlaunch\ClasspathConstructor.java,136,42,2,2,0,46
hadoop-trunk\hadoop-trunk\hadoop-yarn-project\hadoop-yarn\hadoop-yarn-common\src\test\java\org\apache\hadoop\yarn\api\records\impl\pb\TestApplicationClientProtocolRecords.java,110,16,2,11,0,29
hadoop-trunk\hadoop-trunk\hadoop-common-project\hadoop-common\src\main\java\org\apache\hadoop\fs\crypto\CryptoFSDataInputStream.java,13,18,0,1,0,19
hadoop-trunk\hadoop-trunk\hadoop-common-project\hadoop-common\src\main\java\org\apache\hadoop\ha\protocolPB\HAServiceProtocolPB.java,0,5,3,3,0,11
hadoop-trunk\hadoop-trunk\hadoop-tools\hadoop-azure\src\main\java\org\apache\hadoop\fs\azure\SelfRenewingLease.java,163,24,10,2,0,36
hadoop-trunk\hadoop-trunk\hadoop-common-project\hadoop-common\src\main\java\org\apache\hadoop\metrics2\source\JvmMetricsInfo.java,0,32,0,3,0,35
hadoop-trunk\hadoop-trunk\hadoop-hdfs-project\hadoop-hdfs\src\test\java\org\apache\hadoop\hdfs\TestDFSStripedInputStreamWithRandomECPolicy.java,18,4,1,1,0,6
hadoop-trunk\hadoop-trunk\hadoop-tools\hadoop-streaming\src\test\java\org\apache\hadoop\streaming\TestClassWithNoPackage.java,0,11,6,2,0,19
hadoop-trunk\hadoop-trunk\hadoop-tools\hadoop-distcp\src\main\java\org\apache\hadoop\tools\TrueCopyFilter.java,8,2,0,1,0,3
hadoop-trunk\hadoop-trunk\hadoop-common-project\hadoop-common\src\main\java\org\apache\hadoop\crypto\CryptoInputStream.java,0,261,3,4,0,268
hadoop-trunk\hadoop-trunk\hadoop-mapreduce-project\hadoop-mapreduce-client\hadoop-mapreduce-client-hs\src\test\java\org\apache\hadoop\mapreduce\v2\hs\HistoryServerMemStateStoreService.java,0,12,1,1,0,14
hadoop-trunk\hadoop-trunk\hadoop-yarn-project\hadoop-yarn\hadoop-yarn-server\hadoop-yarn-server-resourcemanager\src\main\java\org\apache\hadoop\yarn\server\resourcemanager\scheduler\SchedulerHealth.java,295,90,0,1,0,91
hadoop-trunk\hadoop-trunk\hadoop-common-project\hadoop-common\src\test\java\org\apache\hadoop\metrics2\impl\TestMetricsSystemImpl.java,588,129,32,4,0,165
hadoop-trunk\hadoop-trunk\hadoop-yarn-project\hadoop-yarn\hadoop-yarn-server\hadoop-yarn-server-nodemanager\src\test\java\org\apache\hadoop\yarn\server\nodemanager\containermanager\linux\runtime\TestRuncContainerRuntime.java,908,95,31,31,0,157
hadoop-trunk\hadoop-trunk\hadoop-hdfs-project\hadoop-hdfs\src\test\java\org\apache\hadoop\hdfs\server\namenode\TestStartupOptionUpgrade.java,120,27,1,1,0,29
hadoop-trunk\hadoop-trunk\hadoop-yarn-project\hadoop-yarn\hadoop-yarn-server\hadoop-yarn-server-sharedcachemanager\src\main\java\org\apache\hadoop\yarn\server\sharedcachemanager\store\SCMStore.java,169,19,2,2,0,23
hadoop-trunk\hadoop-trunk\hadoop-tools\hadoop-aws\src\main\java\org\apache\hadoop\fs\s3a\FailureInjectionPolicy.java,70,19,3,1,0,23
hadoop-trunk\hadoop-trunk\hadoop-hdfs-project\hadoop-hdfs\src\main\java\org\apache\hadoop\hdfs\server\datanode\erasurecode\StripedReader.java,0,56,1,3,0,60
hadoop-trunk\hadoop-trunk\hadoop-hdfs-project\hadoop-hdfs-httpfs\src\main\java\org\apache\hadoop\lib\service\FileSystemAccess.java,0,14,6,3,0,23
hadoop-trunk\hadoop-trunk\hadoop-yarn-project\hadoop-yarn\hadoop-yarn-server\hadoop-yarn-server-resourcemanager\src\main\java\org\apache\hadoop\yarn\server\resourcemanager\DBManager.java,90,26,5,1,0,32
hadoop-trunk\hadoop-trunk\hadoop-mapreduce-project\hadoop-mapreduce-client\hadoop-mapreduce-client-app\src\main\java\org\apache\hadoop\mapreduce\v2\app\speculate\StartEndTimesBase.java,172,31,1,2,0,34
hadoop-trunk\hadoop-trunk\hadoop-yarn-project\hadoop-yarn\hadoop-yarn-server\hadoop-yarn-server-nodemanager\src\test\java\org\apache\hadoop\yarn\server\nodemanager\LocalRMInterface.java,34,16,4,8,0,28
hadoop-trunk\hadoop-trunk\hadoop-hdfs-project\hadoop-hdfs\src\test\java\org\apache\hadoop\hdfs\server\namenode\TestFSDirectory.java,393,119,21,3,0,143
hadoop-trunk\hadoop-trunk\hadoop-yarn-project\hadoop-yarn\hadoop-yarn-server\hadoop-yarn-server-nodemanager\src\main\java\org\apache\hadoop\yarn\server\nodemanager\containermanager\launcher\ContainerRelaunch.java,165,24,2,6,0,32
hadoop-trunk\hadoop-trunk\hadoop-yarn-project\hadoop-yarn\hadoop-yarn-server\hadoop-yarn-server-resourcemanager\src\test\java\org\apache\hadoop\yarn\server\resourcemanager\scheduler\capacity\TestSchedulingRequestContainerAllocation.java,0,244,3,10,0,257
hadoop-trunk\hadoop-trunk\hadoop-yarn-project\hadoop-yarn\hadoop-yarn-server\hadoop-yarn-server-resourcemanager\src\test\java\org\apache\hadoop\yarn\server\resourcemanager\MockRM.java,930,240,25,28,0,293
hadoop-trunk\hadoop-trunk\hadoop-common-project\hadoop-common\src\main\java\org\apache\hadoop\io\serializer\Serializer.java,0,6,0,2,0,8
hadoop-trunk\hadoop-trunk\hadoop-common-project\hadoop-common\src\test\java\org\apache\hadoop\crypto\TestOpensslCipher.java,81,37,2,1,0,40
hadoop-trunk\hadoop-trunk\hadoop-common-project\hadoop-registry\src\test\java\org\apache\hadoop\registry\client\binding\TestMarshalling.java,108,18,6,1,0,25
hadoop-trunk\hadoop-trunk\hadoop-yarn-project\hadoop-yarn\hadoop-yarn-server\hadoop-yarn-server-nodemanager\src\test\java\org\apache\hadoop\yarn\server\nodemanager\containermanager\launcher\TestContainerLaunchParameterized.java,0,9,0,2,0,11
hadoop-trunk\hadoop-trunk\hadoop-yarn-project\hadoop-yarn\hadoop-yarn-server\hadoop-yarn-server-timelineservice-documentstore\src\main\java\org\apache\hadoop\yarn\server\timelineservice\documentstore\reader\package-info.java,0,0,0,1,0,1
hadoop-trunk\hadoop-trunk\hadoop-mapreduce-project\hadoop-mapreduce-client\hadoop-mapreduce-client-common\src\main\java\org\apache\hadoop\mapreduce\v2\api\records\impl\pb\AMInfoPBImpl.java,171,44,65,1,0,110
hadoop-trunk\hadoop-trunk\hadoop-common-project\hadoop-common\src\test\java\org\apache\hadoop\crypto\TestCryptoCodec.java,332,134,23,2,0,159
hadoop-trunk\hadoop-trunk\hadoop-hdfs-project\hadoop-hdfs-client\src\main\java\org\apache\hadoop\hdfs\server\namenode\ha\ObserverReadProxyProviderWithIPFailover.java,0,22,0,1,0,23
hadoop-trunk\hadoop-trunk\hadoop-hdfs-project\hadoop-hdfs-rbf\src\main\java\org\apache\hadoop\hdfs\server\federation\router\RouterPermissionChecker.java,102,10,2,1,0,13
hadoop-trunk\hadoop-trunk\hadoop-mapreduce-project\hadoop-mapreduce-client\hadoop-mapreduce-client-core\src\main\java\org\apache\hadoop\mapred\join\CompositeInputFormat.java,0,45,6,3,0,54
hadoop-trunk\hadoop-trunk\hadoop-hdfs-project\hadoop-hdfs\src\main\java\org\apache\hadoop\hdfs\server\namenode\AclFeature.java,0,19,1,2,0,22
hadoop-trunk\hadoop-trunk\hadoop-mapreduce-project\hadoop-mapreduce-client\hadoop-mapreduce-client-nativetask\src\test\java\org\apache\hadoop\mapred\nativetask\nonsorttest\NonSortTestMR.java,42,23,2,4,0,29
hadoop-trunk\hadoop-trunk\hadoop-mapreduce-project\hadoop-mapreduce-client\hadoop-mapreduce-client-app\src\main\java\org\apache\hadoop\mapreduce\v2\app\launcher\ContainerLauncher.java,0,5,1,1,0,7
hadoop-trunk\hadoop-trunk\hadoop-common-project\hadoop-common\src\main\java\org\apache\hadoop\util\DiskValidator.java,0,0,0,1,0,1
hadoop-trunk\hadoop-trunk\hadoop-tools\hadoop-sls\src\main\java\org\apache\hadoop\yarn\sls\synthetic\package-info.java,0,1,0,1,0,2
hadoop-trunk\hadoop-trunk\hadoop-yarn-project\hadoop-yarn\hadoop-yarn-server\hadoop-yarn-server-resourcemanager\src\test\java\org\apache\hadoop\yarn\server\resourcemanager\metrics\TestSystemMetricsPublisherForV2.java,401,35,10,6,0,51
hadoop-trunk\hadoop-trunk\hadoop-common-project\hadoop-common\src\test\java\org\apache\hadoop\fs\shell\TestCount.java,590,72,25,2,0,99
hadoop-trunk\hadoop-trunk\hadoop-common-project\hadoop-common\src\main\java\org\apache\hadoop\fs\statistics\impl\EvaluatingStatisticsMap.java,0,7,1,1,0,9
hadoop-trunk\hadoop-trunk\hadoop-mapreduce-project\hadoop-mapreduce-client\hadoop-mapreduce-client-nativetask\src\test\java\org\apache\hadoop\mapred\nativetask\utils\TestReadWriteBuffer.java,40,12,0,1,0,13
hadoop-trunk\hadoop-trunk\hadoop-tools\hadoop-aliyun\src\main\java\org\apache\hadoop\fs\aliyun\oss\AliyunOSSFileSystemStore.java,654,89,12,1,0,102
hadoop-trunk\hadoop-trunk\hadoop-common-project\hadoop-common\src\main\java\org\apache\hadoop\security\ShellBasedUnixGroupsNetgroupMapping.java,0,21,5,1,0,27
hadoop-trunk\hadoop-trunk\hadoop-tools\hadoop-azure\src\test\java\org\apache\hadoop\fs\azure\integration\CleanupTestContainers.java,53,4,2,1,0,7
hadoop-trunk\hadoop-trunk\hadoop-common-project\hadoop-common\src\main\java\org\apache\hadoop\io\erasurecode\coder\RSErasureEncoder.java,40,9,1,2,0,12
hadoop-trunk\hadoop-trunk\hadoop-yarn-project\hadoop-yarn\hadoop-yarn-api\src\main\java\org\apache\hadoop\yarn\api\protocolrecords\GetClusterNodeLabelsResponse.java,47,6,0,2,0,8
hadoop-trunk\hadoop-trunk\hadoop-yarn-project\hadoop-yarn\hadoop-yarn-api\src\main\java\org\apache\hadoop\yarn\factory\providers\package-info.java,0,1,0,1,0,2
hadoop-trunk\hadoop-trunk\hadoop-yarn-project\hadoop-yarn\hadoop-yarn-common\src\main\java\org\apache\hadoop\yarn\security\AccessType.java,0,4,0,1,0,5
hadoop-trunk\hadoop-trunk\hadoop-yarn-project\hadoop-yarn\hadoop-yarn-server\hadoop-yarn-server-nodemanager\src\main\java\org\apache\hadoop\yarn\server\nodemanager\util\NodeManagerBuilderUtils.java,14,5,3,1,0,9
hadoop-trunk\hadoop-trunk\hadoop-yarn-project\hadoop-yarn\hadoop-yarn-server\hadoop-yarn-server-web-proxy\src\test\java\org\apache\hadoop\yarn\server\webproxy\TestProxyUriUtils.java,91,67,1,9,0,77
hadoop-trunk\hadoop-trunk\hadoop-yarn-project\hadoop-yarn\hadoop-yarn-server\hadoop-yarn-server-nodemanager\src\main\java\org\apache\hadoop\yarn\server\nodemanager\containermanager\launcher\AbstractContainersLauncher.java,8,1,0,2,0,3
hadoop-trunk\hadoop-trunk\hadoop-hdfs-project\hadoop-hdfs\src\test\java\org\apache\hadoop\hdfs\FileAppendTest4.java,78,53,1,7,0,61
hadoop-trunk\hadoop-trunk\hadoop-mapreduce-project\hadoop-mapreduce-client\hadoop-mapreduce-client-app\src\main\java\org\apache\hadoop\mapreduce\v2\app\rm\ContainerAllocatorEvent.java,0,10,0,1,0,11
hadoop-trunk\hadoop-trunk\hadoop-yarn-project\hadoop-yarn\hadoop-yarn-server\hadoop-yarn-server-nodemanager\src\main\java\org\apache\hadoop\yarn\server\nodemanager\containermanager\monitor\ContainersMonitorEvent.java,16,7,0,1,0,8
hadoop-trunk\hadoop-trunk\hadoop-yarn-project\hadoop-yarn\hadoop-yarn-common\src\main\java\org\apache\hadoop\yarn\server\api\protocolrecords\impl\pb\NodesToAttributesMappingRequestPBImpl.java,0,25,43,6,0,74
hadoop-trunk\hadoop-trunk\hadoop-common-project\hadoop-common\src\main\java\org\apache\hadoop\fs\PathNotFoundException.java,22,12,0,1,0,13
hadoop-trunk\hadoop-trunk\hadoop-yarn-project\hadoop-yarn\hadoop-yarn-api\src\main\java\org\apache\hadoop\yarn\api\records\impl\package-info.java,0,1,0,1,0,2
hadoop-trunk\hadoop-trunk\hadoop-yarn-project\hadoop-yarn\hadoop-yarn-server\hadoop-yarn-server-resourcemanager\src\main\java\org\apache\hadoop\yarn\server\resourcemanager\webapp\FairSchedulerAppsBlock.java,171,34,0,6,0,40
hadoop-trunk\hadoop-trunk\hadoop-hdfs-project\hadoop-hdfs\src\test\java\org\apache\hadoop\hdfs\TestDisableConnCache.java,33,8,0,1,0,9
hadoop-trunk\hadoop-trunk\hadoop-common-project\hadoop-common\src\main\java\org\apache\hadoop\fs\HasFileDescriptor.java,0,2,1,1,0,4
hadoop-trunk\hadoop-trunk\hadoop-common-project\hadoop-common\src\main\java\org\apache\hadoop\http\package-info.java,0,1,0,1,0,2
hadoop-trunk\hadoop-trunk\hadoop-yarn-project\hadoop-yarn\hadoop-yarn-server\hadoop-yarn-server-nodemanager\src\main\java\org\apache\hadoop\yarn\server\nodemanager\containermanager\linux\resources\NetworkTagMappingManager.java,0,1,0,3,0,4
hadoop-trunk\hadoop-trunk\hadoop-hdfs-project\hadoop-hdfs-rbf\src\test\java\org\apache\hadoop\hdfs\server\federation\router\TestRouterHeartbeatService.java,97,11,3,5,0,19
hadoop-trunk\hadoop-trunk\hadoop-yarn-project\hadoop-yarn\hadoop-yarn-server\hadoop-yarn-server-common\src\main\java\org\apache\hadoop\yarn\server\federation\store\records\impl\pb\AddApplicationHomeSubClusterResponsePBImpl.java,0,18,32,5,0,55
hadoop-trunk\hadoop-trunk\hadoop-hdfs-project\hadoop-hdfs\src\test\java\org\apache\hadoop\hdfs\server\datanode\TestDataDirs.java,129,22,24,1,0,47
hadoop-trunk\hadoop-trunk\hadoop-mapreduce-project\hadoop-mapreduce-client\hadoop-mapreduce-client-app\src\main\java\org\apache\hadoop\mapreduce\v2\app\webapp\dao\ConfInfo.java,31,12,3,1,0,16
hadoop-trunk\hadoop-trunk\hadoop-tools\hadoop-aws\src\main\java\org\apache\hadoop\fs\s3a\commit\AbstractS3ACommitterFactory.java,0,8,0,1,0,9
hadoop-trunk\hadoop-trunk\hadoop-common-project\hadoop-nfs\src\main\java\org\apache\hadoop\nfs\nfs3\response\CREATE3Response.java,63,26,0,1,0,27
hadoop-trunk\hadoop-trunk\hadoop-common-project\hadoop-common\src\main\java\org\apache\hadoop\fs\EtagSource.java,0,0,0,1,0,1
hadoop-trunk\hadoop-trunk\hadoop-common-project\hadoop-common\src\main\java\org\apache\hadoop\io\ObjectWritable.java,0,153,39,6,0,198
hadoop-trunk\hadoop-trunk\hadoop-yarn-project\hadoop-yarn\hadoop-yarn-api\src\main\java\org\apache\hadoop\yarn\api\records\ResourceOption.java,56,11,0,1,0,12
hadoop-trunk\hadoop-trunk\hadoop-yarn-project\hadoop-yarn\hadoop-yarn-server\hadoop-yarn-server-resourcemanager\src\main\java\org\apache\hadoop\yarn\server\resourcemanager\webapp\dao\BulkActivitiesInfo.java,21,10,3,1,0,14
hadoop-trunk\hadoop-trunk\hadoop-common-project\hadoop-common\src\main\java\org\apache\hadoop\net\ScriptBasedMapping.java,243,43,12,4,0,59
hadoop-trunk\hadoop-trunk\hadoop-hdfs-project\hadoop-hdfs\src\test\java\org\apache\hadoop\hdfs\net\TestDFSNetworkTopology.java,620,125,36,1,0,162
hadoop-trunk\hadoop-trunk\hadoop-hdfs-project\hadoop-hdfs-rbf\src\main\java\org\apache\hadoop\hdfs\server\federation\store\protocol\impl\pb\GetSafeModeRequestPBImpl.java,0,9,23,5,0,37
hadoop-trunk\hadoop-trunk\hadoop-yarn-project\hadoop-yarn\hadoop-yarn-server\hadoop-yarn-server-nodemanager\src\main\java\org\apache\hadoop\yarn\server\nodemanager\containermanager\linux\resources\CGroupsCpuResourceHandlerImpl.java,206,34,8,5,0,47
hadoop-trunk\hadoop-trunk\hadoop-hdfs-project\hadoop-hdfs-rbf\src\test\java\org\apache\hadoop\hdfs\server\federation\fairness\TestRouterRpcFairnessPolicyController.java,171,47,1,5,0,53
hadoop-trunk\hadoop-trunk\hadoop-yarn-project\hadoop-yarn\hadoop-yarn-server\hadoop-yarn-server-resourcemanager\src\test\java\org\apache\hadoop\yarn\server\resourcemanager\applicationsmanager\MockAsm.java,337,67,2,1,0,70
hadoop-trunk\hadoop-trunk\hadoop-common-project\hadoop-common\src\main\java\org\apache\hadoop\util\VersionInfo.java,147,37,11,1,0,49
hadoop-trunk\hadoop-trunk\hadoop-mapreduce-project\hadoop-mapreduce-client\hadoop-mapreduce-client-common\src\main\java\org\apache\hadoop\mapreduce\v2\api\records\TaskAttemptState.java,0,11,0,1,0,12
hadoop-trunk\hadoop-trunk\hadoop-mapreduce-project\hadoop-mapreduce-client\hadoop-mapreduce-client-core\src\main\java\org\apache\hadoop\mapreduce\lib\input\MultipleInputs.java,112,24,17,1,0,42
hadoop-trunk\hadoop-trunk\hadoop-mapreduce-project\hadoop-mapreduce-client\hadoop-mapreduce-client-core\src\test\java\org\apache\hadoop\mapred\TestMapFileOutputFormat.java,43,9,4,1,0,14
hadoop-trunk\hadoop-trunk\hadoop-yarn-project\hadoop-yarn\hadoop-yarn-server\hadoop-yarn-server-resourcemanager\src\main\java\org\apache\hadoop\yarn\server\resourcemanager\scheduler\capacity\placement\schema\Rule.java,319,279,0,18,0,297
hadoop-trunk\hadoop-trunk\hadoop-yarn-project\hadoop-yarn\hadoop-yarn-server\hadoop-yarn-server-resourcemanager\src\test\java\org\apache\hadoop\yarn\server\resourcemanager\scheduler\fair\allocationfile\AllocationFileWriter.java,0,59,1,2,0,62
hadoop-trunk\hadoop-trunk\hadoop-common-project\hadoop-registry\src\main\java\org\apache\hadoop\registry\client\impl\zk\RegistryOperationsService.java,0,31,3,2,0,36
hadoop-trunk\hadoop-trunk\hadoop-common-project\hadoop-common\src\main\java\org\apache\hadoop\util\Daemon.java,45,17,1,1,0,19
hadoop-trunk\hadoop-trunk\hadoop-cloud-storage-project\hadoop-huaweicloud\src\test\java\org\apache\hadoop\fs\obs\TestOBSContractOpen.java,8,1,0,1,0,2
hadoop-trunk\hadoop-trunk\hadoop-hdfs-project\hadoop-hdfs\src\test\java\org\apache\hadoop\hdfs\TestDFSStartupVersions.java,0,84,5,8,0,97
hadoop-trunk\hadoop-trunk\hadoop-hdfs-project\hadoop-hdfs\src\test\java\org\apache\hadoop\hdfs\TestHdfsAdmin.java,242,39,10,1,0,50
hadoop-trunk\hadoop-trunk\hadoop-tools\hadoop-streaming\src\test\java\org\apache\hadoop\streaming\TestGzipInput.java,0,5,1,1,0,7
hadoop-trunk\hadoop-trunk\hadoop-hdfs-project\hadoop-hdfs\src\test\java\org\apache\hadoop\hdfs\TestQuota.java,1665,236,34,12,0,282
hadoop-trunk\hadoop-trunk\hadoop-mapreduce-project\hadoop-mapreduce-client\hadoop-mapreduce-client-core\src\main\java\org\apache\hadoop\mapreduce\jobhistory\EventWriter.java,102,33,27,1,0,61
hadoop-trunk\hadoop-trunk\hadoop-yarn-project\hadoop-yarn\hadoop-yarn-server\hadoop-yarn-server-resourcemanager\src\main\java\org\apache\hadoop\yarn\server\resourcemanager\scheduler\capacity\QueueNodeLabelsSettings.java,113,42,1,14,0,57
hadoop-trunk\hadoop-trunk\hadoop-yarn-project\hadoop-yarn\hadoop-yarn-server\hadoop-yarn-server-resourcemanager\src\main\java\org\apache\hadoop\yarn\server\resourcemanager\IsResourceManagerActiveServlet.java,14,2,0,1,0,3
hadoop-trunk\hadoop-trunk\hadoop-common-project\hadoop-common\src\test\java\org\apache\hadoop\fs\contract\AbstractContractEtagTest.java,153,8,2,8,0,18
hadoop-trunk\hadoop-trunk\hadoop-common-project\hadoop-common\src\test\java\org\apache\hadoop\fs\contract\rawlocal\TestRawlocalContractSeek.java,8,2,0,1,0,3
hadoop-trunk\hadoop-trunk\hadoop-hdfs-project\hadoop-hdfs-client\src\main\java\org\apache\hadoop\hdfs\web\resources\RenameOptionSetParam.java,0,2,0,1,0,3
hadoop-trunk\hadoop-trunk\hadoop-yarn-project\hadoop-yarn\hadoop-yarn-server\hadoop-yarn-server-resourcemanager\src\main\java\org\apache\hadoop\yarn\server\resourcemanager\webapp\dao\ActivitiesInfo.java,73,28,6,2,0,36
hadoop-trunk\hadoop-trunk\hadoop-common-project\hadoop-common\src\main\java\org\apache\hadoop\security\WhitelistBasedResolver.java,86,35,0,12,0,47
hadoop-trunk\hadoop-trunk\hadoop-yarn-project\hadoop-yarn\hadoop-yarn-api\src\main\java\org\apache\hadoop\yarn\conf\HAUtil.java,325,65,7,1,0,73
hadoop-trunk\hadoop-trunk\hadoop-yarn-project\hadoop-yarn\hadoop-yarn-server\hadoop-yarn-server-applicationhistoryservice\src\main\java\org\apache\hadoop\yarn\server\timeline\TimelineStore.java,0,2,0,1,0,3
hadoop-trunk\hadoop-trunk\hadoop-common-project\hadoop-common\src\main\java\org\apache\hadoop\security\AuthenticationFilterInitializer.java,51,9,0,4,0,13
hadoop-trunk\hadoop-trunk\hadoop-common-project\hadoop-registry\src\main\java\org\apache\hadoop\registry\server\dns\SecureableZone.java,112,17,1,1,0,19
hadoop-trunk\hadoop-trunk\hadoop-mapreduce-project\hadoop-mapreduce-client\hadoop-mapreduce-client-core\src\main\java\org\apache\hadoop\mapred\lib\NLineInputFormat.java,0,36,1,2,0,39
hadoop-trunk\hadoop-trunk\hadoop-mapreduce-project\hadoop-mapreduce-client\hadoop-mapreduce-client-jobclient\src\test\java\org\apache\hadoop\mapred\lib\TestLineInputFormat.java,91,33,6,2,0,41
hadoop-trunk\hadoop-trunk\hadoop-hdfs-project\hadoop-hdfs\src\main\java\org\apache\hadoop\hdfs\server\namenode\FSDirConcatOp.java,0,41,6,6,0,53
hadoop-trunk\hadoop-trunk\hadoop-hdfs-project\hadoop-hdfs\src\main\java\org\apache\hadoop\hdfs\server\namenode\snapshot\SnapshotDiffInfo.java,0,50,3,4,0,57
hadoop-trunk\hadoop-trunk\hadoop-common-project\hadoop-common\src\test\java\org\apache\hadoop\service\launcher\testservices\InitInConstructorLaunchableService.java,34,10,0,2,0,12
hadoop-trunk\hadoop-trunk\hadoop-hdfs-project\hadoop-hdfs-client\src\main\java\org\apache\hadoop\hdfs\client\HdfsDataInputStream.java,75,10,0,1,0,11
hadoop-trunk\hadoop-trunk\hadoop-yarn-project\hadoop-yarn\hadoop-yarn-common\src\main\java\org\apache\hadoop\yarn\LocalConfigurationProvider.java,26,5,0,1,0,6
hadoop-trunk\hadoop-trunk\hadoop-hdfs-project\hadoop-hdfs\src\main\java\org\apache\hadoop\hdfs\tools\DelegationTokenFetcher.java,226,30,2,5,0,37
hadoop-trunk\hadoop-trunk\hadoop-yarn-project\hadoop-yarn\hadoop-yarn-server\hadoop-yarn-server-resourcemanager\src\test\java\org\apache\hadoop\yarn\server\resourcemanager\reservation\ReservationSystemTestUtil.java,414,141,14,13,0,168
hadoop-trunk\hadoop-trunk\hadoop-hdfs-project\hadoop-hdfs\src\main\java\org\apache\hadoop\hdfs\qjournal\protocolPB\QJournalProtocolPB.java,0,1,3,2,0,6
hadoop-trunk\hadoop-trunk\hadoop-yarn-project\hadoop-yarn\hadoop-yarn-server\hadoop-yarn-server-resourcemanager\src\main\java\org\apache\hadoop\yarn\server\resourcemanager\volume\csi\provisioner\package-info.java,0,1,0,1,0,2
hadoop-trunk\hadoop-trunk\hadoop-mapreduce-project\hadoop-mapreduce-client\hadoop-mapreduce-client-common\src\main\java\org\apache\hadoop\mapreduce\v2\api\protocolrecords\impl\pb\GetDiagnosticsRequestPBImpl.java,79,34,33,5,0,72
hadoop-trunk\hadoop-trunk\hadoop-common-project\hadoop-common\src\test\java\org\apache\hadoop\ipc\TestMultipleProtocolServer.java,29,4,0,1,0,5
hadoop-trunk\hadoop-trunk\hadoop-yarn-project\hadoop-yarn\hadoop-yarn-server\hadoop-yarn-server-common\src\main\java\org\apache\hadoop\yarn\server\federation\store\records\impl\pb\SetSubClusterPolicyConfigurationResponsePBImpl.java,0,13,23,3,0,39
hadoop-trunk\hadoop-trunk\hadoop-yarn-project\hadoop-yarn\hadoop-yarn-server\hadoop-yarn-server-resourcemanager\src\main\java\org\apache\hadoop\yarn\server\resourcemanager\scheduler\Queue.java,0,29,9,3,0,41
hadoop-trunk\hadoop-trunk\hadoop-mapreduce-project\hadoop-mapreduce-client\hadoop-mapreduce-client-app\src\main\java\org\apache\hadoop\mapreduce\v2\app\webapp\App.java,27,15,0,1,0,16
hadoop-trunk\hadoop-trunk\hadoop-common-project\hadoop-common\src\main\java\org\apache\hadoop\ipc\DecayRpcScheduler.java,0,197,16,3,0,216
hadoop-trunk\hadoop-trunk\hadoop-hdfs-project\hadoop-hdfs\src\test\java\org\apache\hadoop\hdfs\qjournal\client\TestQJMWithFaults.java,469,150,22,9,0,181
hadoop-trunk\hadoop-trunk\hadoop-hdfs-project\hadoop-hdfs-httpfs\src\test\java\org\apache\hadoop\lib\servlet\TestHostnameFilter.java,60,11,1,4,0,16
hadoop-trunk\hadoop-trunk\hadoop-yarn-project\hadoop-yarn\hadoop-yarn-server\hadoop-yarn-server-resourcemanager\src\main\java\org\apache\hadoop\yarn\server\resourcemanager\metrics\package-info.java,0,0,0,1,0,1
hadoop-trunk\hadoop-trunk\hadoop-yarn-project\hadoop-yarn\hadoop-yarn-server\hadoop-yarn-server-resourcemanager\src\test\java\org\apache\hadoop\yarn\server\resourcemanager\placement\csmappingrule\TestVariableContext.java,203,11,2,1,0,14
hadoop-trunk\hadoop-trunk\hadoop-yarn-project\hadoop-yarn\hadoop-yarn-server\hadoop-yarn-server-resourcemanager\src\test\java\org\apache\hadoop\yarn\server\resourcemanager\scheduler\capacity\conf\ConfigurationStoreBaseTest.java,69,16,0,2,0,18
hadoop-trunk\hadoop-trunk\hadoop-common-project\hadoop-common\src\main\java\org\apache\hadoop\fs\FileEncryptionInfo.java,116,16,0,1,0,17
hadoop-trunk\hadoop-trunk\hadoop-yarn-project\hadoop-yarn\hadoop-yarn-server\hadoop-yarn-server-nodemanager\src\test\java\org\apache\hadoop\yarn\server\nodemanager\recovery\TestNMLeveldbStateStoreService.java,1762,225,119,23,0,367
hadoop-trunk\hadoop-trunk\hadoop-mapreduce-project\hadoop-mapreduce-client\hadoop-mapreduce-client-uploader\src\main\java\org\apache\hadoop\mapred\uploader\UploaderException.java,0,1,0,1,0,2
hadoop-trunk\hadoop-trunk\hadoop-tools\hadoop-azure\src\test\java\org\apache\hadoop\fs\azurebfs\extensions\TestDTManagerLifecycle.java,151,12,1,6,0,19
hadoop-trunk\hadoop-trunk\hadoop-hdfs-project\hadoop-hdfs\src\test\java\org\apache\hadoop\hdfs\TestErasureCodingPoliciesWithRandomECPolicy.java,21,4,1,1,0,6
hadoop-trunk\hadoop-trunk\hadoop-tools\hadoop-aliyun\src\main\java\org\apache\hadoop\fs\aliyun\oss\Constants.java,0,58,0,1,0,59
hadoop-trunk\hadoop-trunk\hadoop-mapreduce-project\hadoop-mapreduce-client\hadoop-mapreduce-client-hs\src\main\java\org\apache\hadoop\mapreduce\v2\hs\server\HSAdminServer.java,231,42,2,14,0,58
hadoop-trunk\hadoop-trunk\hadoop-hdfs-project\hadoop-hdfs\src\test\java\org\apache\hadoop\hdfs\server\blockmanagement\TestBlockInfoStriped.java,243,32,47,1,0,80
hadoop-trunk\hadoop-trunk\hadoop-yarn-project\hadoop-yarn\hadoop-yarn-server\hadoop-yarn-server-nodemanager\src\main\java\org\apache\hadoop\yarn\server\nodemanager\NodeManagerEvent.java,0,5,0,1,0,6
hadoop-trunk\hadoop-trunk\hadoop-hdfs-project\hadoop-hdfs-client\src\main\java\org\apache\hadoop\hdfs\protocol\ECTopologyVerifierResult.java,20,11,0,1,0,12
hadoop-trunk\hadoop-trunk\hadoop-yarn-project\hadoop-yarn\hadoop-yarn-common\src\main\java\org\apache\hadoop\yarn\api\records\impl\pb\ResourceAllocationRequestPBImpl.java,139,26,45,2,0,73
hadoop-trunk\hadoop-trunk\hadoop-yarn-project\hadoop-yarn\hadoop-yarn-server\hadoop-yarn-server-resourcemanager\src\main\java\org\apache\hadoop\yarn\server\resourcemanager\scheduler\event\ContainerExpiredSchedulerEvent.java,25,17,0,2,0,19
hadoop-trunk\hadoop-trunk\hadoop-tools\hadoop-sls\src\test\java\org\apache\hadoop\yarn\sls\TestSLSStreamAMSynth.java,39,5,1,3,0,9
hadoop-trunk\hadoop-trunk\hadoop-yarn-project\hadoop-yarn\hadoop-yarn-common\src\test\java\org\apache\hadoop\yarn\webapp\view\TestHtmlBlock.java,43,14,2,1,0,17
hadoop-trunk\hadoop-trunk\hadoop-yarn-project\hadoop-yarn\hadoop-yarn-server\hadoop-yarn-server-common\src\main\java\org\apache\hadoop\yarn\server\federation\resolver\DefaultSubClusterResolverImpl.java,0,17,8,1,0,26
hadoop-trunk\hadoop-trunk\hadoop-yarn-project\hadoop-yarn\hadoop-yarn-common\src\main\java\org\apache\hadoop\yarn\api\protocolrecords\impl\pb\CommitResponsePBImpl.java,43,16,17,1,0,34
hadoop-trunk\hadoop-trunk\hadoop-yarn-project\hadoop-yarn\hadoop-yarn-server\hadoop-yarn-server-nodemanager\src\test\java\org\apache\hadoop\yarn\server\nodemanager\containermanager\resourceplugin\TestResourcePluginManager.java,456,61,9,12,0,82
hadoop-trunk\hadoop-trunk\hadoop-common-project\hadoop-common\src\main\java\org\apache\hadoop\fs\sftp\package-info.java,0,1,0,1,0,2
hadoop-trunk\hadoop-trunk\hadoop-hdfs-project\hadoop-hdfs\src\main\java\org\apache\hadoop\hdfs\server\datanode\BlockChecksumHelper.java,0,86,12,5,0,103
hadoop-trunk\hadoop-trunk\hadoop-yarn-project\hadoop-yarn\hadoop-yarn-server\hadoop-yarn-server-common\src\main\java\org\apache\hadoop\yarn\server\webapp\dao\AppsInfo.java,18,9,3,1,0,13
hadoop-trunk\hadoop-trunk\hadoop-common-project\hadoop-common\src\main\java\org\apache\hadoop\ha\PowerShellFencer.java,115,8,8,1,0,17
hadoop-trunk\hadoop-trunk\hadoop-hdfs-project\hadoop-hdfs-rbf\src\test\java\org\apache\hadoop\fs\contract\router\web\TestRouterWebHDFSContractOpen.java,32,4,0,1,0,5
hadoop-trunk\hadoop-trunk\hadoop-yarn-project\hadoop-yarn\hadoop-yarn-csi\src\main\java\org\apache\hadoop\yarn\csi\adaptor\DefaultCsiAdaptorImpl.java,82,17,18,3,0,38
hadoop-trunk\hadoop-trunk\hadoop-common-project\hadoop-common\src\main\java\org\apache\hadoop\fs\PartialListing.java,54,21,0,1,0,22
hadoop-trunk\hadoop-trunk\hadoop-mapreduce-project\hadoop-mapreduce-client\hadoop-mapreduce-client-jobclient\src\test\java\org\apache\hadoop\mapreduce\lib\input\TestCombineSequenceFileInputFormat.java,140,52,3,2,0,57
hadoop-trunk\hadoop-trunk\hadoop-yarn-project\hadoop-yarn\hadoop-yarn-applications\hadoop-yarn-applications-catalog\hadoop-yarn-applications-catalog-webapp\src\main\java\org\apache\hadoop\yarn\appcatalog\model\AppDetails.java,48,34,0,1,0,35
hadoop-trunk\hadoop-trunk\hadoop-common-project\hadoop-common\src\test\java\org\apache\hadoop\metrics2\impl\TestMetricsCollectorImpl.java,30,5,3,1,0,9
hadoop-trunk\hadoop-trunk\hadoop-common-project\hadoop-registry\src\main\java\org\apache\hadoop\registry\client\impl\zk\RegistryBindingSource.java,0,2,0,1,0,3
hadoop-trunk\hadoop-trunk\hadoop-yarn-project\hadoop-yarn\hadoop-yarn-common\src\main\java\org\apache\hadoop\yarn\factories\RpcClientFactory.java,0,6,2,1,0,9
hadoop-trunk\hadoop-trunk\hadoop-yarn-project\hadoop-yarn\hadoop-yarn-server\hadoop-yarn-server-common\src\main\java\org\apache\hadoop\yarn\server\AMHeartbeatRequestHandler.java,191,41,7,1,0,49
hadoop-trunk\hadoop-trunk\hadoop-yarn-project\hadoop-yarn\hadoop-yarn-server\hadoop-yarn-server-nodemanager\src\test\java\org\apache\hadoop\yarn\server\nodemanager\amrmproxy\TestableFederationInterceptor.java,231,62,2,1,0,65
hadoop-trunk\hadoop-trunk\hadoop-common-project\hadoop-common\src\main\java\org\apache\hadoop\fs\FSDataInputStream.java,0,79,3,1,0,83
hadoop-trunk\hadoop-trunk\hadoop-common-project\hadoop-common\src\test\java\org\apache\hadoop\service\TestServiceOperations.java,23,4,0,1,0,5
hadoop-trunk\hadoop-trunk\hadoop-mapreduce-project\hadoop-mapreduce-client\hadoop-mapreduce-client-common\src\main\java\org\apache\hadoop\mapreduce\v2\api\protocolrecords\GetDiagnosticsRequest.java,0,7,2,1,0,10
hadoop-trunk\hadoop-trunk\hadoop-tools\hadoop-aws\src\main\java\org\apache\hadoop\fs\s3a\commit\staging\Paths.java,0,21,6,5,0,32
hadoop-trunk\hadoop-trunk\hadoop-tools\hadoop-streaming\src\test\java\org\apache\hadoop\streaming\FailApp.java,0,9,3,1,0,13
hadoop-trunk\hadoop-trunk\hadoop-common-project\hadoop-kms\src\test\java\org\apache\hadoop\crypto\key\kms\server\TestKMS.java,0,282,241,56,0,579
hadoop-trunk\hadoop-trunk\hadoop-common-project\hadoop-common\src\test\java\org\apache\hadoop\io\file\tfile\TestTFileLzoCodecsStreams.java,16,2,1,1,0,4
hadoop-trunk\hadoop-trunk\hadoop-yarn-project\hadoop-yarn\hadoop-yarn-server\hadoop-yarn-server-resourcemanager\src\main\java\org\apache\hadoop\yarn\server\resourcemanager\rmapp\RMAppEvent.java,32,22,0,1,0,23
hadoop-trunk\hadoop-trunk\hadoop-common-project\hadoop-common\src\main\java\org\apache\hadoop\io\ByteWritable.java,0,33,5,1,0,39
hadoop-trunk\hadoop-trunk\hadoop-hdfs-project\hadoop-hdfs\src\test\java\org\apache\hadoop\hdfs\protocol\datatransfer\sasl\TestSaslDataTransfer.java,345,47,14,3,0,64
hadoop-trunk\hadoop-trunk\hadoop-yarn-project\hadoop-yarn\hadoop-yarn-server\hadoop-yarn-server-nodemanager\src\main\java\org\apache\hadoop\yarn\server\nodemanager\containermanager\linux\privileged\PrivilegedOperation.java,158,93,0,2,0,95
hadoop-trunk\hadoop-trunk\hadoop-yarn-project\hadoop-yarn\hadoop-yarn-server\hadoop-yarn-server-timelineservice-hbase\hadoop-yarn-server-timelineservice-hbase-server\hadoop-yarn-server-timelineservice-hbase-server-2\src\main\java\org\apache\hadoop\yarn\server\timelineservice\storage\flow\FlowScannerOperation.java,0,0,0,1,0,1
hadoop-trunk\hadoop-trunk\hadoop-hdfs-project\hadoop-hdfs\src\main\java\org\apache\hadoop\hdfs\server\aliasmap\InMemoryAliasMapProtocol.java,0,11,0,1,0,12
hadoop-trunk\hadoop-trunk\hadoop-yarn-project\hadoop-yarn\hadoop-yarn-applications\hadoop-yarn-services\hadoop-yarn-services-core\src\main\java\org\apache\hadoop\yarn\service\monitor\probe\LogEntryBuilder.java,55,18,2,1,0,21
hadoop-trunk\hadoop-trunk\hadoop-tools\hadoop-dynamometer\hadoop-dynamometer-infra\src\main\java\org\apache\hadoop\tools\dynamometer\ApplicationMaster.java,782,82,43,1,0,126
hadoop-trunk\hadoop-trunk\hadoop-yarn-project\hadoop-yarn\hadoop-yarn-server\hadoop-yarn-server-resourcemanager\src\test\java\org\apache\hadoop\yarn\server\resourcemanager\scheduler\capacity\TestCapacitySchedulerWorkflowPriorityMapping.java,139,23,1,17,0,41
hadoop-trunk\hadoop-trunk\hadoop-mapreduce-project\hadoop-mapreduce-client\hadoop-mapreduce-client-core\src\main\java\org\apache\hadoop\mapred\LineRecordReader.java,0,106,10,2,0,118
hadoop-trunk\hadoop-trunk\hadoop-yarn-project\hadoop-yarn\hadoop-yarn-server\hadoop-yarn-server-resourcemanager\src\main\java\org\apache\hadoop\yarn\server\resourcemanager\scheduler\capacity\CSAssignment.java,178,116,0,3,0,119
hadoop-trunk\hadoop-trunk\hadoop-hdfs-project\hadoop-hdfs\src\main\java\org\apache\hadoop\hdfs\server\namenode\snapshot\DiffList.java,0,12,4,2,0,18
hadoop-trunk\hadoop-trunk\hadoop-hdfs-project\hadoop-hdfs\src\main\java\org\apache\hadoop\hdfs\server\namenode\visitor\NamespacePrintVisitor.java,0,39,1,4,0,44
hadoop-trunk\hadoop-trunk\hadoop-hdfs-project\hadoop-hdfs\src\test\java\org\apache\hadoop\hdfs\TestParallelReadUtil.java,0,132,9,8,0,149
hadoop-trunk\hadoop-trunk\hadoop-common-project\hadoop-common\src\main\java\org\apache\hadoop\fs\FSInputChecker.java,0,199,10,1,0,210
hadoop-trunk\hadoop-trunk\hadoop-mapreduce-project\hadoop-mapreduce-client\hadoop-mapreduce-client-app\src\test\java\org\apache\hadoop\mapred\TestYarnChild.java,88,17,1,2,0,20
hadoop-trunk\hadoop-trunk\hadoop-hdfs-project\hadoop-hdfs-client\src\main\java\org\apache\hadoop\fs\SWebHdfs.java,31,5,0,1,0,6
hadoop-trunk\hadoop-trunk\hadoop-yarn-project\hadoop-yarn\hadoop-yarn-server\hadoop-yarn-server-resourcemanager\src\test\java\org\apache\hadoop\yarn\server\resourcemanager\scheduler\AppMetricsChecker.java,0,30,0,13,0,43
hadoop-trunk\hadoop-trunk\hadoop-yarn-project\hadoop-yarn\hadoop-yarn-server\hadoop-yarn-server-resourcemanager\src\test\java\org\apache\hadoop\yarn\server\resourcemanager\scheduler\TestConfigurationMutationACLPolicies.java,133,19,1,3,0,23
hadoop-trunk\hadoop-trunk\hadoop-hdfs-project\hadoop-hdfs\src\test\java\org\apache\hadoop\fs\TestEnhancedByteBufferAccess.java,772,255,65,14,0,334
hadoop-trunk\hadoop-trunk\hadoop-yarn-project\hadoop-yarn\hadoop-yarn-common\src\main\java\org\apache\hadoop\yarn\webapp\WebAppException.java,17,7,0,1,0,8
hadoop-trunk\hadoop-trunk\hadoop-tools\hadoop-aws\src\test\java\org\apache\hadoop\fs\s3a\impl\TestS3AMultipartUploaderSupport.java,62,13,0,4,0,17
hadoop-trunk\hadoop-trunk\hadoop-common-project\hadoop-common\src\main\java\org\apache\hadoop\io\erasurecode\rawcoder\RSLegacyRawErasureCoderFactory.java,25,7,0,1,0,8
hadoop-trunk\hadoop-trunk\hadoop-tools\hadoop-sls\src\main\java\org\apache\hadoop\yarn\sls\AMDefinitionSLS.java,157,37,3,3,0,43
hadoop-trunk\hadoop-trunk\hadoop-common-project\hadoop-registry\src\test\java\org\apache\hadoop\registry\AbstractZKRegistryTest.java,74,19,1,2,0,22
hadoop-trunk\hadoop-trunk\hadoop-hdfs-project\hadoop-hdfs\src\test\java\org\apache\hadoop\hdfs\server\namenode\TestCacheDirectivesWithViewDFS.java,27,4,0,1,0,5
hadoop-trunk\hadoop-trunk\hadoop-hdfs-project\hadoop-hdfs\src\main\java\org\apache\hadoop\hdfs\server\namenode\CheckpointSignature.java,0,54,4,2,0,60
hadoop-trunk\hadoop-trunk\hadoop-yarn-project\hadoop-yarn\hadoop-yarn-server\hadoop-yarn-server-resourcemanager\src\main\java\org\apache\hadoop\yarn\server\resourcemanager\scheduler\constraint\InvalidAllocationTagsQueryException.java,12,4,0,1,0,5
hadoop-trunk\hadoop-trunk\hadoop-common-project\hadoop-nfs\src\main\java\org\apache\hadoop\portmap\PortmapResponse.java,29,16,1,1,0,18
hadoop-trunk\hadoop-trunk\hadoop-mapreduce-project\hadoop-mapreduce-client\hadoop-mapreduce-client-core\src\main\java\org\apache\hadoop\mapreduce\lib\input\NLineInputFormat.java,0,39,0,2,0,41
hadoop-trunk\hadoop-trunk\hadoop-yarn-project\hadoop-yarn\hadoop-yarn-applications\hadoop-yarn-services\hadoop-yarn-services-core\src\main\java\org\apache\hadoop\yarn\service\exceptions\UsageException.java,11,7,0,1,0,8
hadoop-trunk\hadoop-trunk\hadoop-yarn-project\hadoop-yarn\hadoop-yarn-server\hadoop-yarn-server-resourcemanager\src\main\java\org\apache\hadoop\yarn\server\resourcemanager\scheduler\common\ApplicationSchedulingConfig.java,14,6,1,4,0,11
hadoop-trunk\hadoop-trunk\hadoop-common-project\hadoop-common\src\main\java\org\apache\hadoop\security\token\delegation\web\PseudoDelegationTokenAuthenticationHandler.java,0,4,0,3,0,7
hadoop-trunk\hadoop-trunk\hadoop-hdfs-project\hadoop-hdfs\src\main\java\org\apache\hadoop\hdfs\server\diskbalancer\package-info.java,0,2,0,1,0,3
hadoop-trunk\hadoop-trunk\hadoop-hdfs-project\hadoop-hdfs-client\src\main\java\org\apache\hadoop\hdfs\web\ByteRangeInputStream.java,258,85,4,2,0,91
hadoop-trunk\hadoop-trunk\hadoop-tools\hadoop-aws\src\test\java\org\apache\hadoop\fs\s3a\MockS3AFileSystem.java,324,100,11,3,0,114
hadoop-trunk\hadoop-trunk\hadoop-hdfs-project\hadoop-hdfs\src\main\java\org\apache\hadoop\hdfs\server\namenode\EncryptionFaultInjector.java,32,24,7,1,0,32
hadoop-trunk\hadoop-trunk\hadoop-mapreduce-project\hadoop-mapreduce-client\hadoop-mapreduce-client-app\src\main\java\org\apache\hadoop\mapreduce\v2\app\launcher\package-info.java,0,1,0,1,0,2
hadoop-trunk\hadoop-trunk\hadoop-mapreduce-project\hadoop-mapreduce-client\hadoop-mapreduce-client-app\src\test\java\org\apache\hadoop\mapreduce\v2\app\webapp\TestAMWebServices.java,289,46,1,2,0,49
hadoop-trunk\hadoop-trunk\hadoop-tools\hadoop-gridmix\src\main\java\org\apache\hadoop\mapred\gridmix\RandomTextDataGenerator.java,0,48,2,2,0,52
hadoop-trunk\hadoop-trunk\hadoop-tools\hadoop-aws\src\test\java\org\apache\hadoop\fs\s3a\select\ITestS3SelectLandsat.java,316,28,5,10,0,43
hadoop-trunk\hadoop-trunk\hadoop-tools\hadoop-azure-datalake\src\test\java\org\apache\hadoop\fs\adl\common\Parallelized.java,30,6,1,1,0,8
hadoop-trunk\hadoop-trunk\hadoop-yarn-project\hadoop-yarn\hadoop-yarn-server\hadoop-yarn-server-resourcemanager\src\main\java\org\apache\hadoop\yarn\server\resourcemanager\scheduler\capacity\placement\GeneratePojos.java,0,4,0,3,0,7
hadoop-trunk\hadoop-trunk\hadoop-mapreduce-project\hadoop-mapreduce-client\hadoop-mapreduce-client-hs\src\main\java\org\apache\hadoop\mapreduce\v2\hs\webapp\package-info.java,0,1,0,1,0,2
hadoop-trunk\hadoop-trunk\hadoop-yarn-project\hadoop-yarn\hadoop-yarn-server\hadoop-yarn-server-resourcemanager\src\test\java\org\apache\hadoop\yarn\server\resourcemanager\scheduler\fair\TestApplicationMasterServiceWithFS.java,129,23,3,3,0,29
hadoop-trunk\hadoop-trunk\hadoop-tools\hadoop-azure\src\test\java\org\apache\hadoop\fs\azurebfs\contract\ITestAbfsFileSystemContractEtag.java,31,6,0,1,0,7
hadoop-trunk\hadoop-trunk\hadoop-hdfs-project\hadoop-hdfs\src\test\java\org\apache\hadoop\hdfs\server\namenode\TestNetworkTopologyServlet.java,164,21,3,1,0,25
hadoop-trunk\hadoop-trunk\hadoop-hdfs-project\hadoop-hdfs\src\main\java\org\apache\hadoop\hdfs\server\sps\ExternalSPSFilePathCollector.java,131,19,2,1,0,22
hadoop-trunk\hadoop-trunk\hadoop-hdfs-project\hadoop-hdfs-rbf\src\main\java\org\apache\hadoop\hdfs\server\federation\store\protocol\impl\pb\NamenodeHeartbeatResponsePBImpl.java,0,11,28,4,0,43
hadoop-trunk\hadoop-trunk\hadoop-yarn-project\hadoop-yarn\hadoop-yarn-api\src\main\java\org\apache\hadoop\yarn\api\protocolrecords\MoveApplicationAcrossQueuesRequest.java,34,11,0,3,0,14
hadoop-trunk\hadoop-trunk\hadoop-hdfs-project\hadoop-hdfs\src\main\java\org\apache\hadoop\hdfs\server\common\sps\BlockStorageMovementTracker.java,59,9,2,1,0,12
hadoop-trunk\hadoop-trunk\hadoop-mapreduce-project\hadoop-mapreduce-client\hadoop-mapreduce-client-nativetask\src\main\java\org\apache\hadoop\mapred\nativetask\serde\VLongWritableSerializer.java,3,1,0,1,0,2
hadoop-trunk\hadoop-trunk\hadoop-hdfs-project\hadoop-hdfs-client\src\main\java\org\apache\hadoop\hdfs\protocol\DatanodeLocalInfo.java,35,18,0,1,0,19
hadoop-trunk\hadoop-trunk\hadoop-hdfs-project\hadoop-hdfs\src\test\java\org\apache\hadoop\hdfs\TestReadStripedFileWithMissingBlocks.java,129,34,5,1,0,40
hadoop-trunk\hadoop-trunk\hadoop-mapreduce-project\hadoop-mapreduce-client\hadoop-mapreduce-client-app\src\test\java\org\apache\hadoop\mapreduce\v2\app\TestMRApp.java,587,101,3,5,0,109
hadoop-trunk\hadoop-trunk\hadoop-tools\hadoop-gridmix\src\main\java\org\apache\hadoop\mapred\gridmix\RecordFactory.java,16,3,0,1,0,4
hadoop-trunk\hadoop-trunk\hadoop-hdfs-project\hadoop-hdfs\src\test\java\org\apache\hadoop\cli\util\CLICommandErasureCodingCli.java,3,1,0,1,0,2
hadoop-trunk\hadoop-trunk\hadoop-common-project\hadoop-common\src\test\java\org\apache\hadoop\ha\MiniZKFCCluster.java,326,117,4,7,0,128
hadoop-trunk\hadoop-trunk\hadoop-common-project\hadoop-common\src\test\java\org\apache\hadoop\io\file\tfile\TestTFileSeek.java,457,143,74,2,0,219
hadoop-trunk\hadoop-trunk\hadoop-hdfs-project\hadoop-hdfs-rbf\src\test\java\org\apache\hadoop\hdfs\server\federation\store\driver\TestStateStoreFile.java,45,8,0,3,0,11
hadoop-trunk\hadoop-trunk\hadoop-yarn-project\hadoop-yarn\hadoop-yarn-common\src\test\java\org\apache\hadoop\yarn\webapp\view\TestInfoBlock.java,89,33,2,3,0,38
hadoop-trunk\hadoop-trunk\hadoop-common-project\hadoop-common\src\main\java\org\apache\hadoop\security\authorize\RefreshAuthorizationPolicyProtocol.java,0,9,1,2,0,12
hadoop-trunk\hadoop-trunk\hadoop-common-project\hadoop-common\src\test\java\org\apache\hadoop\util\TestReadWriteDiskValidator.java,121,7,2,1,0,10
hadoop-trunk\hadoop-trunk\hadoop-common-project\hadoop-common\src\test\java\org\apache\hadoop\fs\contract\AbstractContractCopyFromLocalTest.java,297,50,0,1,0,51
hadoop-trunk\hadoop-trunk\hadoop-mapreduce-project\hadoop-mapreduce-client\hadoop-mapreduce-client-jobclient\src\test\java\org\apache\hadoop\mapred\TestClientServiceDelegate.java,514,125,3,30,0,158
hadoop-trunk\hadoop-trunk\hadoop-yarn-project\hadoop-yarn\hadoop-yarn-common\src\main\java\org\apache\hadoop\yarn\util\AbstractLivelinessMonitor.java,128,52,4,1,0,57
hadoop-trunk\hadoop-trunk\hadoop-yarn-project\hadoop-yarn\hadoop-yarn-common\src\test\java\org\apache\hadoop\yarn\util\TestRackResolverScriptBasedMapping.java,18,1,0,1,0,2
hadoop-trunk\hadoop-trunk\hadoop-yarn-project\hadoop-yarn\hadoop-yarn-server\hadoop-yarn-server-resourcemanager\src\test\java\org\apache\hadoop\yarn\server\resourcemanager\webapp\helper\JsonCustomResourceTypeTestcase.java,46,19,3,1,0,23
hadoop-trunk\hadoop-trunk\hadoop-hdfs-project\hadoop-hdfs\src\test\java\org\apache\hadoop\hdfs\protocol\datatransfer\sasl\TestBlackListBasedTrustedChannelResolver.java,52,10,3,2,0,15
hadoop-trunk\hadoop-trunk\hadoop-yarn-project\hadoop-yarn\hadoop-yarn-server\hadoop-yarn-server-resourcemanager\src\main\java\org\apache\hadoop\yarn\server\resourcemanager\scheduler\common\ContainerAllocationProposal.java,72,41,0,3,0,44
hadoop-trunk\hadoop-trunk\hadoop-yarn-project\hadoop-yarn\hadoop-yarn-api\src\main\java\org\apache\hadoop\yarn\api\records\timelineservice\package-info.java,0,0,0,1,0,1
hadoop-trunk\hadoop-trunk\hadoop-common-project\hadoop-common\src\test\java\org\apache\hadoop\io\TestSequenceFile.java,0,252,78,19,0,349
hadoop-trunk\hadoop-trunk\hadoop-hdfs-project\hadoop-hdfs\src\main\java\org\apache\hadoop\hdfs\server\datanode\FSCachingGetSpaceUsed.java,48,17,3,1,0,21
hadoop-trunk\hadoop-trunk\hadoop-hdfs-project\hadoop-hdfs\src\test\java\org\apache\hadoop\hdfs\TestHDFSTrash.java,148,39,3,1,0,43
hadoop-trunk\hadoop-trunk\hadoop-common-project\hadoop-common\src\main\java\org\apache\hadoop\io\DataInputBuffer.java,121,33,2,1,0,36
hadoop-trunk\hadoop-trunk\hadoop-hdfs-project\hadoop-hdfs\src\main\java\org\apache\hadoop\hdfs\NameNodeProxies.java,240,85,2,14,0,101
hadoop-trunk\hadoop-trunk\hadoop-hdfs-project\hadoop-hdfs-rbf\src\main\java\org\apache\hadoop\hdfs\server\federation\metrics\FederationRPCMBean.java,0,17,1,3,0,21
hadoop-trunk\hadoop-trunk\hadoop-common-project\hadoop-common\src\main\java\org\apache\hadoop\log\LogLevel.java,347,78,11,1,0,90
hadoop-trunk\hadoop-trunk\hadoop-yarn-project\hadoop-yarn\hadoop-yarn-common\src\test\java\org\apache\hadoop\yarn\event\DrainDispatcher.java,82,11,2,1,0,14
hadoop-trunk\hadoop-trunk\hadoop-yarn-project\hadoop-yarn\hadoop-yarn-server\hadoop-yarn-server-nodemanager\src\test\java\org\apache\hadoop\yarn\server\nodemanager\metrics\TestNodeManagerMetrics.java,113,43,2,1,0,46
hadoop-trunk\hadoop-trunk\hadoop-tools\hadoop-archives\src\main\java\org\apache\hadoop\tools\HadoopArchives.java,860,333,13,10,0,356
hadoop-trunk\hadoop-trunk\hadoop-tools\hadoop-gridmix\src\main\java\org\apache\hadoop\mapred\gridmix\SleepJob.java,357,117,14,3,0,134
hadoop-trunk\hadoop-trunk\hadoop-common-project\hadoop-nfs\src\main\java\org\apache\hadoop\nfs\nfs3\request\FSINFO3Request.java,16,10,0,1,0,11
hadoop-trunk\hadoop-trunk\hadoop-yarn-project\hadoop-yarn\hadoop-yarn-server\hadoop-yarn-server-common\src\main\java\org\apache\hadoop\yarn\server\api\protocolrecords\impl\pb\GetTimelineCollectorContextRequestPBImpl.java,104,20,34,4,0,58
hadoop-trunk\hadoop-trunk\hadoop-yarn-project\hadoop-yarn\hadoop-yarn-api\src\main\java\org\apache\hadoop\yarn\api\protocolrecords\GetQueueInfoRequest.java,0,13,0,1,0,14
hadoop-trunk\hadoop-trunk\hadoop-common-project\hadoop-common\src\main\java\org\apache\hadoop\net\DomainNameResolver.java,0,1,0,1,0,2
hadoop-trunk\hadoop-trunk\hadoop-hdfs-project\hadoop-hdfs-client\src\main\java\org\apache\hadoop\hdfs\DFSHedgedReadMetrics.java,30,18,0,1,0,19
hadoop-trunk\hadoop-trunk\hadoop-hdfs-project\hadoop-hdfs-client\src\main\java\org\apache\hadoop\hdfs\protocol\DirectoryListing.java,59,14,1,1,0,16
hadoop-trunk\hadoop-trunk\hadoop-common-project\hadoop-common\src\test\java\org\apache\hadoop\io\TestTextNonUTF8.java,23,10,1,1,0,12
hadoop-trunk\hadoop-trunk\hadoop-hdfs-project\hadoop-hdfs\src\main\java\org\apache\hadoop\hdfs\server\namenode\top\TopAuditLogger.java,58,18,2,3,0,23
hadoop-trunk\hadoop-trunk\hadoop-tools\hadoop-dynamometer\hadoop-dynamometer-workload\src\main\java\org\apache\hadoop\tools\dynamometer\workloadgenerator\audit\NoSplitTextInputFormat.java,16,5,0,1,0,6
hadoop-trunk\hadoop-trunk\hadoop-yarn-project\hadoop-yarn\hadoop-yarn-api\src\main\java\org\apache\hadoop\yarn\exceptions\InvalidContainerException.java,9,4,0,1,0,5
hadoop-trunk\hadoop-trunk\hadoop-common-project\hadoop-common\src\test\java\org\apache\hadoop\ipc\TestProcessingDetails.java,32,11,0,1,0,12
hadoop-trunk\hadoop-trunk\hadoop-hdfs-project\hadoop-hdfs\src\test\java\org\apache\hadoop\hdfs\UpgradeUtilities.java,0,188,9,19,0,216
hadoop-trunk\hadoop-trunk\hadoop-mapreduce-project\hadoop-mapreduce-client\hadoop-mapreduce-client-core\src\main\java\org\apache\hadoop\mapreduce\TaskInputOutputContext.java,0,13,9,1,0,23
hadoop-trunk\hadoop-trunk\hadoop-mapreduce-project\hadoop-mapreduce-client\hadoop-mapreduce-client-core\src\main\java\org\apache\hadoop\mapreduce\task\reduce\MergeThread.java,0,30,4,1,0,35
hadoop-trunk\hadoop-trunk\hadoop-yarn-project\hadoop-yarn\hadoop-yarn-api\src\main\java\org\apache\hadoop\yarn\api\protocolrecords\UseSharedCacheResourceRequest.java,39,0,0,1,0,1
hadoop-trunk\hadoop-trunk\hadoop-hdfs-project\hadoop-hdfs-rbf\src\main\java\org\apache\hadoop\hdfs\server\federation\store\impl\MembershipStoreImpl.java,0,17,9,12,0,38
hadoop-trunk\hadoop-trunk\hadoop-tools\hadoop-distcp\src\main\java\org\apache\hadoop\tools\CopyListing.java,289,53,1,15,0,69
hadoop-trunk\hadoop-trunk\hadoop-yarn-project\hadoop-yarn\hadoop-yarn-server\hadoop-yarn-server-nodemanager\src\test\java\org\apache\hadoop\yarn\server\nodemanager\nodelabels\TestScriptBasedNodeAttributesProvider.java,207,28,1,1,0,30
hadoop-trunk\hadoop-trunk\hadoop-tools\hadoop-azure\src\main\java\org\apache\hadoop\fs\azure\SecureStorageInterfaceImpl.java,543,156,3,30,0,189
hadoop-trunk\hadoop-trunk\hadoop-tools\hadoop-azure\src\test\java\org\apache\hadoop\fs\azurebfs\TrileanTests.java,62,6,4,2,0,12
hadoop-trunk\hadoop-trunk\hadoop-common-project\hadoop-common\src\main\java\org\apache\hadoop\metrics2\impl\MetricsBufferBuilder.java,0,3,0,1,0,4
hadoop-trunk\hadoop-trunk\hadoop-hdfs-project\hadoop-hdfs\src\test\java\org\apache\hadoop\hdfs\server\namenode\TestSecurityTokenEditLog.java,208,75,7,16,0,98
hadoop-trunk\hadoop-trunk\hadoop-yarn-project\hadoop-yarn\hadoop-yarn-server\hadoop-yarn-server-common\src\main\java\org\apache\hadoop\yarn\server\federation\store\package-info.java,0,1,0,1,0,2
hadoop-trunk\hadoop-trunk\hadoop-yarn-project\hadoop-yarn\hadoop-yarn-server\hadoop-yarn-server-nodemanager\src\main\java\org\apache\hadoop\yarn\server\nodemanager\containermanager\linux\runtime\docker\DockerKillCommand.java,20,5,0,2,0,7
hadoop-trunk\hadoop-trunk\hadoop-common-project\hadoop-nfs\src\main\java\org\apache\hadoop\nfs\nfs3\response\WRITE3Response.java,61,31,4,1,0,36
hadoop-trunk\hadoop-trunk\hadoop-yarn-project\hadoop-yarn\hadoop-yarn-server\hadoop-yarn-server-resourcemanager\src\main\java\org\apache\hadoop\yarn\server\resourcemanager\scheduler\capacity\placement\converter\LegacyMappingRuleToJson.java,372,35,6,3,0,44
hadoop-trunk\hadoop-trunk\hadoop-tools\hadoop-aws\src\test\java\org\apache\hadoop\fs\s3a\commit\staging\integration\ITestStagingCommitProtocol.java,171,34,1,2,0,37
hadoop-trunk\hadoop-trunk\hadoop-tools\hadoop-openstack\src\main\java\org\apache\hadoop\fs\swift\auth\entities\AccessToken.java,66,15,0,1,0,16
hadoop-trunk\hadoop-trunk\hadoop-yarn-project\hadoop-yarn\hadoop-yarn-common\src\main\java\org\apache\hadoop\yarn\api\protocolrecords\impl\pb\CancelDelegationTokenResponsePBImpl.java,38,17,13,3,0,33
hadoop-trunk\hadoop-trunk\hadoop-hdfs-project\hadoop-hdfs-rbf\src\test\java\org\apache\hadoop\fs\contract\router\TestRouterHDFSContractDelete.java,18,4,0,1,0,5
hadoop-trunk\hadoop-trunk\hadoop-mapreduce-project\hadoop-mapreduce-client\hadoop-mapreduce-client-core\src\main\java\org\apache\hadoop\mapred\lib\MultipleOutputFormat.java,0,43,3,6,0,52
hadoop-trunk\hadoop-trunk\hadoop-yarn-project\hadoop-yarn\hadoop-yarn-common\src\test\java\org\apache\hadoop\yarn\security\TestDockerClientConfigHandler.java,0,10,5,1,0,16
hadoop-trunk\hadoop-trunk\hadoop-yarn-project\hadoop-yarn\hadoop-yarn-server\hadoop-yarn-server-common\src\main\java\org\apache\hadoop\yarn\server\api\impl\pb\service\ResourceTrackerPBServiceImpl.java,49,17,16,16,0,49
hadoop-trunk\hadoop-trunk\hadoop-yarn-project\hadoop-yarn\hadoop-yarn-server\hadoop-yarn-server-nodemanager\src\main\java\org\apache\hadoop\yarn\server\nodemanager\executor\DeletionAsUserContext.java,0,22,3,1,0,26
hadoop-trunk\hadoop-trunk\hadoop-yarn-project\hadoop-yarn\hadoop-yarn-server\hadoop-yarn-server-resourcemanager\src\test\java\org\apache\hadoop\yarn\webapp\TestRMWithCSRFFilter.java,160,36,4,7,0,47
hadoop-trunk\hadoop-trunk\hadoop-yarn-project\hadoop-yarn\hadoop-yarn-server\hadoop-yarn-server-nodemanager\src\main\java\org\apache\hadoop\yarn\server\nodemanager\containermanager\localizer\LocalCacheDirectoryManager.java,176,27,2,2,0,31
hadoop-trunk\hadoop-trunk\hadoop-yarn-project\hadoop-yarn\hadoop-yarn-server\hadoop-yarn-server-timelineservice\src\test\java\org\apache\hadoop\yarn\server\timelineservice\storage\TestFileSystemTimelineReaderImpl.java,788,118,34,13,0,165
hadoop-trunk\hadoop-trunk\hadoop-hdfs-project\hadoop-hdfs-rbf\src\main\java\org\apache\hadoop\hdfs\server\federation\router\RouterNetworkTopologyServlet.java,34,4,2,1,0,7
hadoop-trunk\hadoop-trunk\hadoop-hdfs-project\hadoop-hdfs\src\main\java\org\apache\hadoop\hdfs\server\diskbalancer\connectors\DBNameNodeConnector.java,0,12,3,1,0,16
hadoop-trunk\hadoop-trunk\hadoop-yarn-project\hadoop-yarn\hadoop-yarn-server\hadoop-yarn-server-nodemanager\src\test\java\org\apache\hadoop\yarn\server\nodemanager\containermanager\localizer\TestLocalCacheCleanup.java,207,66,1,2,0,69
hadoop-trunk\hadoop-trunk\hadoop-hdfs-project\hadoop-hdfs\src\test\java\org\apache\hadoop\hdfs\server\namenode\TestFSDirWriteFileOp.java,37,3,1,2,0,6
hadoop-trunk\hadoop-trunk\hadoop-common-project\hadoop-common\src\main\java\org\apache\hadoop\metrics2\MetricsSink.java,0,3,0,1,0,4
hadoop-trunk\hadoop-trunk\hadoop-common-project\hadoop-common\src\main\java\org\apache\hadoop\util\Sets.java,0,55,12,1,0,68
hadoop-trunk\hadoop-trunk\hadoop-yarn-project\hadoop-yarn\hadoop-yarn-server\hadoop-yarn-server-resourcemanager\src\main\java\org\apache\hadoop\yarn\server\resourcemanager\placement\csmappingrule\MappingRuleConditionalVariable.java,0,1,0,1,0,2
hadoop-trunk\hadoop-trunk\hadoop-common-project\hadoop-common\src\main\java\org\apache\hadoop\fs\PathIsNotDirectoryException.java,8,3,0,1,0,4
hadoop-trunk\hadoop-trunk\hadoop-yarn-project\hadoop-yarn\hadoop-yarn-server\hadoop-yarn-server-resourcemanager\src\main\java\org\apache\hadoop\yarn\server\resourcemanager\scheduler\DefaultConfigurationMutationACLPolicy.java,16,7,0,1,0,8
hadoop-trunk\hadoop-trunk\hadoop-yarn-project\hadoop-yarn\hadoop-yarn-server\hadoop-yarn-server-resourcemanager\src\test\java\org\apache\hadoop\yarn\server\resourcemanager\scheduler\capacity\TestAutoCreatedQueueTemplate.java,155,37,0,2,0,39
hadoop-trunk\hadoop-trunk\hadoop-hdfs-project\hadoop-hdfs-client\src\main\java\org\apache\hadoop\hdfs\client\impl\BlockReaderLocalLegacy.java,0,123,9,3,0,135
hadoop-trunk\hadoop-trunk\hadoop-tools\hadoop-aws\src\main\java\org\apache\hadoop\fs\s3a\AWSServiceIOException.java,42,16,0,1,0,17
hadoop-trunk\hadoop-trunk\hadoop-tools\hadoop-rumen\src\main\java\org\apache\hadoop\tools\rumen\datatypes\DefaultAnonymizableDataType.java,0,17,0,1,0,18
hadoop-trunk\hadoop-trunk\hadoop-hdfs-project\hadoop-hdfs\src\test\java\org\apache\hadoop\hdfs\server\namenode\ha\TestEditLogsDuringFailover.java,172,37,6,5,0,48
hadoop-trunk\hadoop-trunk\hadoop-mapreduce-project\hadoop-mapreduce-client\hadoop-mapreduce-client-jobclient\src\test\java\org\apache\hadoop\mapreduce\lib\db\TestDataDrivenDBInputFormat.java,183,49,10,1,0,60
hadoop-trunk\hadoop-trunk\hadoop-yarn-project\hadoop-yarn\hadoop-yarn-server\hadoop-yarn-server-timelineservice\src\test\java\org\apache\hadoop\yarn\server\timelineservice\collector\TestPerNodeAggTimelineCollectorMetrics.java,28,9,0,2,0,11
hadoop-trunk\hadoop-trunk\hadoop-mapreduce-project\hadoop-mapreduce-client\hadoop-mapreduce-client-core\src\main\java\org\apache\hadoop\mapreduce\lib\input\InvalidInputException.java,41,7,0,1,0,8
hadoop-trunk\hadoop-trunk\hadoop-common-project\hadoop-common\src\main\java\org\apache\hadoop\io\erasurecode\rawcoder\CoderUtil.java,0,37,0,1,0,38
hadoop-trunk\hadoop-trunk\hadoop-common-project\hadoop-common\src\main\java\org\apache\hadoop\security\authorize\package-info.java,0,1,0,1,0,2
hadoop-trunk\hadoop-trunk\hadoop-yarn-project\hadoop-yarn\hadoop-yarn-server\hadoop-yarn-server-common\src\main\java\org\apache\hadoop\yarn\server\security\BaseNMTokenSecretManager.java,107,36,4,1,0,41
hadoop-trunk\hadoop-trunk\hadoop-common-project\hadoop-registry\src\test\java\org\apache\hadoop\registry\cli\TestRegistryCli.java,168,40,4,20,0,64
hadoop-trunk\hadoop-trunk\hadoop-yarn-project\hadoop-yarn\hadoop-yarn-server\hadoop-yarn-server-resourcemanager\src\main\java\org\apache\hadoop\yarn\server\resourcemanager\placement\FairQueuePlacementUtils.java,0,10,7,2,0,19
hadoop-trunk\hadoop-trunk\hadoop-mapreduce-project\hadoop-mapreduce-client\hadoop-mapreduce-client-core\src\main\java\org\apache\hadoop\mapreduce\lib\output\committer\manifest\stages\SaveSuccessFileStage.java,0,4,1,7,0,12
hadoop-trunk\hadoop-trunk\hadoop-mapreduce-project\hadoop-mapreduce-client\hadoop-mapreduce-client-core\src\main\java\org\apache\hadoop\mapreduce\lib\reduce\IntSumReducer.java,0,11,1,1,0,13
hadoop-trunk\hadoop-trunk\hadoop-common-project\hadoop-common\src\main\java\org\apache\hadoop\io\file\tfile\MetaBlockAlreadyExists.java,12,5,1,1,0,7
hadoop-trunk\hadoop-trunk\hadoop-hdfs-project\hadoop-hdfs\src\test\java\org\apache\hadoop\hdfs\server\datanode\checker\TestThrottledAsyncChecker.java,210,29,0,2,0,31
hadoop-trunk\hadoop-trunk\hadoop-yarn-project\hadoop-yarn\hadoop-yarn-server\hadoop-yarn-server-common\src\test\java\org\apache\hadoop\yarn\lib\TestZKClient.java,163,48,8,1,0,57
hadoop-trunk\hadoop-trunk\hadoop-mapreduce-project\hadoop-mapreduce-client\hadoop-mapreduce-client-app\src\test\java\org\apache\hadoop\mapreduce\v2\app\webapp\TestAMWebServicesJobConf.java,198,18,4,1,0,23
hadoop-trunk\hadoop-trunk\hadoop-yarn-project\hadoop-yarn\hadoop-yarn-server\hadoop-yarn-server-nodemanager\src\test\java\org\apache\hadoop\yarn\server\nodemanager\TestLinuxContainerExecutorWithMocks.java,641,82,7,13,0,102
hadoop-trunk\hadoop-trunk\hadoop-yarn-project\hadoop-yarn\hadoop-yarn-server\hadoop-yarn-server-resourcemanager\src\main\java\org\apache\hadoop\yarn\server\resourcemanager\scheduler\ActiveUsersManager.java,76,24,0,1,0,25
hadoop-trunk\hadoop-trunk\hadoop-hdfs-project\hadoop-hdfs\src\main\java\org\apache\hadoop\hdfs\protocolPB\NamenodeProtocolServerSideTranslatorPB.java,210,54,85,30,0,169
hadoop-trunk\hadoop-trunk\hadoop-hdfs-project\hadoop-hdfs-client\src\main\java\org\apache\hadoop\hdfs\NameNodeProxiesClient.java,312,80,2,5,0,87
hadoop-trunk\hadoop-trunk\hadoop-hdfs-project\hadoop-hdfs-client\src\main\java\org\apache\hadoop\hdfs\protocol\BlockChecksumType.java,0,2,0,1,0,3
hadoop-trunk\hadoop-trunk\hadoop-yarn-project\hadoop-yarn\hadoop-yarn-common\src\main\java\org\apache\hadoop\yarn\api\protocolrecords\impl\pb\ReservationUpdateResponsePBImpl.java,44,17,18,2,0,37
hadoop-trunk\hadoop-trunk\hadoop-yarn-project\hadoop-yarn\hadoop-yarn-server\hadoop-yarn-server-common\src\main\java\org\apache\hadoop\yarn\server\federation\policies\exceptions\UnknownSubclusterException.java,6,2,0,1,0,3
hadoop-trunk\hadoop-trunk\hadoop-hdfs-project\hadoop-hdfs\src\main\java\org\apache\hadoop\hdfs\server\namenode\Quota.java,0,14,0,2,0,16
hadoop-trunk\hadoop-trunk\hadoop-yarn-project\hadoop-yarn\hadoop-yarn-server\hadoop-yarn-server-resourcemanager\src\test\java\org\apache\hadoop\yarn\server\resourcemanager\placement\MockQueueHierarchyBuilder.java,178,51,3,6,0,60
hadoop-trunk\hadoop-trunk\hadoop-tools\hadoop-azure\src\main\java\org\apache\hadoop\fs\azurebfs\services\AbfsUriQueryBuilder.java,51,13,1,4,0,18
hadoop-trunk\hadoop-trunk\hadoop-yarn-project\hadoop-yarn\hadoop-yarn-api\src\main\java\org\apache\hadoop\yarn\api\records\ExecutionType.java,0,2,0,1,0,3
hadoop-trunk\hadoop-trunk\hadoop-hdfs-project\hadoop-hdfs\src\test\java\org\apache\hadoop\hdfs\TestReplaceDatanodeOnFailure.java,318,90,22,4,0,116
hadoop-trunk\hadoop-trunk\hadoop-yarn-project\hadoop-yarn\hadoop-yarn-server\hadoop-yarn-server-applicationhistoryservice\src\main\java\org\apache\hadoop\yarn\server\timeline\package-info.java,0,0,0,1,0,1
hadoop-trunk\hadoop-trunk\hadoop-common-project\hadoop-common\src\main\java\org\apache\hadoop\io\erasurecode\rawcoder\RSLegacyRawDecoder.java,236,42,3,1,0,46
hadoop-trunk\hadoop-trunk\hadoop-hdfs-project\hadoop-hdfs-client\src\main\java\org\apache\hadoop\hdfs\protocolPB\ReconfigurationProtocolUtils.java,0,2,5,3,0,10
hadoop-trunk\hadoop-trunk\hadoop-hdfs-project\hadoop-hdfs\src\test\java\org\apache\hadoop\hdfs\qjournal\client\TestIPCLoggerChannel.java,138,41,5,3,0,49
hadoop-trunk\hadoop-trunk\hadoop-mapreduce-project\hadoop-mapreduce-client\hadoop-mapreduce-client-nativetask\src\main\java\org\apache\hadoop\mapred\nativetask\Platform.java,60,14,0,6,0,20
hadoop-trunk\hadoop-trunk\hadoop-yarn-project\hadoop-yarn\hadoop-yarn-server\hadoop-yarn-server-nodemanager\src\main\java\org\apache\hadoop\yarn\server\nodemanager\CMgrCompletedAppsEvent.java,32,18,4,2,0,24
hadoop-trunk\hadoop-trunk\hadoop-yarn-project\hadoop-yarn\hadoop-yarn-server\hadoop-yarn-server-nodemanager\src\main\java\org\apache\hadoop\yarn\server\nodemanager\containermanager\resourceplugin\fpga\discovery\FPGADiscoveryStrategy.java,0,2,0,4,0,6
hadoop-trunk\hadoop-trunk\hadoop-tools\hadoop-openstack\src\test\java\org\apache\hadoop\fs\swift\TestSwiftFileSystemRead.java,61,14,2,1,0,17
hadoop-trunk\hadoop-trunk\hadoop-hdfs-project\hadoop-hdfs-rbf\src\main\java\org\apache\hadoop\hdfs\server\federation\store\records\StateStoreVersion.java,64,16,1,2,0,19
hadoop-trunk\hadoop-trunk\hadoop-yarn-project\hadoop-yarn\hadoop-yarn-server\hadoop-yarn-server-common\src\main\java\org\apache\hadoop\yarn\server\federation\policies\router\HashBasedRouterPolicy.java,64,4,0,4,0,8
hadoop-trunk\hadoop-trunk\hadoop-tools\hadoop-azure\src\test\java\org\apache\hadoop\fs\azurebfs\ITestAzureBlobFileSystemRandomRead.java,684,80,14,14,0,108
hadoop-trunk\hadoop-trunk\hadoop-yarn-project\hadoop-yarn\hadoop-yarn-api\src\main\java\org\apache\hadoop\yarn\server\api\protocolrecords\package-info.java,0,1,0,1,0,2
hadoop-trunk\hadoop-trunk\hadoop-yarn-project\hadoop-yarn\hadoop-yarn-server\hadoop-yarn-server-resourcemanager\src\main\java\org\apache\hadoop\yarn\server\resourcemanager\scheduler\fair\FSPreemptionThread.java,0,39,5,2,0,46
hadoop-trunk\hadoop-trunk\hadoop-yarn-project\hadoop-yarn\hadoop-yarn-common\src\test\java\org\apache\hadoop\yarn\api\TestGetApplicationsRequest.java,83,24,1,2,0,27
hadoop-trunk\hadoop-trunk\hadoop-hdfs-project\hadoop-hdfs\src\test\java\org\apache\hadoop\hdfs\server\balancer\TestBalancerWithEncryptedTransfer.java,27,19,0,1,0,20
hadoop-trunk\hadoop-trunk\hadoop-tools\hadoop-aws\src\main\java\org\apache\hadoop\fs\s3a\impl\ConfigureShadedAWSSocketFactory.java,0,1,0,1,0,2
hadoop-trunk\hadoop-trunk\hadoop-yarn-project\hadoop-yarn\hadoop-yarn-applications\hadoop-yarn-services\hadoop-yarn-services-core\src\main\java\org\apache\hadoop\yarn\service\provider\defaultImpl\DefaultProviderService.java,11,5,2,1,0,8
hadoop-trunk\hadoop-trunk\hadoop-yarn-project\hadoop-yarn\hadoop-yarn-server\hadoop-yarn-server-resourcemanager\src\test\java\org\apache\hadoop\yarn\server\resourcemanager\reservation\TestRLESparseResourceAllocation.java,580,358,78,4,0,440
hadoop-trunk\hadoop-trunk\hadoop-common-project\hadoop-common\src\main\java\org\apache\hadoop\fs\impl\AbstractMultipartUploader.java,105,12,1,2,0,15
hadoop-trunk\hadoop-trunk\hadoop-yarn-project\hadoop-yarn\hadoop-yarn-applications\hadoop-yarn-applications-catalog\hadoop-yarn-applications-catalog-webapp\src\main\java\org\apache\hadoop\yarn\appcatalog\application\AppCatalogInitializer.java,23,4,1,1,0,6
hadoop-trunk\hadoop-trunk\hadoop-common-project\hadoop-auth\src\main\java\org\apache\hadoop\security\authentication\util\KerberosName.java,465,74,0,2,0,76
hadoop-trunk\hadoop-trunk\hadoop-hdfs-project\hadoop-hdfs-httpfs\src\test\java\org\apache\hadoop\test\TestHTestCase.java,123,32,1,3,0,36
hadoop-trunk\hadoop-trunk\hadoop-tools\hadoop-gridmix\src\main\java\org\apache\hadoop\mapred\gridmix\LoadSplit.java,0,51,1,1,0,53
hadoop-trunk\hadoop-trunk\hadoop-yarn-project\hadoop-yarn\hadoop-yarn-server\hadoop-yarn-server-resourcemanager\src\test\java\org\apache\hadoop\yarn\server\resourcemanager\scheduler\capacity\CapacitySchedulerQueueHelpers.java,0,113,5,8,0,126
hadoop-trunk\hadoop-trunk\hadoop-common-project\hadoop-common\src\main\java\org\apache\hadoop\ipc\GenericRefreshProtocol.java,0,10,1,2,0,13
hadoop-trunk\hadoop-trunk\hadoop-yarn-project\hadoop-yarn\hadoop-yarn-common\src\test\java\org\apache\hadoop\yarn\logaggregation\TestLogAggregationMetaCollector.java,346,49,3,2,0,54
hadoop-trunk\hadoop-trunk\hadoop-hdfs-project\hadoop-hdfs-httpfs\src\test\java\org\apache\hadoop\lib\servlet\TestMDCFilter.java,81,10,0,4,0,14
hadoop-trunk\hadoop-trunk\hadoop-yarn-project\hadoop-yarn\hadoop-yarn-server\hadoop-yarn-server-resourcemanager\src\main\java\org\apache\hadoop\yarn\server\resourcemanager\preprocessor\TagAddProcessor.java,0,4,0,1,0,5
hadoop-trunk\hadoop-trunk\hadoop-yarn-project\hadoop-yarn\hadoop-yarn-api\src\main\java\org\apache\hadoop\yarn\api\records\RejectedSchedulingRequest.java,42,2,0,1,0,3
hadoop-trunk\hadoop-trunk\hadoop-yarn-project\hadoop-yarn\hadoop-yarn-server\hadoop-yarn-server-resourcemanager\src\main\java\org\apache\hadoop\yarn\server\resourcemanager\scheduler\activities\NodeAllocation.java,112,51,3,1,0,55
hadoop-trunk\hadoop-trunk\hadoop-yarn-project\hadoop-yarn\hadoop-yarn-server\hadoop-yarn-server-nodemanager\src\test\java\org\apache\hadoop\yarn\server\nodemanager\webapp\TestNMWebFilter.java,121,23,4,2,0,29
hadoop-trunk\hadoop-trunk\hadoop-tools\hadoop-aliyun\src\test\java\org\apache\hadoop\fs\aliyun\oss\contract\TestAliyunOSSContractGetFileStatus.java,0,2,0,1,0,3
hadoop-trunk\hadoop-trunk\hadoop-common-project\hadoop-common\src\test\java\org\apache\hadoop\security\token\delegation\web\TestDelegationTokenAuthenticationHandlerWithMocks.java,495,44,17,7,0,68
hadoop-trunk\hadoop-trunk\hadoop-yarn-project\hadoop-yarn\hadoop-yarn-server\hadoop-yarn-server-timelineservice-hbase\hadoop-yarn-server-timelineservice-hbase-common\src\main\java\org\apache\hadoop\yarn\server\timelineservice\storage\common\KeyConverterToString.java,0,1,0,1,0,2
hadoop-trunk\hadoop-trunk\hadoop-mapreduce-project\hadoop-mapreduce-client\hadoop-mapreduce-client-core\src\main\java\org\apache\hadoop\mapred\IFile.java,424,243,6,5,0,254
hadoop-trunk\hadoop-trunk\hadoop-tools\hadoop-sls\src\main\java\org\apache\hadoop\yarn\sls\scheduler\FairSchedulerMetrics.java,180,30,0,3,0,33
hadoop-trunk\hadoop-trunk\hadoop-common-project\hadoop-common\src\test\java\org\apache\hadoop\security\TestKDiag.java,200,40,2,2,0,44
hadoop-trunk\hadoop-trunk\hadoop-tools\hadoop-distcp\src\main\java\org\apache\hadoop\tools\OptionsParser.java,269,25,4,4,0,33
hadoop-trunk\hadoop-trunk\hadoop-yarn-project\hadoop-yarn\hadoop-yarn-server\hadoop-yarn-server-resourcemanager\src\main\java\org\apache\hadoop\yarn\server\resourcemanager\monitor\capacity\QueuePriorityContainerCandidateSelector.java,0,44,8,7,0,59
hadoop-trunk\hadoop-trunk\hadoop-hdfs-project\hadoop-hdfs-rbf\src\main\java\org\apache\hadoop\hdfs\server\federation\router\security\token\ZKDelegationTokenSecretManagerImpl.java,182,26,2,4,0,32
hadoop-trunk\hadoop-trunk\hadoop-mapreduce-project\hadoop-mapreduce-client\hadoop-mapreduce-client-core\src\main\java\org\apache\hadoop\mapred\FileInputFormat.java,0,272,27,11,0,310
hadoop-trunk\hadoop-trunk\hadoop-mapreduce-project\hadoop-mapreduce-client\hadoop-mapreduce-client-jobclient\src\test\java\org\apache\hadoop\fs\slive\ObserveableOp.java,0,10,0,1,0,11
hadoop-trunk\hadoop-trunk\hadoop-yarn-project\hadoop-yarn\hadoop-yarn-applications\hadoop-yarn-services\hadoop-yarn-services-core\src\test\java\org\apache\hadoop\yarn\service\component\TestComponent.java,0,28,16,5,0,49
hadoop-trunk\hadoop-trunk\hadoop-hdfs-project\hadoop-hdfs-httpfs\src\main\java\org\apache\hadoop\fs\http\server\metrics\package-info.java,0,1,0,1,0,2
hadoop-trunk\hadoop-trunk\hadoop-hdfs-project\hadoop-hdfs\src\test\java\org\apache\hadoop\hdfs\qjournal\QJMTestUtil.java,135,52,0,4,0,56
hadoop-trunk\hadoop-trunk\hadoop-yarn-project\hadoop-yarn\hadoop-yarn-server\hadoop-yarn-server-applicationhistoryservice\src\main\java\org\apache\hadoop\yarn\server\applicationhistoryservice\ApplicationHistoryWriter.java,0,6,0,7,0,13
hadoop-trunk\hadoop-trunk\hadoop-yarn-project\hadoop-yarn\hadoop-yarn-server\hadoop-yarn-server-resourcemanager\src\main\java\org\apache\hadoop\yarn\server\resourcemanager\webapp\dao\FairSchedulerInfo.java,34,14,1,3,0,18
hadoop-trunk\hadoop-trunk\hadoop-hdfs-project\hadoop-hdfs\src\test\java\org\apache\hadoop\hdfs\server\datanode\checker\TestDatasetVolumeCheckerFailures.java,128,18,9,1,0,28
hadoop-trunk\hadoop-trunk\hadoop-common-project\hadoop-common\src\main\java\org\apache\hadoop\ipc\UserIdentityProvider.java,11,4,0,1,0,5
hadoop-trunk\hadoop-trunk\hadoop-yarn-project\hadoop-yarn\hadoop-yarn-server\hadoop-yarn-server-resourcemanager\src\main\java\org\apache\hadoop\yarn\server\resourcemanager\webapp\dao\ReservationDeleteRequestInfo.java,19,8,0,1,0,9
hadoop-trunk\hadoop-trunk\hadoop-hdfs-project\hadoop-hdfs\src\test\java\org\apache\hadoop\fs\TestFcHdfsSetUMask.java,204,86,16,2,0,104
hadoop-trunk\hadoop-trunk\hadoop-yarn-project\hadoop-yarn\hadoop-yarn-server\hadoop-yarn-server-resourcemanager\src\main\java\org\apache\hadoop\yarn\server\resourcemanager\RMServiceContext.java,122,67,0,4,0,71
hadoop-trunk\hadoop-trunk\hadoop-mapreduce-project\hadoop-mapreduce-client\hadoop-mapreduce-client-core\src\main\java\org\apache\hadoop\mapreduce\counters\CounterGroupFactory.java,143,34,8,1,0,43
hadoop-trunk\hadoop-trunk\hadoop-mapreduce-project\hadoop-mapreduce-client\hadoop-mapreduce-client-core\src\main\java\org\apache\hadoop\mapreduce\JobACL.java,0,6,1,1,0,8
hadoop-trunk\hadoop-trunk\hadoop-yarn-project\hadoop-yarn\hadoop-yarn-server\hadoop-yarn-server-timeline-pluginstorage\src\test\java\org\apache\hadoop\yarn\server\timeline\TestLevelDBCacheTimelineStore.java,79,14,0,1,0,15
hadoop-trunk\hadoop-trunk\hadoop-common-project\hadoop-common\src\main\java\org\apache\hadoop\fs\CompositeCrcFileChecksum.java,51,22,0,1,0,23
hadoop-trunk\hadoop-trunk\hadoop-yarn-project\hadoop-yarn\hadoop-yarn-server\hadoop-yarn-server-timelineservice-hbase\hadoop-yarn-server-timelineservice-hbase-client\src\test\java\org\apache\hadoop\yarn\server\timelineservice\storage\common\TestHBaseTimelineStorageUtils.java,69,8,1,1,0,10
hadoop-trunk\hadoop-trunk\hadoop-yarn-project\hadoop-yarn\hadoop-yarn-api\src\main\java\org\apache\hadoop\yarn\api\ApplicationMasterProtocol.java,0,28,3,8,0,39
hadoop-trunk\hadoop-trunk\hadoop-tools\hadoop-aws\src\test\java\org\apache\hadoop\fs\s3a\impl\ITestRenameDeleteRace.java,194,2,0,2,0,4
hadoop-trunk\hadoop-trunk\hadoop-tools\hadoop-aws\src\test\java\org\apache\hadoop\fs\s3a\TestS3AUnbuffer.java,31,2,0,1,0,3
hadoop-trunk\hadoop-trunk\hadoop-yarn-project\hadoop-yarn\hadoop-yarn-common\src\main\java\org\apache\hadoop\yarn\nodelabels\NodeLabelsStore.java,0,4,0,1,0,5
hadoop-trunk\hadoop-trunk\hadoop-common-project\hadoop-common\src\main\java\org\apache\hadoop\util\CleanerUtil.java,0,12,4,1,0,17
hadoop-trunk\hadoop-trunk\hadoop-tools\hadoop-resourceestimator\src\test\java\org\apache\hadoop\resourceestimator\skylinestore\impl\TestInMemoryStore.java,6,1,0,1,0,2
hadoop-trunk\hadoop-trunk\hadoop-common-project\hadoop-common\src\main\java\org\apache\hadoop\util\LimitInputStream.java,0,12,0,2,0,14
hadoop-trunk\hadoop-trunk\hadoop-yarn-project\hadoop-yarn\hadoop-yarn-server\hadoop-yarn-server-resourcemanager\src\main\java\org\apache\hadoop\yarn\server\resourcemanager\nodelabels\RMDelegatedNodeLabelsUpdater.java,168,24,3,3,0,30
hadoop-trunk\hadoop-trunk\hadoop-yarn-project\hadoop-yarn\hadoop-yarn-server\hadoop-yarn-server-resourcemanager\src\test\java\org\apache\hadoop\yarn\server\resourcemanager\scheduler\fair\TestMaxRunningAppsEnforcer.java,171,36,0,7,0,43
hadoop-trunk\hadoop-trunk\hadoop-yarn-project\hadoop-yarn\hadoop-yarn-server\hadoop-yarn-server-timelineservice-documentstore\src\main\java\org\apache\hadoop\yarn\server\timelineservice\documentstore\collection\package-info.java,0,0,0,1,0,1
hadoop-trunk\hadoop-trunk\hadoop-mapreduce-project\hadoop-mapreduce-client\hadoop-mapreduce-client-jobclient\src\main\java\org\apache\hadoop\mapred\YarnClientProtocolProvider.java,24,9,0,2,0,11
hadoop-trunk\hadoop-trunk\hadoop-tools\hadoop-azure\src\main\java\org\apache\hadoop\fs\azurebfs\extensions\BoundDTExtension.java,0,0,0,1,0,1
hadoop-trunk\hadoop-trunk\hadoop-mapreduce-project\hadoop-mapreduce-client\hadoop-mapreduce-client-nativetask\src\main\java\org\apache\hadoop\mapred\nativetask\serde\NullWritableSerializer.java,8,2,0,1,0,3
hadoop-trunk\hadoop-trunk\hadoop-tools\hadoop-dynamometer\hadoop-dynamometer-workload\src\main\java\org\apache\hadoop\tools\dynamometer\workloadgenerator\WorkloadDriver.java,166,19,19,2,0,40
hadoop-trunk\hadoop-trunk\hadoop-tools\hadoop-aws\src\test\java\org\apache\hadoop\fs\s3a\ITestS3AEncryptionSSEKMSUserDefinedKey.java,0,3,0,1,0,4
hadoop-trunk\hadoop-trunk\hadoop-yarn-project\hadoop-yarn\hadoop-yarn-server\hadoop-yarn-server-resourcemanager\src\main\java\org\apache\hadoop\yarn\server\resourcemanager\rmapp\monitor\RMAppToMonitor.java,52,13,1,1,0,15
hadoop-trunk\hadoop-trunk\hadoop-yarn-project\hadoop-yarn\hadoop-yarn-common\src\main\java\org\apache\hadoop\yarn\client\DefaultNoHARMFailoverProxyProvider.java,0,16,0,1,0,17
hadoop-trunk\hadoop-trunk\hadoop-yarn-project\hadoop-yarn\hadoop-yarn-common\src\main\java\org\apache\hadoop\yarn\api\protocolrecords\impl\pb\GetNewApplicationRequestPBImpl.java,41,21,18,3,0,42
hadoop-trunk\hadoop-trunk\hadoop-common-project\hadoop-common\src\test\java\org\apache\hadoop\crypto\TestCryptoOutputStreamClosing.java,28,9,3,1,0,13
hadoop-trunk\hadoop-trunk\hadoop-hdfs-project\hadoop-hdfs\src\main\java\org\apache\hadoop\hdfs\server\datanode\fsdataset\impl\MountVolumeMap.java,77,22,0,1,0,23
hadoop-trunk\hadoop-trunk\hadoop-mapreduce-project\hadoop-mapreduce-client\hadoop-mapreduce-client-core\src\main\java\org\apache\hadoop\mapreduce\lib\output\FileOutputFormatCounter.java,0,2,0,1,0,3
hadoop-trunk\hadoop-trunk\hadoop-tools\hadoop-azure\src\test\java\org\apache\hadoop\fs\azurebfs\AbstractAbfsIntegrationTest.java,447,116,10,34,0,160
hadoop-trunk\hadoop-trunk\hadoop-yarn-project\hadoop-yarn\hadoop-yarn-server\hadoop-yarn-server-resourcemanager\src\main\java\org\apache\hadoop\yarn\server\resourcemanager\reservation\planning\GreedyReservationAgent.java,83,23,10,2,0,35
hadoop-trunk\hadoop-trunk\hadoop-mapreduce-project\hadoop-mapreduce-client\hadoop-mapreduce-client-hs\src\main\java\org\apache\hadoop\mapreduce\v2\hs\webapp\HsConfPage.java,0,42,0,2,0,44
hadoop-trunk\hadoop-trunk\hadoop-common-project\hadoop-common\src\main\java\org\apache\hadoop\util\IndexedSortable.java,0,5,0,1,0,6
hadoop-trunk\hadoop-trunk\hadoop-mapreduce-project\hadoop-mapreduce-client\hadoop-mapreduce-client-app\src\main\java\org\apache\hadoop\mapreduce\jobhistory\JobSummary.java,259,165,5,1,0,171
hadoop-trunk\hadoop-trunk\hadoop-mapreduce-project\hadoop-mapreduce-examples\src\main\java\org\apache\hadoop\examples\pi\DistBbp.java,0,37,7,11,0,55
hadoop-trunk\hadoop-trunk\hadoop-hdfs-project\hadoop-hdfs\src\main\java\org\apache\hadoop\hdfs\protocolPB\ReconfigurationProtocolServerSideUtils.java,0,5,12,4,0,21
hadoop-trunk\hadoop-trunk\hadoop-yarn-project\hadoop-yarn\hadoop-yarn-csi\src\test\java\org\apache\hadoop\yarn\csi\adaptor\TestNodePublishVolumeRequest.java,27,1,9,4,0,14
hadoop-trunk\hadoop-trunk\hadoop-yarn-project\hadoop-yarn\hadoop-yarn-server\hadoop-yarn-server-common\src\test\java\org\apache\hadoop\yarn\server\federation\utils\TestFederationStateStoreFacadeRetry.java,103,10,0,4,0,14
hadoop-trunk\hadoop-trunk\hadoop-hdfs-project\hadoop-hdfs-client\src\main\java\org\apache\hadoop\hdfs\client\HdfsDataOutputStream.java,77,16,2,1,0,19
hadoop-trunk\hadoop-trunk\hadoop-common-project\hadoop-common\src\test\java\org\apache\hadoop\util\TestVersionUtil.java,80,11,2,2,0,15
hadoop-trunk\hadoop-trunk\hadoop-yarn-project\hadoop-yarn\hadoop-yarn-server\hadoop-yarn-server-resourcemanager\src\main\java\org\apache\hadoop\yarn\server\resourcemanager\amlauncher\ApplicationMasterLauncher.java,112,37,3,3,0,43
hadoop-trunk\hadoop-trunk\hadoop-mapreduce-project\hadoop-mapreduce-client\hadoop-mapreduce-client-core\src\main\java\org\apache\hadoop\mapred\KeyValueLineRecordReader.java,0,42,4,3,0,49
hadoop-trunk\hadoop-trunk\hadoop-hdfs-project\hadoop-hdfs\src\test\java\org\apache\hadoop\fs\TestSymlinkHdfsFileSystem.java,80,34,4,1,0,39
hadoop-trunk\hadoop-trunk\hadoop-mapreduce-project\hadoop-mapreduce-client\hadoop-mapreduce-client-nativetask\src\main\java\org\apache\hadoop\mapred\nativetask\handlers\IDataLoader.java,0,4,2,1,0,7
hadoop-trunk\hadoop-trunk\hadoop-yarn-project\hadoop-yarn\hadoop-yarn-server\hadoop-yarn-server-resourcemanager\src\main\java\org\apache\hadoop\yarn\server\resourcemanager\webapp\AppAttemptPage.java,29,4,0,1,0,5
hadoop-trunk\hadoop-trunk\hadoop-hdfs-project\hadoop-hdfs\src\test\java\org\apache\hadoop\hdfs\TestLeaseRecoveryStriped.java,323,84,10,2,0,96
hadoop-trunk\hadoop-trunk\hadoop-yarn-project\hadoop-yarn\hadoop-yarn-api\src\main\java\org\apache\hadoop\yarn\api\protocolrecords\GetLabelsToNodesResponse.java,18,7,2,1,0,10
hadoop-trunk\hadoop-trunk\hadoop-yarn-project\hadoop-yarn\hadoop-yarn-api\src\main\java\org\apache\hadoop\yarn\api\protocolrecords\GetNewReservationResponse.java,34,3,2,1,0,6
hadoop-trunk\hadoop-trunk\hadoop-yarn-project\hadoop-yarn\hadoop-yarn-csi\src\main\java\org\apache\hadoop\yarn\csi\translator\NodePublishVolumeRequestProtoTranslator.java,0,4,14,2,0,20
hadoop-trunk\hadoop-trunk\hadoop-hdfs-project\hadoop-hdfs\src\test\java\org\apache\hadoop\hdfs\server\datanode\TestDatanodeProtocolRetryPolicy.java,173,31,4,1,0,36
hadoop-trunk\hadoop-trunk\hadoop-yarn-project\hadoop-yarn\hadoop-yarn-api\src\main\java\org\apache\hadoop\yarn\api\protocolrecords\NodePublishVolumeRequest.java,66,24,0,2,0,26
hadoop-trunk\hadoop-trunk\hadoop-yarn-project\hadoop-yarn\hadoop-yarn-server\hadoop-yarn-server-resourcemanager\src\main\java\org\apache\hadoop\yarn\server\resourcemanager\rmapp\attempt\RMAppAttemptEvent.java,33,20,0,1,0,21
hadoop-trunk\hadoop-trunk\hadoop-mapreduce-project\hadoop-mapreduce-client\hadoop-mapreduce-client-jobclient\src\test\java\org\apache\hadoop\io\TestSequenceFileMergeProgress.java,65,22,16,1,0,39
hadoop-trunk\hadoop-trunk\hadoop-yarn-project\hadoop-yarn\hadoop-yarn-server\hadoop-yarn-server-resourcemanager\src\main\java\org\apache\hadoop\yarn\server\resourcemanager\recovery\records\impl\pb\ApplicationStateDataPBImpl.java,336,69,98,7,0,174
hadoop-trunk\hadoop-trunk\hadoop-common-project\hadoop-common\src\main\java\org\apache\hadoop\io\BinaryComparable.java,56,16,3,2,0,21
hadoop-trunk\hadoop-trunk\hadoop-yarn-project\hadoop-yarn\hadoop-yarn-server\hadoop-yarn-server-resourcemanager\src\test\java\org\apache\hadoop\yarn\server\resourcemanager\scheduler\fair\TestFairSchedulerConfiguration.java,752,167,6,3,0,176
hadoop-trunk\hadoop-trunk\hadoop-yarn-project\hadoop-yarn\hadoop-yarn-csi\src\main\java\org\apache\hadoop\yarn\csi\adaptor\CsiAdaptorServices.java,70,9,3,1,0,13
hadoop-trunk\hadoop-trunk\hadoop-hdfs-project\hadoop-hdfs-rbf\src\main\java\org\apache\hadoop\hdfs\server\federation\resolver\MountTableResolver.java,0,50,2,11,0,63
hadoop-trunk\hadoop-trunk\hadoop-common-project\hadoop-common\src\main\java\org\apache\hadoop\util\StringInterner.java,53,16,1,1,0,18
hadoop-trunk\hadoop-trunk\hadoop-hdfs-project\hadoop-hdfs\src\test\java\org\apache\hadoop\hdfs\client\impl\TestBlockReaderFactory.java,599,78,36,9,0,123
hadoop-trunk\hadoop-trunk\hadoop-mapreduce-project\hadoop-mapreduce-client\hadoop-mapreduce-client-core\src\main\java\org\apache\hadoop\mapreduce\task\reduce\MapHost.java,78,39,0,1,0,40
hadoop-trunk\hadoop-trunk\hadoop-yarn-project\hadoop-yarn\hadoop-yarn-server\hadoop-yarn-server-common\src\test\java\org\apache\hadoop\yarn\server\federation\utils\TestFederationStateStoreFacade.java,163,26,3,4,0,33
hadoop-trunk\hadoop-trunk\hadoop-common-project\hadoop-common\src\test\java\org\apache\hadoop\io\TestObjectWritableProtos.java,50,11,0,1,0,12
hadoop-trunk\hadoop-trunk\hadoop-mapreduce-project\hadoop-mapreduce-client\hadoop-mapreduce-client-core\src\main\java\org\apache\hadoop\mapred\SkipBadRecords.java,259,155,1,3,0,159
hadoop-trunk\hadoop-trunk\hadoop-yarn-project\hadoop-yarn\hadoop-yarn-common\src\main\java\org\apache\hadoop\yarn\api\records\impl\pb\ApplicationAttemptIdPBImpl.java,59,23,23,1,0,47
hadoop-trunk\hadoop-trunk\hadoop-yarn-project\hadoop-yarn\hadoop-yarn-common\src\test\java\org\apache\hadoop\yarn\api\TestNodeId.java,25,5,4,1,0,10
hadoop-trunk\hadoop-trunk\hadoop-hdfs-project\hadoop-hdfs-client\src\main\java\org\apache\hadoop\hdfs\ExtendedBlockId.java,0,12,2,1,0,15
hadoop-trunk\hadoop-trunk\hadoop-yarn-project\hadoop-yarn\hadoop-yarn-server\hadoop-yarn-server-timelineservice-hbase-tests\src\test\java\org\apache\hadoop\yarn\server\timelineservice\storage\TestHBaseTimelineStorageDomain.java,90,5,2,6,0,13
hadoop-trunk\hadoop-trunk\hadoop-tools\hadoop-federation-balance\src\main\java\org\apache\hadoop\tools\fedbalance\procedure\package-info.java,0,1,0,1,0,2
hadoop-trunk\hadoop-trunk\hadoop-common-project\hadoop-common\src\test\java\org\apache\hadoop\security\alias\TestCredentialProviderFactory.java,240,48,7,11,0,66
hadoop-trunk\hadoop-trunk\hadoop-yarn-project\hadoop-yarn\hadoop-yarn-api\src\main\java\org\apache\hadoop\yarn\api\protocolrecords\GetApplicationsRequest.java,375,40,1,1,0,42
hadoop-trunk\hadoop-trunk\hadoop-hdfs-project\hadoop-hdfs-client\src\main\java\org\apache\hadoop\hdfs\web\resources\NameSpaceQuotaParam.java,23,4,0,1,0,5
hadoop-trunk\hadoop-trunk\hadoop-common-project\hadoop-common\src\main\java\org\apache\hadoop\fs\permission\UmaskParser.java,0,13,1,2,0,16
hadoop-trunk\hadoop-trunk\hadoop-yarn-project\hadoop-yarn\hadoop-yarn-server\hadoop-yarn-server-common\src\main\java\org\apache\hadoop\yarn\server\federation\store\records\impl\pb\SubClusterHeartbeatResponsePBImpl.java,0,13,17,3,0,33
hadoop-trunk\hadoop-trunk\hadoop-yarn-project\hadoop-yarn\hadoop-yarn-client\src\main\java\org\apache\hadoop\yarn\client\cli\YarnCLI.java,52,33,0,1,0,34
hadoop-trunk\hadoop-trunk\hadoop-hdfs-project\hadoop-hdfs\src\test\java\org\apache\hadoop\hdfs\MiniDFSClusterWithNodeGroup.java,207,137,14,17,0,168
hadoop-trunk\hadoop-trunk\hadoop-common-project\hadoop-common\src\main\java\org\apache\hadoop\service\ServiceOperations.java,0,14,3,3,0,20
hadoop-trunk\hadoop-trunk\hadoop-mapreduce-project\hadoop-mapreduce-client\hadoop-mapreduce-client-nativetask\src\test\java\org\apache\hadoop\mapred\nativetask\testutil\BytesFactory.java,82,31,2,1,0,34
hadoop-trunk\hadoop-trunk\hadoop-yarn-project\hadoop-yarn\hadoop-yarn-server\hadoop-yarn-server-nodemanager\src\main\java\org\apache\hadoop\yarn\server\nodemanager\containermanager\records\AuxServiceRecord.java,139,55,2,1,0,58
hadoop-trunk\hadoop-trunk\hadoop-tools\hadoop-aws\src\main\java\org\apache\hadoop\fs\s3a\statistics\impl\EmptyS3AStatisticsContext.java,0,7,54,3,0,64
hadoop-trunk\hadoop-trunk\hadoop-hdfs-project\hadoop-hdfs-rbf\src\main\java\org\apache\hadoop\hdfs\rbfbalance\package-info.java,0,1,0,1,0,2
hadoop-trunk\hadoop-trunk\hadoop-common-project\hadoop-common\src\main\java\org\apache\hadoop\net\DNSToSwitchMapping.java,0,10,3,2,0,15
hadoop-trunk\hadoop-trunk\hadoop-yarn-project\hadoop-yarn\hadoop-yarn-common\src\main\java\org\apache\hadoop\yarn\api\protocolrecords\impl\pb\ReservationUpdateRequestPBImpl.java,138,33,46,4,0,83
hadoop-trunk\hadoop-trunk\hadoop-common-project\hadoop-common\src\main\java\org\apache\hadoop\io\IntWritable.java,0,41,6,1,0,48
hadoop-trunk\hadoop-trunk\hadoop-mapreduce-project\hadoop-mapreduce-client\hadoop-mapreduce-client-jobclient\src\test\java\org\apache\hadoop\mapred\TestStatisticsCollector.java,84,162,9,1,0,172
hadoop-trunk\hadoop-trunk\hadoop-tools\hadoop-aws\src\test\java\org\apache\hadoop\fs\s3a\ITestS3ATestUtils.java,66,14,3,1,0,18
hadoop-trunk\hadoop-trunk\hadoop-common-project\hadoop-common\src\main\java\org\apache\hadoop\util\bloom\Filter.java,141,67,2,5,0,74
hadoop-trunk\hadoop-trunk\hadoop-yarn-project\hadoop-yarn\hadoop-yarn-server\hadoop-yarn-server-resourcemanager\src\test\java\org\apache\hadoop\yarn\server\resourcemanager\nodelabels\TestRMNodeLabelsManager.java,695,164,49,12,0,225
hadoop-trunk\hadoop-trunk\hadoop-hdfs-project\hadoop-hdfs\src\main\java\org\apache\hadoop\hdfs\server\datanode\ProvidedReplica.java,299,94,4,3,0,101
hadoop-trunk\hadoop-trunk\hadoop-hdfs-project\hadoop-hdfs-client\src\main\java\org\apache\hadoop\hdfs\protocol\HdfsNamedFileStatus.java,148,47,4,1,0,52
hadoop-trunk\hadoop-trunk\hadoop-common-project\hadoop-common\src\main\java\org\apache\hadoop\fs\statistics\impl\EmptyIOStatisticsStore.java,0,0,11,1,0,12
hadoop-trunk\hadoop-trunk\hadoop-hdfs-project\hadoop-hdfs\src\main\java\org\apache\hadoop\hdfs\tools\GetGroups.java,57,26,0,2,0,28
hadoop-trunk\hadoop-trunk\hadoop-tools\hadoop-openstack\src\test\java\org\apache\hadoop\fs\swift\TestSwiftFileSystemBlockLocation.java,135,15,3,1,0,19
hadoop-trunk\hadoop-trunk\hadoop-yarn-project\hadoop-yarn\hadoop-yarn-server\hadoop-yarn-server-nodemanager\src\main\java\org\apache\hadoop\yarn\server\nodemanager\webapp\NMErrorsAndWarningsPage.java,0,4,1,1,0,6
hadoop-trunk\hadoop-trunk\hadoop-yarn-project\hadoop-yarn\hadoop-yarn-applications\hadoop-yarn-applications-catalog\hadoop-yarn-applications-catalog-webapp\src\main\java\org\apache\hadoop\yarn\appcatalog\controller\AppStoreController.java,156,11,2,2,0,15
hadoop-trunk\hadoop-trunk\hadoop-common-project\hadoop-common\src\test\java\org\apache\hadoop\metrics2\lib\TestMetricsRegistry.java,122,48,4,1,0,53
hadoop-trunk\hadoop-trunk\hadoop-yarn-project\hadoop-yarn\hadoop-yarn-server\hadoop-yarn-server-nodemanager\src\main\java\org\apache\hadoop\yarn\server\nodemanager\containermanager\linux\runtime\docker\DockerRmCommand.java,28,11,1,3,0,15
hadoop-trunk\hadoop-trunk\hadoop-common-project\hadoop-common\src\main\java\org\apache\hadoop\io\retry\AsyncCallHandler.java,312,53,12,1,0,66
hadoop-trunk\hadoop-trunk\hadoop-yarn-project\hadoop-yarn\hadoop-yarn-server\hadoop-yarn-server-common\src\main\java\org\apache\hadoop\yarn\server\api\records\package-info.java,0,1,0,1,0,2
hadoop-trunk\hadoop-trunk\hadoop-common-project\hadoop-common\src\main\java\org\apache\hadoop\metrics2\MetricsSource.java,0,1,0,1,0,2
hadoop-trunk\hadoop-trunk\hadoop-yarn-project\hadoop-yarn\hadoop-yarn-server\hadoop-yarn-server-nodemanager\src\main\java\org\apache\hadoop\yarn\server\nodemanager\metrics\NodeManagerMetrics.java,450,255,1,1,0,257
hadoop-trunk\hadoop-trunk\hadoop-yarn-project\hadoop-yarn\hadoop-yarn-server\hadoop-yarn-server-resourcemanager\src\test\java\org\apache\hadoop\yarn\server\resourcemanager\scheduler\fair\allocationfile\AllocationFileQueuePlacementPolicy.java,35,9,0,2,0,11
hadoop-trunk\hadoop-trunk\hadoop-yarn-project\hadoop-yarn\hadoop-yarn-server\hadoop-yarn-server-timelineservice-hbase-tests\src\test\java\org\apache\hadoop\yarn\server\timelineservice\reader\AbstractTimelineReaderHBaseTestBase.java,125,23,3,2,0,28
hadoop-trunk\hadoop-trunk\hadoop-hdfs-project\hadoop-hdfs-client\src\main\java\org\apache\hadoop\hdfs\protocol\StripedBlockInfo.java,38,26,0,1,0,27
hadoop-trunk\hadoop-trunk\hadoop-yarn-project\hadoop-yarn\hadoop-yarn-server\hadoop-yarn-server-resourcemanager\src\main\java\org\apache\hadoop\yarn\server\resourcemanager\ahs\WritingApplicationAttemptStartEvent.java,27,13,1,2,0,16
hadoop-trunk\hadoop-trunk\hadoop-yarn-project\hadoop-yarn\hadoop-yarn-api\src\main\java\org\apache\hadoop\yarn\api\protocolrecords\GetApplicationReportRequest.java,29,11,0,2,0,13
hadoop-trunk\hadoop-trunk\hadoop-common-project\hadoop-common\src\test\java\org\apache\hadoop\io\erasurecode\rawcoder\TestNativeRSRawCoder.java,101,62,14,1,0,77
hadoop-trunk\hadoop-trunk\hadoop-mapreduce-project\hadoop-mapreduce-client\hadoop-mapreduce-client-core\src\main\java\org\apache\hadoop\mapreduce\jobhistory\AvroArrayUtils.java,32,12,3,1,0,16
hadoop-trunk\hadoop-trunk\hadoop-yarn-project\hadoop-yarn\hadoop-yarn-server\hadoop-yarn-server-resourcemanager\src\test\java\org\apache\hadoop\yarn\server\resourcemanager\scheduler\fair\TestComputeFairShares.java,229,88,0,2,0,90
hadoop-trunk\hadoop-trunk\hadoop-yarn-project\hadoop-yarn\hadoop-yarn-server\hadoop-yarn-server-nodemanager\src\main\java\org\apache\hadoop\yarn\server\nodemanager\containermanager\logaggregation\AMOnlyLogAggregationPolicy.java,6,4,0,2,0,6
hadoop-trunk\hadoop-trunk\hadoop-yarn-project\hadoop-yarn\hadoop-yarn-server\hadoop-yarn-server-resourcemanager\src\main\java\org\apache\hadoop\yarn\server\resourcemanager\recovery\RMStateStoreAppEvent.java,14,6,0,2,0,8
hadoop-trunk\hadoop-trunk\hadoop-hdfs-project\hadoop-hdfs-rbf\src\main\java\org\apache\hadoop\hdfs\server\federation\router\RouterUserProtocol.java,0,8,0,3,0,11
hadoop-trunk\hadoop-trunk\hadoop-tools\hadoop-gridmix\src\main\java\org\apache\hadoop\mapred\gridmix\GenerateData.java,0,116,6,1,0,123
hadoop-trunk\hadoop-trunk\hadoop-yarn-project\hadoop-yarn\hadoop-yarn-server\hadoop-yarn-server-resourcemanager\src\main\java\org\apache\hadoop\yarn\server\resourcemanager\webapp\dao\ClusterInfo.java,86,52,3,1,0,56
hadoop-trunk\hadoop-trunk\hadoop-yarn-project\hadoop-yarn\hadoop-yarn-api\src\main\java\org\apache\hadoop\yarn\server\api\protocolrecords\ReplaceLabelsOnNodeResponse.java,6,1,0,1,0,2
hadoop-trunk\hadoop-trunk\hadoop-tools\hadoop-aws\src\test\java\org\apache\hadoop\fs\s3a\scale\ITestS3AHugeFilesDiskBlocks.java,7,1,0,1,0,2
hadoop-trunk\hadoop-trunk\hadoop-yarn-project\hadoop-yarn\hadoop-yarn-applications\hadoop-yarn-services\hadoop-yarn-services-core\src\main\java\org\apache\hadoop\yarn\service\monitor\probe\HttpProbe.java,75,22,2,1,0,25
hadoop-trunk\hadoop-trunk\hadoop-tools\hadoop-kafka\src\test\java\org\apache\hadoop\metrics2\impl\TestKafkaMetrics.java,134,14,5,1,0,20
hadoop-trunk\hadoop-trunk\hadoop-common-project\hadoop-common\src\main\java\org\apache\hadoop\ha\FailoverController.java,220,39,2,3,0,44
hadoop-trunk\hadoop-trunk\hadoop-mapreduce-project\hadoop-mapreduce-client\hadoop-mapreduce-client-common\src\main\java\org\apache\hadoop\mapreduce\v2\api\MRClientProtocolPB.java,0,2,2,2,0,6
hadoop-trunk\hadoop-trunk\hadoop-common-project\hadoop-common\src\main\java\org\apache\hadoop\net\SocketInputStream.java,0,56,0,1,0,57
hadoop-trunk\hadoop-trunk\hadoop-hdfs-project\hadoop-hdfs-client\src\test\java\org\apache\hadoop\hdfs\server\namenode\ha\TestRequestHedgingProxyProvider.java,656,80,90,2,0,172
hadoop-trunk\hadoop-trunk\hadoop-yarn-project\hadoop-yarn\hadoop-yarn-applications\hadoop-yarn-services\hadoop-yarn-services-core\src\main\java\org\apache\hadoop\yarn\service\ServiceMetrics.java,0,34,0,1,0,35
hadoop-trunk\hadoop-trunk\hadoop-maven-plugins\src\main\java\org\apache\hadoop\maven\plugin\cmakebuilder\TestMojo.java,355,58,25,1,0,84
hadoop-trunk\hadoop-trunk\hadoop-yarn-project\hadoop-yarn\hadoop-yarn-applications\hadoop-yarn-services\hadoop-yarn-services-core\src\test\java\org\apache\hadoop\yarn\service\TestServiceAM.java,0,57,35,2,0,94
hadoop-trunk\hadoop-trunk\hadoop-hdfs-project\hadoop-hdfs\src\main\java\org\apache\hadoop\hdfs\protocolPB\ClientNamenodeProtocolServerSideTranslatorPB.java,1745,487,117,241,0,845
hadoop-trunk\hadoop-trunk\hadoop-yarn-project\hadoop-yarn\hadoop-yarn-server\hadoop-yarn-server-timelineservice-hbase\hadoop-yarn-server-timelineservice-hbase-client\src\main\java\org\apache\hadoop\yarn\server\timelineservice\storage\subapplication\SubApplicationTableRW.java,102,8,1,2,0,11
hadoop-trunk\hadoop-trunk\hadoop-hdfs-project\hadoop-hdfs\src\test\java\org\apache\hadoop\hdfs\server\datanode\fsdataset\impl\TestWriteToReplica.java,630,208,48,14,0,270
hadoop-trunk\hadoop-trunk\hadoop-mapreduce-project\hadoop-mapreduce-client\hadoop-mapreduce-client-core\src\main\java\org\apache\hadoop\mapred\pipes\Submitter.java,453,113,14,7,0,134
hadoop-trunk\hadoop-trunk\hadoop-tools\hadoop-aws\src\test\java\org\apache\hadoop\fs\s3a\ITestS3AAWSCredentialsProvider.java,124,17,11,3,0,31
hadoop-trunk\hadoop-trunk\hadoop-yarn-project\hadoop-yarn\hadoop-yarn-applications\hadoop-yarn-services\hadoop-yarn-services-core\src\main\java\org\apache\hadoop\yarn\service\provider\ProviderService.java,0,18,0,1,0,19
hadoop-trunk\hadoop-trunk\hadoop-common-project\hadoop-common\src\test\java\org\apache\hadoop\io\erasurecode\rawcoder\TestRSRawCoderInteroperable2.java,13,1,0,1,0,2
hadoop-trunk\hadoop-trunk\hadoop-hdfs-project\hadoop-hdfs\src\main\java\org\apache\hadoop\hdfs\server\datanode\DatanodeUtil.java,113,50,2,1,0,53
hadoop-trunk\hadoop-trunk\hadoop-hdfs-project\hadoop-hdfs\src\test\java\org\apache\hadoop\hdfs\DataNodeCluster.java,191,78,17,7,0,102
hadoop-trunk\hadoop-trunk\hadoop-common-project\hadoop-nfs\src\main\java\org\apache\hadoop\nfs\nfs3\Nfs3Base.java,72,14,4,1,0,19
hadoop-trunk\hadoop-trunk\hadoop-yarn-project\hadoop-yarn\hadoop-yarn-common\src\test\java\org\apache\hadoop\yarn\util\TestLRUCacheHashMap.java,46,9,0,1,0,10
hadoop-trunk\hadoop-trunk\hadoop-yarn-project\hadoop-yarn\hadoop-yarn-server\hadoop-yarn-server-router\src\main\java\org\apache\hadoop\yarn\server\router\webapp\RouterWebServiceUtil.java,0,41,9,2,0,52
hadoop-trunk\hadoop-trunk\hadoop-yarn-project\hadoop-yarn\hadoop-yarn-server\hadoop-yarn-server-nodemanager\src\main\java\org\apache\hadoop\yarn\server\nodemanager\containermanager\localizer\sharedcache\SharedCacheUploadEventType.java,0,1,0,2,0,3
hadoop-trunk\hadoop-trunk\hadoop-tools\hadoop-aws\src\main\java\org\apache\hadoop\fs\s3a\Tristate.java,0,5,0,1,0,6
hadoop-trunk\hadoop-trunk\hadoop-common-project\hadoop-common\src\main\java\org\apache\hadoop\io\erasurecode\rawcoder\util\RSUtil.java,0,113,6,1,0,120
hadoop-trunk\hadoop-trunk\hadoop-common-project\hadoop-common\src\main\java\org\apache\hadoop\io\erasurecode\codec\RSErasureCodec.java,17,5,0,1,0,6
hadoop-trunk\hadoop-trunk\hadoop-common-project\hadoop-common\src\main\java\org\apache\hadoop\http\HttpServer2.java,0,388,43,19,0,450
hadoop-trunk\hadoop-trunk\hadoop-common-project\hadoop-common\src\test\java\org\apache\hadoop\service\launcher\TestServiceLauncher.java,176,25,5,7,0,37
hadoop-trunk\hadoop-trunk\hadoop-hdfs-project\hadoop-hdfs-httpfs\src\main\java\org\apache\hadoop\lib\util\Check.java,171,36,1,10,0,47
hadoop-trunk\hadoop-trunk\hadoop-hdfs-project\hadoop-hdfs\src\test\java\org\apache\hadoop\hdfs\server\common\TestHostRestrictingAuthorizationFilter.java,257,35,11,4,0,50
hadoop-trunk\hadoop-trunk\hadoop-hdfs-project\hadoop-hdfs\src\test\java\org\apache\hadoop\hdfs\server\datanode\fsdataset\impl\TestDatanodeRestart.java,171,49,12,3,0,64
hadoop-trunk\hadoop-trunk\hadoop-mapreduce-project\hadoop-mapreduce-client\hadoop-mapreduce-client-core\src\main\java\org\apache\hadoop\mapred\lib\BinaryPartitioner.java,0,11,0,1,0,12
hadoop-trunk\hadoop-trunk\hadoop-mapreduce-project\hadoop-mapreduce-client\hadoop-mapreduce-client-jobclient\src\test\java\org\apache\hadoop\fs\slive\OperationOutput.java,0,44,1,1,0,46
hadoop-trunk\hadoop-trunk\hadoop-mapreduce-project\hadoop-mapreduce-client\hadoop-mapreduce-client-core\src\main\java\org\apache\hadoop\mapreduce\lib\aggregate\ValueAggregatorMapper.java,0,15,2,1,0,18
hadoop-trunk\hadoop-trunk\hadoop-tools\hadoop-azure\src\test\java\org\apache\hadoop\fs\azurebfs\ITestClientUrlScheme.java,74,12,2,7,0,21
hadoop-trunk\hadoop-trunk\hadoop-yarn-project\hadoop-yarn\hadoop-yarn-server\hadoop-yarn-server-nodemanager\src\main\java\org\apache\hadoop\yarn\server\nodemanager\api\LocalizationProtocolPB.java,0,2,2,4,0,8
hadoop-trunk\hadoop-trunk\hadoop-mapreduce-project\hadoop-mapreduce-client\hadoop-mapreduce-client-core\src\main\java\org\apache\hadoop\mapred\ClusterStatus.java,503,172,5,1,0,178
hadoop-trunk\hadoop-trunk\hadoop-tools\hadoop-aws\src\test\java\org\apache\hadoop\fs\s3a\audit\ITestAuditManagerDisabled.java,45,2,0,1,0,3
hadoop-trunk\hadoop-trunk\hadoop-tools\hadoop-streaming\src\main\java\org\apache\hadoop\streaming\LoadTypedBytes.java,70,21,1,2,0,24
hadoop-trunk\hadoop-trunk\hadoop-tools\hadoop-azure\src\test\java\org\apache\hadoop\fs\azure\contract\ITestAzureNativeContractOpen.java,8,2,0,1,0,3
hadoop-trunk\hadoop-trunk\hadoop-common-project\hadoop-common\src\main\java\org\apache\hadoop\io\compress\BlockDecompressorStream.java,119,26,3,2,0,31
hadoop-trunk\hadoop-trunk\hadoop-common-project\hadoop-common\src\main\java\org\apache\hadoop\security\token\delegation\web\HttpUserGroupInformation.java,15,2,3,1,0,6
hadoop-trunk\hadoop-trunk\hadoop-yarn-project\hadoop-yarn\hadoop-yarn-common\src\main\java\org\apache\hadoop\yarn\security\client\ClientTimelineSecurityInfo.java,48,6,0,1,0,7
hadoop-trunk\hadoop-trunk\hadoop-mapreduce-project\hadoop-mapreduce-client\hadoop-mapreduce-client-core\src\main\java\org\apache\hadoop\mapreduce\task\reduce\ShuffleHeader.java,43,34,1,1,0,36
hadoop-trunk\hadoop-trunk\hadoop-mapreduce-project\hadoop-mapreduce-client\hadoop-mapreduce-client-core\src\main\java\org\apache\hadoop\mapred\lib\aggregate\LongValueMax.java,0,2,0,1,0,3
hadoop-trunk\hadoop-trunk\hadoop-yarn-project\hadoop-yarn\hadoop-yarn-server\hadoop-yarn-server-common\src\main\java\org\apache\hadoop\yarn\server\util\timeline\package-info.java,0,2,0,1,0,3
hadoop-trunk\hadoop-trunk\hadoop-yarn-project\hadoop-yarn\hadoop-yarn-server\hadoop-yarn-server-resourcemanager\src\main\java\org\apache\hadoop\yarn\server\resourcemanager\webapp\dao\UsersInfo.java,16,11,4,2,0,17
hadoop-trunk\hadoop-trunk\hadoop-hdfs-project\hadoop-hdfs\src\main\java\org\apache\hadoop\hdfs\protocolPB\DatanodeProtocolClientSideTranslatorPB.java,0,70,64,21,0,155
hadoop-trunk\hadoop-trunk\hadoop-common-project\hadoop-common\src\main\java\org\apache\hadoop\metrics2\AbstractMetric.java,63,16,0,1,0,17
hadoop-trunk\hadoop-trunk\hadoop-yarn-project\hadoop-yarn\hadoop-yarn-server\hadoop-yarn-server-nodemanager\src\test\java\org\apache\hadoop\yarn\server\nodemanager\containermanager\monitor\MockCPUResourceCalculatorProcessTree.java,0,12,1,1,0,14
hadoop-trunk\hadoop-trunk\hadoop-yarn-project\hadoop-yarn\hadoop-yarn-server\hadoop-yarn-server-resourcemanager\src\main\java\org\apache\hadoop\yarn\server\resourcemanager\monitor\capacity\ProportionalCapacityPreemptionPolicy.java,0,156,11,36,0,203
hadoop-trunk\hadoop-trunk\hadoop-hdfs-project\hadoop-hdfs-rbf\src\main\java\org\apache\hadoop\hdfs\server\federation\router\RemoteLocationContext.java,0,8,0,1,0,9
hadoop-trunk\hadoop-trunk\hadoop-tools\hadoop-azure\src\test\java\org\apache\hadoop\fs\azurebfs\ITestAbfsRestOperationException.java,116,28,2,14,0,44
hadoop-trunk\hadoop-trunk\hadoop-yarn-project\hadoop-yarn\hadoop-yarn-server\hadoop-yarn-server-resourcemanager\src\test\java\org\apache\hadoop\yarn\server\resourcemanager\monitor\capacity\TestProportionalCapacityPreemptionPolicy.java,1413,1138,9,52,0,1199
hadoop-trunk\hadoop-trunk\hadoop-common-project\hadoop-common\src\test\java\org\apache\hadoop\util\TestCloseableReferenceCount.java,62,7,3,1,0,11
hadoop-trunk\hadoop-trunk\hadoop-yarn-project\hadoop-yarn\hadoop-yarn-server\hadoop-yarn-server-resourcemanager\src\main\java\org\apache\hadoop\yarn\server\resourcemanager\monitor\capacity\ReservedContainerCandidatesSelector.java,0,47,4,6,0,57
hadoop-trunk\hadoop-trunk\hadoop-yarn-project\hadoop-yarn\hadoop-yarn-server\hadoop-yarn-server-resourcemanager\src\main\java\org\apache\hadoop\yarn\server\resourcemanager\webapp\dao\AppInfo.java,593,292,8,5,0,305
hadoop-trunk\hadoop-trunk\hadoop-hdfs-project\hadoop-hdfs\src\test\java\org\apache\hadoop\hdfs\TestDFSUpgrade.java,0,128,10,24,0,162
hadoop-trunk\hadoop-trunk\hadoop-yarn-project\hadoop-yarn\hadoop-yarn-server\hadoop-yarn-server-resourcemanager\src\test\java\org\apache\hadoop\yarn\server\resourcemanager\scheduler\capacity\TestResourceVector.java,85,45,0,14,0,59
hadoop-trunk\hadoop-trunk\hadoop-tools\hadoop-azure-datalake\src\test\java\org\apache\hadoop\fs\adl\live\TestAdlContractSeekLive.java,8,2,0,1,0,3
hadoop-trunk\hadoop-trunk\hadoop-common-project\hadoop-common\src\test\java\org\apache\hadoop\fs\viewfs\ViewFsTestSetup.java,168,65,3,5,0,73
hadoop-trunk\hadoop-trunk\hadoop-hdfs-project\hadoop-hdfs\src\test\java\org\apache\hadoop\hdfs\protocol\datatransfer\sasl\TestSaslDataTransferExpiredBlockToken.java,137,30,0,9,0,39
hadoop-trunk\hadoop-trunk\hadoop-hdfs-project\hadoop-hdfs-client\src\main\java\org\apache\hadoop\hdfs\web\resources\StartAfterParam.java,17,5,1,1,0,7
hadoop-trunk\hadoop-trunk\hadoop-yarn-project\hadoop-yarn\hadoop-yarn-server\hadoop-yarn-server-nodemanager\src\test\java\org\apache\hadoop\yarn\server\nodemanager\webapp\TestContainerLogsPage.java,295,47,3,9,0,59
hadoop-trunk\hadoop-trunk\hadoop-yarn-project\hadoop-yarn\hadoop-yarn-server\hadoop-yarn-server-nodemanager\src\test\java\org\apache\hadoop\yarn\server\nodemanager\api\protocolrecords\impl\pb\TestPBRecordImpl.java,161,32,22,15,0,69
hadoop-trunk\hadoop-trunk\hadoop-common-project\hadoop-common\src\main\java\org\apache\hadoop\fs\statistics\IOStatisticsSupport.java,0,2,0,1,0,3
hadoop-trunk\hadoop-trunk\hadoop-mapreduce-project\hadoop-mapreduce-client\hadoop-mapreduce-client-core\src\main\java\org\apache\hadoop\mapreduce\lib\output\committer\manifest\files\package-info.java,0,3,0,3,0,6
hadoop-trunk\hadoop-trunk\hadoop-tools\hadoop-federation-balance\src\test\java\org\apache\hadoop\tools\fedbalance\procedure\MultiPhaseProcedure.java,58,22,2,1,0,25
hadoop-trunk\hadoop-trunk\hadoop-common-project\hadoop-common\src\main\java\org\apache\hadoop\io\CompressedWritable.java,53,8,2,1,0,11
hadoop-trunk\hadoop-trunk\hadoop-mapreduce-project\hadoop-mapreduce-client\hadoop-mapreduce-client-core\src\main\java\org\apache\hadoop\mapred\JobQueueClient.java,0,36,6,1,0,43
hadoop-trunk\hadoop-trunk\hadoop-hdfs-project\hadoop-hdfs\src\main\java\org\apache\hadoop\hdfs\protocol\datatransfer\Receiver.java,287,87,55,24,0,166
hadoop-trunk\hadoop-trunk\hadoop-yarn-project\hadoop-yarn\hadoop-yarn-api\src\main\java\org\apache\hadoop\yarn\api\protocolrecords\NodePublishVolumeResponse.java,7,1,0,1,0,2
hadoop-trunk\hadoop-trunk\hadoop-yarn-project\hadoop-yarn\hadoop-yarn-server\hadoop-yarn-server-resourcemanager\src\main\java\org\apache\hadoop\yarn\server\resourcemanager\metrics\CombinedSystemMetricsPublisher.java,0,39,0,2,0,41
hadoop-trunk\hadoop-trunk\hadoop-common-project\hadoop-common\src\main\java\org\apache\hadoop\ipc\RpcEngine.java,0,35,0,2,0,37
hadoop-trunk\hadoop-trunk\hadoop-yarn-project\hadoop-yarn\hadoop-yarn-api\src\main\java\org\apache\hadoop\yarn\api\protocolrecords\ReInitializeContainerRequest.java,78,3,0,1,0,4
hadoop-trunk\hadoop-trunk\hadoop-common-project\hadoop-common\src\main\java\org\apache\hadoop\util\ToolRunner.java,92,43,5,2,0,50
hadoop-trunk\hadoop-trunk\hadoop-hdfs-project\hadoop-hdfs\src\main\java\org\apache\hadoop\hdfs\tools\offlineImageViewer\FSImageLoader.java,0,70,89,1,0,160
hadoop-trunk\hadoop-trunk\hadoop-cloud-storage-project\hadoop-cos\src\test\java\org\apache\hadoop\fs\cosn\TestCosCredentials.java,102,21,9,1,0,31
hadoop-trunk\hadoop-trunk\hadoop-mapreduce-project\hadoop-mapreduce-client\hadoop-mapreduce-client-core\src\main\java\org\apache\hadoop\mapreduce\lib\output\MapFileOutputFormat.java,0,33,3,2,0,38
hadoop-trunk\hadoop-trunk\hadoop-hdfs-project\hadoop-hdfs\src\test\java\org\apache\hadoop\hdfs\TestAclsEndToEnd.java,1594,57,17,1,0,75
hadoop-trunk\hadoop-trunk\hadoop-hdfs-project\hadoop-hdfs\src\test\java\org\apache\hadoop\hdfs\tools\offlineImageViewer\TestOfflineImageViewerWithStripedBlocks.java,125,31,3,1,0,35
hadoop-trunk\hadoop-trunk\hadoop-hdfs-project\hadoop-hdfs-client\src\main\java\org\apache\hadoop\hdfs\web\JsonUtilClient.java,892,112,33,4,0,149
hadoop-trunk\hadoop-trunk\hadoop-common-project\hadoop-common\src\test\java\org\apache\hadoop\fs\shell\find\TestPrint.java,28,7,3,1,0,11
hadoop-trunk\hadoop-trunk\hadoop-yarn-project\hadoop-yarn\hadoop-yarn-common\src\main\java\org\apache\hadoop\yarn\logaggregation\filecontroller\LogAggregationFileControllerFactory.java,160,12,4,1,0,17
hadoop-trunk\hadoop-trunk\hadoop-common-project\hadoop-common\src\main\java\org\apache\hadoop\io\compress\bzip2\BZip2DummyCompressor.java,59,19,0,1,0,20
hadoop-trunk\hadoop-trunk\hadoop-mapreduce-project\hadoop-mapreduce-client\hadoop-mapreduce-client-core\src\test\java\org\apache\hadoop\mapreduce\TestContextFactory.java,37,16,1,3,0,20
hadoop-trunk\hadoop-trunk\hadoop-tools\hadoop-azure\src\main\java\org\apache\hadoop\fs\azurebfs\services\AbfsOutputStreamStatisticsImpl.java,0,35,0,16,0,51
hadoop-trunk\hadoop-trunk\hadoop-tools\hadoop-azure\src\test\java\org\apache\hadoop\fs\azurebfs\ITestAzureBlobFileSystemFinalize.java,32,7,2,2,0,11
hadoop-trunk\hadoop-trunk\hadoop-yarn-project\hadoop-yarn\hadoop-yarn-server\hadoop-yarn-server-timelineservice-hbase\hadoop-yarn-server-timelineservice-hbase-common\src\test\java\org\apache\hadoop\yarn\server\timelineservice\storage\common\TestKeyConverters.java,103,15,3,1,0,19
hadoop-trunk\hadoop-trunk\hadoop-yarn-project\hadoop-yarn\hadoop-yarn-server\hadoop-yarn-server-nodemanager\src\test\java\org\apache\hadoop\yarn\server\nodemanager\containermanager\linux\resources\gpu\TestGpuResourceAllocator.java,378,92,4,8,0,104
hadoop-trunk\hadoop-trunk\hadoop-yarn-project\hadoop-yarn\hadoop-yarn-server\hadoop-yarn-server-router\src\test\java\org\apache\hadoop\yarn\server\router\clientrm\TestRouterYarnClientUtils.java,177,31,0,1,0,32
hadoop-trunk\hadoop-trunk\hadoop-tools\hadoop-aws\src\main\java\org\apache\hadoop\fs\s3a\impl\CopyFromLocalOperation.java,465,40,1,8,0,49
hadoop-trunk\hadoop-trunk\hadoop-common-project\hadoop-common\src\main\java\org\apache\hadoop\io\erasurecode\coder\HHXORErasureDecodingStep.java,319,38,1,1,0,40
hadoop-trunk\hadoop-trunk\hadoop-mapreduce-project\hadoop-mapreduce-client\hadoop-mapreduce-client-hs\src\main\java\org\apache\hadoop\mapreduce\v2\hs\HistoryServerFileSystemStateStoreService.java,0,71,11,1,0,83
hadoop-trunk\hadoop-trunk\hadoop-mapreduce-project\hadoop-mapreduce-client\hadoop-mapreduce-client-core\src\main\java\org\apache\hadoop\mapred\IndexCache.java,0,46,9,2,0,57
hadoop-trunk\hadoop-trunk\hadoop-hdfs-project\hadoop-hdfs\src\test\java\org\apache\hadoop\hdfs\server\datanode\fsdataset\impl\TestLazyPersistFiles.java,279,44,18,2,0,64
hadoop-trunk\hadoop-trunk\hadoop-mapreduce-project\hadoop-mapreduce-examples\src\main\java\org\apache\hadoop\examples\Grep.java,69,18,3,1,0,22
hadoop-trunk\hadoop-trunk\hadoop-yarn-project\hadoop-yarn\hadoop-yarn-applications\hadoop-yarn-applications-distributedshell\src\test\java\org\apache\hadoop\yarn\applications\distributedshell\TestDSTimelineV15.java,62,12,1,1,0,14
hadoop-trunk\hadoop-trunk\hadoop-common-project\hadoop-common\src\main\java\org\apache\hadoop\fs\store\EtagChecksum.java,58,10,1,1,0,12
hadoop-trunk\hadoop-trunk\hadoop-hdfs-project\hadoop-hdfs-rbf\src\main\java\org\apache\hadoop\hdfs\server\federation\store\impl\DisabledNameserviceStoreImpl.java,35,7,0,2,0,9
hadoop-trunk\hadoop-trunk\hadoop-common-project\hadoop-common\src\test\java\org\apache\hadoop\security\TestGroupFallback.java,76,10,12,2,0,24
hadoop-trunk\hadoop-trunk\hadoop-common-project\hadoop-common\src\test\java\org\apache\hadoop\util\FakeTimer.java,52,13,0,1,0,14
hadoop-trunk\hadoop-trunk\hadoop-hdfs-project\hadoop-hdfs\src\main\java\org\apache\hadoop\hdfs\tools\CacheAdmin.java,920,121,4,5,0,130
hadoop-trunk\hadoop-trunk\hadoop-hdfs-project\hadoop-hdfs-rbf\src\main\java\org\apache\hadoop\hdfs\server\federation\utils\package-info.java,0,1,0,1,0,2
hadoop-trunk\hadoop-trunk\hadoop-mapreduce-project\hadoop-mapreduce-client\hadoop-mapreduce-client-jobclient\src\test\java\org\apache\hadoop\fs\slive\TestSlive.java,523,70,24,3,0,97
hadoop-trunk\hadoop-trunk\hadoop-yarn-project\hadoop-yarn\hadoop-yarn-server\hadoop-yarn-server-nodemanager\src\main\java\org\apache\hadoop\yarn\server\nodemanager\containermanager\monitor\ContainersMonitorEventType.java,0,3,0,1,0,4
hadoop-trunk\hadoop-trunk\hadoop-mapreduce-project\hadoop-mapreduce-client\hadoop-mapreduce-client-core\src\main\java\org\apache\hadoop\mapreduce\lib\join\OuterJoinRecordReader.java,0,10,0,1,0,11
hadoop-trunk\hadoop-trunk\hadoop-mapreduce-project\hadoop-mapreduce-client\hadoop-mapreduce-client-jobclient\src\test\java\org\apache\hadoop\mapred\TestJobCounters.java,0,305,54,5,0,364
hadoop-trunk\hadoop-trunk\hadoop-yarn-project\hadoop-yarn\hadoop-yarn-server\hadoop-yarn-server-resourcemanager\src\main\java\org\apache\hadoop\yarn\server\resourcemanager\scheduler\fair\FSContext.java,40,15,0,1,0,16
hadoop-trunk\hadoop-trunk\hadoop-common-project\hadoop-common\src\test\java\org\apache\hadoop\fs\shell\TestAclCommands.java,215,59,17,1,0,77
hadoop-trunk\hadoop-trunk\hadoop-common-project\hadoop-common\src\main\java\org\apache\hadoop\fs\http\HttpFileSystem.java,7,1,0,1,0,2
hadoop-trunk\hadoop-trunk\hadoop-hdfs-project\hadoop-hdfs\src\test\java\org\apache\hadoop\hdfs\TestFsShellPermission.java,234,64,5,2,0,71
hadoop-trunk\hadoop-trunk\hadoop-yarn-project\hadoop-yarn\hadoop-yarn-common\src\test\java\org\apache\hadoop\yarn\client\api\impl\TestTimelineClientV2Impl.java,394,49,17,1,0,67
hadoop-trunk\hadoop-trunk\hadoop-hdfs-project\hadoop-hdfs-httpfs\src\main\java\org\apache\hadoop\fs\http\client\HttpFSUtils.java,110,15,1,1,0,17
hadoop-trunk\hadoop-trunk\hadoop-tools\hadoop-rumen\src\main\java\org\apache\hadoop\tools\rumen\datatypes\FileName.java,177,73,2,1,0,76
hadoop-trunk\hadoop-trunk\hadoop-hdfs-project\hadoop-hdfs\src\main\java\org\apache\hadoop\hdfs\server\namenode\AclEntryStatusFormat.java,0,29,3,1,0,33
hadoop-trunk\hadoop-trunk\hadoop-cloud-storage-project\hadoop-cos\src\main\java\org\apache\hadoop\fs\cosn\CosNOutputStream.java,235,36,9,4,0,49
hadoop-trunk\hadoop-trunk\hadoop-hdfs-project\hadoop-hdfs\src\main\java\org\apache\hadoop\hdfs\server\namenode\CheckpointFaultInjector.java,32,36,8,1,0,45
hadoop-trunk\hadoop-trunk\hadoop-tools\hadoop-aws\src\main\java\org\apache\hadoop\fs\s3a\auth\STSClientFactory.java,188,11,2,4,0,17
hadoop-trunk\hadoop-trunk\hadoop-common-project\hadoop-common\src\main\java\org\apache\hadoop\fs\permission\RawParser.java,0,6,0,1,0,7
hadoop-trunk\hadoop-trunk\hadoop-hdfs-project\hadoop-hdfs\src\main\java\org\apache\hadoop\hdfs\server\protocol\NamenodeCommand.java,6,2,0,1,0,3
hadoop-trunk\hadoop-trunk\hadoop-hdfs-project\hadoop-hdfs-nfs\src\test\java\org\apache\hadoop\hdfs\nfs\nfs3\TestClientAccessPrivilege.java,78,20,1,1,0,22
hadoop-trunk\hadoop-trunk\hadoop-hdfs-project\hadoop-hdfs-httpfs\src\main\java\org\apache\hadoop\lib\service\Instrumentation.java,0,20,10,2,0,32
hadoop-trunk\hadoop-trunk\hadoop-tools\hadoop-aws\src\main\java\org\apache\hadoop\fs\s3a\select\package-info.java,0,0,0,1,0,1
hadoop-trunk\hadoop-trunk\hadoop-yarn-project\hadoop-yarn\hadoop-yarn-api\src\main\java\org\apache\hadoop\yarn\api\records\timelineservice\ClusterEntity.java,14,3,0,1,0,4
hadoop-trunk\hadoop-trunk\hadoop-yarn-project\hadoop-yarn\hadoop-yarn-server\hadoop-yarn-server-nodemanager\src\main\java\org\apache\hadoop\yarn\server\nodemanager\containermanager\AuxiliaryServiceWithCustomClassLoader.java,0,19,1,1,0,21
hadoop-trunk\hadoop-trunk\hadoop-hdfs-project\hadoop-hdfs\src\test\java\org\apache\hadoop\fs\TestGlobPaths.java,0,395,56,1,0,452
hadoop-trunk\hadoop-trunk\hadoop-tools\hadoop-azure-datalake\src\main\java\org\apache\hadoop\fs\adl\AdlFsInputStream.java,0,17,0,1,0,18
hadoop-trunk\hadoop-trunk\hadoop-yarn-project\hadoop-yarn\hadoop-yarn-server\hadoop-yarn-server-nodemanager\src\test\java\org\apache\hadoop\yarn\server\nodemanager\webapp\ContainerShellClientSocketTest.java,0,23,2,1,0,26
hadoop-trunk\hadoop-trunk\hadoop-common-project\hadoop-auth\src\test\java\org\apache\hadoop\security\authentication\util\TestStringSignerSecretProvider.java,19,1,0,1,0,2
hadoop-trunk\hadoop-trunk\hadoop-common-project\hadoop-common\src\main\java\org\apache\hadoop\fs\CommonPathCapabilities.java,0,0,0,1,0,1
hadoop-trunk\hadoop-trunk\hadoop-common-project\hadoop-common\src\test\java\org\apache\hadoop\io\serializer\TestWritableSerialization.java,67,20,1,1,0,22
hadoop-trunk\hadoop-trunk\hadoop-common-project\hadoop-registry\src\main\java\org\apache\hadoop\registry\server\dns\ReverseZoneUtils.java,0,17,3,4,0,24
hadoop-trunk\hadoop-trunk\hadoop-tools\hadoop-azure\src\main\java\org\apache\hadoop\fs\azurebfs\constants\FSOperationType.java,0,30,0,1,0,31
hadoop-trunk\hadoop-trunk\hadoop-hdfs-project\hadoop-hdfs\src\test\java\org\apache\hadoop\fs\contract\hdfs\TestHDFSContractCreate.java,18,4,0,1,0,5
hadoop-trunk\hadoop-trunk\hadoop-yarn-project\hadoop-yarn\hadoop-yarn-server\hadoop-yarn-server-resourcemanager\src\main\java\org\apache\hadoop\yarn\server\resourcemanager\security\CapacityQueueACLsManager.java,74,17,4,3,0,24
hadoop-trunk\hadoop-trunk\hadoop-yarn-project\hadoop-yarn\hadoop-yarn-server\hadoop-yarn-server-timelineservice-hbase\hadoop-yarn-server-timelineservice-hbase-common\src\main\java\org\apache\hadoop\yarn\server\timelineservice\storage\flow\AggregationOperation.java,0,9,1,1,0,11
hadoop-trunk\hadoop-trunk\hadoop-yarn-project\hadoop-yarn\hadoop-yarn-server\hadoop-yarn-server-nodemanager\src\main\java\org\apache\hadoop\yarn\server\nodemanager\containermanager\resourceplugin\gpu\GpuDeviceSpecificationException.java,0,33,0,4,0,37
hadoop-trunk\hadoop-trunk\hadoop-common-project\hadoop-common\src\test\java\org\apache\hadoop\fs\viewfs\ViewFileSystemBaseTest.java,0,388,172,13,0,573
hadoop-trunk\hadoop-trunk\hadoop-tools\hadoop-aws\src\main\java\org\apache\hadoop\fs\s3a\impl\DeleteOperation.java,382,14,5,5,0,24
hadoop-trunk\hadoop-trunk\hadoop-common-project\hadoop-common\src\test\java\org\apache\hadoop\crypto\CryptoStreamsTestBase.java,972,296,28,1,0,325
hadoop-trunk\hadoop-trunk\hadoop-yarn-project\hadoop-yarn\hadoop-yarn-common\src\main\java\org\apache\hadoop\yarn\FileSystemBasedConfigurationProvider.java,0,14,2,1,0,17
hadoop-trunk\hadoop-trunk\hadoop-hdfs-project\hadoop-hdfs\src\test\java\org\apache\hadoop\fs\viewfs\TestViewFileSystemAtHdfsRoot.java,64,13,0,1,0,14
hadoop-trunk\hadoop-trunk\hadoop-hdfs-project\hadoop-hdfs\src\test\java\org\apache\hadoop\hdfs\TestFileStatusWithRandomECPolicy.java,22,4,1,1,0,6
hadoop-trunk\hadoop-trunk\hadoop-common-project\hadoop-common\src\main\java\org\apache\hadoop\crypto\key\JavaKeyStoreProvider.java,621,105,8,5,0,118
hadoop-trunk\hadoop-trunk\hadoop-common-project\hadoop-common\src\main\java\org\apache\hadoop\security\token\delegation\AbstractDelegationTokenSelector.java,0,11,1,1,0,13
hadoop-trunk\hadoop-trunk\hadoop-tools\hadoop-azure\src\test\java\org\apache\hadoop\fs\azurebfs\commit\ITestAbfsJobThroughManifestCommitter.java,0,10,0,8,0,18
hadoop-trunk\hadoop-trunk\hadoop-hdfs-project\hadoop-hdfs-client\src\main\java\org\apache\hadoop\hdfs\util\package-info.java,0,0,0,1,0,1
hadoop-trunk\hadoop-trunk\hadoop-yarn-project\hadoop-yarn\hadoop-yarn-server\hadoop-yarn-server-timelineservice\src\test\java\org\apache\hadoop\yarn\server\timelineservice\reader\TestTimelineReaderWebServicesUtils.java,0,219,34,9,0,262
hadoop-trunk\hadoop-trunk\hadoop-mapreduce-project\hadoop-mapreduce-client\hadoop-mapreduce-client-app\src\main\java\org\apache\hadoop\mapreduce\v2\app\rm\preemption\NoopAMPreemptionPolicy.java,44,13,0,1,0,14
hadoop-trunk\hadoop-trunk\hadoop-yarn-project\hadoop-yarn\hadoop-yarn-server\hadoop-yarn-server-common\src\main\java\org\apache\hadoop\yarn\server\volume\csi\exception\VolumeProvisioningException.java,11,5,0,1,0,6
hadoop-trunk\hadoop-trunk\hadoop-yarn-project\hadoop-yarn\hadoop-yarn-server\hadoop-yarn-server-nodemanager\src\main\java\org\apache\hadoop\yarn\server\nodemanager\webapp\AllApplicationsPage.java,0,9,0,2,0,11
hadoop-trunk\hadoop-trunk\hadoop-hdfs-project\hadoop-hdfs\src\main\java\org\apache\hadoop\hdfs\qjournal\server\JournalNodeHttpServer.java,119,26,0,2,0,28
hadoop-trunk\hadoop-trunk\hadoop-mapreduce-project\hadoop-mapreduce-examples\src\main\java\org\apache\hadoop\examples\Sort.java,0,63,10,1,0,74
hadoop-trunk\hadoop-trunk\hadoop-hdfs-project\hadoop-hdfs\src\test\java\org\apache\hadoop\hdfs\TestHAAuxiliaryPort.java,76,6,0,3,0,9
hadoop-trunk\hadoop-trunk\hadoop-yarn-project\hadoop-yarn\hadoop-yarn-server\hadoop-yarn-server-resourcemanager\src\test\java\org\apache\hadoop\yarn\server\resourcemanager\placement\csmappingrule\TestMappingRuleMatchers.java,285,12,0,1,0,13
hadoop-trunk\hadoop-trunk\hadoop-yarn-project\hadoop-yarn\hadoop-yarn-server\hadoop-yarn-server-resourcemanager\src\test\java\org\apache\hadoop\yarn\server\resourcemanager\TestResourceManagerMXBean.java,23,2,0,1,0,3
hadoop-trunk\hadoop-trunk\hadoop-hdfs-project\hadoop-hdfs-rbf\src\main\java\org\apache\hadoop\hdfs\server\federation\store\protocol\impl\pb\RefreshSuperUserGroupsConfigurationResponsePBImpl.java,0,12,29,5,0,46
hadoop-trunk\hadoop-trunk\hadoop-yarn-project\hadoop-yarn\hadoop-yarn-server\hadoop-yarn-server-resourcemanager\src\main\java\org\apache\hadoop\yarn\server\resourcemanager\scheduler\capacity\AutoCreatedLeafQueueConfig.java,63,28,0,2,0,30
hadoop-trunk\hadoop-trunk\hadoop-hdfs-project\hadoop-hdfs-rbf\src\test\java\org\apache\hadoop\fs\contract\router\web\package-info.java,0,0,0,1,0,1
hadoop-trunk\hadoop-trunk\hadoop-tools\hadoop-rumen\src\main\java\org\apache\hadoop\tools\rumen\anonymization\DataAnonymizer.java,0,3,0,1,0,4
hadoop-trunk\hadoop-trunk\hadoop-hdfs-project\hadoop-hdfs\src\test\java\org\apache\hadoop\hdfs\server\namenode\snapshot\TestGetContentSummaryWithSnapshot.java,0,29,1,2,0,32
hadoop-trunk\hadoop-trunk\hadoop-yarn-project\hadoop-yarn\hadoop-yarn-server\hadoop-yarn-server-resourcemanager\src\main\java\org\apache\hadoop\yarn\server\resourcemanager\scheduler\activities\ActivityDiagnosticConstant.java,88,57,0,1,0,58
hadoop-trunk\hadoop-trunk\hadoop-mapreduce-project\hadoop-mapreduce-examples\src\test\java\org\apache\hadoop\examples\TestWordStats.java,262,50,20,9,0,79
hadoop-trunk\hadoop-trunk\hadoop-tools\hadoop-streaming\src\test\java\org\apache\hadoop\streaming\RawBytesMapApp.java,39,16,1,1,0,18
hadoop-trunk\hadoop-trunk\hadoop-mapreduce-project\hadoop-mapreduce-client\hadoop-mapreduce-client-common\src\main\java\org\apache\hadoop\mapreduce\v2\api\protocolrecords\GetTaskAttemptReportResponse.java,0,8,2,2,0,12
hadoop-trunk\hadoop-trunk\hadoop-common-project\hadoop-common\src\test\java\org\apache\hadoop\ipc\TestRPCWaitForProxy.java,108,18,5,3,0,26
hadoop-trunk\hadoop-trunk\hadoop-hdfs-project\hadoop-hdfs-rbf\src\main\java\org\apache\hadoop\hdfs\rbfbalance\RouterFedBalance.java,317,47,13,6,0,66
hadoop-trunk\hadoop-trunk\hadoop-yarn-project\hadoop-yarn\hadoop-yarn-common\src\main\java\org\apache\hadoop\yarn\api\protocolrecords\impl\pb\ContainerUpdateResponsePBImpl.java,194,26,60,4,0,90
hadoop-trunk\hadoop-trunk\hadoop-mapreduce-project\hadoop-mapreduce-client\hadoop-mapreduce-client-jobclient\src\test\java\org\apache\hadoop\mapreduce\TestChild.java,132,65,10,3,0,78
hadoop-trunk\hadoop-trunk\hadoop-mapreduce-project\hadoop-mapreduce-client\hadoop-mapreduce-client-app\src\main\java\org\apache\hadoop\mapreduce\jobhistory\JobHistoryCopyService.java,86,29,3,2,0,34
hadoop-trunk\hadoop-trunk\hadoop-hdfs-project\hadoop-hdfs\src\test\java\org\apache\hadoop\fs\contract\hdfs\TestHDFSContractRootDirectory.java,18,4,0,1,0,5
hadoop-trunk\hadoop-trunk\hadoop-common-project\hadoop-common\src\main\java\org\apache\hadoop\fs\viewfs\RegexMountPointInterceptorFactory.java,0,1,4,1,0,6
hadoop-trunk\hadoop-trunk\hadoop-mapreduce-project\hadoop-mapreduce-client\hadoop-mapreduce-client-core\src\main\java\org\apache\hadoop\mapred\TaskAttemptContextImpl.java,0,26,1,1,0,28
hadoop-trunk\hadoop-trunk\hadoop-tools\hadoop-aws\src\test\java\org\apache\hadoop\fs\s3a\s3guard\AbstractS3GuardToolTestBase.java,228,27,1,6,0,34
hadoop-trunk\hadoop-trunk\hadoop-tools\hadoop-azure-datalake\src\test\java\org\apache\hadoop\fs\adl\live\TestAdlPermissionLive.java,73,14,2,1,0,17
hadoop-trunk\hadoop-trunk\hadoop-yarn-project\hadoop-yarn\hadoop-yarn-server\hadoop-yarn-server-resourcemanager\src\main\java\org\apache\hadoop\yarn\server\resourcemanager\reservation\PlanEdit.java,0,5,1,2,0,8
hadoop-trunk\hadoop-trunk\hadoop-hdfs-project\hadoop-hdfs\src\test\java\org\apache\hadoop\hdfs\TestDFSStripedOutputStreamWithFailureBase.java,365,69,13,1,0,83
hadoop-trunk\hadoop-trunk\hadoop-mapreduce-project\hadoop-mapreduce-client\hadoop-mapreduce-client-jobclient\src\test\java\org\apache\hadoop\mapred\jobcontrol\TestLocalJobControl.java,104,20,22,1,0,43
hadoop-trunk\hadoop-trunk\hadoop-yarn-project\hadoop-yarn\hadoop-yarn-common\src\main\java\org\apache\hadoop\yarn\nodelabels\CommonNodeLabelsManager.java,1108,216,17,4,0,237
hadoop-trunk\hadoop-trunk\hadoop-yarn-project\hadoop-yarn\hadoop-yarn-server\hadoop-yarn-server-resourcemanager\src\test\java\org\apache\hadoop\yarn\server\resourcemanager\TestReservationSystemWithRMHA.java,516,74,16,7,0,97
hadoop-trunk\hadoop-trunk\hadoop-mapreduce-project\hadoop-mapreduce-client\hadoop-mapreduce-client-jobclient\src\test\java\org\apache\hadoop\mapred\MRCaching.java,276,93,24,4,0,121
hadoop-trunk\hadoop-trunk\hadoop-yarn-project\hadoop-yarn\hadoop-yarn-api\src\main\java\org\apache\hadoop\yarn\api\protocolrecords\KillApplicationRequest.java,41,9,0,2,0,11
hadoop-trunk\hadoop-trunk\hadoop-yarn-project\hadoop-yarn\hadoop-yarn-server\hadoop-yarn-server-resourcemanager\src\main\java\org\apache\hadoop\yarn\server\resourcemanager\placement\PlacementRule.java,75,8,0,2,0,10
hadoop-trunk\hadoop-trunk\hadoop-yarn-project\hadoop-yarn\hadoop-yarn-common\src\main\java\org\apache\hadoop\yarn\api\records\impl\pb\UpdateContainerErrorPBImpl.java,115,21,34,1,0,56
hadoop-trunk\hadoop-trunk\hadoop-hdfs-project\hadoop-hdfs-client\src\main\java\org\apache\hadoop\hdfs\protocol\CachePoolStats.java,86,50,2,1,0,53
hadoop-trunk\hadoop-trunk\hadoop-hdfs-project\hadoop-hdfs\src\test\java\org\apache\hadoop\test\MiniDFSClusterManager.java,212,43,5,3,0,51
hadoop-trunk\hadoop-trunk\hadoop-mapreduce-project\hadoop-mapreduce-client\hadoop-mapreduce-client-core\src\main\java\org\apache\hadoop\mapreduce\JobContext.java,0,102,39,1,0,142
hadoop-trunk\hadoop-trunk\hadoop-mapreduce-project\hadoop-mapreduce-client\hadoop-mapreduce-client-core\src\main\java\org\apache\hadoop\mapreduce\lib\output\committer\manifest\impl\InternalConstants.java,0,1,1,8,0,10
hadoop-trunk\hadoop-trunk\hadoop-tools\hadoop-distcp\src\main\java\org\apache\hadoop\tools\util\ProducerConsumer.java,0,15,0,1,0,16
hadoop-trunk\hadoop-trunk\hadoop-common-project\hadoop-common\src\main\java\org\apache\hadoop\security\authorize\ProxyUsers.java,112,27,3,2,0,32
hadoop-trunk\hadoop-trunk\hadoop-hdfs-project\hadoop-hdfs-rbf\src\main\java\org\apache\hadoop\hdfs\server\federation\store\protocol\impl\pb\EnableNameserviceRequestPBImpl.java,0,12,29,5,0,46
hadoop-trunk\hadoop-trunk\hadoop-yarn-project\hadoop-yarn\hadoop-yarn-server\hadoop-yarn-server-resourcemanager\src\test\java\org\apache\hadoop\yarn\server\resourcemanager\volume\csi\TestVolumeProcessor.java,286,35,5,13,0,53
hadoop-trunk\hadoop-trunk\hadoop-common-project\hadoop-common\src\main\java\org\apache\hadoop\security\ssl\FileBasedKeyStoresFactory.java,303,49,1,11,0,61
hadoop-trunk\hadoop-trunk\hadoop-common-project\hadoop-common\src\main\java\org\apache\hadoop\http\IsActiveServlet.java,45,4,0,1,0,5
hadoop-trunk\hadoop-trunk\hadoop-common-project\hadoop-common\src\test\java\org\apache\hadoop\fs\viewfs\TestViewFileSystemOverloadSchemeLocalFileSystem.java,132,18,0,1,0,19
hadoop-trunk\hadoop-trunk\hadoop-hdfs-project\hadoop-hdfs\src\test\java\org\apache\hadoop\hdfs\TestDistributedFileSystemWithECFileWithRandomECPolicy.java,22,4,1,1,0,6
hadoop-trunk\hadoop-trunk\hadoop-yarn-project\hadoop-yarn\hadoop-yarn-common\src\main\java\org\apache\hadoop\yarn\util\ProcfsBasedProcessTree.java,985,176,26,8,0,210
hadoop-trunk\hadoop-trunk\hadoop-yarn-project\hadoop-yarn\hadoop-yarn-server\hadoop-yarn-server-nodemanager\src\main\java\org\apache\hadoop\yarn\server\nodemanager\containermanager\monitor\ContainersMonitorImpl.java,1073,169,15,8,0,192
hadoop-trunk\hadoop-trunk\hadoop-yarn-project\hadoop-yarn\hadoop-yarn-server\hadoop-yarn-server-resourcemanager\src\main\java\org\apache\hadoop\yarn\server\resourcemanager\webapp\dao\ClusterUserInfo.java,28,16,1,5,0,22
hadoop-trunk\hadoop-trunk\hadoop-yarn-project\hadoop-yarn\hadoop-yarn-server\hadoop-yarn-server-nodemanager\src\main\java\org\apache\hadoop\yarn\server\nodemanager\webapp\AllContainersPage.java,68,10,0,3,0,13
hadoop-trunk\hadoop-trunk\hadoop-yarn-project\hadoop-yarn\hadoop-yarn-server\hadoop-yarn-server-nodemanager\src\main\java\org\apache\hadoop\yarn\server\nodemanager\webapp\JAXBContextResolver.java,25,6,4,3,0,13
hadoop-trunk\hadoop-trunk\hadoop-hdfs-project\hadoop-hdfs\src\main\java\org\apache\hadoop\hdfs\server\datanode\web\HostRestrictingAuthorizationFilterHandler.java,0,24,12,3,0,39
hadoop-trunk\hadoop-trunk\hadoop-yarn-project\hadoop-yarn\hadoop-yarn-server\hadoop-yarn-server-timelineservice-hbase\hadoop-yarn-server-timelineservice-hbase-client\src\main\java\org\apache\hadoop\yarn\server\timelineservice\storage\reader\TimelineEntityReaderFactory.java,0,6,0,4,0,10
hadoop-trunk\hadoop-trunk\hadoop-yarn-project\hadoop-yarn\hadoop-yarn-server\hadoop-yarn-server-resourcemanager\src\test\java\org\apache\hadoop\yarn\server\resourcemanager\webapp\TestRMWebServicesSchedulerActivities.java,1609,230,30,35,0,295
hadoop-trunk\hadoop-trunk\hadoop-common-project\hadoop-common\src\main\java\org\apache\hadoop\fs\LocalDirAllocator.java,545,174,12,5,0,191
hadoop-trunk\hadoop-trunk\hadoop-mapreduce-project\hadoop-mapreduce-client\hadoop-mapreduce-client-app\src\test\java\org\apache\hadoop\mapreduce\TestMapreduceConfigFields.java,52,2,0,1,0,3
hadoop-trunk\hadoop-trunk\hadoop-yarn-project\hadoop-yarn\hadoop-yarn-server\hadoop-yarn-server-nodemanager\src\test\java\org\apache\hadoop\yarn\server\nodemanager\containermanager\localizer\TestLocalizedResource.java,188,30,0,9,0,39
hadoop-trunk\hadoop-trunk\hadoop-common-project\hadoop-common\src\test\java\org\apache\hadoop\io\TestSequenceFileSync.java,153,39,0,1,0,40
hadoop-trunk\hadoop-trunk\hadoop-hdfs-project\hadoop-hdfs-rbf\src\test\java\org\apache\hadoop\hdfs\server\federation\router\TestRouterTrash.java,242,33,2,2,0,37
hadoop-trunk\hadoop-trunk\hadoop-mapreduce-project\hadoop-mapreduce-client\hadoop-mapreduce-client-jobclient\src\test\java\org\apache\hadoop\mapreduce\JobHistoryFileReplayMapperV1.java,0,20,15,3,0,38
hadoop-trunk\hadoop-trunk\hadoop-yarn-project\hadoop-yarn\hadoop-yarn-server\hadoop-yarn-server-resourcemanager\src\main\java\org\apache\hadoop\yarn\server\resourcemanager\webapp\ApplicationsRequestBuilder.java,210,49,4,2,0,55
hadoop-trunk\hadoop-trunk\hadoop-hdfs-project\hadoop-hdfs\src\test\java\org\apache\hadoop\hdfs\TestEncryptionZones.java,2283,244,85,17,0,346
hadoop-trunk\hadoop-trunk\hadoop-yarn-project\hadoop-yarn\hadoop-yarn-server\hadoop-yarn-server-nodemanager\src\main\java\org\apache\hadoop\yarn\server\nodemanager\containermanager\resourceplugin\ResourcePluginManager.java,259,38,11,10,0,59
hadoop-trunk\hadoop-trunk\hadoop-yarn-project\hadoop-yarn\hadoop-yarn-server\hadoop-yarn-server-resourcemanager\src\main\java\org\apache\hadoop\yarn\server\resourcemanager\rmnode\RMNodeCleanAppEvent.java,14,7,0,1,0,8
hadoop-trunk\hadoop-trunk\hadoop-common-project\hadoop-nfs\src\main\java\org\apache\hadoop\mount\MountResponse.java,80,20,3,1,0,24
hadoop-trunk\hadoop-trunk\hadoop-common-project\hadoop-common\src\test\java\org\apache\hadoop\fs\FileContextTestHelper.java,0,125,4,4,0,133
hadoop-trunk\hadoop-trunk\hadoop-hdfs-project\hadoop-hdfs\src\test\java\org\apache\hadoop\hdfs\server\namenode\AclTestHelpers.java,0,35,4,1,0,40
hadoop-trunk\hadoop-trunk\hadoop-common-project\hadoop-common\src\main\java\org\apache\hadoop\fs\FsShellPermissions.java,176,83,8,5,0,96
hadoop-trunk\hadoop-trunk\hadoop-tools\hadoop-aws\src\test\java\org\apache\hadoop\fs\s3a\ITestS3AEncryptionWithDefaultS3Settings.java,105,10,2,4,0,16
hadoop-trunk\hadoop-trunk\hadoop-yarn-project\hadoop-yarn\hadoop-yarn-common\src\main\java\org\apache\hadoop\yarn\util\LinuxResourceCalculatorPlugin.java,8,1,0,1,0,2
hadoop-trunk\hadoop-trunk\hadoop-common-project\hadoop-common\src\main\java\org\apache\hadoop\tools\GetGroupsBase.java,74,16,1,2,0,19
hadoop-trunk\hadoop-trunk\hadoop-hdfs-project\hadoop-hdfs-client\src\main\java\org\apache\hadoop\hdfs\net\NioInetPeer.java,105,22,0,1,0,23
hadoop-trunk\hadoop-trunk\hadoop-tools\hadoop-dynamometer\hadoop-dynamometer-infra\src\main\java\org\apache\hadoop\tools\dynamometer\Client.java,0,94,26,2,0,122
hadoop-trunk\hadoop-trunk\hadoop-common-project\hadoop-common\src\main\java\org\apache\hadoop\metrics2\impl\MetricGaugeFloat.java,0,6,0,1,0,7
hadoop-trunk\hadoop-trunk\hadoop-yarn-project\hadoop-yarn\hadoop-yarn-server\hadoop-yarn-server-nodemanager\src\main\java\org\apache\hadoop\yarn\server\nodemanager\webapp\dao\ContainerInfo.java,141,63,2,2,0,67
hadoop-trunk\hadoop-trunk\hadoop-tools\hadoop-azure\src\test\java\org\apache\hadoop\fs\azurebfs\ITestOauthOverAbfsScheme.java,30,4,1,3,0,8
hadoop-trunk\hadoop-trunk\hadoop-mapreduce-project\hadoop-mapreduce-client\hadoop-mapreduce-client-common\src\main\java\org\apache\hadoop\mapreduce\v2\api\impl\pb\client\MRClientProtocolPBClientImpl.java,197,80,43,79,0,202
hadoop-trunk\hadoop-trunk\hadoop-mapreduce-project\hadoop-mapreduce-client\hadoop-mapreduce-client-core\src\main\java\org\apache\hadoop\mapreduce\lib\fieldsel\FieldSelectionHelper.java,174,72,2,7,0,81
hadoop-trunk\hadoop-trunk\hadoop-mapreduce-project\hadoop-mapreduce-client\hadoop-mapreduce-client-core\src\main\java\org\apache\hadoop\mapred\MapRunner.java,0,23,4,1,0,28
hadoop-trunk\hadoop-trunk\hadoop-tools\hadoop-rumen\src\main\java\org\apache\hadoop\tools\rumen\datatypes\JobName.java,19,10,0,1,0,11
hadoop-trunk\hadoop-trunk\hadoop-hdfs-project\hadoop-hdfs-rbf\src\main\java\org\apache\hadoop\hdfs\server\federation\router\RouterRpcServer.java,0,379,23,31,0,433
hadoop-trunk\hadoop-trunk\hadoop-tools\hadoop-streaming\src\main\java\org\apache\hadoop\streaming\mapreduce\StreamBaseRecordReader.java,0,68,1,2,0,71
hadoop-trunk\hadoop-trunk\hadoop-tools\hadoop-aws\src\main\java\org\apache\hadoop\fs\s3a\AWSServiceThrottledException.java,18,2,0,1,0,3
hadoop-trunk\hadoop-trunk\hadoop-common-project\hadoop-common\src\main\java\org\apache\hadoop\fs\shell\find\BaseExpression.java,0,43,4,1,0,48
hadoop-trunk\hadoop-trunk\hadoop-mapreduce-project\hadoop-mapreduce-client\hadoop-mapreduce-client-core\src\main\java\org\apache\hadoop\mapred\SortedRanges.java,0,204,12,1,0,217
hadoop-trunk\hadoop-trunk\hadoop-yarn-project\hadoop-yarn\hadoop-yarn-common\src\main\java\org\apache\hadoop\yarn\nodelabels\store\op\RemoveNodeToAttributeLogOp.java,0,13,3,4,0,20
hadoop-trunk\hadoop-trunk\hadoop-hdfs-project\hadoop-hdfs\src\main\java\org\apache\hadoop\hdfs\server\balancer\ExitStatus.java,0,15,1,1,0,17
hadoop-trunk\hadoop-trunk\hadoop-tools\hadoop-aliyun\src\test\java\org\apache\hadoop\fs\aliyun\oss\contract\TestAliyunOSSContractDelete.java,8,2,0,1,0,3
hadoop-trunk\hadoop-trunk\hadoop-hdfs-project\hadoop-hdfs-client\src\main\java\org\apache\hadoop\hdfs\server\namenode\ha\RequestHedgingProxyProvider.java,253,26,4,1,0,31
hadoop-trunk\hadoop-trunk\hadoop-yarn-project\hadoop-yarn\hadoop-yarn-server\hadoop-yarn-server-timelineservice\src\main\java\org\apache\hadoop\yarn\server\timelineservice\reader\TimelineReaderWebServicesUtils.java,0,72,4,3,0,79
hadoop-trunk\hadoop-trunk\hadoop-mapreduce-project\hadoop-mapreduce-client\hadoop-mapreduce-client-core\src\main\java\org\apache\hadoop\mapred\lib\aggregate\UniqValueCount.java,0,8,0,1,0,9
hadoop-trunk\hadoop-trunk\hadoop-mapreduce-project\hadoop-mapreduce-client\hadoop-mapreduce-client-core\src\test\java\org\apache\hadoop\mapreduce\TestCluster.java,43,8,3,1,0,12
hadoop-trunk\hadoop-trunk\hadoop-common-project\hadoop-common\src\test\java\org\apache\hadoop\crypto\key\TestKeyProviderDelegationTokenExtension.java,45,8,3,2,0,13
hadoop-trunk\hadoop-trunk\hadoop-hdfs-project\hadoop-hdfs\src\main\java\org\apache\hadoop\hdfs\server\namenode\FSDirXAttrOp.java,443,57,9,6,0,72
hadoop-trunk\hadoop-trunk\hadoop-hdfs-project\hadoop-hdfs\src\main\java\org\apache\hadoop\hdfs\server\namenode\snapshot\DiffListBySkipList.java,518,60,2,1,0,63
hadoop-trunk\hadoop-trunk\hadoop-common-project\hadoop-common\src\test\java\org\apache\hadoop\service\launcher\testservices\LaunchableRunningService.java,67,21,0,2,0,23
hadoop-trunk\hadoop-trunk\hadoop-common-project\hadoop-common\src\main\java\org\apache\hadoop\fs\statistics\impl\IOStatisticsStoreBuilder.java,0,0,0,1,0,1
hadoop-trunk\hadoop-trunk\hadoop-common-project\hadoop-common\src\test\java\org\apache\hadoop\util\TestHttpExceptionUtils.java,131,10,5,3,0,18
hadoop-trunk\hadoop-trunk\hadoop-yarn-project\hadoop-yarn\hadoop-yarn-server\hadoop-yarn-server-resourcemanager\src\main\java\org\apache\hadoop\yarn\server\resourcemanager\monitor\capacity\FifoCandidatesSelector.java,0,44,0,8,0,52
hadoop-trunk\hadoop-trunk\hadoop-yarn-project\hadoop-yarn\hadoop-yarn-common\src\main\java\org\apache\hadoop\yarn\api\protocolrecords\impl\pb\ReservationDeleteResponsePBImpl.java,44,17,18,2,0,37
hadoop-trunk\hadoop-trunk\hadoop-yarn-project\hadoop-yarn\hadoop-yarn-api\src\main\java\org\apache\hadoop\yarn\api\protocolrecords\GetLocalizationStatusesRequest.java,32,4,0,1,0,5
hadoop-trunk\hadoop-trunk\hadoop-yarn-project\hadoop-yarn\hadoop-yarn-server\hadoop-yarn-server-resourcemanager\src\main\java\org\apache\hadoop\yarn\server\resourcemanager\scheduler\fair\converter\FSConfigToCSConfigConverterMain.java,0,7,1,1,0,9
hadoop-trunk\hadoop-trunk\hadoop-yarn-project\hadoop-yarn\hadoop-yarn-server\hadoop-yarn-server-resourcemanager\src\test\java\org\apache\hadoop\yarn\server\resourcemanager\scheduler\constraint\TestAllocationTagsManager.java,611,69,3,2,0,74
hadoop-trunk\hadoop-trunk\hadoop-tools\hadoop-azure-datalake\src\test\java\org\apache\hadoop\fs\adl\live\TestAdlContractRenameLive.java,9,2,0,1,0,3
hadoop-trunk\hadoop-trunk\hadoop-mapreduce-project\hadoop-mapreduce-client\hadoop-mapreduce-client-jobclient\src\test\java\org\apache\hadoop\mapreduce\lib\input\TestNLineInputFormat.java,91,27,0,2,0,29
hadoop-trunk\hadoop-trunk\hadoop-hdfs-project\hadoop-hdfs-client\src\main\java\org\apache\hadoop\hdfs\protocol\ProvidedStorageLocation.java,59,29,2,1,0,32
hadoop-trunk\hadoop-trunk\hadoop-common-project\hadoop-nfs\src\main\java\org\apache\hadoop\nfs\nfs3\response\REMOVE3Response.java,29,18,4,1,0,23
hadoop-trunk\hadoop-trunk\hadoop-tools\hadoop-azure\src\test\java\org\apache\hadoop\fs\azurebfs\contract\ITestAbfsFileSystemContractRootDirectory.java,31,7,1,2,0,10
hadoop-trunk\hadoop-trunk\hadoop-hdfs-project\hadoop-hdfs\src\test\java\org\apache\hadoop\fs\viewfs\TestViewFsFileStatusHdfs.java,78,27,4,2,0,33
hadoop-trunk\hadoop-trunk\hadoop-mapreduce-project\hadoop-mapreduce-client\hadoop-mapreduce-client-jobclient\src\test\java\org\apache\hadoop\mapred\TestMROpportunisticMaps.java,226,62,9,1,0,72
hadoop-trunk\hadoop-trunk\hadoop-yarn-project\hadoop-yarn\hadoop-yarn-server\hadoop-yarn-server-resourcemanager\src\test\java\org\apache\hadoop\yarn\server\resourcemanager\scheduler\capacity\TestQueueStateManager.java,120,19,2,3,0,24
hadoop-trunk\hadoop-trunk\hadoop-common-project\hadoop-common\src\main\java\org\apache\hadoop\io\erasurecode\rawcoder\RawErasureEncoder.java,153,16,0,1,0,17
hadoop-trunk\hadoop-trunk\hadoop-mapreduce-project\hadoop-mapreduce-client\hadoop-mapreduce-client-core\src\main\java\org\apache\hadoop\mapred\MapOutputFile.java,130,17,3,1,0,21
hadoop-trunk\hadoop-trunk\hadoop-hdfs-project\hadoop-hdfs-client\src\main\java\org\apache\hadoop\hdfs\web\resources\ConcatSourcesParam.java,42,8,0,1,0,9
hadoop-trunk\hadoop-trunk\hadoop-hdfs-project\hadoop-hdfs-httpfs\src\test\java\org\apache\hadoop\fs\http\server\HttpFSKerberosAuthenticationHandlerForTesting.java,0,3,0,2,0,5
hadoop-trunk\hadoop-trunk\hadoop-tools\hadoop-azure\src\main\java\org\apache\hadoop\fs\azurebfs\extensions\SASTokenProvider.java,0,18,0,1,0,19
hadoop-trunk\hadoop-trunk\hadoop-common-project\hadoop-common\src\main\java\org\apache\hadoop\util\KMSUtil.java,0,29,14,2,0,45
hadoop-trunk\hadoop-trunk\hadoop-common-project\hadoop-registry\src\test\java\org\apache\hadoop\registry\operations\TestRegistryOperations.java,291,28,0,1,0,29
hadoop-trunk\hadoop-trunk\hadoop-hdfs-project\hadoop-hdfs-client\src\main\java\org\apache\hadoop\hdfs\server\namenode\ha\AbstractNNFailoverProxyProvider.java,0,50,5,1,0,56
hadoop-trunk\hadoop-trunk\hadoop-tools\hadoop-fs2img\src\test\java\org\apache\hadoop\hdfs\server\namenode\RandomTreeWalk.java,148,58,4,1,0,63
hadoop-trunk\hadoop-trunk\hadoop-tools\hadoop-aws\src\main\java\org\apache\hadoop\fs\s3a\Constants.java,0,105,3,6,0,114
hadoop-trunk\hadoop-trunk\hadoop-mapreduce-project\hadoop-mapreduce-examples\src\main\java\org\apache\hadoop\examples\RandomWriter.java,221,149,7,2,0,158
hadoop-trunk\hadoop-trunk\hadoop-hdfs-project\hadoop-hdfs-rbf\src\main\java\org\apache\hadoop\hdfs\server\federation\store\StateStoreService.java,389,16,2,3,0,21
hadoop-trunk\hadoop-trunk\hadoop-mapreduce-project\hadoop-mapreduce-client\hadoop-mapreduce-client-jobclient\src\test\java\org\apache\hadoop\mapreduce\JobHistoryFileReplayHelper.java,0,42,7,1,0,50
hadoop-trunk\hadoop-trunk\hadoop-yarn-project\hadoop-yarn\hadoop-yarn-applications\hadoop-yarn-applications-mawo\hadoop-yarn-applications-mawo-core\src\main\java\org\apache\hadoop\applications\mawo\server\common\AbstractTask.java,212,0,2,1,0,3
hadoop-trunk\hadoop-trunk\hadoop-yarn-project\hadoop-yarn\hadoop-yarn-common\src\main\java\org\apache\hadoop\yarn\security\package-info.java,0,1,0,1,0,2
hadoop-trunk\hadoop-trunk\hadoop-tools\hadoop-aws\src\main\java\org\apache\hadoop\fs\s3a\impl\StoreContext.java,351,73,1,3,0,77
hadoop-trunk\hadoop-trunk\hadoop-tools\hadoop-azure\src\test\java\org\apache\hadoop\fs\azurebfs\extensions\KerberizedAbfsCluster.java,265,45,10,3,0,58
hadoop-trunk\hadoop-trunk\hadoop-yarn-project\hadoop-yarn\hadoop-yarn-client\src\main\java\org\apache\hadoop\yarn\client\api\impl\package-info.java,0,1,0,1,0,2
hadoop-trunk\hadoop-trunk\hadoop-common-project\hadoop-common\src\main\java\org\apache\hadoop\metrics2\lib\Interns.java,131,36,3,1,0,40
hadoop-trunk\hadoop-trunk\hadoop-yarn-project\hadoop-yarn\hadoop-yarn-server\hadoop-yarn-server-common\src\main\java\org\apache\hadoop\yarn\server\webapp\WrappedLogMetaRequest.java,137,40,1,3,0,44
hadoop-trunk\hadoop-trunk\hadoop-common-project\hadoop-common\src\main\java\org\apache\hadoop\metrics2\lib\MutableGauge.java,22,8,1,1,0,10
hadoop-trunk\hadoop-trunk\hadoop-mapreduce-project\hadoop-mapreduce-client\hadoop-mapreduce-client-common\src\main\java\org\apache\hadoop\mapreduce\v2\util\MRApps.java,661,162,28,15,0,205
hadoop-trunk\hadoop-trunk\hadoop-yarn-project\hadoop-yarn\hadoop-yarn-server\hadoop-yarn-server-nodemanager\src\test\java\org\apache\hadoop\yarn\server\nodemanager\nodelabels\TestConfigurationNodeLabelsProvider.java,138,22,1,2,0,25
hadoop-trunk\hadoop-trunk\hadoop-hdfs-project\hadoop-hdfs\src\test\java\org\apache\hadoop\hdfs\ListingBenchmark.java,12,3,3,1,0,7
hadoop-trunk\hadoop-trunk\hadoop-tools\hadoop-azure\src\main\java\org\apache\hadoop\fs\azurebfs\commit\ResilientCommitByRename.java,0,10,0,9,0,19
hadoop-trunk\hadoop-trunk\hadoop-common-project\hadoop-common\src\test\java\org\apache\hadoop\util\TestStopWatch.java,41,4,3,1,0,8
hadoop-trunk\hadoop-trunk\hadoop-common-project\hadoop-common\src\test\java\org\apache\hadoop\crypto\key\TestKeyProviderFactory.java,439,47,27,7,0,81
hadoop-trunk\hadoop-trunk\hadoop-common-project\hadoop-nfs\src\main\java\org\apache\hadoop\oncrpc\security\SysSecurityHandler.java,43,20,2,1,0,23
hadoop-trunk\hadoop-trunk\hadoop-hdfs-project\hadoop-hdfs\src\test\java\org\apache\hadoop\hdfs\TestLocatedBlocksRefresher.java,217,49,2,18,0,69
hadoop-trunk\hadoop-trunk\hadoop-hdfs-project\hadoop-hdfs-rbf\src\main\java\org\apache\hadoop\hdfs\server\federation\store\protocol\GetDestinationResponse.java,30,8,0,2,0,10
hadoop-trunk\hadoop-trunk\hadoop-common-project\hadoop-common\src\main\java\org\apache\hadoop\metrics2\MetricsRecord.java,0,4,0,1,0,5
hadoop-trunk\hadoop-trunk\hadoop-hdfs-project\hadoop-hdfs\src\test\java\org\apache\hadoop\hdfs\server\namenode\snapshot\TestSnapshotRename.java,378,88,6,3,0,97
hadoop-trunk\hadoop-trunk\hadoop-yarn-project\hadoop-yarn\hadoop-yarn-server\hadoop-yarn-server-common\src\main\java\org\apache\hadoop\yarn\server\federation\store\records\impl\pb\GetApplicationsHomeSubClusterResponsePBImpl.java,0,19,42,6,0,67
hadoop-trunk\hadoop-trunk\hadoop-yarn-project\hadoop-yarn\hadoop-yarn-common\src\main\java\org\apache\hadoop\yarn\client\AutoRefreshRMFailoverProxyProvider.java,0,4,2,1,0,7
hadoop-trunk\hadoop-trunk\hadoop-yarn-project\hadoop-yarn\hadoop-yarn-common\src\main\java\org\apache\hadoop\yarn\server\api\impl\pb\client\SCMAdminProtocolPBClientImpl.java,34,9,3,6,0,18
hadoop-trunk\hadoop-trunk\hadoop-tools\hadoop-aws\src\test\java\org\apache\hadoop\fs\s3a\scale\ITestS3ADirectoryPerformance.java,372,31,12,8,0,51
hadoop-trunk\hadoop-trunk\hadoop-yarn-project\hadoop-yarn\hadoop-yarn-common\src\main\java\org\apache\hadoop\yarn\security\client\TimelineDelegationTokenIdentifier.java,75,18,1,2,0,21
hadoop-trunk\hadoop-trunk\hadoop-yarn-project\hadoop-yarn\hadoop-yarn-server\hadoop-yarn-server-resourcemanager\src\test\java\org\apache\hadoop\yarn\server\resourcemanager\logaggregationstatus\TestRMAppLogAggregationStatus.java,442,47,10,10,0,67
hadoop-trunk\hadoop-trunk\hadoop-common-project\hadoop-registry\src\test\java\org\apache\hadoop\registry\secure\TestSecureRegistry.java,139,12,5,3,0,20
hadoop-trunk\hadoop-trunk\hadoop-mapreduce-project\hadoop-mapreduce-client\hadoop-mapreduce-client-core\src\test\java\org\apache\hadoop\mapreduce\task\reduce\TestMergeManager.java,276,69,22,5,0,96
hadoop-trunk\hadoop-trunk\hadoop-tools\hadoop-aws\src\main\java\org\apache\hadoop\fs\s3a\auth\delegation\DelegationTokenIOException.java,24,2,0,1,0,3
hadoop-trunk\hadoop-trunk\hadoop-yarn-project\hadoop-yarn\hadoop-yarn-server\hadoop-yarn-server-applicationhistoryservice\src\main\java\org\apache\hadoop\yarn\server\applicationhistoryservice\records\ApplicationAttemptFinishData.java,63,17,0,1,0,18
hadoop-trunk\hadoop-trunk\hadoop-common-project\hadoop-registry\src\main\java\org\apache\hadoop\registry\client\impl\zk\RegistryInternalConstants.java,0,4,7,1,0,12
hadoop-trunk\hadoop-trunk\hadoop-mapreduce-project\hadoop-mapreduce-client\hadoop-mapreduce-client-core\src\main\java\org\apache\hadoop\mapreduce\CryptoUtils.java,181,36,2,2,0,40
hadoop-trunk\hadoop-trunk\hadoop-yarn-project\hadoop-yarn\hadoop-yarn-api\src\main\java\org\apache\hadoop\yarn\api\records\QueueState.java,0,4,0,2,0,6
hadoop-trunk\hadoop-trunk\hadoop-hdfs-project\hadoop-hdfs\src\test\java\org\apache\hadoop\test\HdfsTestDriver.java,36,19,2,1,0,22
hadoop-trunk\hadoop-trunk\hadoop-common-project\hadoop-common\src\main\java\org\apache\hadoop\ipc\metrics\RpcMetrics.java,314,99,2,1,0,102
hadoop-trunk\hadoop-trunk\hadoop-hdfs-project\hadoop-hdfs\src\test\java\org\apache\hadoop\hdfs\server\namenode\TestNameNodeRpcServer.java,0,6,2,2,0,10
hadoop-trunk\hadoop-trunk\hadoop-hdfs-project\hadoop-hdfs\src\test\java\org\apache\hadoop\hdfs\TestDFSOutputStream.java,444,65,70,11,0,146
hadoop-trunk\hadoop-trunk\hadoop-mapreduce-project\hadoop-mapreduce-client\hadoop-mapreduce-client-hs\src\test\java\org\apache\hadoop\mapreduce\v2\hs\webapp\dao\TestJobInfo.java,141,51,3,5,0,59
hadoop-trunk\hadoop-trunk\hadoop-tools\hadoop-gridmix\src\test\java\org\apache\hadoop\mapred\gridmix\TestCompressionEmulationUtils.java,532,170,16,5,0,191
hadoop-trunk\hadoop-trunk\hadoop-yarn-project\hadoop-yarn\hadoop-yarn-server\hadoop-yarn-server-nodemanager\src\main\java\org\apache\hadoop\yarn\server\nodemanager\ResourceView.java,0,3,0,1,0,4
hadoop-trunk\hadoop-trunk\hadoop-common-project\hadoop-common\src\test\java\org\apache\hadoop\util\TestAutoCloseableLock.java,69,1,1,1,0,3
hadoop-trunk\hadoop-trunk\hadoop-mapreduce-project\hadoop-mapreduce-client\hadoop-mapreduce-client-core\src\main\java\org\apache\hadoop\mapred\TextOutputFormat.java,0,32,1,2,0,35
hadoop-trunk\hadoop-trunk\hadoop-hdfs-project\hadoop-hdfs\src\test\java\org\apache\hadoop\hdfs\TestDFSRename.java,165,51,8,3,0,62
hadoop-trunk\hadoop-trunk\hadoop-common-project\hadoop-common\src\main\java\org\apache\hadoop\fs\GlobExpander.java,158,24,7,2,0,33
hadoop-trunk\hadoop-trunk\hadoop-tools\hadoop-azure\src\main\java\org\apache\hadoop\fs\azure\WasbAuthorizationOperations.java,0,5,0,1,0,6
hadoop-trunk\hadoop-trunk\hadoop-yarn-project\hadoop-yarn\hadoop-yarn-server\hadoop-yarn-server-resourcemanager\src\main\java\org\apache\hadoop\yarn\server\resourcemanager\monitor\capacity\FifoIntraQueuePreemptionPlugin.java,579,65,15,14,0,94
hadoop-trunk\hadoop-trunk\hadoop-mapreduce-project\hadoop-mapreduce-client\hadoop-mapreduce-client-nativetask\src\main\java\org\apache\hadoop\mapred\nativetask\serde\DoubleWritableSerializer.java,8,4,0,1,0,5
hadoop-trunk\hadoop-trunk\hadoop-tools\hadoop-aws\src\test\java\org\apache\hadoop\fs\s3a\ITestS3AFSMainOperations.java,41,4,3,1,0,8
hadoop-trunk\hadoop-trunk\hadoop-yarn-project\hadoop-yarn\hadoop-yarn-server\hadoop-yarn-server-timelineservice-hbase\hadoop-yarn-server-timelineservice-hbase-common\src\main\java\org\apache\hadoop\yarn\server\timelineservice\storage\entity\package-info.java,0,0,0,1,0,1
hadoop-trunk\hadoop-trunk\hadoop-yarn-project\hadoop-yarn\hadoop-yarn-client\src\main\java\org\apache\hadoop\yarn\client\cli\TopCLI.java,1150,345,25,9,0,379
hadoop-trunk\hadoop-trunk\hadoop-hdfs-project\hadoop-hdfs-rbf\src\main\java\org\apache\hadoop\hdfs\server\federation\router\RouterFsckServlet.java,42,6,1,1,0,8
hadoop-trunk\hadoop-trunk\hadoop-mapreduce-project\hadoop-mapreduce-client\hadoop-mapreduce-client-core\src\test\java\org\apache\hadoop\mapreduce\lib\output\committer\manifest\TextOutputForTests.java,0,26,1,1,0,28
hadoop-trunk\hadoop-trunk\hadoop-hdfs-project\hadoop-hdfs-rbf\src\main\java\org\apache\hadoop\hdfs\server\federation\store\protocol\impl\pb\RouterHeartbeatRequestPBImpl.java,0,11,32,7,0,50
hadoop-trunk\hadoop-trunk\hadoop-yarn-project\hadoop-yarn\hadoop-yarn-server\hadoop-yarn-server-nodemanager\src\main\java\org\apache\hadoop\yarn\server\nodemanager\api\deviceplugin\MountVolumeSpec.java,0,26,1,1,0,28
hadoop-trunk\hadoop-trunk\hadoop-mapreduce-project\hadoop-mapreduce-client\hadoop-mapreduce-client-app\src\main\java\org\apache\hadoop\mapreduce\v2\app\webapp\TasksBlock.java,86,14,1,2,0,17
hadoop-trunk\hadoop-trunk\hadoop-mapreduce-project\hadoop-mapreduce-client\hadoop-mapreduce-client-nativetask\src\test\java\org\apache\hadoop\mapred\nativetask\combinertest\LargeKVCombinerTest.java,71,24,3,10,0,37
hadoop-trunk\hadoop-trunk\hadoop-yarn-project\hadoop-yarn\hadoop-yarn-applications\hadoop-yarn-services\hadoop-yarn-services-core\src\main\java\org\apache\hadoop\yarn\service\containerlaunch\CommandLineBuilder.java,56,14,0,1,0,15
hadoop-trunk\hadoop-trunk\hadoop-tools\hadoop-azure\src\test\java\org\apache\hadoop\fs\azurebfs\ITestAzureBlobFileSystemFlush.java,374,59,10,22,0,91
hadoop-trunk\hadoop-trunk\hadoop-yarn-project\hadoop-yarn\hadoop-yarn-api\src\main\java\org\apache\hadoop\yarn\api\records\AllocationTagNamespaceType.java,0,8,0,1,0,9
hadoop-trunk\hadoop-trunk\hadoop-yarn-project\hadoop-yarn\hadoop-yarn-server\hadoop-yarn-server-timelineservice-documentstore\src\main\java\org\apache\hadoop\yarn\server\timelineservice\documentstore\collection\document\flowrun\package-info.java,0,0,0,2,0,2
hadoop-trunk\hadoop-trunk\hadoop-mapreduce-project\hadoop-mapreduce-client\hadoop-mapreduce-client-app\src\main\java\org\apache\hadoop\mapreduce\v2\app\speculate\DefaultSpeculator.java,571,119,13,9,0,141
hadoop-trunk\hadoop-trunk\hadoop-tools\hadoop-gridmix\src\main\java\org\apache\hadoop\mapred\gridmix\UserResolver.java,0,4,3,1,0,8
hadoop-trunk\hadoop-trunk\hadoop-hdfs-project\hadoop-hdfs\src\main\java\org\apache\hadoop\hdfs\qjournal\server\JournalNodeRpcServer.java,264,106,27,13,0,146
hadoop-trunk\hadoop-trunk\hadoop-tools\hadoop-aws\src\test\java\org\apache\hadoop\fs\s3a\audit\impl\TestActiveAuditManagerThreadLeakage.java,342,7,1,5,0,13
hadoop-trunk\hadoop-trunk\hadoop-common-project\hadoop-common\src\test\java\org\apache\hadoop\io\TestArrayPrimitiveWritable.java,0,60,3,2,0,65
hadoop-trunk\hadoop-trunk\hadoop-common-project\hadoop-common\src\main\java\org\apache\hadoop\fs\ByteBufferReadable.java,0,2,1,1,0,4
hadoop-trunk\hadoop-trunk\hadoop-common-project\hadoop-auth\src\main\java\org\apache\hadoop\security\authentication\server\PseudoAuthenticationHandler.java,158,27,2,14,0,43
hadoop-trunk\hadoop-trunk\hadoop-common-project\hadoop-common\src\test\java\org\apache\hadoop\util\TestDiskValidatorFactory.java,31,0,0,1,0,1
hadoop-trunk\hadoop-trunk\hadoop-mapreduce-project\hadoop-mapreduce-client\hadoop-mapreduce-client-nativetask\src\main\java\org\apache\hadoop\mapred\nativetask\serde\BoolWritableSerializer.java,8,4,0,1,0,5
hadoop-trunk\hadoop-trunk\hadoop-yarn-project\hadoop-yarn\hadoop-yarn-common\src\main\java\org\apache\hadoop\yarn\api\protocolrecords\impl\pb\GetQueueUserAclsInfoRequestPBImpl.java,43,21,18,4,0,43
hadoop-trunk\hadoop-trunk\hadoop-common-project\hadoop-registry\src\main\java\org\apache\hadoop\registry\server\dns\ContainerServiceRecordProcessor.java,250,25,7,1,0,33
hadoop-trunk\hadoop-trunk\hadoop-mapreduce-project\hadoop-mapreduce-client\hadoop-mapreduce-client-app\src\main\java\org\apache\hadoop\mapred\TaskAttemptListenerImpl.java,0,144,35,16,0,195
hadoop-trunk\hadoop-trunk\hadoop-yarn-project\hadoop-yarn\hadoop-yarn-common\src\main\java\org\apache\hadoop\yarn\server\metrics\AppAttemptMetricsConstants.java,45,15,0,1,0,16
hadoop-trunk\hadoop-trunk\hadoop-yarn-project\hadoop-yarn\hadoop-yarn-server\hadoop-yarn-server-common\src\test\java\org\apache\hadoop\yarn\server\federation\store\utils\TestFederationStateStoreInputValidator.java,1212,52,42,14,0,108
hadoop-trunk\hadoop-trunk\hadoop-mapreduce-project\hadoop-mapreduce-client\hadoop-mapreduce-client-jobclient\src\test\java\org\apache\hadoop\mapred\lib\TestChain.java,34,3,0,1,0,4
hadoop-trunk\hadoop-trunk\hadoop-tools\hadoop-distcp\src\test\java\org\apache\hadoop\tools\TestDistCpSystem.java,0,108,16,2,0,126
hadoop-trunk\hadoop-trunk\hadoop-tools\hadoop-rumen\src\test\java\org\apache\hadoop\tools\rumen\TestHistograms.java,119,26,4,4,0,34
hadoop-trunk\hadoop-trunk\hadoop-common-project\hadoop-common\src\main\java\org\apache\hadoop\fs\viewfs\FsGetter.java,18,11,0,1,0,12
hadoop-trunk\hadoop-trunk\hadoop-hdfs-project\hadoop-hdfs-rbf\src\test\java\org\apache\hadoop\hdfs\server\federation\resolver\TestFederationNamespaceInfo.java,14,1,0,1,0,2
hadoop-trunk\hadoop-trunk\hadoop-hdfs-project\hadoop-hdfs-client\src\main\java\org\apache\hadoop\hdfs\protocol\ErasureCodingPolicyInfo.java,76,23,3,1,0,27
hadoop-trunk\hadoop-trunk\hadoop-yarn-project\hadoop-yarn\hadoop-yarn-api\src\main\java\org\apache\hadoop\yarn\api\records\timeline\TimelineAbout.java,0,53,1,1,0,55
hadoop-trunk\hadoop-trunk\hadoop-yarn-project\hadoop-yarn\hadoop-yarn-server\hadoop-yarn-server-common\src\main\java\org\apache\hadoop\yarn\server\federation\store\records\GetApplicationHomeSubClusterRequest.java,34,2,0,1,0,3
hadoop-trunk\hadoop-trunk\hadoop-tools\hadoop-rumen\src\main\java\org\apache\hadoop\tools\rumen\TraceBuilder.java,266,42,24,2,0,68
hadoop-trunk\hadoop-trunk\hadoop-cloud-storage-project\hadoop-cos\src\main\java\org\apache\hadoop\fs\cosn\FileMetadata.java,0,18,0,1,0,19
hadoop-trunk\hadoop-trunk\hadoop-yarn-project\hadoop-yarn\hadoop-yarn-server\hadoop-yarn-server-resourcemanager\src\main\java\org\apache\hadoop\yarn\server\resourcemanager\webapp\RMWebApp.java,106,20,7,1,0,28
hadoop-trunk\hadoop-trunk\hadoop-common-project\hadoop-common\src\main\java\org\apache\hadoop\ipc\WeightedTimeCostProvider.java,60,8,1,1,0,10
hadoop-trunk\hadoop-trunk\hadoop-common-project\hadoop-common\src\test\java\org\apache\hadoop\test\Whitebox.java,62,12,2,1,0,15
hadoop-trunk\hadoop-trunk\hadoop-yarn-project\hadoop-yarn\hadoop-yarn-server\hadoop-yarn-server-resourcemanager\src\test\java\org\apache\hadoop\yarn\server\resourcemanager\scheduler\constraint\TestBatchedRequestsIterators.java,50,18,0,3,0,21
hadoop-trunk\hadoop-trunk\hadoop-mapreduce-project\hadoop-mapreduce-client\hadoop-mapreduce-client-core\src\main\java\org\apache\hadoop\mapreduce\ContextFactory.java,213,95,16,3,0,114
hadoop-trunk\hadoop-trunk\hadoop-mapreduce-project\hadoop-mapreduce-client\hadoop-mapreduce-client-common\src\main\java\org\apache\hadoop\mapreduce\v2\api\impl\pb\client\package-info.java,0,1,0,1,0,2
hadoop-trunk\hadoop-trunk\hadoop-mapreduce-project\hadoop-mapreduce-client\hadoop-mapreduce-client-core\src\test\java\org\apache\hadoop\mapreduce\lib\partition\TestRehashPartitioner.java,42,54,3,5,0,62
hadoop-trunk\hadoop-trunk\hadoop-yarn-project\hadoop-yarn\hadoop-yarn-common\src\main\java\org\apache\hadoop\yarn\api\records\impl\pb\PreemptionMessagePBImpl.java,135,32,46,1,0,79
hadoop-trunk\hadoop-trunk\hadoop-tools\hadoop-aws\src\test\java\org\apache\hadoop\fs\s3a\ITestS3AContentEncoding.java,56,5,0,3,0,8
hadoop-trunk\hadoop-trunk\hadoop-tools\hadoop-gridmix\src\main\java\org\apache\hadoop\mapred\gridmix\AvgRecordFactory.java,0,39,1,1,0,41
hadoop-trunk\hadoop-trunk\hadoop-yarn-project\hadoop-yarn\hadoop-yarn-server\hadoop-yarn-server-resourcemanager\src\main\java\org\apache\hadoop\yarn\server\resourcemanager\scheduler\constraint\algorithm\iterators\package-info.java,0,0,0,2,0,2
hadoop-trunk\hadoop-trunk\hadoop-common-project\hadoop-common\src\main\java\org\apache\hadoop\fs\shell\CommandUtils.java,0,4,1,1,0,6
hadoop-trunk\hadoop-trunk\hadoop-tools\hadoop-azure\src\test\java\org\apache\hadoop\fs\azurebfs\services\ITestAbfsInputStream.java,216,60,4,11,0,75
hadoop-trunk\hadoop-trunk\hadoop-hdfs-project\hadoop-hdfs-client\src\main\java\org\apache\hadoop\hdfs\HAUtilClient.java,112,24,1,4,0,29
hadoop-trunk\hadoop-trunk\hadoop-yarn-project\hadoop-yarn\hadoop-yarn-client\src\test\java\org\apache\hadoop\yarn\client\api\impl\TestAMRMClient.java,0,406,43,17,0,466
hadoop-trunk\hadoop-trunk\hadoop-yarn-project\hadoop-yarn\hadoop-yarn-common\src\main\java\org\apache\hadoop\yarn\api\records\impl\pb\QueueUserACLInfoPBImpl.java,152,40,51,1,0,92
hadoop-trunk\hadoop-trunk\hadoop-hdfs-project\hadoop-hdfs-rbf\src\test\java\org\apache\hadoop\fs\contract\router\web\RouterWebHDFSContract.java,93,15,2,3,0,20
hadoop-trunk\hadoop-trunk\hadoop-mapreduce-project\hadoop-mapreduce-client\hadoop-mapreduce-client-app\src\main\java\org\apache\hadoop\mapreduce\v2\app\rm\RMHeartbeatHandler.java,0,2,0,1,0,3
hadoop-trunk\hadoop-trunk\hadoop-yarn-project\hadoop-yarn\hadoop-yarn-server\hadoop-yarn-server-resourcemanager\src\test\java\org\apache\hadoop\yarn\server\resourcemanager\TestSubmitApplicationWithRMHA.java,339,31,1,2,0,34
hadoop-trunk\hadoop-trunk\hadoop-mapreduce-project\hadoop-mapreduce-client\hadoop-mapreduce-client-core\src\main\java\org\apache\hadoop\mapred\lib\CombineFileSplit.java,0,24,1,1,0,26
hadoop-trunk\hadoop-trunk\hadoop-tools\hadoop-sls\src\test\java\org\apache\hadoop\yarn\sls\TestSLSDagAMSimulator.java,39,5,1,3,0,9
hadoop-trunk\hadoop-trunk\hadoop-mapreduce-project\hadoop-mapreduce-client\hadoop-mapreduce-client-app\src\test\java\org\apache\hadoop\mapreduce\v2\app\job\impl\TestTaskAttemptContainerRequest.java,86,10,5,4,0,19
hadoop-trunk\hadoop-trunk\hadoop-common-project\hadoop-common\src\main\java\org\apache\hadoop\util\ConfTest.java,0,26,3,1,0,30
hadoop-trunk\hadoop-trunk\hadoop-yarn-project\hadoop-yarn\hadoop-yarn-server\hadoop-yarn-server-resourcemanager\src\test\java\org\apache\hadoop\yarn\server\resourcemanager\monitor\capacity\TestPreemptionForQueueWithPriorities.java,0,117,2,5,0,124
hadoop-trunk\hadoop-trunk\hadoop-hdfs-project\hadoop-hdfs-rbf\src\test\java\org\apache\hadoop\fs\contract\router\TestRouterHDFSContractConcat.java,20,4,0,1,0,5
hadoop-trunk\hadoop-trunk\hadoop-tools\hadoop-gridmix\src\main\java\org\apache\hadoop\mapred\gridmix\RoundRobinUserResolver.java,107,28,3,3,0,34
hadoop-trunk\hadoop-trunk\hadoop-common-project\hadoop-common\src\main\java\org\apache\hadoop\ipc\WeightedRoundRobinMultiplexer.java,112,22,0,2,0,24
hadoop-trunk\hadoop-trunk\hadoop-common-project\hadoop-nfs\src\test\java\org\apache\hadoop\portmap\TestPortmap.java,79,14,3,1,0,18
hadoop-trunk\hadoop-trunk\hadoop-yarn-project\hadoop-yarn\hadoop-yarn-api\src\main\java\org\apache\hadoop\yarn\api\protocolrecords\RegisterApplicationMasterRequest.java,131,17,1,5,0,23
hadoop-trunk\hadoop-trunk\hadoop-cloud-storage-project\hadoop-huaweicloud\src\test\java\org\apache\hadoop\fs\obs\TestOBSContractGetFileStatus.java,9,1,0,1,0,2
hadoop-trunk\hadoop-trunk\hadoop-hdfs-project\hadoop-hdfs\src\main\java\org\apache\hadoop\hdfs\server\blockmanagement\BlockInfoStriped.java,283,59,1,4,0,64
hadoop-trunk\hadoop-trunk\hadoop-common-project\hadoop-common\src\test\java\org\apache\hadoop\fs\statistics\TestIOStatisticsStore.java,136,49,0,8,0,57
hadoop-trunk\hadoop-trunk\hadoop-tools\hadoop-streaming\src\main\java\org\apache\hadoop\streaming\StreamXmlRecordReader.java,257,119,15,13,0,147
hadoop-trunk\hadoop-trunk\hadoop-yarn-project\hadoop-yarn\hadoop-yarn-server\hadoop-yarn-server-timelineservice\src\main\java\org\apache\hadoop\yarn\server\timelineservice\reader\filter\TimelinePrefixFilter.java,71,19,1,1,0,21
hadoop-trunk\hadoop-trunk\hadoop-yarn-project\hadoop-yarn\hadoop-yarn-server\hadoop-yarn-server-common\src\main\java\org\apache\hadoop\yarn\server\federation\policies\router\LocalityRouterPolicy.java,132,9,6,4,0,19
hadoop-trunk\hadoop-trunk\hadoop-common-project\hadoop-common\src\test\java\org\apache\hadoop\fs\contract\rawlocal\TestRawlocalContractPathHandle.java,0,8,4,1,0,13
hadoop-trunk\hadoop-trunk\hadoop-yarn-project\hadoop-yarn\hadoop-yarn-server\hadoop-yarn-server-common\src\main\java\org\apache\hadoop\yarn\server\api\protocolrecords\impl\pb\SCMUploaderNotifyResponsePBImpl.java,50,16,27,4,0,47
hadoop-trunk\hadoop-trunk\hadoop-common-project\hadoop-common\src\test\java\org\apache\hadoop\ha\TestHealthMonitor.java,119,39,3,1,0,43
hadoop-trunk\hadoop-trunk\hadoop-yarn-project\hadoop-yarn\hadoop-yarn-server\hadoop-yarn-server-timelineservice\src\main\java\org\apache\hadoop\yarn\server\timelineservice\reader\security\TimelineReaderAuthenticationFilterInitializer.java,24,3,0,2,0,5
hadoop-trunk\hadoop-trunk\hadoop-hdfs-project\hadoop-hdfs\src\test\java\org\apache\hadoop\hdfs\TestConnCache.java,87,27,4,2,0,33
hadoop-trunk\hadoop-trunk\hadoop-yarn-project\hadoop-yarn\hadoop-yarn-server\hadoop-yarn-server-resourcemanager\src\main\java\org\apache\hadoop\yarn\server\resourcemanager\scheduler\fair\converter\FSConfigToCSConfigRuleHandler.java,234,68,4,3,0,75
hadoop-trunk\hadoop-trunk\hadoop-hdfs-project\hadoop-hdfs\src\test\java\org\apache\hadoop\hdfs\server\namenode\snapshot\TestDiffListBySkipList.java,313,62,10,4,0,76
hadoop-trunk\hadoop-trunk\hadoop-hdfs-project\hadoop-hdfs-httpfs\src\test\java\org\apache\hadoop\lib\service\security\TestGroupsService.java,30,5,0,4,0,9
hadoop-trunk\hadoop-trunk\hadoop-yarn-project\hadoop-yarn\hadoop-yarn-api\src\main\java\org\apache\hadoop\yarn\exceptions\ApplicationMasterNotRegisteredException.java,14,18,0,9,0,27
hadoop-trunk\hadoop-trunk\hadoop-yarn-project\hadoop-yarn\hadoop-yarn-common\src\main\java\org\apache\hadoop\yarn\nodelabels\store\op\AddNodeToAttributeLogOp.java,0,13,3,4,0,20
hadoop-trunk\hadoop-trunk\hadoop-yarn-project\hadoop-yarn\hadoop-yarn-common\src\main\java\org\apache\hadoop\yarn\util\WindowsResourceCalculatorPlugin.java,8,1,0,1,0,2
hadoop-trunk\hadoop-trunk\hadoop-mapreduce-project\hadoop-mapreduce-client\hadoop-mapreduce-client-jobclient\src\test\java\org\apache\hadoop\mapreduce\lib\partition\TestBinaryPartitioner.java,81,93,4,1,0,98
hadoop-trunk\hadoop-trunk\hadoop-yarn-project\hadoop-yarn\hadoop-yarn-applications\hadoop-yarn-services\hadoop-yarn-services-core\src\main\java\org\apache\hadoop\yarn\service\provider\defaultImpl\DefaultProviderFactory.java,0,6,1,1,0,8
hadoop-trunk\hadoop-trunk\hadoop-hdfs-project\hadoop-hdfs\src\main\java\org\apache\hadoop\hdfs\server\namenode\FSPermissionChecker.java,799,198,8,7,0,213
hadoop-trunk\hadoop-trunk\hadoop-yarn-project\hadoop-yarn\hadoop-yarn-server\hadoop-yarn-server-timelineservice-hbase\hadoop-yarn-server-timelineservice-hbase-client\src\main\java\org\apache\hadoop\yarn\server\timelineservice\storage\reader\EntityTypeReader.java,0,14,3,6,0,23
hadoop-trunk\hadoop-trunk\hadoop-hdfs-project\hadoop-hdfs\src\test\java\org\apache\hadoop\hdfs\server\datanode\TestHdfsServerConstants.java,67,10,2,7,0,19
hadoop-trunk\hadoop-trunk\hadoop-yarn-project\hadoop-yarn\hadoop-yarn-server\hadoop-yarn-server-timelineservice-hbase\hadoop-yarn-server-timelineservice-hbase-common\src\main\java\org\apache\hadoop\yarn\server\timelineservice\storage\flow\FlowActivityRowKey.java,216,40,2,5,0,47
hadoop-trunk\hadoop-trunk\hadoop-maven-plugins\src\main\java\org\apache\hadoop\maven\plugin\util\Exec.java,157,21,2,3,0,26
hadoop-trunk\hadoop-trunk\hadoop-common-project\hadoop-common\src\main\java\org\apache\hadoop\util\ShutdownThreadsHelper.java,76,9,2,1,0,12
hadoop-trunk\hadoop-trunk\hadoop-common-project\hadoop-common\src\main\java\org\apache\hadoop\io\erasurecode\rawcoder\AbstractNativeRawEncoder.java,74,11,0,1,0,12
hadoop-trunk\hadoop-trunk\hadoop-yarn-project\hadoop-yarn\hadoop-yarn-common\src\main\java\org\apache\hadoop\yarn\logaggregation\LogAggregationUtils.java,413,73,12,1,0,86
hadoop-trunk\hadoop-trunk\hadoop-yarn-project\hadoop-yarn\hadoop-yarn-server\hadoop-yarn-server-router\src\test\java\org\apache\hadoop\yarn\server\router\webapp\JavaProcess.java,40,11,0,1,0,12
hadoop-trunk\hadoop-trunk\hadoop-yarn-project\hadoop-yarn\hadoop-yarn-api\src\main\java\org\apache\hadoop\yarn\server\api\protocolrecords\RefreshQueuesRequest.java,10,1,1,1,0,3
hadoop-trunk\hadoop-trunk\hadoop-hdfs-project\hadoop-hdfs\src\main\java\org\apache\hadoop\hdfs\server\datanode\fsdataset\impl\NativePmemMappableBlockLoader.java,165,27,2,1,0,30
hadoop-trunk\hadoop-trunk\hadoop-common-project\hadoop-common\src\main\java\org\apache\hadoop\io\retry\RetryInvocationHandler.java,422,101,11,2,0,114
hadoop-trunk\hadoop-trunk\hadoop-hdfs-project\hadoop-hdfs\src\main\java\org\apache\hadoop\hdfs\server\blockmanagement\BlockManagerSafeMode.java,0,74,15,11,0,100
hadoop-trunk\hadoop-trunk\hadoop-hdfs-project\hadoop-hdfs-nfs\src\main\java\org\apache\hadoop\hdfs\nfs\nfs3\Nfs3.java,47,22,0,1,0,23
hadoop-trunk\hadoop-trunk\hadoop-hdfs-project\hadoop-hdfs\src\main\java\org\apache\hadoop\hdfs\server\namenode\sps\FileCollector.java,0,1,0,1,0,2
hadoop-trunk\hadoop-trunk\hadoop-yarn-project\hadoop-yarn\hadoop-yarn-common\src\main\java\org\apache\hadoop\yarn\util\resource\Resources.java,522,197,14,3,0,214
hadoop-trunk\hadoop-trunk\hadoop-yarn-project\hadoop-yarn\hadoop-yarn-server\hadoop-yarn-server-nodemanager\src\main\java\org\apache\hadoop\yarn\server\nodemanager\containermanager\linux\resources\numa\package-info.java,0,0,0,2,0,2
hadoop-trunk\hadoop-trunk\hadoop-yarn-project\hadoop-yarn\hadoop-yarn-common\src\main\java\org\apache\hadoop\yarn\nodelabels\event\NodeLabelsStoreEvent.java,6,4,0,1,0,5
hadoop-trunk\hadoop-trunk\hadoop-yarn-project\hadoop-yarn\hadoop-yarn-server\hadoop-yarn-server-resourcemanager\src\main\java\org\apache\hadoop\yarn\server\resourcemanager\placement\csmappingrule\MappingRuleValidationContextImpl.java,0,29,2,7,0,38
hadoop-trunk\hadoop-trunk\hadoop-yarn-project\hadoop-yarn\hadoop-yarn-server\hadoop-yarn-server-resourcemanager\src\main\java\org\apache\hadoop\yarn\server\resourcemanager\scheduler\constraint\processor\AbstractPlacementProcessor.java,53,21,2,8,0,31
hadoop-trunk\hadoop-trunk\hadoop-tools\hadoop-azure\src\test\java\org\apache\hadoop\fs\azurebfs\ITestAzureBlobFileSystemAppend.java,58,12,0,1,0,13
hadoop-trunk\hadoop-trunk\hadoop-yarn-project\hadoop-yarn\hadoop-yarn-server\hadoop-yarn-server-nodemanager\src\main\java\org\apache\hadoop\yarn\server\nodemanager\containermanager\localizer\event\ResourceEventType.java,0,7,0,3,0,10
hadoop-trunk\hadoop-trunk\hadoop-hdfs-project\hadoop-hdfs\src\main\java\org\apache\hadoop\hdfs\server\datanode\fsdataset\impl\ReplicaCachingGetSpaceUsed.java,60,8,4,1,0,13
hadoop-trunk\hadoop-trunk\hadoop-yarn-project\hadoop-yarn\hadoop-yarn-common\src\main\java\org\apache\hadoop\yarn\api\impl\pb\service\CsiAdaptorProtocolPBServiceImpl.java,68,15,14,10,0,39
hadoop-trunk\hadoop-trunk\hadoop-common-project\hadoop-registry\src\test\java\org\apache\hadoop\registry\client\binding\TestRegistryOperationUtils.java,30,4,0,1,0,5
hadoop-trunk\hadoop-trunk\hadoop-tools\hadoop-rumen\src\main\java\org\apache\hadoop\tools\rumen\RewindableInputStream.java,52,19,0,1,0,20
hadoop-trunk\hadoop-trunk\hadoop-tools\hadoop-azure\src\test\java\org\apache\hadoop\fs\azurebfs\TestAbfsStatistics.java,32,3,1,2,0,6
hadoop-trunk\hadoop-trunk\hadoop-common-project\hadoop-common\src\main\java\org\apache\hadoop\fs\shell\MoveCommands.java,0,36,1,3,0,40
hadoop-trunk\hadoop-trunk\hadoop-yarn-project\hadoop-yarn\hadoop-yarn-api\src\main\java\org\apache\hadoop\yarn\api\records\ResourceSizing.java,61,17,1,2,0,20
hadoop-trunk\hadoop-trunk\hadoop-common-project\hadoop-common\src\main\java\org\apache\hadoop\util\LightWeightResizableGSet.java,0,24,1,1,0,26
hadoop-trunk\hadoop-trunk\hadoop-common-project\hadoop-common\src\main\java\org\apache\hadoop\ipc\RpcInvocationHandler.java,0,1,0,1,0,2
hadoop-trunk\hadoop-trunk\hadoop-yarn-project\hadoop-yarn\hadoop-yarn-server\hadoop-yarn-server-resourcemanager\src\test\java\org\apache\hadoop\yarn\server\resourcemanager\ACLsTestBase.java,87,29,3,1,0,33
hadoop-trunk\hadoop-trunk\hadoop-mapreduce-project\hadoop-mapreduce-client\hadoop-mapreduce-client-core\src\main\java\org\apache\hadoop\mapred\join\CompositeInputSplit.java,116,23,2,1,0,26
hadoop-trunk\hadoop-trunk\hadoop-hdfs-project\hadoop-hdfs\src\test\java\org\apache\hadoop\hdfs\server\namenode\ha\TestPipelinesFailover.java,553,155,10,11,0,176
hadoop-trunk\hadoop-trunk\hadoop-tools\hadoop-dynamometer\hadoop-dynamometer-workload\src\main\java\org\apache\hadoop\tools\dynamometer\workloadgenerator\audit\AuditReplayThread.java,270,22,10,7,0,39
hadoop-trunk\hadoop-trunk\hadoop-mapreduce-project\hadoop-mapreduce-client\hadoop-mapreduce-client-core\src\main\java\org\apache\hadoop\mapreduce\jobhistory\HumanReadableHistoryViewerPrinter.java,0,68,4,1,0,73
hadoop-trunk\hadoop-trunk\hadoop-common-project\hadoop-common\src\main\java\org\apache\hadoop\fs\StorageStatistics.java,140,46,29,1,0,76
hadoop-trunk\hadoop-trunk\hadoop-yarn-project\hadoop-yarn\hadoop-yarn-server\hadoop-yarn-server-sharedcachemanager\src\main\java\org\apache\hadoop\yarn\server\sharedcachemanager\SCMAdminProtocolService.java,95,24,3,4,0,31
hadoop-trunk\hadoop-trunk\hadoop-common-project\hadoop-common\src\main\java\org\apache\hadoop\io\ByteBufferPool.java,0,1,0,1,0,2
hadoop-trunk\hadoop-trunk\hadoop-tools\hadoop-streaming\src\main\java\org\apache\hadoop\streaming\PipeReducer.java,124,39,12,5,0,56
hadoop-trunk\hadoop-trunk\hadoop-mapreduce-project\hadoop-mapreduce-client\hadoop-mapreduce-client-app\src\test\java\org\apache\hadoop\mapreduce\v2\app\TestFail.java,273,70,6,4,0,80
hadoop-trunk\hadoop-trunk\hadoop-tools\hadoop-azure\src\test\java\org\apache\hadoop\fs\azurebfs\AbstractAbfsScaleTest.java,28,5,1,2,0,8
hadoop-trunk\hadoop-trunk\hadoop-yarn-project\hadoop-yarn\hadoop-yarn-common\src\main\java\org\apache\hadoop\yarn\security\YarnAuthorizationProvider.java,80,11,2,3,0,16
hadoop-trunk\hadoop-trunk\hadoop-yarn-project\hadoop-yarn\hadoop-yarn-server\hadoop-yarn-server-resourcemanager\src\main\java\org\apache\hadoop\yarn\server\resourcemanager\scheduler\capacity\policy\PriorityUtilizationQueueOrderingPolicy.java,0,51,2,4,0,57
hadoop-trunk\hadoop-trunk\hadoop-yarn-project\hadoop-yarn\hadoop-yarn-server\hadoop-yarn-server-applicationhistoryservice\src\test\java\org\apache\hadoop\yarn\server\timeline\TestRollingLevelDB.java,70,12,1,1,0,14
hadoop-trunk\hadoop-trunk\hadoop-hdfs-project\hadoop-hdfs-rbf\src\test\java\org\apache\hadoop\fs\contract\router\web\TestRouterWebHDFSContractRename.java,0,4,0,1,0,5
hadoop-trunk\hadoop-trunk\hadoop-tools\hadoop-azure\src\main\java\org\apache\hadoop\fs\azurebfs\constants\ConfigurationKeys.java,0,152,0,101,0,253
hadoop-trunk\hadoop-trunk\hadoop-yarn-project\hadoop-yarn\hadoop-yarn-server\hadoop-yarn-server-resourcemanager\src\main\java\org\apache\hadoop\yarn\server\resourcemanager\rmapp\attempt\AMLivelinessMonitor.java,29,17,1,2,0,20
hadoop-trunk\hadoop-trunk\hadoop-mapreduce-project\hadoop-mapreduce-client\hadoop-mapreduce-client-core\src\main\java\org\apache\hadoop\mapred\JobStatus.java,0,247,18,1,0,266
hadoop-trunk\hadoop-trunk\hadoop-yarn-project\hadoop-yarn\hadoop-yarn-api\src\main\java\org\apache\hadoop\yarn\server\api\protocolrecords\RefreshUserToGroupsMappingsRequest.java,10,1,1,1,0,3
hadoop-trunk\hadoop-trunk\hadoop-mapreduce-project\hadoop-mapreduce-client\hadoop-mapreduce-client-core\src\main\java\org\apache\hadoop\mapreduce\lib\partition\HashPartitioner.java,0,9,0,1,0,10
hadoop-trunk\hadoop-trunk\hadoop-yarn-project\hadoop-yarn\hadoop-yarn-server\hadoop-yarn-server-common\src\main\java\org\apache\hadoop\yarn\server\federation\store\FederationMembershipStateStore.java,0,0,0,11,0,11
hadoop-trunk\hadoop-trunk\hadoop-yarn-project\hadoop-yarn\hadoop-yarn-server\hadoop-yarn-server-resourcemanager\src\main\java\org\apache\hadoop\yarn\server\resourcemanager\scheduler\capacity\AppPriorityACLConfigurationParser.java,183,22,5,1,0,28
hadoop-trunk\hadoop-trunk\hadoop-hdfs-project\hadoop-hdfs\src\main\java\org\apache\hadoop\hdfs\tools\ECAdmin.java,617,71,15,1,0,87
hadoop-trunk\hadoop-trunk\hadoop-hdfs-project\hadoop-hdfs\src\test\java\org\apache\hadoop\hdfs\TestReconstructStripedFile.java,767,146,13,6,0,165
hadoop-trunk\hadoop-trunk\hadoop-yarn-project\hadoop-yarn\hadoop-yarn-server\hadoop-yarn-server-timelineservice-documentstore\src\main\java\org\apache\hadoop\yarn\server\timelineservice\documentstore\collection\document\flowrun\FlowRunDocument.java,208,86,4,6,0,96
hadoop-trunk\hadoop-trunk\hadoop-yarn-project\hadoop-yarn\hadoop-yarn-server\hadoop-yarn-server-resourcemanager\src\main\java\org\apache\hadoop\yarn\server\resourcemanager\ResourceTrackerService.java,968,109,30,19,0,158
hadoop-trunk\hadoop-trunk\hadoop-yarn-project\hadoop-yarn\hadoop-yarn-common\src\main\java\org\apache\hadoop\yarn\api\impl\pb\service\ClientSCMProtocolPBServiceImpl.java,40,9,13,11,0,33
hadoop-trunk\hadoop-trunk\hadoop-yarn-project\hadoop-yarn\hadoop-yarn-server\hadoop-yarn-server-resourcemanager\src\main\java\org\apache\hadoop\yarn\server\resourcemanager\webapp\dao\ReservationInfo.java,70,22,0,2,0,24
hadoop-trunk\hadoop-trunk\hadoop-common-project\hadoop-registry\src\main\java\org\apache\hadoop\registry\server\dns\ZoneSelector.java,0,0,0,1,0,1
hadoop-trunk\hadoop-trunk\hadoop-mapreduce-project\hadoop-mapreduce-client\hadoop-mapreduce-client-core\src\main\java\org\apache\hadoop\mapred\lib\FieldSelectionMapReduce.java,0,48,3,7,0,58
hadoop-trunk\hadoop-trunk\hadoop-hdfs-project\hadoop-hdfs-rbf\src\main\java\org\apache\hadoop\hdfs\server\federation\store\protocol\GetRouterRegistrationsResponse.java,25,6,0,2,0,8
hadoop-trunk\hadoop-trunk\hadoop-yarn-project\hadoop-yarn\hadoop-yarn-common\src\main\java\org\apache\hadoop\yarn\api\protocolrecords\impl\pb\ValidateVolumeCapabilitiesRequestPBImpl.java,90,18,30,2,0,50
hadoop-trunk\hadoop-trunk\hadoop-tools\hadoop-aws\src\main\java\org\apache\hadoop\fs\s3a\commit\files\SinglePendingCommit.java,0,79,4,2,0,85
hadoop-trunk\hadoop-trunk\hadoop-hdfs-project\hadoop-hdfs\src\main\java\org\apache\hadoop\hdfs\server\datanode\metrics\OutlierDetector.java,145,28,6,1,0,35
hadoop-trunk\hadoop-trunk\hadoop-hdfs-project\hadoop-hdfs\src\test\java\org\apache\hadoop\hdfs\server\datanode\TestTransferRbw.java,110,38,12,8,0,58
hadoop-trunk\hadoop-trunk\hadoop-tools\hadoop-azure\src\main\java\org\apache\hadoop\fs\azurebfs\security\package-info.java,0,0,0,1,0,1
hadoop-trunk\hadoop-trunk\hadoop-hdfs-project\hadoop-hdfs\src\main\java\org\apache\hadoop\hdfs\server\common\JspHelper.java,189,47,4,8,0,59
hadoop-trunk\hadoop-trunk\hadoop-hdfs-project\hadoop-hdfs\src\main\java\org\apache\hadoop\hdfs\server\blockmanagement\BlockUnderConstructionFeature.java,316,54,2,2,0,58
hadoop-trunk\hadoop-trunk\hadoop-yarn-project\hadoop-yarn\hadoop-yarn-common\src\main\java\org\apache\hadoop\yarn\util\TrackingUriPlugin.java,13,1,0,1,0,2
hadoop-trunk\hadoop-trunk\hadoop-hdfs-project\hadoop-hdfs-client\src\main\java\org\apache\hadoop\hdfs\server\namenode\ha\ClientHAProxyFactory.java,29,18,0,1,0,19
hadoop-trunk\hadoop-trunk\hadoop-common-project\hadoop-common\src\main\java\org\apache\hadoop\io\compress\CompressionCodecFactory.java,321,40,5,1,0,46
hadoop-trunk\hadoop-trunk\hadoop-tools\hadoop-aws\src\main\java\org\apache\hadoop\fs\s3a\statistics\CommitterStatistics.java,0,0,0,1,0,1
hadoop-trunk\hadoop-trunk\hadoop-common-project\hadoop-nfs\src\test\java\org\apache\hadoop\nfs\TestNfsExports.java,205,49,12,2,0,63
hadoop-trunk\hadoop-trunk\hadoop-mapreduce-project\hadoop-mapreduce-client\hadoop-mapreduce-client-jobclient\src\test\java\org\apache\hadoop\mapreduce\filecache\TestURIFragments.java,0,10,43,1,0,54
hadoop-trunk\hadoop-trunk\hadoop-hdfs-project\hadoop-hdfs\src\main\java\org\apache\hadoop\hdfs\server\namenode\sps\BlockMoveTaskHandler.java,0,2,0,2,0,4
hadoop-trunk\hadoop-trunk\hadoop-hdfs-project\hadoop-hdfs-rbf\src\main\java\org\apache\hadoop\hdfs\server\federation\fairness\StaticRouterRpcFairnessPolicyController.java,100,13,2,5,0,20
hadoop-trunk\hadoop-trunk\hadoop-hdfs-project\hadoop-hdfs-rbf\src\main\java\org\apache\hadoop\hdfs\server\federation\router\ConnectionNullException.java,9,2,0,1,0,3
hadoop-trunk\hadoop-trunk\hadoop-tools\hadoop-azure\src\main\java\org\apache\hadoop\fs\azurebfs\contracts\annotations\ConfigurationValidationAnnotations.java,91,25,0,1,0,26
hadoop-trunk\hadoop-trunk\hadoop-common-project\hadoop-common\src\main\java\org\apache\hadoop\fs\audit\AuditStatisticNames.java,0,0,0,1,0,1
hadoop-trunk\hadoop-trunk\hadoop-hdfs-project\hadoop-hdfs\src\test\java\org\apache\hadoop\hdfs\qjournal\client\DirectExecutorService.java,121,40,0,1,0,41
hadoop-trunk\hadoop-trunk\hadoop-yarn-project\hadoop-yarn\hadoop-yarn-server\hadoop-yarn-server-nodemanager\src\main\java\org\apache\hadoop\yarn\server\nodemanager\timelineservice\package-info.java,0,0,0,1,0,1
hadoop-trunk\hadoop-trunk\hadoop-common-project\hadoop-common\src\test\java\org\apache\hadoop\io\TestBloomMapFile.java,302,38,7,1,0,46
hadoop-trunk\hadoop-trunk\hadoop-tools\hadoop-aws\src\test\java\org\apache\hadoop\fs\s3a\ITestS3AFileOperationCost.java,419,33,6,1,0,40
hadoop-trunk\hadoop-trunk\hadoop-common-project\hadoop-common\src\main\java\org\apache\hadoop\net\unix\DomainSocket.java,581,95,5,3,0,103
hadoop-trunk\hadoop-trunk\hadoop-hdfs-project\hadoop-hdfs\src\test\java\org\apache\hadoop\hdfs\server\datanode\fsdataset\impl\FsDatasetTestUtil.java,85,31,5,3,0,39
hadoop-trunk\hadoop-trunk\hadoop-hdfs-project\hadoop-hdfs-client\src\main\java\org\apache\hadoop\hdfs\protocol\ReplicatedBlockStats.java,0,45,0,1,0,46
hadoop-trunk\hadoop-trunk\hadoop-mapreduce-project\hadoop-mapreduce-client\hadoop-mapreduce-client-core\src\main\java\org\apache\hadoop\mapreduce\task\MapContextImpl.java,0,30,4,1,0,35
hadoop-trunk\hadoop-trunk\hadoop-mapreduce-project\hadoop-mapreduce-client\hadoop-mapreduce-client-nativetask\src\main\java\org\apache\hadoop\mapred\nativetask\serde\SerializationFramework.java,0,6,1,1,0,8
hadoop-trunk\hadoop-trunk\hadoop-common-project\hadoop-common\src\main\java\org\apache\hadoop\fs\GlobPattern.java,140,14,1,1,0,16
hadoop-trunk\hadoop-trunk\hadoop-common-project\hadoop-common\src\main\java\org\apache\hadoop\net\StandardSocketFactory.java,82,29,4,1,0,34
hadoop-trunk\hadoop-trunk\hadoop-mapreduce-project\hadoop-mapreduce-client\hadoop-mapreduce-client-hs\src\main\java\org\apache\hadoop\mapreduce\v2\hs\PartialJob.java,0,57,6,4,0,67
hadoop-trunk\hadoop-trunk\hadoop-common-project\hadoop-common\src\main\java\org\apache\hadoop\ipc\RefreshCallQueueProtocol.java,0,9,1,2,0,12
hadoop-trunk\hadoop-trunk\hadoop-yarn-project\hadoop-yarn\hadoop-yarn-common\src\main\java\org\apache\hadoop\yarn\api\protocolrecords\impl\pb\RestartContainerResponsePBImpl.java,43,17,17,2,0,36
hadoop-trunk\hadoop-trunk\hadoop-yarn-project\hadoop-yarn\hadoop-yarn-server\hadoop-yarn-server-resourcemanager\src\test\java\org\apache\hadoop\yarn\server\resourcemanager\scheduler\capacity\TestParentQueue.java,1167,514,62,38,0,614
hadoop-trunk\hadoop-trunk\hadoop-yarn-project\hadoop-yarn\hadoop-yarn-common\src\main\java\org\apache\hadoop\yarn\server\api\protocolrecords\impl\pb\RefreshClusterMaxPriorityRequestPBImpl.java,44,23,18,3,0,44
hadoop-trunk\hadoop-trunk\hadoop-hdfs-project\hadoop-hdfs\src\test\java\org\apache\hadoop\hdfs\server\namenode\sps\TestBlockStorageMovementAttemptedItems.java,174,28,11,2,0,41
hadoop-trunk\hadoop-trunk\hadoop-common-project\hadoop-kms\src\test\java\org\apache\hadoop\crypto\key\kms\server\KMSBenchmark.java,0,105,27,2,0,134
hadoop-trunk\hadoop-trunk\hadoop-tools\hadoop-azure\src\test\java\org\apache\hadoop\fs\azurebfs\utils\TestCachedSASToken.java,0,8,8,3,0,19
hadoop-trunk\hadoop-trunk\hadoop-yarn-project\hadoop-yarn\hadoop-yarn-server\hadoop-yarn-server-resourcemanager\src\main\java\org\apache\hadoop\yarn\server\resourcemanager\scheduler\fair\FairSchedulerUtilities.java,0,5,0,1,0,6
hadoop-trunk\hadoop-trunk\hadoop-hdfs-project\hadoop-hdfs\src\main\java\org\apache\hadoop\hdfs\server\protocol\BlockRecoveryCommand.java,127,46,0,1,0,47
hadoop-trunk\hadoop-trunk\hadoop-mapreduce-project\hadoop-mapreduce-client\hadoop-mapreduce-client-app\src\main\java\org\apache\hadoop\mapreduce\v2\app\webapp\JobsBlock.java,53,12,0,3,0,15
hadoop-trunk\hadoop-trunk\hadoop-tools\hadoop-azure\src\test\java\org\apache\hadoop\fs\azurebfs\services\ITestAbfsPositionedRead.java,197,26,1,4,0,31
hadoop-trunk\hadoop-trunk\hadoop-yarn-project\hadoop-yarn\hadoop-yarn-server\hadoop-yarn-server-resourcemanager\src\main\java\org\apache\hadoop\yarn\server\resourcemanager\scheduler\ResourceLimits.java,82,44,3,1,0,48
hadoop-trunk\hadoop-trunk\hadoop-hdfs-project\hadoop-hdfs-nfs\src\main\java\org\apache\hadoop\hdfs\nfs\nfs3\WriteCtx.java,0,78,4,1,0,83
hadoop-trunk\hadoop-trunk\hadoop-yarn-project\hadoop-yarn\hadoop-yarn-server\hadoop-yarn-server-timelineservice-documentstore\src\main\java\org\apache\hadoop\yarn\server\timelineservice\documentstore\lib\DocumentStoreFactory.java,0,5,2,8,0,15
hadoop-trunk\hadoop-trunk\hadoop-cloud-storage-project\hadoop-cos\src\test\java\org\apache\hadoop\fs\cosn\contract\TestCosNContractMkdir.java,7,2,0,1,0,3
hadoop-trunk\hadoop-trunk\hadoop-yarn-project\hadoop-yarn\hadoop-yarn-server\hadoop-yarn-server-router\src\test\java\org\apache\hadoop\yarn\server\router\webapp\TestFederationInterceptorRESTRetry.java,0,19,1,10,0,30
hadoop-trunk\hadoop-trunk\hadoop-common-project\hadoop-common\src\main\java\org\apache\hadoop\io\file\tfile\CompareUtils.java,0,32,4,2,0,38
hadoop-trunk\hadoop-trunk\hadoop-yarn-project\hadoop-yarn\hadoop-yarn-server\hadoop-yarn-server-resourcemanager\src\test\java\org\apache\hadoop\yarn\server\resourcemanager\scheduler\capacity\TestQueueConfigurationAutoRefreshPolicy.java,270,39,0,1,0,40
hadoop-trunk\hadoop-trunk\hadoop-yarn-project\hadoop-yarn\hadoop-yarn-server\hadoop-yarn-server-resourcemanager\src\main\java\org\apache\hadoop\yarn\server\resourcemanager\webapp\RMAppsBlock.java,186,13,3,2,0,18
hadoop-trunk\hadoop-trunk\hadoop-tools\hadoop-aws\src\main\java\org\apache\hadoop\fs\s3a\AnonymousAWSCredentialsProvider.java,18,7,1,1,0,9
hadoop-trunk\hadoop-trunk\hadoop-common-project\hadoop-common\src\test\java\org\apache\hadoop\security\NetUtilsTestResolver.java,53,26,6,2,0,34
hadoop-trunk\hadoop-trunk\hadoop-tools\hadoop-aws\src\main\java\org\apache\hadoop\fs\s3a\s3guard\S3GuardTool.java,917,128,13,12,0,153
hadoop-trunk\hadoop-trunk\hadoop-mapreduce-project\hadoop-mapreduce-client\hadoop-mapreduce-client-jobclient\src\test\java\org\apache\hadoop\FailingMapper.java,0,13,0,1,0,14
hadoop-trunk\hadoop-trunk\hadoop-maven-plugins\src\main\java\org\apache\hadoop\maven\plugin\resourcegz\ResourceGzMojo.java,90,15,2,1,0,18
hadoop-trunk\hadoop-trunk\hadoop-mapreduce-project\hadoop-mapreduce-client\hadoop-mapreduce-client-core\src\main\java\org\apache\hadoop\mapred\TaskLog.java,598,181,9,2,0,192
hadoop-trunk\hadoop-trunk\hadoop-hdfs-project\hadoop-hdfs\src\test\java\org\apache\hadoop\hdfs\server\datanode\TestDataNodeErasureCodingMetrics.java,189,38,7,1,0,46
hadoop-trunk\hadoop-trunk\hadoop-yarn-project\hadoop-yarn\hadoop-yarn-api\src\main\java\org\apache\hadoop\yarn\exceptions\ResourceNotFoundException.java,30,10,0,1,0,11
hadoop-trunk\hadoop-trunk\hadoop-yarn-project\hadoop-yarn\hadoop-yarn-server\hadoop-yarn-server-nodemanager\src\test\java\org\apache\hadoop\yarn\server\nodemanager\webapp\TestNMWebServicesContainers.java,481,70,13,8,0,91
hadoop-trunk\hadoop-trunk\hadoop-hdfs-project\hadoop-hdfs\src\main\java\org\apache\hadoop\hdfs\server\protocol\StorageBlockReport.java,18,13,0,1,0,14
hadoop-trunk\hadoop-trunk\hadoop-hdfs-project\hadoop-hdfs-rbf\src\test\java\org\apache\hadoop\hdfs\server\federation\security\token\TestZKDelegationTokenSecretManagerImpl.java,0,23,8,8,0,39
hadoop-trunk\hadoop-trunk\hadoop-yarn-project\hadoop-yarn\hadoop-yarn-server\hadoop-yarn-server-timelineservice-hbase\hadoop-yarn-server-timelineservice-hbase-common\src\main\java\org\apache\hadoop\yarn\server\timelineservice\storage\subapplication\SubApplicationRowKey.java,261,47,1,3,0,51
hadoop-trunk\hadoop-trunk\hadoop-yarn-project\hadoop-yarn\hadoop-yarn-server\hadoop-yarn-server-common\src\main\java\org\apache\hadoop\yarn\server\federation\policies\amrmproxy\LocalityMulticastAMRMProxyPolicy.java,633,96,22,6,0,124
hadoop-trunk\hadoop-trunk\hadoop-common-project\hadoop-common\src\test\java\org\apache\hadoop\io\compress\TestCompressorStream.java,50,17,0,1,0,18
hadoop-trunk\hadoop-trunk\hadoop-yarn-project\hadoop-yarn\hadoop-yarn-server\hadoop-yarn-server-resourcemanager\src\main\java\org\apache\hadoop\yarn\server\resourcemanager\scheduler\constraint\api\ConstraintPlacementAlgorithmOutput.java,27,12,0,1,0,13
hadoop-trunk\hadoop-trunk\hadoop-yarn-project\hadoop-yarn\hadoop-yarn-server\hadoop-yarn-server-resourcemanager\src\main\java\org\apache\hadoop\yarn\server\resourcemanager\scheduler\capacity\CSAMContainerLaunchDiagnosticsConstants.java,0,9,7,1,0,17
hadoop-trunk\hadoop-trunk\hadoop-hdfs-project\hadoop-hdfs-rbf\src\test\java\org\apache\hadoop\fs\contract\router\TestRouterHDFSContractSeekSecure.java,19,5,0,1,0,6
hadoop-trunk\hadoop-trunk\hadoop-yarn-project\hadoop-yarn\hadoop-yarn-server\hadoop-yarn-server-timelineservice-hbase-tests\src\test\java\org\apache\hadoop\yarn\server\timelineservice\storage\TestHBaseTimelineStorageApps.java,0,241,48,26,0,315
hadoop-trunk\hadoop-trunk\hadoop-tools\hadoop-rumen\src\main\java\org\apache\hadoop\tools\rumen\ZombieCluster.java,117,31,1,6,0,38
hadoop-trunk\hadoop-trunk\hadoop-mapreduce-project\hadoop-mapreduce-client\hadoop-mapreduce-client-nativetask\src\test\java\org\apache\hadoop\mapred\nativetask\handlers\TestNativeCollectorOnlyHandler.java,90,20,0,5,0,25
hadoop-trunk\hadoop-trunk\hadoop-yarn-project\hadoop-yarn\hadoop-yarn-api\src\main\java\org\apache\hadoop\yarn\api\resource\PlacementConstraints.java,0,52,1,4,0,57
hadoop-trunk\hadoop-trunk\hadoop-yarn-project\hadoop-yarn\hadoop-yarn-server\hadoop-yarn-server-resourcemanager\src\test\java\org\apache\hadoop\yarn\server\resourcemanager\scheduler\capacity\TestWorkPreservingRMRestartForNodeLabel.java,249,51,1,12,0,64
hadoop-trunk\hadoop-trunk\hadoop-yarn-project\hadoop-yarn\hadoop-yarn-server\hadoop-yarn-server-common\src\main\java\org\apache\hadoop\yarn\server\federation\policies\amrmproxy\package-info.java,0,0,0,1,0,1
hadoop-trunk\hadoop-trunk\hadoop-yarn-project\hadoop-yarn\hadoop-yarn-common\src\main\java\org\apache\hadoop\yarn\api\protocolrecords\impl\pb\StopContainersResponsePBImpl.java,193,36,64,5,0,105
hadoop-trunk\hadoop-trunk\hadoop-mapreduce-project\hadoop-mapreduce-client\hadoop-mapreduce-client-jobclient\src\test\java\org\apache\hadoop\mapreduce\v2\TestMiniMRProxyUser.java,0,23,11,9,0,43
hadoop-trunk\hadoop-trunk\hadoop-hdfs-project\hadoop-hdfs-client\src\main\java\org\apache\hadoop\hdfs\security\token\delegation\DelegationTokenSelector.java,0,7,0,2,0,9
hadoop-trunk\hadoop-trunk\hadoop-mapreduce-project\hadoop-mapreduce-client\hadoop-mapreduce-client-common\src\test\java\org\apache\hadoop\mapred\TestLocalDistributedCacheManager.java,284,80,4,11,0,95
hadoop-trunk\hadoop-trunk\hadoop-tools\hadoop-aws\src\main\java\org\apache\hadoop\fs\s3a\RemoteFileChangedException.java,44,8,1,1,0,10
hadoop-trunk\hadoop-trunk\hadoop-hdfs-project\hadoop-hdfs\dev-support\jdiff\Null.java,4,2,3,1,0,6
hadoop-trunk\hadoop-trunk\hadoop-mapreduce-project\hadoop-mapreduce-client\hadoop-mapreduce-client-jobclient\src\test\java\org\apache\hadoop\mapreduce\lib\db\TestTextSplitter.java,0,36,0,11,0,47
hadoop-trunk\hadoop-trunk\hadoop-mapreduce-project\hadoop-mapreduce-client\hadoop-mapreduce-client-core\src\main\java\org\apache\hadoop\mapreduce\lib\db\OracleDataDrivenDBRecordReader.java,0,16,4,2,0,22
hadoop-trunk\hadoop-trunk\hadoop-mapreduce-project\hadoop-mapreduce-client\hadoop-mapreduce-client-core\src\main\java\org\apache\hadoop\mapreduce\lib\input\LineRecordReader.java,0,55,9,1,0,65
hadoop-trunk\hadoop-trunk\hadoop-yarn-project\hadoop-yarn\hadoop-yarn-common\src\main\java\org\apache\hadoop\yarn\api\protocolrecords\impl\pb\GetClusterNodeLabelsResponsePBImpl.java,147,25,42,3,0,70
hadoop-trunk\hadoop-trunk\hadoop-yarn-project\hadoop-yarn\hadoop-yarn-common\src\main\java\org\apache\hadoop\yarn\state\package-info.java,0,1,0,1,0,2
hadoop-trunk\hadoop-trunk\hadoop-yarn-project\hadoop-yarn\hadoop-yarn-applications\hadoop-yarn-services\hadoop-yarn-services-core\src\main\java\org\apache\hadoop\yarn\service\api\records\Configuration.java,180,73,2,5,0,80
hadoop-trunk\hadoop-trunk\hadoop-common-project\hadoop-common\src\test\java\org\apache\hadoop\log\TestLogThrottlingHelper.java,145,44,0,1,0,45
hadoop-trunk\hadoop-trunk\hadoop-yarn-project\hadoop-yarn\hadoop-yarn-server\hadoop-yarn-server-nodemanager\src\main\java\org\apache\hadoop\yarn\server\nodemanager\nodelabels\ConfigurationNodeAttributesProvider.java,0,12,2,1,0,15
hadoop-trunk\hadoop-trunk\hadoop-yarn-project\hadoop-yarn\hadoop-yarn-server\hadoop-yarn-server-resourcemanager\src\test\java\org\apache\hadoop\yarn\server\resourcemanager\TestRMProxyUsersConf.java,73,17,2,4,0,23
hadoop-trunk\hadoop-trunk\hadoop-tools\hadoop-openstack\src\main\java\org\apache\hadoop\fs\swift\snative\SwiftNativeInputStream.java,0,44,8,3,0,55
hadoop-trunk\hadoop-trunk\hadoop-yarn-project\hadoop-yarn\hadoop-yarn-client\src\main\java\org\apache\hadoop\yarn\client\cli\NodeAttributesCLI.java,647,101,16,5,0,122
hadoop-trunk\hadoop-trunk\hadoop-hdfs-project\hadoop-hdfs-client\src\main\java\org\apache\hadoop\hdfs\server\namenode\SafeModeException.java,7,2,0,1,0,3
hadoop-trunk\hadoop-trunk\hadoop-tools\hadoop-azure\src\test\java\org\apache\hadoop\fs\azurebfs\package-info.java,0,2,0,1,0,3
hadoop-trunk\hadoop-trunk\hadoop-common-project\hadoop-auth\src\main\java\org\apache\hadoop\util\PlatformName.java,27,5,1,2,0,8
hadoop-trunk\hadoop-trunk\hadoop-common-project\hadoop-common\src\main\java\org\apache\hadoop\io\WritableName.java,52,26,6,2,0,34
hadoop-trunk\hadoop-trunk\hadoop-hdfs-project\hadoop-hdfs\src\test\java\org\apache\hadoop\hdfs\server\datanode\fsdataset\impl\LazyPersistTestCase.java,649,118,7,3,0,128
hadoop-trunk\hadoop-trunk\hadoop-tools\hadoop-openstack\src\test\java\org\apache\hadoop\fs\swift\contract\TestSwiftContractCreate.java,13,4,0,2,0,6
hadoop-trunk\hadoop-trunk\hadoop-hdfs-project\hadoop-hdfs\src\test\java\org\apache\hadoop\hdfs\TestDFSStripedOutputStreamWithFailure.java,261,25,9,1,0,35
hadoop-trunk\hadoop-trunk\hadoop-hdfs-project\hadoop-hdfs-rbf\src\main\java\org\apache\hadoop\hdfs\server\federation\store\protocol\RefreshMountTableEntriesRequest.java,9,2,0,2,0,4
hadoop-trunk\hadoop-trunk\hadoop-mapreduce-project\hadoop-mapreduce-client\hadoop-mapreduce-client-common\src\main\java\org\apache\hadoop\mapred\LocalJobRunner.java,976,327,74,17,0,418
hadoop-trunk\hadoop-trunk\hadoop-yarn-project\hadoop-yarn\hadoop-yarn-server\hadoop-yarn-server-timelineservice-hbase\hadoop-yarn-server-timelineservice-hbase-client\src\main\java\org\apache\hadoop\yarn\server\timelineservice\storage\package-info.java,0,0,0,1,0,1
hadoop-trunk\hadoop-trunk\hadoop-yarn-project\hadoop-yarn\hadoop-yarn-server\hadoop-yarn-server-resourcemanager\src\test\java\org\apache\hadoop\yarn\server\resourcemanager\scheduler\capacity\TestQueueCapacityVector.java,77,27,0,11,0,38
hadoop-trunk\hadoop-trunk\hadoop-hdfs-project\hadoop-hdfs-rbf\src\test\java\org\apache\hadoop\hdfs\server\federation\store\records\TestMountTable.java,235,23,0,2,0,25
hadoop-trunk\hadoop-trunk\hadoop-yarn-project\hadoop-yarn\hadoop-yarn-applications\hadoop-yarn-services\hadoop-yarn-services-api\src\main\java\org\apache\hadoop\yarn\service\client\SystemServiceManagerImpl.java,0,45,14,1,0,60
hadoop-trunk\hadoop-trunk\hadoop-common-project\hadoop-common\src\main\java\org\apache\hadoop\http\ProfileServlet.java,307,81,5,34,0,120
hadoop-trunk\hadoop-trunk\hadoop-hdfs-project\hadoop-hdfs-client\src\main\java\org\apache\hadoop\hdfs\web\resources\UnmaskedPermissionParam.java,28,6,1,1,0,8
hadoop-trunk\hadoop-trunk\hadoop-tools\hadoop-azure\src\test\java\org\apache\hadoop\fs\azurebfs\ITestAbfsNetworkStatistics.java,286,21,9,16,0,46
hadoop-trunk\hadoop-trunk\hadoop-hdfs-project\hadoop-hdfs-rbf\src\test\java\org\apache\hadoop\hdfs\server\federation\security\MockDelegationTokenSecretManager.java,0,13,1,3,0,17
hadoop-trunk\hadoop-trunk\hadoop-yarn-project\hadoop-yarn\hadoop-yarn-server\hadoop-yarn-server-resourcemanager\src\test\java\org\apache\hadoop\yarn\server\resourcemanager\scheduler\capacity\TestCapacitySchedulerAutoQueueCreation.java,0,123,41,20,0,184
hadoop-trunk\hadoop-trunk\hadoop-tools\hadoop-azure\src\main\java\org\apache\hadoop\fs\azure\SASKeyGeneratorInterface.java,0,1,0,1,0,2
hadoop-trunk\hadoop-trunk\hadoop-tools\hadoop-azure\src\test\java\org\apache\hadoop\fs\azurebfs\ITestAbfsMsiTokenProvider.java,0,5,2,7,0,14
hadoop-trunk\hadoop-trunk\hadoop-hdfs-project\hadoop-hdfs-rbf\src\main\java\org\apache\hadoop\hdfs\server\federation\store\driver\impl\StateStoreSerializableImpl.java,68,11,0,2,0,13
hadoop-trunk\hadoop-trunk\hadoop-yarn-project\hadoop-yarn\hadoop-yarn-server\hadoop-yarn-server-nodemanager\src\main\java\org\apache\hadoop\yarn\server\nodemanager\webapp\NavBlock.java,51,14,4,3,0,21
hadoop-trunk\hadoop-trunk\hadoop-yarn-project\hadoop-yarn\hadoop-yarn-server\hadoop-yarn-server-resourcemanager\src\main\java\org\apache\hadoop\yarn\server\resourcemanager\scheduler\event\NodeRemovedSchedulerEvent.java,15,6,0,1,0,7
hadoop-trunk\hadoop-trunk\hadoop-mapreduce-project\hadoop-mapreduce-client\hadoop-mapreduce-client-core\src\main\java\org\apache\hadoop\mapreduce\checkpoint\TaskCheckpointID.java,86,29,0,1,0,30
hadoop-trunk\hadoop-trunk\hadoop-common-project\hadoop-common\src\test\java\org\apache\hadoop\fs\viewfs\TestFcMainOperationsLocalFs.java,0,8,0,1,0,9
hadoop-trunk\hadoop-trunk\hadoop-yarn-project\hadoop-yarn\hadoop-yarn-server\hadoop-yarn-server-resourcemanager\src\test\java\org\apache\hadoop\yarn\server\resourcemanager\scheduler\constraint\TestPlacementConstraintManagerService.java,215,21,8,5,0,34
hadoop-trunk\hadoop-trunk\hadoop-common-project\hadoop-common\src\main\java\org\apache\hadoop\metrics2\sink\ganglia\GangliaSink30.java,209,36,5,5,0,46
hadoop-trunk\hadoop-trunk\hadoop-yarn-project\hadoop-yarn\hadoop-yarn-common\src\main\java\org\apache\hadoop\yarn\state\StateMachine.java,0,4,5,1,0,10
hadoop-trunk\hadoop-trunk\hadoop-common-project\hadoop-common\src\test\java\org\apache\hadoop\security\TestUserGroupInformation.java,0,268,27,11,0,306
hadoop-trunk\hadoop-trunk\hadoop-hdfs-project\hadoop-hdfs\src\main\java\org\apache\hadoop\hdfs\web\ParamFilter.java,51,14,0,2,0,16
hadoop-trunk\hadoop-trunk\hadoop-mapreduce-project\hadoop-mapreduce-client\hadoop-mapreduce-client-core\src\main\java\org\apache\hadoop\mapreduce\lib\output\PathOutputCommitterFactory.java,149,9,0,1,0,10
hadoop-trunk\hadoop-trunk\hadoop-hdfs-project\hadoop-hdfs\src\test\java\org\apache\hadoop\hdfs\TestRenameWhileOpen.java,294,82,12,5,0,99
hadoop-trunk\hadoop-trunk\hadoop-yarn-project\hadoop-yarn\hadoop-yarn-server\hadoop-yarn-server-nodemanager\src\main\java\org\apache\hadoop\yarn\server\nodemanager\containermanager\resourceplugin\gpu\GpuResourcePlugin.java,124,28,1,12,0,41
hadoop-trunk\hadoop-trunk\hadoop-hdfs-project\hadoop-hdfs-rbf\src\main\java\org\apache\hadoop\hdfs\server\federation\router\Router.java,787,37,4,11,0,52
hadoop-trunk\hadoop-trunk\hadoop-yarn-project\hadoop-yarn\hadoop-yarn-api\src\main\java\org\apache\hadoop\yarn\api\protocolrecords\StartContainersRequest.java,30,6,0,1,0,7
hadoop-trunk\hadoop-trunk\hadoop-hdfs-project\hadoop-hdfs-client\src\main\java\org\apache\hadoop\hdfs\protocolPB\ClientNamenodeProtocolPB.java,0,1,3,2,0,6
hadoop-trunk\hadoop-trunk\hadoop-mapreduce-project\hadoop-mapreduce-client\hadoop-mapreduce-client-app\src\main\java\org\apache\hadoop\mapreduce\v2\app\webapp\dao\JobsInfo.java,17,8,4,1,0,13
hadoop-trunk\hadoop-trunk\hadoop-yarn-project\hadoop-yarn\hadoop-yarn-server\hadoop-yarn-server-resourcemanager\src\test\java\org\apache\hadoop\yarn\server\resourcemanager\scheduler\distributed\TestNodeQueueLoadMonitor.java,842,286,7,1,0,294
hadoop-trunk\hadoop-trunk\hadoop-tools\hadoop-rumen\src\main\java\org\apache\hadoop\tools\rumen\Task20LineHistoryEventEmitter.java,149,29,8,1,0,38
hadoop-trunk\hadoop-trunk\hadoop-yarn-project\hadoop-yarn\hadoop-yarn-common\src\main\java\org\apache\hadoop\yarn\util\RMHAUtils.java,68,6,3,1,0,10
hadoop-trunk\hadoop-trunk\hadoop-tools\hadoop-openstack\src\main\java\org\apache\hadoop\fs\swift\auth\entities\Endpoint.java,164,50,0,1,0,51
hadoop-trunk\hadoop-trunk\hadoop-tools\hadoop-fs2img\src\main\java\org\apache\hadoop\hdfs\server\namenode\FSTreeWalk.java,95,19,2,5,0,26
hadoop-trunk\hadoop-trunk\hadoop-hdfs-project\hadoop-hdfs\src\main\java\org\apache\hadoop\hdfs\HDFSPolicyProvider.java,51,14,0,8,0,22
hadoop-trunk\hadoop-trunk\hadoop-yarn-project\hadoop-yarn\hadoop-yarn-common\src\main\java\org\apache\hadoop\yarn\server\api\protocolrecords\impl\pb\RefreshQueuesRequestPBImpl.java,42,20,18,3,0,41
hadoop-trunk\hadoop-trunk\hadoop-tools\hadoop-fs2img\src\main\java\org\apache\hadoop\hdfs\server\namenode\ImageWriter.java,552,143,76,3,0,222
hadoop-trunk\hadoop-trunk\hadoop-hdfs-project\hadoop-hdfs\src\main\java\org\apache\hadoop\hdfs\server\namenode\INode.java,0,302,2,18,0,322
hadoop-trunk\hadoop-trunk\hadoop-hdfs-project\hadoop-hdfs\src\main\java\org\apache\hadoop\hdfs\server\namenode\FSNamesystem.java,0,1473,155,132,0,1760
hadoop-trunk\hadoop-trunk\hadoop-mapreduce-project\hadoop-mapreduce-examples\src\main\java\org\apache\hadoop\examples\terasort\GenSort.java,220,173,5,11,0,189
hadoop-trunk\hadoop-trunk\hadoop-common-project\hadoop-common\src\main\java\org\apache\hadoop\util\functional\CloseableTaskPoolSubmitter.java,38,1,0,1,0,2
hadoop-trunk\hadoop-trunk\hadoop-mapreduce-project\hadoop-mapreduce-client\hadoop-mapreduce-client-app\src\main\java\org\apache\hadoop\mapreduce\v2\app\webapp\dao\TaskAttemptInfo.java,97,59,1,1,0,61
hadoop-trunk\hadoop-trunk\hadoop-tools\hadoop-rumen\src\main\java\org\apache\hadoop\tools\rumen\ClusterTopologyReader.java,53,11,0,4,0,15
hadoop-trunk\hadoop-trunk\hadoop-tools\hadoop-azure\src\main\java\org\apache\hadoop\fs\azure\security\Constants.java,0,0,0,1,0,1
hadoop-trunk\hadoop-trunk\hadoop-mapreduce-project\hadoop-mapreduce-client\hadoop-mapreduce-client-jobclient\src\test\java\org\apache\hadoop\util\TestMRCJCRunJar.java,46,11,3,2,0,16
hadoop-trunk\hadoop-trunk\hadoop-yarn-project\hadoop-yarn\hadoop-yarn-common\src\test\java\org\apache\hadoop\yarn\webapp\test\TestWebAppTests.java,71,11,5,1,0,17
hadoop-trunk\hadoop-trunk\hadoop-yarn-project\hadoop-yarn\hadoop-yarn-common\src\main\java\org\apache\hadoop\yarn\logaggregation\filecontroller\LogAggregationHtmlBlock.java,244,70,2,2,0,74
