Class_Location,Class_Length,CheckStyle_Amount,PMD_Amount,SCAX_Amount,SpotBugs_Amount,Total_Amount
 dubbo-3.0\dubbo-3.0\dubbo-common\src\main\java\org\apache\dubbo\rpc\model\ServiceMetadata.java,78,48,1,3,2,54
 dubbo-3.0\dubbo-3.0\dubbo-common\src\main\java\org\apache\dubbo\common\status\reporter\FrameworkStatusReportService.java,78,48,2,8,1,59
 dubbo-3.0\dubbo-3.0\dubbo-rpc\dubbo-rpc-api\src\test\java\org\apache\dubbo\rpc\filter\GenericImplFilterTest.java,78,28,2,15,0,45
 dubbo-3.0\dubbo-3.0\dubbo-config\dubbo-config-spring\src\test\java\org\apache\dubbo\config\spring\boot\configprops\SpringBootMultipleConfigPropsTest.java,78,35,1,29,0,65
 dubbo-3.0\dubbo-3.0\dubbo-common\src\test\java\org\apache\dubbo\common\InterfaceAddressURLTest.java,78,30,0,20,5,55
 dubbo-3.0\dubbo-3.0\dubbo-cluster\src\main\java\org\apache\dubbo\rpc\cluster\support\merger\DefaultProviderURLMergeProcessor.java,78,10,2,13,0,25
 dubbo-3.0\dubbo-3.0\dubbo-plugin\dubbo-qos\src\main\java\org\apache\dubbo\qos\server\handler\QosProcessHandler.java,78,31,0,6,0,37
 dubbo-3.0\dubbo-3.0\dubbo-config\dubbo-config-api\src\main\java\org\apache\dubbo\config\DubboShutdownHook.java,78,17,4,7,0,28
 dubbo-3.0\dubbo-3.0\dubbo-rpc\dubbo-rpc-injvm\src\main\java\org\apache\dubbo\rpc\protocol\injvm\InjvmProtocol.java,78,26,2,12,0,40
 dubbo-3.0\dubbo-3.0\dubbo-common\src\test\java\org\apache\dubbo\common\logger\support\FailsafeLoggerTest.java,78,9,0,6,0,15
 hadoop-trunk\hadoop-trunk\hadoop-hdfs-project\hadoop-hdfs-client\src\main\java\org\apache\hadoop\hdfs\protocol\EncryptionZone.java,78,36,0,1,4,41
 hadoop-trunk\hadoop-trunk\hadoop-mapreduce-project\hadoop-mapreduce-client\hadoop-mapreduce-client-app\src\test\java\org\apache\hadoop\mapreduce\v2\app\webapp\AppControllerForTest.java,78,42,1,3,7,53
 hadoop-trunk\hadoop-trunk\hadoop-yarn-project\hadoop-yarn\hadoop-yarn-client\src\main\java\org\apache\hadoop\yarn\client\api\SharedCacheClient.java,78,6,1,1,0,8
 hadoop-trunk\hadoop-trunk\hadoop-common-project\hadoop-common\src\test\java\org\apache\hadoop\fs\contract\localfs\LocalFSContract.java,78,15,1,3,2,21
 hadoop-trunk\hadoop-trunk\hadoop-yarn-project\hadoop-yarn\hadoop-yarn-server\hadoop-yarn-server-common\src\main\java\org\apache\hadoop\yarn\server\api\protocolrecords\impl\pb\UnRegisterNodeManagerRequestPBImpl.java,78,15,30,4,0,49
 hadoop-trunk\hadoop-trunk\hadoop-mapreduce-project\hadoop-mapreduce-client\hadoop-mapreduce-client-nativetask\src\test\java\org\apache\hadoop\mapred\nativetask\combinertest\CombinerTest.java,78,25,1,11,0,37
 hadoop-trunk\hadoop-trunk\hadoop-yarn-project\hadoop-yarn\hadoop-yarn-server\hadoop-yarn-server-common\src\main\java\org\apache\hadoop\yarn\server\api\protocolrecords\NodeHeartbeatRequest.java,78,37,0,1,0,38
 hadoop-trunk\hadoop-trunk\hadoop-yarn-project\hadoop-yarn\hadoop-yarn-server\hadoop-yarn-server-nodemanager\src\test\java\org\apache\hadoop\yarn\server\nodemanager\containermanager\linux\resources\TestResourceHandlerModule.java,78,7,2,2,0,11
 hadoop-trunk\hadoop-trunk\hadoop-common-project\hadoop-common\src\test\java\org\apache\hadoop\io\retry\TestDefaultRetryPolicy.java,78,3,0,1,1,5
 hadoop-trunk\hadoop-trunk\hadoop-tools\hadoop-federation-balance\src\main\java\org\apache\hadoop\tools\fedbalance\TrashProcedure.java,78,19,2,2,2,25
 hadoop-trunk\hadoop-trunk\hadoop-yarn-project\hadoop-yarn\hadoop-yarn-applications\hadoop-yarn-services\hadoop-yarn-services-core\src\test\java\org\apache\hadoop\yarn\service\utils\TestFilterUtils.java,78,5,9,2,1,17
 hadoop-trunk\hadoop-trunk\hadoop-mapreduce-project\hadoop-mapreduce-client\hadoop-mapreduce-client-core\src\test\java\org\apache\hadoop\mapreduce\task\reduce\TestEventFetcher.java,78,28,4,1,0,33
 hadoop-trunk\hadoop-trunk\hadoop-yarn-project\hadoop-yarn\hadoop-yarn-server\hadoop-yarn-server-nodemanager\src\test\java\org\apache\hadoop\yarn\server\nodemanager\api\impl\pb\TestNMProtoUtils.java,78,7,12,7,0,26
 hadoop-trunk\hadoop-trunk\hadoop-yarn-project\hadoop-yarn\hadoop-yarn-api\src\main\java\org\apache\hadoop\yarn\api\records\ResourceAllocationRequest.java,78,3,0,1,0,4
 hadoop-trunk\hadoop-trunk\hadoop-tools\hadoop-datajoin\src\main\java\org\apache\hadoop\contrib\utils\join\DataJoinMapperBase.java,78,34,5,2,3,44
 hadoop-trunk\hadoop-trunk\hadoop-hdfs-project\hadoop-hdfs-nfs\src\test\java\org\apache\hadoop\hdfs\nfs\nfs3\TestDFSClientCache.java,78,5,8,2,0,15
 hadoop-trunk\hadoop-trunk\hadoop-mapreduce-project\hadoop-mapreduce-client\hadoop-mapreduce-client-core\src\main\java\org\apache\hadoop\mapreduce\task\reduce\MapHost.java,78,39,0,1,8,48
 hadoop-trunk\hadoop-trunk\hadoop-yarn-project\hadoop-yarn\hadoop-yarn-server\hadoop-yarn-server-nodemanager\src\test\java\org\apache\hadoop\yarn\server\nodemanager\containermanager\linux\resources\TestCGroupsBlkioResourceHandlerImpl.java,78,8,0,4,1,13
 hadoop-trunk\hadoop-trunk\hadoop-tools\hadoop-fs2img\src\main\java\org\apache\hadoop\hdfs\server\namenode\TreeWalk.java,78,13,0,1,0,14
 hadoop-trunk\hadoop-trunk\hadoop-hdfs-project\hadoop-hdfs\src\main\java\org\apache\hadoop\hdfs\server\blockmanagement\BlockPlacementStatusWithUpgradeDomain.java,78,21,1,1,1,24
 hadoop-trunk\hadoop-trunk\hadoop-tools\hadoop-azure-datalake\src\test\java\org\apache\hadoop\fs\adl\live\TestAdlDifferentSizeWritesLive.java,78,51,1,1,0,53
 hadoop-trunk\hadoop-trunk\hadoop-yarn-project\hadoop-yarn\hadoop-yarn-server\hadoop-yarn-server-nodemanager\src\main\java\org\apache\hadoop\yarn\server\nodemanager\containermanager\resourceplugin\fpga\FpgaResourcePlugin.java,78,19,2,12,0,33
 hadoop-trunk\hadoop-trunk\hadoop-yarn-project\hadoop-yarn\hadoop-yarn-api\src\main\java\org\apache\hadoop\yarn\api\protocolrecords\ReInitializeContainerRequest.java,78,3,0,1,0,4
 hadoop-trunk\hadoop-trunk\hadoop-hdfs-project\hadoop-hdfs\src\main\java\org\apache\hadoop\hdfs\server\namenode\snapshot\SnapshotDeletionGc.java,78,14,4,3,1,22
 hadoop-trunk\hadoop-trunk\hadoop-hdfs-project\hadoop-hdfs\src\test\java\org\apache\hadoop\fs\viewfs\TestViewFsFileStatusHdfs.java,78,27,4,2,0,33
 hadoop-trunk\hadoop-trunk\hadoop-tools\hadoop-aws\src\main\java\org\apache\hadoop\fs\s3a\Retries.java,78,8,0,1,0,9
 hadoop-trunk\hadoop-trunk\hadoop-hdfs-project\hadoop-hdfs-nfs\src\test\java\org\apache\hadoop\hdfs\nfs\nfs3\TestClientAccessPrivilege.java,78,20,1,1,0,22
 hadoop-trunk\hadoop-trunk\hadoop-tools\hadoop-azure\src\test\java\org\apache\hadoop\fs\azurebfs\ITestAzureBlobFileSystemAttributes.java,78,11,0,6,0,17
 hadoop-trunk\hadoop-trunk\hadoop-mapreduce-project\hadoop-mapreduce-client\hadoop-mapreduce-client-core\src\test\java\org\apache\hadoop\mapred\TestLocatedFileStatusFetcher.java,78,12,1,1,1,15
 hadoop-trunk\hadoop-trunk\hadoop-hdfs-project\hadoop-hdfs\src\test\java\org\apache\hadoop\hdfs\FileAppendTest4.java,78,53,1,7,0,61
 hadoop-trunk\hadoop-trunk\hadoop-common-project\hadoop-common\src\test\java\org\apache\hadoop\fs\contract\AbstractBondedFSContract.java,78,16,3,1,1,21
 hadoop-trunk\hadoop-trunk\hadoop-tools\hadoop-openstack\src\test\java\org\apache\hadoop\fs\swift\http\TestSwiftRestClient.java,78,9,7,1,2,19
 hadoop-trunk\hadoop-trunk\hadoop-tools\hadoop-rumen\src\main\java\org\apache\hadoop\tools\rumen\JobConfigurationParser.java,78,4,6,1,1,12
 hadoop-trunk\hadoop-trunk\hadoop-hdfs-project\hadoop-hdfs\src\test\java\org\apache\hadoop\hdfs\server\datanode\checker\TestDatasetVolumeCheckerTimeout.java,78,14,7,1,2,24
 hadoop-trunk\hadoop-trunk\hadoop-yarn-project\hadoop-yarn\hadoop-yarn-server\hadoop-yarn-server-resourcemanager\src\main\java\org\apache\hadoop\yarn\server\resourcemanager\scheduler\capacity\allocator\ContainerAllocation.java,78,39,6,3,7,55
 kafka-trunk\kafka-trunk\connect\runtime\src\main\java\org\apache\kafka\connect\runtime\isolation\PluginClassLoader.java,78,0,0,18,0,18
 kafka-trunk\kafka-trunk\jmh-benchmarks\src\main\java\org\apache\kafka\jmh\admin\GetListOffsetsCallsBenchmark.java,78,0,3,11,0,14
 kafka-trunk\kafka-trunk\core\src\test\java\kafka\test\ClusterTestExtensionsTest.java,78,0,0,27,0,27
 kafka-trunk\kafka-trunk\clients\src\main\java\org\apache\kafka\common\utils\LoggingSignalHandler.java,78,0,4,17,0,21
 kafka-trunk\kafka-trunk\connect\transforms\src\main\java\org\apache\kafka\connect\transforms\ValueToKey.java,78,0,0,8,0,8
 kafka-trunk\kafka-trunk\clients\src\main\java\org\apache\kafka\common\requests\WriteTxnMarkersResponse.java,78,0,54,19,2,75
 kafka-trunk\kafka-trunk\connect\api\src\main\java\org\apache\kafka\connect\connector\policy\ConnectorClientConfigRequest.java,78,0,0,10,2,12
 kafka-trunk\kafka-trunk\connect\runtime\src\test\java\org\apache\kafka\connect\converters\NumberConverterTest.java,78,0,0,8,0,8
 kafka-trunk\kafka-trunk\clients\src\generated\java\org\apache\kafka\common\message\CreateAclsResponseDataJsonConverter.java,78,0,0,16,0,16
 kafka-trunk\kafka-trunk\clients\src\main\java\org\apache\kafka\common\record\PartialDefaultRecord.java,78,0,0,6,0,6
 kafka-trunk\kafka-trunk\streams\src\test\java\org\apache\kafka\streams\processor\internals\assignment\ConstrainedPrioritySetTest.java,78,0,0,11,0,11
 kafka-trunk\kafka-trunk\streams\src\test\java\org\apache\kafka\streams\kstream\internals\SessionTupleForwarderTest.java,78,0,0,8,0,8
 kafka-trunk\kafka-trunk\trogdor\src\test\java\org\apache\kafka\trogdor\rest\RestExceptionMapperTest.java,78,0,0,15,3,18
 kafka-trunk\kafka-trunk\clients\src\test\java\org\apache\kafka\common\security\oauthbearer\secured\OAuthBearerValidatorCallbackHandlerTest.java,78,0,0,19,0,19
 kafka-trunk\kafka-trunk\connect\runtime\src\main\java\org\apache\kafka\connect\runtime\rest\entities\ConfigInfos.java,78,0,2,1,4,7
 kafka-trunk\kafka-trunk\connect\file\src\test\java\org\apache\kafka\connect\file\FileStreamSinkTaskTest.java,78,0,1,12,5,18
 kafka-trunk\kafka-trunk\clients\src\test\java\org\apache\kafka\clients\consumer\ConsumerConfigTest.java,78,0,1,29,0,30
 pulsar-master\pulsar-master\pulsar-common\src\test\java\org\apache\pulsar\common\util\netty\ChannelFuturesTest.java,78,30,5,10,0,45
 pulsar-master\pulsar-master\pulsar-io\hdfs2\src\main\java\org\apache\pulsar\io\hdfs2\sink\HdfsSinkConfig.java,78,21,2,15,0,38
 pulsar-master\pulsar-master\pulsar-client\src\main\java\org\apache\pulsar\client\impl\schema\reader\AvroReader.java,78,35,0,10,0,45
 pulsar-master\pulsar-master\pulsar-functions\instance\src\main\java\org\apache\pulsar\functions\windowing\WindowImpl.java,78,32,0,5,0,37
 pulsar-master\pulsar-master\pulsar-websocket\src\main\java\org\apache\pulsar\websocket\service\WebSocketServiceStarter.java,78,28,1,20,0,49
 pulsar-master\pulsar-master\pulsar-client\src\main\java\org\apache\pulsar\client\impl\schema\ShortSchema.java,78,21,1,3,0,25
 rocketmq-develop\rocketmq-develop\test\src\main\java\org\apache\rocketmq\test\client\rmq\RMQTransactionalProducer.java,78,29,0,7,4,40
 rocketmq-develop\rocketmq-develop\test\src\test\java\org\apache\rocketmq\test\client\producer\transaction\TransactionalMsgIT.java,78,31,1,11,0,43
 rocketmq-develop\rocketmq-develop\common\src\test\java\org\apache\rocketmq\common\protocol\route\TopicRouteDataTest.java,78,21,4,9,0,34
 rocketmq-develop\rocketmq-develop\client\src\test\java\org\apache\rocketmq\client\impl\consumer\ProcessQueueTest.java,78,27,0,3,0,30
 rocketmq-develop\rocketmq-develop\broker\src\main\java\org\apache\rocketmq\broker\filter\CommitLogDispatcherCalcBitMap.java,78,25,6,12,2,45
 skywalking-master\skywalking-master\oap-server\server-receiver-plugin\skywalking-trace-receiver-plugin\src\test\java\org\apache\skywalking\oap\server\receiver\trace\provider\parser\listener\segment\ProtoBufJsonUtilsTest.java,78,61,0,5,0,66
 skywalking-master\skywalking-master\oap-server\server-storage-plugin\storage-iotdb-plugin\src\main\java\org\apache\skywalking\oap\server\storage\plugin\iotdb\query\IoTDBEBPFProfilingTaskDAO.java,78,30,0,26,0,56
 skywalking-master\skywalking-master\oap-server\server-core\src\test\java\org\apache\skywalking\oap\server\core\storage\PersistenceTimerTest.java,78,18,1,13,0,32
 skywalking-master\skywalking-master\oap-server\analyzer\log-analyzer\src\main\java\org\apache\skywalking\oap\log\analyzer\provider\log\listener\TrafficAnalysisListener.java,78,21,1,9,0,31
 skywalking-master\skywalking-master\oap-server\server-configuration\grpc-configuration-sync\src\main\java\org\apache\skywalking\oap\server\configuration\grpc\GRPCConfigWatcherRegister.java,78,21,0,16,0,37
 skywalking-master\skywalking-master\oap-server\server-receiver-plugin\skywalking-browser-receiver-plugin\src\main\java\org\apache\skywalking\oap\server\receiver\browser\provider\parser\performance\listener\MultiScopesPerfDataAnalysisListener.java,78,23,1,15,0,39
 skywalking-master\skywalking-master\oap-server\server-library\library-util\src\main\java\org\apache\skywalking\oap\server\library\util\ResourceUtils.java,78,28,1,14,4,47
 skywalking-master\skywalking-master\oap-server\server-storage-plugin\storage-influxdb-plugin\src\main\java\org\apache\skywalking\oap\server\storage\plugin\influxdb\TableMetaInfo.java,78,30,2,23,0,55
 zookeeper-master\zookeeper-master\zookeeper-server\src\main\java\org\apache\zookeeper\server\auth\KeyAuthenticationProvider.java,78,0,8,6,0,14
 dubbo-3.0\dubbo-3.0\dubbo-metadata\dubbo-metadata-api\src\main\java\org\apache\dubbo\metadata\report\support\AbstractMetadataReportFactory.java,79,22,2,8,0,32
 dubbo-3.0\dubbo-3.0\dubbo-metadata\dubbo-metadata-api\src\main\java\org\apache\dubbo\metadata\rest\ServiceRestMetadata.java,79,38,0,3,0,41
 dubbo-3.0\dubbo-3.0\dubbo-config\dubbo-config-api\src\test\java\org\apache\dubbo\config\ModuleConfigTest.java,79,12,0,2,0,14
 dubbo-3.0\dubbo-3.0\dubbo-cluster\src\test\java\org\apache\dubbo\rpc\cluster\loadbalance\ShortestResponseLoadBalanceTest.java,79,21,7,16,0,44
 dubbo-3.0\dubbo-3.0\dubbo-rpc\dubbo-rpc-dubbo\src\test\java\org\apache\dubbo\rpc\protocol\dubbo\DecodeableRpcResultTest.java,79,32,2,22,0,56
 dubbo-3.0\dubbo-3.0\dubbo-common\src\test\java\org\apache\dubbo\rpc\model\FrameworkServiceRepositoryTest.java,79,25,1,17,3,46
 dubbo-3.0\dubbo-3.0\dubbo-cluster\src\test\java\org\apache\dubbo\rpc\cluster\support\FailSafeClusterInvokerTest.java,79,22,0,4,0,26
 dubbo-3.0\dubbo-3.0\dubbo-common\src\test\java\org\apache\dubbo\common\config\EnvironmentTest.java,79,17,8,13,0,38
 dubbo-3.0\dubbo-3.0\dubbo-remoting\dubbo-remoting-api\src\test\java\org\apache\dubbo\remoting\buffer\ChannelBufferStreamTest.java,79,13,5,1,11,30
 hadoop-trunk\hadoop-trunk\hadoop-hdfs-project\hadoop-hdfs\src\test\java\org\apache\hadoop\hdfs\server\namenode\startupprogress\StartupProgressTestHelper.java,79,28,3,2,0,33
 hadoop-trunk\hadoop-trunk\hadoop-yarn-project\hadoop-yarn\hadoop-yarn-server\hadoop-yarn-server-resourcemanager\src\test\java\org\apache\hadoop\yarn\server\resourcemanager\applicationsmanager\TestAMRMRPCResponseId.java,79,15,0,3,3,21
 hadoop-trunk\hadoop-trunk\hadoop-mapreduce-project\hadoop-mapreduce-client\hadoop-mapreduce-client-common\src\main\java\org\apache\hadoop\mapreduce\v2\api\protocolrecords\impl\pb\GetCountersResponsePBImpl.java,79,34,33,5,0,72
 hadoop-trunk\hadoop-trunk\hadoop-tools\hadoop-dynamometer\hadoop-dynamometer-workload\src\main\java\org\apache\hadoop\tools\dynamometer\workloadgenerator\audit\UserCommandKey.java,79,36,1,1,3,41
 hadoop-trunk\hadoop-trunk\hadoop-mapreduce-project\hadoop-mapreduce-client\hadoop-mapreduce-client-common\src\main\java\org\apache\hadoop\mapreduce\v2\api\protocolrecords\impl\pb\GetTaskReportResponsePBImpl.java,79,34,33,5,0,72
 hadoop-trunk\hadoop-trunk\hadoop-common-project\hadoop-common\src\main\java\org\apache\hadoop\security\NetgroupCache.java,79,17,1,3,0,21
 hadoop-trunk\hadoop-trunk\hadoop-mapreduce-project\hadoop-mapreduce-client\hadoop-mapreduce-client-core\src\main\java\org\apache\hadoop\mapreduce\counters\GenericCounter.java,79,36,0,1,0,37
 hadoop-trunk\hadoop-trunk\hadoop-common-project\hadoop-common\src\main\java\org\apache\hadoop\crypto\random\OpensslSecureRandom.java,79,33,1,1,0,35
 hadoop-trunk\hadoop-trunk\hadoop-mapreduce-project\hadoop-mapreduce-client\hadoop-mapreduce-client-app\src\main\java\org\apache\hadoop\mapreduce\v2\app\rm\preemption\KillAMPreemptionPolicy.java,79,19,1,1,0,21
 hadoop-trunk\hadoop-trunk\hadoop-mapreduce-project\hadoop-mapreduce-client\hadoop-mapreduce-client-common\src\main\java\org\apache\hadoop\mapreduce\v2\api\protocolrecords\impl\pb\GetTaskReportRequestPBImpl.java,79,34,33,5,0,72
 hadoop-trunk\hadoop-trunk\hadoop-mapreduce-project\hadoop-mapreduce-client\hadoop-mapreduce-client-common\src\main\java\org\apache\hadoop\mapreduce\v2\api\protocolrecords\impl\pb\GetTaskAttemptReportResponsePBImpl.java,79,37,33,10,0,80
 hadoop-trunk\hadoop-trunk\hadoop-hdfs-project\hadoop-hdfs\src\main\java\org\apache\hadoop\hdfs\server\namenode\visitor\INodeCountVisitor.java,79,22,0,1,0,23
 hadoop-trunk\hadoop-trunk\hadoop-yarn-project\hadoop-yarn\hadoop-yarn-client\src\test\java\org\apache\hadoop\yarn\client\TestYarnApiClasses.java,79,11,11,12,0,34
 hadoop-trunk\hadoop-trunk\hadoop-mapreduce-project\hadoop-mapreduce-client\hadoop-mapreduce-client-common\src\main\java\org\apache\hadoop\mapreduce\v2\api\protocolrecords\impl\pb\FailTaskAttemptRequestPBImpl.java,79,34,33,6,0,73
 hadoop-trunk\hadoop-trunk\hadoop-tools\hadoop-aws\src\test\java\org\apache\hadoop\fs\s3a\auth\ITestAssumedRoleCommitOperations.java,79,8,4,1,0,13
 hadoop-trunk\hadoop-trunk\hadoop-common-project\hadoop-common\src\main\java\org\apache\hadoop\metrics2\util\Metrics2Util.java,79,26,0,1,0,27
 hadoop-trunk\hadoop-trunk\hadoop-mapreduce-project\hadoop-mapreduce-client\hadoop-mapreduce-client-common\src\main\java\org\apache\hadoop\mapreduce\v2\api\protocolrecords\impl\pb\GetTaskAttemptReportRequestPBImpl.java,79,35,33,7,0,75
 hadoop-trunk\hadoop-trunk\hadoop-hdfs-project\hadoop-hdfs\src\main\java\org\apache\hadoop\hdfs\server\namenode\CheckpointConf.java,79,34,2,4,0,40
 hadoop-trunk\hadoop-trunk\hadoop-mapreduce-project\hadoop-mapreduce-client\hadoop-mapreduce-client-jobclient\src\test\java\org\apache\hadoop\mapred\TestJobName.java,79,5,8,2,8,23
 hadoop-trunk\hadoop-trunk\hadoop-yarn-project\hadoop-yarn\hadoop-yarn-server\hadoop-yarn-server-timeline-pluginstorage\src\test\java\org\apache\hadoop\yarn\server\timeline\TestLevelDBCacheTimelineStore.java,79,14,0,1,0,15
 hadoop-trunk\hadoop-trunk\hadoop-mapreduce-project\hadoop-mapreduce-client\hadoop-mapreduce-client-common\src\main\java\org\apache\hadoop\mapreduce\v2\api\protocolrecords\impl\pb\GetJobReportRequestPBImpl.java,79,34,33,5,0,72
 hadoop-trunk\hadoop-trunk\hadoop-hdfs-project\hadoop-hdfs\src\main\java\org\apache\hadoop\hdfs\server\datanode\ReportBadBlockAction.java,79,23,1,1,1,26
 hadoop-trunk\hadoop-trunk\hadoop-mapreduce-project\hadoop-mapreduce-client\hadoop-mapreduce-client-common\src\main\java\org\apache\hadoop\mapreduce\v2\api\protocolrecords\impl\pb\GetDiagnosticsRequestPBImpl.java,79,34,33,5,0,72
 hadoop-trunk\hadoop-trunk\hadoop-hdfs-project\hadoop-hdfs\src\test\java\org\apache\hadoop\hdfs\server\namenode\TestSecondaryNameNodeUpgrade.java,79,17,3,9,0,29
 hadoop-trunk\hadoop-trunk\hadoop-mapreduce-project\hadoop-mapreduce-client\hadoop-mapreduce-client-core\src\test\java\org\apache\hadoop\mapreduce\split\TestJobSplitWriterWithEC.java,79,13,1,1,0,15
 hadoop-trunk\hadoop-trunk\hadoop-mapreduce-project\hadoop-mapreduce-client\hadoop-mapreduce-client-common\src\main\java\org\apache\hadoop\mapreduce\v2\api\protocolrecords\impl\pb\KillTaskRequestPBImpl.java,79,33,33,4,0,70
 hadoop-trunk\hadoop-trunk\hadoop-mapreduce-project\hadoop-mapreduce-client\hadoop-mapreduce-client-common\src\main\java\org\apache\hadoop\mapreduce\v2\api\protocolrecords\impl\pb\GetCountersRequestPBImpl.java,79,33,33,4,0,70
 hadoop-trunk\hadoop-trunk\hadoop-mapreduce-project\hadoop-mapreduce-client\hadoop-mapreduce-client-common\src\main\java\org\apache\hadoop\mapreduce\v2\api\protocolrecords\impl\pb\GetJobReportResponsePBImpl.java,79,34,33,5,0,72
 hadoop-trunk\hadoop-trunk\hadoop-yarn-project\hadoop-yarn\hadoop-yarn-server\hadoop-yarn-server-nodemanager\src\main\java\org\apache\hadoop\yarn\server\nodemanager\containermanager\linux\resources\CombinedResourceCalculator.java,79,23,0,2,0,25
 hadoop-trunk\hadoop-trunk\hadoop-tools\hadoop-azure\src\test\java\org\apache\hadoop\fs\azurebfs\ITestFileSystemRegistration.java,79,18,1,7,0,26
 hadoop-trunk\hadoop-trunk\hadoop-hdfs-project\hadoop-hdfs\src\main\java\org\apache\hadoop\hdfs\util\AtomicFileOutputStream.java,79,20,5,5,0,30
 hadoop-trunk\hadoop-trunk\hadoop-mapreduce-project\hadoop-mapreduce-client\hadoop-mapreduce-client-common\src\main\java\org\apache\hadoop\mapreduce\v2\api\protocolrecords\impl\pb\KillTaskAttemptRequestPBImpl.java,79,34,33,6,0,73
 hadoop-trunk\hadoop-trunk\hadoop-tools\hadoop-openstack\src\main\java\org\apache\hadoop\fs\swift\auth\entities\Tenant.java,79,12,0,1,0,13
 hadoop-trunk\hadoop-trunk\hadoop-mapreduce-project\hadoop-mapreduce-client\hadoop-mapreduce-client-common\src\main\java\org\apache\hadoop\mapreduce\v2\api\protocolrecords\impl\pb\KillJobRequestPBImpl.java,79,33,33,3,0,69
 hadoop-trunk\hadoop-trunk\hadoop-yarn-project\hadoop-yarn\hadoop-yarn-server\hadoop-yarn-server-timelineservice\src\main\java\org\apache\hadoop\yarn\server\timelineservice\reader\filter\TimelineExistsFilter.java,79,23,1,1,0,25
 hadoop-trunk\hadoop-trunk\hadoop-yarn-project\hadoop-yarn\hadoop-yarn-common\src\main\java\org\apache\hadoop\yarn\nodelabels\NonAppendableFSNodeLabelStore.java,79,13,3,1,0,17
 hadoop-trunk\hadoop-trunk\hadoop-yarn-project\hadoop-yarn\hadoop-yarn-server\hadoop-yarn-server-nodemanager\src\test\java\org\apache\hadoop\yarn\server\nodemanager\util\TestProcessIdFileReader.java,79,26,9,1,0,36
 hadoop-trunk\hadoop-trunk\hadoop-yarn-project\hadoop-yarn\hadoop-yarn-server\hadoop-yarn-server-resourcemanager\src\test\java\org\apache\hadoop\yarn\server\resourcemanager\scheduler\fair\allocationfile\AllocationFileQueuePlacementRule.java,79,30,0,2,0,32
 hadoop-trunk\hadoop-trunk\hadoop-common-project\hadoop-kms\src\main\java\org\apache\hadoop\crypto\key\kms\server\KMSExceptionsProvider.java,79,14,1,1,0,16
 hadoop-trunk\hadoop-trunk\hadoop-common-project\hadoop-nfs\src\test\java\org\apache\hadoop\portmap\TestPortmap.java,79,14,3,1,0,18
 hadoop-trunk\hadoop-trunk\hadoop-hdfs-project\hadoop-hdfs-client\src\test\java\org\apache\hadoop\hdfs\protocol\TestErasureCodingPolicy.java,79,14,4,1,4,23
 kafka-trunk\kafka-trunk\connect\api\src\test\java\org\apache\kafka\connect\header\ConnectHeaderTest.java,79,0,0,1,1,2
 kafka-trunk\kafka-trunk\jmh-benchmarks\src\main\java\org\apache\kafka\jmh\common\ImplicitLinkedHashCollectionBenchmark.java,79,0,2,4,1,7
 kafka-trunk\kafka-trunk\metadata\src\test\java\org\apache\kafka\image\ClientQuotasImageTest.java,79,0,3,13,0,16
 kafka-trunk\kafka-trunk\streams\examples\src\test\java\org\apache\kafka\streams\examples\wordcount\WordCountDemoTest.java,79,0,0,11,5,16
 kafka-trunk\kafka-trunk\server-common\src\main\java\org\apache\kafka\server\common\serialization\AbstractApiMessageSerde.java,79,0,0,17,0,17
 kafka-trunk\kafka-trunk\clients\src\main\java\org\apache\kafka\common\requests\VoteRequest.java,79,0,0,5,2,7
 kafka-trunk\kafka-trunk\streams\src\test\java\org\apache\kafka\streams\state\internals\ReadOnlyKeyValueStoreFacadeTest.java,79,0,0,19,0,19
 kafka-trunk\kafka-trunk\streams\src\main\java\org\apache\kafka\streams\kstream\WindowedSerdes.java,79,0,1,20,0,21
 kafka-trunk\kafka-trunk\streams\src\test\java\org\apache\kafka\streams\internals\ApiUtilsTest.java,79,0,0,19,0,19
 kafka-trunk\kafka-trunk\streams\src\test\java\org\apache\kafka\streams\processor\internals\TimestampedKeyValueStoreMaterializerTest.java,79,0,1,32,1,34
 kafka-trunk\kafka-trunk\streams\src\main\java\org\apache\kafka\streams\processor\internals\InternalTopicConfig.java,79,0,1,13,0,14
 kafka-trunk\kafka-trunk\streams\src\main\java\org\apache\kafka\streams\processor\internals\TaskMetadataImpl.java,79,0,0,1,5,6
 kafka-trunk\kafka-trunk\metadata\src\test\java\org\apache\kafka\timeline\TimelineHashMapTest.java,79,0,2,9,3,14
 kafka-trunk\kafka-trunk\streams\src\test\java\org\apache\kafka\streams\tests\StreamsSmokeTest.java,79,0,2,12,0,14
 pulsar-master\pulsar-master\pulsar-io\twitter\src\test\java\org\apache\pulsar\io\twitter\TwitterFireHoseConfigTests.java,79,32,0,1,0,33
 pulsar-master\pulsar-master\pulsar-client-admin-api\src\main\java\org\apache\pulsar\common\policies\data\ManagedLedgerInternalStats.java,79,61,0,7,0,68
 pulsar-master\pulsar-master\pulsar-common\src\main\java\org\apache\pulsar\common\compression\CompressionCodecSnappy.java,79,17,0,10,0,27
 pulsar-master\pulsar-master\pulsar-broker\src\test\java\org\apache\pulsar\broker\admin\AdminApiMultiBrokersTest.java,79,30,3,13,0,46
 pulsar-master\pulsar-master\pulsar-common\src\test\java\org\apache\pulsar\common\topics\TopicListTest.java,79,22,0,12,0,34
 pulsar-master\pulsar-master\pulsar-client\src\main\java\org\apache\pulsar\client\impl\DefaultCryptoKeyReader.java,79,23,1,10,0,34
 pulsar-master\pulsar-master\pulsar-functions\utils\src\main\java\org\apache\pulsar\functions\utils\WindowConfigUtils.java,79,23,1,16,0,40
 pulsar-master\pulsar-master\pulsar-broker\src\main\java\org\apache\pulsar\broker\loadbalance\impl\GenericBrokerHostUsageImpl.java,79,28,0,10,0,38
 pulsar-master\pulsar-master\pulsar-broker\src\test\java\org\apache\pulsar\broker\transaction\recover\TransactionRecoverTrackerTest.java,79,32,5,20,0,57
 pulsar-master\pulsar-master\pulsar-broker-auth-sasl\src\main\java\org\apache\pulsar\broker\authentication\SaslRoleTokenSigner.java,79,12,0,6,0,18
 rocketmq-develop\rocketmq-develop\common\src\main\java\org\apache\rocketmq\common\message\MessageAccessor.java,79,36,1,10,0,47
 rocketmq-develop\rocketmq-develop\broker\src\main\java\org\apache\rocketmq\broker\pagecache\OneMessageTransfer.java,79,30,0,8,2,40
 rocketmq-develop\rocketmq-develop\test\src\test\java\org\apache\rocketmq\test\base\dledger\DLedgerProduceAndConsumeIT.java,79,33,1,11,2,47
 rocketmq-develop\rocketmq-develop\example\src\main\java\org\apache\rocketmq\example\operation\Consumer.java,79,13,2,4,0,19
 skywalking-master\skywalking-master\oap-server\server-library\library-util\src\test\java\org\apache\skywalking\oap\server\library\util\PropertyPlaceholderHelperTest.java,79,23,2,15,0,40
 skywalking-master\skywalking-master\oap-server\server-core\src\main\java\org\apache\skywalking\oap\server\core\storage\type\HashMapConverter.java,79,18,0,6,0,24
 skywalking-master\skywalking-master\oap-server\server-core\src\test\java\org\apache\skywalking\oap\server\core\storage\query\MetricsQueryUtilTest.java,79,36,1,23,0,60
 skywalking-master\skywalking-master\oap-server\server-core\src\main\java\org\apache\skywalking\oap\server\core\browser\manual\errorlog\BrowserErrorLogRecord.java,79,29,0,12,0,41
 skywalking-master\skywalking-master\oap-server\server-storage-plugin\storage-elasticsearch-plugin\src\main\java\org\apache\skywalking\oap\server\storage\plugin\elasticsearch\base\HistoryDeleteEsDAO.java,79,16,0,10,0,26
 skywalking-master\skywalking-master\oap-server\server-storage-plugin\storage-iotdb-plugin\src\main\java\org\apache\skywalking\oap\server\storage\plugin\iotdb\query\IoTDBTopNRecordsQueryDAO.java,79,17,0,12,0,29
 zookeeper-master\zookeeper-master\zookeeper-server\src\test\java\org\apache\zookeeper\GetAllChildrenNumberTest.java,79,0,6,12,3,21
 zookeeper-master\zookeeper-master\zookeeper-server\src\main\java\org\apache\zookeeper\server\quorum\ProposalRequestProcessor.java,79,0,1,8,1,10
 dubbo-3.0\dubbo-3.0\dubbo-rpc\dubbo-rpc-api\src\main\java\org\apache\dubbo\rpc\listener\ListenerInvokerWrapper.java,80,25,4,4,2,35
 dubbo-3.0\dubbo-3.0\dubbo-common\src\test\java\org\apache\dubbo\common\model\SerializablePerson.java,80,47,11,2,2,62
 dubbo-3.0\dubbo-3.0\dubbo-config\dubbo-config-spring\src\test\java\org\apache\dubbo\config\spring\beans\factory\annotation\MethodConfigCallbackTest.java,80,17,0,9,0,26
 dubbo-3.0\dubbo-3.0\dubbo-test\dubbo-test-check\src\main\java\org\apache\dubbo\test\check\registrycenter\context\ZookeeperWindowsContext.java,80,15,0,6,1,22
 dubbo-3.0\dubbo-3.0\dubbo-rpc\dubbo-rpc-grpc\src\test\java\org\apache\dubbo\rpc\protocol\grpc\GrpcProtocolTest.java,80,20,0,14,0,34
 dubbo-3.0\dubbo-3.0\dubbo-config\dubbo-config-api\src\test\java\org\apache\dubbo\config\mock\MockRegistry.java,80,21,6,6,0,33
 dubbo-3.0\dubbo-3.0\dubbo-rpc\dubbo-rpc-api\src\main\java\org\apache\dubbo\rpc\proxy\wrapper\StubProxyFactoryWrapper.java,80,37,2,14,0,53
 dubbo-3.0\dubbo-3.0\dubbo-common\src\test\java\org\apache\dubbo\common\config\ConfigurationUtilsTest.java,80,24,0,17,0,41
 dubbo-3.0\dubbo-3.0\dubbo-registry\dubbo-registry-api\src\test\java\org\apache\dubbo\registry\client\migration\model\MigrationRuleTest.java,80,47,10,14,0,71
 dubbo-3.0\dubbo-3.0\dubbo-native-plugin\src\main\java\org\apache\dubbo\maven\plugin\CodeGenerator.java,80,37,9,16,4,66
 hadoop-trunk\hadoop-trunk\hadoop-common-project\hadoop-common\src\test\java\org\apache\hadoop\io\nativeio\TestSharedFileDescriptorFactory.java,80,36,4,1,10,51
 hadoop-trunk\hadoop-trunk\hadoop-tools\hadoop-resourceestimator\src\main\java\org\apache\hadoop\resourceestimator\skylinestore\validator\SkylineStoreValidator.java,80,2,4,7,0,13
 hadoop-trunk\hadoop-trunk\hadoop-common-project\hadoop-nfs\src\main\java\org\apache\hadoop\mount\MountResponse.java,80,20,3,1,0,24
 hadoop-trunk\hadoop-trunk\hadoop-yarn-project\hadoop-yarn\hadoop-yarn-applications\hadoop-yarn-services\hadoop-yarn-services-core\src\main\java\org\apache\hadoop\yarn\service\utils\PortScanner.java,80,17,3,2,2,24
 hadoop-trunk\hadoop-trunk\hadoop-common-project\hadoop-common\src\main\java\org\apache\hadoop\conf\StorageSize.java,80,20,0,1,0,21
 hadoop-trunk\hadoop-trunk\hadoop-mapreduce-project\hadoop-mapreduce-client\hadoop-mapreduce-client-common\src\main\java\org\apache\hadoop\mapreduce\v2\api\records\impl\pb\CounterPBImpl.java,80,27,39,1,0,67
 hadoop-trunk\hadoop-trunk\hadoop-mapreduce-project\hadoop-mapreduce-client\hadoop-mapreduce-client-hs\src\test\java\org\apache\hadoop\mapreduce\v2\hs\MockHistoryContext.java,80,52,1,6,3,62
 hadoop-trunk\hadoop-trunk\hadoop-hdfs-project\hadoop-hdfs\src\main\java\org\apache\hadoop\hdfs\server\common\blockaliasmap\BlockAliasMap.java,80,9,0,1,0,10
 hadoop-trunk\hadoop-trunk\hadoop-hdfs-project\hadoop-hdfs\src\test\java\org\apache\hadoop\fs\viewfs\TestViewFileSystemWithTruncate.java,80,20,2,1,2,25
 hadoop-trunk\hadoop-trunk\hadoop-yarn-project\hadoop-yarn\hadoop-yarn-server\hadoop-yarn-server-timelineservice-hbase-tests\src\test\java\org\apache\hadoop\yarn\server\timelineservice\storage\TestTimelineWriterHBaseDown.java,80,20,2,3,0,25
 hadoop-trunk\hadoop-trunk\hadoop-yarn-project\hadoop-yarn\hadoop-yarn-server\hadoop-yarn-server-timelineservice\src\main\java\org\apache\hadoop\yarn\server\timelineservice\reader\security\TimelineReaderWhitelistAuthorizationFilter.java,80,11,3,2,0,16
 hadoop-trunk\hadoop-trunk\hadoop-common-project\hadoop-common\src\test\java\org\apache\hadoop\fs\TestTruncatedInputBug.java,80,17,5,1,2,25
 hadoop-trunk\hadoop-trunk\hadoop-mapreduce-project\hadoop-mapreduce-client\hadoop-mapreduce-client-jobclient\src\test\java\org\apache\hadoop\fs\slive\Operation.java,80,22,0,1,0,23
 hadoop-trunk\hadoop-trunk\hadoop-yarn-project\hadoop-yarn\hadoop-yarn-server\hadoop-yarn-server-applicationhistoryservice\src\main\java\org\apache\hadoop\yarn\server\applicationhistoryservice\NullApplicationHistoryStore.java,80,22,6,10,0,38
 hadoop-trunk\hadoop-trunk\hadoop-hdfs-project\hadoop-hdfs\src\main\java\org\apache\hadoop\hdfs\server\diskbalancer\command\HelpCommand.java,80,7,1,1,1,10
 hadoop-trunk\hadoop-trunk\hadoop-common-project\hadoop-common\src\main\java\org\apache\hadoop\io\retry\RetryProxy.java,80,30,1,4,0,35
 hadoop-trunk\hadoop-trunk\hadoop-mapreduce-project\hadoop-mapreduce-client\hadoop-mapreduce-client-common\src\main\java\org\apache\hadoop\mapreduce\v2\api\protocolrecords\impl\pb\GetDelegationTokenResponsePBImpl.java,80,35,33,5,0,73
 hadoop-trunk\hadoop-trunk\hadoop-common-project\hadoop-common\src\main\java\org\apache\hadoop\conf\ReconfigurationException.java,80,37,0,1,0,38
 hadoop-trunk\hadoop-trunk\hadoop-common-project\hadoop-common\src\main\java\org\apache\hadoop\fs\FSLinkResolver.java,80,10,5,2,0,17
 hadoop-trunk\hadoop-trunk\hadoop-tools\hadoop-distcp\src\main\java\org\apache\hadoop\tools\util\RetriableCommand.java,80,18,1,3,0,22
 hadoop-trunk\hadoop-trunk\hadoop-yarn-project\hadoop-yarn\hadoop-yarn-common\src\main\java\org\apache\hadoop\yarn\security\ConfiguredYarnAuthorizer.java,80,23,1,3,2,29
 hadoop-trunk\hadoop-trunk\hadoop-yarn-project\hadoop-yarn\hadoop-yarn-api\src\main\java\org\apache\hadoop\yarn\api\protocolrecords\FinishApplicationMasterRequest.java,80,9,0,4,0,13
 hadoop-trunk\hadoop-trunk\hadoop-common-project\hadoop-common\src\test\java\org\apache\hadoop\fs\TestFsUrlConnectionPath.java,80,40,4,1,6,51
 hadoop-trunk\hadoop-trunk\hadoop-mapreduce-project\hadoop-mapreduce-client\hadoop-mapreduce-client-common\src\main\java\org\apache\hadoop\mapreduce\v2\security\MRDelegationTokenRenewer.java,80,18,0,3,0,21
 hadoop-trunk\hadoop-trunk\hadoop-hdfs-project\hadoop-hdfs\src\test\java\org\apache\hadoop\fs\TestSymlinkHdfsFileSystem.java,80,34,4,1,0,39
 hadoop-trunk\hadoop-trunk\hadoop-common-project\hadoop-common\src\test\java\org\apache\hadoop\conf\TestConfigurationSubclass.java,80,13,6,2,2,23
 hadoop-trunk\hadoop-trunk\hadoop-yarn-project\hadoop-yarn\hadoop-yarn-server\hadoop-yarn-server-nodemanager\src\test\java\org\apache\hadoop\yarn\server\nodemanager\containermanager\launcher\TestContainerRelaunch.java,80,3,0,4,7,14
 hadoop-trunk\hadoop-trunk\hadoop-yarn-project\hadoop-yarn\hadoop-yarn-server\hadoop-yarn-server-timelineservice\src\main\java\org\apache\hadoop\yarn\server\timelineservice\metrics\TimelineReaderMetrics.java,80,28,1,1,6,36
 hadoop-trunk\hadoop-trunk\hadoop-yarn-project\hadoop-yarn\hadoop-yarn-common\src\main\java\org\apache\hadoop\yarn\security\AdminACLsManager.java,80,11,1,1,1,14
 hadoop-trunk\hadoop-trunk\hadoop-mapreduce-project\hadoop-mapreduce-client\hadoop-mapreduce-client-common\src\main\java\org\apache\hadoop\mapreduce\v2\util\MRBuilderUtils.java,80,59,1,2,0,62
 hadoop-trunk\hadoop-trunk\hadoop-yarn-project\hadoop-yarn\hadoop-yarn-common\src\main\java\org\apache\hadoop\yarn\security\YarnAuthorizationProvider.java,80,11,2,3,3,19
 hadoop-trunk\hadoop-trunk\hadoop-common-project\hadoop-common\src\test\java\org\apache\hadoop\util\TestVersionUtil.java,80,11,2,2,0,15
 kafka-trunk\kafka-trunk\storage\src\test\java\org\apache\kafka\server\log\remote\metadata\storage\RemoteLogMetadataSerdeTest.java,80,0,0,23,0,23
 kafka-trunk\kafka-trunk\generator\src\test\java\org\apache\kafka\message\VersionsTest.java,80,0,4,4,0,8
 kafka-trunk\kafka-trunk\streams\src\main\java\org\apache\kafka\streams\processor\internals\WindowedChangelogTopicConfig.java,80,0,0,16,0,16
 kafka-trunk\kafka-trunk\clients\src\main\java\org\apache\kafka\clients\admin\ProducerState.java,80,0,2,3,0,5
 kafka-trunk\kafka-trunk\metadata\src\test\java\org\apache\kafka\timeline\TimelineHashSetTest.java,80,0,2,1,1,4
 kafka-trunk\kafka-trunk\clients\src\generated\java\org\apache\kafka\common\message\UpdateFeaturesRequestDataJsonConverter.java,80,0,0,21,0,21
 kafka-trunk\kafka-trunk\clients\src\test\java\org\apache\kafka\common\network\KafkaChannelTest.java,80,0,0,16,0,16
 kafka-trunk\kafka-trunk\connect\runtime\src\main\java\org\apache\kafka\connect\tools\VerifiableSinkTask.java,80,0,1,9,0,10
 kafka-trunk\kafka-trunk\connect\runtime\src\test\java\org\apache\kafka\connect\runtime\StateTrackerTest.java,80,0,2,31,1,34
 kafka-trunk\kafka-trunk\metadata\src\generated\java\org\apache\kafka\common\metadata\AccessControlRecordJsonConverter.java,80,0,0,16,0,16
 kafka-trunk\kafka-trunk\raft\src\main\java\org\apache\kafka\raft\internals\BatchMemoryPool.java,80,0,0,3,0,3
 pulsar-master\pulsar-master\pulsar-io\core\src\main\java\org\apache\pulsar\io\core\BatchPushSource.java,80,16,0,4,0,20
 pulsar-master\pulsar-master\pulsar-common\src\main\java\org\apache\pulsar\common\util\CompletableFutureCancellationHandler.java,80,23,2,14,0,39
 pulsar-master\pulsar-master\tiered-storage\jcloud\src\test\java\org\apache\bookkeeper\mledger\offload\jcloud\provider\JCloudBlobStoreProviderTests.java,80,46,2,14,0,62
 pulsar-master\pulsar-master\pulsar-common\src\main\java-templates\org\apache\pulsar\PulsarVersion.java,80,30,3,10,0,43
 pulsar-master\pulsar-master\pulsar-broker\src\test\java\org\apache\pulsar\client\api\ConsumerAckListTest.java,80,24,0,4,0,28
 pulsar-master\pulsar-master\bouncy-castle\bcfips-include-test\src\test\java\org\apache\pulsar\client\TlsProducerConsumerBase.java,80,39,6,14,0,59
 pulsar-master\pulsar-master\pulsar-client\src\test\java\org\apache\pulsar\client\impl\schema\ProtobufNativeSchemaTest.java,80,41,3,29,0,73
 pulsar-master\pulsar-master\pulsar-sql\presto-pulsar\src\test\java\org\apache\pulsar\sql\presto\TestPulsarConnectorConfig.java,80,25,6,21,0,52
 pulsar-master\pulsar-master\pulsar-broker\src\test\java\org\apache\pulsar\client\api\TlsProducerConsumerBase.java,80,38,6,14,0,58
 pulsar-master\pulsar-master\pulsar-client\src\main\java\org\apache\pulsar\client\impl\MultiMessageIdImpl.java,80,16,0,7,0,23
 pulsar-master\pulsar-master\pulsar-client\src\main\java\org\apache\pulsar\client\impl\auth\oauth2\protocol\DefaultMetadataResolver.java,80,23,0,5,0,28
 rocketmq-develop\rocketmq-develop\example\src\main\java\org\apache\rocketmq\example\operation\Producer.java,80,9,1,3,1,14
 rocketmq-develop\rocketmq-develop\common\src\main\java\org\apache\rocketmq\common\protocol\body\ConsumeQueueData.java,80,58,0,1,0,59
 rocketmq-develop\rocketmq-develop\test\src\test\java\org\apache\rocketmq\test\client\producer\order\OrderMsgDynamicRebalanceIT.java,80,28,1,16,5,50
 rocketmq-develop\rocketmq-develop\broker\src\main\java\org\apache\rocketmq\broker\client\ClientChannelInfo.java,80,47,5,7,0,59
 rocketmq-develop\rocketmq-develop\test\src\test\java\org\apache\rocketmq\test\client\consumer\tag\TagMessageWithSameGroupConsumerIT.java,80,24,1,7,0,32
 rocketmq-develop\rocketmq-develop\client\src\main\java\org\apache\rocketmq\client\Validators.java,80,28,1,14,0,43
 rocketmq-develop\rocketmq-develop\tools\src\main\java\org\apache\rocketmq\tools\command\topic\UpdateOrderConfCommand.java,80,17,0,12,2,31
 skywalking-master\skywalking-master\oap-server\server-receiver-plugin\zipkin-receiver-plugin\src\main\java\org\apache\skywalking\oap\server\receiver\zipkin\handler\ZipkinSpanHTTPHandler.java,80,48,0,15,0,63
 skywalking-master\skywalking-master\oap-server\server-receiver-plugin\skywalking-browser-receiver-plugin\src\main\java\org\apache\skywalking\oap\server\receiver\browser\provider\parser\errorlog\listener\ErrorLogRecordListener.java,80,31,0,20,0,51
 skywalking-master\skywalking-master\oap-server\server-storage-plugin\storage-jdbc-hikaricp-plugin\src\main\java\org\apache\skywalking\oap\server\storage\plugin\jdbc\h2\dao\H2BatchDAO.java,80,31,5,11,0,47
 skywalking-master\skywalking-master\oap-server\server-configuration\configuration-etcd\src\main\java\org\apache\skywalking\oap\server\configuration\etcd\EtcdConfigWatcherRegister.java,80,21,0,17,0,38
 zookeeper-master\zookeeper-master\zookeeper-server\src\main\java\org\apache\zookeeper\common\AtomicFileOutputStream.java,80,0,1,5,0,6
 zookeeper-master\zookeeper-master\zookeeper-server\src\main\java\org\apache\zookeeper\server\watch\PathParentIterator.java,80,0,4,3,0,7
 zookeeper-master\zookeeper-master\zookeeper-contrib\zookeeper-contrib-rest\src\main\java\org\apache\zookeeper\server\jersey\jaxb\ZStat.java,80,0,0,1,1,2
 dubbo-3.0\dubbo-3.0\dubbo-test\dubbo-test-check\src\main\java\org\apache\dubbo\test\check\registrycenter\processor\FindPidWindowsProcessor.java,81,24,6,16,3,49
 dubbo-3.0\dubbo-3.0\dubbo-rpc\dubbo-rpc-triple\src\test\java\org\apache\dubbo\rpc\protocol\tri\TriplePathResolverTest.java,81,14,1,2,0,17
 dubbo-3.0\dubbo-3.0\dubbo-compatible\src\test\java\org\apache\dubbo\cache\CacheTest.java,81,10,2,3,0,15
 dubbo-3.0\dubbo-3.0\dubbo-config\dubbo-config-api\src\main\java\org\apache\dubbo\config\utils\CompositeReferenceCache.java,81,28,0,4,0,32
 hadoop-trunk\hadoop-trunk\hadoop-yarn-project\hadoop-yarn\hadoop-yarn-server\hadoop-yarn-server-resourcemanager\src\test\java\org\apache\hadoop\yarn\server\resourcemanager\TestApplicationMasterServiceFair.java,81,11,0,7,0,18
 hadoop-trunk\hadoop-trunk\hadoop-hdfs-project\hadoop-hdfs\src\main\java\org\apache\hadoop\hdfs\server\diskbalancer\DiskBalancerException.java,81,30,0,1,0,31
 hadoop-trunk\hadoop-trunk\hadoop-yarn-project\hadoop-yarn\hadoop-yarn-server\hadoop-yarn-server-resourcemanager\src\main\java\org\apache\hadoop\yarn\server\resourcemanager\scheduler\capacity\queuemanagement\DeactivatedLeafQueuesByLabel.java,81,51,2,8,2,63
 hadoop-trunk\hadoop-trunk\hadoop-yarn-project\hadoop-yarn\hadoop-yarn-server\hadoop-yarn-server-resourcemanager\src\test\java\org\apache\hadoop\yarn\server\resourcemanager\scheduler\fair\TestVisitedResourceRequestTracker.java,81,26,10,2,7,45
 hadoop-trunk\hadoop-trunk\hadoop-tools\hadoop-fs2img\src\test\java\org\apache\hadoop\hdfs\server\namenode\TestFSTreeWalk.java,81,0,0,1,0,1
 hadoop-trunk\hadoop-trunk\hadoop-yarn-project\hadoop-yarn\hadoop-yarn-common\src\test\java\org\apache\hadoop\yarn\webapp\hamlet2\TestHamletImpl.java,81,8,3,1,1,13
 hadoop-trunk\hadoop-trunk\hadoop-hdfs-project\hadoop-hdfs-httpfs\src\test\java\org\apache\hadoop\lib\servlet\TestMDCFilter.java,81,10,0,4,4,18
 hadoop-trunk\hadoop-trunk\hadoop-common-project\hadoop-common\src\test\java\org\apache\hadoop\metrics2\impl\TestStatsDMetrics.java,81,21,11,1,0,33
 hadoop-trunk\hadoop-trunk\hadoop-common-project\hadoop-common\src\main\java\org\apache\hadoop\fs\permission\PermissionStatus.java,81,62,2,1,2,67
 hadoop-trunk\hadoop-trunk\hadoop-tools\hadoop-aws\src\main\java\org\apache\hadoop\fs\s3a\audit\impl\NoopSpan.java,81,9,0,1,0,10
 hadoop-trunk\hadoop-trunk\hadoop-tools\hadoop-aws\src\main\java\org\apache\hadoop\fs\s3a\S3ALocatedFileStatus.java,81,15,2,2,0,19
 hadoop-trunk\hadoop-trunk\hadoop-yarn-project\hadoop-yarn\hadoop-yarn-common\src\main\java\org\apache\hadoop\yarn\util\YarnVersionInfo.java,81,16,1,1,0,18
 hadoop-trunk\hadoop-trunk\hadoop-tools\hadoop-azure\src\test\java\org\apache\hadoop\fs\azurebfs\ITestAzureBlobFileSystemE2EScale.java,81,10,1,1,3,15
 hadoop-trunk\hadoop-trunk\hadoop-common-project\hadoop-common\src\test\java\org\apache\hadoop\security\TestKDiagNoKDC.java,81,30,21,4,0,55
 hadoop-trunk\hadoop-trunk\hadoop-tools\hadoop-aws\src\main\java\org\apache\hadoop\fs\s3a\statistics\impl\AwsStatisticsCollector.java,81,7,0,1,0,8
 hadoop-trunk\hadoop-trunk\hadoop-yarn-project\hadoop-yarn\hadoop-yarn-common\src\main\java\org\apache\hadoop\yarn\client\api\TimelineReaderClient.java,81,3,0,1,0,4
 hadoop-trunk\hadoop-trunk\hadoop-mapreduce-project\hadoop-mapreduce-client\hadoop-mapreduce-client-jobclient\src\test\java\org\apache\hadoop\mapreduce\lib\partition\TestBinaryPartitioner.java,81,93,4,1,0,98
 hadoop-trunk\hadoop-trunk\hadoop-common-project\hadoop-common\src\test\java\org\apache\hadoop\crypto\TestOpensslCipher.java,81,37,2,1,2,42
 hadoop-trunk\hadoop-trunk\hadoop-yarn-project\hadoop-yarn\hadoop-yarn-applications\hadoop-yarn-services\hadoop-yarn-services-core\src\main\java\org\apache\hadoop\yarn\service\monitor\probe\Probe.java,81,23,2,1,0,26
 hadoop-trunk\hadoop-trunk\hadoop-yarn-project\hadoop-yarn\hadoop-yarn-server\hadoop-yarn-server-resourcemanager\src\main\java\org\apache\hadoop\yarn\server\resourcemanager\webapp\dao\QueueCapacitiesInfo.java,81,31,2,4,2,39
 hadoop-trunk\hadoop-trunk\hadoop-common-project\hadoop-common\src\test\java\org\apache\hadoop\fs\shell\TestCommandFactory.java,81,39,4,1,1,45
 hadoop-trunk\hadoop-trunk\hadoop-tools\hadoop-azure\src\test\java\org\apache\hadoop\fs\azurebfs\services\TestExponentialRetryPolicy.java,81,15,2,11,4,32
 hadoop-trunk\hadoop-trunk\hadoop-yarn-project\hadoop-yarn\hadoop-yarn-server\hadoop-yarn-server-web-proxy\src\test\java\org\apache\hadoop\yarn\server\webproxy\TestAppReportFetcher.java,81,23,4,1,6,34
 hadoop-trunk\hadoop-trunk\hadoop-hdfs-project\hadoop-hdfs\src\test\java\org\apache\hadoop\hdfs\server\datanode\TestDataNodeUUID.java,81,4,1,1,1,7
 hadoop-trunk\hadoop-trunk\hadoop-tools\hadoop-aws\src\test\java\org\apache\hadoop\fs\s3a\auth\delegation\ITestRoleDelegationTokens.java,81,6,1,6,0,13
 hadoop-trunk\hadoop-trunk\hadoop-hdfs-project\hadoop-hdfs\src\test\java\org\apache\hadoop\hdfs\server\common\blockaliasmap\impl\TestLevelDbMockAliasMapClient.java,81,20,2,2,2,26
 hadoop-trunk\hadoop-trunk\hadoop-common-project\hadoop-common\src\main\java\org\apache\hadoop\fs\FileSystemLinkResolver.java,81,10,5,1,0,16
 hadoop-trunk\hadoop-trunk\hadoop-yarn-project\hadoop-yarn\hadoop-yarn-server\hadoop-yarn-server-resourcemanager\src\test\java\org\apache\hadoop\yarn\server\resourcemanager\RMDelegationTokenIdentifierForTest.java,81,24,27,3,0,54
 hadoop-trunk\hadoop-trunk\hadoop-hdfs-project\hadoop-hdfs\src\test\java\org\apache\hadoop\hdfs\server\datanode\TestDataNodeExit.java,81,22,0,1,0,23
 hadoop-trunk\hadoop-trunk\hadoop-mapreduce-project\hadoop-mapreduce-client\hadoop-mapreduce-client-common\src\main\java\org\apache\hadoop\mapreduce\v2\api\records\JobId.java,81,27,6,1,0,34
 hadoop-trunk\hadoop-trunk\hadoop-common-project\hadoop-common\src\main\java\org\apache\hadoop\io\serializer\JavaSerialization.java,81,13,1,1,5,20
 hadoop-trunk\hadoop-trunk\hadoop-yarn-project\hadoop-yarn\hadoop-yarn-server\hadoop-yarn-server-timelineservice\src\test\java\org\apache\hadoop\yarn\server\timelineservice\reader\TestTimelineUIDConverter.java,81,9,3,1,0,13
 hadoop-trunk\hadoop-trunk\hadoop-yarn-project\hadoop-yarn\hadoop-yarn-applications\hadoop-yarn-services\hadoop-yarn-services-core\src\main\java\org\apache\hadoop\yarn\service\utils\ServiceRegistryUtils.java,81,14,2,1,0,17
 hadoop-trunk\hadoop-trunk\hadoop-hdfs-project\hadoop-hdfs\src\test\java\org\apache\hadoop\hdfs\server\blockmanagement\TestProvidedStorageMap.java,81,10,7,1,1,19
 kafka-trunk\kafka-trunk\streams\src\test\java\org\apache\kafka\streams\kstream\internals\KStreamFlatMapValuesTest.java,81,0,3,19,1,23
 kafka-trunk\kafka-trunk\streams\src\test\java\org\apache\kafka\streams\tests\StreamsNamedRepartitionTest.java,81,0,1,20,0,21
 kafka-trunk\kafka-trunk\clients\src\test\java\org\apache\kafka\common\utils\ByteBufferOutputStreamTest.java,81,0,0,7,7,14
 kafka-trunk\kafka-trunk\clients\src\main\java\org\apache\kafka\common\requests\AlterClientQuotasResponse.java,81,0,0,10,2,12
 kafka-trunk\kafka-trunk\streams\src\test\java\org\apache\kafka\streams\kstream\internals\TimestampedTupleForwarderTest.java,81,0,0,20,0,20
 kafka-trunk\kafka-trunk\connect\runtime\src\main\java\org\apache\kafka\connect\runtime\Connect.java,81,0,0,3,1,4
 kafka-trunk\kafka-trunk\clients\src\main\java\org\apache\kafka\common\requests\IncrementalAlterConfigsRequest.java,81,0,62,19,3,84
 kafka-trunk\kafka-trunk\clients\src\test\java\org\apache\kafka\clients\admin\DeleteConsumerGroupOffsetsResultTest.java,81,0,1,14,2,17
 kafka-trunk\kafka-trunk\streams\test-utils\src\test\java\org\apache\kafka\streams\WindowStoreFacadeTest.java,81,0,0,3,0,3
 kafka-trunk\kafka-trunk\clients\src\main\java\org\apache\kafka\clients\admin\DescribeLogDirsResult.java,81,0,0,23,1,24
 kafka-trunk\kafka-trunk\clients\src\test\java\org\apache\kafka\common\requests\DeleteAclsRequestTest.java,81,0,4,17,0,21
 kafka-trunk\kafka-trunk\clients\src\main\java\org\apache\kafka\common\TopicPartitionInfo.java,81,0,2,9,2,13
 pulsar-master\pulsar-master\pulsar-common\src\main\java\org\apache\pulsar\common\policies\data\PersistentOfflineTopicStats.java,81,56,0,5,0,61
 pulsar-master\pulsar-master\pulsar-common\src\test\java\org\apache\pulsar\common\util\collections\FieldParserTest.java,81,10,3,2,0,15
 pulsar-master\pulsar-master\pulsar-broker\src\main\java\org\apache\pulsar\broker\stats\AllocatorStatsGenerator.java,81,9,1,3,0,13
 pulsar-master\pulsar-master\managed-ledger\src\test\java\org\apache\bookkeeper\mledger\util\PositionAckSetUtilTest.java,81,25,0,7,0,32
 pulsar-master\pulsar-master\pulsar-broker\src\main\java\org\apache\pulsar\PulsarTransactionCoordinatorMetadataSetup.java,81,25,1,15,0,41
 pulsar-master\pulsar-master\pulsar-client\src\main\java\org\apache\pulsar\client\impl\schema\IntSchema.java,81,26,1,3,0,30
 pulsar-master\pulsar-master\pulsar-metadata\src\main\java\org\apache\pulsar\metadata\coordination\impl\CoordinationServiceImpl.java,81,25,1,7,0,33
 pulsar-master\pulsar-master\pulsar-broker\src\test\java\org\apache\pulsar\broker\service\BkEnsemblesTestBase.java,81,26,2,7,0,35
 pulsar-master\pulsar-master\pulsar-common\src\test\java\org\apache\pulsar\common\util\CmdGenerateDocsTest.java,81,8,4,2,0,14
 pulsar-master\pulsar-master\pulsar-client\src\main\java\org\apache\pulsar\client\impl\schema\generic\JsonRecordBuilderImpl.java,81,14,0,2,0,16
 pulsar-master\pulsar-master\pulsar-client\src\main\java\org\apache\pulsar\client\impl\schema\FloatSchema.java,81,26,1,3,0,30
 pulsar-master\pulsar-master\pulsar-broker\src\test\java\org\apache\pulsar\socks5\handler\CommandRequestHandler.java,81,36,0,15,0,51
 pulsar-master\pulsar-master\pulsar-broker\src\test\java\org\apache\pulsar\client\impl\SchemaDeleteTest.java,81,17,0,10,0,27
 pulsar-master\pulsar-master\pulsar-broker-common\src\main\java\org\apache\pulsar\broker\stats\prometheus\PrometheusMetricsServlet.java,81,38,1,13,0,52
 rocketmq-develop\rocketmq-develop\test\src\test\java\org\apache\rocketmq\test\client\consumer\balance\NormalMsgDynamicBalanceIT.java,81,22,1,13,1,37
 rocketmq-develop\rocketmq-develop\namesrv\src\test\java\org\apache\rocketmq\namesrv\routeinfo\RouteInfoManagerBrokerPermTest.java,81,27,2,8,5,42
 rocketmq-develop\rocketmq-develop\tools\src\main\java\org\apache\rocketmq\tools\command\broker\UpdateBrokerConfigSubCommand.java,81,16,0,9,3,28
 rocketmq-develop\rocketmq-develop\store\src\test\java\org\apache\rocketmq\store\StoreStatsServiceTest.java,81,21,5,11,1,38
 rocketmq-develop\rocketmq-develop\common\src\main\java\org\apache\rocketmq\common\protocol\header\ConsumerSendMsgBackRequestHeader.java,81,51,1,3,0,55
 shardingsphere-master\shardingsphere-master\shardingsphere-test\shardingsphere-integration-test\shardingsphere-integration-test-suite\src\test\java\org\apache\shardingsphere\test\integration\engine\dql\BaseDQLIT.java,81,38,5,29,0,72
 skywalking-master\skywalking-master\oap-server\server-core\src\main\java\org\apache\skywalking\oap\server\core\analysis\worker\TopNWorker.java,81,26,7,9,0,42
 skywalking-master\skywalking-master\oap-server\server-library\library-datacarrier-queue\src\main\java\org\apache\skywalking\oap\server\library\datacarrier\consumer\ConsumerThread.java,81,21,2,2,0,25
 zookeeper-master\zookeeper-master\zookeeper-contrib\zookeeper-contrib-rest\src\test\java\org\apache\zookeeper\server\jersey\GetTest.java,81,0,2,3,4,9
 zookeeper-master\zookeeper-master\zookeeper-server\src\test\java\org\apache\zookeeper\test\CreateTest.java,81,0,23,10,1,34
 zookeeper-master\zookeeper-master\zookeeper-contrib\zookeeper-contrib-zooinspector\src\test\java\org\apache\zookeeper\inspector\manager\ZooInspectorManagerImplTest.java,81,0,6,8,0,14
 backendApi-main\backendApi-main\src\main\java\com\consultadd\CRUD\model\Student.java,82,83,4,2,0,89
 dubbo-3.0\dubbo-3.0\dubbo-compatible\src\main\java\com\alibaba\dubbo\common\utils\UrlUtils.java,82,76,1,26,0,103
 dubbo-3.0\dubbo-3.0\dubbo-cluster\src\main\java\org\apache\dubbo\rpc\cluster\loadbalance\LeastActiveLoadBalance.java,82,21,0,16,0,37
 dubbo-3.0\dubbo-3.0\dubbo-common\src\main\java\org\apache\dubbo\common\logger\log4j2\Log4j2LoggerAdapter.java,82,14,5,1,0,20
 dubbo-3.0\dubbo-3.0\dubbo-common\src\test\java\org\apache\dubbo\rpc\model\FrameworkModelTest.java,82,25,0,21,0,46
 dubbo-3.0\dubbo-3.0\dubbo-common\src\main\java\org\apache\dubbo\rpc\model\FrameworkServiceRepository.java,82,44,2,11,2,59
 dubbo-3.0\dubbo-3.0\dubbo-cluster\src\main\java\org\apache\dubbo\rpc\cluster\loadbalance\RandomLoadBalance.java,82,21,0,12,0,33
 file-management-system-master\file-management-system-master\src\main\java\com\fms\controller\UploadFileController.java,82,50,1,13,2,66
 hadoop-trunk\hadoop-trunk\hadoop-yarn-project\hadoop-yarn\hadoop-yarn-server\hadoop-yarn-server-resourcemanager\src\main\java\org\apache\hadoop\yarn\server\resourcemanager\scheduler\capacity\AppPriorityACLGroup.java,82,34,2,1,6,43
 hadoop-trunk\hadoop-trunk\hadoop-mapreduce-project\hadoop-mapreduce-client\hadoop-mapreduce-client-jobclient\src\test\java\org\apache\hadoop\mapreduce\lib\input\TestMRSequenceFileAsBinaryInputFormat.java,82,14,3,1,4,22
 hadoop-trunk\hadoop-trunk\hadoop-hdfs-project\hadoop-hdfs\src\test\java\org\apache\hadoop\hdfs\TestRollingUpgradeDowngrade.java,82,2,2,1,1,6
 hadoop-trunk\hadoop-trunk\hadoop-common-project\hadoop-common\src\test\java\org\apache\hadoop\io\TestWritableName.java,82,25,6,1,0,32
 hadoop-trunk\hadoop-trunk\hadoop-common-project\hadoop-common\src\main\java\org\apache\hadoop\io\ShortWritable.java,82,27,7,1,0,35
 hadoop-trunk\hadoop-trunk\hadoop-common-project\hadoop-common\src\main\java\org\apache\hadoop\net\StandardSocketFactory.java,82,29,4,1,0,34
 hadoop-trunk\hadoop-trunk\hadoop-common-project\hadoop-common\src\main\java\org\apache\hadoop\conf\ConfServlet.java,82,22,1,1,0,24
 hadoop-trunk\hadoop-trunk\hadoop-yarn-project\hadoop-yarn\hadoop-yarn-server\hadoop-yarn-server-sharedcachemanager\src\test\java\org\apache\hadoop\yarn\server\sharedcachemanager\TestSCMAdminProtocolService.java,82,22,0,7,7,36
 hadoop-trunk\hadoop-trunk\hadoop-common-project\hadoop-common\src\test\java\org\apache\hadoop\cli\util\CLITestData.java,82,18,11,1,6,36
 hadoop-trunk\hadoop-trunk\hadoop-mapreduce-project\hadoop-mapreduce-client\hadoop-mapreduce-client-nativetask\src\test\java\org\apache\hadoop\mapred\nativetask\testutil\BytesFactory.java,82,31,2,1,2,36
 hadoop-trunk\hadoop-trunk\hadoop-mapreduce-project\hadoop-mapreduce-client\hadoop-mapreduce-client-jobclient\src\test\java\org\apache\hadoop\mapreduce\lib\input\TestMRSequenceFileAsTextInputFormat.java,82,18,3,2,2,25
 hadoop-trunk\hadoop-trunk\hadoop-mapreduce-project\hadoop-mapreduce-client\hadoop-mapreduce-client-app\src\main\java\org\apache\hadoop\mapreduce\v2\app\speculate\DataStatistics.java,82,21,3,1,0,25
 hadoop-trunk\hadoop-trunk\hadoop-common-project\hadoop-common\src\test\java\org\apache\hadoop\util\TestLightWeightGSet.java,82,30,4,1,0,35
 hadoop-trunk\hadoop-trunk\hadoop-yarn-project\hadoop-yarn\hadoop-yarn-common\src\test\java\org\apache\hadoop\yarn\event\DrainDispatcher.java,82,11,2,1,2,16
 hadoop-trunk\hadoop-trunk\hadoop-hdfs-project\hadoop-hdfs\src\main\java\org\apache\hadoop\hdfs\tools\offlineEditsViewer\StatisticsEditsVisitor.java,82,22,1,1,1,25
 hadoop-trunk\hadoop-trunk\hadoop-yarn-project\hadoop-yarn\hadoop-yarn-csi\src\main\java\org\apache\hadoop\yarn\csi\adaptor\DefaultCsiAdaptorImpl.java,82,17,18,3,0,38
 hadoop-trunk\hadoop-trunk\hadoop-yarn-project\hadoop-yarn\hadoop-yarn-server\hadoop-yarn-server-resourcemanager\src\main\java\org\apache\hadoop\yarn\server\resourcemanager\scheduler\ResourceLimits.java,82,44,3,1,11,59
 kafka-trunk\kafka-trunk\clients\src\generated\java\org\apache\kafka\common\message\FindCoordinatorRequestDataJsonConverter.java,82,0,0,16,0,16
 kafka-trunk\kafka-trunk\connect\runtime\src\main\java\org\apache\kafka\connect\runtime\rest\entities\ConfigValueInfo.java,82,0,2,1,4,7
 kafka-trunk\kafka-trunk\trogdor\src\main\java\org\apache\kafka\trogdor\basic\BasicNode.java,82,0,6,3,3,12
 kafka-trunk\kafka-trunk\streams\src\test\java\org\apache\kafka\streams\processor\internals\TopicPartitionMetadataTest.java,82,0,0,14,0,14
 kafka-trunk\kafka-trunk\metadata\src\generated\java\org\apache\kafka\common\metadata\AccessControlEntryRecordJsonConverter.java,82,0,0,20,0,20
 kafka-trunk\kafka-trunk\streams\src\test\java\org\apache\kafka\streams\processor\internals\ClientUtilsTest.java,82,0,9,26,0,35
 kafka-trunk\kafka-trunk\trogdor\src\main\java\org\apache\kafka\trogdor\basic\BasicPlatform.java,82,0,2,5,0,7
 kafka-trunk\kafka-trunk\clients\src\generated\java\org\apache\kafka\common\message\DescribeLogDirsRequestDataJsonConverter.java,82,0,0,19,0,19
 kafka-trunk\kafka-trunk\streams\src\main\java\org\apache\kafka\streams\kstream\internals\WrappingNullableUtils.java,82,0,3,23,0,26
 kafka-trunk\kafka-trunk\clients\src\test\java\org\apache\kafka\clients\admin\RemoveMembersFromConsumerGroupResultTest.java,82,0,0,19,1,20
 kafka-trunk\kafka-trunk\clients\src\main\java\org\apache\kafka\common\quota\ClientQuotaAlteration.java,82,0,2,3,2,7
 kafka-trunk\kafka-trunk\clients\src\test\java\org\apache\kafka\clients\producer\internals\StickyPartitionCacheTest.java,82,0,0,21,0,21
 pulsar-master\pulsar-master\tests\integration\src\test\java\org\apache\pulsar\tests\integration\proxy\TestProxyWithWebSocket.java,82,29,5,6,0,40
 pulsar-master\pulsar-master\pulsar-io\batch-data-generator\src\main\java\org\apache\pulsar\io\batchdatagenerator\Person.java,82,41,2,2,0,45
 pulsar-master\pulsar-master\pulsar-broker\src\test\java\org\apache\pulsar\broker\service\persistent\ReplicatedSubscriptionSnapshotCacheTest.java,82,32,0,13,0,45
 pulsar-master\pulsar-master\pulsar-package-management\core\src\test\java\org\apache\pulsar\packages\management\core\MockedPackagesStorage.java,82,22,3,5,0,30
 pulsar-master\pulsar-master\tests\integration\src\test\java\org\apache\pulsar\tests\integration\io\sinks\KafkaSinkTester.java,82,20,1,8,0,29
 pulsar-master\pulsar-master\pulsar-broker\src\main\java\org\apache\pulsar\broker\service\schema\DefaultSchemaRegistryService.java,82,59,1,18,0,78
 pulsar-master\pulsar-master\pulsar-websocket\src\main\java\org\apache\pulsar\websocket\admin\WebSocketProxyStatsBase.java,82,16,1,9,0,26
 pulsar-master\pulsar-master\managed-ledger\src\main\java\org\apache\bookkeeper\mledger\util\AbstractCASReferenceCounted.java,82,26,1,10,0,37
 pulsar-master\pulsar-master\pulsar-io\redis\src\main\java\org\apache\pulsar\io\redis\RedisAbstractConfig.java,82,21,0,5,0,26
 pulsar-master\pulsar-master\pulsar-functions\utils\src\main\java\org\apache\pulsar\functions\utils\functions\FunctionUtils.java,82,25,4,14,0,43
 pulsar-master\pulsar-master\pulsar-metadata\src\test\java\org\apache\pulsar\metadata\bookkeeper\PulsarLedgerAuditorManagerTest.java,82,17,3,7,0,27
 pulsar-master\pulsar-master\pulsar-common\src\main\java\org\apache\pulsar\common\util\netty\EventLoopUtil.java,82,29,3,14,0,46
 rocketmq-develop\rocketmq-develop\common\src\test\java\org\apache\rocketmq\common\protocol\QueryConsumeTimeSpanBodyTest.java,82,50,0,31,1,82
 rocketmq-develop\rocketmq-develop\common\src\test\java\org\apache\rocketmq\common\MixAllTest.java,82,19,4,6,9,38
 rocketmq-develop\rocketmq-develop\broker\src\main\java\org\apache\rocketmq\broker\transaction\AbstractTransactionalMessageCheckListener.java,82,41,1,17,3,62
 rocketmq-develop\rocketmq-develop\tools\src\main\java\org\apache\rocketmq\tools\command\topic\TopicRouteSubCommand.java,82,20,1,9,1,31
 rocketmq-develop\rocketmq-develop\tools\src\test\java\org\apache\rocketmq\tools\command\message\QueryMsgTraceByIdSubCommandTest.java,82,19,2,10,2,33
 rocketmq-develop\rocketmq-develop\tools\src\main\java\org\apache\rocketmq\tools\command\acl\DeleteAccessConfigSubCommand.java,82,18,0,10,1,29
 shardingsphere-master\shardingsphere-master\shardingsphere-test\shardingsphere-integration-test\shardingsphere-integration-test-suite\src\test\java\org\apache\shardingsphere\test\integration\engine\dml\BaseDMLIT.java,82,35,0,30,0,65
 shardingsphere-master\shardingsphere-master\shardingsphere-proxy\shardingsphere-proxy-backend\src\main\java\org\apache\shardingsphere\proxy\backend\communication\jdbc\executor\callback\ProxyJDBCExecutorCallback.java,82,44,3,30,0,77
 skywalking-master\skywalking-master\oap-server\server-receiver-plugin\skywalking-browser-receiver-plugin\src\main\java\org\apache\skywalking\oap\server\receiver\browser\provider\BrowserModuleProvider.java,82,24,2,28,0,54
 skywalking-master\skywalking-master\oap-server\server-receiver-plugin\envoy-metrics-receiver-plugin\src\test\java\org\apache\skywalking\oap\server\receiver\envoy\als\k8s\ServiceNameFormatterTest.java,82,16,0,10,0,26
 skywalking-master\skywalking-master\oap-server\server-receiver-plugin\envoy-metrics-receiver-plugin\src\main\java\org\apache\skywalking\oap\server\receiver\envoy\als\tcp\TCPLogEntry2MetricsAdapter.java,82,20,0,16,0,36
 skywalking-master\skywalking-master\test\e2e-v2\java-test-service\e2e-mock-sender\src\main\java\org\apache\skywalking\e2e\controller\MeterMetricSenderController.java,82,30,1,21,0,52
 skywalking-master\skywalking-master\oap-server\server-core\src\main\java\org\apache\skywalking\oap\server\core\config\ComponentLibraryCatalogService.java,82,25,1,11,0,37
 zookeeper-master\zookeeper-master\zookeeper-server\src\test\java\org\apache\zookeeper\server\ServerMetricsTest.java,82,0,0,2,1,3
 zookeeper-master\zookeeper-master\zookeeper-server\src\test\java\org\apache\zookeeper\server\quorum\LearnerHandlerMetricsTest.java,82,0,7,11,2,20
 dubbo-3.0\dubbo-3.0\dubbo-config\dubbo-config-spring\src\main\java\org\apache\dubbo\config\spring\context\DubboSpringInitContext.java,83,45,1,6,0,52
 dubbo-3.0\dubbo-3.0\dubbo-rpc\dubbo-rpc-dubbo\src\main\java\org\apache\dubbo\rpc\protocol\dubbo\filter\TraceFilter.java,83,33,2,16,0,51
 dubbo-3.0\dubbo-3.0\dubbo-metadata\dubbo-metadata-processor\src\test\java\org\apache\dubbo\metadata\annotation\processing\builder\ArrayTypeDefinitionBuilderTest.java,83,37,1,20,0,58
 dubbo-3.0\dubbo-3.0\dubbo-rpc\dubbo-rpc-api\src\test\java\org\apache\dubbo\rpc\filter\tps\StatItemTest.java,83,30,3,3,0,36
 hadoop-trunk\hadoop-trunk\hadoop-yarn-project\hadoop-yarn\hadoop-yarn-server\hadoop-yarn-server-resourcemanager\src\test\java\org\apache\hadoop\yarn\server\resourcemanager\scheduler\fair\TestQueueManagerRealScheduler.java,83,26,0,1,0,27
 hadoop-trunk\hadoop-trunk\hadoop-tools\hadoop-rumen\src\main\java\org\apache\hadoop\tools\rumen\anonymization\WordListAnonymizerUtility.java,83,40,4,1,0,45
 hadoop-trunk\hadoop-trunk\hadoop-tools\hadoop-sls\src\main\java\org\apache\hadoop\yarn\sls\AMDefinition.java,83,64,1,1,2,68
 hadoop-trunk\hadoop-trunk\hadoop-yarn-project\hadoop-yarn\hadoop-yarn-server\hadoop-yarn-server-nodemanager\src\test\java\org\apache\hadoop\yarn\server\nodemanager\containermanager\container\TestResourceMappings.java,83,11,0,1,0,12
 hadoop-trunk\hadoop-trunk\hadoop-common-project\hadoop-common\src\test\java\org\apache\hadoop\cli\util\ComparatorData.java,83,18,2,1,0,21
 hadoop-trunk\hadoop-trunk\hadoop-common-project\hadoop-common\src\test\java\org\apache\hadoop\metrics2\impl\MetricsRecords.java,83,30,1,1,0,32
 hadoop-trunk\hadoop-trunk\hadoop-hdfs-project\hadoop-hdfs\src\test\java\org\apache\hadoop\hdfs\protocol\datatransfer\TestPacketReceiver.java,83,29,4,2,2,37
 hadoop-trunk\hadoop-trunk\hadoop-yarn-project\hadoop-yarn\hadoop-yarn-api\src\main\java\org\apache\hadoop\yarn\server\api\ContainerContext.java,83,32,0,1,4,37
 hadoop-trunk\hadoop-trunk\hadoop-common-project\hadoop-common\src\main\java\org\apache\hadoop\security\alias\UserProvider.java,83,20,0,3,0,23
 hadoop-trunk\hadoop-trunk\hadoop-hdfs-project\hadoop-hdfs\src\test\java\org\apache\hadoop\hdfs\server\common\blockaliasmap\impl\TestLevelDBFileRegionAliasMap.java,83,39,0,1,2,42
 hadoop-trunk\hadoop-trunk\hadoop-mapreduce-project\hadoop-mapreduce-client\hadoop-mapreduce-client-core\src\main\java\org\apache\hadoop\mapreduce\lib\aggregate\UserDefinedValueAggregatorDescriptor.java,83,23,3,1,1,28
 hadoop-trunk\hadoop-trunk\hadoop-yarn-project\hadoop-yarn\hadoop-yarn-common\src\test\java\org\apache\hadoop\yarn\api\TestGetApplicationsRequest.java,83,24,1,2,0,27
 hadoop-trunk\hadoop-trunk\hadoop-mapreduce-project\hadoop-mapreduce-client\hadoop-mapreduce-client-jobclient\src\test\java\org\apache\hadoop\mapreduce\v2\TestMRAMWithNonNormalizedCapabilities.java,83,22,7,1,2,32
 hadoop-trunk\hadoop-trunk\hadoop-yarn-project\hadoop-yarn\hadoop-yarn-server\hadoop-yarn-server-resourcemanager\src\main\java\org\apache\hadoop\yarn\server\resourcemanager\reservation\planning\GreedyReservationAgent.java,83,23,10,2,0,35
 hadoop-trunk\hadoop-trunk\hadoop-common-project\hadoop-auth\src\test\java\org\apache\hadoop\security\authentication\client\TestPseudoAuthenticator.java,83,12,0,6,0,18
 hadoop-trunk\hadoop-trunk\hadoop-hdfs-project\hadoop-hdfs\src\main\java\org\apache\hadoop\hdfs\web\resources\ExceptionHandler.java,83,19,3,2,0,24
 hadoop-trunk\hadoop-trunk\hadoop-mapreduce-project\hadoop-mapreduce-client\hadoop-mapreduce-client-app\src\test\java\org\apache\hadoop\mapreduce\v2\app\TestMRAppComponentDependencies.java,83,24,0,1,0,25
 hadoop-trunk\hadoop-trunk\hadoop-tools\hadoop-azure\src\main\java\org\apache\hadoop\fs\azurebfs\commit\AbfsManifestStoreOperations.java,83,8,0,6,0,14
 hadoop-trunk\hadoop-trunk\hadoop-yarn-project\hadoop-yarn\hadoop-yarn-server\hadoop-yarn-server-nodemanager\src\main\java\org\apache\hadoop\yarn\server\nodemanager\containermanager\logaggregation\SampleContainerLogAggregationPolicy.java,83,34,5,2,0,41
 hadoop-trunk\hadoop-trunk\hadoop-hdfs-project\hadoop-hdfs-client\src\test\java\org\apache\hadoop\hdfs\web\oauth2\TestRefreshTokenTimeBasedTokenRefresher.java,83,14,3,5,0,22
 hadoop-trunk\hadoop-trunk\hadoop-yarn-project\hadoop-yarn\hadoop-yarn-server\hadoop-yarn-server-resourcemanager\src\main\java\org\apache\hadoop\yarn\server\resourcemanager\rmcontainer\RMContainer.java,83,40,2,2,0,44
 hadoop-trunk\hadoop-trunk\hadoop-yarn-project\hadoop-yarn\hadoop-yarn-applications\hadoop-yarn-services\hadoop-yarn-services-core\src\main\java\org\apache\hadoop\yarn\service\utils\Duration.java,83,21,2,1,0,24
 kafka-trunk\kafka-trunk\connect\runtime\src\main\java\org\apache\kafka\connect\runtime\isolation\PluginScanResult.java,83,0,0,6,18,24
 kafka-trunk\kafka-trunk\clients\src\main\java\org\apache\kafka\clients\admin\AlterConfigOp.java,83,0,2,9,0,11
 kafka-trunk\kafka-trunk\clients\src\main\java\org\apache\kafka\common\utils\Exit.java,83,0,6,6,2,14
 kafka-trunk\kafka-trunk\connect\runtime\src\test\java\org\apache\kafka\connect\integration\StartAndStopCounterTest.java,83,0,0,1,0,1
 kafka-trunk\kafka-trunk\clients\src\main\java\org\apache\kafka\clients\admin\FeatureMetadata.java,83,0,0,14,0,14
 kafka-trunk\kafka-trunk\clients\src\main\java\org\apache\kafka\common\security\oauthbearer\OAuthBearerTokenCallback.java,83,0,1,6,0,7
 kafka-trunk\kafka-trunk\clients\src\main\java\org\apache\kafka\common\security\oauthbearer\secured\LoginAccessTokenValidator.java,83,0,4,27,0,31
 kafka-trunk\kafka-trunk\clients\src\main\java\org\apache\kafka\common\TopicIdPartition.java,83,0,0,5,0,5
 kafka-trunk\kafka-trunk\storage\src\generated\java\org\apache\kafka\server\log\remote\metadata\storage\generated\RemotePartitionDeleteMetadataRecordJsonConverter.java,83,0,0,26,0,26
 pulsar-master\pulsar-master\pulsar-io\jdbc\sqlite\src\test\java\org\apache\pulsar\io\jdbc\JdbcUtilsTest.java,83,31,2,6,0,39
 pulsar-master\pulsar-master\pulsar-functions\utils\src\main\java\org\apache\pulsar\functions\utils\functioncache\FunctionCacheEntry.java,83,35,1,11,0,47
 pulsar-master\pulsar-master\pulsar-proxy\src\test\java\org\apache\pulsar\proxy\server\ProxyTlsTest.java,83,27,3,15,0,45
 pulsar-master\pulsar-master\pulsar-sql\presto-pulsar\src\main\java\org\apache\pulsar\sql\presto\PulsarInternalColumn.java,83,49,0,20,0,69
 pulsar-master\pulsar-master\pulsar-broker\src\main\java\org\apache\pulsar\broker\transaction\pendingack\impl\MLPendingAckReplyCallBack.java,83,35,3,25,0,63
 pulsar-master\pulsar-master\pulsar-client\src\main\java\org\apache\pulsar\client\impl\AuthenticationUtil.java,83,19,3,12,0,34
 pulsar-master\pulsar-master\managed-ledger\src\main\java\org\apache\bookkeeper\mledger\impl\ManagedLedgerFactoryMBeanImpl.java,83,38,0,3,0,41
 rocketmq-develop\rocketmq-develop\common\src\main\java\org\apache\rocketmq\common\PlainAccessConfig.java,83,56,0,1,4,61
 skywalking-master\skywalking-master\oap-server\server-storage-plugin\storage-influxdb-plugin\src\main\java\org\apache\skywalking\oap\server\storage\plugin\influxdb\query\AlarmQuery.java,83,28,1,14,0,43
 skywalking-master\skywalking-master\oap-server\server-storage-plugin\storage-influxdb-plugin\src\main\java\org\apache\skywalking\oap\server\storage\plugin\influxdb\query\EBPFProfilingTaskQuery.java,83,28,0,20,0,48
 skywalking-master\skywalking-master\oap-server\server-core\src\main\java\org\apache\skywalking\oap\server\core\analysis\metrics\PxxMetrics.java,83,28,0,8,0,36
 skywalking-master\skywalking-master\oap-server\server-storage-plugin\storage-iotdb-plugin\src\main\java\org\apache\skywalking\oap\server\storage\plugin\iotdb\profile\IoTDBProfileTaskQueryDAO.java,83,27,0,16,0,43
 skywalking-master\skywalking-master\oap-server\server-query-plugin\query-graphql-plugin\src\main\java\org\apache\skywalking\oap\query\graphql\resolver\LogTestQuery.java,83,18,0,14,0,32
 zookeeper-master\zookeeper-master\zookeeper-server\src\test\java\org\apache\zookeeper\test\InvalidSnapshotTest.java,83,0,4,12,0,16
 zookeeper-master\zookeeper-master\zookeeper-server\src\main\java\org\apache\zookeeper\server\quorum\LeaderBean.java,83,0,0,1,1,2
 zookeeper-master\zookeeper-master\zookeeper-server\src\test\java\org\apache\zookeeper\server\controller\ControllerClientServerTest.java,83,0,0,22,0,22
 zookeeper-master\zookeeper-master\zookeeper-server\src\test\java\org\apache\zookeeper\common\KeyStoreFileTypeTest.java,83,0,0,22,0,22
 dubbo-3.0\dubbo-3.0\dubbo-metadata\dubbo-metadata-api\src\main\java\org\apache\dubbo\metadata\report\MetadataReportInstance.java,84,40,3,18,0,61
 dubbo-3.0\dubbo-3.0\dubbo-rpc\dubbo-rpc-injvm\src\test\java\org\apache\dubbo\rpc\protocol\injvm\InjvmDeepCopyTest.java,84,22,0,14,0,36
 dubbo-3.0\dubbo-3.0\dubbo-common\src\test\java\org\apache\dubbo\common\utils\NetUtilsInterfaceDisplayNameHasMetaCharactersTest.java,84,38,6,21,4,69
 dubbo-3.0\dubbo-3.0\dubbo-remoting\dubbo-remoting-api\src\main\java\org\apache\dubbo\remoting\exchange\support\ExchangeHandlerDispatcher.java,84,50,0,7,0,57
 dubbo-3.0\dubbo-3.0\dubbo-common\src\main\java\org\apache\dubbo\common\io\UnsafeStringWriter.java,84,30,9,1,0,40
 dubbo-3.0\dubbo-3.0\dubbo-rpc\dubbo-rpc-triple\src\main\java\org\apache\dubbo\rpc\protocol\tri\transport\WriteQueue.java,84,27,1,3,0,31
 dubbo-3.0\dubbo-3.0\dubbo-common\src\test\java\org\apache\dubbo\rpc\model\ModuleServiceRepositoryTest.java,84,24,1,16,3,44
 dubbo-3.0\dubbo-3.0\dubbo-remoting\dubbo-remoting-api\src\main\java\org\apache\dubbo\remoting\exchange\support\header\HeartbeatHandler.java,84,29,0,8,0,37
 hadoop-trunk\hadoop-trunk\hadoop-hdfs-project\hadoop-hdfs\src\test\java\org\apache\hadoop\hdfs\server\namenode\TestRefreshBlockPlacementPolicy.java,84,24,3,4,2,33
 hadoop-trunk\hadoop-trunk\hadoop-yarn-project\hadoop-yarn\hadoop-yarn-server\hadoop-yarn-server-nodemanager\src\test\java\org\apache\hadoop\yarn\server\nodemanager\containermanager\linux\runtime\docker\TestDockerClient.java,84,6,0,3,5,14
 hadoop-trunk\hadoop-trunk\hadoop-yarn-project\hadoop-yarn\hadoop-yarn-common\src\main\java\org\apache\hadoop\yarn\security\client\YARNDelegationTokenIdentifier.java,84,29,37,4,0,70
 hadoop-trunk\hadoop-trunk\hadoop-hdfs-project\hadoop-hdfs\src\test\java\org\apache\hadoop\hdfs\server\namenode\TestPathComponents.java,84,16,0,1,0,17
 hadoop-trunk\hadoop-trunk\hadoop-yarn-project\hadoop-yarn\hadoop-yarn-server\hadoop-yarn-server-resourcemanager\src\main\java\org\apache\hadoop\yarn\server\resourcemanager\reservation\planning\TryManyReservationAgents.java,84,19,1,2,0,22
 hadoop-trunk\hadoop-trunk\hadoop-yarn-project\hadoop-yarn\hadoop-yarn-server\hadoop-yarn-server-resourcemanager\src\main\java\org\apache\hadoop\yarn\server\resourcemanager\webapp\dao\ReservationDefinitionInfo.java,84,45,1,1,2,49
 hadoop-trunk\hadoop-trunk\hadoop-tools\hadoop-aliyun\src\test\java\org\apache\hadoop\fs\aliyun\oss\TestAliyunOSSFileSystemStore.java,84,12,3,1,4,20
 hadoop-trunk\hadoop-trunk\hadoop-hdfs-project\hadoop-hdfs\src\main\java\org\apache\hadoop\hdfs\server\namenode\startupprogress\StartupProgressMetrics.java,84,25,4,3,2,34
 hadoop-trunk\hadoop-trunk\hadoop-hdfs-project\hadoop-hdfs-client\src\test\java\org\apache\hadoop\hdfs\web\oauth2\TestClientCredentialTimeBasedTokenRefresher.java,84,20,3,5,0,28
 hadoop-trunk\hadoop-trunk\hadoop-yarn-project\hadoop-yarn\hadoop-yarn-common\src\main\java\org\apache\hadoop\yarn\api\records\impl\pb\NodeLabelPBImpl.java,84,30,35,1,0,66
 hadoop-trunk\hadoop-trunk\hadoop-common-project\hadoop-registry\src\test\java\org\apache\hadoop\registry\AbstractRegistryTest.java,84,23,3,3,0,29
 hadoop-trunk\hadoop-trunk\hadoop-yarn-project\hadoop-yarn\hadoop-yarn-applications\hadoop-yarn-services\hadoop-yarn-services-core\src\test\java\org\apache\hadoop\yarn\service\monitor\TestServiceMonitor.java,84,11,1,1,1,14
 hadoop-trunk\hadoop-trunk\hadoop-common-project\hadoop-common\src\main\java\org\apache\hadoop\io\SetFile.java,84,62,13,3,0,78
 hadoop-trunk\hadoop-trunk\hadoop-hdfs-project\hadoop-hdfs\src\test\java\org\apache\hadoop\hdfs\server\namenode\TestAddStripedBlockInFBR.java,84,15,4,1,2,22
 hadoop-trunk\hadoop-trunk\hadoop-yarn-project\hadoop-yarn\hadoop-yarn-applications\hadoop-yarn-applications-distributedshell\src\main\java\org\apache\hadoop\yarn\applications\distributedshell\PlacementSpec.java,84,17,2,2,0,21
 hadoop-trunk\hadoop-trunk\hadoop-yarn-project\hadoop-yarn\hadoop-yarn-server\hadoop-yarn-server-resourcemanager\src\main\java\org\apache\hadoop\yarn\server\resourcemanager\monitor\capacity\TempAppPerPartition.java,84,35,0,2,4,41
 hadoop-trunk\hadoop-trunk\hadoop-hdfs-project\hadoop-hdfs\src\main\java\org\apache\hadoop\hdfs\tools\offlineImageViewer\NameDistributionVisitor.java,84,32,7,1,0,40
 hadoop-trunk\hadoop-trunk\hadoop-mapreduce-project\hadoop-mapreduce-client\hadoop-mapreduce-client-jobclient\src\test\java\org\apache\hadoop\mapred\TestStatisticsCollector.java,84,162,9,1,0,172
 hadoop-trunk\hadoop-trunk\hadoop-yarn-project\hadoop-yarn\hadoop-yarn-common\src\main\java\org\apache\hadoop\yarn\security\client\ClientToAMTokenIdentifier.java,84,29,21,2,0,52
 hadoop-trunk\hadoop-trunk\hadoop-hdfs-project\hadoop-hdfs\src\main\java\org\apache\hadoop\hdfs\server\datanode\FinalizedProvidedReplica.java,84,44,3,1,0,48
 hadoop-trunk\hadoop-trunk\hadoop-yarn-project\hadoop-yarn\hadoop-yarn-server\hadoop-yarn-server-nodemanager\src\main\java\org\apache\hadoop\yarn\server\nodemanager\containermanager\linux\resources\numa\NumaResourceHandlerImpl.java,84,21,6,7,0,34
 hadoop-trunk\hadoop-trunk\hadoop-hdfs-project\hadoop-hdfs\src\test\java\org\apache\hadoop\hdfs\qjournal\client\TestQuorumCall.java,84,35,3,2,0,40
 hadoop-trunk\hadoop-trunk\hadoop-common-project\hadoop-common\src\test\java\org\apache\hadoop\security\authentication\server\TestProxyUserAuthenticationFilter.java,84,10,2,1,1,14
 hadoop-trunk\hadoop-trunk\hadoop-mapreduce-project\hadoop-mapreduce-client\hadoop-mapreduce-client-jobclient\src\test\java\org\apache\hadoop\mapred\TestGetSplitHosts.java,84,86,7,1,0,94
 hadoop-trunk\hadoop-trunk\hadoop-tools\hadoop-azure\src\test\java\org\apache\hadoop\fs\azurebfs\services\TestAzureADAuthenticator.java,84,8,0,11,0,19
 hadoop-trunk\hadoop-trunk\hadoop-hdfs-project\hadoop-hdfs\src\main\java\org\apache\hadoop\hdfs\tools\offlineImageViewer\PBImageCorruption.java,84,22,1,1,0,24
 kafka-trunk\kafka-trunk\clients\src\main\java\org\apache\kafka\common\security\oauthbearer\secured\SerializedJwt.java,84,0,5,8,0,13
 kafka-trunk\kafka-trunk\metadata\src\test\java\org\apache\kafka\metadata\authorizer\StandardAclTest.java,84,0,4,3,0,7
 kafka-trunk\kafka-trunk\clients\src\test\java\org\apache\kafka\common\UuidTest.java,84,0,0,5,0,5
 kafka-trunk\kafka-trunk\connect\runtime\src\test\java\org\apache\kafka\connect\runtime\RestartRequestTest.java,84,0,1,29,0,30
 kafka-trunk\kafka-trunk\streams\src\main\java\org\apache\kafka\streams\processor\internals\assignment\ConsumerProtocolUtils.java,84,0,2,13,0,15
 kafka-trunk\kafka-trunk\clients\src\test\java\org\apache\kafka\clients\admin\ListTransactionsResultTest.java,84,0,0,14,0,14
 kafka-trunk\kafka-trunk\connect\runtime\src\main\java\org\apache\kafka\connect\runtime\AbstractStatus.java,84,0,2,1,0,3
 kafka-trunk\kafka-trunk\clients\src\main\java\org\apache\kafka\common\acl\AccessControlEntry.java,84,0,3,9,0,12
 kafka-trunk\kafka-trunk\metadata\src\generated\java\org\apache\kafka\common\metadata\UserScramCredentialRecordJsonConverter.java,84,0,0,23,0,23
 pulsar-master\pulsar-master\managed-ledger\src\test\java\org\apache\bookkeeper\mledger\impl\ManagedLedgerFactoryChangeLedgerPathTest.java,84,20,0,9,0,29
 pulsar-master\pulsar-master\pulsar-client\src\main\java\org\apache\pulsar\client\impl\AbstractBatchMessageContainer.java,84,52,5,16,0,73
 pulsar-master\pulsar-master\pulsar-client\src\main\java\org\apache\pulsar\client\impl\schema\LongSchema.java,84,30,1,3,0,34
 pulsar-master\pulsar-master\pulsar-broker-common\src\main\java\org\apache\pulsar\broker\resources\TopicResources.java,84,43,1,11,0,55
 pulsar-master\pulsar-master\pulsar-broker\src\main\java\org\apache\pulsar\PulsarInitialNamespaceSetup.java,84,21,1,10,0,32
 pulsar-master\pulsar-master\buildtools\src\main\java\org\apache\pulsar\tests\ThreadLeakDetectorListener.java,84,31,3,13,0,47
 pulsar-master\pulsar-master\pulsar-broker\src\main\java\org\apache\pulsar\broker\BundleData.java,84,26,1,5,0,32
 pulsar-master\pulsar-master\pulsar-common\src\main\java\org\apache\pulsar\common\util\TrustManagerProxy.java,84,44,3,15,0,62
 pulsar-master\pulsar-master\pulsar-common\src\test\java\org\apache\pulsar\common\lookup\data\LookupDataTest.java,84,30,1,17,0,48
 pulsar-master\pulsar-master\pulsar-broker\src\main\java\org\apache\pulsar\broker\stats\MBeanStatsGenerator.java,84,8,2,2,0,12
 pulsar-master\pulsar-master\tests\integration\src\test\java\org\apache\pulsar\tests\integration\proxy\TestProxy.java,84,25,1,13,0,39
 pulsar-master\pulsar-master\pulsar-broker-auth-sasl\src\test\java\org\apache\pulsar\broker\authentication\SaslServerTokenSignerTest.java,84,14,9,8,0,31
 pulsar-master\pulsar-master\pulsar-common\src\test\java\org\apache\pulsar\common\policies\data\NamespaceIsolationDataTest.java,84,3,1,1,0,5
 pulsar-master\pulsar-master\pulsar-client-tools\src\main\java\org\apache\pulsar\admin\cli\CmdBase.java,84,18,1,4,0,23
 rocketmq-develop\rocketmq-develop\logging\src\test\java\org\apache\rocketmq\logging\inner\LoggerTest.java,84,13,1,9,2,25
 rocketmq-develop\rocketmq-develop\test\src\main\java\org\apache\rocketmq\test\util\data\collect\impl\MapDataCollectorImpl.java,84,33,1,2,0,36
 rocketmq-develop\rocketmq-develop\test\src\main\java\org\apache\rocketmq\test\factory\TagMessage.java,84,44,0,3,1,48
 skywalking-master\skywalking-master\oap-server\server-fetcher-plugin\kafka-fetcher-plugin\src\main\java\org\apache\skywalking\oap\server\analyzer\agent\kafka\provider\handler\ServiceManagementHandler.java,84,29,2,21,0,52
 skywalking-master\skywalking-master\oap-server\server-core\src\test\java\org\apache\skywalking\oap\server\core\config\group\EndpointNameGroupingRuleWatcherTest.java,84,51,3,23,0,77
 zookeeper-master\zookeeper-master\zookeeper-server\src\test\java\org\apache\zookeeper\server\quorum\CurrentEpochWriteFailureTest.java,84,0,2,16,0,18
 zookeeper-master\zookeeper-master\zookeeper-server\src\test\java\org\apache\zookeeper\server\DeserializationPerfTest.java,84,0,2,14,0,16
 zookeeper-master\zookeeper-master\zookeeper-server\src\test\java\org\apache\zookeeper\test\SSLAuthTest.java,84,0,2,17,2,21
 dubbo-3.0\dubbo-3.0\dubbo-remoting\dubbo-remoting-api\src\test\java\org\apache\dubbo\remoting\buffer\ChannelBuffersTest.java,85,32,0,8,0,40
 dubbo-3.0\dubbo-3.0\dubbo-registry\dubbo-registry-api\src\main\java\org\apache\dubbo\registry\RegistryNotifier.java,85,40,3,8,0,51
 dubbo-3.0\dubbo-3.0\dubbo-config\dubbo-config-api\src\test\java\org\apache\dubbo\config\MonitorConfigTest.java,85,13,0,2,0,15
 dubbo-3.0\dubbo-3.0\dubbo-registry\dubbo-registry-api\src\main\java\org\apache\dubbo\registry\client\migration\DefaultMigrationAddressComparator.java,85,29,6,12,0,47
 dubbo-3.0\dubbo-3.0\dubbo-config\dubbo-config-spring\src\test\java\org\apache\dubbo\config\spring\context\annotation\consumer\test\TestConsumerConfiguration.java,85,50,0,8,0,58
 dubbo-3.0\dubbo-3.0\dubbo-metadata\dubbo-metadata-processor\src\test\java\org\apache\dubbo\metadata\tools\Compiler.java,85,33,0,10,0,43
 dubbo-3.0\dubbo-3.0\dubbo-remoting\dubbo-remoting-http\src\test\java\org\apache\dubbo\remoting\http\jetty\JettyLoggerAdapterTest.java,85,23,2,11,0,36
 dubbo-3.0\dubbo-3.0\dubbo-common\src\test\java\org\apache\dubbo\common\utils\LogUtilTest.java,85,11,0,2,0,13
 dubbo-3.0\dubbo-3.0\dubbo-metadata\dubbo-metadata-processor\src\test\java\org\apache\dubbo\metadata\annotation\processing\util\ServiceAnnotationUtilsTest.java,85,22,2,29,0,53
 dubbo-3.0\dubbo-3.0\dubbo-common\src\test\java\org\apache\dubbo\rpc\model\ScopeModelTest.java,85,17,2,16,0,35
 hadoop-trunk\hadoop-trunk\hadoop-hdfs-project\hadoop-hdfs\src\main\java\org\apache\hadoop\hdfs\security\token\block\ExportedBlockKeys.java,85,32,1,1,2,36
 hadoop-trunk\hadoop-trunk\hadoop-yarn-project\hadoop-yarn\hadoop-yarn-server\hadoop-yarn-server-common\src\main\java\org\apache\hadoop\yarn\server\federation\store\records\ApplicationHomeSubCluster.java,85,8,0,1,0,9
 hadoop-trunk\hadoop-trunk\hadoop-yarn-project\hadoop-yarn\hadoop-yarn-server\hadoop-yarn-server-resourcemanager\src\main\java\org\apache\hadoop\yarn\server\resourcemanager\scheduler\QueueResourceQuotas.java,85,50,1,1,0,52
 hadoop-trunk\hadoop-trunk\hadoop-tools\hadoop-aws\src\test\java\org\apache\hadoop\fs\contract\s3a\ITestS3AContractRename.java,85,13,0,2,0,15
 hadoop-trunk\hadoop-trunk\hadoop-yarn-project\hadoop-yarn\hadoop-yarn-api\src\main\java\org\apache\hadoop\yarn\api\protocolrecords\ReservationSubmissionRequest.java,85,14,0,1,0,15
 hadoop-trunk\hadoop-trunk\hadoop-common-project\hadoop-common\src\main\java\org\apache\hadoop\fs\shell\Truncate.java,85,45,2,1,0,48
 hadoop-trunk\hadoop-trunk\hadoop-hdfs-project\hadoop-hdfs-rbf\src\main\java\org\apache\hadoop\hdfs\server\federation\metrics\NameserviceRPCMetrics.java,85,32,1,2,0,35
 hadoop-trunk\hadoop-trunk\hadoop-mapreduce-project\hadoop-mapreduce-client\hadoop-mapreduce-client-nativetask\src\test\java\org\apache\hadoop\mapred\nativetask\combinertest\OldAPICombinerTest.java,85,22,1,12,0,35
 hadoop-trunk\hadoop-trunk\hadoop-common-project\hadoop-common\src\main\java\org\apache\hadoop\conf\ConfigurationWithLogging.java,85,19,3,1,0,23
 hadoop-trunk\hadoop-trunk\hadoop-tools\hadoop-distcp\src\test\java\org\apache\hadoop\tools\TestRegexCopyFilter.java,85,5,2,1,0,8
 hadoop-trunk\hadoop-trunk\hadoop-mapreduce-project\hadoop-mapreduce-client\hadoop-mapreduce-client-jobclient\src\test\java\org\apache\hadoop\mapred\TestInputPath.java,85,21,4,1,0,26
 hadoop-trunk\hadoop-trunk\hadoop-hdfs-project\hadoop-hdfs\src\test\java\org\apache\hadoop\hdfs\server\datanode\fsdataset\impl\FsDatasetTestUtil.java,85,31,5,3,5,44
 hadoop-trunk\hadoop-trunk\hadoop-tools\hadoop-gridmix\src\test\java\org\apache\hadoop\mapred\gridmix\GridmixTestUtils.java,85,32,4,4,0,40
 hadoop-trunk\hadoop-trunk\hadoop-mapreduce-project\hadoop-mapreduce-client\hadoop-mapreduce-client-jobclient\src\main\java\org\apache\hadoop\mapred\ClientCache.java,85,22,3,2,2,29
 hadoop-trunk\hadoop-trunk\hadoop-hdfs-project\hadoop-hdfs\src\test\java\org\apache\hadoop\hdfs\TestEncryptionZonesWithHA.java,85,20,4,1,7,32
 hadoop-trunk\hadoop-trunk\hadoop-yarn-project\hadoop-yarn\hadoop-yarn-server\hadoop-yarn-server-resourcemanager\src\test\java\org\apache\hadoop\yarn\server\resourcemanager\monitor\capacity\mockframework\ContainerSpecification.java,85,36,0,3,2,41
 hadoop-trunk\hadoop-trunk\hadoop-yarn-project\hadoop-yarn\hadoop-yarn-server\hadoop-yarn-server-resourcemanager\src\test\java\org\apache\hadoop\yarn\server\resourcemanager\scheduler\capacity\TestResourceVector.java,85,45,0,14,0,59
 kafka-trunk\kafka-trunk\connect\transforms\src\test\java\org\apache\kafka\connect\transforms\predicates\HasHeaderKeyTest.java,85,0,0,10,0,10
 kafka-trunk\kafka-trunk\clients\src\main\java\org\apache\kafka\common\requests\LeaderAndIsrResponse.java,85,0,46,12,2,60
 kafka-trunk\kafka-trunk\clients\src\main\java\org\apache\kafka\common\requests\DescribeClientQuotasResponse.java,85,0,0,15,2,17
 kafka-trunk\kafka-trunk\clients\src\test\java\org\apache\kafka\common\security\plain\internals\PlainSaslServerTest.java,85,0,0,20,0,20
 kafka-trunk\kafka-trunk\connect\transforms\src\test\java\org\apache\kafka\connect\transforms\ExtractFieldTest.java,85,0,0,10,2,12
 kafka-trunk\kafka-trunk\clients\src\main\java\org\apache\kafka\common\requests\JoinGroupRequest.java,85,0,40,6,3,49
 kafka-trunk\kafka-trunk\connect\json\src\main\java\org\apache\kafka\connect\json\JsonConverterConfig.java,85,0,0,10,1,11
 kafka-trunk\kafka-trunk\raft\src\main\java\org\apache\kafka\raft\UnattachedState.java,85,0,1,2,1,4
 kafka-trunk\kafka-trunk\clients\src\main\java\org\apache\kafka\common\security\kerberos\KerberosName.java,85,0,1,5,0,6
 kafka-trunk\kafka-trunk\clients\src\main\java\org\apache\kafka\common\requests\DescribeDelegationTokenResponse.java,85,0,0,10,2,12
 kafka-trunk\kafka-trunk\clients\src\generated\java\org\apache\kafka\common\message\LeaderChangeMessageJsonConverter.java,85,0,0,18,0,18
 kafka-trunk\kafka-trunk\streams\src\test\java\org\apache\kafka\streams\kstream\MaterializedTest.java,85,0,0,10,4,14
 kafka-trunk\kafka-trunk\connect\runtime\src\main\java\org\apache\kafka\connect\runtime\TopicStatus.java,85,0,0,5,0,5
 kafka-trunk\kafka-trunk\trogdor\src\main\java\org\apache\kafka\trogdor\task\TaskSpec.java,85,0,2,6,0,8
 kafka-trunk\kafka-trunk\clients\src\main\java\org\apache\kafka\clients\admin\RemoveMembersFromConsumerGroupResult.java,85,0,0,13,0,13
 kafka-trunk\kafka-trunk\clients\src\main\java\org\apache\kafka\common\quota\ClientQuotaFilterComponent.java,85,0,3,10,0,13
 kafka-trunk\kafka-trunk\streams\src\test\java\org\apache\kafka\streams\processor\internals\HandlingSourceTopicDeletionIntegrationTest.java,85,0,0,17,0,17
 pulsar-master\pulsar-master\pulsar-metadata\src\test\java\org\apache\pulsar\metadata\bookkeeper\PulsarLayoutManagerTest.java,85,12,4,3,0,19
 pulsar-master\pulsar-master\pulsar-client-1x-base\pulsar-client-1x\src\main\java\org\apache\pulsar\client\impl\MessageBuilderImpl.java,85,27,0,2,0,29
 pulsar-master\pulsar-master\pulsar-io\dynamodb\src\main\java\org\apache\pulsar\io\dynamodb\DynamoDBSource.java,85,33,6,24,0,63
 pulsar-master\pulsar-master\pulsar-sql\presto-pulsar\src\test\java\org\apache\pulsar\sql\presto\decoder\AbstractDecoderTester.java,85,81,0,17,0,98
 pulsar-master\pulsar-master\pulsar-client\src\main\java\org\apache\pulsar\client\impl\schema\AutoProduceBytesSchema.java,85,27,4,5,0,36
 rocketmq-develop\rocketmq-develop\broker\src\test\java\org\apache\rocketmq\broker\processor\ClientManageProcessorTest.java,85,33,3,17,0,53
 rocketmq-develop\rocketmq-develop\client\src\main\java\org\apache\rocketmq\client\latency\MQFaultStrategy.java,85,53,3,11,4,71
 rocketmq-develop\rocketmq-develop\common\src\main\java\org\apache\rocketmq\common\stats\MomentStatsItemSet.java,85,38,1,9,2,50
 rocketmq-develop\rocketmq-develop\client\src\main\java\org\apache\rocketmq\client\trace\hook\ConsumeMessageTraceHookImpl.java,85,35,1,11,1,48
 rocketmq-develop\rocketmq-develop\openmessaging\src\test\java\io\openmessaging\rocketmq\utils\BeanUtilsTest.java,85,54,2,7,0,63
 rocketmq-develop\rocketmq-develop\client\src\main\java\org\apache\rocketmq\client\impl\consumer\PullRequest.java,85,49,7,4,4,64
 rocketmq-develop\rocketmq-develop\test\src\test\java\org\apache\rocketmq\test\delay\NormalMsgDelayIT.java,85,37,3,15,8,63
 rocketmq-develop\rocketmq-develop\test\src\main\java\org\apache\rocketmq\test\util\FileUtil.java,85,26,0,2,3,31
 shardingsphere-master\shardingsphere-master\shardingsphere-mode\shardingsphere-mode-core\src\test\java\org\apache\shardingsphere\mode\metadata\persist\node\SchemaMetaDataNodeTest.java,85,36,0,14,0,50
 shardingsphere-master\shardingsphere-master\examples\example-core\example-raw-jdbc\src\main\java\org\apache\shardingsphere\example\core\jdbc\repository\AccountRepositoryImpl.java,85,25,0,5,0,30
 shardingsphere-master\shardingsphere-master\examples\example-core\example-spring-jpa\src\main\java\org\apache\shardingsphere\example\core\jpa\service\OrderServiceImpl.java,85,25,1,10,0,36
 skywalking-master\skywalking-master\oap-server\server-storage-plugin\storage-elasticsearch-plugin\src\main\java\org\apache\skywalking\oap\server\storage\plugin\elasticsearch\query\AggregationQueryEsDAO.java,85,16,0,21,0,37
 skywalking-master\skywalking-master\oap-server\server-core\src\main\java\org\apache\skywalking\oap\server\core\profiling\ebpf\storage\EBPFProfilingTaskRecord.java,85,48,0,22,0,70
 skywalking-master\skywalking-master\oap-server\server-receiver-plugin\skywalking-zabbix-receiver-plugin\src\main\java\org\apache\skywalking\oap\server\receiver\zabbix\provider\protocol\ZabbixProtocolDecoder.java,85,50,0,15,0,65
 skywalking-master\skywalking-master\oap-server\server-storage-plugin\storage-jdbc-hikaricp-plugin\src\main\java\org\apache\skywalking\oap\server\storage\plugin\jdbc\h2\dao\H2BrowserLogQueryDAO.java,85,29,0,15,0,44
 skywalking-master\skywalking-master\oap-server\server-core\src\test\java\org\apache\skywalking\oap\server\core\remote\HTTPServerTest.java,85,26,1,9,0,36
 zookeeper-master\zookeeper-master\zookeeper-server\src\test\java\org\apache\zookeeper\test\ConnectStringParserTest.java,85,0,14,25,0,39
 zookeeper-master\zookeeper-master\zookeeper-server\src\test\java\org\apache\zookeeper\test\ObserverMasterTestBase.java,85,0,10,11,7,28
 zookeeper-master\zookeeper-master\zookeeper-contrib\zookeeper-contrib-rest\src\test\java\org\apache\zookeeper\JUnit4ZKTestRunner.java,85,0,6,6,0,12
 zookeeper-master\zookeeper-master\zookeeper-contrib\zookeeper-contrib-rest\src\main\java\org\apache\zookeeper\server\jersey\cfg\RestCfg.java,85,0,0,1,2,3
 dubbo-3.0\dubbo-3.0\dubbo-registry\dubbo-registry-api\src\main\java\org\apache\dubbo\registry\integration\AbstractConfiguratorListener.java,86,35,1,9,0,45
 dubbo-3.0\dubbo-3.0\dubbo-cluster\src\main\java\org\apache\dubbo\rpc\cluster\directory\StaticDirectory.java,86,37,2,10,0,49
 dubbo-3.0\dubbo-3.0\dubbo-cluster\src\main\java\org\apache\dubbo\rpc\cluster\support\BroadcastClusterInvoker.java,86,25,4,12,0,41
 dubbo-3.0\dubbo-3.0\dubbo-common\src\test\java\org\apache\dubbo\metadata\definition\ServiceDefinitionBuilderTest.java,86,38,1,35,5,79
 dubbo-3.0\dubbo-3.0\dubbo-plugin\dubbo-qos\src\test\java\org\apache\dubbo\qos\legacy\ChangeTelnetHandlerTest.java,86,30,2,14,0,46
 dubbo-3.0\dubbo-3.0\dubbo-common\src\main\java\org\apache\dubbo\common\utils\ClassLoaderResourceLoader.java,86,24,7,12,4,47
 dubbo-3.0\dubbo-3.0\dubbo-remoting\dubbo-remoting-api\src\main\java\org\apache\dubbo\remoting\exchange\Exchangers.java,86,61,1,15,0,77
 dubbo-3.0\dubbo-3.0\dubbo-config\dubbo-config-spring\src\main\java\org\apache\dubbo\config\spring\beans\factory\annotation\ServiceBeanNameBuilder.java,86,61,1,15,0,77
 dubbo-3.0\dubbo-3.0\dubbo-cluster\src\test\java\org\apache\dubbo\rpc\cluster\configurator\override\OverrideConfiguratorTest.java,86,26,2,18,0,46
 hadoop-trunk\hadoop-trunk\hadoop-yarn-project\hadoop-yarn\hadoop-yarn-server\hadoop-yarn-server-applicationhistoryservice\src\main\java\org\apache\hadoop\yarn\server\timeline\MemoryTimelineStore.java,86,12,1,1,0,14
 hadoop-trunk\hadoop-trunk\hadoop-mapreduce-project\hadoop-mapreduce-client\hadoop-mapreduce-client-core\src\test\java\org\apache\hadoop\mapreduce\lib\output\committer\manifest\TestCommitTaskStage.java,86,4,2,11,0,17
 hadoop-trunk\hadoop-trunk\hadoop-hdfs-project\hadoop-hdfs\src\main\java\org\apache\hadoop\hdfs\protocol\SnapshotInfo.java,86,55,8,1,0,64
 hadoop-trunk\hadoop-trunk\hadoop-mapreduce-project\hadoop-mapreduce-client\hadoop-mapreduce-client-app\src\main\java\org\apache\hadoop\mapreduce\v2\app\webapp\TasksBlock.java,86,14,1,2,0,17
 hadoop-trunk\hadoop-trunk\hadoop-yarn-project\hadoop-yarn\hadoop-yarn-common\src\main\java\org\apache\hadoop\yarn\api\protocolrecords\impl\pb\GetDelegationTokenRequestPBImpl.java,86,38,32,3,0,73
 hadoop-trunk\hadoop-trunk\hadoop-hdfs-project\hadoop-hdfs\src\test\java\org\apache\hadoop\hdfs\server\namenode\startupprogress\TestStartupProgressMetrics.java,86,25,7,2,0,34
 hadoop-trunk\hadoop-trunk\hadoop-hdfs-project\hadoop-hdfs-client\src\main\java\org\apache\hadoop\hdfs\protocol\CachePoolStats.java,86,50,2,1,0,53
 hadoop-trunk\hadoop-trunk\hadoop-mapreduce-project\hadoop-mapreduce-client\hadoop-mapreduce-client-jobclient\src\test\java\org\apache\hadoop\mapreduce\TestYarnClientProtocolProvider.java,86,11,3,3,6,23
 hadoop-trunk\hadoop-trunk\hadoop-common-project\hadoop-auth\src\test\java\org\apache\hadoop\security\authentication\util\TestRandomSignerSecretProvider.java,86,7,2,1,2,12
 hadoop-trunk\hadoop-trunk\hadoop-mapreduce-project\hadoop-mapreduce-client\hadoop-mapreduce-client-core\src\main\java\org\apache\hadoop\mapreduce\checkpoint\TaskCheckpointID.java,86,29,0,1,4,34
 hadoop-trunk\hadoop-trunk\hadoop-yarn-project\hadoop-yarn\hadoop-yarn-server\hadoop-yarn-server-resourcemanager\src\main\java\org\apache\hadoop\yarn\server\resourcemanager\webapp\dao\ClusterInfo.java,86,52,3,1,0,56
 hadoop-trunk\hadoop-trunk\hadoop-tools\hadoop-fs2img\src\test\java\org\apache\hadoop\hdfs\server\namenode\TestFixedBlockResolver.java,86,36,12,1,0,49
 hadoop-trunk\hadoop-trunk\hadoop-yarn-project\hadoop-yarn\hadoop-yarn-server\hadoop-yarn-server-nodemanager\src\main\java\org\apache\hadoop\yarn\server\nodemanager\nodelabels\ScriptBasedNodeLabelsProvider.java,86,11,1,1,0,13
 hadoop-trunk\hadoop-trunk\hadoop-yarn-project\hadoop-yarn\hadoop-yarn-api\src\main\java\org\apache\hadoop\yarn\api\records\NodeLabel.java,86,18,0,2,0,20
 hadoop-trunk\hadoop-trunk\hadoop-common-project\hadoop-common\src\main\java\org\apache\hadoop\util\OperationDuration.java,86,6,2,1,1,10
 hadoop-trunk\hadoop-trunk\hadoop-mapreduce-project\hadoop-mapreduce-client\hadoop-mapreduce-client-jobclient\src\test\java\org\apache\hadoop\mapreduce\lib\input\TestDelegatingInputFormat.java,86,11,4,1,1,17
 hadoop-trunk\hadoop-trunk\hadoop-yarn-project\hadoop-yarn\hadoop-yarn-api\src\main\java\org\apache\hadoop\yarn\api\records\SerializedException.java,86,11,0,1,0,12
 hadoop-trunk\hadoop-trunk\hadoop-common-project\hadoop-common\src\main\java\org\apache\hadoop\io\erasurecode\ECChunk.java,86,24,1,1,3,29
 hadoop-trunk\hadoop-trunk\hadoop-mapreduce-project\hadoop-mapreduce-client\hadoop-mapreduce-client-app\src\test\java\org\apache\hadoop\mapreduce\v2\app\job\impl\TestTaskAttemptContainerRequest.java,86,10,5,4,2,21
 hadoop-trunk\hadoop-trunk\hadoop-common-project\hadoop-common\src\main\java\org\apache\hadoop\security\KerberosAuthException.java,86,24,1,1,0,26
 hadoop-trunk\hadoop-trunk\hadoop-mapreduce-project\hadoop-mapreduce-client\hadoop-mapreduce-client-app\src\main\java\org\apache\hadoop\mapreduce\jobhistory\JobHistoryCopyService.java,86,29,3,2,1,35
 hadoop-trunk\hadoop-trunk\hadoop-cloud-storage-project\hadoop-cos\src\main\java\org\apache\hadoop\fs\cosn\CosNFileReadTask.java,86,15,2,1,2,20
 hadoop-trunk\hadoop-trunk\hadoop-common-project\hadoop-common\src\main\java\org\apache\hadoop\security\WhitelistBasedResolver.java,86,35,0,12,2,49
 hadoop-trunk\hadoop-trunk\hadoop-tools\hadoop-aws\src\main\java\org\apache\hadoop\fs\s3a\commit\S3ACommitterFactory.java,86,7,2,2,0,11
 hadoop-trunk\hadoop-trunk\hadoop-mapreduce-project\hadoop-mapreduce-client\hadoop-mapreduce-client-nativetask\src\test\java\org\apache\hadoop\mapred\nativetask\serde\TestNativeSerialization.java,86,30,4,6,1,41
 hadoop-trunk\hadoop-trunk\hadoop-mapreduce-project\hadoop-mapreduce-client\hadoop-mapreduce-client-jobclient\src\test\java\org\apache\hadoop\mapreduce\lib\db\TestDBOutputFormat.java,86,24,2,1,0,27
 hadoop-trunk\hadoop-trunk\hadoop-yarn-project\hadoop-yarn\hadoop-yarn-common\src\main\java\org\apache\hadoop\yarn\api\records\impl\pb\ResourceOptionPBImpl.java,86,31,38,1,0,70
 hadoop-trunk\hadoop-trunk\hadoop-yarn-project\hadoop-yarn\hadoop-yarn-server\hadoop-yarn-server-resourcemanager\src\main\java\org\apache\hadoop\yarn\server\resourcemanager\scheduler\fair\converter\ConversionOptions.java,86,47,0,1,1,49
 hadoop-trunk\hadoop-trunk\hadoop-common-project\hadoop-common\src\main\java\org\apache\hadoop\ipc\ProtocolProxy.java,86,30,2,1,0,33
 hadoop-trunk\hadoop-trunk\hadoop-hdfs-project\hadoop-hdfs\src\test\java\org\apache\hadoop\hdfs\server\namenode\web\resources\TestWebHdfsCreatePermissions.java,86,13,2,1,0,16
 hadoop-trunk\hadoop-trunk\hadoop-yarn-project\hadoop-yarn\hadoop-yarn-common\src\main\java\org\apache\hadoop\yarn\util\Times.java,86,18,3,1,0,22
 kafka-trunk\kafka-trunk\clients\src\main\java\org\apache\kafka\common\requests\CreateTopicsRequest.java,86,0,27,11,3,41
 kafka-trunk\kafka-trunk\streams\src\main\java\org\apache\kafka\streams\processor\TaskMetadata.java,86,0,0,6,3,9
 kafka-trunk\kafka-trunk\clients\src\test\java\org\apache\kafka\clients\consumer\ConsumerRecordTest.java,86,0,0,8,0,8
 kafka-trunk\kafka-trunk\trogdor\src\main\java\org\apache\kafka\trogdor\common\StringFormatter.java,86,0,3,2,0,5
 kafka-trunk\kafka-trunk\streams\src\test\java\org\apache\kafka\streams\integration\StateRestorationIntegrationTest.java,86,0,0,8,0,8
 kafka-trunk\kafka-trunk\clients\src\generated\java\org\apache\kafka\common\message\CreateDelegationTokenResponseDataJsonConverter.java,86,0,0,25,0,25
 kafka-trunk\kafka-trunk\clients\src\main\java\org\apache\kafka\common\network\PlaintextChannelBuilder.java,86,0,4,19,1,24
 kafka-trunk\kafka-trunk\streams\src\main\java\org\apache\kafka\streams\query\StateQueryResult.java,86,0,0,14,3,17
 kafka-trunk\kafka-trunk\clients\src\test\java\org\apache\kafka\common\network\ChannelBuildersTest.java,86,0,0,29,0,29
 kafka-trunk\kafka-trunk\jmh-benchmarks\src\main\java\org\apache\kafka\jmh\common\FetchRequestBenchmark.java,86,0,1,9,0,10
 kafka-trunk\kafka-trunk\clients\src\main\java\org\apache\kafka\common\acl\AclBindingFilter.java,86,0,3,11,0,14
 kafka-trunk\kafka-trunk\clients\src\main\java\org\apache\kafka\common\record\CompressionRatioEstimator.java,86,0,3,15,0,18
 kafka-trunk\kafka-trunk\clients\src\main\java\org\apache\kafka\common\requests\LeaveGroupRequest.java,86,0,0,11,1,12
 LittleBooks-master\LittleBooks-master\app\src\main\java\com\example\littlebooks\ModelRecenzia.java,86,76,4,2,0,82
 pulsar-master\pulsar-master\pulsar-broker-common\src\test\java\org\apache\pulsar\broker\validator\MultipleListenerValidatorTest.java,86,27,7,15,0,49
 pulsar-master\pulsar-master\pulsar-common\src\test\java\org\apache\pulsar\common\util\FileModifiedTimeUpdaterTest.java,86,43,1,11,0,55
 pulsar-master\pulsar-master\pulsar-broker\src\main\java\org\apache\pulsar\broker\service\schema\JsonSchemaCompatibilityCheck.java,86,28,3,14,0,45
 pulsar-master\pulsar-master\tests\integration\src\test\java\org\apache\pulsar\tests\integration\topologies\PulsarStandaloneTestBase.java,86,28,4,13,0,45
 pulsar-master\pulsar-master\pulsar-sql\presto-pulsar\src\test\java\org\apache\pulsar\sql\presto\decoder\DecoderTestUtil.java,86,64,2,13,0,79
 pulsar-master\pulsar-master\pulsar-client\src\main\java\org\apache\pulsar\client\impl\schema\generic\GenericAvroReader.java,86,35,3,9,0,47
 pulsar-master\pulsar-master\pulsar-common\src\main\java\org\apache\pulsar\common\tls\InetAddressUtils.java,86,26,1,13,0,40
 pulsar-master\pulsar-master\pulsar-functions\instance\src\test\java\org\apache\pulsar\functions\instance\state\InstanceStateManagerTest.java,86,8,2,1,0,11
 pulsar-master\pulsar-master\pulsar-broker\src\test\java\org\apache\pulsar\websocket\proxy\ProxyAuthorizationTest.java,86,25,2,21,0,48
 pulsar-master\pulsar-master\pulsar-broker-common\src\main\java\org\apache\pulsar\broker\authentication\utils\AuthTokenUtils.java,86,29,2,10,0,41
 pulsar-master\pulsar-master\pulsar-client\src\main\java\org\apache\pulsar\client\impl\schema\DoubleSchema.java,86,30,1,3,0,34
 rocketmq-develop\rocketmq-develop\tools\src\main\java\org\apache\rocketmq\tools\command\consumer\DeleteSubscriptionGroupCommand.java,86,20,0,13,2,35
 rocketmq-develop\rocketmq-develop\logging\src\test\java\org\apache\rocketmq\logging\inner\LoggingBuilderTest.java,86,25,1,11,5,42
 rocketmq-develop\rocketmq-develop\store\src\main\java\org\apache\rocketmq\store\ha\WaitNotifyObject.java,86,22,2,5,5,34
 shardingsphere-master\shardingsphere-master\shardingsphere-jdbc\shardingsphere-jdbc-spring\shardingsphere-jdbc-core-spring\shardingsphere-jdbc-core-spring-namespace\src\test\java\org\apache\shardingsphere\spring\namespace\AbstractSpringNamespaceTest.java,86,36,0,17,0,53
 skywalking-master\skywalking-master\oap-server\server-core\src\main\java\org\apache\skywalking\oap\server\core\analysis\manual\endpoint\EndpointTraffic.java,86,20,1,7,0,28
 skywalking-master\skywalking-master\oap-server\server-core\src\main\java\org\apache\skywalking\oap\server\core\source\ServiceRelation.java,86,29,1,9,0,39
 zookeeper-master\zookeeper-master\zookeeper-server\src\main\java\org\apache\zookeeper\jmx\ManagedUtil.java,86,0,2,15,1,18
 zookeeper-master\zookeeper-master\zookeeper-server\src\test\java\org\apache\zookeeper\server\embedded\ZookeeperServerSslEmbeddedTest.java,86,0,9,13,1,23
 zookeeper-master\zookeeper-master\zookeeper-server\src\test\java\org\apache\zookeeper\server\util\SerializeUtilsTest.java,86,0,11,1,0,12
 zookeeper-master\zookeeper-master\zookeeper-server\src\test\java\org\apache\zookeeper\test\FourLetterWordsQuorumTest.java,86,0,2,4,0,6
 dubbo-3.0\dubbo-3.0\dubbo-rpc\dubbo-rpc-triple\src\main\java\org\apache\dubbo\rpc\protocol\tri\stream\StreamUtils.java,87,27,3,10,0,40
 dubbo-3.0\dubbo-3.0\dubbo-serialization\dubbo-serialization-jdk\src\main\java\org\apache\dubbo\common\serialize\nativejava\NativeJavaObjectOutput.java,87,31,0,1,0,32
 dubbo-3.0\dubbo-3.0\dubbo-config\dubbo-config-spring\src\test\java\org\apache\dubbo\config\spring\reference\localcallam\LocalCallMultipleReferenceAnnotationsTest.java,87,28,3,14,0,45
 dubbo-3.0\dubbo-3.0\dubbo-rpc\dubbo-rpc-api\src\main\java\org\apache\dubbo\rpc\CancellationContext.java,87,27,2,4,5,38
 dubbo-3.0\dubbo-3.0\dubbo-common\src\main\java\org\apache\dubbo\metadata\definition\model\MethodDefinition.java,87,43,0,6,5,54
 dubbo-3.0\dubbo-3.0\dubbo-rpc\dubbo-rpc-triple\src\main\java\org\apache\dubbo\rpc\protocol\tri\observer\ServerCallToObserverAdapter.java,87,38,1,3,0,42
 dubbo-3.0\dubbo-3.0\dubbo-config\dubbo-config-spring\src\main\java\org\apache\dubbo\config\spring\status\SpringStatusChecker.java,87,19,4,8,0,31
 dubbo-3.0\dubbo-3.0\dubbo-cluster\src\main\java\org\apache\dubbo\rpc\cluster\support\FailoverClusterInvoker.java,87,21,1,13,0,35
 dubbo-3.0\dubbo-3.0\dubbo-cluster\src\main\java\org\apache\dubbo\rpc\cluster\router\mesh\rule\virtualservice\DubboMatchRequest.java,87,51,0,6,0,57
 dubbo-3.0\dubbo-3.0\dubbo-plugin\dubbo-qos\src\test\java\org\apache\dubbo\qos\command\impl\ChangeTelnetTest.java,87,36,0,18,0,54
 dubbo-3.0\dubbo-3.0\dubbo-rpc\dubbo-rpc-api\src\main\java\org\apache\dubbo\rpc\proxy\AbstractProxyFactory.java,87,21,5,10,0,36
 dubbo-3.0\dubbo-3.0\dubbo-rpc\dubbo-rpc-triple\src\main\java\org\apache\dubbo\rpc\protocol\tri\transport\TripleHttp2FrameServerHandler.java,87,51,1,17,0,69
 hadoop-trunk\hadoop-trunk\hadoop-hdfs-project\hadoop-hdfs\src\test\java\org\apache\hadoop\hdfs\TestBlockMissingException.java,87,31,2,3,0,36
 hadoop-trunk\hadoop-trunk\hadoop-common-project\hadoop-common\src\test\java\org\apache\hadoop\fs\viewfs\TestViewFileSystemLocalFileSystem.java,87,7,1,1,1,10
 hadoop-trunk\hadoop-trunk\hadoop-yarn-project\hadoop-yarn\hadoop-yarn-server\hadoop-yarn-server-resourcemanager\src\main\java\org\apache\hadoop\yarn\server\resourcemanager\scheduler\FSQueueMetricsForCustomResources.java,87,48,0,1,6,55
 hadoop-trunk\hadoop-trunk\hadoop-common-project\hadoop-common\src\main\java\org\apache\hadoop\ipc\ProtocolMetaInfoServerSideTranslatorPB.java,87,23,20,6,0,49
 hadoop-trunk\hadoop-trunk\hadoop-hdfs-project\hadoop-hdfs-rbf\src\test\java\org\apache\hadoop\fs\contract\router\RouterHDFSContract.java,87,18,1,2,2,23
 hadoop-trunk\hadoop-trunk\hadoop-hdfs-project\hadoop-hdfs\src\test\java\org\apache\hadoop\hdfs\TestConnCache.java,87,27,4,2,0,33
 hadoop-trunk\hadoop-trunk\hadoop-tools\hadoop-aws\src\main\java\org\apache\hadoop\fs\s3a\S3ObjectAttributes.java,87,46,0,1,0,47
 hadoop-trunk\hadoop-trunk\hadoop-mapreduce-project\hadoop-mapreduce-examples\src\test\java\org\apache\hadoop\examples\terasort\TestTeraSort.java,87,21,0,1,0,22
 hadoop-trunk\hadoop-trunk\hadoop-yarn-project\hadoop-yarn\hadoop-yarn-common\src\test\java\org\apache\hadoop\yarn\api\records\TestResourceUtilization.java,87,51,0,1,0,52
 hadoop-trunk\hadoop-trunk\hadoop-tools\hadoop-sls\src\test\java\org\apache\hadoop\yarn\sls\TestSLSRunner.java,87,7,2,3,0,12
 hadoop-trunk\hadoop-trunk\hadoop-hdfs-project\hadoop-hdfs\src\test\java\org\apache\hadoop\hdfs\server\namenode\snapshot\TestSnapshotListing.java,87,28,0,1,2,31
 hadoop-trunk\hadoop-trunk\hadoop-yarn-project\hadoop-yarn\hadoop-yarn-server\hadoop-yarn-server-resourcemanager\src\test\java\org\apache\hadoop\yarn\server\resourcemanager\resourcetracker\TestRMNMRPCResponseId.java,87,21,2,10,2,35
 hadoop-trunk\hadoop-trunk\hadoop-common-project\hadoop-kms\src\main\java\org\apache\hadoop\crypto\key\kms\server\KMSMDCFilter.java,87,27,2,1,0,30
 hadoop-trunk\hadoop-trunk\hadoop-hdfs-project\hadoop-hdfs\src\test\java\org\apache\hadoop\hdfs\qjournal\server\TestJournalNodeMXBean.java,87,19,0,5,1,25
 hadoop-trunk\hadoop-trunk\hadoop-yarn-project\hadoop-yarn\hadoop-yarn-common\src\test\java\org\apache\hadoop\yarn\util\TestBoundedAppender.java,87,18,1,1,0,20
 hadoop-trunk\hadoop-trunk\hadoop-tools\hadoop-azure\src\test\java\org\apache\hadoop\fs\azurebfs\services\TestAbfsHttpOperation.java,87,6,0,5,0,11
 hadoop-trunk\hadoop-trunk\hadoop-yarn-project\hadoop-yarn\hadoop-yarn-server\hadoop-yarn-server-resourcemanager\src\main\java\org\apache\hadoop\yarn\server\resourcemanager\monitor\capacity\TempSchedulerNode.java,87,47,0,2,13,62
 hadoop-trunk\hadoop-trunk\hadoop-hdfs-project\hadoop-hdfs\src\test\java\org\apache\hadoop\hdfs\server\namenode\TestAuditLogAtDebug.java,87,24,3,4,0,31
 hadoop-trunk\hadoop-trunk\hadoop-yarn-project\hadoop-yarn\hadoop-yarn-server\hadoop-yarn-server-resourcemanager\src\test\java\org\apache\hadoop\yarn\server\resourcemanager\ACLsTestBase.java,87,29,3,1,2,35
 hadoop-trunk\hadoop-trunk\hadoop-hdfs-project\hadoop-hdfs\src\test\java\org\apache\hadoop\hdfs\TestErasureCodeBenchmarkThroughput.java,87,22,1,1,1,25
 hadoop-trunk\hadoop-trunk\hadoop-mapreduce-project\hadoop-mapreduce-client\hadoop-mapreduce-client-jobclient\src\test\java\org\apache\hadoop\mapred\TestSequenceFileAsTextInputFormat.java,87,27,7,3,2,39
 hadoop-trunk\hadoop-trunk\hadoop-hdfs-project\hadoop-hdfs\src\test\java\org\apache\hadoop\hdfs\server\datanode\TestDNUsageReport.java,87,25,7,1,3,36
 kafka-trunk\kafka-trunk\streams\src\main\java\org\apache\kafka\streams\state\internals\StreamThreadStateStoreProvider.java,87,0,1,23,1,25
 kafka-trunk\kafka-trunk\connect\mirror-client\src\main\java\org\apache\kafka\connect\mirror\MirrorClientConfig.java,87,0,0,8,0,8
 kafka-trunk\kafka-trunk\streams\src\main\java\org\apache\kafka\streams\processor\internals\TopicPartitionMetadata.java,87,0,1,7,3,11
 kafka-trunk\kafka-trunk\streams\src\main\java\org\apache\kafka\streams\processor\internals\namedtopology\RemoveNamedTopologyResult.java,87,0,1,14,0,15
 kafka-trunk\kafka-trunk\streams\src\test\java\org\apache\kafka\streams\integration\MetricsReporterIntegrationTest.java,87,0,4,15,1,20
 kafka-trunk\kafka-trunk\streams\src\test\java\org\apache\kafka\streams\state\internals\KeyValueSegmentTest.java,87,0,0,18,0,18
 pulsar-master\pulsar-master\tests\integration\src\test\java\org\apache\pulsar\tests\integration\python\PythonSchemaTest.java,87,21,0,9,0,30
 pulsar-master\pulsar-master\pulsar-client\src\test\java\org\apache\pulsar\client\impl\BinaryProtoLookupServiceTest.java,87,40,4,17,0,61
 pulsar-master\pulsar-master\pulsar-broker\src\main\java\org\apache\pulsar\broker\transaction\pendingack\impl\MLPendingAckStoreProvider.java,87,50,3,38,0,91
 pulsar-master\pulsar-master\pulsar-client\src\test\java\org\apache\pulsar\client\impl\schema\generic\GenericJsonRecordTest.java,87,40,0,10,0,50
 pulsar-master\pulsar-master\tests\integration\src\test\java\org\apache\pulsar\tests\integration\io\sinks\KinesisSinkTester.java,87,16,0,8,0,24
 pulsar-master\pulsar-master\managed-ledger\src\test\java\org\apache\bookkeeper\mledger\impl\ManagedCursorIndividualDeletedMessagesTest.java,87,67,1,11,0,79
 pulsar-master\pulsar-master\pulsar-broker\src\main\java\org\apache\pulsar\broker\web\ResponseHandlerFilter.java,87,33,2,16,0,51
 pulsar-master\pulsar-master\pulsar-websocket\src\test\java\org\apache\pulsar\websocket\PingPongHandlerTest.java,87,30,5,9,0,44
 pulsar-master\pulsar-master\pulsar-client-tools\src\main\java\org\apache\pulsar\admin\cli\CmdFunctionWorker.java,87,9,1,8,0,18
 pulsar-master\pulsar-master\pulsar-io\flume\src\main\java\org\apache\pulsar\io\flume\FlumeConnector.java,87,20,1,12,0,33
 pulsar-master\pulsar-master\pulsar-broker\src\main\java\org\apache\pulsar\broker\loadbalance\impl\PulsarResourceDescription.java,87,22,1,7,0,30
 pulsar-master\pulsar-master\pulsar-broker\src\test\java\org\apache\pulsar\broker\resourcegroup\ResourceQuotaCalculatorImplTest.java,87,31,0,14,0,45
 pulsar-master\pulsar-master\pulsar-broker\src\test\java\org\apache\pulsar\client\impl\TopicPublishThrottlingInitTest.java,87,23,1,15,0,39
 rocketmq-develop\rocketmq-develop\broker\src\main\java\org\apache\rocketmq\broker\offset\LmqConsumerOffsetManager.java,87,26,1,8,2,37
 shardingsphere-master\shardingsphere-master\examples\example-core\example-raw-jdbc\src\main\java\org\apache\shardingsphere\example\core\jdbc\repository\OrderRepositoryImpl.java,87,27,0,6,0,33
 skywalking-master\skywalking-master\oap-server\server-query-plugin\query-graphql-plugin\src\test\java\org\apache\skywalking\oap\query\graphql\resolver\LogTestQueryTest.java,87,36,1,6,0,43
 skywalking-master\skywalking-master\oap-server\server-library\library-datacarrier-queue\src\main\java\org\apache\skywalking\oap\server\library\datacarrier\consumer\BulkConsumePool.java,87,29,1,5,0,35
 skywalking-master\skywalking-master\oap-server\server-core\src\test\java\org\apache\skywalking\oap\server\core\cluster\OAPNodeCheckerTest.java,87,40,10,18,0,68
 skywalking-master\skywalking-master\oap-server\server-configuration\configuration-etcd\src\test\java\org\apache\skywalking\oap\server\configuration\etcd\EtcdConfigurationTestProvider.java,87,15,2,7,0,24
 skywalking-master\skywalking-master\oap-server\server-query-plugin\query-graphql-plugin\src\main\java\org\apache\skywalking\oap\query\graphql\GraphQLQueryProvider.java,87,20,1,15,0,36
 skywalking-master\skywalking-master\oap-server\analyzer\agent-analyzer\src\main\java\org\apache\skywalking\oap\server\analyzer\provider\trace\parser\TraceAnalyzer.java,87,27,1,18,0,46
 skywalking-master\skywalking-master\oap-server\server-core\src\main\java\org\apache\skywalking\oap\server\core\config\NamingControl.java,87,26,0,19,0,45
 zookeeper-master\zookeeper-master\zookeeper-server\src\main\java\org\apache\zookeeper\server\persistence\FilePadding.java,87,0,0,7,0,7
 zookeeper-master\zookeeper-master\zookeeper-jute\src\main\java\org\apache\jute\compiler\JBuffer.java,87,0,0,10,0,10
 zookeeper-master\zookeeper-master\zookeeper-contrib\zookeeper-contrib-rest\src\main\java\org\apache\zookeeper\server\jersey\resources\SessionsResource.java,87,0,4,1,0,5
 zookeeper-master\zookeeper-master\zookeeper-server\src\test\java\org\apache\zookeeper\server\InvalidSnapCountTest.java,87,0,4,3,4,11
 zookeeper-master\zookeeper-master\zookeeper-server\src\main\java\org\apache\zookeeper\server\admin\UnifiedConnectionFactory.java,87,0,2,13,1,16
 dubbo-3.0\dubbo-3.0\dubbo-common\src\main\java\org\apache\dubbo\common\profiler\Profiler.java,88,40,1,10,0,51
 dubbo-3.0\dubbo-3.0\dubbo-remoting\dubbo-remoting-netty4\src\test\java\org\apache\dubbo\remoting\transport\netty4\NettyChannelTest.java,88,28,3,13,0,44
 dubbo-3.0\dubbo-3.0\dubbo-remoting\dubbo-remoting-api\src\main\java\org\apache\dubbo\remoting\buffer\ChannelBufferInputStream.java,88,26,0,1,1,28
 dubbo-3.0\dubbo-3.0\dubbo-plugin\dubbo-qos\src\main\java\org\apache\dubbo\qos\command\impl\Help.java,88,14,0,3,0,17
 hadoop-trunk\hadoop-trunk\hadoop-tools\hadoop-openstack\src\main\java\org\apache\hadoop\fs\swift\util\HttpResponseUtils.java,88,11,1,3,1,16
 hadoop-trunk\hadoop-trunk\hadoop-common-project\hadoop-common\src\test\java\org\apache\hadoop\test\StatUtils.java,88,31,5,2,3,41
 hadoop-trunk\hadoop-trunk\hadoop-yarn-project\hadoop-yarn\hadoop-yarn-server\hadoop-yarn-server-resourcemanager\src\main\java\org\apache\hadoop\yarn\server\resourcemanager\scheduler\activities\ActivityDiagnosticConstant.java,88,57,0,1,0,58
 hadoop-trunk\hadoop-trunk\hadoop-tools\hadoop-azure\src\main\java\org\apache\hadoop\fs\azurebfs\services\AbfsPermission.java,88,21,2,6,0,29
 hadoop-trunk\hadoop-trunk\hadoop-tools\hadoop-aws\src\main\java\org\apache\hadoop\fs\s3a\commit\staging\DirectoryStagingCommitter.java,88,10,4,1,0,15
 hadoop-trunk\hadoop-trunk\hadoop-hdfs-project\hadoop-hdfs\src\main\java\org\apache\hadoop\hdfs\server\datanode\ReplicaWaitingToBeRecovered.java,88,32,3,1,0,36
 hadoop-trunk\hadoop-trunk\hadoop-hdfs-project\hadoop-hdfs\src\main\java\org\apache\hadoop\hdfs\server\protocol\BlockCommand.java,88,66,0,2,8,76
 hadoop-trunk\hadoop-trunk\hadoop-yarn-project\hadoop-yarn\hadoop-yarn-server\hadoop-yarn-server-resourcemanager\src\test\java\org\apache\hadoop\yarn\server\resourcemanager\scheduler\fair\TestFairSchedulerQueueACLs.java,88,8,0,1,1,10
 hadoop-trunk\hadoop-trunk\hadoop-hdfs-project\hadoop-hdfs-client\src\main\java\org\apache\hadoop\hdfs\protocol\datatransfer\DataTransferProtoUtil.java,88,18,31,5,0,54
 hadoop-trunk\hadoop-trunk\hadoop-common-project\hadoop-common\src\test\java\org\apache\hadoop\io\file\tfile\TestTFileComparators.java,88,27,6,1,3,37
 hadoop-trunk\hadoop-trunk\hadoop-mapreduce-project\hadoop-mapreduce-client\hadoop-mapreduce-client-jobclient\src\test\java\org\apache\hadoop\mapred\TestSequenceFileInputFormat.java,88,26,6,2,1,35
 hadoop-trunk\hadoop-trunk\hadoop-yarn-project\hadoop-yarn\hadoop-yarn-server\hadoop-yarn-server-nodemanager\src\main\java\org\apache\hadoop\yarn\server\nodemanager\containermanager\resourceplugin\gpu\GpuNodeResourceUpdateHandler.java,88,14,3,5,3,25
 hadoop-trunk\hadoop-trunk\hadoop-common-project\hadoop-common\src\main\java\org\apache\hadoop\util\CpuTimeTracker.java,88,18,0,1,0,19
 hadoop-trunk\hadoop-trunk\hadoop-tools\hadoop-aws\src\test\java\org\apache\hadoop\fs\s3a\audit\ITestAuditManager.java,88,4,0,7,0,11
 hadoop-trunk\hadoop-trunk\hadoop-mapreduce-project\hadoop-mapreduce-client\hadoop-mapreduce-client-jobclient\src\test\java\org\apache\hadoop\mapreduce\FailJob.java,88,45,15,3,4,67
 hadoop-trunk\hadoop-trunk\hadoop-mapreduce-project\hadoop-mapreduce-client\hadoop-mapreduce-client-app\src\test\java\org\apache\hadoop\mapred\TestYarnChild.java,88,17,1,2,0,20
 hadoop-trunk\hadoop-trunk\hadoop-tools\hadoop-rumen\src\main\java\org\apache\hadoop\tools\rumen\ParsedTaskAttempt.java,88,27,4,2,2,35
 hadoop-trunk\hadoop-trunk\hadoop-yarn-project\hadoop-yarn\hadoop-yarn-server\hadoop-yarn-server-resourcemanager\src\main\java\org\apache\hadoop\yarn\server\resourcemanager\scheduler\capacity\AbstractAutoCreatedLeafQueue.java,88,28,1,3,1,33
 hadoop-trunk\hadoop-trunk\hadoop-yarn-project\hadoop-yarn\hadoop-yarn-server\hadoop-yarn-server-common\src\test\java\org\apache\hadoop\yarn\TestYSCRPCFactories.java,88,21,5,7,7,40
 hadoop-trunk\hadoop-trunk\hadoop-yarn-project\hadoop-yarn\hadoop-yarn-server\hadoop-yarn-server-resourcemanager\src\test\java\org\apache\hadoop\yarn\server\resourcemanager\TestCapacitySchedulerMetrics.java,88,21,0,7,0,28
 hadoop-trunk\hadoop-trunk\hadoop-hdfs-project\hadoop-hdfs\src\test\java\org\apache\hadoop\hdfs\util\TestReferenceCountMap.java,88,14,0,1,0,15
 hadoop-trunk\hadoop-trunk\hadoop-common-project\hadoop-common\src\main\java\org\apache\hadoop\fs\viewfs\HCFSMountTableConfigLoader.java,88,7,2,1,1,11
 kafka-trunk\kafka-trunk\streams\src\test\java\org\apache\kafka\streams\integration\StreamsUpgradeTestIntegrationTest.java,88,0,0,15,0,15
 kafka-trunk\kafka-trunk\clients\src\generated\java\org\apache\kafka\common\message\CreatePartitionsResponseDataJsonConverter.java,88,0,0,22,0,22
 kafka-trunk\kafka-trunk\trogdor\src\main\java\org\apache\kafka\trogdor\workload\PartitionsSpec.java,88,0,0,7,2,9
 kafka-trunk\kafka-trunk\clients\src\generated\java\org\apache\kafka\common\message\AlterUserScramCredentialsResponseDataJsonConverter.java,88,0,0,23,0,23
 kafka-trunk\kafka-trunk\connect\runtime\src\main\java\org\apache\kafka\connect\runtime\isolation\PluginDesc.java,88,0,0,3,0,3
 kafka-trunk\kafka-trunk\streams\src\test\java\org\apache\kafka\streams\processor\internals\InternalTopicConfigTest.java,88,0,0,25,2,27
 kafka-trunk\kafka-trunk\metadata\src\test\java\org\apache\kafka\controller\QuorumControllerMetricsTest.java,88,0,1,18,0,19
 kafka-trunk\kafka-trunk\clients\src\main\java\org\apache\kafka\common\security\oauthbearer\internals\OAuthBearerSaslClientCallbackHandler.java,88,0,10,25,1,36
 kafka-trunk\kafka-trunk\clients\src\main\java\org\apache\kafka\clients\admin\TransactionDescription.java,88,0,2,3,2,7
 pulsar-master\pulsar-master\pulsar-broker\src\test\java\org\apache\pulsar\client\impl\ConsumerDedupPermitsUpdateTest.java,88,27,0,5,0,32
 pulsar-master\pulsar-master\pulsar-transaction\coordinator\src\test\java\org\apache\pulsar\transaction\coordinator\TxnStatusTest.java,88,8,0,4,0,12
 pulsar-master\pulsar-master\tests\integration\src\test\java\org\apache\pulsar\tests\integration\cli\tenant\TenantTest.java,88,36,0,29,0,65
 pulsar-master\pulsar-master\pulsar-broker-common\src\main\java\org\apache\pulsar\broker\web\plugin\servlet\AdditionalServlets.java,88,33,2,22,0,57
 pulsar-master\pulsar-master\pulsar-broker\src\main\java\org\apache\pulsar\broker\systopic\SystemTopicClientBase.java,88,25,1,2,0,28
 pulsar-master\pulsar-master\pulsar-common\src\test\java\org\apache\pulsar\common\policies\data\ClusterDataTest.java,88,4,0,4,0,8
 pulsar-master\pulsar-master\pulsar-io\kinesis\src\main\java\org\apache\pulsar\io\kinesis\KinesisRecordProcessor.java,88,27,3,7,0,37
 pulsar-master\pulsar-master\pulsar-broker\src\main\java\org\apache\pulsar\broker\service\persistent\MessageRedeliveryController.java,88,44,0,11,0,55
 pulsar-master\pulsar-master\pulsar-broker\src\test\java\org\apache\pulsar\broker\resourcegroup\ResourceUsageTransportManagerTest.java,88,28,0,14,0,42
 pulsar-master\pulsar-master\pulsar-broker\src\test\java\org\apache\pulsar\broker\service\DistributedIdGeneratorTest.java,88,20,2,9,0,31
 pulsar-master\pulsar-master\pulsar-broker-common\src\main\java\org\apache\pulsar\broker\web\AuthenticationFilter.java,88,36,2,20,0,58
 pulsar-master\pulsar-master\pulsar-proxy\src\test\java\org\apache\pulsar\proxy\server\BrokerProxyValidatorTest.java,88,38,8,16,0,62
 pulsar-master\pulsar-master\pulsar-broker\src\test\java\org\apache\pulsar\websocket\proxy\ProxyPublishConsumeWithoutZKTest.java,88,21,1,10,0,32
 rocketmq-develop\rocketmq-develop\example\src\main\java\org\apache\rocketmq\example\quickstart\Producer.java,88,14,1,10,1,26
 skywalking-master\skywalking-master\oap-server\server-alarm-plugin\src\test\java\org\apache\skywalking\oap\server\core\alarm\provider\dingtalk\DingtalkHookCallbackTest.java,88,27,2,19,0,48
 skywalking-master\skywalking-master\oap-server\server-receiver-plugin\skywalking-browser-receiver-plugin\src\main\java\org\apache\skywalking\oap\server\receiver\browser\provider\handler\rest\BrowserPerfServiceHTTPHandler.java,88,36,4,17,0,57
 skywalking-master\skywalking-master\oap-server\server-storage-plugin\storage-iotdb-plugin\src\main\java\org\apache\skywalking\oap\server\storage\plugin\iotdb\IoTDBStorageProvider.java,88,37,1,58,0,96
 zookeeper-master\zookeeper-master\zookeeper-server\src\test\java\org\apache\zookeeper\server\quorum\FLEOutOfElectionTest.java,88,0,1,29,0,30
 zookeeper-master\zookeeper-master\zookeeper-server\src\test\java\org\apache\zookeeper\ZKUtilTest.java,88,0,7,10,3,20
 zookeeper-master\zookeeper-master\zookeeper-contrib\zookeeper-contrib-fatjar\src\main\java\org\apache\zookeeper\util\FatJarMain.java,88,0,4,4,3,11
 dubbo-3.0\dubbo-3.0\dubbo-registry\dubbo-registry-api\src\test\java\org\apache\dubbo\registry\MockCacheableRegistryImpl.java,89,37,2,1,0,40
 dubbo-3.0\dubbo-3.0\dubbo-common\src\main\java\org\apache\dubbo\common\threadpool\MemoryLimitedLinkedBlockingQueue.java,89,43,0,7,0,50
 dubbo-3.0\dubbo-3.0\dubbo-rpc\dubbo-rpc-grpc\src\main\java\org\apache\dubbo\rpc\protocol\grpc\GrpcInvoker.java,89,26,2,6,0,34
 dubbo-3.0\dubbo-3.0\dubbo-rpc\dubbo-rpc-api\src\test\java\org\apache\dubbo\rpc\protocol\ProtocolListenerWrapperTest.java,89,27,0,23,4,54
 dubbo-3.0\dubbo-3.0\dubbo-rpc\dubbo-rpc-injvm\src\test\java\org\apache\dubbo\rpc\protocol\injvm\InjvmProtocolTest.java,89,33,0,22,0,55
 dubbo-3.0\dubbo-3.0\dubbo-rpc\dubbo-rpc-dubbo\src\test\java\org\apache\dubbo\rpc\protocol\dubbo\decode\MockChannel.java,89,25,7,1,0,33
 dubbo-3.0\dubbo-3.0\dubbo-remoting\dubbo-remoting-api\src\test\java\org\apache\dubbo\remoting\handler\MockedChannel.java,89,29,5,1,4,39
 dubbo-3.0\dubbo-3.0\dubbo-serialization\dubbo-serialization-jdk\src\main\java\org\apache\dubbo\common\serialize\nativejava\NativeJavaObjectInput.java,89,24,1,3,1,29
 hadoop-trunk\hadoop-trunk\hadoop-yarn-project\hadoop-yarn\hadoop-yarn-server\hadoop-yarn-server-common\src\main\java\org\apache\hadoop\yarn\server\security\BaseContainerTokenSecretManager.java,89,26,3,1,1,31
 hadoop-trunk\hadoop-trunk\hadoop-hdfs-project\hadoop-hdfs\src\test\java\org\apache\hadoop\hdfs\server\namenode\snapshot\TestFileContextSnapshot.java,89,18,3,1,6,28
 hadoop-trunk\hadoop-trunk\hadoop-hdfs-project\hadoop-hdfs\src\test\java\org\apache\hadoop\hdfs\TestDatanodeStartupFixesLegacyStorageIDs.java,89,13,2,3,0,18
 hadoop-trunk\hadoop-trunk\hadoop-tools\hadoop-resourceestimator\src\test\java\org\apache\hadoop\resourceestimator\common\serialization\TestHistorySkylineSerDe.java,89,20,1,3,6,30
 hadoop-trunk\hadoop-trunk\hadoop-yarn-project\hadoop-yarn\hadoop-yarn-api\src\main\java\org\apache\hadoop\yarn\api\records\UpdatedContainer.java,89,7,0,1,0,8
 hadoop-trunk\hadoop-trunk\hadoop-tools\hadoop-openstack\src\main\java\org\apache\hadoop\fs\swift\exceptions\SwiftInvalidResponseException.java,89,32,0,1,0,33
 hadoop-trunk\hadoop-trunk\hadoop-hdfs-project\hadoop-hdfs\src\test\java\org\apache\hadoop\hdfs\server\datanode\TestRefreshNamenodes.java,89,15,4,1,5,25
 hadoop-trunk\hadoop-trunk\hadoop-yarn-project\hadoop-yarn\hadoop-yarn-common\src\test\java\org\apache\hadoop\yarn\TestYarnUncaughtExceptionHandler.java,89,6,2,2,0,10
 hadoop-trunk\hadoop-trunk\hadoop-yarn-project\hadoop-yarn\hadoop-yarn-common\src\test\java\org\apache\hadoop\yarn\webapp\view\TestInfoBlock.java,89,33,2,3,2,40
 hadoop-trunk\hadoop-trunk\hadoop-common-project\hadoop-common\src\test\java\org\apache\hadoop\util\TestJarFinder.java,89,6,3,1,14,24
 hadoop-trunk\hadoop-trunk\hadoop-tools\hadoop-azure\src\test\java\org\apache\hadoop\fs\azurebfs\ITestAbfsHugeFiles.java,89,18,0,6,2,26
 hadoop-trunk\hadoop-trunk\hadoop-yarn-project\hadoop-yarn\hadoop-yarn-server\hadoop-yarn-server-resourcemanager\src\test\java\org\apache\hadoop\yarn\server\resourcemanager\scheduler\capacity\TestReservationQueue.java,89,31,3,4,0,38
 hadoop-trunk\hadoop-trunk\hadoop-yarn-project\hadoop-yarn\hadoop-yarn-api\src\main\java\org\apache\hadoop\yarn\api\protocolrecords\StartContainersResponse.java,89,14,0,1,0,15
 hadoop-trunk\hadoop-trunk\hadoop-yarn-project\hadoop-yarn\hadoop-yarn-server\hadoop-yarn-server-resourcemanager\src\main\java\org\apache\hadoop\yarn\server\resourcemanager\webapp\dao\PartitionResourcesInfo.java,89,58,1,1,18,78
 hadoop-trunk\hadoop-trunk\hadoop-yarn-project\hadoop-yarn\hadoop-yarn-server\hadoop-yarn-server-nodemanager\src\main\java\org\apache\hadoop\yarn\server\nodemanager\api\impl\pb\ResourceLocalizationSpecPBImpl.java,89,18,34,3,0,55
 hadoop-trunk\hadoop-trunk\hadoop-yarn-project\hadoop-yarn\hadoop-yarn-server\hadoop-yarn-server-timelineservice-hbase\hadoop-yarn-server-timelineservice-hbase-common\src\main\java\org\apache\hadoop\yarn\server\timelineservice\storage\common\TimestampGenerator.java,89,7,2,1,0,10
 hadoop-trunk\hadoop-trunk\hadoop-mapreduce-project\hadoop-mapreduce-client\hadoop-mapreduce-client-common\src\main\java\org\apache\hadoop\mapreduce\v2\api\records\impl\pb\TaskAttemptIdPBImpl.java,89,36,40,3,0,79
 kafka-trunk\kafka-trunk\clients\src\main\java\org\apache\kafka\clients\admin\ConsumerGroupListing.java,89,0,8,2,0,10
 kafka-trunk\kafka-trunk\clients\src\generated\java\org\apache\kafka\common\message\SyncGroupResponseDataJsonConverter.java,89,0,0,14,0,14
 kafka-trunk\kafka-trunk\clients\src\test\java\org\apache\kafka\common\requests\RequestHeaderTest.java,89,0,0,12,0,12
 kafka-trunk\kafka-trunk\connect\file\src\test\java\org\apache\kafka\connect\file\FileStreamSourceConnectorTest.java,89,0,1,11,0,12
 kafka-trunk\kafka-trunk\clients\src\test\java\org\apache\kafka\common\requests\ProduceResponseTest.java,89,0,1,29,0,30
 kafka-trunk\kafka-trunk\connect\runtime\src\test\java\org\apache\kafka\connect\integration\StartAndStopLatch.java,89,0,0,11,0,11
 kafka-trunk\kafka-trunk\clients\src\generated\java\org\apache\kafka\common\message\ConsumerProtocolAssignmentJsonConverter.java,89,0,0,21,0,21
 kafka-trunk\kafka-trunk\clients\src\test\java\org\apache\kafka\clients\admin\DescribeUserScramCredentialsResultTest.java,89,0,0,27,13,40
 kafka-trunk\kafka-trunk\streams\src\test\java\org\apache\kafka\streams\processor\internals\ProcessorRecordContextTest.java,89,0,1,2,3,6
 kafka-trunk\kafka-trunk\core\src\test\java\kafka\testkit\BrokerNode.java,89,0,0,2,3,5
 kafka-trunk\kafka-trunk\connect\api\src\main\java\org\apache\kafka\connect\health\ConnectorHealth.java,89,0,2,1,2,5
 kafka-trunk\kafka-trunk\clients\src\generated\java\org\apache\kafka\common\message\ListPartitionReassignmentsRequestDataJsonConverter.java,89,0,0,24,0,24
 kafka-trunk\kafka-trunk\clients\src\main\java\org\apache\kafka\clients\admin\MemberDescription.java,89,0,2,2,0,4
 pulsar-master\pulsar-master\pulsar-io\influxdb\src\main\java\org\apache\pulsar\io\influxdb\v1\InfluxDBSinkConfig.java,89,25,0,8,0,33
 pulsar-master\pulsar-master\pulsar-io\flume\src\test\java\org\apache\pulsar\io\flume\sink\StringSinkTests.java,89,24,2,1,0,27
 pulsar-master\pulsar-master\pulsar-testclient\src\main\java\org\apache\pulsar\testclient\DefaultMessageFormatter.java,89,13,2,2,0,17
 pulsar-master\pulsar-master\pulsar-functions\instance\src\main\java\org\apache\pulsar\functions\source\PulsarRecord.java,89,22,0,2,0,24
 pulsar-master\pulsar-master\pulsar-broker-common\src\test\java\org\apache\pulsar\broker\web\plugin\servlet\AdditionalServletUtilsTest.java,89,20,0,17,0,37
 pulsar-master\pulsar-master\pulsar-client-admin\src\main\java\org\apache\pulsar\client\admin\internal\ResourceGroupsImpl.java,89,43,0,13,0,56
 pulsar-master\pulsar-master\pulsar-io\kinesis\src\main\java\org\apache\pulsar\io\kinesis\KinesisSource.java,89,31,6,19,0,56
 pulsar-master\pulsar-master\pulsar-functions\runtime\src\test\java\org\apache\pulsar\functions\config\TestWorkerConfig.java,89,24,1,13,0,38
 pulsar-master\pulsar-master\pulsar-functions\runtime\src\test\java\org\apache\pulsar\functions\worker\WorkerApiV2ResourceConfigTest.java,89,54,3,29,0,86
 pulsar-master\pulsar-master\tests\integration\src\test\java\org\apache\pulsar\tests\integration\io\sources\debezium\PulsarIODebeziumSourceRunner.java,89,44,0,13,0,57
 pulsar-master\pulsar-master\pulsar-io\solr\src\main\java\org\apache\pulsar\io\solr\SolrAbstractSink.java,89,23,2,8,0,33
 rocketmq-develop\rocketmq-develop\common\src\test\java\org\apache\rocketmq\common\CountDownLatch2Test.java,89,11,1,2,1,15
 rocketmq-develop\rocketmq-develop\broker\src\main\java\org\apache\rocketmq\broker\pagecache\ManyMessageTransfer.java,89,30,0,7,2,39
 rocketmq-develop\rocketmq-develop\broker\src\main\java\org\apache\rocketmq\broker\pagecache\QueryMessageTransfer.java,89,29,0,7,2,38
 rocketmq-develop\rocketmq-develop\client\src\main\java\org\apache\rocketmq\client\consumer\rebalance\AllocateMessageQueueConsistentHash.java,89,32,0,9,0,41
 rocketmq-develop\rocketmq-develop\client\src\main\java\org\apache\rocketmq\client\impl\consumer\PullMessageService.java,89,29,2,9,1,41
 rocketmq-develop\rocketmq-develop\openmessaging\src\main\java\io\openmessaging\rocketmq\domain\BytesMessageImpl.java,89,38,0,2,2,42
 skywalking-master\skywalking-master\oap-server\server-configuration\configuration-consul\src\test\java\org\apache\skywalking\oap\server\configuration\consul\ConsulConfigurationTestProvider.java,89,18,2,10,0,30
 skywalking-master\skywalking-master\oap-server\server-configuration\configuration-apollo\src\test\java\org\apache\skywalking\oap\server\configuration\apollo\ApolloConfigurationTestProvider.java,89,16,2,8,0,26
 skywalking-master\skywalking-master\oap-server\server-configuration\configuration-nacos\src\test\java\org\apache\skywalking\oap\server\configuration\nacos\NacosConfigurationTestProvider.java,89,18,2,10,0,30
 skywalking-master\skywalking-master\oap-server\server-configuration\configuration-zookeeper\src\test\java\org\apache\skywalking\oap\server\configuration\zookeeper\it\MockZookeeperConfigurationProvider.java,89,18,2,8,0,28
 skywalking-master\skywalking-master\oap-server\server-core\src\main\java\org\apache\skywalking\oap\server\core\analysis\DispatcherManager.java,89,24,1,16,0,41
 skywalking-master\skywalking-master\oap-server\server-configuration\configuration-consul\src\test\java\org\apache\skywalking\oap\server\configuration\consul\ConsulConfigurationWatcherRegisterTest.java,89,19,2,13,0,34
 skywalking-master\skywalking-master\oap-server\server-storage-plugin\storage-iotdb-plugin\src\main\java\org\apache\skywalking\oap\server\storage\plugin\iotdb\IoTDBTableMetaInfo.java,89,17,0,10,0,27
 skywalking-master\skywalking-master\oap-server\server-query-plugin\query-graphql-plugin\src\main\java\org\apache\skywalking\oap\query\graphql\resolver\AggregationQuery.java,89,27,0,14,0,41
 zookeeper-master\zookeeper-master\zookeeper-server\src\test\java\org\apache\zookeeper\test\GetProposalFromTxnTest.java,89,0,12,6,1,19
 zookeeper-master\zookeeper-master\zookeeper-server\src\main\java\org\apache\zookeeper\server\quorum\LearnerSyncThrottler.java,89,0,2,9,1,12
 zookeeper-master\zookeeper-master\zookeeper-server\src\test\java\org\apache\zookeeper\test\ServerCnxnTest.java,89,0,1,5,2,8
 zookeeper-master\zookeeper-master\zookeeper-server\src\test\java\org\apache\zookeeper\test\MultiAsyncTransactionTest.java,89,0,2,12,3,17
 zookeeper-master\zookeeper-master\zookeeper-server\src\main\java\org\apache\zookeeper\server\admin\CommandResponse.java,89,0,0,1,0,1
 dubbo-3.0\dubbo-3.0\dubbo-remoting\dubbo-remoting-api\src\main\java\org\apache\dubbo\remoting\transport\ChannelHandlerDispatcher.java,90,33,11,4,1,49
 dubbo-3.0\dubbo-3.0\dubbo-remoting\dubbo-remoting-netty\src\main\java\org\apache\dubbo\remoting\transport\netty\NettyHandler.java,90,44,0,17,0,61
 dubbo-3.0\dubbo-3.0\dubbo-cluster\src\test\java\org\apache\dubbo\rpc\cluster\configurator\absent\AbsentConfiguratorTest.java,90,24,0,18,0,42
 dubbo-3.0\dubbo-3.0\dubbo-cluster\src\main\java\org\apache\dubbo\rpc\cluster\router\mesh\route\MeshRuleManager.java,90,33,1,13,0,47
 dubbo-3.0\dubbo-3.0\dubbo-spring-boot\dubbo-spring-boot-compatible\autoconfigure\src\test\java\org\apache\dubbo\spring\boot\autoconfigure\DubboAutoConfigurationOnSingleConfigTest.java,90,23,3,4,0,30
 file-management-system-master\file-management-system-master\src\main\java\com\fms\model\FileEntity.java,90,59,2,2,5,68
 hadoop-trunk\hadoop-trunk\hadoop-yarn-project\hadoop-yarn\hadoop-yarn-client\src\test\java\org\apache\hadoop\yarn\client\TestHedgingRequestRMFailoverProxyProvider.java,90,12,1,1,0,14
 hadoop-trunk\hadoop-trunk\hadoop-yarn-project\hadoop-yarn\hadoop-yarn-api\src\main\java\org\apache\hadoop\yarn\api\protocolrecords\ValidateVolumeCapabilitiesRequest.java,90,34,0,1,2,37
 hadoop-trunk\hadoop-trunk\hadoop-common-project\hadoop-common\src\main\java\org\apache\hadoop\ipc\ClientCache.java,90,19,0,3,0,22
 hadoop-trunk\hadoop-trunk\hadoop-yarn-project\hadoop-yarn\hadoop-yarn-applications\hadoop-yarn-services\hadoop-yarn-services-core\src\test\java\org\apache\hadoop\yarn\service\TestDefaultUpgradeComponentsFinder.java,90,7,0,1,0,8
 hadoop-trunk\hadoop-trunk\hadoop-common-project\hadoop-common\src\main\java\org\apache\hadoop\metrics2\MetricsJsonBuilder.java,90,37,0,1,2,40
 hadoop-trunk\hadoop-trunk\hadoop-yarn-project\hadoop-yarn\hadoop-yarn-common\src\main\java\org\apache\hadoop\yarn\api\protocolrecords\impl\pb\ValidateVolumeCapabilitiesRequestPBImpl.java,90,18,30,2,0,50
 hadoop-trunk\hadoop-trunk\hadoop-mapreduce-project\hadoop-mapreduce-client\hadoop-mapreduce-client-core\src\main\java\org\apache\hadoop\mapred\lib\ChainMapper.java,90,24,3,1,0,28
 hadoop-trunk\hadoop-trunk\hadoop-maven-plugins\src\main\java\org\apache\hadoop\maven\plugin\resourcegz\ResourceGzMojo.java,90,15,2,1,2,20
 hadoop-trunk\hadoop-trunk\hadoop-yarn-project\hadoop-yarn\hadoop-yarn-common\src\main\java\org\apache\hadoop\yarn\api\records\impl\pb\UpdatedContainerPBImpl.java,90,17,31,1,0,49
 hadoop-trunk\hadoop-trunk\hadoop-yarn-project\hadoop-yarn\hadoop-yarn-server\hadoop-yarn-server-common\src\test\java\org\apache\hadoop\yarn\server\webapp\TestLogWebService.java,90,14,0,1,0,15
 hadoop-trunk\hadoop-trunk\hadoop-hdfs-project\hadoop-hdfs\src\test\java\org\apache\hadoop\hdfs\TestDFSShellGenericOptions.java,90,46,2,2,3,53
 hadoop-trunk\hadoop-trunk\hadoop-mapreduce-project\hadoop-mapreduce-client\hadoop-mapreduce-client-jobclient\src\test\java\testjar\JobKillCommitter.java,90,37,4,3,0,44
 hadoop-trunk\hadoop-trunk\hadoop-yarn-project\hadoop-yarn\hadoop-yarn-server\hadoop-yarn-server-timelineservice-hbase-tests\src\test\java\org\apache\hadoop\yarn\server\timelineservice\storage\TestHBaseTimelineStorageDomain.java,90,5,2,6,0,13
 hadoop-trunk\hadoop-trunk\hadoop-yarn-project\hadoop-yarn\hadoop-yarn-server\hadoop-yarn-server-resourcemanager\src\main\java\org\apache\hadoop\yarn\server\resourcemanager\DBManager.java,90,26,5,1,0,32
 hadoop-trunk\hadoop-trunk\hadoop-mapreduce-project\hadoop-mapreduce-client\hadoop-mapreduce-client-jobclient\src\test\java\org\apache\hadoop\mapred\TestIFileStreams.java,90,21,4,1,7,33
 hadoop-trunk\hadoop-trunk\hadoop-yarn-project\hadoop-yarn\hadoop-yarn-server\hadoop-yarn-server-resourcemanager\src\main\java\org\apache\hadoop\yarn\server\resourcemanager\scheduler\distributed\QueueLimitCalculator.java,90,20,1,2,0,23
 hadoop-trunk\hadoop-trunk\hadoop-yarn-project\hadoop-yarn\hadoop-yarn-server\hadoop-yarn-server-resourcemanager\src\main\java\org\apache\hadoop\yarn\server\resourcemanager\monitor\SchedulingMonitor.java,90,23,5,1,1,30
 hadoop-trunk\hadoop-trunk\hadoop-common-project\hadoop-common\src\main\java\org\apache\hadoop\metrics2\MetricsRecordBuilder.java,90,12,0,1,0,13
 hadoop-trunk\hadoop-trunk\hadoop-hdfs-project\hadoop-hdfs\src\main\java\org\apache\hadoop\hdfs\server\datanode\fsdataset\impl\MemoryMappableBlockLoader.java,90,23,0,1,0,24
 hadoop-trunk\hadoop-trunk\hadoop-hdfs-project\hadoop-hdfs-client\src\main\java\org\apache\hadoop\hdfs\protocol\DatanodeAdminProperties.java,90,10,0,1,0,11
 hadoop-trunk\hadoop-trunk\hadoop-hdfs-project\hadoop-hdfs-client\src\main\java\org\apache\hadoop\hdfs\protocolPB\ReconfigurationProtocolTranslatorPB.java,90,23,15,5,0,43
 hadoop-trunk\hadoop-trunk\hadoop-yarn-project\hadoop-yarn\hadoop-yarn-server\hadoop-yarn-server-timelineservice\src\main\java\org\apache\hadoop\yarn\server\timelineservice\security\TimelineV2DelegationTokenSecretManagerService.java,90,30,1,3,0,34
 hadoop-trunk\hadoop-trunk\hadoop-common-project\hadoop-common\src\test\java\org\apache\hadoop\io\TestDefaultStringifier.java,90,37,5,8,0,50
 hadoop-trunk\hadoop-trunk\hadoop-yarn-project\hadoop-yarn\hadoop-yarn-api\src\main\java\org\apache\hadoop\yarn\api\records\YarnClusterMetrics.java,90,15,0,1,0,16
 hadoop-trunk\hadoop-trunk\hadoop-mapreduce-project\hadoop-mapreduce-client\hadoop-mapreduce-client-nativetask\src\test\java\org\apache\hadoop\mapred\nativetask\handlers\TestNativeCollectorOnlyHandler.java,90,20,0,5,1,26
 hadoop-trunk\hadoop-trunk\hadoop-yarn-project\hadoop-yarn\hadoop-yarn-common\src\main\java\org\apache\hadoop\yarn\factories\impl\pb\RpcClientFactoryPBImpl.java,90,30,6,6,1,43
 hadoop-trunk\hadoop-trunk\hadoop-tools\hadoop-dynamometer\hadoop-dynamometer-blockgen\src\main\java\org\apache\hadoop\tools\dynamometer\blockgenerator\GenerateBlockImagesDriver.java,90,16,16,1,0,33
 hadoop-trunk\hadoop-trunk\hadoop-yarn-project\hadoop-yarn\hadoop-yarn-server\hadoop-yarn-server-web-proxy\src\main\java\org\apache\hadoop\yarn\server\webproxy\ProxyUtils.java,90,19,4,1,0,24
 kafka-trunk\kafka-trunk\clients\src\main\java\org\apache\kafka\common\requests\DeleteTopicsRequest.java,90,0,38,7,2,47
 kafka-trunk\kafka-trunk\streams\src\test\java\org\apache\kafka\streams\kstream\internals\AbstractStreamTest.java,90,0,1,18,6,25
 kafka-trunk\kafka-trunk\clients\src\main\java\org\apache\kafka\clients\admin\DeleteAclsResult.java,90,0,2,11,3,16
 kafka-trunk\kafka-trunk\clients\src\test\java\org\apache\kafka\common\message\ApiMessageTypeTest.java,90,0,4,19,0,23
 kafka-trunk\kafka-trunk\clients\src\main\java\org\apache\kafka\common\resource\ResourcePattern.java,90,0,2,10,0,12
 kafka-trunk\kafka-trunk\streams\src\test\java\org\apache\kafka\streams\kstream\PrintedTest.java,90,0,1,16,6,23
 kafka-trunk\kafka-trunk\clients\src\main\java\org\apache\kafka\common\requests\OffsetCommitRequest.java,90,0,0,15,3,18
 kafka-trunk\kafka-trunk\streams\src\test\java\org\apache\kafka\streams\processor\internals\assignment\StandbyTaskAssignmentUtilsTest.java,90,0,0,32,3,35
 kafka-trunk\kafka-trunk\clients\src\main\java\org\apache\kafka\clients\admin\ListTransactionsResult.java,90,0,0,23,0,23
 kafka-trunk\kafka-trunk\clients\src\test\java\org\apache\kafka\common\network\NetworkTestUtils.java,90,0,2,26,1,29
 kafka-trunk\kafka-trunk\streams\src\main\java\org\apache\kafka\streams\processor\internals\PunctuationSchedule.java,90,0,2,4,2,8
 pulsar-master\pulsar-master\pulsar-broker\src\test\java\org\apache\pulsar\broker\intercept\BrokerInterceptorUtilsTest.java,90,21,0,19,0,40
 pulsar-master\pulsar-master\pulsar-broker\src\test\java\org\apache\pulsar\client\impl\DynamicReceiverQueueSizeTest.java,90,35,0,10,0,45
 pulsar-master\pulsar-master\managed-ledger\src\test\java\org\apache\bookkeeper\mledger\impl\ManagedLedgerInfoMetadataTest.java,90,22,2,17,0,41
 pulsar-master\pulsar-master\pulsar-broker\src\test\java\org\apache\pulsar\client\impl\TopicFromMessageTest.java,90,22,0,14,0,36
 pulsar-master\pulsar-master\pulsar-client\src\test\java\org\apache\pulsar\client\impl\BuildersTest.java,90,37,1,20,0,58
 pulsar-master\pulsar-master\pulsar-package-management\bookkeeper-storage\src\test\java\org\apache\pulsar\packages\management\storage\bookkeeper\bookkeeper\test\PortManager.java,90,23,2,8,0,33
 pulsar-master\pulsar-master\pulsar-broker\src\test\java\org\apache\pulsar\utils\SimpleTextOutputStreamTest.java,90,21,0,2,0,23
 rocketmq-develop\rocketmq-develop\tools\src\main\java\org\apache\rocketmq\tools\command\acl\GetAccessConfigSubCommand.java,90,20,2,12,8,42
 rocketmq-develop\rocketmq-develop\acl\src\main\java\org\apache\rocketmq\acl\common\Permission.java,90,30,3,9,7,49
 shardingsphere-master\shardingsphere-master\shardingsphere-jdbc\shardingsphere-jdbc-core\src\main\java\org\apache\shardingsphere\driver\jdbc\adapter\AbstractResultSetAdapter.java,90,37,0,17,0,54
 shardingsphere-master\shardingsphere-master\examples\example-core\example-raw-jdbc\src\main\java\org\apache\shardingsphere\example\core\jdbc\repository\OrderItemRepositoryImpl.java,90,30,0,10,0,40
 shardingsphere-master\shardingsphere-master\shardingsphere-sql-parser\shardingsphere-sql-parser-statement\src\main\java\org\apache\shardingsphere\sql\parser\sql\common\segment\ddl\routine\ValidStatementSegment.java,90,24,0,18,0,42
 skywalking-master\skywalking-master\oap-server\server-receiver-plugin\skywalking-zabbix-receiver-plugin\src\test\java\org\apache\skywalking\oap\server\receiver\zabbix\provider\ZabbixMetricsTest.java,90,38,0,26,0,64
 skywalking-master\skywalking-master\oap-server\server-storage-plugin\storage-iotdb-plugin\src\main\java\org\apache\skywalking\oap\server\storage\plugin\iotdb\query\IoTDBAggregationQueryDAO.java,90,23,0,17,0,40
 skywalking-master\skywalking-master\oap-server\server-core\src\main\java\org\apache\skywalking\oap\server\core\CoreModule.java,90,12,0,7,0,19
 skywalking-master\skywalking-master\oap-server\server-storage-plugin\storage-influxdb-plugin\src\main\java\org\apache\skywalking\oap\server\storage\plugin\influxdb\InfluxStorageProvider.java,90,35,1,55,0,91
 zookeeper-master\zookeeper-master\zookeeper-server\src\test\java\org\apache\zookeeper\test\LocalSessionsOnlyTest.java,90,0,8,9,0,17
 zookeeper-master\zookeeper-master\zookeeper-contrib\zookeeper-contrib-loggraph\src\test\java\org\apache\zookeeper\graph\servlets\FileLoaderTest.java,90,0,4,8,0,12
 dubbo-3.0\dubbo-3.0\dubbo-remoting\dubbo-remoting-api\src\main\java\org\apache\dubbo\remoting\transport\ServerDelegate.java,91,33,1,1,0,35
 dubbo-3.0\dubbo-3.0\dubbo-common\src\test\java\org\apache\dubbo\common\compiler\support\JavaCodeTest.java,91,19,1,7,0,27
 dubbo-3.0\dubbo-3.0\dubbo-common\src\main\java\org\apache\dubbo\common\config\configcenter\wrapper\CompositeDynamicConfiguration.java,91,53,1,17,1,72
 dubbo-3.0\dubbo-3.0\dubbo-common\src\test\java\org\apache\dubbo\common\utils\IOUtilsTest.java,91,28,0,4,16,48
 dubbo-3.0\dubbo-3.0\dubbo-registry\dubbo-registry-api\src\test\java\org\apache\dubbo\registry\client\metadata\store\MetaCacheManagerTest.java,91,16,1,11,0,28
 dubbo-3.0\dubbo-3.0\dubbo-config\dubbo-config-spring\src\test\java\org\apache\dubbo\config\spring\context\annotation\DubboComponentScanRegistrarTest.java,91,11,1,11,0,23
 hadoop-trunk\hadoop-trunk\hadoop-mapreduce-project\hadoop-mapreduce-client\hadoop-mapreduce-client-nativetask\src\test\java\org\apache\hadoop\mapred\nativetask\kvtest\LargeKVTest.java,91,22,2,8,0,32
 hadoop-trunk\hadoop-trunk\hadoop-mapreduce-project\hadoop-mapreduce-client\hadoop-mapreduce-client-jobclient\src\test\java\org\apache\hadoop\mapred\lib\TestLineInputFormat.java,91,33,6,2,2,43
 hadoop-trunk\hadoop-trunk\hadoop-mapreduce-project\hadoop-mapreduce-client\hadoop-mapreduce-client-jobclient\src\test\java\org\apache\hadoop\mapreduce\lib\fieldsel\TestMRFieldSelection.java,91,106,26,1,0,133
 hadoop-trunk\hadoop-trunk\hadoop-mapreduce-project\hadoop-mapreduce-client\hadoop-mapreduce-client-jobclient\src\test\java\org\apache\hadoop\mapreduce\lib\input\TestNLineInputFormat.java,91,27,0,2,1,30
 hadoop-trunk\hadoop-trunk\hadoop-mapreduce-project\hadoop-mapreduce-client\hadoop-mapreduce-client-jobclient\src\test\java\org\apache\hadoop\mapred\TestSpecialCharactersInOutputPath.java,91,31,10,3,1,45
 hadoop-trunk\hadoop-trunk\hadoop-yarn-project\hadoop-yarn\hadoop-yarn-server\hadoop-yarn-server-web-proxy\src\test\java\org\apache\hadoop\yarn\server\webproxy\TestProxyUriUtils.java,91,67,1,9,3,80
 hadoop-trunk\hadoop-trunk\hadoop-yarn-project\hadoop-yarn\hadoop-yarn-common\src\test\java\org\apache\hadoop\yarn\util\TestConverterUtils.java,91,24,1,1,0,26
 hadoop-trunk\hadoop-trunk\hadoop-common-project\hadoop-common\src\test\java\org\apache\hadoop\metrics2\util\TestSampleQuantiles.java,91,16,0,1,0,17
 hadoop-trunk\hadoop-trunk\hadoop-hdfs-project\hadoop-hdfs\src\main\java\org\apache\hadoop\hdfs\server\diskbalancer\command\ExecuteCommand.java,91,9,1,1,2,13
 hadoop-trunk\hadoop-trunk\hadoop-tools\hadoop-azure\src\test\java\org\apache\hadoop\fs\azurebfs\AbstractAbfsTestWithTimeout.java,91,6,2,2,1,11
 hadoop-trunk\hadoop-trunk\hadoop-yarn-project\hadoop-yarn\hadoop-yarn-server\hadoop-yarn-server-resourcemanager\src\test\java\org\apache\hadoop\yarn\server\resourcemanager\scheduler\capacity\TestCapacitySchedulerAmbiguousLeafs.java,91,19,1,6,0,26
 hadoop-trunk\hadoop-trunk\hadoop-hdfs-project\hadoop-hdfs-rbf\src\test\java\org\apache\hadoop\hdfs\server\federation\router\TestRouterMultiRack.java,91,12,2,4,1,19
 hadoop-trunk\hadoop-trunk\hadoop-yarn-project\hadoop-yarn\hadoop-yarn-server\hadoop-yarn-server-router\src\main\java\org\apache\hadoop\yarn\server\router\webapp\AppsBlock.java,91,8,1,1,1,11
 hadoop-trunk\hadoop-trunk\hadoop-hdfs-project\hadoop-hdfs\src\test\java\org\apache\hadoop\cli\TestErasureCodingCLI.java,91,16,3,1,2,22
 hadoop-trunk\hadoop-trunk\hadoop-hdfs-project\hadoop-hdfs\src\test\java\org\apache\hadoop\hdfs\client\impl\TestClientBlockVerification.java,91,34,7,1,1,43
 hadoop-trunk\hadoop-trunk\hadoop-common-project\hadoop-common\src\main\java\org\apache\hadoop\tools\CommandShell.java,91,22,0,1,4,27
 hadoop-trunk\hadoop-trunk\hadoop-mapreduce-project\hadoop-mapreduce-client\hadoop-mapreduce-client-common\src\main\java\org\apache\hadoop\mapreduce\v2\api\records\impl\pb\JobIdPBImpl.java,91,28,39,1,0,68
 hadoop-trunk\hadoop-trunk\hadoop-hdfs-project\hadoop-hdfs-rbf\src\main\java\org\apache\hadoop\hdfs\server\federation\store\driver\StateStoreSerializer.java,91,7,0,1,1,9
 hadoop-trunk\hadoop-trunk\hadoop-tools\hadoop-sls\src\test\java\org\apache\hadoop\yarn\sls\web\TestSLSWebApp.java,91,24,0,4,2,30
 hadoop-trunk\hadoop-trunk\hadoop-hdfs-project\hadoop-hdfs\src\test\java\org\apache\hadoop\hdfs\server\namenode\TestXAttrFeature.java,91,37,11,1,1,50
 hadoop-trunk\hadoop-trunk\hadoop-yarn-project\hadoop-yarn\hadoop-yarn-server\hadoop-yarn-server-nodemanager\src\test\java\org\apache\hadoop\yarn\server\nodemanager\containermanager\resourceplugin\gpu\TestNvidiaDockerV2CommandPlugin.java,91,10,3,5,1,19
 hadoop-trunk\hadoop-trunk\hadoop-tools\hadoop-azure\src\main\java\org\apache\hadoop\fs\azurebfs\contracts\annotations\ConfigurationValidationAnnotations.java,91,25,0,1,0,26
 hadoop-trunk\hadoop-trunk\hadoop-mapreduce-project\hadoop-mapreduce-client\hadoop-mapreduce-client-jobclient\src\test\java\org\apache\hadoop\mapreduce\security\TestMRCredentials.java,91,42,4,3,5,54
 hadoop-trunk\hadoop-trunk\hadoop-yarn-project\hadoop-yarn\hadoop-yarn-server\hadoop-yarn-server-resourcemanager\src\main\java\org\apache\hadoop\yarn\server\resourcemanager\scheduler\fair\ReservationQueueConfiguration.java,91,47,0,2,0,49
 kafka-trunk\kafka-trunk\streams\src\main\java\org\apache\kafka\streams\processor\internals\StreamsRebalanceListener.java,91,0,3,22,0,25
 kafka-trunk\kafka-trunk\clients\src\main\java\org\apache\kafka\common\config\ConfigValue.java,91,0,2,3,5,10
 kafka-trunk\kafka-trunk\clients\src\generated\java\org\apache\kafka\common\message\DescribeClientQuotasRequestDataJsonConverter.java,91,0,0,19,0,19
 kafka-trunk\kafka-trunk\trogdor\src\main\java\org\apache\kafka\trogdor\coordinator\CoordinatorRestResource.java,91,0,3,15,0,18
 LittleBooks-master\LittleBooks-master\app\src\main\java\com\example\littlebooks\old\BooksActivity.java,91,74,10,6,0,90
 pulsar-master\pulsar-master\managed-ledger\src\test\java\org\apache\bookkeeper\mledger\util\TestStatsBuckets.java,91,37,2,1,0,40
 pulsar-master\pulsar-master\pulsar-sql\presto-pulsar\src\main\java\org\apache\pulsar\sql\presto\PulsarTableHandle.java,91,23,0,1,0,24
 pulsar-master\pulsar-master\pulsar-websocket\src\main\java\org\apache\pulsar\websocket\stats\StatsBuckets.java,91,32,0,3,0,35
 pulsar-master\pulsar-master\pulsar-io\netty\src\main\java\org\apache\pulsar\io\netty\http\NettyHttpServerHandler.java,91,35,0,14,0,49
 rocketmq-develop\rocketmq-develop\common\src\main\java\org\apache\rocketmq\common\protocol\header\CreateAccessConfigRequestHeader.java,91,57,1,1,0,59
 rocketmq-develop\rocketmq-develop\test\src\main\java\org\apache\rocketmq\test\clientinterface\MQCollector.java,91,40,0,3,3,46
 skywalking-master\skywalking-master\oap-server\server-receiver-plugin\skywalking-trace-receiver-plugin\src\test\java\org\apache\skywalking\oap\server\receiver\trace\provider\parser\listener\EndpointDepFromCrossThreadAnalysisListenerTest.java,91,38,1,27,0,66
 skywalking-master\skywalking-master\oap-server\server-core\src\test\java\org\apache\skywalking\oap\server\core\analysis\meter\function\avg\AvgLabeledFunctionTest.java,91,51,0,25,0,76
 skywalking-master\skywalking-master\oap-server\analyzer\meter-analyzer\src\test\java\org\apache\skywalking\oap\meter\analyzer\dsl\ExpressionParsingTest.java,91,30,1,14,0,45
 zookeeper-master\zookeeper-master\zookeeper-server\src\main\java\org\apache\zookeeper\cli\CliCommand.java,91,0,0,1,3,4
 zookeeper-master\zookeeper-master\zookeeper-server\src\test\java\org\apache\zookeeper\server\MultiOpSessionUpgradeTest.java,91,0,20,23,1,44
 zookeeper-master\zookeeper-master\zookeeper-server\src\main\java\org\apache\zookeeper\server\metric\AvgMinMaxCounter.java,91,0,3,3,0,6
 zookeeper-master\zookeeper-master\zookeeper-server\src\main\java\org\apache\zookeeper\common\IOUtils.java,91,0,4,3,0,7
 dubbo-3.0\dubbo-3.0\dubbo-config\dubbo-config-spring\src\test\java\org\apache\dubbo\config\spring\registry\nacos\nacos\NacosServiceNameTest.java,92,20,0,5,0,25
 dubbo-3.0\dubbo-3.0\dubbo-metadata\dubbo-metadata-processor\src\test\java\org\apache\dubbo\metadata\annotation\processing\builder\PrimitiveTypeDefinitionBuilderTest.java,92,36,0,10,0,46
 dubbo-3.0\dubbo-3.0\dubbo-remoting\dubbo-remoting-api\src\test\java\org\apache\dubbo\remoting\ChanelHandlerTest.java,92,32,2,10,2,46
 hadoop-trunk\hadoop-trunk\hadoop-tools\hadoop-aws\src\test\java\org\apache\hadoop\fs\s3a\s3guard\TestAuthoritativePath.java,92,16,0,1,1,18
 hadoop-trunk\hadoop-trunk\hadoop-mapreduce-project\hadoop-mapreduce-client\hadoop-mapreduce-client-jobclient\src\test\java\org\apache\hadoop\mapreduce\lib\aggregate\TestMapReduceAggregates.java,92,12,7,1,1,21
 hadoop-trunk\hadoop-trunk\hadoop-yarn-project\hadoop-yarn\hadoop-yarn-common\src\main\java\org\apache\hadoop\yarn\api\protocolrecords\impl\pb\GetLabelsToNodesRequestPBImpl.java,92,26,33,3,0,62
 hadoop-trunk\hadoop-trunk\hadoop-yarn-project\hadoop-yarn\hadoop-yarn-server\hadoop-yarn-server-resourcemanager\src\main\java\org\apache\hadoop\yarn\server\resourcemanager\reservation\ReservationInterval.java,92,25,2,1,0,28
 hadoop-trunk\hadoop-trunk\hadoop-yarn-project\hadoop-yarn\hadoop-yarn-server\hadoop-yarn-server-resourcemanager\src\main\java\org\apache\hadoop\yarn\server\resourcemanager\scheduler\event\AppAddedSchedulerEvent.java,92,85,0,1,8,94
 hadoop-trunk\hadoop-trunk\hadoop-mapreduce-project\hadoop-mapreduce-client\hadoop-mapreduce-client-app\src\test\java\org\apache\hadoop\mapreduce\v2\app\speculate\forecast\TestSimpleExponentialForecast.java,92,41,3,1,0,45
 hadoop-trunk\hadoop-trunk\hadoop-hdfs-project\hadoop-hdfs\src\main\java\org\apache\hadoop\hdfs\server\protocol\ReceivedDeletedBlockInfo.java,92,49,1,1,3,54
 hadoop-trunk\hadoop-trunk\hadoop-yarn-project\hadoop-yarn\hadoop-yarn-server\hadoop-yarn-server-resourcemanager\src\main\java\org\apache\hadoop\yarn\server\resourcemanager\reservation\FairSchedulerPlanFollower.java,92,35,4,4,2,45
 hadoop-trunk\hadoop-trunk\hadoop-hdfs-project\hadoop-hdfs\src\test\java\org\apache\hadoop\hdfs\server\namenode\TestNameNodeHttpServer.java,92,23,2,2,2,29
 hadoop-trunk\hadoop-trunk\hadoop-common-project\hadoop-common\src\main\java\org\apache\hadoop\util\ToolRunner.java,92,43,5,2,0,50
 hadoop-trunk\hadoop-trunk\hadoop-common-project\hadoop-common\src\test\java\org\apache\hadoop\crypto\random\TestOpensslSecureRandom.java,92,43,0,1,0,44
 hadoop-trunk\hadoop-trunk\hadoop-common-project\hadoop-common\src\main\java\org\apache\hadoop\io\compress\CompressorStream.java,92,38,5,2,1,46
 hadoop-trunk\hadoop-trunk\hadoop-hdfs-project\hadoop-hdfs\src\test\java\org\apache\hadoop\hdfs\TestAbandonBlock.java,92,32,0,4,0,36
 hadoop-trunk\hadoop-trunk\hadoop-common-project\hadoop-auth\src\test\java\org\apache\hadoop\security\authentication\server\TestPseudoAuthenticationHandler.java,92,11,3,3,0,17
 hadoop-trunk\hadoop-trunk\hadoop-tools\hadoop-rumen\src\main\java\org\apache\hadoop\tools\rumen\TaskInfo.java,92,60,0,1,2,63
 hadoop-trunk\hadoop-trunk\hadoop-yarn-project\hadoop-yarn\hadoop-yarn-server\hadoop-yarn-server-resourcemanager\src\test\java\org\apache\hadoop\yarn\server\resourcemanager\blacklist\TestBlacklistManager.java,92,11,0,1,0,12
 hadoop-trunk\hadoop-trunk\hadoop-mapreduce-project\hadoop-mapreduce-client\hadoop-mapreduce-client-common\src\main\java\org\apache\hadoop\mapreduce\v2\api\records\TaskId.java,92,22,7,1,0,30
 hadoop-trunk\hadoop-trunk\hadoop-yarn-project\hadoop-yarn\hadoop-yarn-server\hadoop-yarn-server-resourcemanager\src\main\java\org\apache\hadoop\yarn\server\resourcemanager\scheduler\capacity\CapacitySchedulerMetrics.java,92,47,1,1,2,51
 hadoop-trunk\hadoop-trunk\hadoop-yarn-project\hadoop-yarn\hadoop-yarn-server\hadoop-yarn-server-common\src\main\java\org\apache\hadoop\yarn\server\federation\store\records\impl\pb\GetSubClusterInfoRequestPBImpl.java,92,18,35,5,0,58
 hadoop-trunk\hadoop-trunk\hadoop-common-project\hadoop-common\src\test\java\org\apache\hadoop\fs\contract\AbstractContractDeleteTest.java,92,12,2,1,0,15
 hadoop-trunk\hadoop-trunk\hadoop-common-project\hadoop-common\src\test\java\org\apache\hadoop\crypto\key\kms\TestKMSClientProvider.java,92,16,18,2,0,36
 kafka-trunk\kafka-trunk\connect\transforms\src\main\java\org\apache\kafka\connect\transforms\ExtractField.java,92,0,1,19,0,20
 kafka-trunk\kafka-trunk\connect\runtime\src\test\java\org\apache\kafka\connect\util\clusters\WorkerHandle.java,92,0,1,4,0,5
 kafka-trunk\kafka-trunk\metadata\src\test\java\org\apache\kafka\metadata\PartitionRegistrationTest.java,92,0,0,19,0,19
 kafka-trunk\kafka-trunk\clients\src\test\java\org\apache\kafka\clients\admin\internals\DeleteConsumerGroupsHandlerTest.java,92,0,2,14,1,17
 kafka-trunk\kafka-trunk\streams\upgrade-system-tests-23\src\test\java\org\apache\kafka\streams\tests\StreamsUpgradeToCooperativeRebalanceTest.java,92,0,2,17,0,19
 kafka-trunk\kafka-trunk\clients\src\main\java\org\apache\kafka\common\requests\AddPartitionsToTxnResponse.java,92,0,0,13,4,17
 kafka-trunk\kafka-trunk\streams\src\test\java\org\apache\kafka\streams\kstream\internals\FullChangeSerdeTest.java,92,0,1,21,1,23
 kafka-trunk\kafka-trunk\clients\src\main\java\org\apache\kafka\common\requests\DescribeAclsRequest.java,92,0,31,10,1,42
 pulsar-master\pulsar-master\pulsar-io\file\src\test\java\org\apache\pulsar\io\file\AbstractFileTests.java,92,51,0,12,0,63
 pulsar-master\pulsar-master\pulsar-common\src\main\java\org\apache\pulsar\common\policies\data\NamespaceIsolationDataImpl.java,92,41,1,12,0,54
 pulsar-master\pulsar-master\pulsar-websocket\src\main\java\org\apache\pulsar\websocket\stats\JvmMetrics.java,92,24,11,10,0,45
 pulsar-master\pulsar-master\pulsar-testclient\src\main\java\org\apache\pulsar\testclient\CmdGenerateDocumentation.java,92,23,3,16,0,42
 rocketmq-develop\rocketmq-develop\test\src\main\java\org\apache\rocketmq\test\clientinterface\AbstractMQConsumer.java,92,73,1,1,4,79
 shardingsphere-master\shardingsphere-master\shardingsphere-test\shardingsphere-integration-test\shardingsphere-integration-test-suite\src\test\java\org\apache\shardingsphere\test\integration\engine\rdl\BaseRDLIT.java,92,30,2,19,0,51
 skywalking-master\skywalking-master\oap-server\server-core\src\main\java\org\apache\skywalking\oap\server\core\config\group\openapi\EndpointGroupingRule4Openapi.java,92,40,0,18,0,58
 skywalking-master\skywalking-master\oap-server\server-receiver-plugin\envoy-metrics-receiver-plugin\src\main\java\org\apache\skywalking\oap\server\receiver\envoy\metrics\adapters\ProtoMetricFamily2MetricsAdapter.java,92,28,0,14,0,42
 skywalking-master\skywalking-master\oap-server\microbench\src\main\java\org\apache\skywalking\oap\server\microbench\library\util\StringFormatGroupBenchmark.java,92,24,0,20,0,44
 skywalking-master\skywalking-master\oap-server\server-core\src\test\java\org\apache\skywalking\oap\server\core\analysis\metrics\MetricsTest.java,92,17,2,1,0,20
 skywalking-master\skywalking-master\oap-server\server-alarm-plugin\src\test\java\org\apache\skywalking\oap\server\core\alarm\provider\EventHookCallbackTest.java,92,30,0,15,0,45
 skywalking-master\skywalking-master\oap-server\server-receiver-plugin\skywalking-browser-receiver-plugin\src\main\java\org\apache\skywalking\oap\server\receiver\browser\provider\parser\performance\BrowserPerfDataDecorator.java,92,51,0,9,0,60
 skywalking-master\skywalking-master\oap-server\server-core\src\main\java\org\apache\skywalking\oap\server\core\analysis\metrics\PercentileMetrics.java,92,25,0,11,0,36
 zookeeper-master\zookeeper-master\zookeeper-server\src\test\java\org\apache\zookeeper\TestableZooKeeper.java,92,0,7,2,3,12
 zookeeper-master\zookeeper-master\zookeeper-server\src\test\java\org\apache\zookeeper\test\RestoreCommittedLogTest.java,92,0,3,12,2,17
 zookeeper-master\zookeeper-master\zookeeper-server\src\test\java\org\apache\zookeeper\test\QuorumOracleMajTest.java,92,0,1,6,1,8
 zookeeper-master\zookeeper-master\zookeeper-server\src\main\java\org\apache\zookeeper\server\auth\EnsembleAuthenticationProvider.java,92,0,0,7,0,7
 zookeeper-master\zookeeper-master\zookeeper-server\src\main\java\org\apache\zookeeper\server\controller\ControllableConnectionFactory.java,92,0,2,7,0,9
 zookeeper-master\zookeeper-master\zookeeper-server\src\test\java\org\apache\zookeeper\test\UnsupportedAddWatcherTest.java,92,0,0,7,0,7
 zookeeper-master\zookeeper-master\zookeeper-server\src\test\java\org\apache\zookeeper\server\embedded\ZookeeperServerClusterTest.java,92,0,1,14,0,15
 dubbo-3.0\dubbo-3.0\dubbo-common\src\main\java\org\apache\dubbo\common\utils\ServiceAnnotationResolver.java,93,29,0,8,1,38
 dubbo-3.0\dubbo-3.0\dubbo-config\dubbo-config-api\src\test\java\org\apache\dubbo\config\MetricsConfigTest.java,93,29,0,18,0,47
 dubbo-3.0\dubbo-3.0\dubbo-rpc\dubbo-rpc-dubbo\src\test\java\org\apache\dubbo\rpc\protocol\dubbo\filter\MockChannel.java,93,31,4,1,0,36
 dubbo-3.0\dubbo-3.0\dubbo-common\src\main\java\org\apache\dubbo\common\beans\support\InstantiationStrategy.java,93,22,1,7,0,30
 file-management-system-master\file-management-system-master\src\test\java\com\fms\service\storage\FileStorageStrategyFactoryTest.java,93,58,6,30,2,96
 hadoop-trunk\hadoop-trunk\hadoop-hdfs-project\hadoop-hdfs-rbf\src\test\java\org\apache\hadoop\hdfs\server\federation\router\TestRouterQuotaManager.java,93,6,0,1,1,8
 hadoop-trunk\hadoop-trunk\hadoop-common-project\hadoop-auth\src\test\java\org\apache\hadoop\security\authentication\client\TestAuthenticatedURL.java,93,8,0,3,0,11
 hadoop-trunk\hadoop-trunk\hadoop-hdfs-project\hadoop-hdfs-rbf\src\test\java\org\apache\hadoop\fs\contract\router\web\RouterWebHDFSContract.java,93,15,2,3,1,21
 hadoop-trunk\hadoop-trunk\hadoop-tools\hadoop-openstack\src\main\java\org\apache\hadoop\fs\swift\util\JSONUtil.java,93,12,3,2,0,17
 hadoop-trunk\hadoop-trunk\hadoop-hdfs-project\hadoop-hdfs-rbf\src\test\java\org\apache\hadoop\hdfs\server\federation\resolver\order\TestLocalResolver.java,93,8,0,5,0,13
 hadoop-trunk\hadoop-trunk\hadoop-yarn-project\hadoop-yarn\hadoop-yarn-client\src\test\java\org\apache\hadoop\yarn\client\api\impl\AMRMTokenIdentifierForTest.java,93,58,38,3,0,99
 hadoop-trunk\hadoop-trunk\hadoop-common-project\hadoop-nfs\src\main\java\org\apache\hadoop\nfs\nfs3\response\PATHCONF3Response.java,93,33,0,1,1,35
 hadoop-trunk\hadoop-trunk\hadoop-common-project\hadoop-common\src\test\java\org\apache\hadoop\fs\shell\TestMove.java,93,36,7,1,2,46
 hadoop-trunk\hadoop-trunk\hadoop-hdfs-project\hadoop-hdfs\src\main\java\org\apache\hadoop\hdfs\protocol\datatransfer\WhitelistBasedTrustedChannelResolver.java,93,45,2,19,2,68
 hadoop-trunk\hadoop-trunk\hadoop-tools\hadoop-resourceestimator\src\test\java\org\apache\hadoop\resourceestimator\common\api\TestResourceSkyline.java,93,47,1,3,3,54
 hadoop-trunk\hadoop-trunk\hadoop-mapreduce-project\hadoop-mapreduce-examples\src\main\java\org\apache\hadoop\examples\pi\math\Modular.java,93,74,21,2,0,97
 hadoop-trunk\hadoop-trunk\hadoop-yarn-project\hadoop-yarn\hadoop-yarn-common\src\test\java\org\apache\hadoop\yarn\nodelabels\TestNodeLabelUtil.java,93,2,1,1,2,6
 hadoop-trunk\hadoop-trunk\hadoop-hdfs-project\hadoop-hdfs-client\src\main\java\org\apache\hadoop\hdfs\protocol\DatanodeVolumeInfo.java,93,30,0,1,0,31
 hadoop-trunk\hadoop-trunk\hadoop-yarn-project\hadoop-yarn\hadoop-yarn-server\hadoop-yarn-server-nodemanager\src\main\java\org\apache\hadoop\yarn\server\nodemanager\containermanager\launcher\RecoverPausedContainerLaunch.java,93,16,9,4,0,29
 hadoop-trunk\hadoop-trunk\hadoop-hdfs-project\hadoop-hdfs\src\main\java\org\apache\hadoop\hdfs\server\balancer\MovedBlocks.java,93,45,0,1,3,49
 hadoop-trunk\hadoop-trunk\hadoop-yarn-project\hadoop-yarn\hadoop-yarn-common\src\main\java\org\apache\hadoop\yarn\api\protocolrecords\impl\pb\UseSharedCacheResourceRequestPBImpl.java,93,23,38,3,0,64
 hadoop-trunk\hadoop-trunk\hadoop-yarn-project\hadoop-yarn\hadoop-yarn-common\src\test\java\org\apache\hadoop\yarn\TestRPCFactories.java,93,20,5,6,1,32
 hadoop-trunk\hadoop-trunk\hadoop-yarn-project\hadoop-yarn\hadoop-yarn-common\src\main\java\org\apache\hadoop\yarn\webapp\util\WebServiceClient.java,93,12,2,1,3,18
 hadoop-trunk\hadoop-trunk\hadoop-tools\hadoop-fs2img\src\test\java\org\apache\hadoop\hdfs\server\namenode\TestRandomTreeWalk.java,93,20,2,1,0,23
 kafka-trunk\kafka-trunk\metadata\src\generated\java\org\apache\kafka\common\metadata\MetadataJsonConverters.java,93,0,0,31,19,50
 kafka-trunk\kafka-trunk\clients\src\main\java\org\apache\kafka\common\record\EndTransactionMarker.java,93,0,6,13,0,19
 kafka-trunk\kafka-trunk\streams\src\test\java\org\apache\kafka\streams\state\internals\TimestampedSegmentTest.java,93,0,0,16,0,16
 kafka-trunk\kafka-trunk\clients\src\test\java\org\apache\kafka\common\security\authenticator\ClientAuthenticationFailureTest.java,93,0,3,21,3,27
 kafka-trunk\kafka-trunk\clients\src\test\java\org\apache\kafka\clients\consumer\internals\HeartbeatTest.java,93,0,0,9,0,9
 kafka-trunk\kafka-trunk\connect\api\src\test\java\org\apache\kafka\connect\source\SourceRecordTest.java,93,0,0,11,0,11
 kafka-trunk\kafka-trunk\clients\src\test\java\org\apache\kafka\common\record\ByteBufferLogInputStreamTest.java,93,0,0,12,15,27
 kafka-trunk\kafka-trunk\clients\src\main\java\org\apache\kafka\clients\consumer\internals\KafkaConsumerMetrics.java,93,0,2,11,1,14
 pulsar-master\pulsar-master\pulsar-broker-common\src\main\java\org\apache\pulsar\broker\BaseGenerateDocumentation.java,93,24,2,8,0,34
 pulsar-master\pulsar-master\pulsar-functions\instance\src\test\java\org\apache\pulsar\functions\instance\FunctionResultRouterTest.java,93,30,2,9,0,41
 pulsar-master\pulsar-master\pulsar-broker\src\main\java\org\apache\pulsar\broker\stats\prometheus\metrics\PrometheusMetricsProvider.java,93,40,0,16,0,56
 pulsar-master\pulsar-master\pulsar-broker\src\test\java\org\apache\pulsar\stats\client\PulsarBrokerStatsClientTest.java,93,31,4,21,0,56
 pulsar-master\pulsar-master\pulsar-broker\src\test\java\org\apache\pulsar\broker\auth\AuthenticationServiceTest.java,93,37,8,19,0,64
 pulsar-master\pulsar-master\pulsar-io\flume\src\test\java\org\apache\pulsar\io\flume\node\TestAbstractZooKeeperConfigurationProvider.java,93,20,0,5,0,25
 pulsar-master\pulsar-master\pulsar-broker\src\test\java\org\apache\pulsar\broker\service\schema\JsonSchemaCompatibilityCheckTest.java,93,37,2,13,0,52
 pulsar-master\pulsar-master\pulsar-io\file\src\test\java\org\apache\pulsar\io\file\FileSourceConfigTests.java,93,43,3,6,0,52
 pulsar-master\pulsar-master\pulsar-broker\src\main\java\org\apache\pulsar\broker\stats\prometheus\metrics\DataSketchesSummaryLogger.java,93,29,3,3,0,35
 pulsar-master\pulsar-master\pulsar-io\kafka-connect-adaptor\src\test\java\org\apache\pulsar\io\kafka\connect\PulsarOffsetBackingStoreTest.java,93,13,3,3,0,19
 pulsar-master\pulsar-master\pulsar-broker\src\test\java\org\apache\pulsar\broker\EmbeddedPulsarCluster.java,93,25,5,7,0,37
 pulsar-master\pulsar-master\pulsar-broker\src\test\java\org\apache\pulsar\broker\service\ReplicatorGlobalNSTest.java,93,34,0,21,0,55
 pulsar-master\pulsar-master\managed-ledger\src\main\java\org\apache\bookkeeper\mledger\impl\ManagedCursorMXBeanImpl.java,93,27,0,2,0,29
 pulsar-master\pulsar-master\pulsar-broker\src\main\java\org\apache\pulsar\broker\service\PublishRateLimiterImpl.java,93,37,6,6,0,49
 pulsar-master\pulsar-master\pulsar-broker\src\main\java\org\apache\pulsar\broker\loadbalance\impl\PulsarServiceRequest.java,93,70,0,1,0,71
 pulsar-master\pulsar-master\pulsar-io\flume\src\main\java\org\apache\pulsar\io\flume\source\AbstractSource.java,93,21,2,4,0,27
 rocketmq-develop\rocketmq-develop\openmessaging\src\test\java\io\openmessaging\rocketmq\promise\DefaultPromiseTest.java,93,24,4,3,1,32
 rocketmq-develop\rocketmq-develop\tools\src\main\java\org\apache\rocketmq\tools\command\offset\SkipAccumulationSubCommand.java,93,22,0,13,1,36
 rocketmq-develop\rocketmq-develop\namesrv\src\test\java\org\apache\rocketmq\namesrv\routeinfo\RouteInfoManagerBrokerRegisterTest.java,93,31,1,11,7,50
 rocketmq-develop\rocketmq-develop\client\src\test\java\org\apache\rocketmq\client\consumer\store\RemoteBrokerOffsetStoreTest.java,93,58,3,29,0,90
 shardingsphere-master\shardingsphere-master\shardingsphere-jdbc\shardingsphere-jdbc-core\src\main\java\org\apache\shardingsphere\driver\jdbc\unsupported\AbstractUnsupportedOperationPreparedStatement.java,93,42,0,25,0,67
 shardingsphere-master\shardingsphere-master\shardingsphere-jdbc\shardingsphere-jdbc-core\src\main\java\org\apache\shardingsphere\driver\jdbc\unsupported\AbstractUnsupportedOperationConnection.java,93,24,0,8,0,32
 shardingsphere-master\shardingsphere-master\shardingsphere-test\shardingsphere-integration-test\shardingsphere-integration-test-suite\src\test\java\org\apache\shardingsphere\test\integration\engine\ral\BaseRALIT.java,93,33,2,22,0,57
 shardingsphere-master\shardingsphere-master\shardingsphere-features\shardingsphere-sharding\shardingsphere-sharding-spring\shardingsphere-sharding-spring-boot-starter\src\test\java\org\apache\shardingsphere\sharding\spring\boot\ShardingSpringBootStarterTest.java,93,59,0,46,0,105
 skywalking-master\skywalking-master\oap-server\server-core\src\main\java\org\apache\skywalking\oap\server\core\cache\ProfileTaskCache.java,93,41,2,14,0,57
 skywalking-master\skywalking-master\oap-server\server-alarm-plugin\src\main\java\org\apache\skywalking\oap\server\core\alarm\provider\CompositeRuleEvaluator.java,93,27,0,11,0,38
 dubbo-3.0\dubbo-3.0\dubbo-rpc\dubbo-rpc-triple\src\main\java\org\apache\dubbo\rpc\protocol\tri\SingleProtobufUtils.java,94,38,1,13,0,52
 dubbo-3.0\dubbo-3.0\dubbo-common\src\test\java\org\apache\dubbo\common\lang\PrioritizedTest.java,94,16,2,1,1,20
 dubbo-3.0\dubbo-3.0\dubbo-cluster\src\test\java\org\apache\dubbo\rpc\cluster\router\tag\TagStateRouterTest.java,94,33,3,10,0,46
 dubbo-3.0\dubbo-3.0\dubbo-registry\dubbo-registry-nacos\src\main\java\org\apache\dubbo\registry\nacos\NacosServiceDiscovery.java,94,38,0,22,0,60
 dubbo-3.0\dubbo-3.0\dubbo-rpc\dubbo-rpc-rest\src\main\java\org\apache\dubbo\rpc\protocol\rest\DubboHttpProtocolServer.java,94,28,0,10,0,38
 hadoop-trunk\hadoop-trunk\hadoop-yarn-project\hadoop-yarn\hadoop-yarn-common\src\main\java\org\apache\hadoop\yarn\api\protocolrecords\impl\pb\CancelDelegationTokenRequestPBImpl.java,94,29,37,3,0,69
 hadoop-trunk\hadoop-trunk\hadoop-mapreduce-project\hadoop-mapreduce-client\hadoop-mapreduce-client-core\src\main\java\org\apache\hadoop\mapred\JobACLsManager.java,94,21,5,1,1,28
 hadoop-trunk\hadoop-trunk\hadoop-common-project\hadoop-common\src\test\java\org\apache\hadoop\io\TestDataByteBuffers.java,94,34,1,11,0,46
 hadoop-trunk\hadoop-trunk\hadoop-common-project\hadoop-common\src\test\java\org\apache\hadoop\io\erasurecode\rawcoder\TestRSRawCoderBase.java,94,61,14,1,0,76
 hadoop-trunk\hadoop-trunk\hadoop-tools\hadoop-aws\src\test\java\org\apache\hadoop\fs\s3a\commit\staging\TestPaths.java,94,19,1,1,0,21
 hadoop-trunk\hadoop-trunk\hadoop-common-project\hadoop-common\src\main\java\org\apache\hadoop\io\BooleanWritable.java,94,38,2,1,0,41
 hadoop-trunk\hadoop-trunk\hadoop-yarn-project\hadoop-yarn\hadoop-yarn-server\hadoop-yarn-server-nodemanager\src\main\java\org\apache\hadoop\yarn\server\nodemanager\containermanager\launcher\RecoveredContainerLaunch.java,94,16,8,8,0,32
 hadoop-trunk\hadoop-trunk\hadoop-common-project\hadoop-common\src\main\java\org\apache\hadoop\service\ServiceStateException.java,94,16,0,1,0,17
 hadoop-trunk\hadoop-trunk\hadoop-yarn-project\hadoop-yarn\hadoop-yarn-common\src\main\java\org\apache\hadoop\yarn\api\protocolrecords\impl\pb\RenewDelegationTokenRequestPBImpl.java,94,35,37,3,0,75
 hadoop-trunk\hadoop-trunk\hadoop-common-project\hadoop-common\src\main\java\org\apache\hadoop\util\StopWatch.java,94,13,0,1,0,14
 hadoop-trunk\hadoop-trunk\hadoop-yarn-project\hadoop-yarn\hadoop-yarn-server\hadoop-yarn-server-resourcemanager\src\main\java\org\apache\hadoop\yarn\server\resourcemanager\scheduler\SchedContainerChangeRequest.java,94,49,0,1,9,59
 hadoop-trunk\hadoop-trunk\hadoop-yarn-project\hadoop-yarn\hadoop-yarn-server\hadoop-yarn-server-common\src\main\java\org\apache\hadoop\yarn\server\api\protocolrecords\NodeHeartbeatResponse.java,94,38,3,2,0,43
 hadoop-trunk\hadoop-trunk\hadoop-tools\hadoop-aws\src\test\java\org\apache\hadoop\fs\s3a\ITestS3AMultipartUtils.java,94,11,2,1,0,14
 hadoop-trunk\hadoop-trunk\hadoop-hdfs-project\hadoop-hdfs\src\main\java\org\apache\hadoop\hdfs\tools\offlineEditsViewer\XmlEditsVisitor.java,94,30,7,2,1,40
 kafka-trunk\kafka-trunk\connect\api\src\test\java\org\apache\kafka\connect\sink\SinkRecordTest.java,94,0,0,7,0,7
 kafka-trunk\kafka-trunk\clients\src\test\java\org\apache\kafka\clients\ClientUtilsTest.java,94,0,8,21,0,29
 kafka-trunk\kafka-trunk\metadata\src\test\java\org\apache\kafka\image\ClusterImageTest.java,94,0,1,16,0,17
 kafka-trunk\kafka-trunk\metadata\src\main\java\org\apache\kafka\timeline\TimelineObject.java,94,0,6,3,3,12
 kafka-trunk\kafka-trunk\clients\src\test\java\org\apache\kafka\clients\admin\AdminClientUnitTestEnv.java,94,0,0,13,3,16
 kafka-trunk\kafka-trunk\clients\src\main\java\org\apache\kafka\common\record\SimpleRecord.java,94,0,2,7,6,15
 kafka-trunk\kafka-trunk\connect\runtime\src\main\java\org\apache\kafka\connect\cli\ConnectDistributed.java,94,0,1,19,0,20
 kafka-trunk\kafka-trunk\clients\src\main\java\org\apache\kafka\common\requests\ApiVersionsRequest.java,94,0,0,18,2,20
 kafka-trunk\kafka-trunk\connect\api\src\main\java\org\apache\kafka\connect\source\SourceRecord.java,94,0,3,29,4,36
 pulsar-master\pulsar-master\pulsar-broker-common\src\main\java\org\apache\pulsar\broker\authentication\AuthenticationDataCommand.java,94,45,4,3,0,52
 pulsar-master\pulsar-master\tests\integration\src\test\java\org\apache\pulsar\tests\integration\io\sources\debezium\DebeziumMongoDbSourceTester.java,94,50,2,19,0,71
 pulsar-master\pulsar-master\pulsar-package-management\bookkeeper-storage\src\test\java\org\apache\pulsar\packages\management\storage\bookkeeper\bookkeeper\test\ZooKeeperUtil.java,94,36,1,10,0,47
 pulsar-master\pulsar-master\pulsar-common\src\main\java\org\apache\pulsar\client\api\url\DataURLStreamHandler.java,94,16,0,7,0,23
 pulsar-master\pulsar-master\pulsar-functions\instance\src\test\java\org\apache\pulsar\functions\windowing\WaterMarkEventGeneratorTest.java,94,43,0,4,0,47
 pulsar-master\pulsar-master\pulsar-broker\src\test\java\org\apache\pulsar\broker\systopic\PartitionedSystemTopicTest.java,94,22,1,11,0,34
 pulsar-master\pulsar-master\pulsar-client\src\main\java\org\apache\pulsar\client\util\ExecutorProvider.java,94,38,3,9,0,50
 pulsar-master\pulsar-master\pulsar-client\src\main\java\org\apache\pulsar\client\impl\ProducerInterceptors.java,94,38,5,22,0,65
 pulsar-master\pulsar-master\pulsar-broker\src\test\java\org\apache\pulsar\client\impl\KeyStoreTlsTest.java,94,52,11,15,0,78
 pulsar-master\pulsar-master\pulsar-functions\instance\src\test\java\org\apache\pulsar\functions\instance\state\BKStateStoreImplTest.java,94,26,4,3,0,33
 pulsar-master\pulsar-master\pulsar-client\src\main\java\org\apache\pulsar\client\impl\schema\reader\AbstractMultiVersionReader.java,94,52,6,15,0,73
 rocketmq-develop\rocketmq-develop\test\src\test\java\org\apache\rocketmq\test\client\producer\batch\BatchSendIT.java,94,20,3,5,2,30
 rocketmq-develop\rocketmq-develop\tools\src\main\java\org\apache\rocketmq\tools\command\broker\GetBrokerConfigCommand.java,94,12,0,8,6,26
 rocketmq-develop\rocketmq-develop\tools\src\main\java\org\apache\rocketmq\tools\command\export\ExportConfigsCommand.java,94,34,0,25,1,60
 rocketmq-develop\rocketmq-develop\tools\src\main\java\org\apache\rocketmq\tools\command\acl\ClusterAclConfigVersionListSubCommand.java,94,21,1,13,1,36
 skywalking-master\skywalking-master\oap-server\server-library\library-util\src\test\java\org\apache\skywalking\oap\server\library\util\prometheus\parser\TextParserTest.java,94,54,0,10,3,67
 zookeeper-master\zookeeper-master\zookeeper-server\src\test\java\org\apache\zookeeper\server\util\ConfigUtilsTest.java,94,0,9,4,0,13
 zookeeper-master\zookeeper-master\zookeeper-server\src\test\java\org\apache\zookeeper\server\SerializationPerfTest.java,94,0,4,15,0,19
 zookeeper-master\zookeeper-master\zookeeper-server\src\test\java\org\apache\zookeeper\test\EnsembleAuthTest.java,94,0,1,7,0,8
 zookeeper-master\zookeeper-master\zookeeper-server\src\test\java\org\apache\zookeeper\server\MockServerCnxn.java,94,0,13,2,1,16
 dubbo-3.0\dubbo-3.0\dubbo-common\src\main\java\org\apache\dubbo\common\utils\Log.java,95,34,0,4,0,38
 dubbo-3.0\dubbo-3.0\dubbo-config\dubbo-config-spring\src\test\java\org\apache\dubbo\config\spring\context\annotation\EnableDubboConfigTest.java,95,29,1,18,0,48
 dubbo-3.0\dubbo-3.0\dubbo-common\src\main\java\org\apache\dubbo\common\io\UnsafeStringReader.java,95,20,6,1,0,27
 dubbo-3.0\dubbo-3.0\dubbo-common\src\main\java\org\apache\dubbo\common\io\UnsafeByteArrayInputStream.java,95,37,4,1,1,43
 hadoop-trunk\hadoop-trunk\hadoop-hdfs-project\hadoop-hdfs\src\test\java\org\apache\hadoop\hdfs\server\datanode\TestBlockHasMultipleReplicasOnSameDN.java,95,19,3,5,0,27
 hadoop-trunk\hadoop-trunk\hadoop-common-project\hadoop-common\src\test\java\org\apache\hadoop\service\BreakableService.java,95,45,0,1,0,46
 hadoop-trunk\hadoop-trunk\hadoop-yarn-project\hadoop-yarn\hadoop-yarn-server\hadoop-yarn-server-timelineservice\src\main\java\org\apache\hadoop\yarn\server\timelineservice\reader\filter\TimelineKeyValuesFilter.java,95,28,1,1,3,33
 hadoop-trunk\hadoop-trunk\hadoop-yarn-project\hadoop-yarn\hadoop-yarn-applications\hadoop-yarn-services\hadoop-yarn-services-core\src\test\java\org\apache\hadoop\yarn\service\conf\TestValidateServiceNames.java,95,19,1,1,0,21
 hadoop-trunk\hadoop-trunk\hadoop-common-project\hadoop-common\src\main\java\org\apache\hadoop\util\CloseableReferenceCount.java,95,2,3,1,0,6
 hadoop-trunk\hadoop-trunk\hadoop-hdfs-project\hadoop-hdfs\src\test\java\org\apache\hadoop\hdfs\TestLocalDFS.java,95,26,4,1,1,32
 hadoop-trunk\hadoop-trunk\hadoop-hdfs-project\hadoop-hdfs-rbf\src\main\java\org\apache\hadoop\hdfs\server\federation\resolver\FederationNamespaceInfo.java,95,15,0,1,0,16
 hadoop-trunk\hadoop-trunk\hadoop-yarn-project\hadoop-yarn\hadoop-yarn-api\src\main\java\org\apache\hadoop\yarn\api\records\timelineservice\TimelineEvent.java,95,38,6,1,5,50
 hadoop-trunk\hadoop-trunk\hadoop-mapreduce-project\hadoop-mapreduce-client\hadoop-mapreduce-client-app\src\main\java\org\apache\hadoop\mapreduce\v2\app\webapp\dao\TaskInfo.java,95,47,1,1,0,49
 hadoop-trunk\hadoop-trunk\hadoop-yarn-project\hadoop-yarn\hadoop-yarn-common\src\main\java\org\apache\hadoop\yarn\api\protocolrecords\impl\pb\ReleaseSharedCacheResourceRequestPBImpl.java,95,23,38,4,0,65
 hadoop-trunk\hadoop-trunk\hadoop-yarn-project\hadoop-yarn\hadoop-yarn-server\hadoop-yarn-server-common\src\main\java\org\apache\hadoop\yarn\server\api\records\NodeStatus.java,95,27,0,1,0,28
 hadoop-trunk\hadoop-trunk\hadoop-common-project\hadoop-common\src\test\java\org\apache\hadoop\io\erasurecode\rawcoder\TestCoderUtil.java,95,31,2,1,3,37
 hadoop-trunk\hadoop-trunk\hadoop-common-project\hadoop-common\src\test\java\org\apache\hadoop\io\serializer\avro\TestAvroSerialization.java,95,35,13,1,0,49
 hadoop-trunk\hadoop-trunk\hadoop-yarn-project\hadoop-yarn\hadoop-yarn-server\hadoop-yarn-server-sharedcachemanager\src\main\java\org\apache\hadoop\yarn\server\sharedcachemanager\SCMAdminProtocolService.java,95,24,3,4,1,32
 hadoop-trunk\hadoop-trunk\hadoop-hdfs-project\hadoop-hdfs\src\test\java\org\apache\hadoop\hdfs\server\namenode\TestFSImageWithXAttr.java,95,35,0,1,0,36
 hadoop-trunk\hadoop-trunk\hadoop-hdfs-project\hadoop-hdfs\src\test\java\org\apache\hadoop\hdfs\server\namenode\ha\TestPendingCorruptDnMessages.java,95,31,1,3,1,36
 hadoop-trunk\hadoop-trunk\hadoop-yarn-project\hadoop-yarn\hadoop-yarn-server\hadoop-yarn-server-resourcemanager\src\test\java\org\apache\hadoop\yarn\server\resourcemanager\scheduler\capacity\TestApplicationPriorityACLConfiguration.java,95,26,4,3,5,38
 hadoop-trunk\hadoop-trunk\hadoop-yarn-project\hadoop-yarn\hadoop-yarn-server\hadoop-yarn-server-resourcemanager\src\test\java\org\apache\hadoop\yarn\server\resourcemanager\scheduler\capacity\TestQueueManagementDynamicEditPolicy.java,95,17,0,2,1,20
 hadoop-trunk\hadoop-trunk\hadoop-mapreduce-project\hadoop-mapreduce-client\hadoop-mapreduce-client-jobclient\src\test\java\org\apache\hadoop\mapred\TestUserDefinedCounters.java,95,27,4,1,4,36
 hadoop-trunk\hadoop-trunk\hadoop-yarn-project\hadoop-yarn\hadoop-yarn-common\src\main\java\org\apache\hadoop\yarn\nodelabels\store\FSStoreOpHandler.java,95,14,13,3,0,30
 hadoop-trunk\hadoop-trunk\hadoop-hdfs-project\hadoop-hdfs-httpfs\src\main\java\org\apache\hadoop\lib\service\scheduler\SchedulerService.java,95,32,4,9,0,45
 hadoop-trunk\hadoop-trunk\hadoop-tools\hadoop-rumen\src\main\java\org\apache\hadoop\tools\rumen\LoggedLocation.java,95,36,1,1,1,39
 hadoop-trunk\hadoop-trunk\hadoop-yarn-project\hadoop-yarn\hadoop-yarn-applications\hadoop-yarn-services\hadoop-yarn-services-core\src\main\java\org\apache\hadoop\yarn\service\api\records\LocalizationStatus.java,95,16,0,1,0,17
 hadoop-trunk\hadoop-trunk\hadoop-tools\hadoop-fs2img\src\main\java\org\apache\hadoop\hdfs\server\namenode\FSTreeWalk.java,95,19,2,5,1,27
 hadoop-trunk\hadoop-trunk\hadoop-yarn-project\hadoop-yarn\hadoop-yarn-server\hadoop-yarn-server-nodemanager\src\main\java\org\apache\hadoop\yarn\server\nodemanager\containermanager\linux\runtime\docker\DockerCommand.java,95,16,0,4,0,20
 hadoop-trunk\hadoop-trunk\hadoop-hdfs-project\hadoop-hdfs\src\test\java\org\apache\hadoop\hdfs\server\namenode\snapshot\TestCheckpointsWithSnapshots.java,95,19,1,4,0,24
 kafka-trunk\kafka-trunk\clients\src\test\java\org\apache\kafka\common\requests\DeleteAclsResponseTest.java,95,0,4,12,0,16
 kafka-trunk\kafka-trunk\clients\src\test\java\org\apache\kafka\common\requests\TxnOffsetCommitRequestTest.java,95,0,0,9,2,11
 kafka-trunk\kafka-trunk\clients\src\test\java\org\apache\kafka\common\requests\LeaveGroupRequestTest.java,95,0,6,10,7,23
 kafka-trunk\kafka-trunk\clients\src\generated\java\org\apache\kafka\common\message\IncrementalAlterConfigsResponseDataJsonConverter.java,95,0,0,25,0,25
 kafka-trunk\kafka-trunk\clients\src\generated\java\org\apache\kafka\common\message\DescribeQuorumRequestDataJsonConverter.java,95,0,0,21,0,21
 kafka-trunk\kafka-trunk\clients\src\generated\java\org\apache\kafka\common\message\AlterConfigsResponseDataJsonConverter.java,95,0,0,23,0,23
 kafka-trunk\kafka-trunk\clients\src\test\java\org\apache\kafka\clients\InFlightRequestsTest.java,95,0,0,16,0,16
 kafka-trunk\kafka-trunk\clients\src\main\java\org\apache\kafka\common\requests\ApiError.java,95,0,1,12,0,13
 kafka-trunk\kafka-trunk\clients\src\main\java\org\apache\kafka\common\PartitionInfo.java,95,0,1,7,6,14
 kafka-trunk\kafka-trunk\clients\src\main\java\org\apache\kafka\common\security\token\delegation\internals\DelegationTokenCache.java,95,0,0,10,0,10
 LittleBooks-master\LittleBooks-master\app\src\main\java\com\example\littlebooks\Settings.java,95,35,2,9,0,46
 pulsar-master\pulsar-master\pulsar-metadata\src\test\java\org\apache\pulsar\metadata\bookkeeper\EndToEndTest.java,95,18,1,3,0,22
 pulsar-master\pulsar-master\tiered-storage\file-system\src\test\java\org\apache\bookkeeper\mledger\offload\filesystem\impl\FileSystemManagedLedgerOffloaderTest.java,95,42,1,15,0,58
 pulsar-master\pulsar-master\pulsar-package-management\bookkeeper-storage\src\test\java\org\apache\pulsar\packages\management\storage\bookkeeper\bookkeeper\test\MockedBookKeeperTestCase.java,95,37,1,7,0,45
 pulsar-master\pulsar-master\pulsar-common\src\main\java\org\apache\pulsar\common\sasl\SaslConstants.java,95,42,2,14,0,58
 pulsar-master\pulsar-master\pulsar-transaction\coordinator\src\main\java\org\apache\pulsar\transaction\coordinator\exceptions\CoordinatorException.java,95,44,0,12,0,56
 pulsar-master\pulsar-master\pulsar-proxy\src\test\java\org\apache\pulsar\proxy\server\UnauthedAdminProxyHandlerTest.java,95,25,3,12,0,40
 pulsar-master\pulsar-master\pulsar-transaction\coordinator\src\test\java\org\apache\pulsar\transaction\coordinator\test\MockedBookKeeperTestCase.java,95,39,1,6,0,46
 pulsar-master\pulsar-master\pulsar-client\src\test\java\org\apache\pulsar\client\impl\DefaultCryptoKeyReaderTest.java,95,28,4,27,0,59
 pulsar-master\pulsar-master\pulsar-io\flume\src\main\java\org\apache\pulsar\io\flume\node\PollingZooKeeperConfigurationProvider.java,95,19,1,4,0,24
 pulsar-master\pulsar-master\pulsar-io\kafka\src\test\java\org\apache\pulsar\io\kafka\source\KafkaAbstractSourceTest.java,95,22,1,8,0,31
 pulsar-master\pulsar-master\tests\integration\src\test\java\org\apache\pulsar\tests\integration\schema\JodaTimeTest.java,95,33,0,8,0,41
 rocketmq-develop\rocketmq-develop\store\src\main\java\org\apache\rocketmq\store\StoreCheckpoint.java,95,47,10,6,0,63
 rocketmq-develop\rocketmq-develop\common\src\main\java\org\apache\rocketmq\common\protocol\header\CreateTopicRequestHeader.java,95,61,0,3,0,64
 rocketmq-develop\rocketmq-develop\client\src\main\java\org\apache\rocketmq\client\log\ClientLogger.java,95,36,2,20,0,58
 rocketmq-develop\rocketmq-develop\client\src\main\java\org\apache\rocketmq\client\impl\producer\TopicPublishInfo.java,95,49,3,5,4,61
 dubbo-3.0\dubbo-3.0\dubbo-rpc\dubbo-rpc-api\src\main\java\org\apache\dubbo\rpc\FutureContext.java,96,26,0,13,2,41
 dubbo-3.0\dubbo-3.0\dubbo-rpc\dubbo-rpc-api\src\test\java\org\apache\dubbo\rpc\filter\ExecuteLimitFilterTest.java,96,18,1,11,0,30
 dubbo-3.0\dubbo-3.0\dubbo-metadata\dubbo-metadata-api\src\main\java\org\apache\dubbo\metadata\rest\springmvc\SpringMvcServiceRestMetadataResolver.java,96,50,0,21,0,71
 dubbo-3.0\dubbo-3.0\dubbo-registry\dubbo-registry-api\src\main\java\org\apache\dubbo\registry\retry\AbstractRetryTask.java,96,36,4,8,0,48
 hadoop-trunk\hadoop-trunk\hadoop-yarn-project\hadoop-yarn\hadoop-yarn-common\src\main\java\org\apache\hadoop\yarn\util\AdHocLogDumper.java,96,20,6,1,1,28
 hadoop-trunk\hadoop-trunk\hadoop-hdfs-project\hadoop-hdfs\src\test\java\org\apache\hadoop\hdfs\protocol\datatransfer\sasl\SaslDataTransferTestCase.java,96,21,1,12,2,36
 hadoop-trunk\hadoop-trunk\hadoop-common-project\hadoop-common\src\test\java\org\apache\hadoop\io\RandomDatum.java,96,74,2,1,3,80
 hadoop-trunk\hadoop-trunk\hadoop-common-project\hadoop-common\src\test\java\org\apache\hadoop\tools\GetGroupsTestBase.java,96,43,1,11,8,63
 hadoop-trunk\hadoop-trunk\hadoop-yarn-project\hadoop-yarn\hadoop-yarn-common\src\main\java\org\apache\hadoop\yarn\api\records\impl\pb\ResourceSizingPBImpl.java,96,26,35,1,0,62
 hadoop-trunk\hadoop-trunk\hadoop-yarn-project\hadoop-yarn\hadoop-yarn-server\hadoop-yarn-server-nodemanager\src\main\java\org\apache\hadoop\yarn\server\nodemanager\containermanager\resourceplugin\deviceframework\DevicePluginAdapter.java,96,32,3,9,2,46
 hadoop-trunk\hadoop-trunk\hadoop-mapreduce-project\hadoop-mapreduce-client\hadoop-mapreduce-client-app\src\test\java\org\apache\hadoop\mapreduce\v2\app\metrics\TestMRAppMetrics.java,96,26,2,1,0,29
 hadoop-trunk\hadoop-trunk\hadoop-mapreduce-project\hadoop-mapreduce-client\hadoop-mapreduce-client-jobclient\src\test\java\org\apache\hadoop\mapreduce\lib\partition\TestMRKeyFieldBasedComparator.java,96,29,5,1,5,40
 hadoop-trunk\hadoop-trunk\hadoop-tools\hadoop-azure\src\test\java\org\apache\hadoop\fs\azure\TestNativeAzureFileSystemFileNameCheck.java,96,13,3,3,0,19
 hadoop-trunk\hadoop-trunk\hadoop-yarn-project\hadoop-yarn\hadoop-yarn-server\hadoop-yarn-server-resourcemanager\src\test\java\org\apache\hadoop\yarn\server\resourcemanager\TestRMHATimelineCollectors.java,96,7,0,2,4,13
 hadoop-trunk\hadoop-trunk\hadoop-common-project\hadoop-common\src\test\java\org\apache\hadoop\crypto\TestCryptoStreamsForLocalFS.java,96,69,13,1,0,83
 hadoop-trunk\hadoop-trunk\hadoop-common-project\hadoop-common\src\test\java\org\apache\hadoop\io\erasurecode\coder\TestHHXORErasureCoder.java,96,43,9,1,0,53
 hadoop-trunk\hadoop-trunk\hadoop-mapreduce-project\hadoop-mapreduce-client\hadoop-mapreduce-client-core\src\main\java\org\apache\hadoop\mapreduce\lib\input\FileSplit.java,96,47,1,1,3,52
 hadoop-trunk\hadoop-trunk\hadoop-hdfs-project\hadoop-hdfs\src\main\java\org\apache\hadoop\hdfs\tools\offlineImageViewer\WebImageViewer.java,96,24,5,2,1,32
 hadoop-trunk\hadoop-trunk\hadoop-common-project\hadoop-common\src\main\java\org\apache\hadoop\ipc\metrics\DecayRpcSchedulerDetailedMetrics.java,96,43,2,1,0,46
 hadoop-trunk\hadoop-trunk\hadoop-common-project\hadoop-auth\src\test\java\org\apache\hadoop\security\authentication\server\TestLdapAuthenticationHandler.java,96,17,3,2,3,25
 hadoop-trunk\hadoop-trunk\hadoop-yarn-project\hadoop-yarn\hadoop-yarn-common\src\main\java\org\apache\hadoop\yarn\client\api\TimelineV2Client.java,96,2,1,1,0,4
 hadoop-trunk\hadoop-trunk\hadoop-common-project\hadoop-common\src\main\java\org\apache\hadoop\util\hash\Hash.java,96,17,1,3,0,21
 hadoop-trunk\hadoop-trunk\hadoop-mapreduce-project\hadoop-mapreduce-client\hadoop-mapreduce-client-app\src\test\java\org\apache\hadoop\mapreduce\v2\app\TestKillAMPreemptionPolicy.java,96,5,0,1,0,6
 kafka-trunk\kafka-trunk\connect\runtime\src\test\java\org\apache\kafka\connect\runtime\isolation\SamplingTestPlugin.java,96,0,0,10,4,14
 kafka-trunk\kafka-trunk\metadata\src\test\java\org\apache\kafka\metadata\ReplicasTest.java,96,0,0,15,0,15
 kafka-trunk\kafka-trunk\clients\src\test\java\org\apache\kafka\clients\admin\AdminClientTestUtils.java,96,0,1,29,0,30
 kafka-trunk\kafka-trunk\clients\src\test\java\org\apache\kafka\common\security\oauthbearer\internals\OAuthBearerClientInitialResponseTest.java,96,0,0,23,0,23
 kafka-trunk\kafka-trunk\streams\src\test\java\org\apache\kafka\streams\state\internals\FilteredCacheIteratorTest.java,96,0,0,11,7,18
 kafka-trunk\kafka-trunk\raft\src\main\java\org\apache\kafka\raft\VotedState.java,96,0,2,5,1,8
 kafka-trunk\kafka-trunk\clients\src\test\java\org\apache\kafka\common\security\authenticator\LoginManagerTest.java,96,0,2,26,0,28
 kafka-trunk\kafka-trunk\connect\transforms\src\main\java\org\apache\kafka\connect\transforms\HoistField.java,96,0,0,15,0,15
 pulsar-master\pulsar-master\pulsar-client\src\test\java\org\apache\pulsar\client\impl\PulsarServiceNameResolverTest.java,96,24,1,8,0,33
 pulsar-master\pulsar-master\pulsar-client-tools\src\main\java\org\apache\pulsar\admin\cli\CmdGenerateDocument.java,96,21,3,13,0,37
 pulsar-master\pulsar-master\pulsar-package-management\core\src\test\java\org\apache\pulsar\packages\management\core\common\PackageNameTest.java,96,17,0,10,0,27
 pulsar-master\pulsar-master\pulsar-broker\src\main\java\org\apache\pulsar\broker\transaction\recover\TransactionRecoverTrackerImpl.java,96,35,0,19,0,54
 pulsar-master\pulsar-master\tests\integration\src\test\java\org\apache\pulsar\tests\integration\io\sources\debezium\DebeziumMySqlSourceTester.java,96,38,2,16,0,56
 pulsar-master\pulsar-master\pulsar-functions\worker\src\main\java\org\apache\pulsar\functions\worker\Worker.java,96,27,2,11,0,40
 pulsar-master\pulsar-master\pulsar-common\src\test\java\org\apache\pulsar\common\util\netty\SslContextTest.java,96,26,0,14,0,40
 pulsar-master\pulsar-master\tests\integration\src\test\java\org\apache\pulsar\tests\integration\cli\FileSystemPackagesCliTest.java,96,25,0,16,0,41
 pulsar-master\pulsar-master\pulsar-proxy\src\test\java\org\apache\pulsar\proxy\extensions\ProxyExtensionWithClassLoaderTest.java,96,21,1,17,0,39
 rocketmq-develop\rocketmq-develop\store\src\main\java\org\apache\rocketmq\store\MultiPathMappedFileQueue.java,96,23,0,10,2,35
 rocketmq-develop\rocketmq-develop\broker\src\test\java\org\apache\rocketmq\broker\client\ProducerManagerTest.java,96,26,3,11,1,41
 skywalking-master\skywalking-master\oap-server\server-storage-plugin\storage-jdbc-hikaricp-plugin\src\main\java\org\apache\skywalking\oap\server\storage\plugin\jdbc\h2\dao\H2ProfileTaskQueryDAO.java,96,31,0,18,0,49
 skywalking-master\skywalking-master\oap-server\server-core\src\main\java\org\apache\skywalking\oap\server\core\query\type\Call.java,96,59,1,10,0,70
 skywalking-master\skywalking-master\oap-server\server-core\src\main\java\org\apache\skywalking\oap\server\core\profiling\ebpf\storage\EBPFProfilingScheduleRecord.java,96,36,1,16,0,53
 skywalking-master\skywalking-master\oap-server\server-storage-plugin\storage-elasticsearch-plugin\src\main\java\org\apache\skywalking\oap\server\storage\plugin\elasticsearch\query\ProfileTaskQueryEsDAO.java,96,31,0,24,0,55
 dubbo-3.0\dubbo-3.0\dubbo-config\dubbo-config-api\src\test\java\org\apache\dubbo\config\cache\CacheTest.java,97,21,1,9,0,31
 dubbo-3.0\dubbo-3.0\dubbo-config\dubbo-config-spring\src\main\java\org\apache\dubbo\config\spring\util\SpringCompatUtils.java,97,30,5,16,0,51
 dubbo-3.0\dubbo-3.0\dubbo-common\src\main\java\org\apache\dubbo\rpc\model\StubServiceDescriptor.java,97,47,0,14,0,61
 dubbo-3.0\dubbo-3.0\dubbo-rpc\dubbo-rpc-api\src\test\java\org\apache\dubbo\rpc\filter\ExceptionFilterTest.java,97,18,4,13,0,35
 dubbo-3.0\dubbo-3.0\dubbo-registry\dubbo-registry-api\src\test\java\org\apache\dubbo\registry\client\metadata\MetadataServiceNameMappingTest.java,97,29,6,15,0,50
 dubbo-3.0\dubbo-3.0\dubbo-remoting\dubbo-remoting-netty4\src\main\java\org\apache\dubbo\remoting\transport\netty4\NettyServerHandler.java,97,45,1,18,0,64
 hadoop-trunk\hadoop-trunk\hadoop-common-project\hadoop-registry\src\main\java\org\apache\hadoop\registry\client\impl\zk\ZKPathDumper.java,97,20,0,1,0,21
 hadoop-trunk\hadoop-trunk\hadoop-yarn-project\hadoop-yarn\hadoop-yarn-common\src\main\java\org\apache\hadoop\yarn\logaggregation\filecontroller\LogAggregationFileControllerContext.java,97,65,0,1,8,74
 hadoop-trunk\hadoop-trunk\hadoop-common-project\hadoop-auth\src\main\java\org\apache\hadoop\security\authentication\util\Signer.java,97,14,2,3,0,19
 hadoop-trunk\hadoop-trunk\hadoop-yarn-project\hadoop-yarn\hadoop-yarn-server\hadoop-yarn-server-resourcemanager\src\test\java\org\apache\hadoop\yarn\server\resourcemanager\scheduler\policy\MockSchedulableEntity.java,97,65,2,1,3,71
 hadoop-trunk\hadoop-trunk\hadoop-common-project\hadoop-common\src\test\java\org\apache\hadoop\fs\viewfs\ViewFileSystemTestSetup.java,97,56,5,7,2,70
 hadoop-trunk\hadoop-trunk\hadoop-common-project\hadoop-common\src\main\java\org\apache\hadoop\io\DataOutputBuffer.java,97,47,0,1,0,48
 hadoop-trunk\hadoop-trunk\hadoop-tools\hadoop-streaming\src\test\java\org\apache\hadoop\streaming\mapreduce\TestStreamXmlRecordReader.java,97,22,2,1,5,30
 hadoop-trunk\hadoop-trunk\hadoop-mapreduce-project\hadoop-mapreduce-client\hadoop-mapreduce-client-core\src\main\java\org\apache\hadoop\mapreduce\lib\db\IntegerSplitter.java,97,14,0,3,0,17
 hadoop-trunk\hadoop-trunk\hadoop-yarn-project\hadoop-yarn\hadoop-yarn-common\src\test\java\org\apache\hadoop\yarn\logaggregation\filecontroller\TestLogAggregationFileController.java,97,12,0,5,0,17
 hadoop-trunk\hadoop-trunk\hadoop-yarn-project\hadoop-yarn\hadoop-yarn-server\hadoop-yarn-server-common\src\main\java\org\apache\hadoop\yarn\server\api\records\AppCollectorData.java,97,30,6,1,0,37
 hadoop-trunk\hadoop-trunk\hadoop-common-project\hadoop-common\src\test\java\org\apache\hadoop\fs\TestFileSystemStorageStatistics.java,97,23,1,1,0,25
 hadoop-trunk\hadoop-trunk\hadoop-yarn-project\hadoop-yarn\hadoop-yarn-server\hadoop-yarn-server-resourcemanager\src\main\java\org\apache\hadoop\yarn\server\resourcemanager\scheduler\capacity\CapacitySchedulerQueueContext.java,97,51,0,10,6,67
 hadoop-trunk\hadoop-trunk\hadoop-yarn-project\hadoop-yarn\hadoop-yarn-server\hadoop-yarn-server-resourcemanager\src\main\java\org\apache\hadoop\yarn\server\resourcemanager\webapp\dao\FifoSchedulerInfo.java,97,50,1,5,0,56
 hadoop-trunk\hadoop-trunk\hadoop-mapreduce-project\hadoop-mapreduce-client\hadoop-mapreduce-client-jobclient\src\test\java\org\apache\hadoop\mapreduce\security\CredentialsTestJob.java,97,62,0,3,0,65
 hadoop-trunk\hadoop-trunk\hadoop-tools\hadoop-streaming\src\main\java\org\apache\hadoop\streaming\Environment.java,97,18,6,4,0,28
 hadoop-trunk\hadoop-trunk\hadoop-yarn-project\hadoop-yarn\hadoop-yarn-server\hadoop-yarn-server-common\src\main\java\org\apache\hadoop\yarn\server\utils\YarnServerBuilderUtils.java,97,20,14,2,0,36
 hadoop-trunk\hadoop-trunk\hadoop-mapreduce-project\hadoop-mapreduce-client\hadoop-mapreduce-client-jobclient\src\test\java\testshell\ExternalMapReduce.java,97,35,9,1,0,45
 hadoop-trunk\hadoop-trunk\hadoop-hdfs-project\hadoop-hdfs-rbf\src\test\java\org\apache\hadoop\hdfs\server\federation\router\TestRouterHeartbeatService.java,97,11,3,5,5,24
 hadoop-trunk\hadoop-trunk\hadoop-hdfs-project\hadoop-hdfs-client\src\main\java\org\apache\hadoop\hdfs\KeyProviderCache.java,97,14,4,2,1,21
 hadoop-trunk\hadoop-trunk\hadoop-tools\hadoop-dynamometer\hadoop-dynamometer-workload\src\main\java\org\apache\hadoop\tools\dynamometer\workloadgenerator\CreateFileMapper.java,97,23,9,1,0,33
 hadoop-trunk\hadoop-trunk\hadoop-mapreduce-project\hadoop-mapreduce-client\hadoop-mapreduce-client-app\src\main\java\org\apache\hadoop\mapreduce\v2\app\webapp\dao\TaskAttemptInfo.java,97,59,1,1,1,62
 hadoop-trunk\hadoop-trunk\hadoop-hdfs-project\hadoop-hdfs\src\main\java\org\apache\hadoop\hdfs\server\namenode\ha\RemoteNameNodeInfo.java,97,43,7,10,1,61
 hadoop-trunk\hadoop-trunk\hadoop-yarn-project\hadoop-yarn\hadoop-yarn-common\src\main\java\org\apache\hadoop\yarn\api\protocolrecords\impl\pb\GetContainerReportRequestPBImpl.java,97,25,36,3,0,64
 hadoop-trunk\hadoop-trunk\hadoop-tools\hadoop-rumen\src\main\java\org\apache\hadoop\tools\rumen\anonymization\WordList.java,97,34,0,1,2,37
 hadoop-trunk\hadoop-trunk\hadoop-yarn-project\hadoop-yarn\hadoop-yarn-server\hadoop-yarn-server-resourcemanager\src\main\java\org\apache\hadoop\yarn\server\resourcemanager\scheduler\activities\AppAllocation.java,97,55,0,1,6,62
 kafka-trunk\kafka-trunk\metadata\src\main\java\org\apache\kafka\timeline\TimelineLong.java,97,0,6,1,3,10
 kafka-trunk\kafka-trunk\clients\src\main\java\org\apache\kafka\clients\consumer\internals\AbstractPartitionAssignor.java,97,0,5,18,0,23
 kafka-trunk\kafka-trunk\trogdor\src\main\java\org\apache\kafka\trogdor\workload\GaussianThroughputGenerator.java,97,0,1,17,0,18
 kafka-trunk\kafka-trunk\metadata\src\main\java\org\apache\kafka\timeline\TimelineInteger.java,97,0,6,3,3,12
 kafka-trunk\kafka-trunk\clients\src\main\java\org\apache\kafka\common\requests\ElectLeadersRequest.java,97,0,0,11,2,13
 pulsar-master\pulsar-master\pulsar-client\src\main\java\org\apache\pulsar\client\impl\Backoff.java,97,64,0,14,0,78
 pulsar-master\pulsar-master\pulsar-client-admin-api\src\main\java\org\apache\pulsar\common\functions\FunctionConfig.java,97,56,0,12,0,68
 pulsar-master\pulsar-master\pulsar-client\src\test\java\org\apache\pulsar\client\impl\ControlledClusterFailoverTest.java,97,18,0,16,0,34
 pulsar-master\pulsar-master\pulsar-io\aws\src\main\java\org\apache\pulsar\io\aws\AbstractAwsConnector.java,97,30,2,16,0,48
 pulsar-master\pulsar-master\pulsar-metadata\src\main\java\org\apache\pulsar\metadata\bookkeeper\AbstractMetadataDriver.java,97,31,0,8,0,39
 pulsar-master\pulsar-master\tests\integration\src\test\java\org\apache\pulsar\tests\integration\io\sinks\JdbcPostgresSinkTester.java,97,22,4,4,0,30
 pulsar-master\pulsar-master\pulsar-io\kafka-connect-adaptor\src\test\java\org\apache\pulsar\io\kafka\connect\KafkaConnectSourceErrTest.java,97,20,4,11,0,35
 pulsar-master\pulsar-master\tests\integration\src\test\java\org\apache\pulsar\tests\integration\io\sinks\SinkTester.java,97,59,2,4,0,65
 pulsar-master\pulsar-master\pulsar-client\src\main\java\org\apache\pulsar\client\impl\schema\StringSchema.java,97,29,1,3,0,33
 rocketmq-develop\rocketmq-develop\test\src\test\java\org\apache\rocketmq\test\client\producer\exception\msg\MessageExceptionIT.java,97,36,4,13,28,81
 rocketmq-develop\rocketmq-develop\common\src\main\java\org\apache\rocketmq\common\protocol\route\QueueData.java,97,53,10,4,1,68
 shardingsphere-master\shardingsphere-master\examples\example-core\example-spring-mybatis\src\main\java\org\apache\shardingsphere\example\core\mybatis\service\OrderServiceImpl.java,97,27,0,10,0,37
 skywalking-master\skywalking-master\oap-server\server-core\src\test\java\org\apache\skywalking\oap\server\core\analysis\metrics\HeatMapMetricsTest.java,97,44,1,1,0,46
 skywalking-master\skywalking-master\oap-server\analyzer\log-analyzer\src\test\java\org\apache\skywalking\oap\log\analyzer\dsl\DSLSecurityTest.java,97,42,0,7,0,49
 skywalking-master\skywalking-master\oap-server\server-library\library-util\src\main\java\org\apache\skywalking\oap\server\library\util\prometheus\parser\TextParser.java,97,14,2,5,1,22
 zookeeper-master\zookeeper-master\zookeeper-server\src\main\java\org\apache\zookeeper\server\DigestCalculator.java,97,0,4,1,0,5
 zookeeper-master\zookeeper-master\zookeeper-server\src\main\java\org\apache\zookeeper\server\util\ConfigUtils.java,97,0,2,11,0,13
 zookeeper-master\zookeeper-master\zookeeper-server\src\test\java\org\apache\zookeeper\test\TestByteBufAllocator.java,97,0,3,9,1,13
 zookeeper-master\zookeeper-master\zookeeper-contrib\zookeeper-contrib-rest\src\test\java\org\apache\zookeeper\server\jersey\SessionTest.java,97,0,4,12,0,16
 zookeeper-master\zookeeper-master\zookeeper-server\src\main\java\org\apache\zookeeper\server\DumbWatcher.java,97,0,15,2,1,18
 backendApi-main\backendApi-main\.mvn\wrapper\MavenWrapperDownloader.java,98,30,7,16,0,53
 dubbo-3.0\dubbo-3.0\dubbo-metadata\dubbo-metadata-processor\src\test\java\org\apache\dubbo\metadata\annotation\processing\builder\MapTypeDefinitionBuilderTest.java,98,36,0,20,0,56
 dubbo-3.0\dubbo-3.0\dubbo-registry\dubbo-registry-api\src\main\java\org\apache\dubbo\registry\client\migration\model\SubMigrationRule.java,98,61,1,5,0,67
 dubbo-3.0\dubbo-3.0\dubbo-rpc\dubbo-rpc-api\src\main\java\org\apache\dubbo\rpc\RpcException.java,98,62,0,3,0,65
 hadoop-trunk\hadoop-trunk\hadoop-common-project\hadoop-common\src\test\java\org\apache\hadoop\tools\TestCommandShell.java,98,26,6,1,8,41
 hadoop-trunk\hadoop-trunk\hadoop-yarn-project\hadoop-yarn\hadoop-yarn-server\hadoop-yarn-server-resourcemanager\src\test\java\org\apache\hadoop\yarn\server\resourcemanager\MockMemoryRMStateStore.java,98,16,0,3,0,19
 hadoop-trunk\hadoop-trunk\hadoop-tools\hadoop-sls\src\main\java\org\apache\hadoop\yarn\sls\RMRunner.java,98,33,1,6,6,46
 hadoop-trunk\hadoop-trunk\hadoop-tools\hadoop-aws\src\test\java\org\apache\hadoop\fs\s3a\audit\MemoryHungryAuditor.java,98,14,5,2,1,22
 hadoop-trunk\hadoop-trunk\hadoop-yarn-project\hadoop-yarn\hadoop-yarn-server\hadoop-yarn-server-applicationhistoryservice\src\test\java\org\apache\hadoop\yarn\server\timeline\webapp\TestTimelineWebServicesWithSSL.java,98,18,2,2,1,23
 hadoop-trunk\hadoop-trunk\hadoop-mapreduce-project\hadoop-mapreduce-client\hadoop-mapreduce-client-jobclient\src\test\java\org\apache\hadoop\mapred\lib\TestDelegatingInputFormat.java,98,13,6,1,1,21
 hadoop-trunk\hadoop-trunk\hadoop-common-project\hadoop-common\src\main\java\org\apache\hadoop\io\erasurecode\rawcoder\RSLegacyRawEncoder.java,98,11,1,1,5,18
 hadoop-trunk\hadoop-trunk\hadoop-yarn-project\hadoop-yarn\hadoop-yarn-server\hadoop-yarn-server-resourcemanager\src\main\java\org\apache\hadoop\yarn\server\resourcemanager\reservation\planning\AlignedPlannerWithGreedy.java,98,23,9,2,0,34
 hadoop-trunk\hadoop-trunk\hadoop-yarn-project\hadoop-yarn\hadoop-yarn-applications\hadoop-yarn-services\hadoop-yarn-services-core\src\test\java\org\apache\hadoop\yarn\service\component\TestComponentDecommissionInstances.java,98,21,2,1,1,25
 hadoop-trunk\hadoop-trunk\hadoop-yarn-project\hadoop-yarn\hadoop-yarn-server\hadoop-yarn-server-nodemanager\src\main\java\org\apache\hadoop\yarn\server\nodemanager\containermanager\records\AuxServiceConfiguration.java,98,38,2,1,6,47
 hadoop-trunk\hadoop-trunk\hadoop-yarn-project\hadoop-yarn\hadoop-yarn-common\src\main\java\org\apache\hadoop\yarn\api\protocolrecords\impl\pb\GetContainerReportResponsePBImpl.java,98,26,36,4,0,66
 hadoop-trunk\hadoop-trunk\hadoop-yarn-project\hadoop-yarn\hadoop-yarn-server\hadoop-yarn-server-resourcemanager\src\main\java\org\apache\hadoop\yarn\server\resourcemanager\webapp\JAXBContextResolver.java,98,11,18,2,0,31
 hadoop-trunk\hadoop-trunk\hadoop-yarn-project\hadoop-yarn\hadoop-yarn-common\src\main\java\org\apache\hadoop\yarn\api\records\impl\pb\PreemptionContainerPBImpl.java,98,25,36,2,0,63
 hadoop-trunk\hadoop-trunk\hadoop-yarn-project\hadoop-yarn\hadoop-yarn-api\src\main\java\org\apache\hadoop\yarn\api\records\timelineservice\FlowRunEntity.java,98,42,0,1,1,44
 hadoop-trunk\hadoop-trunk\hadoop-common-project\hadoop-common\src\test\java\org\apache\hadoop\fs\store\TestDataBlocks.java,98,8,0,1,1,10
 hadoop-trunk\hadoop-trunk\hadoop-yarn-project\hadoop-yarn\hadoop-yarn-applications\hadoop-yarn-applications-mawo\hadoop-yarn-applications-mawo-core\src\main\java\org\apache\hadoop\applications\mawo\server\master\job\JobId.java,98,2,2,1,1,6
 hadoop-trunk\hadoop-trunk\hadoop-yarn-project\hadoop-yarn\hadoop-yarn-server\hadoop-yarn-server-resourcemanager\src\test\java\org\apache\hadoop\yarn\server\resourcemanager\scheduler\fair\TestSchedulingUpdate.java,98,13,1,4,0,18
 hadoop-trunk\hadoop-trunk\hadoop-yarn-project\hadoop-yarn\hadoop-yarn-server\hadoop-yarn-server-resourcemanager\src\test\java\org\apache\hadoop\yarn\server\resourcemanager\ParameterizedSchedulerTestBase.java,98,24,2,5,3,34
 hadoop-trunk\hadoop-trunk\hadoop-hdfs-project\hadoop-hdfs\src\test\java\org\apache\hadoop\hdfs\TestRestartDFS.java,98,19,0,4,2,25
 hadoop-trunk\hadoop-trunk\hadoop-client-modules\hadoop-client-integration-tests\src\test\java\org\apache\hadoop\example\ITUseHadoopCodecs.java,98,24,45,10,0,79
 hadoop-trunk\hadoop-trunk\hadoop-hdfs-project\hadoop-hdfs-rbf\src\main\java\org\apache\hadoop\hdfs\server\federation\resolver\order\HashResolver.java,98,10,0,1,0,11
 hadoop-trunk\hadoop-trunk\hadoop-common-project\hadoop-common\src\test\java\org\apache\hadoop\io\erasurecode\coder\TestRSErasureCoder.java,98,48,10,1,1,60
 hadoop-trunk\hadoop-trunk\hadoop-yarn-project\hadoop-yarn\hadoop-yarn-server\hadoop-yarn-server-timelineservice-documentstore\src\main\java\org\apache\hadoop\yarn\server\timelineservice\documentstore\collection\document\flowactivity\FlowActivityDocument.java,98,52,2,3,2,59
 hadoop-trunk\hadoop-trunk\hadoop-yarn-project\hadoop-yarn\hadoop-yarn-common\src\main\java\org\apache\hadoop\yarn\api\records\impl\pb\EnhancedHeadroomPBImpl.java,98,19,36,2,0,57
 hadoop-trunk\hadoop-trunk\hadoop-yarn-project\hadoop-yarn\hadoop-yarn-common\src\main\java\org\apache\hadoop\yarn\api\records\impl\pb\PreemptionResourceRequestPBImpl.java,98,25,36,2,0,63
 hadoop-trunk\hadoop-trunk\hadoop-yarn-project\hadoop-yarn\hadoop-yarn-server\hadoop-yarn-server-timelineservice\src\main\java\org\apache\hadoop\yarn\server\timelineservice\collector\AppLevelTimelineCollector.java,98,38,3,1,4,46
 kafka-trunk\kafka-trunk\clients\src\generated\java\org\apache\kafka\common\message\AddPartitionsToTxnRequestDataJsonConverter.java,98,0,0,26,0,26
 kafka-trunk\kafka-trunk\clients\src\main\java\org\apache\kafka\common\utils\BufferSupplier.java,98,0,4,9,1,14
 kafka-trunk\kafka-trunk\clients\src\test\java\org\apache\kafka\clients\producer\RoundRobinPartitionerTest.java,98,0,4,17,1,22
 kafka-trunk\kafka-trunk\streams\src\test\java\org\apache\kafka\streams\kstream\SessionWindowsTest.java,98,0,1,19,2,22
 kafka-trunk\kafka-trunk\connect\mirror\src\test\java\org\apache\kafka\connect\mirror\MirrorCheckpointConnectorTest.java,98,0,0,17,0,17
 kafka-trunk\kafka-trunk\generator\src\test\java\org\apache\kafka\message\IsNullConditionalTest.java,98,0,0,1,0,1
 kafka-trunk\kafka-trunk\streams\src\test\java\org\apache\kafka\streams\state\internals\SegmentedCacheFunctionTest.java,98,0,0,9,0,9
 kafka-trunk\kafka-trunk\clients\src\main\java\org\apache\kafka\clients\consumer\OffsetAndMetadata.java,98,0,6,12,0,18
 kafka-trunk\kafka-trunk\clients\src\main\java\org\apache\kafka\clients\admin\DescribeReplicaLogDirsResult.java,98,0,0,19,1,20
 kafka-trunk\kafka-trunk\clients\src\main\java\org\apache\kafka\common\security\oauthbearer\internals\expiring\ExpiringCredentialRefreshConfig.java,98,0,0,23,0,23
 kafka-trunk\kafka-trunk\streams\src\test\java\org\apache\kafka\streams\state\internals\QueryableStoreProviderTest.java,98,0,4,25,3,32
 pulsar-master\pulsar-master\buildtools\src\test\java\org\apache\pulsar\tests\FastThreadLocalStateCleanerTest.java,98,31,1,8,0,40
 pulsar-master\pulsar-master\pulsar-broker\src\test\java\org\apache\pulsar\websocket\proxy\SimpleConsumerSocket.java,98,52,3,6,0,61
 pulsar-master\pulsar-master\pulsar-metadata\src\test\java\org\apache\pulsar\metadata\bookkeeper\PulsarMetadataDriverBaseStaticTest.java,98,13,0,3,0,16
 pulsar-master\pulsar-master\pulsar-broker\src\main\java\org\apache\pulsar\broker\loadbalance\impl\OverloadShedder.java,98,40,2,33,0,75
 pulsar-master\pulsar-master\pulsar-client\src\main\java\org\apache\pulsar\client\impl\schema\RecordSchemaBuilderImpl.java,98,30,0,5,0,35
 pulsar-master\pulsar-master\tests\integration\src\test\java\org\apache\pulsar\tests\integration\io\sinks\CassandraSinkTester.java,98,21,5,5,0,31
 pulsar-master\pulsar-master\pulsar-broker\src\test\java\org\apache\pulsar\broker\stats\SubscriptionStatsTest.java,98,13,0,9,0,22
 rocketmq-develop\rocketmq-develop\tools\src\main\java\org\apache\rocketmq\tools\command\offset\ResetOffsetByTimeOldCommand.java,98,30,0,15,2,47
 rocketmq-develop\rocketmq-develop\test\src\test\java\org\apache\rocketmq\test\client\producer\order\OrderMsgRebalanceIT.java,98,26,2,18,6,52
 rocketmq-develop\rocketmq-develop\test\src\main\java\org\apache\rocketmq\test\listener\AbstractListener.java,98,49,5,9,2,65
 rocketmq-develop\rocketmq-develop\filter\src\test\java\org\apache\rocketmq\filter\BitsArrayTest.java,98,24,0,5,1,30
 shardingsphere-master\shardingsphere-master\.mvn\wrapper\MavenWrapperDownloader.java,98,31,6,16,0,53
 skywalking-master\skywalking-master\oap-server\server-receiver-plugin\envoy-metrics-receiver-plugin\src\main\java\org\apache\skywalking\oap\server\receiver\envoy\als\tcp\mx\MetaExchangeTCPAccessLogAnalyzer.java,98,29,2,23,0,54
 skywalking-master\skywalking-master\oap-server\server-core\src\main\java\org\apache\skywalking\oap\server\core\source\ServiceInstanceRelation.java,98,36,1,13,0,50
 zookeeper-master\zookeeper-master\zookeeper-server\src\test\java\org\apache\zookeeper\common\NetUtilsTest.java,98,0,12,14,0,26
 dubbo-3.0\dubbo-3.0\dubbo-registry\dubbo-registry-api\src\test\java\org\apache\dubbo\registry\PerformanceUtils.java,99,30,4,11,0,45
 dubbo-3.0\dubbo-3.0\dubbo-remoting\dubbo-remoting-api\src\main\java\org\apache\dubbo\remoting\transport\ChannelDelegate.java,99,36,1,1,2,40
 dubbo-3.0\dubbo-3.0\dubbo-rpc\dubbo-rpc-dubbo\src\test\java\org\apache\dubbo\rpc\protocol\dubbo\filter\TraceFilterTest.java,99,18,2,6,0,26
 dubbo-3.0\dubbo-3.0\dubbo-remoting\dubbo-remoting-api\src\test\java\org\apache\dubbo\remoting\PerformanceUtils.java,99,30,4,11,0,45
 dubbo-3.0\dubbo-3.0\dubbo-common\src\test\java\org\apache\dubbo\common\threadpool\support\AbortPolicyWithReportTest.java,99,26,7,14,3,50
 hadoop-trunk\hadoop-trunk\hadoop-hdfs-project\hadoop-hdfs\src\main\java\org\apache\hadoop\hdfs\server\protocol\BlockStorageMovementCommand.java,99,36,0,1,9,46
 hadoop-trunk\hadoop-trunk\hadoop-yarn-project\hadoop-yarn\hadoop-yarn-server\hadoop-yarn-server-resourcemanager\src\test\java\org\apache\hadoop\yarn\server\resourcemanager\scheduler\capacity\TestConfigurationProperties.java,99,10,2,2,0,14
 hadoop-trunk\hadoop-trunk\hadoop-yarn-project\hadoop-yarn\hadoop-yarn-common\src\main\java\org\apache\hadoop\yarn\api\protocolrecords\impl\pb\GetApplicationReportRequestPBImpl.java,99,39,37,6,0,82
 hadoop-trunk\hadoop-trunk\hadoop-common-project\hadoop-nfs\src\test\java\org\apache\hadoop\oncrpc\TestRpcCallCache.java,99,41,2,1,0,44
 hadoop-trunk\hadoop-trunk\hadoop-tools\hadoop-rumen\src\test\java\org\apache\hadoop\tools\rumen\TestPiecewiseLinearInterpolation.java,99,48,2,3,0,53
 hadoop-trunk\hadoop-trunk\hadoop-common-project\hadoop-common\src\test\java\org\apache\hadoop\net\TestSwitchMapping.java,99,9,2,1,0,12
 hadoop-trunk\hadoop-trunk\hadoop-hdfs-project\hadoop-hdfs\src\test\java\org\apache\hadoop\hdfs\server\aliasmap\TestSecureAliasMap.java,99,13,4,1,3,21
 hadoop-trunk\hadoop-trunk\hadoop-yarn-project\hadoop-yarn\hadoop-yarn-server\hadoop-yarn-server-common\src\test\java\org\apache\hadoop\yarn\server\federation\policies\router\TestLoadBasedRouterPolicy.java,99,15,1,2,1,19
 hadoop-trunk\hadoop-trunk\hadoop-common-project\hadoop-common\src\test\java\org\apache\hadoop\fs\TestChecksumFs.java,99,17,4,1,3,25
 hadoop-trunk\hadoop-trunk\hadoop-tools\hadoop-rumen\src\main\java\org\apache\hadoop\tools\rumen\ParsedTask.java,99,20,4,1,2,27
 hadoop-trunk\hadoop-trunk\hadoop-mapreduce-project\hadoop-mapreduce-client\hadoop-mapreduce-client-core\src\main\java\org\apache\hadoop\mapreduce\lib\aggregate\UniqValueCount.java,99,23,2,1,0,26
 hadoop-trunk\hadoop-trunk\hadoop-yarn-project\hadoop-yarn\hadoop-yarn-server\hadoop-yarn-server-resourcemanager\src\test\java\org\apache\hadoop\yarn\server\resourcemanager\monitor\TestSchedulingMonitor.java,99,9,0,6,0,15
 hadoop-trunk\hadoop-trunk\hadoop-hdfs-project\hadoop-hdfs\src\test\java\org\apache\hadoop\hdfs\server\datanode\TestLargeBlockReport.java,99,21,11,4,5,41
 hadoop-trunk\hadoop-trunk\hadoop-yarn-project\hadoop-yarn\hadoop-yarn-common\src\main\java\org\apache\hadoop\yarn\api\protocolrecords\impl\pb\GetDelegationTokenResponsePBImpl.java,99,34,37,4,0,75
 hadoop-trunk\hadoop-trunk\hadoop-yarn-project\hadoop-yarn\hadoop-yarn-common\src\main\java\org\apache\hadoop\yarn\api\protocolrecords\impl\pb\ReservationDeleteRequestPBImpl.java,99,25,36,3,0,64
 hadoop-trunk\hadoop-trunk\hadoop-mapreduce-project\hadoop-mapreduce-client\hadoop-mapreduce-client-core\src\test\java\org\apache\hadoop\mapreduce\lib\output\committer\manifest\TestLoadManifestsStage.java,99,3,0,6,0,9
 hadoop-trunk\hadoop-trunk\hadoop-mapreduce-project\hadoop-mapreduce-client\hadoop-mapreduce-client-core\src\main\java\org\apache\hadoop\mapred\lib\MultipleInputs.java,99,21,14,6,0,41
 hadoop-trunk\hadoop-trunk\hadoop-tools\hadoop-aws\src\test\java\org\apache\hadoop\fs\s3a\audit\TestAuditSpanLifecycle.java,99,9,0,1,1,11
 hadoop-trunk\hadoop-trunk\hadoop-yarn-project\hadoop-yarn\hadoop-yarn-common\src\main\java\org\apache\hadoop\yarn\api\protocolrecords\impl\pb\GetApplicationReportResponsePBImpl.java,99,40,37,8,0,85
 hadoop-trunk\hadoop-trunk\hadoop-common-project\hadoop-common\src\test\java\org\apache\hadoop\ha\TestSshFenceByTcpPort.java,99,29,6,1,0,36
 hadoop-trunk\hadoop-trunk\hadoop-common-project\hadoop-common\src\test\java\org\apache\hadoop\fs\TestBlockLocation.java,99,19,0,1,0,20
 hadoop-trunk\hadoop-trunk\hadoop-hdfs-project\hadoop-hdfs\src\test\java\org\apache\hadoop\hdfs\server\namenode\OfflineEditsViewerHelper.java,99,17,1,1,0,19
 hadoop-trunk\hadoop-trunk\hadoop-yarn-project\hadoop-yarn\hadoop-yarn-common\src\main\java\org\apache\hadoop\yarn\api\protocolrecords\impl\pb\GetClusterMetricsResponsePBImpl.java,99,37,37,5,0,79
 hadoop-trunk\hadoop-trunk\hadoop-yarn-project\hadoop-yarn\hadoop-yarn-common\src\main\java\org\apache\hadoop\yarn\api\protocolrecords\impl\pb\SubmitApplicationRequestPBImpl.java,99,45,37,11,0,93
 hadoop-trunk\hadoop-trunk\hadoop-yarn-project\hadoop-yarn\hadoop-yarn-server\hadoop-yarn-server-applicationhistoryservice\src\main\java\org\apache\hadoop\yarn\server\timeline\GenericObjectMapper.java,99,50,2,1,0,53
 hadoop-trunk\hadoop-trunk\hadoop-tools\hadoop-aws\src\test\java\org\apache\hadoop\fs\s3a\ITestS3AFileSystemContract.java,99,15,2,1,0,18
 hadoop-trunk\hadoop-trunk\hadoop-yarn-project\hadoop-yarn\hadoop-yarn-common\src\main\java\org\apache\hadoop\yarn\api\protocolrecords\impl\pb\GetQueueInfoResponsePBImpl.java,99,34,36,2,0,72
 kafka-trunk\kafka-trunk\raft\src\generated\java\org\apache\kafka\raft\generated\QuorumStateDataJsonConverter.java,99,0,0,21,0,21
 kafka-trunk\kafka-trunk\clients\src\main\java\org\apache\kafka\clients\consumer\StickyAssignor.java,99,0,2,45,0,47
 kafka-trunk\kafka-trunk\clients\src\test\java\org\apache\kafka\common\config\SaslConfigsTest.java,99,0,0,20,0,20
 kafka-trunk\kafka-trunk\clients\src\main\java\org\apache\kafka\common\requests\DescribeClientQuotasRequest.java,99,0,0,15,2,17
 kafka-trunk\kafka-trunk\clients\src\test\java\org\apache\kafka\common\utils\MockTime.java,99,0,4,8,2,14
 kafka-trunk\kafka-trunk\streams\src\test\java\org\apache\kafka\streams\processor\internals\PunctuationQueueTest.java,99,0,0,28,0,28
 pulsar-master\pulsar-master\pulsar-io\redis\src\main\java\org\apache\pulsar\io\redis\RedisSession.java,99,33,2,12,0,47
 pulsar-master\pulsar-master\pulsar-common\src\main\java\org\apache\pulsar\common\compression\CompressionCodecZLib.java,99,24,0,8,0,32
 pulsar-master\pulsar-master\pulsar-common\src\test\java\org\apache\pulsar\common\policies\data\PublisherStatsTest.java,99,16,0,3,0,19
 pulsar-master\pulsar-master\pulsar-package-management\bookkeeper-storage\src\test\java\org\apache\pulsar\packages\management\storage\bookkeeper\DLInputStreamTest.java,99,17,1,7,0,25
 rocketmq-develop\rocketmq-develop\client\src\main\java\org\apache\rocketmq\client\producer\RequestResponseFuture.java,99,65,4,3,9,81
 rocketmq-develop\rocketmq-develop\store\src\main\java\org\apache\rocketmq\store\index\IndexHeader.java,99,57,0,1,2,60
 skywalking-master\skywalking-master\oap-server\server-storage-plugin\storage-iotdb-plugin\src\main\java\org\apache\skywalking\oap\server\storage\plugin\iotdb\query\IoTDBBrowserLogQueryDAO.java,99,31,1,19,0,51
 skywalking-master\skywalking-master\oap-server\server-receiver-plugin\skywalking-trace-receiver-plugin\src\test\java\org\apache\skywalking\oap\server\receiver\trace\mock\AgentDataMock.java,99,28,3,17,0,48
 zookeeper-master\zookeeper-master\zookeeper-server\src\main\java\org\apache\zookeeper\server\quorum\ReadOnlyRequestProcessor.java,99,0,5,6,1,12
 zookeeper-master\zookeeper-master\zookeeper-server\src\test\java\org\apache\zookeeper\server\quorum\LearnerMetricsTest.java,99,0,1,19,2,22
 zookeeper-master\zookeeper-master\zookeeper-server\src\main\java\org\apache\zookeeper\server\controller\ControlCommand.java,99,0,1,8,1,10
 zookeeper-master\zookeeper-master\zookeeper-server\src\test\java\org\apache\zookeeper\test\OOMTest.java,99,0,6,18,0,24
 dubbo-3.0\dubbo-3.0\dubbo-rpc\dubbo-rpc-api\src\test\java\org\apache\dubbo\rpc\support\DemoServiceImpl.java,100,58,7,2,0,67
 dubbo-3.0\dubbo-3.0\dubbo-cluster\src\main\java\org\apache\dubbo\rpc\cluster\loadbalance\RoundRobinLoadBalance.java,100,34,1,9,0,44
 dubbo-3.0\dubbo-3.0\dubbo-common\src\main\java\org\apache\dubbo\rpc\model\ScopeModelUtil.java,100,32,1,15,0,48
 hadoop-trunk\hadoop-trunk\hadoop-yarn-project\hadoop-yarn\hadoop-yarn-server\hadoop-yarn-server-web-proxy\src\main\java\org\apache\hadoop\yarn\server\webproxy\WebAppProxyServer.java,100,19,3,2,0,24
 hadoop-trunk\hadoop-trunk\hadoop-yarn-project\hadoop-yarn\hadoop-yarn-server\hadoop-yarn-server-resourcemanager\src\test\java\org\apache\hadoop\yarn\server\resourcemanager\reservation\TestReservationSystemUtil.java,100,30,0,2,0,32
 hadoop-trunk\hadoop-trunk\hadoop-tools\hadoop-openstack\src\test\java\org\apache\hadoop\fs\swift\hdfs2\TestV2LsOperations.java,100,11,1,2,0,14
 hadoop-trunk\hadoop-trunk\hadoop-yarn-project\hadoop-yarn\hadoop-yarn-applications\hadoop-yarn-services\hadoop-yarn-services-core\src\main\java\org\apache\hadoop\yarn\service\component\ComponentEvent.java,100,67,0,1,9,77
 hadoop-trunk\hadoop-trunk\hadoop-hdfs-project\hadoop-hdfs-client\src\main\java\org\apache\hadoop\hdfs\protocol\ExtendedBlock.java,100,45,0,1,3,49
 hadoop-trunk\hadoop-trunk\hadoop-yarn-project\hadoop-yarn\hadoop-yarn-server\hadoop-yarn-server-resourcemanager\src\main\java\org\apache\hadoop\yarn\server\resourcemanager\recovery\records\impl\pb\AMRMTokenSecretManagerStatePBImpl.java,100,31,39,6,0,76
 hadoop-trunk\hadoop-trunk\hadoop-mapreduce-project\hadoop-mapreduce-client\hadoop-mapreduce-client-jobclient\src\test\java\org\apache\hadoop\mapreduce\lib\input\TestLineRecordReaderJobs.java,100,12,1,1,2,16
 hadoop-trunk\hadoop-trunk\hadoop-common-project\hadoop-common\src\main\java\org\apache\hadoop\fs\UnionStorageStatistics.java,100,11,3,1,3,18
 hadoop-trunk\hadoop-trunk\hadoop-yarn-project\hadoop-yarn\hadoop-yarn-server\hadoop-yarn-server-common\src\main\java\org\apache\hadoop\yarn\lib\ZKClient.java,100,32,3,1,0,36
 hadoop-trunk\hadoop-trunk\hadoop-yarn-project\hadoop-yarn\hadoop-yarn-api\src\main\java\org\apache\hadoop\yarn\api\records\NodeId.java,100,24,7,1,0,32
 hadoop-trunk\hadoop-trunk\hadoop-tools\hadoop-streaming\src\main\java\org\apache\hadoop\streaming\DumpTypedBytes.java,100,23,3,1,3,30
 hadoop-trunk\hadoop-trunk\hadoop-common-project\hadoop-common\src\main\java\org\apache\hadoop\io\nativeio\SharedFileDescriptorFactory.java,100,26,2,1,0,29
 hadoop-trunk\hadoop-trunk\hadoop-tools\hadoop-openstack\src\main\java\org\apache\hadoop\fs\swift\auth\entities\User.java,100,19,3,1,4,27
 hadoop-trunk\hadoop-trunk\hadoop-yarn-project\hadoop-yarn\hadoop-yarn-applications\hadoop-yarn-services\hadoop-yarn-services-core\src\main\java\org\apache\hadoop\yarn\service\api\records\Error.java,100,40,2,1,0,43
 hadoop-trunk\hadoop-trunk\hadoop-hdfs-project\hadoop-hdfs-rbf\src\main\java\org\apache\hadoop\hdfs\server\federation\fairness\StaticRouterRpcFairnessPolicyController.java,100,13,2,5,0,20
 hadoop-trunk\hadoop-trunk\hadoop-mapreduce-project\hadoop-mapreduce-client\hadoop-mapreduce-client-core\src\main\java\org\apache\hadoop\mapreduce\counters\Limits.java,100,51,1,2,1,55
 hadoop-trunk\hadoop-trunk\hadoop-mapreduce-project\hadoop-mapreduce-client\hadoop-mapreduce-client-jobclient\src\test\java\org\apache\hadoop\mapred\lib\aggregate\TestAggregates.java,100,20,17,1,1,39
 hadoop-trunk\hadoop-trunk\hadoop-hdfs-project\hadoop-hdfs\src\main\java\org\apache\hadoop\hdfs\server\namenode\StartupProgressServlet.java,100,25,1,2,0,28
 kafka-trunk\kafka-trunk\clients\src\main\java\org\apache\kafka\common\MetricNameTemplate.java,100,0,4,8,1,13
 kafka-trunk\kafka-trunk\clients\src\main\java\org\apache\kafka\common\requests\CreateAclsRequest.java,100,0,30,9,2,41
 kafka-trunk\kafka-trunk\connect\runtime\src\test\java\org\apache\kafka\connect\runtime\isolation\DelegatingClassLoaderTest.java,100,0,0,8,0,8
 kafka-trunk\kafka-trunk\clients\src\main\java\org\apache\kafka\clients\ClientResponse.java,100,0,1,6,6,13
 kafka-trunk\kafka-trunk\generator\src\main\java\org\apache\kafka\message\MetadataJsonConvertersGenerator.java,100,0,1,13,0,14
 kafka-trunk\kafka-trunk\streams\src\test\java\org\apache\kafka\streams\kstream\internals\SessionWindowTest.java,100,0,2,2,2,6
 kafka-trunk\kafka-trunk\clients\src\main\java\org\apache\kafka\common\requests\AddPartitionsToTxnRequest.java,100,0,0,12,4,16
 kafka-trunk\kafka-trunk\clients\src\main\java\org\apache\kafka\common\utils\ByteBufferOutputStream.java,100,0,1,18,2,21
 kafka-trunk\kafka-trunk\streams\src\main\java\org\apache\kafka\streams\processor\internals\ChangelogTopics.java,100,0,1,29,3,33
 pulsar-master\pulsar-master\pulsar-broker\src\main\java\org\apache\pulsar\broker\stats\NamespaceStats.java,100,54,0,11,0,65
 pulsar-master\pulsar-master\pulsar-broker\src\test\java\org\apache\pulsar\broker\transaction\coordinator\TransactionMetaStoreAssignmentTest.java,100,21,1,7,0,29
 pulsar-master\pulsar-master\managed-ledger\src\test\java\org\apache\bookkeeper\mledger\util\CallbackMutexTest.java,100,39,5,3,0,47
 pulsar-master\pulsar-master\pulsar-client\src\main\java\org\apache\pulsar\client\impl\schema\SchemaDefinitionImpl.java,100,33,0,5,0,38
 pulsar-master\pulsar-master\pulsar-broker\src\main\java\org\apache\pulsar\broker\admin\impl\ResourceQuotasBase.java,100,38,7,27,0,72
 pulsar-master\pulsar-master\pulsar-client-admin-api\src\main\java\org\apache\pulsar\common\policies\data\impl\BacklogQuotaImpl.java,100,54,0,4,0,58
 pulsar-master\pulsar-master\pulsar-functions\instance\src\main\java\org\apache\pulsar\functions\instance\LogAppender.java,100,36,0,5,0,41
 pulsar-master\pulsar-master\pulsar-broker\src\main\java\org\apache\pulsar\broker\loadbalance\impl\LeastLongTermMessageRate.java,100,25,4,23,0,52
 pulsar-master\pulsar-master\pulsar-metadata\src\test\java\org\apache\pulsar\metadata\impl\RocksdbMetadataStoreTest.java,100,21,3,15,0,39
 pulsar-master\pulsar-master\pulsar-functions\secrets\src\main\java\org\apache\pulsar\functions\secretsproviderconfigurator\KubernetesSecretsProviderConfigurator.java,100,45,1,27,0,73
 rocketmq-develop\rocketmq-develop\broker\src\test\java\org\apache\rocketmq\broker\processor\EndTransactionProcessorTest.java,100,49,3,25,0,77
 rocketmq-develop\rocketmq-develop\broker\src\main\java\org\apache\rocketmq\broker\latency\BrokerFastFailure.java,100,32,4,18,1,55
 rocketmq-develop\rocketmq-develop\tools\src\main\java\org\apache\rocketmq\tools\command\topic\TopicListSubCommand.java,100,19,1,11,4,35
 rocketmq-develop\rocketmq-develop\common\src\main\java\org\apache\rocketmq\common\protocol\route\BrokerData.java,100,49,12,6,3,70
 rocketmq-develop\rocketmq-develop\test\src\main\java\org\apache\rocketmq\test\factory\MQMessageFactory.java,100,53,2,13,6,74
 skywalking-master\skywalking-master\oap-server\server-alarm-plugin\src\main\java\org\apache\skywalking\oap\server\core\alarm\provider\AlarmRulesWatcher.java,100,39,4,15,0,58
 skywalking-master\skywalking-master\oap-server\server-core\src\main\java\org\apache\skywalking\oap\server\core\analysis\worker\MetricsAggregateWorker.java,100,31,3,12,0,46
 zookeeper-master\zookeeper-master\zookeeper-contrib\zookeeper-contrib-zooinspector\src\main\java\org\apache\zookeeper\inspector\gui\nodeviewer\NodeViewerData.java,100,0,2,5,1,8
 zookeeper-master\zookeeper-master\zookeeper-server\src\main\java\org\apache\zookeeper\server\NodeHashMapImpl.java,100,0,0,1,1,2
 zookeeper-master\zookeeper-master\zookeeper-server\src\test\java\org\apache\zookeeper\test\GetChildren2Test.java,100,0,14,7,1,22
 zookeeper-master\zookeeper-master\zookeeper-server\src\main\java\org\apache\zookeeper\server\quorum\UpgradeableSessionTracker.java,100,0,2,7,0,9
 zookeeper-master\zookeeper-master\zookeeper-server\src\test\java\org\apache\zookeeper\test\SessionTimeoutTest.java,100,0,13,15,0,28
 zookeeper-master\zookeeper-master\zookeeper-server\src\main\java\org\apache\zookeeper\server\controller\CommandClient.java,100,0,1,16,0,17
 dubbo-3.0\dubbo-3.0\dubbo-cluster\src\test\java\org\apache\dubbo\rpc\cluster\support\FailfastClusterInvokerTest.java,101,25,0,9,0,34
 dubbo-3.0\dubbo-3.0\dubbo-rpc\dubbo-rpc-api\src\test\java\org\apache\dubbo\rpc\RpcStatusTest.java,101,31,4,7,1,43
 hadoop-trunk\hadoop-trunk\hadoop-yarn-project\hadoop-yarn\hadoop-yarn-server\hadoop-yarn-server-resourcemanager\src\main\java\org\apache\hadoop\yarn\server\resourcemanager\scheduler\capacity\conf\QueueAdminConfigurationMutationACLPolicy.java,101,14,3,3,2,22
 hadoop-trunk\hadoop-trunk\hadoop-tools\hadoop-gridmix\src\test\java\org\apache\hadoop\mapred\gridmix\TestRandomAlgorithm.java,101,27,4,2,2,35
 hadoop-trunk\hadoop-trunk\hadoop-yarn-project\hadoop-yarn\hadoop-yarn-server\hadoop-yarn-server-resourcemanager\src\test\java\org\apache\hadoop\yarn\server\resourcemanager\placement\TestFairQueuePlacementUtils.java,101,4,0,7,0,11
 hadoop-trunk\hadoop-trunk\hadoop-yarn-project\hadoop-yarn\hadoop-yarn-api\src\main\java\org\apache\hadoop\yarn\api\records\timelineservice\HierarchicalTimelineEntity.java,101,32,1,1,0,34
 hadoop-trunk\hadoop-trunk\hadoop-yarn-project\hadoop-yarn\hadoop-yarn-common\src\main\java\org\apache\hadoop\yarn\api\protocolrecords\impl\pb\GetNewReservationResponsePBImpl.java,101,22,34,3,0,59
 hadoop-trunk\hadoop-trunk\hadoop-hdfs-project\hadoop-hdfs\src\main\java\org\apache\hadoop\hdfs\util\EnumDoubles.java,101,24,0,1,0,25
 hadoop-trunk\hadoop-trunk\hadoop-yarn-project\hadoop-yarn\hadoop-yarn-server\hadoop-yarn-server-resourcemanager\src\main\java\org\apache\hadoop\yarn\server\resourcemanager\scheduler\capacity\CSQueuePreemptionSettings.java,101,18,2,2,0,22
 hadoop-trunk\hadoop-trunk\hadoop-common-project\hadoop-common\src\main\java\org\apache\hadoop\ipc\ProtobufHelper.java,101,16,7,1,2,26
 hadoop-trunk\hadoop-trunk\hadoop-yarn-project\hadoop-yarn\hadoop-yarn-common\src\main\java\org\apache\hadoop\yarn\metrics\CustomResourceMetrics.java,101,35,0,1,1,37
 hadoop-trunk\hadoop-trunk\hadoop-yarn-project\hadoop-yarn\hadoop-yarn-client\src\main\java\org\apache\hadoop\yarn\client\api\impl\AHSClientImpl.java,101,22,0,5,0,27
 hadoop-trunk\hadoop-trunk\hadoop-yarn-project\hadoop-yarn\hadoop-yarn-common\src\main\java\org\apache\hadoop\yarn\api\records\impl\pb\ApplicationTimeoutPBImpl.java,101,22,37,1,0,60
 hadoop-trunk\hadoop-trunk\hadoop-yarn-project\hadoop-yarn\hadoop-yarn-server\hadoop-yarn-server-common\src\main\java\org\apache\hadoop\yarn\server\federation\store\records\impl\pb\GetSubClusterInfoResponsePBImpl.java,101,20,34,5,0,59
 hadoop-trunk\hadoop-trunk\hadoop-tools\hadoop-aws\src\main\java\org\apache\hadoop\fs\s3a\impl\BulkDeleteRetryHandler.java,101,9,5,1,0,15
 hadoop-trunk\hadoop-trunk\hadoop-tools\hadoop-azure\src\test\java\org\apache\hadoop\fs\azurebfs\TestAbfsNetworkStatistics.java,101,8,1,6,0,15
 hadoop-trunk\hadoop-trunk\hadoop-tools\hadoop-azure\src\test\java\org\apache\hadoop\fs\azure\TestWasbFsck.java,101,18,0,3,2,23
 hadoop-trunk\hadoop-trunk\hadoop-mapreduce-project\hadoop-mapreduce-client\hadoop-mapreduce-client-common\src\main\java\org\apache\hadoop\mapreduce\v2\api\protocolrecords\impl\pb\GetTaskAttemptCompletionEventsRequestPBImpl.java,101,44,45,10,0,99
 hadoop-trunk\hadoop-trunk\hadoop-yarn-project\hadoop-yarn\hadoop-yarn-server\hadoop-yarn-server-timelineservice-hbase\hadoop-yarn-server-timelineservice-hbase-client\src\main\java\org\apache\hadoop\yarn\server\timelineservice\storage\entity\EntityTableRW.java,101,8,1,2,0,11
 hadoop-trunk\hadoop-trunk\hadoop-tools\hadoop-aws\src\test\java\org\apache\hadoop\fs\s3a\TestWildflyAndOpenSSLBinding.java,101,7,0,5,0,12
 hadoop-trunk\hadoop-trunk\hadoop-yarn-project\hadoop-yarn\hadoop-yarn-common\src\main\java\org\apache\hadoop\yarn\webapp\view\TwoColumnLayout.java,101,10,2,2,0,14
 hadoop-trunk\hadoop-trunk\hadoop-yarn-project\hadoop-yarn\hadoop-yarn-server\hadoop-yarn-server-common\src\main\java\org\apache\hadoop\yarn\server\federation\store\records\impl\pb\SubClusterRegisterRequestPBImpl.java,101,20,34,5,0,59
 hadoop-trunk\hadoop-trunk\hadoop-mapreduce-project\hadoop-mapreduce-client\hadoop-mapreduce-client-jobclient\src\test\java\org\apache\hadoop\mapred\TestLineRecordReaderJobs.java,101,20,1,1,2,24
 hadoop-trunk\hadoop-trunk\hadoop-common-project\hadoop-common\src\test\java\org\apache\hadoop\security\TestNetgroupCache.java,101,9,0,1,0,10
 hadoop-trunk\hadoop-trunk\hadoop-tools\hadoop-aws\src\test\java\org\apache\hadoop\fs\s3a\auth\TestMarshalledCredentials.java,101,9,0,1,2,12
 hadoop-trunk\hadoop-trunk\hadoop-hdfs-project\hadoop-hdfs-httpfs\src\test\java\org\apache\hadoop\lib\wsrs\TestParam.java,101,24,5,3,10,42
 hadoop-trunk\hadoop-trunk\hadoop-hdfs-project\hadoop-hdfs-client\src\main\java\org\apache\hadoop\hdfs\net\DomainPeer.java,101,25,0,2,3,30
 hadoop-trunk\hadoop-trunk\hadoop-common-project\hadoop-common\src\main\java\org\apache\hadoop\ipc\RefreshRegistry.java,101,24,2,3,0,29
 hadoop-trunk\hadoop-trunk\hadoop-yarn-project\hadoop-yarn\hadoop-yarn-common\src\main\java\org\apache\hadoop\yarn\api\protocolrecords\impl\pb\GetApplicationAttemptsRequestPBImpl.java,101,24,34,3,0,61
 hadoop-trunk\hadoop-trunk\hadoop-common-project\hadoop-common\src\test\java\org\apache\hadoop\io\erasurecode\rawcoder\TestNativeRSRawCoder.java,101,62,14,1,0,77
 hadoop-trunk\hadoop-trunk\hadoop-mapreduce-project\hadoop-mapreduce-client\hadoop-mapreduce-client-app\src\test\java\org\apache\hadoop\mapreduce\v2\app\job\impl\TestShuffleProvider.java,101,29,6,12,1,48
 hadoop-trunk\hadoop-trunk\hadoop-yarn-project\hadoop-yarn\hadoop-yarn-server\hadoop-yarn-server-resourcemanager\src\main\java\org\apache\hadoop\yarn\server\resourcemanager\placement\csmappingrule\MappingRuleConditionalVariables.java,101,12,0,2,2,16
 hadoop-trunk\hadoop-trunk\hadoop-common-project\hadoop-nfs\src\main\java\org\apache\hadoop\oncrpc\RpcCall.java,101,57,1,1,4,63
 hadoop-trunk\hadoop-trunk\hadoop-yarn-project\hadoop-yarn\hadoop-yarn-common\src\main\java\org\apache\hadoop\yarn\server\metrics\ApplicationMetricsConstants.java,101,34,0,1,0,35
 hadoop-trunk\hadoop-trunk\hadoop-yarn-project\hadoop-yarn\hadoop-yarn-server\hadoop-yarn-server-resourcemanager\src\main\java\org\apache\hadoop\yarn\server\resourcemanager\reservation\CapacitySchedulerPlanFollower.java,101,35,3,9,1,48
 kafka-trunk\kafka-trunk\streams\upgrade-system-tests-22\src\test\java\org\apache\kafka\streams\tests\StreamsUpgradeToCooperativeRebalanceTest.java,101,0,2,17,0,19
 kafka-trunk\kafka-trunk\streams\upgrade-system-tests-20\src\test\java\org\apache\kafka\streams\tests\StreamsUpgradeToCooperativeRebalanceTest.java,101,0,2,17,0,19
 kafka-trunk\kafka-trunk\streams\upgrade-system-tests-10\src\test\java\org\apache\kafka\streams\tests\StreamsUpgradeToCooperativeRebalanceTest.java,101,0,2,17,0,19
 kafka-trunk\kafka-trunk\metadata\src\generated\java\org\apache\kafka\common\metadata\ClientQuotaRecordJsonConverter.java,101,0,0,18,0,18
 kafka-trunk\kafka-trunk\trogdor\src\main\java\org\apache\kafka\trogdor\workload\RoundTripWorkloadSpec.java,101,0,0,4,5,9
 kafka-trunk\kafka-trunk\streams\src\test\java\org\apache\kafka\streams\tests\StreamsUpgradeToCooperativeRebalanceTest.java,101,0,2,16,0,18
 kafka-trunk\kafka-trunk\streams\upgrade-system-tests-21\src\test\java\org\apache\kafka\streams\tests\StreamsUpgradeToCooperativeRebalanceTest.java,101,0,2,17,0,19
 kafka-trunk\kafka-trunk\streams\upgrade-system-tests-11\src\test\java\org\apache\kafka\streams\tests\StreamsUpgradeToCooperativeRebalanceTest.java,101,0,2,17,0,19
 pulsar-master\pulsar-master\pulsar-functions\runtime\src\test\java\org\apache\pulsar\functions\runtime\thread\ThreadRuntimeFactoryTest.java,101,48,0,18,0,66
 pulsar-master\pulsar-master\pulsar-broker\src\test\java\org\apache\pulsar\broker\protocol\ProtocolHandlerUtilsTest.java,101,19,2,18,0,39
 pulsar-master\pulsar-master\pulsar-common\src\main\java\org\apache\pulsar\common\protocol\PulsarHandler.java,101,42,4,16,0,62
 pulsar-master\pulsar-master\pulsar-broker\src\test\java\org\apache\pulsar\broker\transaction\coordinator\TransactionMetaStoreTestBase.java,101,29,1,9,0,39
 pulsar-master\pulsar-master\pulsar-broker\src\main\java\org\apache\pulsar\broker\service\persistent\ReplicatedSubscriptionsSnapshotBuilder.java,101,42,0,17,0,59
 pulsar-master\pulsar-master\pulsar-common\src\test\java\org\apache\pulsar\common\util\FutureUtilTest.java,101,20,2,14,0,36
 pulsar-master\pulsar-master\pulsar-io\rabbitmq\src\main\java\org\apache\pulsar\io\rabbitmq\RabbitMQAbstractConfig.java,101,26,0,6,0,32
 pulsar-master\pulsar-master\pulsar-client\src\test\java\org\apache\pulsar\client\impl\auth\oauth2\AuthenticationOAuth2Test.java,101,24,0,8,0,32
 pulsar-master\pulsar-master\managed-ledger\src\main\java\org\apache\bookkeeper\mledger\util\StatsBuckets.java,101,31,0,3,0,34
 rocketmq-develop\rocketmq-develop\client\src\main\java\org\apache\rocketmq\client\hook\CheckForbiddenContext.java,101,74,0,4,8,86
 rocketmq-develop\rocketmq-develop\store\src\main\java\org\apache\rocketmq\store\stats\LmqBrokerStatsManager.java,101,15,0,6,0,21
 rocketmq-develop\rocketmq-develop\tools\src\main\java\org\apache\rocketmq\tools\command\offset\ResetOffsetByTimeCommand.java,101,20,1,12,1,34
 rocketmq-develop\rocketmq-develop\test\src\test\java\org\apache\rocketmq\test\client\consumer\filter\SqlFilterIT.java,101,30,2,11,4,47
 skywalking-master\skywalking-master\oap-server\server-core\src\test\java\org\apache\skywalking\oap\server\core\profiling\ebpf\analyze\EBPFProfilingAnalyzeContext.java,101,29,0,19,0,48
 skywalking-master\skywalking-master\oap-server\server-storage-plugin\storage-elasticsearch-plugin\src\main\java\org\apache\skywalking\oap\server\storage\plugin\elasticsearch\base\MetricsEsDAO.java,101,40,1,29,0,70
 zookeeper-master\zookeeper-master\zookeeper-server\src\test\java\org\apache\zookeeper\test\KeyAuthClientTest.java,101,0,19,4,0,23
 dubbo-3.0\dubbo-3.0\dubbo-common\src\test\java\org\apache\dubbo\common\utils\StackTest.java,102,12,0,1,6,19
 dubbo-3.0\dubbo-3.0\dubbo-rpc\dubbo-rpc-triple\src\main\java\org\apache\dubbo\rpc\protocol\tri\TripleHttp2Protocol.java,102,49,2,25,0,76
 dubbo-3.0\dubbo-3.0\dubbo-remoting\dubbo-remoting-api\src\main\java\org\apache\dubbo\remoting\exchange\support\ExchangeServerDelegate.java,102,36,1,1,0,38
 dubbo-3.0\dubbo-3.0\dubbo-metadata\dubbo-metadata-api\src\test\java\org\apache\dubbo\metadata\MetadataInfoTest.java,102,41,1,23,0,65
 dubbo-3.0\dubbo-3.0\dubbo-filter\dubbo-filter-validation\src\test\java\org\apache\dubbo\validation\filter\ValidationFilterTest.java,102,26,0,14,0,40
 hadoop-trunk\hadoop-trunk\hadoop-yarn-project\hadoop-yarn\hadoop-yarn-server\hadoop-yarn-server-nodemanager\src\main\java\org\apache\hadoop\yarn\server\nodemanager\webapp\NMWebAppFilter.java,102,17,1,2,1,21
 hadoop-trunk\hadoop-trunk\hadoop-yarn-project\hadoop-yarn\hadoop-yarn-server\hadoop-yarn-server-timelineservice-hbase\hadoop-yarn-server-timelineservice-hbase-client\src\main\java\org\apache\hadoop\yarn\server\timelineservice\storage\subapplication\SubApplicationTableRW.java,102,8,1,2,0,11
 hadoop-trunk\hadoop-trunk\hadoop-common-project\hadoop-common\src\main\java\org\apache\hadoop\util\ThreadUtil.java,102,13,1,1,0,15
 hadoop-trunk\hadoop-trunk\hadoop-hdfs-project\hadoop-hdfs\src\test\java\org\apache\hadoop\hdfs\TestStripedFileAppend.java,102,20,1,1,2,24
 hadoop-trunk\hadoop-trunk\hadoop-common-project\hadoop-auth\src\test\java\org\apache\hadoop\security\authentication\KerberosTestUtils.java,102,30,1,9,0,40
 hadoop-trunk\hadoop-trunk\hadoop-yarn-project\hadoop-yarn\hadoop-yarn-applications\hadoop-yarn-services\hadoop-yarn-services-core\src\test\java\org\apache\hadoop\yarn\service\component\TestComponentRestartPolicy.java,102,10,12,1,6,29
 hadoop-trunk\hadoop-trunk\hadoop-yarn-project\hadoop-yarn\hadoop-yarn-server\hadoop-yarn-server-resourcemanager\src\main\java\org\apache\hadoop\yarn\server\resourcemanager\scheduler\fair\policies\FifoPolicy.java,102,25,2,2,0,29
 hadoop-trunk\hadoop-trunk\hadoop-yarn-project\hadoop-yarn\hadoop-yarn-server\hadoop-yarn-server-timelineservice-hbase\hadoop-yarn-server-timelineservice-hbase-client\src\main\java\org\apache\hadoop\yarn\server\timelineservice\storage\application\ApplicationTableRW.java,102,8,1,2,0,11
 hadoop-trunk\hadoop-trunk\hadoop-mapreduce-project\hadoop-mapreduce-client\hadoop-mapreduce-client-core\src\main\java\org\apache\hadoop\mapreduce\jobhistory\EventWriter.java,102,33,27,1,0,61
 hadoop-trunk\hadoop-trunk\hadoop-tools\hadoop-streaming\src\main\java\org\apache\hadoop\streaming\io\IdentifierResolver.java,102,36,15,1,0,52
 hadoop-trunk\hadoop-trunk\hadoop-hdfs-project\hadoop-hdfs\src\main\java\org\apache\hadoop\hdfs\server\protocol\BlockECReconstructionCommand.java,102,58,0,1,13,72
 hadoop-trunk\hadoop-trunk\hadoop-yarn-project\hadoop-yarn\hadoop-yarn-server\hadoop-yarn-server-common\src\test\java\org\apache\hadoop\yarn\server\federation\policies\router\TestWeightedRandomRouterPolicy.java,102,15,2,2,0,19
 hadoop-trunk\hadoop-trunk\hadoop-yarn-project\hadoop-yarn\hadoop-yarn-common\src\main\java\org\apache\hadoop\yarn\api\protocolrecords\impl\pb\GetQueueInfoRequestPBImpl.java,102,31,48,2,0,81
 hadoop-trunk\hadoop-trunk\hadoop-common-project\hadoop-common\src\main\java\org\apache\hadoop\io\compress\GzipCodec.java,102,40,2,3,0,45
 hadoop-trunk\hadoop-trunk\hadoop-yarn-project\hadoop-yarn\hadoop-yarn-applications\hadoop-yarn-services\hadoop-yarn-services-core\src\main\java\org\apache\hadoop\yarn\service\utils\SliderFileSystem.java,102,24,0,1,0,25
 hadoop-trunk\hadoop-trunk\hadoop-yarn-project\hadoop-yarn\hadoop-yarn-server\hadoop-yarn-server-common\src\main\java\org\apache\hadoop\yarn\server\api\impl\pb\service\DistributedSchedulingAMProtocolPBServiceImpl.java,102,19,25,14,0,58
 hadoop-trunk\hadoop-trunk\hadoop-yarn-project\hadoop-yarn\hadoop-yarn-common\src\main\java\org\apache\hadoop\yarn\api\protocolrecords\impl\pb\FailApplicationAttemptRequestPBImpl.java,102,30,37,6,0,73
 hadoop-trunk\hadoop-trunk\hadoop-yarn-project\hadoop-yarn\hadoop-yarn-common\src\main\java\org\apache\hadoop\yarn\server\api\protocolrecords\impl\pb\RefreshNodesRequestPBImpl.java,102,31,40,5,0,76
 hadoop-trunk\hadoop-trunk\hadoop-yarn-project\hadoop-yarn\hadoop-yarn-server\hadoop-yarn-server-common\src\test\java\org\apache\hadoop\yarn\server\federation\policies\TestFederationPolicyInitializationContextValidator.java,102,18,5,8,3,34
 hadoop-trunk\hadoop-trunk\hadoop-yarn-project\hadoop-yarn\hadoop-yarn-server\hadoop-yarn-server-common\src\main\java\org\apache\hadoop\yarn\server\scheduler\ResourceRequestSetKey.java,102,23,3,1,3,30
 hadoop-trunk\hadoop-trunk\hadoop-hdfs-project\hadoop-hdfs\src\test\java\org\apache\hadoop\hdfs\server\namenode\TestQuotaWithStripedBlocks.java,102,20,5,1,8,34
 hadoop-trunk\hadoop-trunk\hadoop-hdfs-project\hadoop-hdfs-rbf\src\main\java\org\apache\hadoop\hdfs\server\federation\router\RouterPermissionChecker.java,102,10,2,1,0,13
 hadoop-trunk\hadoop-trunk\hadoop-cloud-storage-project\hadoop-cos\src\test\java\org\apache\hadoop\fs\cosn\TestCosCredentials.java,102,21,9,1,1,32
 hadoop-trunk\hadoop-trunk\hadoop-hdfs-project\hadoop-hdfs\src\test\java\org\apache\hadoop\cli\TestCacheAdminCLI.java,102,24,1,1,0,26
 hadoop-trunk\hadoop-trunk\hadoop-yarn-project\hadoop-yarn\hadoop-yarn-server\hadoop-yarn-server-resourcemanager\src\main\java\org\apache\hadoop\yarn\server\resourcemanager\webapp\DeSelectFields.java,102,13,1,1,0,15
 hadoop-trunk\hadoop-trunk\hadoop-hdfs-project\hadoop-hdfs\src\test\java\org\apache\hadoop\hdfs\server\namenode\ha\TestHAAppend.java,102,24,0,1,1,26
 kafka-trunk\kafka-trunk\streams\src\test\java\org\apache\kafka\streams\kstream\internals\KStreamFlatTransformValuesTest.java,102,0,0,13,1,14
 kafka-trunk\kafka-trunk\streams\src\test\java\org\apache\kafka\streams\processor\internals\WriteConsistencyVectorTest.java,102,0,1,15,2,18
 kafka-trunk\kafka-trunk\streams\src\test\java\org\apache\kafka\streams\kstream\internals\foreignkeyjoin\SubscriptionResponseWrapperSerdeTest.java,102,0,3,19,6,28
 kafka-trunk\kafka-trunk\connect\runtime\src\test\java\org\apache\kafka\connect\integration\StartAndStopLatchTest.java,102,0,1,8,2,11
 kafka-trunk\kafka-trunk\clients\src\main\java\org\apache\kafka\common\requests\OffsetsForLeaderEpochRequest.java,102,0,54,27,2,83
 kafka-trunk\kafka-trunk\jmh-benchmarks\src\main\java\org\apache\kafka\jmh\partition\PartitionMakeFollowerBenchmark.java,102,0,2,21,1,24
 kafka-trunk\kafka-trunk\clients\src\generated\java\org\apache\kafka\common\message\ListGroupsResponseDataJsonConverter.java,102,0,0,19,0,19
 kafka-trunk\kafka-trunk\raft\src\main\java\org\apache\kafka\raft\ElectionState.java,102,0,12,13,1,26
 kafka-trunk\kafka-trunk\storage\src\test\java\org\apache\kafka\server\log\remote\metadata\storage\TopicBasedRemoteLogMetadataManagerHarness.java,102,0,0,33,2,35
 pulsar-master\pulsar-master\pulsar-broker\src\test\java\org\apache\pulsar\websocket\proxy\ProxyPublishConsumeTlsTest.java,102,22,3,13,0,38
 pulsar-master\pulsar-master\pulsar-package-management\bookkeeper-storage\src\test\java\org\apache\pulsar\packages\management\storage\bookkeeper\DLOutputStreamTest.java,102,22,0,10,0,32
 pulsar-master\pulsar-master\pulsar-proxy\src\test\java\org\apache\pulsar\proxy\extensions\ProxyExtensionUtilsTest.java,102,19,2,18,0,39
 skywalking-master\skywalking-master\oap-server\server-storage-plugin\storage-influxdb-plugin\src\main\java\org\apache\skywalking\oap\server\storage\plugin\influxdb\query\ProfileTaskQuery.java,102,17,0,5,0,22
 skywalking-master\skywalking-master\oap-server\server-core\src\main\java\org\apache\skywalking\oap\server\core\analysis\manual\segment\SegmentRecord.java,102,35,0,11,0,46
 zookeeper-master\zookeeper-master\zookeeper-server\src\main\java\org\apache\zookeeper\server\metric\AvgMinMaxPercentileCounter.java,102,0,2,7,0,9
 dubbo-3.0\dubbo-3.0\dubbo-compatible\src\main\java\com\alibaba\dubbo\container\page\pages\SystemPageHandler.java,103,15,0,7,0,22
 dubbo-3.0\dubbo-3.0\dubbo-filter\dubbo-filter-cache\src\test\java\org\apache\dubbo\cache\filter\CacheFilterTest.java,103,34,0,7,0,41
 dubbo-3.0\dubbo-3.0\dubbo-remoting\dubbo-remoting-http\src\main\java\org\apache\dubbo\remoting\http\support\AbstractHttpServer.java,103,30,7,2,0,39
 hadoop-trunk\hadoop-trunk\hadoop-mapreduce-project\hadoop-mapreduce-client\hadoop-mapreduce-client-jobclient\src\test\java\org\apache\hadoop\mapred\TestJobSysDirWithDFS.java,103,41,9,3,1,54
 hadoop-trunk\hadoop-trunk\hadoop-yarn-project\hadoop-yarn\hadoop-yarn-server\hadoop-yarn-server-resourcemanager\src\main\java\org\apache\hadoop\yarn\server\resourcemanager\webapp\dao\AppAttemptInfo.java,103,45,8,4,0,57
 hadoop-trunk\hadoop-trunk\hadoop-hdfs-project\hadoop-hdfs\src\test\java\org\apache\hadoop\hdfs\server\namenode\TestEditLogAutoroll.java,103,33,3,8,5,49
 hadoop-trunk\hadoop-trunk\hadoop-mapreduce-project\hadoop-mapreduce-client\hadoop-mapreduce-client-core\src\main\java\org\apache\hadoop\mapreduce\security\token\JobTokenSecretManager.java,103,22,1,1,1,25
 hadoop-trunk\hadoop-trunk\hadoop-yarn-project\hadoop-yarn\hadoop-yarn-applications\hadoop-yarn-services\hadoop-yarn-services-core\src\main\java\org\apache\hadoop\yarn\service\impl\pb\service\ClientAMProtocolPBServiceImpl.java,103,30,35,10,0,75
 hadoop-trunk\hadoop-trunk\hadoop-mapreduce-project\hadoop-mapreduce-client\hadoop-mapreduce-client-jobclient\src\test\java\org\apache\hadoop\mapreduce\lib\partition\TestMRKeyFieldBasedPartitioner.java,103,19,0,2,7,28
 hadoop-trunk\hadoop-trunk\hadoop-hdfs-project\hadoop-hdfs-nfs\src\test\java\org\apache\hadoop\hdfs\nfs\TestUdpServer.java,103,39,9,1,2,51
 hadoop-trunk\hadoop-trunk\hadoop-hdfs-project\hadoop-hdfs-client\src\main\java\org\apache\hadoop\hdfs\net\BasicInetPeer.java,103,24,0,1,2,27
 hadoop-trunk\hadoop-trunk\hadoop-tools\hadoop-distcp\src\test\java\org\apache\hadoop\tools\TestGlobbedCopyListing.java,103,17,3,4,1,25
 hadoop-trunk\hadoop-trunk\hadoop-hdfs-project\hadoop-hdfs-httpfs\src\test\java\org\apache\hadoop\test\KerberosTestUtils.java,103,23,1,2,0,26
 hadoop-trunk\hadoop-trunk\hadoop-hdfs-project\hadoop-hdfs\src\test\java\org\apache\hadoop\hdfs\server\datanode\TestBlockCountersInPendingIBR.java,103,15,0,2,0,17
 hadoop-trunk\hadoop-trunk\hadoop-hdfs-project\hadoop-hdfs-client\src\main\java\org\apache\hadoop\hdfs\server\protocol\DatanodeStorage.java,103,29,1,1,0,31
 hadoop-trunk\hadoop-trunk\hadoop-yarn-project\hadoop-yarn\hadoop-yarn-server\hadoop-yarn-server-nodemanager\src\test\java\org\apache\hadoop\yarn\server\nodemanager\security\TestNMContainerTokenSecretManager.java,103,10,2,2,0,14
 hadoop-trunk\hadoop-trunk\hadoop-yarn-project\hadoop-yarn\hadoop-yarn-server\hadoop-yarn-server-timelineservice-hbase\hadoop-yarn-server-timelineservice-hbase-common\src\test\java\org\apache\hadoop\yarn\server\timelineservice\storage\common\TestKeyConverters.java,103,15,3,1,0,19
 hadoop-trunk\hadoop-trunk\hadoop-hdfs-project\hadoop-hdfs\src\test\java\org\apache\hadoop\hdfs\server\datanode\TestDataNodeFSDataSetSink.java,103,12,1,1,0,14
 hadoop-trunk\hadoop-trunk\hadoop-yarn-project\hadoop-yarn\hadoop-yarn-server\hadoop-yarn-server-common\src\main\java\org\apache\hadoop\yarn\server\federation\policies\FederationPolicyInitializationContext.java,103,17,0,3,9,29
 hadoop-trunk\hadoop-trunk\hadoop-yarn-project\hadoop-yarn\hadoop-yarn-common\src\main\java\org\apache\hadoop\yarn\api\protocolrecords\impl\pb\GetContainersRequestPBImpl.java,103,24,34,3,0,61
 hadoop-trunk\hadoop-trunk\hadoop-yarn-project\hadoop-yarn\hadoop-yarn-server\hadoop-yarn-server-nodemanager\src\test\java\org\apache\hadoop\yarn\server\nodemanager\amrmproxy\TestAMRMProxyTokenSecretManager.java,103,7,2,2,2,13
 hadoop-trunk\hadoop-trunk\hadoop-yarn-project\hadoop-yarn\hadoop-yarn-common\src\main\java\org\apache\hadoop\yarn\api\protocolrecords\impl\pb\UpdateApplicationPriorityResponsePBImpl.java,103,23,35,4,0,62
 hadoop-trunk\hadoop-trunk\hadoop-yarn-project\hadoop-yarn\hadoop-yarn-server\hadoop-yarn-server-common\src\test\java\org\apache\hadoop\yarn\server\federation\utils\TestFederationStateStoreFacadeRetry.java,103,10,0,4,0,14
 hadoop-trunk\hadoop-trunk\hadoop-yarn-project\hadoop-yarn\hadoop-yarn-server\hadoop-yarn-server-timelineservice-documentstore\src\main\java\org\apache\hadoop\yarn\server\timelineservice\documentstore\writer\TimelineCollectionWriter.java,103,29,3,6,1,39
 hadoop-trunk\hadoop-trunk\hadoop-common-project\hadoop-common\src\main\java\org\apache\hadoop\http\lib\StaticUserWebFilter.java,103,27,1,3,0,31
 hadoop-trunk\hadoop-trunk\hadoop-yarn-project\hadoop-yarn\hadoop-yarn-server\hadoop-yarn-server-resourcemanager\src\test\java\org\apache\hadoop\yarn\server\resourcemanager\reservation\TestCapacityOverTimePolicy.java,103,66,5,5,0,76
 kafka-trunk\kafka-trunk\clients\src\main\java\org\apache\kafka\common\requests\RequestHeader.java,103,0,44,10,2,56
 kafka-trunk\kafka-trunk\clients\src\test\java\org\apache\kafka\common\requests\OffsetCommitRequestTest.java,103,0,0,11,13,24
 kafka-trunk\kafka-trunk\connect\runtime\src\main\java\org\apache\kafka\connect\runtime\rest\resources\ConnectorPluginsResource.java,103,0,2,26,1,29
 kafka-trunk\kafka-trunk\clients\src\main\java\org\apache\kafka\clients\consumer\CooperativeStickyAssignor.java,103,0,2,32,0,34
 kafka-trunk\kafka-trunk\clients\src\main\java\org\apache\kafka\common\requests\DeleteAclsResponse.java,103,0,28,20,2,50
 pulsar-master\pulsar-master\pulsar-io\kafka-connect-adaptor\src\test\java\org\apache\pulsar\io\kafka\connect\KafkaConnectSourceTest.java,103,22,4,10,0,36
 pulsar-master\pulsar-master\pulsar-broker\src\main\java\org\apache\pulsar\broker\loadbalance\impl\ModularLoadManagerWrapper.java,103,27,2,6,0,35
 pulsar-master\pulsar-master\pulsar-metadata\src\test\java\org\apache\pulsar\metadata\BaseMetadataStoreTest.java,103,39,1,11,0,51
 pulsar-master\pulsar-master\pulsar-client\src\test\java\org\apache\pulsar\client\impl\schema\StringSchemaTest.java,103,7,0,1,0,8
 pulsar-master\pulsar-master\pulsar-broker\src\main\java\org\apache\pulsar\broker\resourcegroup\ResourceQuotaCalculatorImpl.java,103,40,0,27,0,67
 pulsar-master\pulsar-master\pulsar-client\src\main\java\org\apache\pulsar\client\impl\auth\oauth2\protocol\TokenClient.java,103,28,0,10,0,38
 pulsar-master\pulsar-master\tests\integration\src\test\java\org\apache\pulsar\tests\integration\io\sources\KafkaSourceTester.java,103,23,1,8,0,32
 skywalking-master\skywalking-master\oap-server\server-core\src\test\java\org\apache\skywalking\oap\server\core\remote\client\GRPCRemoteClientTestCase.java,103,31,5,11,0,47
 skywalking-master\skywalking-master\oap-server\server-library\library-module\src\main\java\org\apache\skywalking\oap\server\library\module\ModuleProvider.java,103,27,3,15,0,45
 skywalking-master\skywalking-master\oap-server\server-storage-plugin\storage-jdbc-hikaricp-plugin\src\main\java\org\apache\skywalking\oap\server\storage\plugin\jdbc\h2\dao\H2TableInstaller.java,103,45,1,15,0,61
 skywalking-master\skywalking-master\oap-server\server-receiver-plugin\envoy-metrics-receiver-plugin\src\main\java\org\apache\skywalking\oap\server\receiver\envoy\als\mx\MetaExchangeALSHTTPAnalyzer.java,103,29,4,18,0,51
 zookeeper-master\zookeeper-master\zookeeper-server\src\main\java\org\apache\zookeeper\cli\LsCommand.java,103,0,5,4,0,9
 zookeeper-master\zookeeper-master\zookeeper-server\src\test\java\org\apache\zookeeper\server\util\MessageTrackerTest.java,103,0,3,6,0,9
 zookeeper-master\zookeeper-master\zookeeper-server\src\test\java\org\apache\zookeeper\server\persistence\SnapStreamTest.java,103,0,7,7,0,14
 zookeeper-master\zookeeper-master\zookeeper-server\src\test\java\org\apache\zookeeper\test\ChrootTest.java,103,0,17,7,0,24
 zookeeper-master\zookeeper-master\zookeeper-server\src\test\java\org\apache\zookeeper\test\BufferSizeTest.java,103,0,7,13,2,22
 dubbo-3.0\dubbo-3.0\dubbo-plugin\dubbo-qos\src\test\java\org\apache\dubbo\qos\command\impl\SelectTelnetTest.java,104,36,0,21,0,57
 dubbo-3.0\dubbo-3.0\dubbo-cluster\src\test\java\org\apache\dubbo\rpc\cluster\router\script\ScriptStateRouterTest.java,104,45,3,17,0,65
 dubbo-3.0\dubbo-3.0\dubbo-rpc\dubbo-rpc-api\src\test\java\org\apache\dubbo\rpc\AppResponseTest.java,104,17,0,7,0,24
 dubbo-3.0\dubbo-3.0\dubbo-cluster\src\test\java\org\apache\dubbo\rpc\cluster\router\mesh\rule\virtualservice\DubboMatchRequestTest.java,104,13,0,15,0,28
 dubbo-3.0\dubbo-3.0\dubbo-common\src\main\java\org\apache\dubbo\common\logger\log4j\Log4jLoggerAdapter.java,104,14,3,1,0,18
 dubbo-3.0\dubbo-3.0\dubbo-config\dubbo-config-api\src\test\java\org\apache\dubbo\config\AbstractMethodConfigTest.java,104,21,0,1,0,22
 hadoop-trunk\hadoop-trunk\hadoop-hdfs-project\hadoop-hdfs\src\test\java\org\apache\hadoop\hdfs\server\namenode\TestRedudantBlocks.java,104,21,2,1,3,27
 hadoop-trunk\hadoop-trunk\hadoop-yarn-project\hadoop-yarn\hadoop-yarn-server\hadoop-yarn-server-resourcemanager\src\main\java\org\apache\hadoop\yarn\server\resourcemanager\scheduler\constraint\processor\PlacementDispatcher.java,104,16,7,7,1,31
 hadoop-trunk\hadoop-trunk\hadoop-yarn-project\hadoop-yarn\hadoop-yarn-applications\hadoop-yarn-services\hadoop-yarn-services-core\src\test\java\org\apache\hadoop\yarn\service\provider\TestAbstractProviderService.java,104,14,0,1,6,21
 hadoop-trunk\hadoop-trunk\hadoop-yarn-project\hadoop-yarn\hadoop-yarn-common\src\main\java\org\apache\hadoop\yarn\api\records\impl\pb\ResourceUtilizationPBImpl.java,104,26,36,2,0,64
 hadoop-trunk\hadoop-trunk\hadoop-yarn-project\hadoop-yarn\hadoop-yarn-server\hadoop-yarn-server-nodemanager\src\main\java\org\apache\hadoop\yarn\server\nodemanager\containermanager\records\AuxServiceFile.java,104,32,2,1,0,35
 hadoop-trunk\hadoop-trunk\hadoop-yarn-project\hadoop-yarn\hadoop-yarn-common\src\main\java\org\apache\hadoop\yarn\nodelabels\NodeAttributesManager.java,104,6,0,2,0,8
 hadoop-trunk\hadoop-trunk\hadoop-hdfs-project\hadoop-hdfs\src\main\java\org\apache\hadoop\hdfs\server\blockmanagement\BlockInfoContiguous.java,104,32,0,1,0,33
 hadoop-trunk\hadoop-trunk\hadoop-yarn-project\hadoop-yarn\hadoop-yarn-server\hadoop-yarn-server-common\src\main\java\org\apache\hadoop\yarn\server\api\protocolrecords\impl\pb\GetTimelineCollectorContextRequestPBImpl.java,104,20,34,4,0,58
 hadoop-trunk\hadoop-trunk\hadoop-tools\hadoop-azure\src\test\java\org\apache\hadoop\fs\azurebfs\ITestAbfsReadWriteAndSeek.java,104,21,4,11,4,40
 hadoop-trunk\hadoop-trunk\hadoop-mapreduce-project\hadoop-mapreduce-client\hadoop-mapreduce-client-jobclient\src\test\java\org\apache\hadoop\mapred\TestClusterMapReduceTestCase.java,104,13,9,2,5,29
 hadoop-trunk\hadoop-trunk\hadoop-yarn-project\hadoop-yarn\hadoop-yarn-server\hadoop-yarn-server-resourcemanager\src\test\java\org\apache\hadoop\yarn\server\resourcemanager\scheduler\capacity\TestQueuePath.java,104,20,0,8,0,28
 hadoop-trunk\hadoop-trunk\hadoop-mapreduce-project\hadoop-mapreduce-client\hadoop-mapreduce-client-core\src\test\java\org\apache\hadoop\mapreduce\filecache\TestDistributedCache.java,104,1,29,1,4,35
 hadoop-trunk\hadoop-trunk\hadoop-common-project\hadoop-common\src\test\java\org\apache\hadoop\net\ServerSocketUtil.java,104,17,5,1,0,23
 hadoop-trunk\hadoop-trunk\hadoop-yarn-project\hadoop-yarn\hadoop-yarn-server\hadoop-yarn-server-resourcemanager\src\test\java\org\apache\hadoop\yarn\server\resourcemanager\webapp\fairscheduler\FairSchedulerJsonVerifications.java,104,14,0,1,0,15
 hadoop-trunk\hadoop-trunk\hadoop-mapreduce-project\hadoop-mapreduce-client\hadoop-mapreduce-client-jobclient\src\test\java\org\apache\hadoop\mapred\jobcontrol\TestLocalJobControl.java,104,20,22,1,4,47
 hadoop-trunk\hadoop-trunk\hadoop-tools\hadoop-aws\src\test\java\org\apache\hadoop\fs\s3a\commit\staging\integration\ITestPartitionedCommitProtocol.java,104,21,0,1,0,22
 kafka-trunk\kafka-trunk\clients\src\main\java\org\apache\kafka\common\security\token\delegation\TokenInformation.java,104,0,0,3,2,5
 kafka-trunk\kafka-trunk\connect\runtime\src\main\java\org\apache\kafka\connect\tools\VerifiableSourceTask.java,104,0,3,13,0,16
 kafka-trunk\kafka-trunk\clients\src\test\java\org\apache\kafka\common\requests\DeleteTopicsRequestTest.java,104,0,0,26,0,26
 kafka-trunk\kafka-trunk\streams\src\test\java\org\apache\kafka\streams\kstream\internals\KStreamFlatTransformTest.java,104,0,0,10,1,11
 kafka-trunk\kafka-trunk\streams\src\test\java\org\apache\kafka\streams\integration\TaskAssignorIntegrationTest.java,104,0,7,35,6,48
 kafka-trunk\kafka-trunk\clients\src\main\java\org\apache\kafka\common\security\oauthbearer\internals\unsecured\OAuthBearerValidationResult.java,104,0,3,9,0,12
 kafka-trunk\kafka-trunk\streams\src\test\java\org\apache\kafka\streams\processor\internals\testutil\LogCaptureAppender.java,104,0,0,6,0,6
 kafka-trunk\kafka-trunk\clients\src\main\java\org\apache\kafka\clients\producer\internals\ProduceRequestResult.java,104,0,4,10,0,14
 pulsar-master\pulsar-master\pulsar-io\rabbitmq\src\test\java\org\apache\pulsar\io\rabbitmq\sink\RabbitMQSinkConfigTest.java,104,7,0,1,0,8
 pulsar-master\pulsar-master\pulsar-functions\instance\src\main\java\org\apache\pulsar\functions\instance\SinkRecord.java,104,23,0,7,0,30
 pulsar-master\pulsar-master\bouncy-castle\bcfips-include-test\src\test\java\org\apache\pulsar\client\TlsProducerConsumerTest.java,104,33,3,20,0,56
 pulsar-master\pulsar-master\pulsar-functions\runtime-all\src\main\java\org\apache\pulsar\functions\instance\JavaInstanceMain.java,104,35,6,22,0,63
 pulsar-master\pulsar-master\pulsar-broker\src\test\java\org\apache\pulsar\client\impl\ConnectionPoolTest.java,104,30,5,19,0,54
 pulsar-master\pulsar-master\pulsar-proxy\src\test\java\org\apache\pulsar\proxy\server\AdminProxyHandlerTest.java,104,29,3,17,0,49
 rocketmq-develop\rocketmq-develop\client\src\test\java\org\apache\rocketmq\client\trace\DefaultMQProducerWithOpenTracingTest.java,104,40,3,21,2,66
 rocketmq-develop\rocketmq-develop\tools\src\main\java\org\apache\rocketmq\tools\command\consumer\ConsumerSubCommand.java,104,29,1,20,2,52
 rocketmq-develop\rocketmq-develop\remoting\src\main\java\org\apache\rocketmq\remoting\netty\TlsSystemConfig.java,104,76,0,32,15,123
 rocketmq-develop\rocketmq-develop\tools\src\main\java\org\apache\rocketmq\tools\command\message\CheckMsgSendRTCommand.java,104,25,0,7,3,35
 skywalking-master\skywalking-master\oap-server\server-cluster-plugin\cluster-nacos-plugin\src\test\java\org\apache\skywalking\oap\server\cluster\plugin\nacos\NacosCoordinatorTest.java,104,30,3,10,0,43
 skywalking-master\skywalking-master\oap-server\analyzer\agent-analyzer\src\main\java\org\apache\skywalking\oap\server\analyzer\provider\AnalyzerModuleProvider.java,104,32,1,35,0,68
 skywalking-master\skywalking-master\oap-server\server-core\src\main\java\org\apache\skywalking\oap\server\core\analysis\meter\MeterEntity.java,104,54,1,13,0,68
 skywalking-master\skywalking-master\oap-server\analyzer\log-analyzer\src\main\java\org\apache\skywalking\oap\log\analyzer\provider\log\listener\RecordAnalysisListener.java,104,24,2,12,0,38
 zookeeper-master\zookeeper-master\zookeeper-server\src\test\java\org\apache\zookeeper\test\QuorumRestartTest.java,104,0,3,18,0,21
 dubbo-3.0\dubbo-3.0\dubbo-remoting\dubbo-remoting-api\src\main\java\org\apache\dubbo\remoting\api\PortUnificationServerHandler.java,105,44,2,9,3,58
 dubbo-3.0\dubbo-3.0\dubbo-common\src\main\java\org\apache\dubbo\common\utils\CIDRUtils.java,105,23,3,2,0,28
 dubbo-3.0\dubbo-3.0\dubbo-cluster\src\main\java\org\apache\dubbo\rpc\cluster\router\condition\config\ListenableStateRouter.java,105,44,6,18,0,68
 hadoop-trunk\hadoop-trunk\hadoop-yarn-project\hadoop-yarn\hadoop-yarn-server\hadoop-yarn-server-timelineservice-hbase-tests\src\test\java\org\apache\hadoop\yarn\server\timelineservice\storage\TestHBaseTimelineStorageSchema.java,105,6,2,3,0,11
 hadoop-trunk\hadoop-trunk\hadoop-mapreduce-project\hadoop-mapreduce-client\hadoop-mapreduce-client-jobclient\src\test\java\org\apache\hadoop\mapred\TestResourceMgrDelegate.java,105,7,0,3,0,10
 hadoop-trunk\hadoop-trunk\hadoop-common-project\hadoop-common\src\main\java\org\apache\hadoop\security\token\delegation\web\MultiSchemeDelegationTokenAuthenticationHandler.java,105,11,0,4,0,15
 hadoop-trunk\hadoop-trunk\hadoop-tools\hadoop-gridmix\src\test\java\org\apache\hadoop\mapred\gridmix\TestSleepJob.java,105,19,7,2,3,31
 hadoop-trunk\hadoop-trunk\hadoop-hdfs-project\hadoop-hdfs-client\src\main\java\org\apache\hadoop\hdfs\net\NioInetPeer.java,105,22,0,1,4,27
 hadoop-trunk\hadoop-trunk\hadoop-mapreduce-project\hadoop-mapreduce-examples\src\main\java\org\apache\hadoop\examples\pi\math\ArithmeticProgression.java,105,65,11,3,0,79
 hadoop-trunk\hadoop-trunk\hadoop-hdfs-project\hadoop-hdfs\src\test\java\org\apache\hadoop\hdfs\server\namenode\snapshot\TestListSnapshot.java,105,16,2,1,4,23
 hadoop-trunk\hadoop-trunk\hadoop-common-project\hadoop-common\src\test\java\org\apache\hadoop\fs\TestGetSpaceUsed.java,105,22,4,1,2,29
 hadoop-trunk\hadoop-trunk\hadoop-common-project\hadoop-common\src\main\java\org\apache\hadoop\fs\impl\AbstractMultipartUploader.java,105,12,1,2,0,15
 hadoop-trunk\hadoop-trunk\hadoop-yarn-project\hadoop-yarn\hadoop-yarn-applications\hadoop-yarn-services\hadoop-yarn-services-core\src\main\java\org\apache\hadoop\yarn\service\monitor\ServiceMonitor.java,105,16,3,11,2,32
 hadoop-trunk\hadoop-trunk\hadoop-tools\hadoop-rumen\src\main\java\org\apache\hadoop\tools\rumen\TopologyBuilder.java,105,19,0,4,0,23
 hadoop-trunk\hadoop-trunk\hadoop-tools\hadoop-azure\src\test\java\org\apache\hadoop\fs\azurebfs\extensions\MockDelegationSASTokenProvider.java,105,53,2,28,2,85
 hadoop-trunk\hadoop-trunk\hadoop-tools\hadoop-aws\src\test\java\org\apache\hadoop\fs\s3a\ITestS3AEncryptionWithDefaultS3Settings.java,105,10,2,4,0,16
 hadoop-trunk\hadoop-trunk\hadoop-yarn-project\hadoop-yarn\hadoop-yarn-common\src\main\java\org\apache\hadoop\yarn\logaggregation\LogAggregationMetaCollector.java,105,14,1,2,1,18
 hadoop-trunk\hadoop-trunk\hadoop-yarn-project\hadoop-yarn\hadoop-yarn-server\hadoop-yarn-server-timelineservice\src\main\java\org\apache\hadoop\yarn\server\timelineservice\reader\TimelineReaderContext.java,105,69,0,1,0,70
 hadoop-trunk\hadoop-trunk\hadoop-yarn-project\hadoop-yarn\hadoop-yarn-server\hadoop-yarn-server-resourcemanager\src\test\java\org\apache\hadoop\yarn\server\resourcemanager\scheduler\capacity\conf\PersistentConfigurationStoreBaseTest.java,105,5,0,1,0,6
 hadoop-trunk\hadoop-trunk\hadoop-hdfs-project\hadoop-hdfs\src\test\java\org\apache\hadoop\hdfs\qjournal\client\TestEpochsAreUnique.java,105,30,9,3,0,42
 hadoop-trunk\hadoop-trunk\hadoop-yarn-project\hadoop-yarn\hadoop-yarn-server\hadoop-yarn-server-resourcemanager\src\main\java\org\apache\hadoop\yarn\server\resourcemanager\webapp\dao\CapacitySchedulerHealthInfo.java,105,47,3,2,2,54
 hadoop-trunk\hadoop-trunk\hadoop-hdfs-project\hadoop-hdfs\src\test\java\org\apache\hadoop\hdfs\server\blockmanagement\TestBlockPlacementStatusWithUpgradeDomain.java,105,25,0,1,0,26
 hadoop-trunk\hadoop-trunk\hadoop-mapreduce-project\hadoop-mapreduce-client\hadoop-mapreduce-client-core\src\test\java\org\apache\hadoop\mapreduce\TestJobSubmissionFiles.java,105,26,1,1,1,29
 hadoop-trunk\hadoop-trunk\hadoop-mapreduce-project\hadoop-mapreduce-client\hadoop-mapreduce-client-common\src\main\java\org\apache\hadoop\mapreduce\v2\api\protocolrecords\impl\pb\GetTaskReportsRequestPBImpl.java,105,39,43,5,0,87
 kafka-trunk\kafka-trunk\clients\src\main\java\org\apache\kafka\server\authorizer\Action.java,105,0,0,19,0,19
 kafka-trunk\kafka-trunk\connect\runtime\src\test\java\org\apache\kafka\connect\runtime\SourceConnectorConfigTest.java,105,0,0,39,0,39
 kafka-trunk\kafka-trunk\streams\src\test\java\org\apache\kafka\streams\kstream\internals\KStreamRepartitionTest.java,105,0,2,25,1,28
 kafka-trunk\kafka-trunk\clients\src\generated\java\org\apache\kafka\common\message\OffsetDeleteRequestDataJsonConverter.java,105,0,0,27,0,27
 kafka-trunk\kafka-trunk\streams\src\main\java\org\apache\kafka\streams\StoreQueryParameters.java,105,0,0,17,0,17
 pulsar-master\pulsar-master\pulsar-io\twitter\src\main\java\org\apache\pulsar\io\twitter\data\TweetData.java,105,74,0,1,0,75
 pulsar-master\pulsar-master\pulsar-client-api\src\main\java\org\apache\pulsar\client\api\BatchReceivePolicy.java,105,49,1,15,0,65
 pulsar-master\pulsar-master\pulsar-io\influxdb\src\test\java\org\apache\pulsar\io\influxdb\v1\InfluxDBGenericRecordSinkTest.java,105,27,5,4,0,36
 pulsar-master\pulsar-master\pulsar-broker\src\main\java\org\apache\pulsar\compaction\CompactionRecord.java,105,56,0,4,0,60
 pulsar-master\pulsar-master\pulsar-io\kafka\src\main\java\org\apache\pulsar\io\kafka\KafkaSinkConfig.java,105,41,0,20,0,61
 pulsar-master\pulsar-master\pulsar-client-api\src\main\java\org\apache\pulsar\client\api\transaction\TransactionCoordinatorClientException.java,105,38,2,12,0,52
 pulsar-master\pulsar-master\pulsar-broker-common\src\main\java\org\apache\pulsar\broker\resources\MetadataStoreCacheLoader.java,105,37,1,18,0,56
 pulsar-master\pulsar-master\pulsar-broker-common\src\test\java\org\apache\pulsar\broker\validator\BindAddressValidatorTest.java,105,37,1,22,0,60
 rocketmq-develop\rocketmq-develop\filter\src\test\java\org\apache\rocketmq\filter\ParserTest.java,105,33,9,7,6,55
 skywalking-master\skywalking-master\oap-server\server-storage-plugin\storage-jdbc-hikaricp-plugin\src\main\java\org\apache\skywalking\oap\server\storage\plugin\jdbc\mysql\MySQLTableInstaller.java,105,24,3,13,0,40
 zookeeper-master\zookeeper-master\zookeeper-server\src\test\java\org\apache\zookeeper\server\embedded\ZookeeperServerClusterMutualAuthTest.java,105,0,1,16,0,17
 zookeeper-master\zookeeper-master\zookeeper-contrib\zookeeper-contrib-zooinspector\src\main\java\org\apache\zookeeper\inspector\gui\nodeviewer\ZooInspectorNodeViewer.java,105,0,5,1,1,7
 zookeeper-master\zookeeper-master\zookeeper-server\src\main\java\org\apache\zookeeper\cli\CreateCommand.java,105,0,9,7,0,16
 dubbo-3.0\dubbo-3.0\dubbo-configcenter\dubbo-configcenter-zookeeper\src\main\java\org\apache\dubbo\configcenter\support\zookeeper\ZookeeperDynamicConfiguration.java,106,46,0,14,0,60
 dubbo-3.0\dubbo-3.0\dubbo-cluster\src\main\java\org\apache\dubbo\rpc\cluster\router\mesh\route\MeshAppRuleListener.java,106,34,4,11,0,49
 dubbo-3.0\dubbo-3.0\dubbo-common\src\main\java\org\apache\dubbo\common\utils\LogUtil.java,106,25,9,3,0,37
 hadoop-trunk\hadoop-trunk\hadoop-yarn-project\hadoop-yarn\hadoop-yarn-server\hadoop-yarn-server-timelineservice\src\main\java\org\apache\hadoop\yarn\server\timelineservice\reader\filter\TimelineFilterList.java,106,26,0,1,1,28
 hadoop-trunk\hadoop-trunk\hadoop-tools\hadoop-azure\src\test\java\org\apache\hadoop\fs\azurebfs\ITestFileSystemProperties.java,106,18,1,3,0,22
 hadoop-trunk\hadoop-trunk\hadoop-hdfs-project\hadoop-hdfs\src\test\java\org\apache\hadoop\hdfs\TestBalancerBandwidth.java,106,31,3,3,1,38
 hadoop-trunk\hadoop-trunk\hadoop-hdfs-project\hadoop-hdfs\src\main\java\org\apache\hadoop\hdfs\server\protocol\BlocksWithLocations.java,106,64,0,1,12,77
 hadoop-trunk\hadoop-trunk\hadoop-tools\hadoop-aws\src\main\java\org\apache\hadoop\fs\s3a\auth\delegation\SessionTokenIdentifier.java,106,3,0,2,2,7
 hadoop-trunk\hadoop-trunk\hadoop-common-project\hadoop-common\src\test\java\org\apache\hadoop\http\TestHttpServerLifecycle.java,106,17,4,3,0,24
 hadoop-trunk\hadoop-trunk\hadoop-yarn-project\hadoop-yarn\hadoop-yarn-server\hadoop-yarn-server-common\src\main\java\org\apache\hadoop\yarn\server\api\records\impl\pb\NodeHealthStatusPBImpl.java,106,24,43,3,0,70
 hadoop-trunk\hadoop-trunk\hadoop-yarn-project\hadoop-yarn\hadoop-yarn-server\hadoop-yarn-server-resourcemanager\src\main\java\org\apache\hadoop\yarn\server\resourcemanager\reservation\planning\StageExecutionIntervalByDemand.java,106,16,4,4,0,24
 hadoop-trunk\hadoop-trunk\hadoop-hdfs-project\hadoop-hdfs-rbf\src\main\java\org\apache\hadoop\hdfs\server\federation\router\ConnectionPoolId.java,106,13,1,1,1,16
 hadoop-trunk\hadoop-trunk\hadoop-hdfs-project\hadoop-hdfs\src\main\java\org\apache\hadoop\hdfs\util\DataTransferThrottler.java,106,54,0,2,0,56
 hadoop-trunk\hadoop-trunk\hadoop-common-project\hadoop-common\src\test\java\org\apache\hadoop\crypto\TestCryptoStreamsNormal.java,106,83,13,1,0,97
 hadoop-trunk\hadoop-trunk\hadoop-common-project\hadoop-kms\src\test\java\org\apache\hadoop\crypto\key\kms\server\TestKMSWithZK.java,106,10,1,2,0,13
 hadoop-trunk\hadoop-trunk\hadoop-tools\hadoop-rumen\src\main\java\org\apache\hadoop\tools\rumen\ZombieJobProducer.java,106,43,1,1,0,45
 hadoop-trunk\hadoop-trunk\hadoop-common-project\hadoop-common\src\test\java\org\apache\hadoop\metrics2\sink\TestFileSink.java,106,82,3,7,2,94
 hadoop-trunk\hadoop-trunk\hadoop-yarn-project\hadoop-yarn\hadoop-yarn-server\hadoop-yarn-server-resourcemanager\src\main\java\org\apache\hadoop\yarn\server\resourcemanager\webapp\RMWebApp.java,106,20,7,1,1,29
 kafka-trunk\kafka-trunk\clients\src\test\java\org\apache\kafka\common\security\ssl\SslPrincipalMapperTest.java,106,0,1,18,0,19
 kafka-trunk\kafka-trunk\clients\src\generated\java\org\apache\kafka\common\message\DescribeAclsRequestDataJsonConverter.java,106,0,0,21,0,21
 kafka-trunk\kafka-trunk\clients\src\main\java\org\apache\kafka\common\requests\LeaveGroupResponse.java,106,0,0,9,2,11
 kafka-trunk\kafka-trunk\clients\src\generated\java\org\apache\kafka\common\message\ElectLeadersRequestDataJsonConverter.java,106,0,0,22,0,22
 kafka-trunk\kafka-trunk\connect\runtime\src\main\java\org\apache\kafka\connect\runtime\rest\ConnectRestConfigurable.java,106,0,0,6,0,6
 kafka-trunk\kafka-trunk\streams\src\test\java\org\apache\kafka\streams\kstream\internals\KStreamTransformValuesTest.java,106,0,7,24,3,34
 kafka-trunk\kafka-trunk\streams\src\main\java\org\apache\kafka\streams\KeyQueryMetadata.java,106,0,0,9,3,12
 LittleBooks-master\LittleBooks-master\app\src\main\java\com\example\littlebooks\ui\dashboard\DashboardFragment.java,106,97,48,5,0,150
 pulsar-master\pulsar-master\tiered-storage\jcloud\src\main\java\org\apache\bookkeeper\mledger\offload\jcloud\impl\BufferedOffloadStream.java,106,46,2,10,0,58
 pulsar-master\pulsar-master\pulsar-broker\src\test\java\org\apache\pulsar\broker\service\schema\validator\SchemaDataValidatorTest.java,106,44,0,7,0,51
 pulsar-master\pulsar-master\pulsar-functions\worker\src\main\java\org\apache\pulsar\functions\worker\scheduler\RoundRobinScheduler.java,106,25,0,16,0,41
 pulsar-master\pulsar-master\pulsar-functions\worker\src\main\java\org\apache\pulsar\functions\worker\dlog\DLInputStream.java,106,17,0,3,0,20
 pulsar-master\pulsar-master\pulsar-client-admin\src\main\java\org\apache\pulsar\client\admin\internal\BookiesImpl.java,106,46,0,16,0,62
 pulsar-master\pulsar-master\pulsar-io\elastic-search\src\test\java\org\apache\pulsar\io\elasticsearch\JsonConverterTests.java,106,70,3,31,0,104
 pulsar-master\pulsar-master\pulsar-common\src\main\java\org\apache\pulsar\common\stats\JvmDefaultGCMetricsLogger.java,106,31,12,10,0,53
 rocketmq-develop\rocketmq-develop\filter\src\main\java\org\apache\rocketmq\filter\expression\ConstantExpression.java,106,26,2,4,2,34
 rocketmq-develop\rocketmq-develop\store\src\test\java\org\apache\rocketmq\store\dledger\MessageStoreTestBase.java,106,52,0,17,3,72
 skywalking-master\skywalking-master\oap-server\server-library\library-server\src\main\java\org\apache\skywalking\oap\server\library\server\grpc\GRPCServer.java,106,75,4,14,0,93
 skywalking-master\skywalking-master\oap-server\server-cluster-plugin\cluster-zookeeper-plugin\src\main\java\org\apache\skywalking\oap\server\cluster\plugin\zookeeper\ClusterModuleZookeeperProvider.java,106,26,6,15,0,47
 zookeeper-master\zookeeper-master\zookeeper-contrib\zookeeper-contrib-rest\src\test\java\org\apache\zookeeper\server\jersey\SetTest.java,106,0,6,2,3,11
 zookeeper-master\zookeeper-master\zookeeper-server\src\test\java\org\apache\zookeeper\test\LocalSessionRequestTest.java,106,0,4,7,2,13
 zookeeper-master\zookeeper-master\zookeeper-contrib\zookeeper-contrib-loggraph\src\main\java\org\apache\zookeeper\graph\FilterParser.java,106,0,5,3,0,8
 zookeeper-master\zookeeper-master\zookeeper-contrib\zookeeper-contrib-zooinspector\src\main\java\org\apache\zookeeper\inspector\manager\ZooInspectorManager.java,106,0,11,2,0,13
 dubbo-3.0\dubbo-3.0\dubbo-config\dubbo-config-spring\src\test\java\org\apache\dubbo\config\spring\context\annotation\consumer\ConsumerConfiguration.java,107,46,1,4,0,51
 dubbo-3.0\dubbo-3.0\dubbo-remoting\dubbo-remoting-api\src\test\java\org\apache\dubbo\remoting\PerformanceClientFixedTest.java,107,19,5,11,1,36
 dubbo-3.0\dubbo-3.0\dubbo-common\src\test\java\org\apache\dubbo\common\threadpool\support\eager\EagerThreadPoolExecutorTest.java,107,44,1,26,0,71
 dubbo-3.0\dubbo-3.0\dubbo-config\dubbo-config-spring\src\test\java\org\apache\dubbo\config\spring\SimpleRegistryService.java,107,38,7,10,0,55
 hadoop-trunk\hadoop-trunk\hadoop-yarn-project\hadoop-yarn\hadoop-yarn-server\hadoop-yarn-server-tests\src\test\java\org\apache\hadoop\yarn\server\NMTokenIdentifierNewForTest.java,107,62,40,4,0,106
 hadoop-trunk\hadoop-trunk\hadoop-tools\hadoop-azure\src\test\java\org\apache\hadoop\fs\azurebfs\ITestAzureBlobFileSystemMkDir.java,107,9,1,3,0,13
 hadoop-trunk\hadoop-trunk\hadoop-hdfs-project\hadoop-hdfs\src\test\java\org\apache\hadoop\hdfs\server\namenode\TestQuotaCounts.java,107,26,0,1,0,27
 hadoop-trunk\hadoop-trunk\hadoop-tools\hadoop-azure\src\test\java\org\apache\hadoop\fs\azurebfs\diagnostics\TestConfigurationValidators.java,107,50,0,46,1,97
 hadoop-trunk\hadoop-trunk\hadoop-common-project\hadoop-common\src\test\java\org\apache\hadoop\util\TestApplicationClassLoader.java,107,18,3,2,3,26
 hadoop-trunk\hadoop-trunk\hadoop-hdfs-project\hadoop-hdfs\src\test\java\org\apache\hadoop\hdfs\server\datanode\extdataset\ExternalVolumeImpl.java,107,31,7,1,2,41
 hadoop-trunk\hadoop-trunk\hadoop-common-project\hadoop-common\src\main\java\org\apache\hadoop\fs\PathIOException.java,107,37,0,1,0,38
 hadoop-trunk\hadoop-trunk\hadoop-yarn-project\hadoop-yarn\hadoop-yarn-common\src\main\java\org\apache\hadoop\yarn\api\protocolrecords\impl\pb\GetApplicationAttemptReportResponsePBImpl.java,107,24,35,6,0,65
 hadoop-trunk\hadoop-trunk\hadoop-yarn-project\hadoop-yarn\hadoop-yarn-common\src\main\java\org\apache\hadoop\yarn\api\protocolrecords\impl\pb\GetApplicationAttemptReportRequestPBImpl.java,107,24,34,5,0,63
 hadoop-trunk\hadoop-trunk\hadoop-common-project\hadoop-common\src\main\java\org\apache\hadoop\io\BoundedByteArrayOutputStream.java,107,41,6,1,1,49
 hadoop-trunk\hadoop-trunk\hadoop-hdfs-project\hadoop-hdfs-rbf\src\main\java\org\apache\hadoop\hdfs\server\federation\router\RouterMetricsService.java,107,6,0,1,2,9
 hadoop-trunk\hadoop-trunk\hadoop-mapreduce-project\hadoop-mapreduce-client\hadoop-mapreduce-client-jobclient\src\test\java\org\apache\hadoop\mapred\WordCount.java,107,58,19,1,0,78
 hadoop-trunk\hadoop-trunk\hadoop-yarn-project\hadoop-yarn\hadoop-yarn-common\src\main\java\org\apache\hadoop\yarn\webapp\log\AggregatedLogsBlock.java,107,13,0,3,1,17
 hadoop-trunk\hadoop-trunk\hadoop-yarn-project\hadoop-yarn\hadoop-yarn-server\hadoop-yarn-server-common\src\main\java\org\apache\hadoop\yarn\server\security\BaseNMTokenSecretManager.java,107,36,4,1,6,47
 hadoop-trunk\hadoop-trunk\hadoop-hdfs-project\hadoop-hdfs-client\src\main\java\org\apache\hadoop\fs\XAttr.java,107,43,0,1,2,46
 hadoop-trunk\hadoop-trunk\hadoop-tools\hadoop-gridmix\src\main\java\org\apache\hadoop\mapred\gridmix\RoundRobinUserResolver.java,107,28,3,3,0,34
 hadoop-trunk\hadoop-trunk\hadoop-hdfs-project\hadoop-hdfs-nfs\src\test\java\org\apache\hadoop\hdfs\nfs\nfs3\TestOpenFileCtxCache.java,107,21,10,1,2,34
 hadoop-trunk\hadoop-trunk\hadoop-hdfs-project\hadoop-hdfs-httpfs\src\main\java\org\apache\hadoop\lib\lang\XException.java,107,17,2,4,0,23
 hadoop-trunk\hadoop-trunk\hadoop-yarn-project\hadoop-yarn\hadoop-yarn-common\src\main\java\org\apache\hadoop\yarn\server\security\ApplicationACLsManager.java,107,30,4,3,1,38
 hadoop-trunk\hadoop-trunk\hadoop-common-project\hadoop-common\src\main\java\org\apache\hadoop\fs\shell\CommandFactory.java,107,24,4,1,0,29
 hadoop-trunk\hadoop-trunk\hadoop-hdfs-project\hadoop-hdfs\src\test\java\org\apache\hadoop\hdfs\server\namenode\TestRefreshNamenodeReplicationConfig.java,107,31,0,1,3,35
 kafka-trunk\kafka-trunk\trogdor\src\main\java\org\apache\kafka\trogdor\workload\ConfigurableProducerSpec.java,107,0,0,32,4,36
 kafka-trunk\kafka-trunk\streams\src\test\java\org\apache\kafka\streams\kstream\internals\KStreamSplitTest.java,107,0,6,33,6,45
 kafka-trunk\kafka-trunk\connect\runtime\src\main\java\org\apache\kafka\connect\storage\MemoryStatusBackingStore.java,107,0,8,7,0,15
 kafka-trunk\kafka-trunk\clients\src\test\java\org\apache\kafka\common\record\LegacyRecordTest.java,107,0,7,14,2,23
 kafka-trunk\kafka-trunk\clients\src\main\java\org\apache\kafka\common\requests\DeleteAclsRequest.java,107,0,30,17,2,49
 kafka-trunk\kafka-trunk\storage\src\test\java\org\apache\kafka\server\log\remote\metadata\storage\TopicBasedRemoteLogMetadataManagerConfigTest.java,107,0,3,33,0,36
 kafka-trunk\kafka-trunk\clients\src\main\java\org\apache\kafka\common\memory\SimpleMemoryPool.java,107,0,8,19,1,28
 kafka-trunk\kafka-trunk\streams\src\test\java\org\apache\kafka\streams\integration\ErrorHandlingIntegrationTest.java,107,0,1,17,0,18
 kafka-trunk\kafka-trunk\streams\src\main\java\org\apache\kafka\streams\kstream\TimeWindowedDeserializer.java,107,0,2,17,0,19
 LittleBooks-master\LittleBooks-master\app\src\main\java\com\example\littlebooks\Account.java,107,80,13,7,0,100
 pulsar-master\pulsar-master\pulsar-broker\src\main\java\org\apache\pulsar\broker\service\ConsistentHashingStickyKeyConsumerSelector.java,107,20,0,9,0,29
 pulsar-master\pulsar-master\pulsar-package-management\filesystem-storage\src\main\java\org\apache\pulsar\packages\management\storage\filesystem\FileSystemPackagesStorage.java,107,26,0,7,0,33
 pulsar-master\pulsar-master\pulsar-common\src\main\java\org\apache\pulsar\common\util\ObjectMapperFactory.java,107,37,1,37,0,75
 pulsar-master\pulsar-master\pulsar-proxy\src\main\java\org\apache\pulsar\proxy\extensions\ProxyExtensions.java,107,35,4,21,0,60
 pulsar-master\pulsar-master\pulsar-common\src\main\java\org\apache\pulsar\common\policies\data\FunctionStatsImpl.java,107,33,0,17,0,50
 pulsar-master\pulsar-master\pulsar-broker\src\test\java\org\apache\pulsar\broker\service\persistent\ReplicatedSubscriptionConfigTest.java,107,8,1,5,0,14
 pulsar-master\pulsar-master\tests\integration\src\test\java\org\apache\pulsar\tests\integration\messaging\ReaderMessagingTest.java,107,20,0,13,0,33
 pulsar-master\pulsar-master\pulsar-metadata\src\main\java\org\apache\pulsar\metadata\bookkeeper\PulsarLedgerManagerFactory.java,107,37,2,17,0,56
 pulsar-master\pulsar-master\pulsar-config-validation\src\main\java\org\apache\pulsar\config\validation\ConfigValidation.java,107,31,2,11,0,44
 pulsar-master\pulsar-master\pulsar-common\src\main\java\org\apache\pulsar\common\util\KeyManagerProxy.java,107,55,3,19,0,77
 rocketmq-develop\rocketmq-develop\common\src\main\java\org\apache\rocketmq\common\protocol\header\EndTransactionRequestHeader.java,107,59,0,1,0,60
 shardingsphere-master\shardingsphere-master\shardingsphere-features\shardingsphere-sharding\shardingsphere-sharding-core\src\main\java\org\apache\shardingsphere\sharding\route\engine\validator\dml\ShardingDMLStatementValidator.java,107,41,0,42,0,83
 skywalking-master\skywalking-master\oap-server\server-alarm-plugin\src\main\java\org\apache\skywalking\oap\server\core\alarm\provider\dingtalk\DingtalkHookCallback.java,107,44,4,16,0,64
 skywalking-master\skywalking-master\oap-server\server-library\library-datacarrier-queue\src\test\java\org\apache\skywalking\oap\server\library\datacarrier\consumer\ConsumerTest.java,107,41,3,13,5,62
 skywalking-master\skywalking-master\oap-server\server-storage-plugin\storage-iotdb-plugin\src\main\java\org\apache\skywalking\oap\server\storage\plugin\iotdb\management\IoTDBUITemplateManagementDAO.java,107,38,3,28,0,69
 zookeeper-master\zookeeper-master\zookeeper-server\src\main\java\org\apache\zookeeper\server\quorum\LocalPeerBean.java,107,0,0,4,1,5
 zookeeper-master\zookeeper-master\zookeeper-server\src\test\java\org\apache\zookeeper\server\ZooKeeperServerBeanTest.java,107,0,5,3,0,8
 zookeeper-master\zookeeper-master\zookeeper-server\src\test\java\org\apache\zookeeper\test\MaxCnxnsTest.java,107,0,5,10,3,18
 dubbo-3.0\dubbo-3.0\dubbo-rpc\dubbo-rpc-api\src\test\java\org\apache\dubbo\rpc\filter\GenericFilterTest.java,108,43,3,22,0,68
 dubbo-3.0\dubbo-3.0\dubbo-registry\dubbo-registry-api\src\test\java\org\apache\dubbo\registry\support\AbstractRegistryFactoryTest.java,108,27,6,10,0,43
 dubbo-3.0\dubbo-3.0\dubbo-cluster\src\test\java\org\apache\dubbo\rpc\cluster\router\ConfigConditionRouterTest.java,108,56,0,5,0,61
 dubbo-3.0\dubbo-3.0\dubbo-test\dubbo-test-check\src\main\java\org\apache\dubbo\test\check\registrycenter\initializer\ConfigZookeeperInitializer.java,108,33,2,20,42,97
 dubbo-3.0\dubbo-3.0\dubbo-common\src\main\java\org\apache\dubbo\metadata\definition\model\ServiceDefinition.java,108,47,0,3,6,56
 hadoop-trunk\hadoop-trunk\hadoop-hdfs-project\hadoop-hdfs\src\main\java\org\apache\hadoop\hdfs\server\namenode\INodeMap.java,108,37,3,1,1,42
 hadoop-trunk\hadoop-trunk\hadoop-yarn-project\hadoop-yarn\hadoop-yarn-server\hadoop-yarn-server-resourcemanager\src\main\java\org\apache\hadoop\yarn\server\resourcemanager\scheduler\capacity\QueueAppLifetimeAndLimitSettings.java,108,34,3,8,0,45
 hadoop-trunk\hadoop-trunk\hadoop-tools\hadoop-gridmix\src\test\java\org\apache\hadoop\mapred\gridmix\TestFileQueue.java,108,22,4,1,8,35
 hadoop-trunk\hadoop-trunk\hadoop-yarn-project\hadoop-yarn\hadoop-yarn-applications\hadoop-yarn-services\hadoop-yarn-services-core\src\main\java\org\apache\hadoop\yarn\service\api\records\ServiceStatus.java,108,43,2,4,0,49
 hadoop-trunk\hadoop-trunk\hadoop-common-project\hadoop-common\src\test\java\org\apache\hadoop\ipc\TestRPCWaitForProxy.java,108,18,5,3,2,28
 hadoop-trunk\hadoop-trunk\hadoop-tools\hadoop-streaming\src\main\java\org\apache\hadoop\typedbytes\TypedBytesRecordOutput.java,108,74,18,1,1,94
 hadoop-trunk\hadoop-trunk\hadoop-mapreduce-project\hadoop-mapreduce-client\hadoop-mapreduce-client-common\src\main\java\org\apache\hadoop\mapreduce\v2\api\protocolrecords\impl\pb\GetDiagnosticsResponsePBImpl.java,108,43,29,6,0,78
 hadoop-trunk\hadoop-trunk\hadoop-mapreduce-project\hadoop-mapreduce-client\hadoop-mapreduce-client-app\src\test\java\org\apache\hadoop\mapreduce\v2\api\records\TestTaskReport.java,108,9,0,1,0,10
 hadoop-trunk\hadoop-trunk\hadoop-tools\hadoop-aws\src\test\java\org\apache\hadoop\fs\s3a\TestDataBlocks.java,108,10,1,2,1,14
 hadoop-trunk\hadoop-trunk\hadoop-yarn-project\hadoop-yarn\hadoop-yarn-server\hadoop-yarn-server-resourcemanager\src\test\java\org\apache\hadoop\yarn\server\resourcemanager\TestRMStoreCommands.java,108,15,0,2,0,17
 hadoop-trunk\hadoop-trunk\hadoop-mapreduce-project\hadoop-mapreduce-client\hadoop-mapreduce-client-common\src\main\java\org\apache\hadoop\mapreduce\v2\jobhistory\JobIndexInfo.java,108,114,1,2,3,120
 hadoop-trunk\hadoop-trunk\hadoop-mapreduce-project\hadoop-mapreduce-client\hadoop-mapreduce-client-jobclient\src\test\java\org\apache\hadoop\mapreduce\security\token\delegation\TestDelegationToken.java,108,29,13,1,2,45
 hadoop-trunk\hadoop-trunk\hadoop-tools\hadoop-openstack\src\test\java\org\apache\hadoop\fs\swift\TestSwiftFileSystemExtendedContract.java,108,10,1,2,2,15
 hadoop-trunk\hadoop-trunk\hadoop-mapreduce-project\hadoop-mapreduce-client\hadoop-mapreduce-client-core\src\test\java\org\apache\hadoop\mapred\TestJobAclsManager.java,108,9,0,5,4,18
 hadoop-trunk\hadoop-trunk\hadoop-common-project\hadoop-registry\src\test\java\org\apache\hadoop\registry\client\binding\TestMarshalling.java,108,18,6,1,4,29
 hadoop-trunk\hadoop-trunk\hadoop-tools\hadoop-sls\src\main\java\org\apache\hadoop\yarn\sls\conf\SLSConfiguration.java,108,73,1,1,0,75
 hadoop-trunk\hadoop-trunk\hadoop-mapreduce-project\hadoop-mapreduce-client\hadoop-mapreduce-client-core\src\test\java\org\apache\hadoop\mapreduce\lib\output\committer\manifest\TestCleanupStage.java,108,8,0,7,3,18
 hadoop-trunk\hadoop-trunk\hadoop-common-project\hadoop-common\src\test\java\org\apache\hadoop\fs\TestGetFileBlockLocations.java,108,32,11,1,4,48
 hadoop-trunk\hadoop-trunk\hadoop-mapreduce-project\hadoop-mapreduce-client\hadoop-mapreduce-client-nativetask\src\main\java\org\apache\hadoop\mapred\nativetask\buffer\InputBuffer.java,108,33,2,1,3,39
 hadoop-trunk\hadoop-trunk\hadoop-hdfs-project\hadoop-hdfs-rbf\src\test\java\org\apache\hadoop\hdfs\server\federation\store\driver\TestStateStoreZK.java,108,18,1,6,1,26
 hadoop-trunk\hadoop-trunk\hadoop-common-project\hadoop-common\src\main\java\org\apache\hadoop\security\token\delegation\DelegationKey.java,108,43,1,2,2,48
 hadoop-trunk\hadoop-trunk\hadoop-tools\hadoop-streaming\src\main\java\org\apache\hadoop\record\BinaryRecordOutput.java,108,83,8,1,1,93
 kafka-trunk\kafka-trunk\streams\src\test\java\org\apache\kafka\streams\tests\StreamsOptimizedTest.java,108,0,2,29,0,31
 kafka-trunk\kafka-trunk\clients\src\main\java\org\apache\kafka\common\requests\AlterConfigsRequest.java,108,0,0,8,3,11
 kafka-trunk\kafka-trunk\streams\src\test\java\org\apache\kafka\streams\state\StateSerdesTest.java,108,0,0,28,4,32
 kafka-trunk\kafka-trunk\clients\src\main\java\org\apache\kafka\common\record\MultiRecordsSend.java,108,0,5,14,3,22
 kafka-trunk\kafka-trunk\clients\src\test\java\org\apache\kafka\clients\consumer\MockConsumerTest.java,108,0,0,24,0,24
 kafka-trunk\kafka-trunk\clients\src\generated\java\org\apache\kafka\common\message\ListTransactionsResponseDataJsonConverter.java,108,0,0,28,0,28
 kafka-trunk\kafka-trunk\connect\runtime\src\main\java\org\apache\kafka\connect\util\ShutdownableThread.java,108,0,6,21,0,27
 kafka-trunk\kafka-trunk\jmh-benchmarks\src\main\java\org\apache\kafka\jmh\server\CheckpointBench.java,108,0,6,15,0,21
 kafka-trunk\kafka-trunk\connect\basic-auth-extension\src\main\java\org\apache\kafka\connect\rest\basic\auth\extension\PropertyFileLoginModule.java,108,0,3,21,0,24
 kafka-trunk\kafka-trunk\clients\src\main\java\org\apache\kafka\common\protocol\types\ArrayOf.java,108,0,11,6,1,18
 pulsar-master\pulsar-master\pulsar-client\src\test\java\org\apache\pulsar\client\impl\BatchMessageIdImplTest.java,108,14,0,6,0,20
 pulsar-master\pulsar-master\pulsar-client-tools\src\main\java\org\apache\pulsar\admin\cli\CmdBookies.java,108,27,1,17,0,45
 pulsar-master\pulsar-master\pulsar-proxy\src\test\java\org\apache\pulsar\proxy\server\ProxyForwardAuthDataTest.java,108,20,1,16,0,37
 pulsar-master\pulsar-master\pulsar-broker\src\main\java\org\apache\pulsar\broker\service\HashRangeAutoSplitStickyKeyConsumerSelector.java,108,26,0,13,0,39
 rocketmq-develop\rocketmq-develop\common\src\main\java\org\apache\rocketmq\common\utils\HttpTinyClient.java,108,48,2,8,0,58
 rocketmq-develop\rocketmq-develop\common\src\main\java\org\apache\rocketmq\common\consistenthash\ConsistentHashRouter.java,108,39,3,9,2,53
 skywalking-master\skywalking-master\oap-server\server-core\src\main\java\org\apache\skywalking\oap\server\core\analysis\manual\log\AbstractLogRecord.java,108,41,0,12,0,53
 skywalking-master\skywalking-master\oap-server\analyzer\agent-analyzer\src\main\java\org\apache\skywalking\oap\server\analyzer\provider\AnalyzerModuleConfig.java,108,23,2,15,0,40
 skywalking-master\skywalking-master\oap-server\analyzer\agent-analyzer\src\main\java\org\apache\skywalking\oap\server\analyzer\provider\meter\process\MeterProcessor.java,108,15,0,9,0,24
 zookeeper-master\zookeeper-master\zookeeper-server\src\test\java\org\apache\zookeeper\util\PemReaderTest.java,108,0,0,22,0,22
 zookeeper-master\zookeeper-master\zookeeper-server\src\main\java\org\apache\zookeeper\audit\ZKAuditProvider.java,108,0,4,12,1,17
 zookeeper-master\zookeeper-master\zookeeper-server\src\main\java\org\apache\zookeeper\server\AuthenticationHelper.java,108,0,9,16,0,25
 zookeeper-master\zookeeper-master\zookeeper-server\src\main\java\org\apache\zookeeper\server\auth\IPAuthenticationProvider.java,108,0,7,2,3,12
 zookeeper-master\zookeeper-master\zookeeper-server\src\main\java\org\apache\zookeeper\server\quorum\auth\SaslQuorumServerCallbackHandler.java,108,0,3,11,1,15
 zookeeper-master\zookeeper-master\zookeeper-server\src\test\java\org\apache\zookeeper\test\LeaderSessionTrackerTest.java,108,0,21,11,0,32
 dubbo-3.0\dubbo-3.0\dubbo-cluster\src\main\java\org\apache\dubbo\rpc\cluster\filter\DefaultFilterChainBuilder.java,109,25,0,18,0,43
 dubbo-3.0\dubbo-3.0\dubbo-plugin\dubbo-qos\src\test\java\org\apache\dubbo\qos\legacy\service\DemoServiceImpl.java,109,68,5,2,0,75
 dubbo-3.0\dubbo-3.0\dubbo-metadata\dubbo-metadata-processor\src\test\java\org\apache\dubbo\metadata\annotation\processing\builder\SimpleTypeDefinitionBuilderTest.java,109,22,0,5,0,27
 dubbo-3.0\dubbo-3.0\dubbo-common\src\main\java\org\apache\dubbo\common\logger\log4j2\Log4j2Logger.java,109,45,0,1,0,46
 hadoop-trunk\hadoop-trunk\hadoop-hdfs-project\hadoop-hdfs\src\main\java\org\apache\hadoop\hdfs\server\namenode\JournalManager.java,109,25,2,1,0,28
 hadoop-trunk\hadoop-trunk\hadoop-tools\hadoop-openstack\src\test\java\org\apache\hadoop\fs\swift\TestSwiftFileSystemDirectories.java,109,10,1,2,1,14
 hadoop-trunk\hadoop-trunk\hadoop-mapreduce-project\hadoop-mapreduce-client\hadoop-mapreduce-client-core\src\test\java\org\apache\hadoop\mapreduce\lib\output\committer\manifest\CommitterTestBinding.java,109,7,6,5,1,19
 hadoop-trunk\hadoop-trunk\hadoop-yarn-project\hadoop-yarn\hadoop-yarn-server\hadoop-yarn-server-nodemanager\src\main\java\org\apache\hadoop\yarn\server\nodemanager\collectormanager\NMCollectorService.java,109,15,3,8,1,27
 hadoop-trunk\hadoop-trunk\hadoop-tools\hadoop-rumen\src\main\java\org\apache\hadoop\tools\rumen\ParsedHost.java,109,33,4,1,0,38
 hadoop-trunk\hadoop-trunk\hadoop-mapreduce-project\hadoop-mapreduce-client\hadoop-mapreduce-client-jobclient\src\test\java\org\apache\hadoop\mapred\TestMultiFileInputFormat.java,109,71,11,4,1,87
 hadoop-trunk\hadoop-trunk\hadoop-yarn-project\hadoop-yarn\hadoop-yarn-common\src\main\java\org\apache\hadoop\yarn\api\records\impl\pb\NodeAttributeKeyPBImpl.java,109,22,29,1,0,52
 hadoop-trunk\hadoop-trunk\hadoop-common-project\hadoop-auth\src\test\java\org\apache\hadoop\security\authentication\util\TestAuthToken.java,109,10,13,1,0,24
 hadoop-trunk\hadoop-trunk\hadoop-yarn-project\hadoop-yarn\hadoop-yarn-client\src\main\java\org\apache\hadoop\yarn\client\api\impl\AHSv2ClientImpl.java,109,23,0,1,0,24
 hadoop-trunk\hadoop-trunk\hadoop-yarn-project\hadoop-yarn\hadoop-yarn-server\hadoop-yarn-server-common\src\main\java\org\apache\hadoop\yarn\server\federation\store\records\SubClusterHeartbeatRequest.java,109,10,0,1,0,11
 hadoop-trunk\hadoop-trunk\hadoop-common-project\hadoop-common\src\test\java\org\apache\hadoop\http\TestGlobalFilter.java,109,44,11,2,2,59
 hadoop-trunk\hadoop-trunk\hadoop-common-project\hadoop-common\src\main\java\org\apache\hadoop\metrics2\MetricStringBuilder.java,109,48,1,1,2,52
 hadoop-trunk\hadoop-trunk\hadoop-yarn-project\hadoop-yarn\hadoop-yarn-api\src\main\java\org\apache\hadoop\yarn\server\api\AuxiliaryService.java,109,20,2,2,0,24
 hadoop-trunk\hadoop-trunk\hadoop-mapreduce-project\hadoop-mapreduce-client\hadoop-mapreduce-client-jobclient\src\test\java\org\apache\hadoop\mapred\TestReduceTask.java,109,30,2,2,0,34
 hadoop-trunk\hadoop-trunk\hadoop-yarn-project\hadoop-yarn\hadoop-yarn-server\hadoop-yarn-server-resourcemanager\src\test\java\org\apache\hadoop\yarn\server\resourcemanager\webapp\fairscheduler\TestRMWebServicesFairScheduler.java,109,7,0,4,0,11
 hadoop-trunk\hadoop-trunk\hadoop-hdfs-project\hadoop-hdfs-nfs\src\main\java\org\apache\hadoop\hdfs\nfs\nfs3\AsyncDataService.java,109,19,3,1,0,23
 hadoop-trunk\hadoop-trunk\hadoop-mapreduce-project\hadoop-mapreduce-client\hadoop-mapreduce-client-core\src\main\java\org\apache\hadoop\mapreduce\lib\output\committer\manifest\files\ManifestPrinter.java,109,15,0,2,1,18
 hadoop-trunk\hadoop-trunk\hadoop-tools\hadoop-aws\src\main\java\org\apache\hadoop\fs\s3a\auth\SignerManager.java,109,23,6,1,2,32
 kafka-trunk\kafka-trunk\clients\src\generated\java\org\apache\kafka\common\message\TxnOffsetCommitResponseDataJsonConverter.java,109,0,0,32,0,32
 kafka-trunk\kafka-trunk\jmh-benchmarks\src\main\java\org\apache\kafka\jmh\record\BaseRecordBatchBenchmark.java,109,0,9,10,0,19
 kafka-trunk\kafka-trunk\clients\src\main\java\org\apache\kafka\common\requests\AlterClientQuotasRequest.java,109,0,0,17,2,19
 kafka-trunk\kafka-trunk\clients\src\test\java\org\apache\kafka\common\requests\ListOffsetsRequestTest.java,109,0,0,21,0,21
 kafka-trunk\kafka-trunk\clients\src\test\java\org\apache\kafka\common\security\oauthbearer\secured\RetryTest.java,109,0,0,3,0,3
 kafka-trunk\kafka-trunk\clients\src\main\java\org\apache\kafka\clients\producer\internals\KafkaProducerMetrics.java,109,0,0,4,1,5
 kafka-trunk\kafka-trunk\clients\src\generated\java\org\apache\kafka\common\message\AddPartitionsToTxnResponseDataJsonConverter.java,109,0,0,31,0,31
 kafka-trunk\kafka-trunk\connect\api\src\main\java\org\apache\kafka\connect\connector\Connector.java,109,0,0,32,0,32
 kafka-trunk\kafka-trunk\clients\src\generated\java\org\apache\kafka\common\message\AlterReplicaLogDirsResponseDataJsonConverter.java,109,0,0,33,0,33
 kafka-trunk\kafka-trunk\clients\src\main\java\org\apache\kafka\clients\admin\TopicDescription.java,109,0,2,13,4,19
 kafka-trunk\kafka-trunk\clients\src\generated\java\org\apache\kafka\common\message\DeleteRecordsRequestDataJsonConverter.java,109,0,0,28,0,28
 kafka-trunk\kafka-trunk\clients\src\test\java\org\apache\kafka\common\feature\SupportedVersionRangeTest.java,109,0,4,12,0,16
 pulsar-master\pulsar-master\pulsar-io\kafka\src\test\java\org\apache\pulsar\io\kafka\KafkaBytesSourceTest.java,109,46,4,29,0,79
 pulsar-master\pulsar-master\pulsar-broker\src\test\java\org\apache\pulsar\broker\admin\BrokerAdminClientTlsAuthTest.java,109,26,1,12,0,39
 pulsar-master\pulsar-master\pulsar-common\src\main\java\org\apache\pulsar\common\util\SimpleTextOutputStream.java,109,49,0,2,0,51
 pulsar-master\pulsar-master\managed-ledger\src\test\java\org\apache\bookkeeper\test\MockedBookKeeperTestCase.java,109,34,3,6,0,43
 pulsar-master\pulsar-master\pulsar-broker\src\test\java\org\apache\pulsar\broker\TimeAverageBrokerDataTest.java,109,43,1,9,0,53
 pulsar-master\pulsar-master\tests\integration\src\test\java\org\apache\pulsar\tests\integration\cli\PackagesCliTest.java,109,28,1,15,0,44
 pulsar-master\pulsar-master\pulsar-broker\src\test\java\org\apache\pulsar\broker\loadbalance\LeaderElectionServiceTest.java,109,34,1,18,0,53
 rocketmq-develop\rocketmq-develop\test\src\main\java\org\apache\rocketmq\test\util\DuplicateMessageInfo.java,109,28,6,13,8,55
 rocketmq-develop\rocketmq-develop\client\src\main\java\org\apache\rocketmq\client\consumer\rebalance\AllocateMachineRoomNearby.java,109,43,0,26,0,69
 rocketmq-develop\rocketmq-develop\tools\src\test\java\org\apache\rocketmq\tools\command\server\ServerResponseMocker.java,109,33,7,7,1,48
 skywalking-master\skywalking-master\oap-server\server-core\src\main\java\org\apache\skywalking\oap\server\core\analysis\manual\networkalias\NetworkAddressAlias.java,109,33,1,16,0,50
 skywalking-master\skywalking-master\oap-server\server-cluster-plugin\cluster-consul-plugin\src\test\java\org\apache\skywalking\oap\server\cluster\plugin\consul\ClusterModuleConsulProviderTest.java,109,30,5,13,0,48
 skywalking-master\skywalking-master\oap-server\analyzer\meter-analyzer\src\main\java\org\apache\skywalking\oap\meter\analyzer\dsl\Expression.java,109,23,2,12,0,37
 dubbo-3.0\dubbo-3.0\dubbo-registry\dubbo-registry-api\src\main\java\org\apache\dubbo\registry\client\metadata\StandardMetadataServiceURLBuilder.java,110,42,0,24,0,66
 dubbo-3.0\dubbo-3.0\dubbo-rpc\dubbo-rpc-triple\src\test\java\org\apache\dubbo\rpc\protocol\tri\service\TriHealthImplTest.java,110,23,6,13,0,42
 dubbo-3.0\dubbo-3.0\dubbo-common\src\main\java\org\apache\dubbo\common\logger\jcl\JclLogger.java,110,46,1,2,0,49
 dubbo-3.0\dubbo-3.0\dubbo-common\src\main\java\org\apache\dubbo\common\utils\ExecutorUtil.java,110,25,3,6,2,36
 dubbo-3.0\dubbo-3.0\dubbo-common\src\main\java\org\apache\dubbo\common\logger\jdk\JdkLogger.java,110,45,5,1,1,52
 hadoop-trunk\hadoop-trunk\hadoop-yarn-project\hadoop-yarn\hadoop-yarn-server\hadoop-yarn-server-nodemanager\src\test\java\org\apache\hadoop\yarn\server\nodemanager\logaggregation\tracker\TestNMLogAggregationStatusTracker.java,110,14,2,2,0,18
 hadoop-trunk\hadoop-trunk\hadoop-hdfs-project\hadoop-hdfs\src\test\java\org\apache\hadoop\fs\viewfs\TestViewFsWithXAttrs.java,110,27,6,3,5,41
 hadoop-trunk\hadoop-trunk\hadoop-hdfs-project\hadoop-hdfs\src\test\java\org\apache\hadoop\hdfs\server\namenode\TestNameNodeStatusMXBean.java,110,17,1,1,1,20
 hadoop-trunk\hadoop-trunk\hadoop-common-project\hadoop-common\src\test\java\org\apache\hadoop\fs\statistics\TestIOStatisticsSnapshot.java,110,10,5,2,0,17
 hadoop-trunk\hadoop-trunk\hadoop-hdfs-project\hadoop-hdfs-client\src\main\java\org\apache\hadoop\hdfs\net\EncryptedPeer.java,110,24,0,1,2,27
 hadoop-trunk\hadoop-trunk\hadoop-mapreduce-project\hadoop-mapreduce-client\hadoop-mapreduce-client-jobclient\src\test\java\org\apache\hadoop\mapred\TestCommandLineJobSubmission.java,110,48,14,3,7,72
 hadoop-trunk\hadoop-trunk\hadoop-common-project\hadoop-common\src\test\java\org\apache\hadoop\http\TestPathFilter.java,110,46,12,1,2,61
 hadoop-trunk\hadoop-trunk\hadoop-yarn-project\hadoop-yarn\hadoop-yarn-common\src\test\java\org\apache\hadoop\yarn\api\records\impl\pb\TestApplicationClientProtocolRecords.java,110,16,2,11,3,32
 hadoop-trunk\hadoop-trunk\hadoop-yarn-project\hadoop-yarn\hadoop-yarn-server\hadoop-yarn-server-resourcemanager\src\main\java\org\apache\hadoop\yarn\server\resourcemanager\placement\csmappingrule\MappingRule.java,110,25,1,1,0,27
 hadoop-trunk\hadoop-trunk\hadoop-tools\hadoop-fs2img\src\main\java\org\apache\hadoop\hdfs\server\namenode\FileSystemImage.java,110,10,0,1,2,13
 hadoop-trunk\hadoop-trunk\hadoop-yarn-project\hadoop-yarn\hadoop-yarn-common\src\main\java\org\apache\hadoop\yarn\api\records\impl\pb\NodeToAttributeValuePBImpl.java,110,21,29,2,0,52
 hadoop-trunk\hadoop-trunk\hadoop-common-project\hadoop-nfs\src\main\java\org\apache\hadoop\oncrpc\security\CredentialsSys.java,110,47,4,1,1,53
 hadoop-trunk\hadoop-trunk\hadoop-hdfs-project\hadoop-hdfs-httpfs\src\main\java\org\apache\hadoop\fs\http\client\HttpFSUtils.java,110,15,1,1,0,17
 hadoop-trunk\hadoop-trunk\hadoop-common-project\hadoop-common\src\main\java\org\apache\hadoop\fs\ftp\FTPInputStream.java,110,33,0,2,5,40
 hadoop-trunk\hadoop-trunk\hadoop-common-project\hadoop-common\src\test\java\org\apache\hadoop\util\TestZKUtil.java,110,28,1,1,4,34
 hadoop-trunk\hadoop-trunk\hadoop-hdfs-project\hadoop-hdfs\src\test\java\org\apache\hadoop\hdfs\server\datanode\TestTransferRbw.java,110,38,12,8,0,58
 hadoop-trunk\hadoop-trunk\hadoop-common-project\hadoop-common\src\test\java\org\apache\hadoop\test\TestMultithreadedTestUtil.java,110,18,1,1,0,20
 kafka-trunk\kafka-trunk\streams\test-utils\src\test\java\org\apache\kafka\streams\test\wordcount\WindowedWordCountProcessorTest.java,110,0,0,29,0,29
 kafka-trunk\kafka-trunk\streams\src\main\java\org\apache\kafka\streams\state\internals\RocksDbWindowBytesStoreSupplier.java,110,0,0,6,0,6
 kafka-trunk\kafka-trunk\clients\src\test\java\org\apache\kafka\clients\admin\internals\FenceProducersHandlerTest.java,110,0,1,17,0,18
 kafka-trunk\kafka-trunk\storage\api\src\main\java\org\apache\kafka\server\log\remote\storage\LogSegmentData.java,110,0,0,11,1,12
 kafka-trunk\kafka-trunk\clients\src\main\java\org\apache\kafka\common\requests\DescribeLogDirsResponse.java,110,0,0,10,2,12
 kafka-trunk\kafka-trunk\streams\src\test\java\org\apache\kafka\streams\kstream\internals\TimeWindowTest.java,110,0,2,4,2,8
 kafka-trunk\kafka-trunk\clients\src\test\java\org\apache\kafka\common\security\oauthbearer\secured\ConfigurationUtilsTest.java,110,0,1,14,1,16
 pulsar-master\pulsar-master\pulsar-proxy\src\test\java\org\apache\pulsar\proxy\extensions\ProxyExtensionsTest.java,110,34,9,6,0,49
 pulsar-master\pulsar-master\pulsar-broker\src\main\java\org\apache\pulsar\broker\service\schema\validator\SchemaRegistryServiceWithSchemaDataValidator.java,110,54,1,22,0,77
 pulsar-master\pulsar-master\pulsar-broker-common\src\main\java\org\apache\pulsar\broker\ServiceConfigurationUtils.java,110,47,2,18,0,67
 pulsar-master\pulsar-master\pulsar-functions\utils\src\main\java\org\apache\pulsar\functions\utils\Actions.java,110,25,5,5,0,35
 pulsar-master\pulsar-master\pulsar-broker\src\test\java\org\apache\pulsar\broker\service\CurrentLedgerRolloverIfFullTest.java,110,34,2,24,0,60
 pulsar-master\pulsar-master\pulsar-broker\src\test\java\org\apache\pulsar\broker\PulsarServiceTest.java,110,30,0,15,0,45
 pulsar-master\pulsar-master\pulsar-broker\src\test\java\org\apache\pulsar\broker\transaction\buffer\InMemTransactionBufferReaderTest.java,110,33,0,11,0,44
 pulsar-master\pulsar-master\pulsar-broker\src\main\java\org\apache\pulsar\broker\admin\impl\OffloaderObjectsScannerUtils.java,110,33,1,17,0,51
 pulsar-master\pulsar-master\pulsar-client\src\test\java\org\apache\pulsar\client\impl\ClientCnxTest.java,110,15,4,10,0,29
 pulsar-master\pulsar-master\pulsar-broker\src\test\java\org\apache\pulsar\broker\protocol\ProtocolHandlerWithClassLoaderTest.java,110,24,1,20,0,45
 pulsar-master\pulsar-master\pulsar-io\redis\src\main\java\org\apache\pulsar\io\redis\sink\RedisSink.java,110,21,4,9,0,34
 rocketmq-develop\rocketmq-develop\common\src\main\java\org\apache\rocketmq\common\protocol\route\TopicRouteData.java,110,55,14,11,6,86
 skywalking-master\skywalking-master\oap-server\server-storage-plugin\storage-iotdb-plugin\src\main\java\org\apache\skywalking\oap\server\storage\plugin\iotdb\query\IoTDBLogQueryDAO.java,110,38,0,20,0,58
 skywalking-master\skywalking-master\oap-server\server-storage-plugin\storage-jdbc-hikaricp-plugin\src\main\java\org\apache\skywalking\oap\server\storage\plugin\jdbc\h2\dao\H2UITemplateManagementDAO.java,110,23,2,19,0,44
 skywalking-master\skywalking-master\oap-server\server-library\library-datacarrier-queue\src\main\java\org\apache\skywalking\oap\server\library\datacarrier\consumer\ConsumeDriver.java,110,42,3,8,0,53
 skywalking-master\skywalking-master\oap-server\server-core\src\test\java\org\apache\skywalking\oap\server\core\analysis\metrics\ApdexMetricsTest.java,110,44,2,1,0,47
 zookeeper-master\zookeeper-master\zookeeper-server\src\main\java\org\apache\zookeeper\server\util\BitMap.java,110,0,0,2,0,2
 zookeeper-master\zookeeper-master\zookeeper-server\src\test\java\org\apache\zookeeper\test\SaslDigestAuthOverSSLTest.java,110,0,2,17,1,20
 dubbo-3.0\dubbo-3.0\dubbo-registry\dubbo-registry-api\src\main\java\org\apache\dubbo\registry\client\migration\MigrationRuleHandler.java,111,46,6,19,0,71
 dubbo-3.0\dubbo-3.0\dubbo-common\src\main\java\org\apache\dubbo\common\logger\jdk\JdkLoggerAdapter.java,111,22,11,8,1,42
 dubbo-3.0\dubbo-3.0\dubbo-registry\dubbo-registry-nacos\src\main\java\org\apache\dubbo\registry\nacos\util\NacosNamingServiceUtils.java,111,31,2,11,0,44
 dubbo-3.0\dubbo-3.0\dubbo-rpc\dubbo-rpc-dubbo\src\test\java\org\apache\dubbo\rpc\protocol\dubbo\support\DemoServiceImpl.java,111,68,5,2,0,75
 dubbo-3.0\dubbo-3.0\dubbo-compatible\src\main\java\com\alibaba\dubbo\container\page\ResourceFilter.java,111,19,4,3,0,26
 hadoop-trunk\hadoop-trunk\hadoop-yarn-project\hadoop-yarn\hadoop-yarn-server\hadoop-yarn-server-timelineservice-hbase\hadoop-yarn-server-timelineservice-hbase-common\src\test\java\org\apache\hadoop\yarn\server\timelineservice\storage\common\TestRowKeysAsString.java,111,25,0,5,0,30
 hadoop-trunk\hadoop-trunk\hadoop-hdfs-project\hadoop-hdfs\src\test\java\org\apache\hadoop\hdfs\server\namenode\TestGetBlockLocations.java,111,18,1,2,0,21
 hadoop-trunk\hadoop-trunk\hadoop-hdfs-project\hadoop-hdfs\src\test\java\org\apache\hadoop\hdfs\server\namenode\TestFSDirAttrOp.java,111,37,7,1,0,45
 hadoop-trunk\hadoop-trunk\hadoop-mapreduce-project\hadoop-mapreduce-client\hadoop-mapreduce-client-nativetask\src\test\java\org\apache\hadoop\mapred\nativetask\kvtest\KVTest.java,111,22,2,5,0,29
 hadoop-trunk\hadoop-trunk\hadoop-yarn-project\hadoop-yarn\hadoop-yarn-server\hadoop-yarn-server-sharedcachemanager\src\main\java\org\apache\hadoop\yarn\server\sharedcachemanager\metrics\CleanerMetrics.java,111,26,3,2,0,31
 hadoop-trunk\hadoop-trunk\hadoop-yarn-project\hadoop-yarn\hadoop-yarn-server\hadoop-yarn-server-timelineservice\src\main\java\org\apache\hadoop\yarn\server\timelineservice\reader\TimelineDataToRetrieve.java,111,45,0,4,9,58
 hadoop-trunk\hadoop-trunk\hadoop-yarn-project\hadoop-yarn\hadoop-yarn-server\hadoop-yarn-server-resourcemanager\src\main\java\org\apache\hadoop\yarn\server\resourcemanager\RMSecretManagerService.java,111,39,1,8,2,50
 hadoop-trunk\hadoop-trunk\hadoop-tools\hadoop-dynamometer\hadoop-dynamometer-workload\src\main\java\org\apache\hadoop\tools\dynamometer\workloadgenerator\audit\AuditLogDirectParser.java,111,12,0,1,0,13
 hadoop-trunk\hadoop-trunk\hadoop-hdfs-project\hadoop-hdfs\src\test\java\org\apache\hadoop\hdfs\server\namenode\ha\TestDNFencingWithReplication.java,111,36,2,1,0,39
 hadoop-trunk\hadoop-trunk\hadoop-yarn-project\hadoop-yarn\hadoop-yarn-api\src\main\java\org\apache\hadoop\yarn\api\records\UpdateContainerError.java,111,8,0,1,0,9
 hadoop-trunk\hadoop-trunk\hadoop-mapreduce-project\hadoop-mapreduce-client\hadoop-mapreduce-client-jobclient\src\test\java\org\apache\hadoop\mapred\TestCombineOutputCollector.java,111,30,7,3,1,41
 hadoop-trunk\hadoop-trunk\hadoop-mapreduce-project\hadoop-mapreduce-client\hadoop-mapreduce-client-jobclient\src\test\java\org\apache\hadoop\mapred\jobcontrol\JobControlTestUtils.java,111,36,4,3,0,43
 hadoop-trunk\hadoop-trunk\hadoop-hdfs-project\hadoop-hdfs\src\test\java\org\apache\hadoop\hdfs\server\namenode\TestEditsDoubleBuffer.java,111,13,3,1,1,18
 hadoop-trunk\hadoop-trunk\hadoop-hdfs-project\hadoop-hdfs-rbf\src\main\java\org\apache\hadoop\hdfs\server\federation\metrics\StateStoreMetrics.java,111,45,2,1,0,48
 hadoop-trunk\hadoop-trunk\hadoop-tools\hadoop-dynamometer\hadoop-dynamometer-workload\src\test\java\org\apache\hadoop\tools\dynamometer\workloadgenerator\TestWorkloadGenerator.java,111,17,2,6,0,25
 hadoop-trunk\hadoop-trunk\hadoop-yarn-project\hadoop-yarn\hadoop-yarn-common\src\main\java\org\apache\hadoop\yarn\api\records\impl\pb\NMTokenPBImpl.java,111,42,40,1,0,83
 hadoop-trunk\hadoop-trunk\hadoop-mapreduce-project\hadoop-mapreduce-client\hadoop-mapreduce-client-hs\src\test\java\org\apache\hadoop\mapreduce\v2\hs\webapp\VerifyJobsUtils.java,111,42,1,4,1,48
 hadoop-trunk\hadoop-trunk\hadoop-mapreduce-project\hadoop-mapreduce-client\hadoop-mapreduce-client-jobclient\src\test\java\org\apache\hadoop\mapreduce\v2\TestMRAppWithCombiner.java,111,25,8,3,2,38
 hadoop-trunk\hadoop-trunk\hadoop-hdfs-project\hadoop-hdfs\src\main\java\org\apache\hadoop\hdfs\server\diskbalancer\command\CancelCommand.java,111,12,2,1,2,17
 hadoop-trunk\hadoop-trunk\hadoop-hdfs-project\hadoop-hdfs-rbf\src\main\java\org\apache\hadoop\hdfs\server\federation\utils\ConsistentHashRing.java,111,15,0,1,0,16
 hadoop-trunk\hadoop-trunk\hadoop-yarn-project\hadoop-yarn\hadoop-yarn-server\hadoop-yarn-server-resourcemanager\src\main\java\org\apache\hadoop\yarn\server\resourcemanager\scheduler\fair\ConfigurableResource.java,111,17,0,1,3,21
 hadoop-trunk\hadoop-trunk\hadoop-mapreduce-project\hadoop-mapreduce-client\hadoop-mapreduce-client-common\src\test\java\org\apache\hadoop\mapreduce\v2\api\records\TestIds.java,111,36,25,1,0,62
 hadoop-trunk\hadoop-trunk\hadoop-tools\hadoop-sls\src\test\java\org\apache\hadoop\yarn\sls\BaseSLSRunnerTest.java,111,28,6,2,0,36
 hadoop-trunk\hadoop-trunk\hadoop-yarn-project\hadoop-yarn\hadoop-yarn-client\src\main\java\org\apache\hadoop\yarn\client\api\NMTokenCache.java,111,36,0,5,1,42
 hadoop-trunk\hadoop-trunk\hadoop-yarn-project\hadoop-yarn\hadoop-yarn-common\src\main\java\org\apache\hadoop\yarn\api\protocolrecords\impl\pb\StartContainersRequestPBImpl.java,111,24,40,4,0,68
 hadoop-trunk\hadoop-trunk\hadoop-yarn-project\hadoop-yarn\hadoop-yarn-server\hadoop-yarn-server-resourcemanager\src\test\java\org\apache\hadoop\yarn\server\resourcemanager\placement\TestPlacementManager.java,111,16,0,8,1,25
 hadoop-trunk\hadoop-trunk\hadoop-mapreduce-project\hadoop-mapreduce-client\hadoop-mapreduce-client-core\src\main\java\org\apache\hadoop\mapreduce\lib\db\BigDecimalSplitter.java,111,27,4,8,1,40
 hadoop-trunk\hadoop-trunk\hadoop-hdfs-project\hadoop-hdfs\src\test\java\org\apache\hadoop\hdfs\server\blockmanagement\TestBlockTokenWithDFSStriped.java,111,35,7,2,6,50
 hadoop-trunk\hadoop-trunk\hadoop-yarn-project\hadoop-yarn\hadoop-yarn-common\src\test\java\org\apache\hadoop\yarn\client\api\impl\TestTimelineReaderClientImpl.java,111,13,1,3,3,20
 hadoop-trunk\hadoop-trunk\hadoop-mapreduce-project\hadoop-mapreduce-client\hadoop-mapreduce-client-common\src\test\java\org\apache\hadoop\mapred\TestLocalModeWithNewApis.java,111,41,7,1,2,51
 kafka-trunk\kafka-trunk\connect\mirror\src\test\java\org\apache\kafka\connect\mirror\MirrorCheckpointTaskTest.java,111,0,0,25,0,25
 kafka-trunk\kafka-trunk\raft\src\test\java\org\apache\kafka\raft\RequestManagerTest.java,111,0,2,1,2,5
 kafka-trunk\kafka-trunk\clients\src\test\java\org\apache\kafka\common\requests\ApiVersionsResponseTest.java,111,0,0,24,0,24
 kafka-trunk\kafka-trunk\storage\src\main\java\org\apache\kafka\server\log\remote\metadata\storage\ConsumerManager.java,111,0,0,32,0,32
 kafka-trunk\kafka-trunk\clients\src\main\java\org\apache\kafka\common\protocol\types\CompactArrayOf.java,111,0,7,5,1,13
 pulsar-master\pulsar-master\pulsar-client-tools-test\src\test\java\org\apache\pulsar\client\cli\PulsarClientToolWsTest.java,111,31,2,18,0,51
 pulsar-master\pulsar-master\pulsar-client-auth-sasl\src\main\java\org\apache\pulsar\client\impl\auth\PulsarSaslClient.java,111,34,5,21,0,60
 pulsar-master\pulsar-master\pulsar-broker\src\main\java\org\apache\pulsar\broker\transaction\buffer\impl\TransactionEntryImpl.java,111,41,0,1,0,42
 pulsar-master\pulsar-master\pulsar-client\src\main\java\org\apache\pulsar\client\impl\schema\generic\GenericJsonRecord.java,111,26,0,5,0,31
 pulsar-master\pulsar-master\pulsar-io\file\src\test\java\org\apache\pulsar\io\file\FileConsumerThreadTests.java,111,32,0,13,0,45
 pulsar-master\pulsar-master\pulsar-broker\src\main\java\org\apache\pulsar\compaction\CompactorTool.java,111,37,6,29,0,72
 pulsar-master\pulsar-master\pulsar-client-tools\src\main\java\org\apache\pulsar\admin\cli\CmdBrokerStats.java,111,15,0,9,0,24
 pulsar-master\pulsar-master\pulsar-io\dynamodb\src\test\java\org\apache\pulsar\io\dynamodb\DynamoDBSourceConfigTests.java,111,51,0,17,0,68
 rocketmq-develop\rocketmq-develop\remoting\src\main\java\org\apache\rocketmq\remoting\netty\ResponseFuture.java,111,65,3,4,7,79
 rocketmq-develop\rocketmq-develop\openmessaging\src\main\java\io\openmessaging\rocketmq\producer\ProducerImpl.java,111,32,5,16,4,57
 rocketmq-develop\rocketmq-develop\client\src\test\java\org\apache\rocketmq\client\consumer\DefaultMQPullConsumerTest.java,111,54,7,15,3,79
 skywalking-master\skywalking-master\oap-server\server-tools\profile-exporter\tool-profile-snapshot-bootstrap\src\main\java\org\apache\skywalking\oap\server\tool\profile\exporter\ProfiledBasicInfo.java,111,45,0,18,0,63
 skywalking-master\skywalking-master\oap-server\server-library\library-module\src\main\java\org\apache\skywalking\oap\server\library\module\ModuleDefine.java,111,33,3,18,1,55
 skywalking-master\skywalking-master\oap-server\server-storage-plugin\storage-jdbc-hikaricp-plugin\src\main\java\org\apache\skywalking\oap\server\storage\plugin\jdbc\h2\dao\H2EBPFProfilingTaskDAO.java,111,43,0,29,0,72
 skywalking-master\skywalking-master\oap-server\server-core\src\main\java\org\apache\skywalking\oap\server\core\query\input\Entity.java,111,27,0,20,0,47
 dubbo-3.0\dubbo-3.0\dubbo-remoting\dubbo-remoting-netty4\src\test\java\org\apache\dubbo\remoting\transport\netty4\ReplierDispatcherTest.java,112,40,5,9,0,54
 dubbo-3.0\dubbo-3.0\dubbo-metadata\dubbo-metadata-api\src\test\java\org\apache\dubbo\metadata\report\support\AbstractMetadataReportFactoryTest.java,112,50,7,28,0,85
 dubbo-3.0\dubbo-3.0\dubbo-common\src\main\java\org\apache\dubbo\common\logger\log4j\Log4jLogger.java,112,46,0,1,0,47
 dubbo-3.0\dubbo-3.0\dubbo-remoting\dubbo-remoting-api\src\test\java\org\apache\dubbo\remoting\codec\AbstractMockChannel.java,112,50,5,4,3,62
 dubbo-3.0\dubbo-3.0\dubbo-config\dubbo-config-spring\src\main\java\org\apache\dubbo\config\spring\util\EnvironmentUtils.java,112,24,0,12,0,36
 dubbo-3.0\dubbo-3.0\dubbo-remoting\dubbo-remoting-api\src\main\java\org\apache\dubbo\remoting\transport\dispatcher\ChannelEventRunnable.java,112,62,7,13,2,84
 hadoop-trunk\hadoop-trunk\hadoop-hdfs-project\hadoop-hdfs\src\test\java\org\apache\hadoop\hdfs\server\namenode\TestNNStorageRetentionFunctional.java,112,38,0,3,0,41
 hadoop-trunk\hadoop-trunk\hadoop-common-project\hadoop-common\src\main\java\org\apache\hadoop\ipc\WeightedRoundRobinMultiplexer.java,112,22,0,2,0,24
 hadoop-trunk\hadoop-trunk\hadoop-mapreduce-project\hadoop-mapreduce-client\hadoop-mapreduce-client-core\src\main\java\org\apache\hadoop\mapreduce\lib\input\MultipleInputs.java,112,24,17,1,0,42
 hadoop-trunk\hadoop-trunk\hadoop-common-project\hadoop-common\src\main\java\org\apache\hadoop\io\file\tfile\BoundedRangeFileInputStream.java,112,33,4,1,1,39
 hadoop-trunk\hadoop-trunk\hadoop-hdfs-project\hadoop-hdfs\src\test\java\org\apache\hadoop\hdfs\TestDFSClientExcludedNodes.java,112,31,1,1,0,33
 hadoop-trunk\hadoop-trunk\hadoop-tools\hadoop-sls\src\test\java\org\apache\hadoop\yarn\sls\utils\TestSLSUtils.java,112,31,6,1,0,38
 hadoop-trunk\hadoop-trunk\hadoop-mapreduce-project\hadoop-mapreduce-client\hadoop-mapreduce-client-jobclient\src\test\java\org\apache\hadoop\fs\TestJHLA.java,112,76,9,62,2,149
 hadoop-trunk\hadoop-trunk\hadoop-mapreduce-project\hadoop-mapreduce-client\hadoop-mapreduce-client-core\src\main\java\org\apache\hadoop\mapred\SpillRecord.java,112,36,5,1,0,42
 hadoop-trunk\hadoop-trunk\hadoop-tools\hadoop-aliyun\src\test\java\org\apache\hadoop\fs\aliyun\oss\yarn\TestOSSMiniYarnCluster.java,112,21,1,1,5,28
 hadoop-trunk\hadoop-trunk\hadoop-common-project\hadoop-common\src\main\java\org\apache\hadoop\net\TableMapping.java,112,23,6,3,1,33
 hadoop-trunk\hadoop-trunk\hadoop-common-project\hadoop-registry\src\main\java\org\apache\hadoop\registry\server\dns\SecureableZone.java,112,17,1,1,2,21
 hadoop-trunk\hadoop-trunk\hadoop-yarn-project\hadoop-yarn\hadoop-yarn-common\src\main\java\org\apache\hadoop\yarn\ipc\RPCUtil.java,112,19,8,1,0,28
 hadoop-trunk\hadoop-trunk\hadoop-hdfs-project\hadoop-hdfs-httpfs\src\test\java\org\apache\hadoop\lib\util\TestConfigurationUtils.java,112,8,0,2,2,12
 hadoop-trunk\hadoop-trunk\hadoop-common-project\hadoop-common\src\test\java\org\apache\hadoop\fs\FSTestWrapper.java,112,66,1,1,0,68
 hadoop-trunk\hadoop-trunk\hadoop-yarn-project\hadoop-yarn\hadoop-yarn-server\hadoop-yarn-server-resourcemanager\src\main\java\org\apache\hadoop\yarn\server\resourcemanager\amlauncher\ApplicationMasterLauncher.java,112,37,3,3,1,44
 hadoop-trunk\hadoop-trunk\hadoop-yarn-project\hadoop-yarn\hadoop-yarn-applications\hadoop-yarn-applications-catalog\hadoop-yarn-applications-catalog-webapp\src\test\java\org\apache\hadoop\yarn\appcatalog\application\TestAppCatalogSolrClient.java,112,14,2,1,4,21
 hadoop-trunk\hadoop-trunk\hadoop-hdfs-project\hadoop-hdfs\src\test\java\org\apache\hadoop\tools\TestHdfsConfigFields.java,112,5,0,4,1,10
 hadoop-trunk\hadoop-trunk\hadoop-yarn-project\hadoop-yarn\hadoop-yarn-common\src\main\java\org\apache\hadoop\yarn\api\protocolrecords\impl\pb\StopContainersRequestPBImpl.java,112,28,43,3,0,74
 hadoop-trunk\hadoop-trunk\hadoop-yarn-project\hadoop-yarn\hadoop-yarn-server\hadoop-yarn-server-sharedcachemanager\src\test\java\org\apache\hadoop\yarn\server\sharedcachemanager\TestCleanerTask.java,112,11,0,1,0,12
 hadoop-trunk\hadoop-trunk\hadoop-common-project\hadoop-common\src\main\java\org\apache\hadoop\security\authorize\ProxyUsers.java,112,27,3,2,0,32
 hadoop-trunk\hadoop-trunk\hadoop-hdfs-project\hadoop-hdfs-client\src\main\java\org\apache\hadoop\hdfs\ReadStatistics.java,112,30,0,1,1,32
 hadoop-trunk\hadoop-trunk\hadoop-yarn-project\hadoop-yarn\hadoop-yarn-server\hadoop-yarn-server-resourcemanager\src\main\java\org\apache\hadoop\yarn\server\resourcemanager\scheduler\activities\NodeAllocation.java,112,51,3,1,4,59
 hadoop-trunk\hadoop-trunk\hadoop-hdfs-project\hadoop-hdfs\src\test\java\org\apache\hadoop\hdfs\server\namenode\TestValidateConfigurationSettings.java,112,21,0,3,3,27
 hadoop-trunk\hadoop-trunk\hadoop-common-project\hadoop-common\src\test\java\org\apache\hadoop\security\http\TestXFrameOptionsFilter.java,112,11,4,1,2,18
 hadoop-trunk\hadoop-trunk\hadoop-hdfs-project\hadoop-hdfs-client\src\main\java\org\apache\hadoop\hdfs\HAUtilClient.java,112,24,1,4,0,29
 hadoop-trunk\hadoop-trunk\hadoop-tools\hadoop-aws\src\test\java\org\apache\hadoop\fs\s3a\scale\ITestS3ADeleteManyFiles.java,112,4,3,2,0,9
 hadoop-trunk\hadoop-trunk\hadoop-hdfs-project\hadoop-hdfs\src\test\java\org\apache\hadoop\hdfs\TestFileCreationClient.java,112,38,6,3,2,49
 hadoop-trunk\hadoop-trunk\hadoop-hdfs-project\hadoop-hdfs\src\test\java\org\apache\hadoop\hdfs\server\datanode\TestStartSecureDataNode.java,112,8,1,4,0,13
 hadoop-trunk\hadoop-trunk\hadoop-common-project\hadoop-common\src\main\java\org\apache\hadoop\security\ssl\ReloadingX509KeystoreManager.java,112,54,1,6,0,61
 hadoop-trunk\hadoop-trunk\hadoop-yarn-project\hadoop-yarn\hadoop-yarn-server\hadoop-yarn-server-resourcemanager\src\main\java\org\apache\hadoop\yarn\server\resourcemanager\scheduler\policy\AbstractComparatorOrderingPolicy.java,112,56,5,2,1,64
 hadoop-trunk\hadoop-trunk\hadoop-mapreduce-project\hadoop-mapreduce-client\hadoop-mapreduce-client-core\src\main\java\org\apache\hadoop\mapreduce\security\SecureShuffleUtils.java,112,66,8,3,0,77
 kafka-trunk\kafka-trunk\clients\src\main\java\org\apache\kafka\common\security\oauthbearer\OAuthBearerValidatorCallback.java,112,0,2,14,0,16
 kafka-trunk\kafka-trunk\streams\src\test\java\org\apache\kafka\streams\state\internals\KeyValueStoreBuilderTest.java,112,0,3,13,2,18
 kafka-trunk\kafka-trunk\clients\src\test\java\org\apache\kafka\common\security\oauthbearer\internals\OAuthBearerSaslClientTest.java,112,0,7,16,4,27
 kafka-trunk\kafka-trunk\trogdor\src\main\java\org\apache\kafka\trogdor\rest\TasksRequest.java,112,0,13,6,1,20
 kafka-trunk\kafka-trunk\clients\src\test\java\org\apache\kafka\common\security\authenticator\SaslServerAuthenticatorTest.java,112,0,1,36,0,37
 kafka-trunk\kafka-trunk\shell\src\test\java\org\apache\kafka\shell\GlobVisitorTest.java,112,0,0,2,0,2
 kafka-trunk\kafka-trunk\clients\src\main\java\org\apache\kafka\clients\admin\DescribeUserScramCredentialsResult.java,112,0,0,38,0,38
 kafka-trunk\kafka-trunk\streams\src\test\java\org\apache\kafka\streams\processor\internals\StateRestoreCallbackAdapterTest.java,112,0,0,8,1,9
 kafka-trunk\kafka-trunk\streams\src\test\java\org\apache\kafka\streams\tests\StreamsBrokerDownResilienceTest.java,112,0,1,28,0,29
 kafka-trunk\kafka-trunk\streams\test-utils\src\test\java\org\apache\kafka\streams\KeyValueStoreFacadeTest.java,112,0,0,9,0,9
 kafka-trunk\kafka-trunk\connect\runtime\src\test\java\org\apache\kafka\connect\runtime\WorkerConfigTransformerTest.java,112,0,4,18,1,23
 pulsar-master\pulsar-master\pulsar-io\elastic-search\src\test\java\org\apache\pulsar\io\elasticsearch\opensearch\OpenSearchClientSslTests.java,112,32,0,15,0,47
 pulsar-master\pulsar-master\pulsar-client-tools\src\test\java\org\apache\pulsar\admin\cli\TestCmdTopics.java,112,35,7,12,0,54
 pulsar-master\pulsar-master\tests\integration\src\test\java\org\apache\pulsar\tests\integration\io\sinks\ElasticSearchSinkTester.java,112,28,0,11,0,39
 pulsar-master\pulsar-master\pulsar-broker\src\test\java\org\apache\pulsar\broker\systopic\NamespaceEventsSystemTopicServiceTest.java,112,39,3,27,0,69
 pulsar-master\pulsar-master\pulsar-io\kinesis\src\main\java\org\apache\pulsar\io\kinesis\KinesisSinkConfig.java,112,32,0,22,0,54
 pulsar-master\pulsar-master\pulsar-broker\src\test\java\org\apache\pulsar\client\impl\ProducerCloseTest.java,112,32,0,13,0,45
 pulsar-master\pulsar-master\pulsar-common\src\test\java\org\apache\pulsar\common\util\collections\TripleLongPriorityQueueTest.java,112,37,5,1,0,43
 pulsar-master\pulsar-master\pulsar-metadata\src\main\java\org\apache\pulsar\metadata\bookkeeper\PulsarRegistrationClient.java,112,36,5,11,0,52
 pulsar-master\pulsar-master\tests\integration\src\test\java\org\apache\pulsar\tests\integration\topologies\PulsarClusterTestBase.java,112,36,2,9,0,47
 pulsar-master\pulsar-master\pulsar-client-api\src\main\java\org\apache\pulsar\client\api\KeySharedPolicy.java,112,40,0,11,0,51
 puzzle-game-master\puzzle-game-master\core\src\com\jbgames\game\levels\Level.java,112,76,11,5,0,92
 rocketmq-develop\rocketmq-develop\client\src\main\java\org\apache\rocketmq\client\trace\TraceContext.java,112,74,1,2,2,79
 rocketmq-develop\rocketmq-develop\test\src\test\java\org\apache\rocketmq\test\client\producer\async\AsyncSendExceptionIT.java,112,35,2,10,16,63
 skywalking-master\skywalking-master\oap-server\analyzer\meter-analyzer\src\test\java\org\apache\skywalking\oap\meter\analyzer\dsl\FunctionTest.java,112,61,3,31,0,95
 skywalking-master\skywalking-master\oap-server\server-storage-plugin\storage-elasticsearch-plugin\src\main\java\org\apache\skywalking\oap\server\storage\plugin\elasticsearch\StorageModuleElasticsearchConfig.java,112,42,0,16,0,58
 skywalking-master\skywalking-master\oap-server\server-alarm-plugin\src\test\java\org\apache\skywalking\oap\server\core\alarm\provider\feishu\FeishuHookCallbackTest.java,112,37,2,28,0,67
 zookeeper-master\zookeeper-master\zookeeper-server\src\test\java\org\apache\zookeeper\test\StatsTrackTest.java,112,0,0,2,0,2
 zookeeper-master\zookeeper-master\zookeeper-server\src\test\java\org\apache\zookeeper\test\StandaloneTest.java,112,0,9,14,0,23
 zookeeper-master\zookeeper-master\zookeeper-server\src\main\java\org\apache\zookeeper\server\quorum\ObserverZooKeeperServer.java,112,0,0,9,3,12
 dubbo-3.0\dubbo-3.0\dubbo-registry\dubbo-registry-api\src\test\java\org\apache\dubbo\registry\MockLogger.java,113,31,14,1,0,46
 dubbo-3.0\dubbo-3.0\dubbo-config\dubbo-config-spring\src\test\java\org\apache\dubbo\config\spring\propertyconfigurer\consumer3\PropertySourcesInJavaConfigTest.java,113,37,3,25,0,65
 dubbo-3.0\dubbo-3.0\dubbo-plugin\dubbo-qos\src\main\java\org\apache\dubbo\qos\server\Server.java,113,47,3,5,0,55
 hadoop-trunk\hadoop-trunk\hadoop-mapreduce-project\hadoop-mapreduce-client\hadoop-mapreduce-client-nativetask\src\test\java\org\apache\hadoop\mapred\nativetask\compresstest\CompressTest.java,113,17,0,8,0,25
 hadoop-trunk\hadoop-trunk\hadoop-hdfs-project\hadoop-hdfs\src\test\java\org\apache\hadoop\hdfs\server\datanode\extdataset\ExternalReplicaInPipeline.java,113,30,8,1,1,40
 hadoop-trunk\hadoop-trunk\hadoop-hdfs-project\hadoop-hdfs\src\test\java\org\apache\hadoop\hdfs\server\namenode\TestXAttrConfigFlag.java,113,19,5,2,0,26
 hadoop-trunk\hadoop-trunk\hadoop-yarn-project\hadoop-yarn\hadoop-yarn-server\hadoop-yarn-server-resourcemanager\src\test\java\org\apache\hadoop\yarn\server\resourcemanager\scheduler\capacity\conf\TestLeveldbConfigurationStore.java,113,8,1,5,0,14
 hadoop-trunk\hadoop-trunk\hadoop-yarn-project\hadoop-yarn\hadoop-yarn-server\hadoop-yarn-server-nodemanager\src\test\java\org\apache\hadoop\yarn\server\nodemanager\security\TestNMTokenSecretManagerInNM.java,113,2,3,2,0,7
 hadoop-trunk\hadoop-trunk\hadoop-yarn-project\hadoop-yarn\hadoop-yarn-server\hadoop-yarn-server-nodemanager\src\main\java\org\apache\hadoop\yarn\server\nodemanager\nodelabels\ScriptBasedNodeAttributesProvider.java,113,15,2,1,0,18
 hadoop-trunk\hadoop-trunk\hadoop-yarn-project\hadoop-yarn\hadoop-yarn-applications\hadoop-yarn-services\hadoop-yarn-services-core\src\test\java\org\apache\hadoop\yarn\service\monitor\probe\TestDefaultProbe.java,113,14,2,1,1,18
 hadoop-trunk\hadoop-trunk\hadoop-yarn-project\hadoop-yarn\hadoop-yarn-server\hadoop-yarn-server-nodemanager\src\test\java\org\apache\hadoop\yarn\server\nodemanager\metrics\TestNodeManagerMetrics.java,113,43,2,1,0,46
 hadoop-trunk\hadoop-trunk\hadoop-hdfs-project\hadoop-hdfs\src\test\java\org\apache\hadoop\hdfs\tools\TestDelegationTokenFetcher.java,113,12,2,4,1,19
 hadoop-trunk\hadoop-trunk\hadoop-yarn-project\hadoop-yarn\hadoop-yarn-applications\hadoop-yarn-services\hadoop-yarn-services-api\src\main\java\org\apache\hadoop\yarn\service\webapp\ApiServerWebApp.java,113,13,6,3,0,22
 hadoop-trunk\hadoop-trunk\hadoop-hdfs-project\hadoop-hdfs-client\src\main\java\org\apache\hadoop\hdfs\protocol\RollingUpgradeInfo.java,113,49,0,1,0,50
 hadoop-trunk\hadoop-trunk\hadoop-yarn-project\hadoop-yarn\hadoop-yarn-server\hadoop-yarn-server-resourcemanager\src\test\java\org\apache\hadoop\yarn\server\resourcemanager\webapp\fairscheduler\FairSchedulerXmlVerifications.java,113,19,0,2,0,21
 hadoop-trunk\hadoop-trunk\hadoop-common-project\hadoop-common\src\main\java\org\apache\hadoop\security\SaslPropertiesResolver.java,113,31,0,2,5,38
 hadoop-trunk\hadoop-trunk\hadoop-hdfs-project\hadoop-hdfs\src\main\java\org\apache\hadoop\hdfs\server\datanode\DatanodeUtil.java,113,50,2,1,2,55
 hadoop-trunk\hadoop-trunk\hadoop-tools\hadoop-distcp\src\test\java\org\apache\hadoop\tools\StubContext.java,113,54,7,3,4,68
 hadoop-trunk\hadoop-trunk\hadoop-hdfs-project\hadoop-hdfs\src\main\java\org\apache\hadoop\hdfs\server\datanode\web\webhdfs\DataNodeUGIProvider.java,113,19,2,2,0,23
 hadoop-trunk\hadoop-trunk\hadoop-mapreduce-project\hadoop-mapreduce-client\hadoop-mapreduce-client-jobclient\src\test\java\org\apache\hadoop\mapred\TestMiniMRWithDFSWithDistinctUsers.java,113,52,12,2,0,66
 hadoop-trunk\hadoop-trunk\hadoop-yarn-project\hadoop-yarn\hadoop-yarn-server\hadoop-yarn-server-resourcemanager\src\main\java\org\apache\hadoop\yarn\server\resourcemanager\scheduler\capacity\QueueNodeLabelsSettings.java,113,42,1,14,4,61
 hadoop-trunk\hadoop-trunk\hadoop-tools\hadoop-streaming\src\main\java\org\apache\hadoop\streaming\StreamKeyValUtil.java,113,84,4,3,0,91
 hadoop-trunk\hadoop-trunk\hadoop-common-project\hadoop-common\src\test\java\org\apache\hadoop\http\TestHttpCookieFlag.java,113,18,3,1,1,23
 hadoop-trunk\hadoop-trunk\hadoop-common-project\hadoop-common\src\test\java\org\apache\hadoop\io\erasurecode\TestCodecRawCoderMapping.java,113,12,0,1,13,26
 hadoop-trunk\hadoop-trunk\hadoop-yarn-project\hadoop-yarn\hadoop-yarn-server\hadoop-yarn-server-resourcemanager\src\main\java\org\apache\hadoop\yarn\server\resourcemanager\webapp\dao\ActivityNodeInfo.java,113,52,1,4,4,61
 hadoop-trunk\hadoop-trunk\hadoop-common-project\hadoop-common\src\main\java\org\apache\hadoop\io\compress\bzip2\Bzip2Factory.java,113,52,5,1,0,58
 hadoop-trunk\hadoop-trunk\hadoop-tools\hadoop-azure\src\test\java\org\apache\hadoop\fs\azurebfs\ITestAzureBlobFileSystemFileStatus.java,113,20,0,7,0,27
 hadoop-trunk\hadoop-trunk\hadoop-common-project\hadoop-common\src\main\java\org\apache\hadoop\metrics2\MetricsSystem.java,113,26,4,1,0,31
 hadoop-trunk\hadoop-trunk\hadoop-yarn-project\hadoop-yarn\hadoop-yarn-server\hadoop-yarn-server-resourcemanager\src\main\java\org\apache\hadoop\yarn\server\resourcemanager\resource\DynamicResourceConfiguration.java,113,45,10,1,0,56
 hadoop-trunk\hadoop-trunk\hadoop-common-project\hadoop-common\src\test\java\org\apache\hadoop\crypto\random\TestOsSecureRandom.java,113,45,2,1,0,48
 hadoop-trunk\hadoop-trunk\hadoop-common-project\hadoop-nfs\src\main\java\org\apache\hadoop\nfs\nfs3\response\FSSTAT3Response.java,113,37,2,1,1,41
 kafka-trunk\kafka-trunk\connect\basic-auth-extension\src\main\java\org\apache\kafka\connect\rest\basic\auth\extension\JaasBasicAuthFilter.java,113,0,1,15,0,16
 kafka-trunk\kafka-trunk\connect\runtime\src\main\java\org\apache\kafka\connect\runtime\errors\ErrorHandlingMetrics.java,113,0,0,17,1,18
 kafka-trunk\kafka-trunk\clients\src\main\java\org\apache\kafka\common\utils\ConfigUtils.java,113,0,4,25,0,29
 kafka-trunk\kafka-trunk\connect\runtime\src\test\java\org\apache\kafka\connect\runtime\rest\InternalRequestSignatureTest.java,113,0,0,22,3,25
 kafka-trunk\kafka-trunk\streams\src\test\java\org\apache\kafka\streams\state\StreamsMetadataTest.java,113,0,0,12,0,12
 kafka-trunk\kafka-trunk\clients\src\main\java\org\apache\kafka\clients\admin\DescribeTopicsResult.java,113,0,2,31,3,36
 kafka-trunk\kafka-trunk\clients\src\generated\java\org\apache\kafka\common\message\UpdateFeaturesResponseDataJsonConverter.java,113,0,0,24,0,24
 pulsar-master\pulsar-master\pulsar-broker\src\test\java\org\apache\pulsar\broker\service\TransactionMarkerDeleteTest.java,113,22,0,16,0,38
 pulsar-master\pulsar-master\pulsar-config-validation\src\test\java\org\apache\pulsar\config\validation\ConfigValidationTest.java,113,43,4,13,0,60
 pulsar-master\pulsar-master\managed-ledger\src\test\java\org\apache\bookkeeper\mledger\impl\ManagedLedgerMBeanTest.java,113,28,2,8,0,38
 rocketmq-develop\rocketmq-develop\client\src\main\java\org\apache\rocketmq\client\producer\SendResult.java,113,81,1,4,4,90
 zookeeper-master\zookeeper-master\zookeeper-contrib\zookeeper-contrib-rest\src\main\java\org\apache\zookeeper\server\jersey\RestMain.java,113,0,2,4,2,8
 zookeeper-master\zookeeper-master\zookeeper-server\src\main\java\org\apache\zookeeper\common\NettyUtils.java,113,0,3,19,0,22
 dubbo-3.0\dubbo-3.0\dubbo-common\src\test\java\org\apache\dubbo\metadata\definition\MetadataTest.java,114,29,4,25,0,58
 dubbo-3.0\dubbo-3.0\dubbo-remoting\dubbo-remoting-netty\src\main\java\org\apache\dubbo\remoting\transport\netty\NettyServer.java,114,30,12,13,0,55
 dubbo-3.0\dubbo-3.0\dubbo-common\src\test\java\org\apache\dubbo\common\threadpool\manager\ExecutorRepositoryTest.java,114,35,0,6,2,43
 hadoop-trunk\hadoop-trunk\hadoop-tools\hadoop-rumen\src\main\java\org\apache\hadoop\tools\rumen\LoggedDiscreteCDF.java,114,48,1,2,1,52
 hadoop-trunk\hadoop-trunk\hadoop-common-project\hadoop-common\src\main\java\org\apache\hadoop\ipc\RemoteException.java,114,39,11,6,0,56
 hadoop-trunk\hadoop-trunk\hadoop-yarn-project\hadoop-yarn\hadoop-yarn-applications\hadoop-yarn-services\hadoop-yarn-services-core\src\main\java\org\apache\hadoop\yarn\service\provider\AbstractClientProvider.java,114,18,2,1,0,21
 hadoop-trunk\hadoop-trunk\hadoop-hdfs-project\hadoop-hdfs\src\main\java\org\apache\hadoop\hdfs\protocol\datatransfer\BlackListBasedTrustedChannelResolver.java,114,15,0,1,2,18
 hadoop-trunk\hadoop-trunk\hadoop-hdfs-project\hadoop-hdfs\src\test\java\org\apache\hadoop\fs\viewfs\TestViewFileSystemWithXAttrs.java,114,24,3,1,5,33
 hadoop-trunk\hadoop-trunk\hadoop-hdfs-project\hadoop-hdfs\src\test\java\org\apache\hadoop\hdfs\TestSetrepIncreasing.java,114,35,2,4,6,47
 hadoop-trunk\hadoop-trunk\hadoop-yarn-project\hadoop-yarn\hadoop-yarn-common\src\main\java\org\apache\hadoop\yarn\api\protocolrecords\impl\pb\GetContainerStatusesRequestPBImpl.java,114,28,43,3,0,74
 hadoop-trunk\hadoop-trunk\hadoop-common-project\hadoop-common\src\main\java\org\apache\hadoop\fs\Trash.java,114,25,0,1,0,26
 hadoop-trunk\hadoop-trunk\hadoop-tools\hadoop-azure\src\test\java\org\apache\hadoop\fs\azurebfs\services\TestTextFileBasedIdentityHandler.java,114,62,14,36,1,113
 hadoop-trunk\hadoop-trunk\hadoop-hdfs-project\hadoop-hdfs-rbf\src\main\java\org\apache\hadoop\hdfs\server\federation\router\RouterFsck.java,114,21,0,4,5,30
 hadoop-trunk\hadoop-trunk\hadoop-mapreduce-project\hadoop-mapreduce-client\hadoop-mapreduce-client-common\src\main\java\org\apache\hadoop\mapreduce\v2\api\records\impl\pb\TaskIdPBImpl.java,114,33,51,1,0,85
 hadoop-trunk\hadoop-trunk\hadoop-hdfs-project\hadoop-hdfs\src\main\java\org\apache\hadoop\hdfs\server\namenode\startupprogress\Step.java,114,39,0,1,0,40
 kafka-trunk\kafka-trunk\storage\src\generated\java\org\apache\kafka\server\log\remote\metadata\storage\generated\RemoteLogSegmentMetadataUpdateRecordJsonConverter.java,114,0,0,34,0,34
 kafka-trunk\kafka-trunk\trogdor\src\main\java\org\apache\kafka\trogdor\workload\TimestampRecordProcessor.java,114,0,0,15,0,15
 kafka-trunk\kafka-trunk\clients\src\main\java\org\apache\kafka\common\serialization\ListSerializer.java,114,0,7,19,1,27
 kafka-trunk\kafka-trunk\metadata\src\main\java\org\apache\kafka\controller\FeatureControlManager.java,114,0,1,15,0,16
 kafka-trunk\kafka-trunk\clients\src\generated\java\org\apache\kafka\common\message\CreateAclsRequestDataJsonConverter.java,114,0,0,26,0,26
 kafka-trunk\kafka-trunk\clients\src\test\java\org\apache\kafka\common\security\kerberos\KerberosNameTest.java,114,0,1,5,0,6
 pulsar-master\pulsar-master\pulsar-functions\instance\src\main\java\org\apache\pulsar\functions\instance\state\PulsarMetadataStateStoreImpl.java,114,47,4,2,0,53
 pulsar-master\pulsar-master\pulsar-common\src\main\java\org\apache\pulsar\common\util\keystoretls\NettySSLContextAutoRefreshBuilder.java,114,69,3,14,0,86
 pulsar-master\pulsar-master\pulsar-broker\src\test\java\org\apache\pulsar\broker\service\utils\ClientChannelHelper.java,114,39,2,6,0,47
 pulsar-master\pulsar-master\pulsar-functions\instance\src\main\java\org\apache\pulsar\functions\windowing\WaterMarkEventGenerator.java,114,41,2,11,0,54
 pulsar-master\pulsar-master\pulsar-broker\src\main\java\org\apache\pulsar\broker\resourcegroup\ResourceGroupConfigListener.java,114,38,6,18,0,62
 pulsar-master\pulsar-master\pulsar-broker\src\test\java\org\apache\pulsar\broker\admin\AdminResourceTest.java,114,16,0,11,0,27
 pulsar-master\pulsar-master\pulsar-functions\instance\src\test\java\org\apache\pulsar\functions\instance\JavaInstanceRunnableTest.java,114,33,3,15,0,51
 pulsar-master\pulsar-master\pulsar-broker\src\main\java\org\apache\pulsar\broker\loadbalance\NoopLoadManager.java,114,24,0,9,0,33
 pulsar-master\pulsar-master\managed-ledger\src\main\java\org\apache\bookkeeper\mledger\impl\NonDurableCursorImpl.java,114,52,3,29,0,84
 pulsar-master\pulsar-master\pulsar-functions\instance\src\main\java\org\apache\pulsar\functions\windowing\WindowContextImpl.java,114,42,0,2,0,44
 pulsar-master\pulsar-master\pulsar-client\src\main\java\org\apache\pulsar\client\impl\schema\AvroSchema.java,114,56,5,23,0,84
 pulsar-master\pulsar-master\pulsar-functions\runtime\src\main\java\org\apache\pulsar\functions\runtime\RuntimeSpawner.java,114,50,6,20,0,76
 pulsar-master\pulsar-master\pulsar-client-tools-test\src\test\java\org\apache\pulsar\admin\cli\utils\IOUtilsTest.java,114,18,3,4,0,25
 rocketmq-develop\rocketmq-develop\tools\src\test\java\org\apache\rocketmq\tools\monitor\MonitorServiceTest.java,114,37,11,21,6,75
 rocketmq-develop\rocketmq-develop\example\src\main\java\org\apache\rocketmq\example\simple\PullConsumer.java,114,29,5,20,1,55
 rocketmq-develop\rocketmq-develop\common\src\test\java\org\apache\rocketmq\common\stats\StatsItemSetTest.java,114,72,5,22,3,102
 skywalking-master\skywalking-master\oap-server\oal-rt\src\main\java\org\apache\skywalking\oal\rt\parser\AnalysisResult.java,114,21,0,13,0,34
 skywalking-master\skywalking-master\oap-server\server-configuration\configuration-consul\src\main\java\org\apache\skywalking\oap\server\configuration\consul\ConsulConfigurationWatcherRegister.java,114,25,0,13,0,38
 zookeeper-master\zookeeper-master\zookeeper-server\src\main\java\org\apache\zookeeper\server\util\LogChopper.java,114,0,8,11,1,20
 zookeeper-master\zookeeper-master\zookeeper-server\src\main\java\org\apache\zookeeper\client\FourLetterWordMain.java,114,0,4,11,2,17
 dubbo-3.0\dubbo-3.0\dubbo-remoting\dubbo-remoting-api\src\test\java\org\apache\dubbo\remoting\handler\ConnectChannelHandlerTest.java,115,33,0,20,1,54
 dubbo-3.0\dubbo-3.0\dubbo-monitor\dubbo-monitor-default\src\main\java\org\apache\dubbo\monitor\dubbo\StatisticsItem.java,115,112,2,5,0,119
 dubbo-3.0\dubbo-3.0\dubbo-remoting\dubbo-remoting-api\src\main\java\org\apache\dubbo\remoting\api\SslContexts.java,115,31,8,22,0,61
 dubbo-3.0\dubbo-3.0\dubbo-remoting\dubbo-remoting-api\src\main\java\org\apache\dubbo\remoting\transport\ClientDelegate.java,115,41,1,1,0,43
 hadoop-trunk\hadoop-trunk\hadoop-yarn-project\hadoop-yarn\hadoop-yarn-server\hadoop-yarn-server-resourcemanager\src\main\java\org\apache\hadoop\yarn\server\resourcemanager\volume\csi\processor\VolumeAMSProcessor.java,115,21,1,11,1,34
 hadoop-trunk\hadoop-trunk\hadoop-tools\hadoop-aws\src\main\java\org\apache\hadoop\fs\s3a\S3AReadOpContext.java,115,16,0,1,2,19
 hadoop-trunk\hadoop-trunk\hadoop-yarn-project\hadoop-yarn\hadoop-yarn-common\src\main\java\org\apache\hadoop\yarn\server\api\protocolrecords\impl\pb\CheckForDecommissioningNodesResponsePBImpl.java,115,28,43,5,0,76
 hadoop-trunk\hadoop-trunk\hadoop-hdfs-project\hadoop-hdfs-rbf\src\main\java\org\apache\hadoop\hdfs\server\federation\router\RouterHttpServer.java,115,22,1,1,1,25
 hadoop-trunk\hadoop-trunk\hadoop-hdfs-project\hadoop-hdfs\src\test\java\org\apache\hadoop\hdfs\TestEncryptionZonesWithKMS.java,115,17,8,1,0,26
 hadoop-trunk\hadoop-trunk\hadoop-mapreduce-project\hadoop-mapreduce-client\hadoop-mapreduce-client-core\src\test\java\org\apache\hadoop\mapred\TestTaskLog.java,115,20,2,1,5,28
 hadoop-trunk\hadoop-trunk\hadoop-yarn-project\hadoop-yarn\hadoop-yarn-common\src\main\java\org\apache\hadoop\yarn\client\api\impl\TimelineWriter.java,115,29,3,2,1,35
 hadoop-trunk\hadoop-trunk\hadoop-mapreduce-project\hadoop-mapreduce-client\hadoop-mapreduce-client-app\src\main\java\org\apache\hadoop\mapreduce\v2\app\speculate\LegacyTaskRuntimeEstimator.java,115,19,0,6,0,25
 hadoop-trunk\hadoop-trunk\hadoop-yarn-project\hadoop-yarn\hadoop-yarn-server\hadoop-yarn-server-nodemanager\src\test\java\org\apache\hadoop\yarn\server\nodemanager\NodeManagerTestBase.java,115,57,1,11,7,76
 hadoop-trunk\hadoop-trunk\hadoop-yarn-project\hadoop-yarn\hadoop-yarn-common\src\main\java\org\apache\hadoop\yarn\api\records\impl\pb\UpdateContainerErrorPBImpl.java,115,21,34,1,0,56
 hadoop-trunk\hadoop-trunk\hadoop-yarn-project\hadoop-yarn\hadoop-yarn-server\hadoop-yarn-server-common\src\main\java\org\apache\hadoop\yarn\server\api\protocolrecords\impl\pb\ReportNewCollectorInfoRequestPBImpl.java,115,18,38,5,0,61
 hadoop-trunk\hadoop-trunk\hadoop-common-project\hadoop-common\src\test\java\org\apache\hadoop\util\TestLists.java,115,20,0,1,0,21
 hadoop-trunk\hadoop-trunk\hadoop-hdfs-project\hadoop-hdfs\src\test\java\org\apache\hadoop\hdfs\qjournal\TestMiniJournalCluster.java,115,37,1,14,0,52
 hadoop-trunk\hadoop-trunk\hadoop-common-project\hadoop-common\src\test\java\org\apache\hadoop\ipc\TestWeightedRoundRobinMultiplexer.java,115,24,0,2,0,26
 hadoop-trunk\hadoop-trunk\hadoop-common-project\hadoop-common\src\test\java\org\apache\hadoop\fs\loadGenerator\DataGenerator.java,115,58,6,1,5,70
 hadoop-trunk\hadoop-trunk\hadoop-common-project\hadoop-common\src\main\java\org\apache\hadoop\ha\PowerShellFencer.java,115,8,8,1,0,17
 hadoop-trunk\hadoop-trunk\hadoop-yarn-project\hadoop-yarn\hadoop-yarn-server\hadoop-yarn-server-web-proxy\src\test\java\org\apache\hadoop\yarn\server\webproxy\amfilter\TestSecureAmFilter.java,115,12,0,1,0,13
 hadoop-trunk\hadoop-trunk\hadoop-common-project\hadoop-common\src\test\java\org\apache\hadoop\io\TestSecureIOUtils.java,115,19,10,1,4,34
 kafka-trunk\kafka-trunk\clients\src\test\java\org\apache\kafka\common\acl\AclBindingTest.java,115,0,2,18,0,20
 kafka-trunk\kafka-trunk\clients\src\main\java\org\apache\kafka\common\record\RecordsUtil.java,115,0,9,31,0,40
 kafka-trunk\kafka-trunk\clients\src\generated\java\org\apache\kafka\common\message\OffsetCommitResponseDataJsonConverter.java,115,0,0,30,0,30
 kafka-trunk\kafka-trunk\connect\api\src\main\java\org\apache\kafka\connect\source\SourceTask.java,115,0,0,32,0,32
 kafka-trunk\kafka-trunk\connect\runtime\src\main\java\org\apache\kafka\connect\util\TopicCreation.java,115,0,1,22,1,24
 kafka-trunk\kafka-trunk\clients\src\main\java\org\apache\kafka\common\acl\AccessControlEntryFilter.java,115,0,12,9,0,21
 kafka-trunk\kafka-trunk\streams\src\test\java\org\apache\kafka\streams\integration\EOSUncleanShutdownIntegrationTest.java,115,0,3,29,4,36
 kafka-trunk\kafka-trunk\connect\runtime\src\main\java\org\apache\kafka\connect\runtime\rest\entities\ConnectorStateInfo.java,115,0,2,3,2,7
 kafka-trunk\kafka-trunk\clients\src\main\java\org\apache\kafka\common\metrics\stats\Percentiles.java,115,0,4,8,3,15
 pulsar-master\pulsar-master\pulsar-common\src\test\java\org\apache\pulsar\common\protocol\MarkersTest.java,115,48,0,17,0,65
 pulsar-master\pulsar-master\pulsar-io\influxdb\src\test\java\org\apache\pulsar\io\influxdb\v1\InfluxDBSinkConfigTest.java,115,11,1,4,0,16
 pulsar-master\pulsar-master\pulsar-io\mongo\src\main\java\org\apache\pulsar\io\mongodb\MongoSource.java,115,24,5,7,0,36
 pulsar-master\pulsar-master\pulsar-websocket\src\main\java\org\apache\pulsar\websocket\service\ProxyServer.java,115,46,5,17,0,68
 pulsar-master\pulsar-master\pulsar-broker\src\test\java\org\apache\pulsar\client\impl\BatchMessageIndexAckDisableTest.java,115,23,0,3,0,26
 pulsar-master\pulsar-master\pulsar-broker\src\main\java\org\apache\pulsar\broker\service\HashRangeExclusiveStickyKeyConsumerSelector.java,115,40,0,26,0,66
 pulsar-master\pulsar-master\pulsar-metadata\src\test\java\org\apache\pulsar\metadata\bookkeeper\PulsarLedgerIdGeneratorTest.java,115,19,2,13,0,34
 pulsar-master\pulsar-master\pulsar-io\twitter\src\main\java\org\apache\pulsar\io\twitter\TwitterFireHose.java,115,24,1,12,0,37
 rocketmq-develop\rocketmq-develop\namesrv\src\test\java\org\apache\rocketmq\namesrv\routeinfo\RouteInfoManagerStaticRegisterTest.java,115,32,0,9,5,46
 rocketmq-develop\rocketmq-develop\broker\src\main\java\org\apache\rocketmq\broker\slave\SlaveSynchronize.java,115,37,1,22,6,66
 rocketmq-develop\rocketmq-develop\store\src\main\java\org\apache\rocketmq\store\RunningFlags.java,115,41,10,5,0,56
 rocketmq-develop\rocketmq-develop\tools\src\main\java\org\apache\rocketmq\tools\command\CommandUtil.java,115,40,1,31,0,72
 skywalking-master\skywalking-master\oap-server\server-storage-plugin\storage-influxdb-plugin\src\main\java\org\apache\skywalking\oap\server\storage\plugin\influxdb\base\MetricsDAO.java,115,45,0,31,0,76
 skywalking-master\skywalking-master\oap-server\server-alarm-plugin\src\main\java\org\apache\skywalking\oap\server\core\alarm\provider\EventHookCallback.java,115,30,1,21,0,52
 skywalking-master\skywalking-master\oap-server\server-core\src\main\java\org\apache\skywalking\oap\server\core\analysis\manual\relation\service\ServiceRelationServerSideMetrics.java,115,34,1,14,0,49
 skywalking-master\skywalking-master\oap-server\server-configuration\configuration-consul\src\test\java\org\apache\skywalking\oap\server\configuration\consul\ITConsulConfigurationTest.java,115,39,2,22,0,63
 skywalking-master\skywalking-master\oap-server\server-storage-plugin\storage-zipkin-elasticsearch-plugin\src\main\java\org\apache\skywalking\oap\server\storage\plugin\zipkin\ZipkinSpanRecord.java,115,37,0,9,0,46
 zookeeper-master\zookeeper-master\zookeeper-server\src\test\java\org\apache\zookeeper\server\quorum\FLEBackwardElectionRoundTest.java,115,0,1,6,7,14
 zookeeper-master\zookeeper-master\zookeeper-server\src\main\java\org\apache\zookeeper\client\ZKClientConfig.java,115,0,0,23,0,23
 dubbo-3.0\dubbo-3.0\dubbo-metadata\dubbo-metadata-processor\src\main\java\org\apache\dubbo\metadata\annotation\processing\rest\springmvc\SpringMvcServiceRestMetadataResolver.java,116,57,0,29,0,86
 dubbo-3.0\dubbo-3.0\dubbo-registry\dubbo-registry-api\src\main\java\org\apache\dubbo\registry\client\metadata\MetadataServiceNameMapping.java,116,41,1,22,0,64
 dubbo-3.0\dubbo-3.0\dubbo-rpc\dubbo-rpc-api\src\main\java\org\apache\dubbo\rpc\proxy\AbstractProxyInvoker.java,116,37,2,17,2,58
 dubbo-3.0\dubbo-3.0\dubbo-common\src\test\java\org\apache\dubbo\rpc\model\ApplicationModelTest.java,116,39,0,33,0,72
 dubbo-3.0\dubbo-3.0\dubbo-config\dubbo-config-api\src\test\java\org\apache\dubbo\config\integration\AbstractRegistryCenterExporterListener.java,116,32,6,12,0,50
 dubbo-3.0\dubbo-3.0\dubbo-plugin\dubbo-qos\src\test\java\org\apache\dubbo\qos\legacy\channel\MockChannel.java,116,52,4,2,0,58
 hadoop-trunk\hadoop-trunk\hadoop-common-project\hadoop-common\src\test\java\org\apache\hadoop\metrics2\util\TestMetricsCache.java,116,31,5,1,3,40
 hadoop-trunk\hadoop-trunk\hadoop-hdfs-project\hadoop-hdfs\src\test\java\org\apache\hadoop\hdfs\TestReadStripedFileWithDecoding.java,116,9,4,7,3,23
 hadoop-trunk\hadoop-trunk\hadoop-yarn-project\hadoop-yarn\hadoop-yarn-applications\hadoop-yarn-applications-catalog\hadoop-yarn-applications-catalog-webapp\src\test\java\org\apache\hadoop\yarn\appcatalog\controller\AppDetailsControllerTest.java,116,11,7,1,1,20
 hadoop-trunk\hadoop-trunk\hadoop-common-project\hadoop-common\src\main\java\org\apache\hadoop\fs\FileEncryptionInfo.java,116,16,0,1,8,25
 hadoop-trunk\hadoop-trunk\hadoop-tools\hadoop-sls\src\main\java\org\apache\hadoop\yarn\sls\AMDefinitionSynth.java,116,32,1,2,2,37
 hadoop-trunk\hadoop-trunk\hadoop-hdfs-project\hadoop-hdfs-httpfs\src\main\java\org\apache\hadoop\fs\http\server\HttpFSServerWebApp.java,116,20,1,1,2,24
 hadoop-trunk\hadoop-trunk\hadoop-hdfs-project\hadoop-hdfs\src\test\java\org\apache\hadoop\hdfs\server\namenode\snapshot\TestSetQuotaWithSnapshot.java,116,33,1,2,1,37
 hadoop-trunk\hadoop-trunk\hadoop-tools\hadoop-azure\src\test\java\org\apache\hadoop\fs\azurebfs\ITestAbfsRestOperationException.java,116,28,2,14,1,45
 hadoop-trunk\hadoop-trunk\hadoop-tools\hadoop-sls\src\main\java\org\apache\hadoop\yarn\sls\scheduler\ContainerSimulator.java,116,86,0,1,4,91
 hadoop-trunk\hadoop-trunk\hadoop-yarn-project\hadoop-yarn\hadoop-yarn-server\hadoop-yarn-server-resourcemanager\src\main\java\org\apache\hadoop\yarn\server\resourcemanager\webapp\RMAppLogAggregationStatusBlock.java,116,14,4,1,0,19
 hadoop-trunk\hadoop-trunk\hadoop-hdfs-project\hadoop-hdfs-httpfs\src\main\java\org\apache\hadoop\fs\http\server\metrics\HttpFSServerMetrics.java,116,67,0,1,2,70
 hadoop-trunk\hadoop-trunk\hadoop-mapreduce-project\hadoop-mapreduce-client\hadoop-mapreduce-client-core\src\main\java\org\apache\hadoop\mapred\join\CompositeInputSplit.java,116,23,2,1,0,26
 kafka-trunk\kafka-trunk\clients\src\main\java\org\apache\kafka\clients\admin\ConsumerGroupDescription.java,116,0,2,6,3,11
 kafka-trunk\kafka-trunk\streams\src\main\java\org\apache\kafka\streams\processor\internals\ProcessorMetadata.java,116,0,0,10,1,11
 kafka-trunk\kafka-trunk\connect\runtime\src\main\java\org\apache\kafka\connect\runtime\TopicCreationConfig.java,116,0,2,49,0,51
 kafka-trunk\kafka-trunk\clients\src\generated\java\org\apache\kafka\common\message\OffsetDeleteResponseDataJsonConverter.java,116,0,0,32,0,32
 kafka-trunk\kafka-trunk\clients\src\main\java\org\apache\kafka\common\requests\DescribeAclsResponse.java,116,0,31,17,2,50
 kafka-trunk\kafka-trunk\clients\src\generated\java\org\apache\kafka\common\message\AlterReplicaLogDirsRequestDataJsonConverter.java,116,0,0,29,0,29
 kafka-trunk\kafka-trunk\streams\src\main\java\org\apache\kafka\streams\internals\metrics\ClientMetrics.java,116,0,1,22,1,24
 kafka-trunk\kafka-trunk\connect\runtime\src\main\java\org\apache\kafka\connect\runtime\RestartRequest.java,116,0,0,20,0,20
 kafka-trunk\kafka-trunk\clients\src\generated\java\org\apache\kafka\common\message\DeleteRecordsResponseDataJsonConverter.java,116,0,0,32,0,32
 kafka-trunk\kafka-trunk\clients\src\main\java\org\apache\kafka\common\Node.java,116,0,2,4,0,6
 kafka-trunk\kafka-trunk\jmh-benchmarks\src\main\java\org\apache\kafka\jmh\partition\UpdateFollowerFetchStateBenchmark.java,116,0,1,23,0,24
 pulsar-master\pulsar-master\pulsar-broker\src\main\java\org\apache\pulsar\broker\protocol\ProtocolHandlers.java,116,37,4,21,0,62
 pulsar-master\pulsar-master\pulsar-io\redis\src\test\java\org\apache\pulsar\io\redis\sink\RedisSinkConfigTest.java,116,12,1,4,0,17
 pulsar-master\pulsar-master\pulsar-client\src\main\java\org\apache\pulsar\client\impl\ProducerStatsDisabled.java,116,22,0,1,0,23
 pulsar-master\pulsar-master\pulsar-broker-common\src\main\java\org\apache\pulsar\broker\authentication\AuthenticationProviderBasic.java,116,30,3,18,0,51
 pulsar-master\pulsar-master\pulsar-broker\src\test\java\org\apache\pulsar\client\api\PartitionCreationTest.java,116,61,2,27,0,90
 rocketmq-develop\rocketmq-develop\common\src\test\java\org\apache\rocketmq\common\ServiceThreadTest.java,116,22,1,1,1,25
 rocketmq-develop\rocketmq-develop\broker\src\main\java\org\apache\rocketmq\broker\processor\ConsumerManageProcessor.java,116,39,3,30,1,73
 rocketmq-develop\rocketmq-develop\tools\src\main\java\org\apache\rocketmq\tools\command\consumer\ConsumerStatusSubCommand.java,116,29,1,20,2,52
 rocketmq-develop\rocketmq-develop\client\src\test\java\org\apache\rocketmq\client\trace\TransactionMQProducerWithOpenTracingTest.java,116,46,4,24,3,77
 rocketmq-develop\rocketmq-develop\common\src\main\java\org\apache\rocketmq\common\protocol\header\PullMessageRequestHeader.java,116,78,1,2,0,81
 skywalking-master\skywalking-master\oap-server\server-storage-plugin\storage-jdbc-hikaricp-plugin\src\main\java\org\apache\skywalking\oap\server\storage\plugin\jdbc\h2\dao\H2AlarmQueryDAO.java,116,39,1,16,0,56
 skywalking-master\skywalking-master\oap-server\server-core\src\main\java\org\apache\skywalking\oap\server\core\profiling\trace\ProfileTaskMutationService.java,116,21,0,21,0,42
 zookeeper-master\zookeeper-master\zookeeper-server\src\test\java\org\apache\zookeeper\server\ServerStatsTest.java,116,0,2,4,1,7
 zookeeper-master\zookeeper-master\zookeeper-contrib\zookeeper-contrib-rest\src\test\java\org\apache\zookeeper\server\jersey\CreateTest.java,116,0,4,3,4,11
 zookeeper-master\zookeeper-master\zookeeper-server\src\test\java\org\apache\zookeeper\server\SessionTrackerTest.java,116,0,6,13,5,24
 zookeeper-master\zookeeper-master\zookeeper-server\src\main\java\org\apache\zookeeper\server\auth\ServerAuthenticationProvider.java,116,0,6,9,4,19
 dubbo-3.0\dubbo-3.0\dubbo-compatible\src\main\java\com\alibaba\dubbo\registry\support\AbstractRegistry.java,117,77,1,23,0,101
 dubbo-3.0\dubbo-3.0\dubbo-common\src\main\java\org\apache\dubbo\common\resource\GlobalResourcesRepository.java,117,29,6,9,4,48
 hadoop-trunk\hadoop-trunk\hadoop-hdfs-project\hadoop-hdfs-httpfs\src\test\java\org\apache\hadoop\lib\util\TestCheck.java,117,27,0,1,2,30
 hadoop-trunk\hadoop-trunk\hadoop-mapreduce-project\hadoop-mapreduce-client\hadoop-mapreduce-client-nativetask\src\test\java\org\apache\hadoop\mapred\nativetask\serde\TestKVSerializer.java,117,35,0,8,2,45
 hadoop-trunk\hadoop-trunk\hadoop-tools\hadoop-datajoin\src\test\java\org\apache\hadoop\contrib\utils\join\TestDataJoin.java,117,26,6,1,2,35
 hadoop-trunk\hadoop-trunk\hadoop-yarn-project\hadoop-yarn\hadoop-yarn-server\hadoop-yarn-server-resourcemanager\src\test\java\org\apache\hadoop\yarn\server\resourcemanager\webapp\TestRMWebServicesContainers.java,117,6,0,4,0,10
 hadoop-trunk\hadoop-trunk\hadoop-yarn-project\hadoop-yarn\hadoop-yarn-common\src\main\java\org\apache\hadoop\yarn\api\records\impl\pb\NodeAttributeInfoPBImpl.java,117,23,38,1,0,62
 hadoop-trunk\hadoop-trunk\hadoop-mapreduce-project\hadoop-mapreduce-client\hadoop-mapreduce-client-hs\src\main\java\org\apache\hadoop\mapreduce\v2\hs\webapp\HsJobsBlock.java,117,18,1,2,0,21
 hadoop-trunk\hadoop-trunk\hadoop-common-project\hadoop-common\src\test\java\org\apache\hadoop\fs\TestDelegateToFsCheckPath.java,117,27,0,1,0,28
 hadoop-trunk\hadoop-trunk\hadoop-common-project\hadoop-common\src\main\java\org\apache\hadoop\io\erasurecode\coder\HHXORErasureEncodingStep.java,117,20,0,1,0,21
 hadoop-trunk\hadoop-trunk\hadoop-yarn-project\hadoop-yarn\hadoop-yarn-server\hadoop-yarn-server-resourcemanager\src\test\java\org\apache\hadoop\yarn\server\resourcemanager\scheduler\TestResourceUsage.java,117,31,3,1,0,35
 hadoop-trunk\hadoop-trunk\hadoop-hdfs-project\hadoop-hdfs\src\test\java\org\apache\hadoop\hdfs\TestKeyProviderCache.java,117,28,4,1,2,35
 hadoop-trunk\hadoop-trunk\hadoop-yarn-project\hadoop-yarn\hadoop-yarn-client\src\main\java\org\apache\hadoop\yarn\client\api\ContainerShellWebSocket.java,117,31,5,1,0,37
 hadoop-trunk\hadoop-trunk\hadoop-hdfs-project\hadoop-hdfs\src\main\java\org\apache\hadoop\hdfs\server\blockmanagement\BlockReconstructionWork.java,117,27,0,1,0,28
 hadoop-trunk\hadoop-trunk\hadoop-hdfs-project\hadoop-hdfs\src\test\java\org\apache\hadoop\hdfs\server\namenode\TestAddBlock.java,117,23,1,1,2,27
 hadoop-trunk\hadoop-trunk\hadoop-tools\hadoop-rumen\src\main\java\org\apache\hadoop\tools\rumen\ZombieCluster.java,117,31,1,6,1,39
 hadoop-trunk\hadoop-trunk\hadoop-tools\hadoop-azure\src\test\java\org\apache\hadoop\fs\azurebfs\ITestAzureBlobFileSystemStoreListStatusWithRange.java,117,39,0,18,2,59
 hadoop-trunk\hadoop-trunk\hadoop-common-project\hadoop-common\src\test\java\org\apache\hadoop\util\curator\TestZKCuratorManager.java,117,11,4,1,0,16
 hadoop-trunk\hadoop-trunk\hadoop-common-project\hadoop-common\src\test\java\org\apache\hadoop\security\TestRaceWhenRelogin.java,117,22,4,1,7,34
 hadoop-trunk\hadoop-trunk\hadoop-common-project\hadoop-common\src\main\java\org\apache\hadoop\util\SysInfo.java,117,0,0,1,0,1
 hadoop-trunk\hadoop-trunk\hadoop-yarn-project\hadoop-yarn\hadoop-yarn-common\src\main\java\org\apache\hadoop\yarn\security\AMRMTokenIdentifier.java,117,34,27,2,0,63
 hadoop-trunk\hadoop-trunk\hadoop-yarn-project\hadoop-yarn\hadoop-yarn-common\src\main\java\org\apache\hadoop\yarn\api\protocolrecords\impl\pb\KillApplicationRequestPBImpl.java,117,40,43,4,0,87
 hadoop-trunk\hadoop-trunk\hadoop-mapreduce-project\hadoop-mapreduce-client\hadoop-mapreduce-client-jobclient\src\test\java\org\apache\hadoop\mapred\TestFileInputFormatPathFilter.java,117,24,6,2,2,34
 kafka-trunk\kafka-trunk\storage\src\test\java\org\apache\kafka\server\log\remote\storage\RemoteLogMetadataManagerTest.java,117,0,0,55,0,55
 kafka-trunk\kafka-trunk\clients\src\generated\java\org\apache\kafka\common\message\LeaveGroupResponseDataJsonConverter.java,117,0,0,23,0,23
 kafka-trunk\kafka-trunk\connect\runtime\src\test\java\org\apache\kafka\connect\integration\SessionedProtocolIntegrationTest.java,117,0,0,27,0,27
 kafka-trunk\kafka-trunk\metadata\src\test\java\org\apache\kafka\timeline\BaseHashTableTest.java,117,0,1,10,0,11
 kafka-trunk\kafka-trunk\streams\src\main\java\org\apache\kafka\streams\kstream\internals\graph\GraphNode.java,117,0,1,3,1,5
 kafka-trunk\kafka-trunk\connect\runtime\src\main\java\org\apache\kafka\connect\util\TopicCreationGroup.java,117,0,0,21,0,21
 kafka-trunk\kafka-trunk\connect\api\src\test\java\org\apache\kafka\connect\sink\SinkConnectorTest.java,117,0,1,7,2,10
 kafka-trunk\kafka-trunk\streams\src\main\java\org\apache\kafka\streams\processor\ThreadMetadata.java,117,0,4,7,4,15
 pulsar-master\pulsar-master\pulsar-broker\src\main\java\org\apache\pulsar\client\impl\RawBatchConverter.java,117,44,1,35,0,80
 pulsar-master\pulsar-master\pulsar-broker\src\main\java\org\apache\pulsar\PulsarStandaloneStarter.java,117,22,6,10,0,38
 pulsar-master\pulsar-master\pulsar-broker\src\test\java\org\apache\pulsar\broker\stats\ManagedCursorMetricsTest.java,117,24,0,16,0,40
 pulsar-master\pulsar-master\pulsar-broker\src\main\java\org\apache\pulsar\broker\rest\Topics.java,117,91,4,48,0,143
 pulsar-master\pulsar-master\pulsar-broker\src\main\java\org\apache\pulsar\broker\loadbalance\impl\DeviationShedder.java,117,24,2,21,0,47
 pulsar-master\pulsar-master\pulsar-sql\presto-pulsar\src\main\java\org\apache\pulsar\sql\presto\decoder\protobufnative\PulsarProtobufNativeRowDecoderFactory.java,117,33,1,19,0,53
 pulsar-master\pulsar-master\pulsar-broker\src\test\java\org\apache\pulsar\broker\resourcegroup\ResourceGroupRateLimiterTest.java,117,39,8,12,0,59
 rocketmq-develop\rocketmq-develop\store\src\main\java\org\apache\rocketmq\store\GetMessageResult.java,117,69,0,3,2,74
 shardingsphere-master\shardingsphere-master\shardingsphere-test\shardingsphere-integration-test\shardingsphere-integration-test-suite\src\test\java\org\apache\shardingsphere\test\integration\engine\BatchITCase.java,117,45,0,30,0,75
 skywalking-master\skywalking-master\oap-server\server-configuration\configuration-zookeeper\src\test\java\org\apache\skywalking\oap\server\configuration\zookeeper\it\ITZookeeperConfigurationTest.java,117,46,12,25,0,83
 skywalking-master\skywalking-master\oap-server\analyzer\meter-analyzer\src\main\java\org\apache\skywalking\oap\meter\analyzer\prometheus\PrometheusMetricConverter.java,117,33,0,20,0,53
 skywalking-master\skywalking-master\oap-server\server-tools\profile-exporter\tool-profile-snapshot-bootstrap\src\test\java\org\apache\skywalking\oap\server\tool\profile\exporter\ProfileExportedAnalyze.java,117,25,3,15,0,43
 skywalking-master\skywalking-master\oap-server\server-core\src\main\java\org\apache\skywalking\oap\server\core\profiling\ebpf\EBPFProfilingQueryService.java,117,38,0,27,0,65
 zookeeper-master\zookeeper-master\zookeeper-server\src\test\java\org\apache\zookeeper\metrics\BaseTestMetricsProvider.java,117,0,5,11,0,16
 dubbo-3.0\dubbo-3.0\dubbo-compatible\src\main\java\com\alibaba\dubbo\rpc\protocol\dubbo\FutureAdapter.java,118,32,2,5,0,39
 dubbo-3.0\dubbo-3.0\dubbo-common\src\main\java\org\apache\dubbo\common\logger\LoggerFactory.java,118,24,3,7,1,35
 dubbo-3.0\dubbo-3.0\dubbo-common\src\main\java\org\apache\dubbo\common\utils\Stack.java,118,12,2,4,0,18
 hadoop-trunk\hadoop-trunk\hadoop-common-project\hadoop-common\src\main\java\org\apache\hadoop\util\AutoCloseableLock.java,118,4,0,1,0,5
 hadoop-trunk\hadoop-trunk\hadoop-yarn-project\hadoop-yarn\hadoop-yarn-server\hadoop-yarn-server-nodemanager\src\main\java\org\apache\hadoop\yarn\server\nodemanager\containermanager\resourceplugin\fpga\FpgaDevice.java,118,41,1,2,0,44
 hadoop-trunk\hadoop-trunk\hadoop-yarn-project\hadoop-yarn\hadoop-yarn-common\src\main\java\org\apache\hadoop\yarn\client\ClientRMProxy.java,118,16,0,1,1,18
 hadoop-trunk\hadoop-trunk\hadoop-yarn-project\hadoop-yarn\hadoop-yarn-server\hadoop-yarn-server-resourcemanager\src\test\java\org\apache\hadoop\yarn\server\resourcemanager\scheduler\constraint\algorithm\TestLocalAllocationTagsManager.java,118,8,1,6,0,15
 hadoop-trunk\hadoop-trunk\hadoop-yarn-project\hadoop-yarn\hadoop-yarn-common\src\main\java\org\apache\hadoop\yarn\api\protocolrecords\impl\pb\GetLocalizationStatusesRequestPBImpl.java,118,20,39,4,0,63
 hadoop-trunk\hadoop-trunk\hadoop-hdfs-project\hadoop-hdfs\src\test\java\org\apache\hadoop\hdfs\TestStoragePolicyPermissionSettings.java,118,19,4,1,2,26
 hadoop-trunk\hadoop-trunk\hadoop-yarn-project\hadoop-yarn\hadoop-yarn-server\hadoop-yarn-server-sharedcachemanager\src\main\java\org\apache\hadoop\yarn\server\sharedcachemanager\SharedCacheManager.java,118,19,2,2,0,23
 hadoop-trunk\hadoop-trunk\hadoop-hdfs-project\hadoop-hdfs\src\test\java\org\apache\hadoop\hdfs\server\datanode\TestProvidedReplicaImpl.java,118,41,7,1,13,62
 hadoop-trunk\hadoop-trunk\hadoop-yarn-project\hadoop-yarn\hadoop-yarn-client\src\main\java\org\apache\hadoop\yarn\client\api\impl\SharedCacheClientImpl.java,118,22,1,3,0,26
 hadoop-trunk\hadoop-trunk\hadoop-yarn-project\hadoop-yarn\hadoop-yarn-server\hadoop-yarn-server-resourcemanager\src\test\java\org\apache\hadoop\yarn\server\resourcemanager\nodelabels\TestRMDelegatedNodeLabelsUpdater.java,118,24,1,2,1,28
 hadoop-trunk\hadoop-trunk\hadoop-hdfs-project\hadoop-hdfs\src\test\java\org\apache\hadoop\hdfs\server\namenode\ha\TestNNHealthCheck.java,118,12,0,5,1,18
 hadoop-trunk\hadoop-trunk\hadoop-hdfs-project\hadoop-hdfs\src\test\java\org\apache\hadoop\hdfs\TestDFSMkdirs.java,118,14,5,4,0,23
 hadoop-trunk\hadoop-trunk\hadoop-mapreduce-project\hadoop-mapreduce-examples\src\main\java\org\apache\hadoop\examples\Join.java,118,48,8,3,0,59
 hadoop-trunk\hadoop-trunk\hadoop-mapreduce-project\hadoop-mapreduce-client\hadoop-mapreduce-client-jobclient\src\test\java\org\apache\hadoop\mapred\pipes\CommonStub.java,118,21,2,3,1,27
 hadoop-trunk\hadoop-trunk\hadoop-yarn-project\hadoop-yarn\hadoop-yarn-common\src\main\java\org\apache\hadoop\yarn\api\records\impl\pb\ResourceTypeInfoPBImpl.java,118,28,37,1,0,66
 kafka-trunk\kafka-trunk\clients\src\main\java\org\apache\kafka\common\requests\FindCoordinatorRequest.java,118,0,56,17,3,76
 kafka-trunk\kafka-trunk\clients\src\test\java\org\apache\kafka\common\metrics\KafkaMbeanTest.java,118,0,7,12,0,19
 kafka-trunk\kafka-trunk\streams\src\main\java\org\apache\kafka\streams\processor\internals\GlobalStateUpdateTask.java,118,0,0,19,2,21
 kafka-trunk\kafka-trunk\connect\runtime\src\main\java\org\apache\kafka\connect\runtime\rest\InternalRequestSignature.java,118,0,4,12,2,18
 kafka-trunk\kafka-trunk\clients\src\test\java\org\apache\kafka\clients\consumer\ConsumerPartitionAssignorTest.java,118,0,0,17,0,17
 pulsar-master\pulsar-master\pulsar-broker\src\test\java\org\apache\pulsar\client\api\TokenAuthenticatedProducerConsumerTest.java,118,32,0,13,0,45
 pulsar-master\pulsar-master\tiered-storage\jcloud\src\main\java\org\apache\bookkeeper\mledger\offload\jcloud\impl\BlobStoreBackedInputStreamImpl.java,118,44,1,9,0,54
 pulsar-master\pulsar-master\pulsar-broker\src\test\java\org\apache\pulsar\broker\admin\v3\PackagesApiTest.java,118,28,1,19,0,48
 pulsar-master\pulsar-master\tests\integration\src\test\java\org\apache\pulsar\tests\integration\topologies\PulsarClusterSpec.java,118,23,0,2,0,25
 pulsar-master\pulsar-master\pulsar-broker\src\test\java\org\apache\pulsar\broker\service\schema\validator\SchemaRegistryServiceWithSchemaDataValidatorTest.java,118,26,0,15,0,41
 pulsar-master\pulsar-master\pulsar-broker-auth-athenz\src\main\java\org\apache\pulsar\broker\authentication\AuthenticationProviderAthenz.java,118,36,1,23,0,60
 rocketmq-develop\rocketmq-develop\broker\src\main\java\org\apache\rocketmq\broker\filter\ConsumerFilterData.java,118,70,0,5,2,77
 skywalking-master\skywalking-master\oap-server\server-storage-plugin\storage-influxdb-plugin\src\main\java\org\apache\skywalking\oap\server\storage\plugin\influxdb\query\LogQuery.java,118,22,0,28,0,50
 zookeeper-master\zookeeper-master\zookeeper-server\src\test\java\org\apache\zookeeper\server\quorum\auth\KerberosTestUtils.java,118,0,3,9,3,15
 zookeeper-master\zookeeper-master\zookeeper-server\src\test\java\org\apache\zookeeper\server\controller\ControllerConfigTest.java,118,0,17,10,14,41
 hadoop-trunk\hadoop-trunk\hadoop-yarn-project\hadoop-yarn\hadoop-yarn-server\hadoop-yarn-server-resourcemanager\src\main\java\org\apache\hadoop\yarn\server\resourcemanager\webapp\dao\UserMetricsInfo.java,119,67,3,2,0,72
 hadoop-trunk\hadoop-trunk\hadoop-common-project\hadoop-common\src\main\java\org\apache\hadoop\util\AsyncDiskService.java,119,43,4,1,0,48
 hadoop-trunk\hadoop-trunk\hadoop-yarn-project\hadoop-yarn\hadoop-yarn-applications\hadoop-yarn-applications-mawo\hadoop-yarn-applications-mawo-core\src\main\java\org\apache\hadoop\applications\mawo\server\common\TaskId.java,119,2,2,1,1,6
 hadoop-trunk\hadoop-trunk\hadoop-yarn-project\hadoop-yarn\hadoop-yarn-common\src\test\java\org\apache\hadoop\yarn\webapp\WebServicesTestUtils.java,119,49,2,5,0,56
 hadoop-trunk\hadoop-trunk\hadoop-common-project\hadoop-common\src\main\java\org\apache\hadoop\io\compress\BlockDecompressorStream.java,119,26,3,2,0,31
 hadoop-trunk\hadoop-trunk\hadoop-yarn-project\hadoop-yarn\hadoop-yarn-server\hadoop-yarn-server-common\src\test\java\org\apache\hadoop\yarn\server\federation\store\metrics\TestFederationStateStoreClientMetrics.java,119,16,0,1,0,17
 hadoop-trunk\hadoop-trunk\hadoop-common-project\hadoop-common\src\main\java\org\apache\hadoop\fs\TrashPolicy.java,119,29,3,2,0,34
 hadoop-trunk\hadoop-trunk\hadoop-yarn-project\hadoop-yarn\hadoop-yarn-client\src\main\java\org\apache\hadoop\yarn\client\cli\ClusterCLI.java,119,25,2,3,0,30
 hadoop-trunk\hadoop-trunk\hadoop-yarn-project\hadoop-yarn\hadoop-yarn-server\hadoop-yarn-server-resourcemanager\src\test\java\org\apache\hadoop\yarn\server\resourcemanager\placement\csmappingrule\TestMappingRule.java,119,21,3,1,0,25
 hadoop-trunk\hadoop-trunk\hadoop-yarn-project\hadoop-yarn\hadoop-yarn-server\hadoop-yarn-server-resourcemanager\src\test\java\org\apache\hadoop\yarn\server\resourcemanager\Task.java,119,93,5,2,5,105
 hadoop-trunk\hadoop-trunk\hadoop-hdfs-project\hadoop-hdfs\src\main\java\org\apache\hadoop\hdfs\qjournal\server\JournalNodeHttpServer.java,119,26,0,2,1,29
 hadoop-trunk\hadoop-trunk\hadoop-hdfs-project\hadoop-hdfs\src\main\java\org\apache\hadoop\hdfs\server\datanode\fsdataset\ReplicaInputStreams.java,119,58,2,1,2,63
 hadoop-trunk\hadoop-trunk\hadoop-common-project\hadoop-common\src\test\java\org\apache\hadoop\fs\viewfs\TestViewFsOverloadSchemeListStatus.java,119,8,4,1,3,16
 hadoop-trunk\hadoop-trunk\hadoop-common-project\hadoop-common\src\test\java\org\apache\hadoop\ha\TestHealthMonitor.java,119,39,3,1,1,44
 hadoop-trunk\hadoop-trunk\hadoop-yarn-project\hadoop-yarn\hadoop-yarn-server\hadoop-yarn-server-timelineservice\src\main\java\org\apache\hadoop\yarn\server\timelineservice\reader\filter\TimelineCompareFilter.java,119,42,1,1,0,44
 hadoop-trunk\hadoop-trunk\hadoop-tools\hadoop-rumen\src\test\java\org\apache\hadoop\tools\rumen\TestHistograms.java,119,26,4,4,0,34
 hadoop-trunk\hadoop-trunk\hadoop-yarn-project\hadoop-yarn\hadoop-yarn-applications\hadoop-yarn-services\hadoop-yarn-services-core\src\main\java\org\apache\hadoop\yarn\service\monitor\ComponentHealthThresholdMonitor.java,119,20,6,1,1,28
 hadoop-trunk\hadoop-trunk\hadoop-yarn-project\hadoop-yarn\hadoop-yarn-server\hadoop-yarn-server-resourcemanager\src\main\java\org\apache\hadoop\yarn\server\resourcemanager\scheduler\capacity\QueueManagementChange.java,119,44,5,1,2,52
 hadoop-trunk\hadoop-trunk\hadoop-hdfs-project\hadoop-hdfs-httpfs\src\test\java\org\apache\hadoop\test\TestDirHelper.java,119,26,1,15,3,45
 hadoop-trunk\hadoop-trunk\hadoop-common-project\hadoop-common\src\test\java\org\apache\hadoop\fs\shell\find\TestFilterExpression.java,119,21,2,1,7,31
 kafka-trunk\kafka-trunk\storage\src\generated\java\org\apache\kafka\server\log\remote\metadata\storage\generated\RemoteLogSegmentMetadataSnapshotRecordJsonConverter.java,119,0,0,38,0,38
 kafka-trunk\kafka-trunk\streams\src\test\java\org\apache\kafka\streams\kstream\internals\TransformerSupplierAdapterTest.java,119,0,2,23,2,27
 kafka-trunk\kafka-trunk\clients\src\test\java\org\apache\kafka\common\config\ConfigTransformerTest.java,119,0,2,13,0,15
 kafka-trunk\kafka-trunk\connect\runtime\src\main\java\org\apache\kafka\connect\runtime\RestartPlan.java,119,0,0,17,1,18
 kafka-trunk\kafka-trunk\connect\runtime\src\test\java\org\apache\kafka\connect\integration\MonitorableSinkConnector.java,119,0,4,16,1,21
 kafka-trunk\kafka-trunk\connect\runtime\src\main\java\org\apache\kafka\connect\storage\OffsetStorageReaderImpl.java,119,0,5,30,2,37
 kafka-trunk\kafka-trunk\streams\src\main\java\org\apache\kafka\streams\processor\internals\ThreadMetadataImpl.java,119,0,0,4,3,7
 kafka-trunk\kafka-trunk\raft\src\main\java\org\apache\kafka\raft\ResignedState.java,119,0,1,4,4,9
 kafka-trunk\kafka-trunk\clients\src\main\java\org\apache\kafka\common\requests\DescribeGroupsResponse.java,119,0,28,11,2,41
 kafka-trunk\kafka-trunk\clients\src\main\java\org\apache\kafka\common\metrics\stats\SampledStat.java,119,0,7,9,0,16
 pulsar-master\pulsar-master\pulsar-client\src\main\java\org\apache\pulsar\client\impl\schema\ProtobufNativeSchemaUtils.java,119,49,3,38,0,90
 pulsar-master\pulsar-master\pulsar-io\kinesis\src\test\java\org\apache\pulsar\io\kinesis\KinesisSinkAuthTest.java,119,29,1,17,0,47
 pulsar-master\pulsar-master\pulsar-config-validation\src\test\java\org\apache\pulsar\config\validation\ValidatorImplsTest.java,119,49,0,34,0,83
 pulsar-master\pulsar-master\pulsar-client-admin\src\main\java\org\apache\pulsar\client\admin\internal\LookupImpl.java,119,43,0,15,0,58
 rocketmq-develop\rocketmq-develop\common\src\test\java\org\apache\rocketmq\common\topic\TopicValidatorTest.java,119,24,3,11,0,38
 shardingsphere-master\shardingsphere-master\shardingsphere-features\shardingsphere-shadow\shardingsphere-shadow-distsql\shardingsphere-shadow-distsql-handler\src\main\java\org\apache\shardingsphere\shadow\distsql\handler\checker\ShadowRuleStatementChecker.java,119,54,1,37,0,92
 skywalking-master\skywalking-master\oap-server\server-library\library-datacarrier-queue\src\test\java\org\apache\skywalking\oap\server\library\datacarrier\DataCarrierTest.java,119,40,4,22,2,68
 skywalking-master\skywalking-master\oap-server\server-alarm-plugin\src\main\java\org\apache\skywalking\oap\server\core\alarm\provider\welink\WeLinkHookCallback.java,119,50,3,21,0,74
 skywalking-master\skywalking-master\oap-server\oal-rt\src\main\java\org\apache\skywalking\oal\rt\parser\DeepAnalysis.java,119,26,1,27,0,54
 skywalking-master\skywalking-master\oap-server\server-core\src\main\java\org\apache\skywalking\oap\server\core\analysis\manual\relation\endpoint\EndpointRelationServerSideMetrics.java,119,32,1,12,0,45
 zookeeper-master\zookeeper-master\zookeeper-server\src\main\java\org\apache\zookeeper\SaslServerPrincipal.java,119,0,2,11,0,13
 zookeeper-master\zookeeper-master\zookeeper-server\src\main\java\org\apache\zookeeper\server\auth\SaslServerCallbackHandler.java,119,0,2,20,0,22
 zookeeper-master\zookeeper-master\zookeeper-server\src\test\java\org\apache\zookeeper\server\quorum\EpochWriteFailureTest.java,119,0,4,18,2,24
 zookeeper-master\zookeeper-master\zookeeper-jute\src\main\java\org\apache\jute\compiler\JField.java,119,0,0,2,0,2
 druid-master\druid-master\extensions-contrib\influx-extensions\target\generated-sources\antlr4\org\apache\druid\data\input\influx\InfluxLineProtocolLexer.java,120,161,3,3,4,171
 dubbo-3.0\dubbo-3.0\dubbo-common\src\test\java\org\apache\dubbo\common\model\person\Phone.java,120,55,12,3,0,70
 dubbo-3.0\dubbo-3.0\dubbo-remoting\dubbo-remoting-netty4\src\main\java\org\apache\dubbo\remoting\transport\netty4\NettyClientHandler.java,120,45,0,16,0,61
 dubbo-3.0\dubbo-3.0\dubbo-remoting\dubbo-remoting-netty\src\test\java\org\apache\dubbo\remoting\transport\netty\ThreadNameTest.java,120,50,2,10,0,62
 dubbo-3.0\dubbo-3.0\dubbo-registry\dubbo-registry-api\src\test\java\org\apache\dubbo\registry\client\InstanceAddressURLTest.java,120,63,2,41,0,106
 dubbo-3.0\dubbo-3.0\dubbo-common\src\test\java\org\apache\dubbo\common\URLBuilderTest.java,120,18,2,8,2,30
 dubbo-3.0\dubbo-3.0\dubbo-common\src\test\java\org\apache\dubbo\rpc\model\person\Phone.java,120,55,12,3,0,70
 dubbo-3.0\dubbo-3.0\dubbo-common\src\main\java\org\apache\dubbo\rpc\model\ReflectionServiceDescriptor.java,120,54,1,19,0,74
 hadoop-trunk\hadoop-trunk\hadoop-mapreduce-project\hadoop-mapreduce-client\hadoop-mapreduce-client-core\src\main\java\org\apache\hadoop\mapred\TaskLogAppender.java,120,36,0,2,4,42
 hadoop-trunk\hadoop-trunk\hadoop-hdfs-project\hadoop-hdfs\src\main\java\org\apache\hadoop\hdfs\server\datanode\ReplicaUnderRecovery.java,120,46,2,2,4,54
 hadoop-trunk\hadoop-trunk\hadoop-hdfs-project\hadoop-hdfs\src\test\java\org\apache\hadoop\hdfs\server\datanode\metrics\TestDataNodeOutlierDetectionViaMetrics.java,120,18,2,1,0,21
 hadoop-trunk\hadoop-trunk\hadoop-yarn-project\hadoop-yarn\hadoop-yarn-server\hadoop-yarn-server-resourcemanager\src\test\java\org\apache\hadoop\yarn\server\resourcemanager\scheduler\capacity\TestQueueStateManager.java,120,19,2,3,5,29
 hadoop-trunk\hadoop-trunk\hadoop-yarn-project\hadoop-yarn\hadoop-yarn-applications\hadoop-yarn-services\hadoop-yarn-services-core\src\main\java\org\apache\hadoop\yarn\service\utils\ZookeeperUtils.java,120,31,3,5,0,39
 hadoop-trunk\hadoop-trunk\hadoop-common-project\hadoop-common\src\test\java\org\apache\hadoop\util\TestGenericsUtil.java,120,26,6,1,2,35
 hadoop-trunk\hadoop-trunk\hadoop-hdfs-project\hadoop-hdfs\src\test\java\org\apache\hadoop\hdfs\tools\TestViewFileSystemOverloadSchemeWithFSCommands.java,120,24,3,1,3,31
 hadoop-trunk\hadoop-trunk\hadoop-common-project\hadoop-common\src\main\java\org\apache\hadoop\net\SocksSocketFactory.java,120,40,8,2,3,53
 hadoop-trunk\hadoop-trunk\hadoop-yarn-project\hadoop-yarn\hadoop-yarn-applications\hadoop-yarn-services\hadoop-yarn-services-core\src\main\java\org\apache\hadoop\yarn\service\utils\ConfigHelper.java,120,24,1,4,0,29
 hadoop-trunk\hadoop-trunk\hadoop-mapreduce-project\hadoop-mapreduce-client\hadoop-mapreduce-client-core\src\main\java\org\apache\hadoop\mapreduce\lib\output\committer\manifest\stages\RenameFilesStage.java,120,6,2,9,1,18
 hadoop-trunk\hadoop-trunk\hadoop-yarn-project\hadoop-yarn\hadoop-yarn-server\hadoop-yarn-server-timelineservice\src\test\java\org\apache\hadoop\yarn\server\timelineservice\collector\TestNMTimelineCollectorManager.java,120,13,2,4,2,21
 hadoop-trunk\hadoop-trunk\hadoop-common-project\hadoop-common\src\main\java\org\apache\hadoop\util\bloom\Key.java,120,56,2,2,2,62
 hadoop-trunk\hadoop-trunk\hadoop-common-project\hadoop-common\src\test\java\org\apache\hadoop\fs\shell\TestFsShellConcat.java,120,23,3,1,8,35
 hadoop-trunk\hadoop-trunk\hadoop-hdfs-project\hadoop-hdfs-rbf\src\main\java\org\apache\hadoop\hdfs\server\federation\store\driver\impl\StateStoreFileImpl.java,120,20,4,1,0,25
 hadoop-trunk\hadoop-trunk\hadoop-mapreduce-project\hadoop-mapreduce-client\hadoop-mapreduce-client-core\src\test\java\org\apache\hadoop\mapred\lib\db\TestDBInputFormat.java,120,25,4,3,0,32
 hadoop-trunk\hadoop-trunk\hadoop-hdfs-project\hadoop-hdfs\src\test\java\org\apache\hadoop\hdfs\server\namenode\ha\TestQuotasWithHA.java,120,31,0,1,4,36
 hadoop-trunk\hadoop-trunk\hadoop-hdfs-project\hadoop-hdfs\src\test\java\org\apache\hadoop\hdfs\util\TestAtomicFileOutputStream.java,120,24,7,2,11,44
 hadoop-trunk\hadoop-trunk\hadoop-hdfs-project\hadoop-hdfs\src\test\java\org\apache\hadoop\hdfs\server\namenode\TestStartupOptionUpgrade.java,120,27,1,1,1,30
 kafka-trunk\kafka-trunk\streams\src\test\java\org\apache\kafka\streams\processor\internals\TaskMetadataImplTest.java,120,0,0,11,0,11
 pulsar-master\pulsar-master\tests\integration\src\test\java\org\apache\pulsar\tests\integration\io\sources\debezium\DebeziumPostgreSqlSourceTester.java,120,50,3,25,0,78
 pulsar-master\pulsar-master\pulsar-client-tools\src\main\java\org\apache\pulsar\admin\cli\CmdResourceGroups.java,120,23,0,10,0,33
 pulsar-master\pulsar-master\pulsar-client-tools\src\main\java\org\apache\pulsar\admin\cli\CmdNonPersistentTopics.java,120,31,0,20,0,51
 pulsar-master\pulsar-master\pulsar-broker-auth-athenz\src\test\java\org\apache\pulsar\broker\authentication\AuthenticationProviderAthenzTest.java,120,32,7,20,0,59
 pulsar-master\pulsar-master\pulsar-broker\src\test\java\org\apache\pulsar\broker\service\MessagePublishBufferThrottleTest.java,120,26,3,12,0,41
 pulsar-master\pulsar-master\pulsar-broker\src\test\java\org\apache\pulsar\broker\loadbalance\MultiBrokerLeaderElectionTest.java,120,31,2,19,0,52
 pulsar-master\pulsar-master\pulsar-io\hbase\src\test\java\org\apache\pulsar\io\hbase\sink\HbaseSinkConfigTest.java,120,12,0,3,0,15
 pulsar-master\pulsar-master\pulsar-client\src\main\java\org\apache\pulsar\client\impl\MessagePayloadContextImpl.java,120,35,3,13,0,51
 pulsar-master\pulsar-master\pulsar-broker\src\main\java\org\apache\pulsar\broker\service\plugin\EntryFilterProvider.java,120,37,4,26,0,67
 pulsar-master\pulsar-master\pulsar-metadata\src\test\java\org\apache\pulsar\metadata\MetadataBenchmark.java,120,38,9,10,0,57
 pulsar-master\pulsar-master\pulsar-client\src\main\java\org\apache\pulsar\client\impl\auth\AuthenticationDataTls.java,120,57,5,23,0,85
 pulsar-master\pulsar-master\pulsar-broker\src\test\java\org\apache\pulsar\broker\MultiBrokerBaseTest.java,120,36,2,18,0,56
 rocketmq-develop\rocketmq-develop\client\src\main\java\org\apache\rocketmq\client\hook\SendMessageContext.java,120,89,0,1,12,102
 skywalking-master\skywalking-master\oap-server\server-fetcher-plugin\kafka-fetcher-plugin\src\main\java\org\apache\skywalking\oap\server\analyzer\agent\kafka\KafkaFetcherHandlerRegister.java,120,41,2,17,0,60
 zookeeper-master\zookeeper-master\zookeeper-server\src\test\java\org\apache\zookeeper\audit\ZKAuditLoggerPerformance.java,120,0,5,3,1,9
 zookeeper-master\zookeeper-master\zookeeper-server\src\test\java\org\apache\zookeeper\server\persistence\TxnLogToolkitTest.java,120,0,10,15,9,34
 zookeeper-master\zookeeper-master\zookeeper-server\src\test\java\org\apache\zookeeper\server\quorum\auth\QuorumKerberosAuthTest.java,120,0,4,16,0,20
 hadoop-trunk\hadoop-trunk\hadoop-common-project\hadoop-common\src\main\java\org\apache\hadoop\io\DataInputBuffer.java,121,33,2,1,0,36
 hadoop-trunk\hadoop-trunk\hadoop-common-project\hadoop-common\src\test\java\org\apache\hadoop\util\TestReadWriteDiskValidator.java,121,7,2,1,4,14
 hadoop-trunk\hadoop-trunk\hadoop-yarn-project\hadoop-yarn\hadoop-yarn-common\src\main\java\org\apache\hadoop\yarn\api\protocolrecords\impl\pb\ReservationListResponsePBImpl.java,121,20,36,4,0,60
 hadoop-trunk\hadoop-trunk\hadoop-common-project\hadoop-auth\src\test\java\org\apache\hadoop\security\authentication\util\TestKerberosName.java,121,20,2,2,0,24
 hadoop-trunk\hadoop-trunk\hadoop-yarn-project\hadoop-yarn\hadoop-yarn-server\hadoop-yarn-server-common\src\main\java\org\apache\hadoop\yarn\server\metrics\OpportunisticSchedulerMetrics.java,121,54,1,1,3,59
 hadoop-trunk\hadoop-trunk\hadoop-hdfs-project\hadoop-hdfs-rbf\src\main\java\org\apache\hadoop\hdfs\server\federation\router\ConnectionContext.java,121,9,0,1,0,10
 hadoop-trunk\hadoop-trunk\hadoop-hdfs-project\hadoop-hdfs\src\test\java\org\apache\hadoop\hdfs\server\namenode\TestTruncateQuotaUpdate.java,121,16,6,1,0,23
 hadoop-trunk\hadoop-trunk\hadoop-mapreduce-project\hadoop-mapreduce-client\hadoop-mapreduce-client-jobclient\src\test\java\org\apache\hadoop\mapreduce\v2\TestRMNMInfo.java,121,24,5,2,2,33
 hadoop-trunk\hadoop-trunk\hadoop-hdfs-project\hadoop-hdfs\src\test\java\org\apache\hadoop\hdfs\server\datanode\TestBlockPoolSliceStorage.java,121,43,3,2,1,49
 hadoop-trunk\hadoop-trunk\hadoop-hdfs-project\hadoop-hdfs\src\test\java\org\apache\hadoop\hdfs\server\blockmanagement\TestStorageBlockPoolUsageStdDev.java,121,35,0,6,2,43
 hadoop-trunk\hadoop-trunk\hadoop-yarn-project\hadoop-yarn\hadoop-yarn-server\hadoop-yarn-server-common\src\main\java\org\apache\hadoop\yarn\server\api\protocolrecords\RegisterNodeManagerRequest.java,121,59,0,1,0,60
 hadoop-trunk\hadoop-trunk\hadoop-hdfs-project\hadoop-hdfs\src\test\java\org\apache\hadoop\hdfs\TestViewDistributedFileSystemWithMountLinks.java,121,10,0,4,0,14
 hadoop-trunk\hadoop-trunk\hadoop-hdfs-project\hadoop-hdfs\src\test\java\org\apache\hadoop\hdfs\qjournal\client\DirectExecutorService.java,121,40,0,1,4,45
 hadoop-trunk\hadoop-trunk\hadoop-yarn-project\hadoop-yarn\hadoop-yarn-server\hadoop-yarn-server-nodemanager\src\test\java\org\apache\hadoop\yarn\server\nodemanager\webapp\TestNMWebFilter.java,121,23,4,2,0,29
 hadoop-trunk\hadoop-trunk\hadoop-yarn-project\hadoop-yarn\hadoop-yarn-server\hadoop-yarn-server-resourcemanager\src\main\java\org\apache\hadoop\yarn\server\resourcemanager\scheduler\activities\ActivityNode.java,121,56,2,2,3,63
 hadoop-trunk\hadoop-trunk\hadoop-tools\hadoop-aws\src\main\java\org\apache\hadoop\fs\s3a\statistics\BlockOutputStreamStatistics.java,121,2,0,1,0,3
 hadoop-trunk\hadoop-trunk\hadoop-tools\hadoop-rumen\src\main\java\org\apache\hadoop\tools\rumen\Node.java,121,32,4,2,1,39
 hadoop-trunk\hadoop-trunk\hadoop-hdfs-project\hadoop-hdfs\src\test\java\org\apache\hadoop\hdfs\server\datanode\TestDataNodePeerMetrics.java,121,18,4,3,1,26
 hadoop-trunk\hadoop-trunk\hadoop-mapreduce-project\hadoop-mapreduce-client\hadoop-mapreduce-client-app\src\main\java\org\apache\hadoop\mapreduce\v2\app\webapp\SingleCounterBlock.java,121,29,1,2,0,32
 hadoop-trunk\hadoop-trunk\hadoop-tools\hadoop-aws\src\main\java\org\apache\hadoop\fs\s3a\S3ListResult.java,121,17,2,1,0,20
 hadoop-trunk\hadoop-trunk\hadoop-hdfs-project\hadoop-hdfs\src\test\java\org\apache\hadoop\hdfs\server\blockmanagement\TestCachedBlocksList.java,121,46,7,4,0,57
 hadoop-trunk\hadoop-trunk\hadoop-yarn-project\hadoop-yarn\hadoop-yarn-common\src\main\java\org\apache\hadoop\yarn\api\protocolrecords\impl\pb\FinishApplicationMasterRequestPBImpl.java,121,36,47,9,0,92
 hadoop-trunk\hadoop-trunk\hadoop-yarn-project\hadoop-yarn\hadoop-yarn-common\src\main\java\org\apache\hadoop\yarn\api\records\impl\pb\RejectedSchedulingRequestPBImpl.java,121,23,38,1,0,62
 hadoop-trunk\hadoop-trunk\hadoop-mapreduce-project\hadoop-mapreduce-client\hadoop-mapreduce-client-nativetask\src\main\java\org\apache\hadoop\mapred\nativetask\buffer\ByteBufferDataReader.java,121,36,2,1,0,39
 hadoop-trunk\hadoop-trunk\hadoop-yarn-project\hadoop-yarn\hadoop-yarn-server\hadoop-yarn-server-resourcemanager\src\main\java\org\apache\hadoop\yarn\server\resourcemanager\reservation\planning\StageAllocatorGreedy.java,121,11,2,5,1,19
 hadoop-trunk\hadoop-trunk\hadoop-tools\hadoop-dynamometer\hadoop-dynamometer-infra\src\main\java\org\apache\hadoop\tools\dynamometer\SimulatedDataNodes.java,121,11,9,2,0,22
 hadoop-trunk\hadoop-trunk\hadoop-hdfs-project\hadoop-hdfs\src\main\java\org\apache\hadoop\hdfs\server\namenode\ContentCounts.java,121,56,2,2,0,60
 hadoop-trunk\hadoop-trunk\hadoop-common-project\hadoop-common\src\test\java\org\apache\hadoop\net\StaticMapping.java,121,19,1,2,0,22
 hadoop-trunk\hadoop-trunk\hadoop-common-project\hadoop-common\src\main\java\org\apache\hadoop\util\NativeLibraryChecker.java,121,11,9,2,0,22
 kafka-trunk\kafka-trunk\clients\src\main\java\org\apache\kafka\common\utils\AppInfoParser.java,121,0,5,14,1,20
 kafka-trunk\kafka-trunk\streams\src\test\java\org\apache\kafka\streams\utils\UniqueTopicSerdeScope.java,121,0,0,16,2,18
 pulsar-master\pulsar-master\pulsar-common\src\test\java\org\apache\pulsar\common\nar\NarUnpackerTest.java,121,28,2,7,0,37
 pulsar-master\pulsar-master\pulsar-io\hdfs3\src\test\java\org\apache\pulsar\io\hdfs3\sink\HdfsSinkConfigTests.java,121,49,1,3,0,53
 pulsar-master\pulsar-master\pulsar-client\src\test\java\org\apache\pulsar\client\impl\RoundRobinPartitionMessageRouterImplTest.java,121,42,1,13,0,56
 pulsar-master\pulsar-master\pulsar-proxy\src\main\java\org\apache\pulsar\proxy\server\BrokerDiscoveryProvider.java,121,52,3,27,0,82
 pulsar-master\pulsar-master\tiered-storage\jcloud\src\test\java\org\apache\bookkeeper\mledger\offload\jcloud\impl\BlobStoreManagedLedgerOffloaderBase.java,121,62,0,24,0,86
 pulsar-master\pulsar-master\pulsar-broker\src\test\java\org\apache\pulsar\broker\service\BrokerServiceAutoSubscriptionCreationTest.java,121,35,2,29,0,66
 rocketmq-develop\rocketmq-develop\test\src\test\java\org\apache\rocketmq\test\client\consumer\tag\MulTagSubIT.java,121,28,1,12,4,45
 rocketmq-develop\rocketmq-develop\tools\src\main\java\org\apache\rocketmq\tools\command\message\QueryMsgTraceByIdSubCommand.java,121,24,0,11,3,38
 skywalking-master\skywalking-master\oap-server\server-core\src\main\java\org\apache\skywalking\oap\server\core\query\ServiceInstanceTopologyBuilder.java,121,32,0,26,0,58
 zookeeper-master\zookeeper-master\zookeeper-server\src\main\java\org\apache\zookeeper\server\controller\ControllerServerConfig.java,121,0,2,14,0,16
 dubbo-3.0\dubbo-3.0\dubbo-cluster\src\main\java\org\apache\dubbo\rpc\cluster\router\AbstractRouterRule.java,122,72,0,1,0,73
 dubbo-3.0\dubbo-3.0\dubbo-common\src\main\java\org\apache\dubbo\common\utils\SerializeClassChecker.java,122,46,3,20,1,70
 hadoop-trunk\hadoop-trunk\hadoop-common-project\hadoop-common\src\test\java\org\apache\hadoop\fs\contract\AbstractContractUnbufferTest.java,122,24,0,2,3,29
 hadoop-trunk\hadoop-trunk\hadoop-common-project\hadoop-common\src\test\java\org\apache\hadoop\io\retry\TestConnectionRetryPolicy.java,122,9,1,1,0,11
 hadoop-trunk\hadoop-trunk\hadoop-hdfs-project\hadoop-hdfs\src\test\java\org\apache\hadoop\tools\TestJMXGet.java,122,35,14,8,3,60
 hadoop-trunk\hadoop-trunk\hadoop-yarn-project\hadoop-yarn\hadoop-yarn-server\hadoop-yarn-server-timelineservice\src\test\java\org\apache\hadoop\yarn\server\timelineservice\reader\TestTimelineReaderWebServicesACL.java,122,34,1,3,1,39
 hadoop-trunk\hadoop-trunk\hadoop-common-project\hadoop-common\src\main\java\org\apache\hadoop\metrics2\lib\MetricsSourceBuilder.java,122,47,8,4,1,60
 hadoop-trunk\hadoop-trunk\hadoop-mapreduce-project\hadoop-mapreduce-client\hadoop-mapreduce-client-core\src\main\java\org\apache\hadoop\mapreduce\lib\db\DBInputFormat.java,122,96,17,3,4,120
 hadoop-trunk\hadoop-trunk\hadoop-mapreduce-project\hadoop-mapreduce-client\hadoop-mapreduce-client-core\src\main\java\org\apache\hadoop\mapreduce\jobhistory\TaskAttemptStartedEvent.java,122,67,35,1,0,103
 hadoop-trunk\hadoop-trunk\hadoop-yarn-project\hadoop-yarn\hadoop-yarn-common\src\main\java\org\apache\hadoop\yarn\api\records\impl\pb\CollectorInfoPBImpl.java,122,24,39,1,0,64
 hadoop-trunk\hadoop-trunk\hadoop-tools\hadoop-streaming\src\main\java\org\apache\hadoop\streaming\PipeMapper.java,122,43,8,8,2,61
 hadoop-trunk\hadoop-trunk\hadoop-yarn-project\hadoop-yarn\hadoop-yarn-server\hadoop-yarn-server-resourcemanager\src\main\java\org\apache\hadoop\yarn\server\resourcemanager\RMServiceContext.java,122,67,0,4,9,80
 hadoop-trunk\hadoop-trunk\hadoop-yarn-project\hadoop-yarn\hadoop-yarn-api\src\main\java\org\apache\hadoop\yarn\api\records\ApplicationId.java,122,35,7,1,0,43
 hadoop-trunk\hadoop-trunk\hadoop-mapreduce-project\hadoop-mapreduce-client\hadoop-mapreduce-client-jobclient\src\test\java\org\apache\hadoop\mapred\join\TestWrappedRecordReaderClassloader.java,122,56,8,3,1,68
 hadoop-trunk\hadoop-trunk\hadoop-hdfs-project\hadoop-hdfs\src\main\java\org\apache\hadoop\hdfs\server\namenode\INodeSymlink.java,122,52,0,6,1,59
 hadoop-trunk\hadoop-trunk\hadoop-hdfs-project\hadoop-hdfs\src\test\java\org\apache\hadoop\hdfs\server\namenode\ha\HAStressTestHarness.java,122,29,0,5,1,35
 hadoop-trunk\hadoop-trunk\hadoop-common-project\hadoop-common\src\test\java\org\apache\hadoop\ha\TestZKFailoverControllerStress.java,122,36,3,1,6,46
 hadoop-trunk\hadoop-trunk\hadoop-hdfs-project\hadoop-hdfs\src\test\java\org\apache\hadoop\fs\viewfs\TestViewFsHdfs.java,122,16,2,1,0,19
 hadoop-trunk\hadoop-trunk\hadoop-mapreduce-project\hadoop-mapreduce-client\hadoop-mapreduce-client-jobclient\src\test\java\org\apache\hadoop\mapred\TestMultipleTextOutputFormat.java,122,74,10,12,1,97
 hadoop-trunk\hadoop-trunk\hadoop-common-project\hadoop-common\src\test\java\org\apache\hadoop\metrics2\lib\TestMetricsRegistry.java,122,48,4,1,6,59
 kafka-trunk\kafka-trunk\clients\src\test\java\org\apache\kafka\common\serialization\ListSerializerTest.java,122,0,1,32,1,34
 kafka-trunk\kafka-trunk\generator\src\test\java\org\apache\kafka\message\StructRegistryTest.java,122,0,0,31,0,31
 kafka-trunk\kafka-trunk\streams\src\test\java\org\apache\kafka\streams\integration\EmitOnChangeIntegrationTest.java,122,0,1,12,5,18
 kafka-trunk\kafka-trunk\connect\api\src\main\java\org\apache\kafka\connect\sink\SinkTask.java,122,0,3,42,0,45
 kafka-trunk\kafka-trunk\connect\api\src\test\java\org\apache\kafka\connect\source\SourceConnectorTest.java,122,0,1,7,0,8
 kafka-trunk\kafka-trunk\clients\src\test\java\org\apache\kafka\common\security\oauthbearer\internals\unsecured\OAuthBearerUnsecuredLoginCallbackHandlerTest.java,122,0,1,32,0,33
 kafka-trunk\kafka-trunk\clients\src\generated\java\org\apache\kafka\common\message\ConsumerProtocolSubscriptionJsonConverter.java,122,0,0,28,0,28
 kafka-trunk\kafka-trunk\clients\src\test\java\org\apache\kafka\common\requests\DescribeAclsResponseTest.java,122,0,3,21,0,24
 kafka-trunk\kafka-trunk\connect\runtime\src\test\java\org\apache\kafka\connect\integration\ConnectorClientPolicyIntegrationTest.java,122,0,1,24,0,25
 kafka-trunk\kafka-trunk\streams\src\main\java\org\apache\kafka\streams\kstream\internals\foreignkeyjoin\SubscriptionResponseWrapperSerde.java,122,0,1,17,2,20
 kafka-trunk\kafka-trunk\streams\src\test\java\org\apache\kafka\streams\tests\BrokerCompatibilityTest.java,122,0,5,30,0,35
 pulsar-master\pulsar-master\pulsar-io\hbase\src\test\java\org\apache\pulsar\io\hbase\sink\HbaseGenericRecordSinkTest.java,122,32,2,10,0,44
 pulsar-master\pulsar-master\pulsar-metadata\src\main\java\org\apache\pulsar\metadata\impl\EtcdSessionWatcher.java,122,37,1,17,0,55
 pulsar-master\pulsar-master\pulsar-sql\presto-pulsar\src\test\java\org\apache\pulsar\sql\presto\TestCacheSizeAllocator.java,122,33,4,20,0,57
 pulsar-master\pulsar-master\pulsar-broker\src\test\java\org\apache\pulsar\client\impl\MessageParserTest.java,122,33,0,11,0,44
 pulsar-master\pulsar-master\pulsar-broker\src\test\java\org\apache\pulsar\broker\admin\IncrementPartitionsTest.java,122,44,3,25,0,72
 pulsar-master\pulsar-master\pulsar-sql\presto-pulsar\src\main\java\org\apache\pulsar\sql\presto\decoder\json\PulsarJsonRowDecoderFactory.java,122,37,2,22,0,61
 pulsar-master\pulsar-master\pulsar-sql\presto-pulsar\src\main\java\org\apache\pulsar\sql\presto\decoder\avro\PulsarAvroRowDecoderFactory.java,122,42,2,24,0,68
 rocketmq-develop\rocketmq-develop\test\src\main\java\org\apache\rocketmq\test\util\VerifyUtils.java,122,54,5,12,0,71
 skywalking-master\skywalking-master\oap-server\server-core\src\main\java\org\apache\skywalking\oap\server\core\analysis\metrics\DataTable.java,122,47,1,5,0,53
 skywalking-master\skywalking-master\oap-server\server-tools\profile-exporter\tool-profile-snapshot-server-mock\src\main\java\org\apache\skywalking\oap\server\tool\profile\core\MockCoreModuleProvider.java,122,45,1,46,0,92
 skywalking-master\skywalking-master\oap-server\server-storage-plugin\storage-elasticsearch-plugin\src\main\java\org\apache\skywalking\oap\server\storage\plugin\elasticsearch\query\UITemplateManagementEsDAO.java,122,32,2,32,0,66
 zookeeper-master\zookeeper-master\zookeeper-server\src\test\java\org\apache\zookeeper\test\SaslSuperUserTest.java,122,0,20,19,0,39
 zookeeper-master\zookeeper-master\zookeeper-server\src\test\java\org\apache\zookeeper\server\quorum\QuorumServerTest.java,122,0,2,18,0,20
 hadoop-trunk\hadoop-trunk\hadoop-yarn-project\hadoop-yarn\hadoop-yarn-server\hadoop-yarn-server-nodemanager\src\main\java\org\apache\hadoop\yarn\server\nodemanager\amrmproxy\AMRMProxyApplicationContextImpl.java,123,41,0,1,16,58
 hadoop-trunk\hadoop-trunk\hadoop-hdfs-project\hadoop-hdfs\src\test\java\org\apache\hadoop\cli\TestCryptoAdminCLI.java,123,25,1,1,2,29
 hadoop-trunk\hadoop-trunk\hadoop-yarn-project\hadoop-yarn\hadoop-yarn-common\src\main\java\org\apache\hadoop\yarn\api\records\impl\pb\ReservationRequestPBImpl.java,123,32,48,1,0,81
 hadoop-trunk\hadoop-trunk\hadoop-hdfs-project\hadoop-hdfs-httpfs\src\test\java\org\apache\hadoop\test\TestHTestCase.java,123,32,1,3,5,41
 hadoop-trunk\hadoop-trunk\hadoop-hdfs-project\hadoop-hdfs\src\test\java\org\apache\hadoop\hdfs\server\blockmanagement\TestHostFileManager.java,123,19,26,1,0,46
 hadoop-trunk\hadoop-trunk\hadoop-mapreduce-project\hadoop-mapreduce-client\hadoop-mapreduce-client-shuffle\src\test\java\org\apache\hadoop\mapred\TestFadvisedFileRegion.java,123,62,5,1,6,74
 hadoop-trunk\hadoop-trunk\hadoop-mapreduce-project\hadoop-mapreduce-client\hadoop-mapreduce-client-core\src\main\java\org\apache\hadoop\mapreduce\jobhistory\TaskFinishedEvent.java,123,54,26,1,0,81
 hadoop-trunk\hadoop-trunk\hadoop-hdfs-project\hadoop-hdfs\src\test\java\org\apache\hadoop\hdfs\server\namenode\TestEditLogFileOutputStream.java,123,24,4,2,2,32
 hadoop-trunk\hadoop-trunk\hadoop-common-project\hadoop-common\src\test\java\org\apache\hadoop\io\TestBoundedByteArrayOutputStream.java,123,35,9,1,3,48
 hadoop-trunk\hadoop-trunk\hadoop-yarn-project\hadoop-yarn\hadoop-yarn-server\hadoop-yarn-server-nodemanager\src\main\java\org\apache\hadoop\yarn\server\nodemanager\containermanager\linux\runtime\runc\HdfsManifestToResourcesPlugin.java,123,33,0,9,1,43
 hadoop-trunk\hadoop-trunk\hadoop-yarn-project\hadoop-yarn\hadoop-yarn-server\hadoop-yarn-server-common\src\main\java\org\apache\hadoop\yarn\server\federation\store\records\SubClusterPolicyConfiguration.java,123,12,1,1,0,14
 hadoop-trunk\hadoop-trunk\hadoop-mapreduce-project\hadoop-mapreduce-client\hadoop-mapreduce-client-jobclient\src\test\java\org\apache\hadoop\mapreduce\TestCounters.java,123,29,7,1,1,38
 hadoop-trunk\hadoop-trunk\hadoop-mapreduce-project\hadoop-mapreduce-client\hadoop-mapreduce-client-core\src\main\java\org\apache\hadoop\mapreduce\lib\output\BindingPathOutputCommitter.java,123,32,0,1,1,34
 hadoop-trunk\hadoop-trunk\hadoop-mapreduce-project\hadoop-mapreduce-examples\src\test\java\org\apache\hadoop\examples\pi\math\TestSummation.java,123,50,11,3,1,65
 hadoop-trunk\hadoop-trunk\hadoop-hdfs-project\hadoop-hdfs\src\test\java\org\apache\hadoop\hdfs\server\blockmanagement\TestAvailableSpaceBPPBalanceLocal.java,123,36,1,4,0,41
 hadoop-trunk\hadoop-trunk\hadoop-hdfs-project\hadoop-hdfs\src\test\java\org\apache\hadoop\hdfs\server\datanode\TestCorruptMetadataFile.java,123,16,8,1,5,30
 hadoop-trunk\hadoop-trunk\hadoop-yarn-project\hadoop-yarn\hadoop-yarn-server\hadoop-yarn-server-resourcemanager\src\test\java\org\apache\hadoop\yarn\server\resourcemanager\webapp\TestRMWebServicesAppCustomResourceTypes.java,123,12,0,9,0,21
 kafka-trunk\kafka-trunk\clients\src\generated\java\org\apache\kafka\common\message\EndQuorumEpochResponseDataJsonConverter.java,123,0,0,29,0,29
 kafka-trunk\kafka-trunk\clients\src\test\java\org\apache\kafka\common\metrics\stats\FrequenciesTest.java,123,0,0,11,0,11
 kafka-trunk\kafka-trunk\clients\src\generated\java\org\apache\kafka\common\message\BeginQuorumEpochResponseDataJsonConverter.java,123,0,0,30,0,30
 kafka-trunk\kafka-trunk\clients\src\test\java\org\apache\kafka\common\security\authenticator\TestJaasConfig.java,123,0,5,17,0,22
 kafka-trunk\kafka-trunk\streams\src\main\java\org\apache\kafka\streams\state\StreamsMetadata.java,123,0,0,15,4,19
 kafka-trunk\kafka-trunk\streams\src\test\java\org\apache\kafka\streams\state\internals\SessionStoreBuilderTest.java,123,0,0,14,2,16
 kafka-trunk\kafka-trunk\streams\src\test\java\org\apache\kafka\streams\state\internals\MergedSortedCacheWrappedSessionStoreIteratorTest.java,123,0,0,39,2,41
 LittleBooks-master\LittleBooks-master\app\src\main\java\com\example\littlebooks\Login.java,123,53,4,16,0,73
 pulsar-master\pulsar-master\pulsar-broker\src\main\java\org\apache\pulsar\broker\loadbalance\impl\ThresholdShedder.java,123,53,1,42,0,96
 pulsar-master\pulsar-master\pulsar-broker\src\test\java\org\apache\pulsar\broker\admin\AdminApiHealthCheckTest.java,123,23,0,13,0,36
 pulsar-master\pulsar-master\pulsar-broker\src\test\java\org\apache\pulsar\utils\StatsOutputStreamTest.java,123,17,0,2,0,19
 pulsar-master\pulsar-master\pulsar-config-validation\src\main\java\org\apache\pulsar\config\validation\ConfigValidationAnnotations.java,123,40,0,11,0,51
 pulsar-master\pulsar-master\pulsar-broker-common\src\main\java\org\apache\pulsar\broker\resources\ClusterResources.java,123,95,0,27,0,122
 pulsar-master\pulsar-master\pulsar-broker\src\main\java\org\apache\pulsar\broker\stats\DimensionStats.java,123,68,2,11,0,81
 pulsar-master\pulsar-master\pulsar-broker\src\test\java\org\apache\pulsar\broker\protocol\ProtocolHandlersTest.java,123,35,9,6,0,50
 pulsar-master\pulsar-master\tests\integration\src\test\java\org\apache\pulsar\tests\integration\transaction\TransactionTest.java,123,24,1,19,0,44
 skywalking-master\skywalking-master\oap-server\server-core\src\main\java\org\apache\skywalking\oap\server\core\analysis\manual\relation\service\ServiceRelationClientSideMetrics.java,123,37,1,17,0,55
 skywalking-master\skywalking-master\oap-server\server-storage-plugin\storage-elasticsearch-plugin\src\main\java\org\apache\skywalking\oap\server\storage\plugin\elasticsearch\base\IndexStructures.java,123,42,1,9,0,52
 skywalking-master\skywalking-master\oap-server\server-fetcher-plugin\prometheus-fetcher-plugin\src\main\java\org\apache\skywalking\oap\server\fetcher\prometheus\provider\PrometheusFetcherProvider.java,123,34,1,26,0,61
 zookeeper-master\zookeeper-master\zookeeper-jute\src\main\java\org\apache\jute\BinaryOutputArchive.java,123,0,6,1,1,8
 zookeeper-master\zookeeper-master\zookeeper-server\src\test\java\org\apache\zookeeper\server\CRCTest.java,123,0,8,8,1,17
 zookeeper-master\zookeeper-master\zookeeper-server\src\main\java\org\apache\zookeeper\server\util\BitHashSet.java,123,0,0,1,0,1
 dubbo-3.0\dubbo-3.0\dubbo-cluster\src\main\java\org\apache\dubbo\rpc\cluster\configurator\AbstractConfigurator.java,124,35,1,22,0,58
 dubbo-3.0\dubbo-3.0\dubbo-config\dubbo-config-api\src\test\java\org\apache\dubbo\config\utils\ReferenceCacheTest.java,124,27,0,15,0,42
 hadoop-trunk\hadoop-trunk\hadoop-mapreduce-project\hadoop-mapreduce-client\hadoop-mapreduce-client-core\src\test\java\org\apache\hadoop\mapreduce\lib\db\TestSplitters.java,124,56,6,3,0,65
 hadoop-trunk\hadoop-trunk\hadoop-hdfs-project\hadoop-hdfs\src\test\java\org\apache\hadoop\hdfs\TestPipelines.java,124,31,7,6,1,45
 hadoop-trunk\hadoop-trunk\hadoop-hdfs-project\hadoop-hdfs\src\test\java\org\apache\hadoop\hdfs\server\namenode\ha\TestMultiObserverNode.java,124,26,0,2,0,28
 hadoop-trunk\hadoop-trunk\hadoop-yarn-project\hadoop-yarn\hadoop-yarn-server\hadoop-yarn-server-web-proxy\src\main\java\org\apache\hadoop\yarn\server\webproxy\WebAppProxy.java,124,38,1,3,0,42
 hadoop-trunk\hadoop-trunk\hadoop-yarn-project\hadoop-yarn\hadoop-yarn-server\hadoop-yarn-server-nodemanager\src\main\java\org\apache\hadoop\yarn\server\nodemanager\containermanager\resourceplugin\gpu\GpuResourcePlugin.java,124,28,1,12,1,42
 hadoop-trunk\hadoop-trunk\hadoop-hdfs-project\hadoop-hdfs\src\main\java\org\apache\hadoop\hdfs\server\namenode\top\metrics\TopMetrics.java,124,36,4,4,0,44
 hadoop-trunk\hadoop-trunk\hadoop-mapreduce-project\hadoop-mapreduce-client\hadoop-mapreduce-client-jobclient\src\test\java\org\apache\hadoop\mapred\lib\TestKeyFieldBasedComparator.java,124,38,8,3,11,60
 hadoop-trunk\hadoop-trunk\hadoop-yarn-project\hadoop-yarn\hadoop-yarn-common\src\main\java\org\apache\hadoop\yarn\api\protocolrecords\impl\pb\GetClusterNodesRequestPBImpl.java,124,31,39,4,0,74
 hadoop-trunk\hadoop-trunk\hadoop-tools\hadoop-aws\src\test\java\org\apache\hadoop\fs\s3a\ITestS3AAWSCredentialsProvider.java,124,17,11,3,1,32
 hadoop-trunk\hadoop-trunk\hadoop-tools\hadoop-streaming\src\main\java\org\apache\hadoop\streaming\PipeReducer.java,124,39,12,5,2,58
 hadoop-trunk\hadoop-trunk\hadoop-yarn-project\hadoop-yarn\hadoop-yarn-server\hadoop-yarn-server-tests\src\test\java\org\apache\hadoop\yarn\server\TestMiniYarnCluster.java,124,17,9,1,0,27
 hadoop-trunk\hadoop-trunk\hadoop-mapreduce-project\hadoop-mapreduce-client\hadoop-mapreduce-client-core\src\main\java\org\apache\hadoop\mapreduce\lib\join\CompositeInputSplit.java,124,28,5,1,2,36
 hadoop-trunk\hadoop-trunk\hadoop-hdfs-project\hadoop-hdfs-rbf\src\test\java\org\apache\hadoop\hdfs\server\federation\router\TestRouterWebHdfsMethods.java,124,17,2,3,1,23
 hadoop-trunk\hadoop-trunk\hadoop-hdfs-project\hadoop-hdfs\src\test\java\org\apache\hadoop\hdfs\TestAppendDifferentChecksum.java,124,36,1,1,2,40
 hadoop-trunk\hadoop-trunk\hadoop-tools\hadoop-gridmix\src\test\java\org\apache\hadoop\mapred\gridmix\DummyResourceCalculatorPlugin.java,124,13,0,1,0,14
 hadoop-trunk\hadoop-trunk\hadoop-hdfs-project\hadoop-hdfs\src\test\java\org\apache\hadoop\fs\TestUnbuffer.java,124,11,6,1,1,19
 hadoop-trunk\hadoop-trunk\hadoop-yarn-project\hadoop-yarn\hadoop-yarn-server\hadoop-yarn-server-nodemanager\src\test\java\org\apache\hadoop\yarn\server\nodemanager\TestEventFlow.java,124,16,2,7,4,29
 hadoop-trunk\hadoop-trunk\hadoop-tools\hadoop-aws\src\test\java\org\apache\hadoop\fs\s3a\performance\ITestS3AMiscOperationCost.java,124,8,5,4,1,18
 hadoop-trunk\hadoop-trunk\hadoop-common-project\hadoop-common\src\test\java\org\apache\hadoop\fs\TestQuotaUsage.java,124,31,4,1,0,36
 hadoop-trunk\hadoop-trunk\hadoop-tools\hadoop-azure\src\test\java\org\apache\hadoop\fs\azurebfs\utils\TracingHeaderValidator.java,124,55,0,3,0,58
 hadoop-trunk\hadoop-trunk\hadoop-yarn-project\hadoop-yarn\hadoop-yarn-server\hadoop-yarn-server-timelineservice-hbase\hadoop-yarn-server-timelineservice-hbase-client\src\main\java\org\apache\hadoop\yarn\server\timelineservice\storage\reader\AbstractTimelineStorageReader.java,124,27,0,6,1,34
 hadoop-trunk\hadoop-trunk\hadoop-common-project\hadoop-common\src\test\java\org\apache\hadoop\io\TestMD5Hash.java,124,113,4,3,6,126
 kafka-trunk\kafka-trunk\clients\src\generated\java\org\apache\kafka\common\message\DeleteTopicsRequestDataJsonConverter.java,124,0,0,23,0,23
 kafka-trunk\kafka-trunk\examples\src\main\java\kafka\examples\KafkaExactlyOnceDemo.java,124,0,1,30,0,31
 kafka-trunk\kafka-trunk\clients\src\generated\java\org\apache\kafka\common\message\DeleteTopicsResponseDataJsonConverter.java,124,0,0,23,0,23
 kafka-trunk\kafka-trunk\metadata\src\test\java\org\apache\kafka\metalog\LocalLogManagerTest.java,124,0,1,14,1,16
 kafka-trunk\kafka-trunk\clients\src\main\java\org\apache\kafka\common\config\ConfigTransformer.java,124,0,0,31,1,32
 kafka-trunk\kafka-trunk\streams\src\test\java\org\apache\kafka\streams\integration\SmokeTestDriverIntegrationTest.java,124,0,0,13,0,13
 pulsar-master\pulsar-master\pulsar-io\hdfs2\src\test\java\org\apache\pulsar\io\hdfs2\sink\HdfsSinkConfigTests.java,124,49,1,3,0,53
 pulsar-master\pulsar-master\pulsar-metadata\src\main\java\org\apache\pulsar\metadata\impl\batching\AbstractBatchedMetadataStore.java,124,32,1,9,0,42
 pulsar-master\pulsar-master\pulsar-broker\src\main\java\org\apache\pulsar\broker\intercept\BrokerInterceptorUtils.java,124,37,2,25,0,64
 pulsar-master\pulsar-master\tests\integration\src\test\java\org\apache\pulsar\tests\integration\functions\PulsarFunctionsTestBase.java,124,50,0,12,0,62
 pulsar-master\pulsar-master\pulsar-broker\src\main\java\org\apache\pulsar\broker\intercept\BrokerInterceptorWithClassLoader.java,124,75,0,22,0,97
 pulsar-master\pulsar-master\pulsar-common\src\test\java\org\apache\pulsar\common\compression\Crc32cChecksumTest.java,124,26,1,13,0,40
 pulsar-master\pulsar-master\pulsar-broker\src\test\java\org\apache\pulsar\broker\service\PublishRateLimiterTest.java,124,65,7,27,0,99
 pulsar-master\pulsar-master\pulsar-broker-common\src\main\java\org\apache\pulsar\broker\web\plugin\servlet\AdditionalServletUtils.java,124,35,2,23,0,60
 pulsar-master\pulsar-master\managed-ledger\src\main\java\org\apache\bookkeeper\mledger\impl\ReadOnlyManagedLedgerImpl.java,124,53,0,38,0,91
 rocketmq-develop\rocketmq-develop\common\src\main\java\org\apache\rocketmq\common\utils\IOTinyUtils.java,124,37,3,6,2,48
 skywalking-master\skywalking-master\oap-server\server-storage-plugin\storage-elasticsearch-plugin\src\main\java\org\apache\skywalking\oap\server\storage\plugin\elasticsearch\query\LogQueryEsDAO.java,124,25,0,28,0,53
 skywalking-master\skywalking-master\oap-server\server-storage-plugin\storage-elasticsearch-plugin\src\main\java\org\apache\skywalking\oap\server\storage\plugin\elasticsearch\base\TimeSeriesUtils.java,124,68,1,29,0,98
 zookeeper-master\zookeeper-master\zookeeper-server\src\test\java\org\apache\zookeeper\common\JKSFileLoaderTest.java,124,0,0,29,0,29
 dubbo-3.0\dubbo-3.0\dubbo-compatible\src\test\java\org\apache\dubbo\config\ProtocolConfigTest.java,125,25,0,1,0,26
 dubbo-3.0\dubbo-3.0\dubbo-cluster\src\main\java\org\apache\dubbo\rpc\cluster\router\script\ScriptStateRouter.java,125,58,4,15,0,77
 dubbo-3.0\dubbo-3.0\dubbo-cluster\src\test\java\org\apache\dubbo\rpc\cluster\router\mesh\rule\virtualservice\match\DubboMethodMatchTest.java,125,22,0,11,0,33
 dubbo-3.0\dubbo-3.0\dubbo-registry\dubbo-registry-nacos\src\test\java\org\apache\dubbo\registry\nacos\NacosServiceDiscoveryTest.java,125,44,2,26,0,72
 dubbo-3.0\dubbo-3.0\dubbo-remoting\dubbo-remoting-api\src\main\java\org\apache\dubbo\remoting\transport\dispatcher\WrappedChannelHandler.java,125,52,1,15,2,70
 dubbo-3.0\dubbo-3.0\dubbo-cluster\src\test\java\org\apache\dubbo\rpc\cluster\StickyTest.java,125,36,2,6,0,44
 hadoop-trunk\hadoop-trunk\hadoop-yarn-project\hadoop-yarn\hadoop-yarn-server\hadoop-yarn-server-resourcemanager\src\test\java\org\apache\hadoop\yarn\server\resourcemanager\scheduler\capacity\CapacitySchedulerPreemptionTestBase.java,125,41,7,8,1,57
 hadoop-trunk\hadoop-trunk\hadoop-yarn-project\hadoop-yarn\hadoop-yarn-server\hadoop-yarn-server-resourcemanager\src\main\java\org\apache\hadoop\yarn\server\resourcemanager\scheduler\Allocation.java,125,117,0,1,25,143
 hadoop-trunk\hadoop-trunk\hadoop-tools\hadoop-aws\src\test\java\org\apache\hadoop\fs\s3a\TestS3ABlockOutputStream.java,125,11,2,1,1,15
 hadoop-trunk\hadoop-trunk\hadoop-tools\hadoop-azure\src\test\java\org\apache\hadoop\fs\azurebfs\contract\ListResultSchemaTest.java,125,3,0,1,0,4
 hadoop-trunk\hadoop-trunk\hadoop-yarn-project\hadoop-yarn\hadoop-yarn-applications\hadoop-yarn-services\hadoop-yarn-services-core\src\test\java\org\apache\hadoop\yarn\service\providers\TestAbstractClientProvider.java,125,12,10,1,0,23
 hadoop-trunk\hadoop-trunk\hadoop-hdfs-project\hadoop-hdfs\src\test\java\org\apache\hadoop\hdfs\tools\offlineImageViewer\TestOfflineImageViewerWithStripedBlocks.java,125,31,3,1,3,38
 hadoop-trunk\hadoop-trunk\hadoop-yarn-project\hadoop-yarn\hadoop-yarn-server\hadoop-yarn-server-resourcemanager\src\test\java\org\apache\hadoop\yarn\server\resourcemanager\webapp\TestRMWebServicesAppsCustomResourceTypes.java,125,11,0,7,0,18
 hadoop-trunk\hadoop-trunk\hadoop-tools\hadoop-aws\src\test\java\org\apache\hadoop\fs\s3a\impl\TestDirectoryMarkerPolicy.java,125,25,0,3,0,28
 hadoop-trunk\hadoop-trunk\hadoop-mapreduce-project\hadoop-mapreduce-client\hadoop-mapreduce-client-core\src\main\java\org\apache\hadoop\mapred\JobQueueInfo.java,125,39,1,1,0,41
 hadoop-trunk\hadoop-trunk\hadoop-hdfs-project\hadoop-hdfs\src\test\java\org\apache\hadoop\hdfs\web\TestWebHdfsWithMultipleNameNodes.java,125,41,5,4,3,53
 hadoop-trunk\hadoop-trunk\hadoop-yarn-project\hadoop-yarn\hadoop-yarn-common\src\main\java\org\apache\hadoop\yarn\event\EventDispatcher.java,125,33,11,1,2,47
 hadoop-trunk\hadoop-trunk\hadoop-yarn-project\hadoop-yarn\hadoop-yarn-server\hadoop-yarn-server-timelineservice-hbase-tests\src\test\java\org\apache\hadoop\yarn\server\timelineservice\reader\AbstractTimelineReaderHBaseTestBase.java,125,23,3,2,3,31
 hadoop-trunk\hadoop-trunk\hadoop-yarn-project\hadoop-yarn\hadoop-yarn-server\hadoop-yarn-server-timeline-pluginstorage\src\main\java\org\apache\hadoop\yarn\server\timeline\EntityCacheItem.java,125,14,1,1,4,20
 hadoop-trunk\hadoop-trunk\hadoop-tools\hadoop-azure\src\test\java\org\apache\hadoop\fs\azurebfs\commit\ITestAbfsManifestStoreOperations.java,125,14,0,12,0,26
 hadoop-trunk\hadoop-trunk\hadoop-common-project\hadoop-common\src\main\java\org\apache\hadoop\security\SaslPlainServer.java,125,51,3,2,2,58
 hadoop-trunk\hadoop-trunk\hadoop-tools\hadoop-azure\src\main\java\org\apache\hadoop\fs\azurebfs\security\AbfsDelegationTokenManager.java,125,17,0,7,2,26
 hadoop-trunk\hadoop-trunk\hadoop-tools\hadoop-dynamometer\hadoop-dynamometer-workload\src\test\java\org\apache\hadoop\tools\dynamometer\workloadgenerator\audit\TestAuditLogDirectParser.java,125,31,9,1,0,41
 hadoop-trunk\hadoop-trunk\hadoop-common-project\hadoop-common\src\main\java\org\apache\hadoop\security\alias\CredentialProvider.java,125,18,0,1,1,20
 hadoop-trunk\hadoop-trunk\hadoop-yarn-project\hadoop-yarn\hadoop-yarn-common\src\main\java\org\apache\hadoop\yarn\security\client\RMDelegationTokenIdentifier.java,125,42,1,4,1,48
 hadoop-trunk\hadoop-trunk\hadoop-tools\hadoop-aws\src\test\java\org\apache\hadoop\fs\s3a\commit\staging\integration\ITestDirectoryCommitProtocol.java,125,22,0,3,0,25
 hadoop-trunk\hadoop-trunk\hadoop-yarn-project\hadoop-yarn\hadoop-yarn-server\hadoop-yarn-server-resourcemanager\src\main\java\org\apache\hadoop\yarn\server\resourcemanager\scheduler\capacity\AutoCreatedQueueDeletionPolicy.java,125,27,8,4,4,43
 hadoop-trunk\hadoop-trunk\hadoop-hdfs-project\hadoop-hdfs\src\test\java\org\apache\hadoop\hdfs\server\namenode\TestEncryptionZoneManager.java,125,19,0,1,4,24
 hadoop-trunk\hadoop-trunk\hadoop-yarn-project\hadoop-yarn\hadoop-yarn-server\hadoop-yarn-server-timelineservice\src\main\java\org\apache\hadoop\yarn\server\timelineservice\TimelineContext.java,125,47,0,1,0,48
 hadoop-trunk\hadoop-trunk\hadoop-yarn-project\hadoop-yarn\hadoop-yarn-common\src\main\java\org\apache\hadoop\yarn\server\api\protocolrecords\impl\pb\AddToClusterNodeLabelsRequestPBImpl.java,125,24,42,4,0,70
 kafka-trunk\kafka-trunk\metadata\src\test\java\org\apache\kafka\metadata\KafkaConfigSchemaTest.java,125,0,1,34,2,37
 kafka-trunk\kafka-trunk\clients\src\main\java\org\apache\kafka\common\requests\FindCoordinatorResponse.java,125,0,76,10,2,88
 kafka-trunk\kafka-trunk\raft\src\main\java\org\apache\kafka\raft\RaftUtil.java,125,0,3,29,0,32
 pulsar-master\pulsar-master\managed-ledger\src\test\java\org\apache\bookkeeper\test\ZooKeeperUtil.java,125,46,4,14,0,64
 pulsar-master\pulsar-master\pulsar-broker\src\test\java\org\apache\pulsar\client\impl\PulsarMultiHostClientTest.java,125,23,1,12,0,36
 pulsar-master\pulsar-master\pulsar-io\kafka-connect-adaptor\src\main\java\org\apache\pulsar\io\kafka\connect\schema\KafkaConnectData.java,125,28,6,18,0,52
 pulsar-master\pulsar-master\pulsar-io\kinesis\src\test\java\org\apache\pulsar\io\kinesis\KinesisSinkTest.java,125,20,3,10,0,33
 pulsar-master\pulsar-master\pulsar-broker\src\main\java\org\apache\pulsar\broker\admin\impl\BrokerStatsBase.java,125,47,9,25,0,81
 pulsar-master\pulsar-master\managed-ledger\src\main\java\org\apache\bookkeeper\mledger\offload\OffloaderUtils.java,125,38,5,27,0,70
 pulsar-master\pulsar-master\pulsar-client\src\main\java\org\apache\pulsar\client\impl\schema\SchemaDefinitionBuilderImpl.java,125,47,2,15,0,64
 pulsar-master\pulsar-master\pulsar-websocket\src\main\java\org\apache\pulsar\websocket\admin\WebSocketWebResource.java,125,36,2,17,0,55
 pulsar-master\pulsar-master\pulsar-proxy\src\test\java\org\apache\pulsar\proxy\server\ProxyServiceTlsStarterTest.java,125,49,7,23,0,79
 rocketmq-develop\rocketmq-develop\test\src\main\java\org\apache\rocketmq\test\clientinterface\AbstractMQProducer.java,125,79,1,5,1,86
 rocketmq-develop\rocketmq-develop\tools\src\main\java\org\apache\rocketmq\tools\command\broker\BrokerConsumeStatsSubCommad.java,125,36,1,21,3,61
 skywalking-master\skywalking-master\oap-server\server-configuration\configuration-nacos\src\test\java\org\apache\skywalking\oap\server\configuration\nacos\ITNacosConfigurationTest.java,125,40,1,23,0,64
 zookeeper-master\zookeeper-master\zookeeper-server\src\main\java\org\apache\zookeeper\metrics\impl\NullMetricsProvider.java,125,0,13,4,0,17
 zookeeper-master\zookeeper-master\zookeeper-server\src\test\java\org\apache\zookeeper\server\quorum\ZabUtils.java,125,0,20,15,7,42
 dubbo-3.0\dubbo-3.0\dubbo-common\src\test\java\org\apache\dubbo\common\utils\ClassUtilsTest.java,126,58,0,44,0,102
 dubbo-3.0\dubbo-3.0\dubbo-cluster\src\main\java\org\apache\dubbo\rpc\cluster\loadbalance\ShortestResponseLoadBalance.java,126,35,1,14,0,50
 hadoop-trunk\hadoop-trunk\hadoop-tools\hadoop-streaming\src\main\java\org\apache\hadoop\record\CsvRecordOutput.java,126,71,4,1,0,76
 hadoop-trunk\hadoop-trunk\hadoop-yarn-project\hadoop-yarn\hadoop-yarn-applications\hadoop-yarn-services\hadoop-yarn-services-core\src\main\java\org\apache\hadoop\yarn\service\provider\AbstractProviderService.java,126,45,1,7,0,53
 hadoop-trunk\hadoop-trunk\hadoop-mapreduce-project\hadoop-mapreduce-client\hadoop-mapreduce-client-hs\src\main\java\org\apache\hadoop\mapreduce\v2\hs\HSAuditLogger.java,126,61,1,1,0,63
 hadoop-trunk\hadoop-trunk\hadoop-yarn-project\hadoop-yarn\hadoop-yarn-applications\hadoop-yarn-services\hadoop-yarn-services-core\src\main\java\org\apache\hadoop\yarn\service\api\records\Artifact.java,126,50,2,4,0,56
 hadoop-trunk\hadoop-trunk\hadoop-hdfs-project\hadoop-hdfs\src\main\java\org\apache\hadoop\hdfs\server\blockmanagement\HostFileManager.java,126,30,2,1,4,37
 hadoop-trunk\hadoop-trunk\hadoop-hdfs-project\hadoop-hdfs\src\test\java\org\apache\hadoop\hdfs\TestDatanodeConfig.java,126,20,3,1,0,24
 hadoop-trunk\hadoop-trunk\hadoop-common-project\hadoop-common\src\main\java\org\apache\hadoop\fs\FileSystemStorageStatistics.java,126,16,1,1,4,22
 hadoop-trunk\hadoop-trunk\hadoop-yarn-project\hadoop-yarn\hadoop-yarn-server\hadoop-yarn-server-resourcemanager\src\main\java\org\apache\hadoop\yarn\server\resourcemanager\scheduler\common\AssignmentInformation.java,126,63,0,1,0,64
 hadoop-trunk\hadoop-trunk\hadoop-tools\hadoop-azure\src\test\java\org\apache\hadoop\fs\azure\ITestBlobTypeSpeedDifference.java,126,57,1,4,2,64
 hadoop-trunk\hadoop-trunk\hadoop-tools\hadoop-resourceestimator\src\main\java\org\apache\hadoop\resourceestimator\translator\api\JobMetaData.java,126,6,1,3,3,13
 hadoop-trunk\hadoop-trunk\hadoop-common-project\hadoop-common\src\main\java\org\apache\hadoop\util\ProgramDriver.java,126,63,1,2,1,67
 hadoop-trunk\hadoop-trunk\hadoop-hdfs-project\hadoop-hdfs-rbf\src\test\java\org\apache\hadoop\hdfs\server\federation\router\TestRouterMissingFolderMulti.java,126,7,0,7,0,14
 kafka-trunk\kafka-trunk\streams\src\test\java\org\apache\kafka\streams\tests\StreamsStandByReplicaTest.java,126,0,1,31,0,32
 kafka-trunk\kafka-trunk\streams\src\main\java\org\apache\kafka\streams\processor\internals\ClientUtils.java,126,0,1,29,0,30
 kafka-trunk\kafka-trunk\clients\src\test\java\org\apache\kafka\clients\admin\internals\ListConsumerGroupOffsetsHandlerTest.java,126,0,3,31,1,35
 kafka-trunk\kafka-trunk\streams\src\test\java\org\apache\kafka\streams\internals\metrics\ClientMetricsTest.java,126,0,0,17,0,17
 kafka-trunk\kafka-trunk\clients\src\test\java\org\apache\kafka\common\network\SslVersionsTransportLayerTest.java,126,0,2,43,1,46
 kafka-trunk\kafka-trunk\clients\src\main\java\org\apache\kafka\clients\producer\internals\ProducerMetadata.java,126,0,1,15,0,16
 pulsar-master\pulsar-master\pulsar-proxy\src\test\java\org\apache\pulsar\proxy\server\ProxyServiceStarterTest.java,126,40,4,20,0,64
 pulsar-master\pulsar-master\pulsar-client\src\test\java\org\apache\pulsar\client\impl\schema\PrimitiveSchemaTest.java,126,106,3,55,0,164
 pulsar-master\pulsar-master\pulsar-client\src\main\java\org\apache\pulsar\client\impl\ConsumerStatsDisabled.java,126,21,1,1,0,23
 puzzle-game-master\puzzle-game-master\core\src\com\jbgames\game\helpers\AStar.java,126,62,8,11,0,81
 rocketmq-develop\rocketmq-develop\example\src\main\java\org\apache\rocketmq\example\simple\AclClient.java,126,36,5,14,4,59
 skywalking-master\skywalking-master\oap-server\analyzer\agent-analyzer\src\main\java\org\apache\skywalking\oap\server\analyzer\provider\trace\UninstrumentedGatewaysConfig.java,126,27,1,11,0,39
 zookeeper-master\zookeeper-master\zookeeper-server\src\test\java\org\apache\zookeeper\test\SaslAuthDesignatedClientTest.java,126,0,18,19,7,44
 zookeeper-master\zookeeper-master\zookeeper-recipes\zookeeper-recipes-lock\src\test\java\org\apache\zookeeper\recipes\lock\WriteLockTest.java,126,0,3,8,6,17
 dubbo-3.0\dubbo-3.0\dubbo-cluster\src\test\java\org\apache\dubbo\rpc\cluster\support\ForkingClusterInvokerTest.java,127,34,1,19,0,54
 dubbo-3.0\dubbo-3.0\dubbo-metadata\dubbo-metadata-api\src\main\java\org\apache\dubbo\metadata\AbstractCacheManager.java,127,61,2,8,0,71
 dubbo-3.0\dubbo-3.0\dubbo-remoting\dubbo-remoting-api\src\test\java\org\apache\dubbo\remoting\PerformanceServerTest.java,127,45,9,25,4,83
 dubbo-3.0\dubbo-3.0\dubbo-remoting\dubbo-remoting-netty\src\main\java\org\apache\dubbo\remoting\transport\netty\NettyClient.java,127,27,7,17,0,51
 hadoop-trunk\hadoop-trunk\hadoop-hdfs-project\hadoop-hdfs\src\main\java\org\apache\hadoop\hdfs\server\balancer\BalancingPolicy.java,127,55,1,1,0,57
 hadoop-trunk\hadoop-trunk\hadoop-hdfs-project\hadoop-hdfs\src\test\java\org\apache\hadoop\hdfs\server\datanode\InternalDataNodeTestUtils.java,127,21,2,1,11,35
 hadoop-trunk\hadoop-trunk\hadoop-yarn-project\hadoop-yarn\hadoop-yarn-server\hadoop-yarn-server-resourcemanager\src\test\java\org\apache\hadoop\yarn\server\resourcemanager\applicationsmanager\TestApplicationMasterExpiry.java,127,6,0,9,0,15
 hadoop-trunk\hadoop-trunk\hadoop-yarn-project\hadoop-yarn\hadoop-yarn-server\hadoop-yarn-server-resourcemanager\src\test\java\org\apache\hadoop\yarn\server\resourcemanager\scheduler\capacity\TestQueueMappings.java,127,30,3,3,0,36
 hadoop-trunk\hadoop-trunk\hadoop-yarn-project\hadoop-yarn\hadoop-yarn-api\src\main\java\org\apache\hadoop\yarn\api\records\timeline\TimelineEntityGroupId.java,127,22,4,1,2,29
 hadoop-trunk\hadoop-trunk\hadoop-hdfs-project\hadoop-hdfs\src\test\java\org\apache\hadoop\hdfs\server\namenode\TestSecureNameNode.java,127,10,6,4,0,20
 hadoop-trunk\hadoop-trunk\hadoop-yarn-project\hadoop-yarn\hadoop-yarn-server\hadoop-yarn-server-resourcemanager\src\test\java\org\apache\hadoop\yarn\server\resourcemanager\federation\TestFederationRMStateStoreService.java,127,20,4,5,0,29
 hadoop-trunk\hadoop-trunk\hadoop-yarn-project\hadoop-yarn\hadoop-yarn-common\src\main\java\org\apache\hadoop\yarn\api\protocolrecords\impl\pb\MoveApplicationAcrossQueuesRequestPBImpl.java,127,46,39,9,0,94
 hadoop-trunk\hadoop-trunk\hadoop-common-project\hadoop-common\src\main\java\org\apache\hadoop\io\compress\BlockCompressorStream.java,127,36,4,1,0,41
 hadoop-trunk\hadoop-trunk\hadoop-common-project\hadoop-common\src\main\java\org\apache\hadoop\net\CachedDNSToSwitchMapping.java,127,28,1,2,0,31
 hadoop-trunk\hadoop-trunk\hadoop-mapreduce-project\hadoop-mapreduce-client\hadoop-mapreduce-client-jobclient\src\test\java\org\apache\hadoop\mapreduce\v2\TestUberAM.java,127,24,4,2,1,31
 hadoop-trunk\hadoop-trunk\hadoop-tools\hadoop-azure\src\test\java\org\apache\hadoop\fs\azurebfs\services\ITestReadBufferManager.java,127,41,1,29,2,73
 hadoop-trunk\hadoop-trunk\hadoop-yarn-project\hadoop-yarn\hadoop-yarn-common\src\test\java\org\apache\hadoop\yarn\api\resource\TestPlacementConstraintTransformations.java,127,12,1,10,13,36
 hadoop-trunk\hadoop-trunk\hadoop-yarn-project\hadoop-yarn\hadoop-yarn-server\hadoop-yarn-server-nodemanager\src\test\java\org\apache\hadoop\yarn\server\nodemanager\amrmproxy\TestAMRMProxyMetrics.java,127,5,1,3,0,9
 hadoop-trunk\hadoop-trunk\hadoop-yarn-project\hadoop-yarn\hadoop-yarn-server\hadoop-yarn-server-resourcemanager\src\main\java\org\apache\hadoop\yarn\server\resourcemanager\scheduler\capacity\conf\InMemoryConfigurationStore.java,127,15,3,1,2,21
 hadoop-trunk\hadoop-trunk\hadoop-yarn-project\hadoop-yarn\hadoop-yarn-common\src\main\java\org\apache\hadoop\yarn\security\DockerCredentialTokenIdentifier.java,127,13,20,2,0,35
 hadoop-trunk\hadoop-trunk\hadoop-hdfs-project\hadoop-hdfs\src\main\java\org\apache\hadoop\hdfs\server\protocol\BlockRecoveryCommand.java,127,46,0,1,5,52
 hadoop-trunk\hadoop-trunk\hadoop-hdfs-project\hadoop-hdfs\src\test\java\org\apache\hadoop\hdfs\server\namenode\ha\TestHAConfiguration.java,127,16,14,6,0,36
 kafka-trunk\kafka-trunk\clients\src\test\java\org\apache\kafka\common\network\CertStores.java,127,0,1,10,2,13
 kafka-trunk\kafka-trunk\raft\src\main\java\org\apache\kafka\raft\FileBasedStateStore.java,127,0,4,15,0,19
 kafka-trunk\kafka-trunk\clients\src\main\java\org\apache\kafka\clients\admin\CreateTopicsResult.java,127,0,1,23,1,25
 kafka-trunk\kafka-trunk\clients\src\test\java\org\apache\kafka\common\utils\TimerTest.java,127,0,0,2,0,2
 kafka-trunk\kafka-trunk\clients\src\generated\java\org\apache\kafka\common\message\BeginQuorumEpochRequestDataJsonConverter.java,127,0,0,27,0,27
 pulsar-master\pulsar-master\pulsar-io\kafka\src\main\java\org\apache\pulsar\io\kafka\KafkaSourceConfig.java,127,47,0,21,0,68
 pulsar-master\pulsar-master\pulsar-broker\src\main\java\org\apache\pulsar\broker\loadbalance\impl\BrokerVersionFilter.java,127,36,6,30,0,72
 pulsar-master\pulsar-master\pulsar-broker\src\main\java\org\apache\pulsar\broker\stats\BrokerOperabilityMetrics.java,127,72,0,21,0,93
 pulsar-master\pulsar-master\tests\integration\src\test\java\org\apache\pulsar\tests\integration\io\sources\debezium\DebeziumMsSqlSourceTester.java,127,40,4,14,0,58
 rocketmq-develop\rocketmq-develop\broker\src\main\java\org\apache\rocketmq\broker\processor\QueryMessageProcessor.java,127,44,4,26,1,75
 rocketmq-develop\rocketmq-develop\store\src\main\java\org\apache\rocketmq\store\MultiDispatch.java,127,46,3,26,4,79
 rocketmq-develop\rocketmq-develop\test\src\test\java\org\apache\rocketmq\test\client\producer\querymsg\QueryMsgByKeyIT.java,127,35,4,8,11,58
 skywalking-master\skywalking-master\oap-server\analyzer\meter-analyzer\src\test\java\org\apache\skywalking\oap\meter\analyzer\dsl\ValueFilterTest.java,127,45,1,31,0,77
 skywalking-master\skywalking-master\oap-server\server-core\src\test\java\org\apache\skywalking\oap\server\core\analysis\metrics\PercentileMetricsTest.java,127,55,1,5,0,61
 zookeeper-master\zookeeper-master\zookeeper-server\src\test\java\org\apache\zookeeper\test\QuorumZxidSyncTest.java,127,0,7,9,6,22
 dubbo-3.0\dubbo-3.0\dubbo-common\src\main\java\org\apache\dubbo\config\MonitorConfig.java,128,70,1,3,2,76
 dubbo-3.0\dubbo-3.0\dubbo-rpc\dubbo-rpc-api\src\test\java\org\apache\dubbo\rpc\filter\tps\DefaultTPSLimiterTest.java,128,51,0,17,0,68
 dubbo-3.0\dubbo-3.0\dubbo-remoting\dubbo-remoting-api\src\main\java\org\apache\dubbo\remoting\exchange\Request.java,128,58,1,4,0,63
file-management-system-master\file-management-system-master\src\main\java\com\fms\service\UploadFileService.java,128,68,1,27,2,98
 hadoop-trunk\hadoop-trunk\hadoop-yarn-project\hadoop-yarn\hadoop-yarn-server\hadoop-yarn-server-nodemanager\src\main\java\org\apache\hadoop\yarn\server\nodemanager\webapp\dao\NodeInfo.java,128,75,1,1,0,77
 hadoop-trunk\hadoop-trunk\hadoop-yarn-project\hadoop-yarn\hadoop-yarn-server\hadoop-yarn-server-nodemanager\src\main\java\org\apache\hadoop\yarn\server\nodemanager\containermanager\linux\resources\ResourceHandlerChain.java,128,21,0,4,1,26
 hadoop-trunk\hadoop-trunk\hadoop-common-project\hadoop-nfs\src\main\java\org\apache\hadoop\nfs\nfs3\response\READDIR3Response.java,128,59,2,1,3,65
 hadoop-trunk\hadoop-trunk\hadoop-hdfs-project\hadoop-hdfs\src\main\java\org\apache\hadoop\hdfs\server\datanode\fsdataset\ReplicaOutputStreams.java,128,45,2,1,8,56
 hadoop-trunk\hadoop-trunk\hadoop-mapreduce-project\hadoop-mapreduce-client\hadoop-mapreduce-client-common\src\test\java\org\apache\hadoop\mapreduce\v2\jobhistory\TestJobHistoryUtils.java,128,148,38,2,16,204
 hadoop-trunk\hadoop-trunk\hadoop-hdfs-project\hadoop-hdfs\src\test\java\org\apache\hadoop\hdfs\server\datanode\checker\TestDatasetVolumeCheckerFailures.java,128,18,9,1,0,28
 hadoop-trunk\hadoop-trunk\hadoop-common-project\hadoop-common\src\test\java\org\apache\hadoop\fs\shell\TestCopyFromLocal.java,128,34,4,1,0,39
 hadoop-trunk\hadoop-trunk\hadoop-common-project\hadoop-common\src\main\java\org\apache\hadoop\util\Options.java,128,66,2,1,2,71
 hadoop-trunk\hadoop-trunk\hadoop-hdfs-project\hadoop-hdfs\src\main\java\org\apache\hadoop\hdfs\server\datanode\DataNodeFaultInjector.java,128,63,26,1,2,92
 hadoop-trunk\hadoop-trunk\hadoop-yarn-project\hadoop-yarn\hadoop-yarn-server\hadoop-yarn-server-resourcemanager\src\main\java\org\apache\hadoop\yarn\server\resourcemanager\webapp\RmController.java,128,34,2,6,0,42
 hadoop-trunk\hadoop-trunk\hadoop-hdfs-project\hadoop-hdfs-client\src\main\java\org\apache\hadoop\hdfs\protocol\SnapshotDiffReportListing.java,128,57,0,1,11,69
 hadoop-trunk\hadoop-trunk\hadoop-common-project\hadoop-common\src\test\java\org\apache\hadoop\metrics2\impl\TestMetricsConfig.java,128,19,6,2,0,27
 hadoop-trunk\hadoop-trunk\hadoop-hdfs-project\hadoop-hdfs-rbf\src\test\java\org\apache\hadoop\hdfs\server\federation\StateStoreDFSCluster.java,128,32,0,6,0,38
 hadoop-trunk\hadoop-trunk\hadoop-tools\hadoop-azure\src\test\java\org\apache\hadoop\fs\azurebfs\ITestAzureBlobFileSystemRename.java,128,12,0,4,0,16
 hadoop-trunk\hadoop-trunk\hadoop-mapreduce-project\hadoop-mapreduce-client\hadoop-mapreduce-client-core\src\main\java\org\apache\hadoop\mapreduce\JobSubmissionFiles.java,128,44,5,1,0,50
 hadoop-trunk\hadoop-trunk\hadoop-hdfs-project\hadoop-hdfs\src\test\java\org\apache\hadoop\hdfs\server\namenode\snapshot\TestFileWithSnapshotFeature.java,128,11,13,1,3,28
 hadoop-trunk\hadoop-trunk\hadoop-common-project\hadoop-common\src\test\java\org\apache\hadoop\io\compress\TestGzipCodec.java,128,24,1,1,1,27
 hadoop-trunk\hadoop-trunk\hadoop-tools\hadoop-streaming\src\main\java\org\apache\hadoop\record\BinaryRecordInput.java,128,50,1,1,0,52
 hadoop-trunk\hadoop-trunk\hadoop-tools\hadoop-resourceestimator\src\test\java\org\apache\hadoop\resourceestimator\translator\api\TestJobMetaData.java,128,27,1,2,0,30
 hadoop-trunk\hadoop-trunk\hadoop-tools\hadoop-aws\src\test\java\org\apache\hadoop\fs\s3a\yarn\ITestS3AMiniYarnCluster.java,128,19,1,3,2,25
 hadoop-trunk\hadoop-trunk\hadoop-common-project\hadoop-common\src\test\java\org\apache\hadoop\fs\TestStat.java,128,50,3,4,0,57
 hadoop-trunk\hadoop-trunk\hadoop-common-project\hadoop-common\src\main\java\org\apache\hadoop\util\PriorityQueue.java,128,29,7,3,0,39
 hadoop-trunk\hadoop-trunk\hadoop-yarn-project\hadoop-yarn\hadoop-yarn-common\src\main\java\org\apache\hadoop\yarn\util\AbstractLivelinessMonitor.java,128,52,4,1,0,57
 kafka-trunk\kafka-trunk\clients\src\main\java\org\apache\kafka\common\record\AbstractRecords.java,128,0,9,20,0,29
 kafka-trunk\kafka-trunk\connect\mirror\src\main\java\org\apache\kafka\connect\mirror\MirrorCheckpointConnector.java,128,0,2,17,0,19
 kafka-trunk\kafka-trunk\storage\src\test\java\org\apache\kafka\server\log\remote\metadata\storage\TopicBasedRemoteLogMetadataManagerTest.java,128,0,1,50,0,51
 kafka-trunk\kafka-trunk\clients\src\generated\java\org\apache\kafka\common\message\OffsetForLeaderEpochRequestDataJsonConverter.java,128,0,0,33,0,33
 kafka-trunk\kafka-trunk\clients\src\main\java\org\apache\kafka\common\Uuid.java,128,0,3,18,0,21
 kafka-trunk\kafka-trunk\connect\runtime\src\test\java\org\apache\kafka\connect\runtime\ConnectMetricsTest.java,128,0,1,8,0,9
 kafka-trunk\kafka-trunk\clients\src\generated\java\org\apache\kafka\common\message\AlterPartitionReassignmentsRequestDataJsonConverter.java,128,0,0,33,0,33
 pulsar-master\pulsar-master\pulsar-broker\src\main\java\org\apache\pulsar\broker\ManagedLedgerClientFactory.java,128,57,2,37,0,96
 pulsar-master\pulsar-master\pulsar-client-tools\src\main\java\org\apache\pulsar\admin\cli\CmdTenants.java,128,22,0,9,0,31
 pulsar-master\pulsar-master\pulsar-io\canal\src\main\java\org\apache\pulsar\io\canal\MessageUtils.java,128,12,2,9,0,23
 pulsar-master\pulsar-master\tests\integration\src\test\java\org\apache\pulsar\tests\integration\messaging\MessagingBase.java,128,49,3,19,0,71
 pulsar-master\pulsar-master\pulsar-package-management\core\src\main\java\org\apache\pulsar\packages\management\core\common\PackageName.java,128,50,2,15,0,67
 pulsar-master\pulsar-master\pulsar-functions\utils\src\main\java\org\apache\pulsar\functions\utils\functioncache\FunctionCacheManagerImpl.java,128,26,2,6,0,34
 rocketmq-develop\rocketmq-develop\store\src\test\java\org\apache\rocketmq\store\MultiPathMappedFileQueueTest.java,128,55,0,27,7,89
 rocketmq-develop\rocketmq-develop\tools\src\main\java\org\apache\rocketmq\tools\command\queue\QueryConsumeQueueCommand.java,128,26,2,16,4,48
 rocketmq-develop\rocketmq-develop\srvutil\src\main\java\org\apache\rocketmq\srvutil\AclFileWatchService.java,128,40,9,14,4,67
 rocketmq-develop\rocketmq-develop\common\src\main\java\org\apache\rocketmq\common\message\MessageClientIDSetter.java,128,47,2,5,0,54
 rocketmq-develop\rocketmq-develop\acl\src\main\java\org\apache\rocketmq\acl\plain\PlainAccessValidator.java,128,47,1,33,0,81
 shardingsphere-master\shardingsphere-master\shardingsphere-jdbc\shardingsphere-jdbc-core\src\main\java\org\apache\shardingsphere\driver\jdbc\unsupported\AbstractUnsupportedDatabaseMetaDataResultSet.java,128,48,0,23,0,71
 skywalking-master\skywalking-master\oap-server\server-configuration\configuration-k8s-configmap\src\test\java\org\apache\skywalking\oap\server\configuration\configmap\ConfigmapConfigWatcherRegisterTest.java,128,35,9,23,0,67
 zookeeper-master\zookeeper-master\zookeeper-server\src\test\java\org\apache\zookeeper\server\ByteBufferInputStreamTest.java,128,0,10,4,2,16
 dubbo-3.0\dubbo-3.0\dubbo-common\src\main\java\org\apache\dubbo\common\extension\ExtensionDirector.java,129,45,1,12,4,62
 dubbo-3.0\dubbo-3.0\dubbo-cluster\src\test\java\org\apache\dubbo\rpc\cluster\loadbalance\RoundRobinLoadBalanceTest.java,129,35,1,22,0,58
 dubbo-3.0\dubbo-3.0\dubbo-common\src\main\java\org\apache\dubbo\common\utils\ClassHelper.java,129,39,1,4,0,44
 hadoop-trunk\hadoop-trunk\hadoop-hdfs-project\hadoop-hdfs\src\main\java\org\apache\hadoop\hdfs\server\common\sps\BlockDispatcher.java,129,27,16,4,0,47
 hadoop-trunk\hadoop-trunk\hadoop-yarn-project\hadoop-yarn\hadoop-yarn-server\hadoop-yarn-server-resourcemanager\src\test\java\org\apache\hadoop\yarn\server\resourcemanager\scheduler\fair\TestApplicationMasterServiceWithFS.java,129,23,3,3,2,31
 hadoop-trunk\hadoop-trunk\hadoop-yarn-project\hadoop-yarn\hadoop-yarn-common\src\test\java\org\apache\hadoop\yarn\nodelabels\NodeLabelTestBase.java,129,33,3,1,4,41
 hadoop-trunk\hadoop-trunk\hadoop-yarn-project\hadoop-yarn\hadoop-yarn-api\src\main\java\org\apache\hadoop\yarn\api\records\ReservationId.java,129,29,6,1,0,36
 hadoop-trunk\hadoop-trunk\hadoop-yarn-project\hadoop-yarn\hadoop-yarn-common\src\main\java\org\apache\hadoop\yarn\security\NMTokenIdentifier.java,129,46,31,3,0,80
 hadoop-trunk\hadoop-trunk\hadoop-hdfs-project\hadoop-hdfs-rbf\src\main\java\org\apache\hadoop\hdfs\server\federation\router\RouterHeartbeatService.java,129,9,1,3,1,14
 hadoop-trunk\hadoop-trunk\hadoop-tools\hadoop-aws\src\main\java\org\apache\hadoop\fs\s3a\commit\magic\MagicCommitTracker.java,129,22,1,2,3,28
 hadoop-trunk\hadoop-trunk\hadoop-yarn-project\hadoop-yarn\hadoop-yarn-server\hadoop-yarn-server-router\src\test\java\org\apache\hadoop\yarn\server\router\TestRouterAuditLogger.java,129,15,2,1,0,18
 hadoop-trunk\hadoop-trunk\hadoop-hdfs-project\hadoop-hdfs\src\test\java\org\apache\hadoop\hdfs\TestReadStripedFileWithMissingBlocks.java,129,34,5,1,1,41
 hadoop-trunk\hadoop-trunk\hadoop-hdfs-project\hadoop-hdfs\src\test\java\org\apache\hadoop\fs\TestResolveHdfsSymlink.java,129,13,5,5,0,23
 hadoop-trunk\hadoop-trunk\hadoop-yarn-project\hadoop-yarn\hadoop-yarn-server\hadoop-yarn-server-nodemanager\src\test\java\org\apache\hadoop\yarn\server\nodemanager\webapp\TestNMContainerWebSocket.java,129,12,5,4,0,21
 hadoop-trunk\hadoop-trunk\hadoop-hdfs-project\hadoop-hdfs\src\test\java\org\apache\hadoop\hdfs\server\datanode\TestDataDirs.java,129,22,24,1,10,57
 hadoop-trunk\hadoop-trunk\hadoop-yarn-project\hadoop-yarn\hadoop-yarn-server\hadoop-yarn-server-resourcemanager\src\test\java\org\apache\hadoop\yarn\server\resourcemanager\reservation\planning\TestSimpleCapacityReplanner.java,129,45,0,10,0,55
 hadoop-trunk\hadoop-trunk\hadoop-common-project\hadoop-common\src\test\java\org\apache\hadoop\ipc\TestProtoBufRpcServerHandoff.java,129,35,17,3,0,55
 hadoop-trunk\hadoop-trunk\hadoop-yarn-project\hadoop-yarn\hadoop-yarn-server\hadoop-yarn-server-resourcemanager\src\test\java\org\apache\hadoop\yarn\server\resourcemanager\scheduler\capacity\TestCapacitySchedulerConfiguration.java,129,51,0,12,0,63
 hadoop-trunk\hadoop-trunk\hadoop-yarn-project\hadoop-yarn\hadoop-yarn-server\hadoop-yarn-server-timelineservice-hbase\hadoop-yarn-server-timelineservice-hbase-client\src\main\java\org\apache\hadoop\yarn\server\timelineservice\storage\common\BaseTableRW.java,129,18,1,1,0,20
 hadoop-trunk\hadoop-trunk\hadoop-yarn-project\hadoop-yarn\hadoop-yarn-api\src\main\java\org\apache\hadoop\yarn\api\records\timelineservice\TimelineWriteResponse.java,129,11,2,1,1,15
 hadoop-trunk\hadoop-trunk\hadoop-mapreduce-project\hadoop-mapreduce-client\hadoop-mapreduce-client-jobclient\src\test\java\org\apache\hadoop\mapreduce\lib\jobcontrol\TestMapReduceJobControlWithMocks.java,129,41,0,2,0,43
 hadoop-trunk\hadoop-trunk\hadoop-common-project\hadoop-nfs\src\main\java\org\apache\hadoop\nfs\nfs3\response\READDIRPLUS3Response.java,129,61,4,1,3,69
 kafka-trunk\kafka-trunk\streams\src\test\java\org\apache\kafka\streams\processor\internals\StateConsumerTest.java,129,0,0,15,0,15
 kafka-trunk\kafka-trunk\metadata\src\generated\java\org\apache\kafka\common\metadata\RemoveTopicRecord.java,129,0,0,7,2,9
 kafka-trunk\kafka-trunk\clients\src\test\java\org\apache\kafka\common\security\oauthbearer\internals\unsecured\OAuthBearerUnsecuredJwsTest.java,129,0,2,26,2,30
 kafka-trunk\kafka-trunk\streams\src\test\java\org\apache\kafka\streams\kstream\internals\KStreamTransformTest.java,129,0,4,22,2,28
 kafka-trunk\kafka-trunk\clients\src\generated\java\org\apache\kafka\common\message\DescribeClusterRequestData.java,129,0,0,14,1,15
 kafka-trunk\kafka-trunk\metadata\src\generated\java\org\apache\kafka\common\metadata\RemoveAccessControlEntryRecord.java,129,0,0,9,2,11
 kafka-trunk\kafka-trunk\clients\src\generated\java\org\apache\kafka\common\message\UnregisterBrokerRequestData.java,129,0,0,7,1,8
 kafka-trunk\kafka-trunk\clients\src\generated\java\org\apache\kafka\common\message\SnapshotFooterRecord.java,129,0,0,7,2,9
 pulsar-master\pulsar-master\managed-ledger\src\test\java\org\apache\bookkeeper\mledger\impl\ManagedLedgerTerminationTest.java,129,16,4,3,0,23
 pulsar-master\pulsar-master\pulsar-broker\src\test\java\org\apache\pulsar\broker\service\nonpersistent\NonPersistentStickyKeyDispatcherMultipleConsumersTest.java,129,42,9,22,0,73
 pulsar-master\pulsar-master\pulsar-broker\src\test\java\org\apache\pulsar\broker\protocol\SimpleProtocolHandlerTestsBase.java,129,31,4,14,0,49
 rocketmq-develop\rocketmq-develop\client\src\main\java\org\apache\rocketmq\client\impl\consumer\RebalanceLitePullImpl.java,129,51,3,23,2,79
 rocketmq-develop\rocketmq-develop\client\src\main\java\org\apache\rocketmq\client\stat\ConsumerStatsManager.java,129,59,2,26,6,93
 skywalking-master\skywalking-master\oap-server\server-storage-plugin\storage-iotdb-plugin\src\main\java\org\apache\skywalking\oap\server\storage\plugin\iotdb\query\IoTDBTraceQueryDAO.java,129,53,2,30,0,85
 skywalking-master\skywalking-master\oap-server\server-alarm-plugin\src\main\java\org\apache\skywalking\oap\server\core\alarm\provider\feishu\FeishuHookCallback.java,129,48,4,16,0,68
 skywalking-master\skywalking-master\oap-server\server-storage-plugin\storage-influxdb-plugin\src\main\java\org\apache\skywalking\oap\server\storage\plugin\influxdb\query\UITemplateManagementDAOImpl.java,129,30,0,25,0,55
 zookeeper-master\zookeeper-master\zookeeper-server\src\main\java\org\apache\zookeeper\server\util\MessageTracker.java,129,0,3,15,0,18
 zookeeper-master\zookeeper-master\zookeeper-server\src\main\java\org\apache\zookeeper\server\quorum\flexible\QuorumMaj.java,129,0,4,4,4,12
 dubbo-3.0\dubbo-3.0\dubbo-config\dubbo-config-spring\src\test\java\org\apache\dubbo\config\spring\context\annotation\EnableDubboTest.java,130,27,2,20,0,49
 dubbo-3.0\dubbo-3.0\dubbo-registry\dubbo-registry-zookeeper\src\main\java\org\apache\dubbo\registry\zookeeper\ZookeeperServiceDiscovery.java,130,61,0,34,0,95
 dubbo-3.0\dubbo-3.0\dubbo-rpc\dubbo-rpc-dubbo\src\test\java\org\apache\dubbo\rpc\protocol\dubbo\DubboInvokerAvailableTest.java,130,43,10,21,0,74
 hadoop-trunk\hadoop-trunk\hadoop-tools\hadoop-distcp\src\test\java\org\apache\hadoop\tools\util\TestThrottledInputStream.java,130,39,2,4,0,45
 hadoop-trunk\hadoop-trunk\hadoop-common-project\hadoop-common\src\test\java\org\apache\hadoop\util\TestIdentityHashStore.java,130,50,12,1,5,68
 hadoop-trunk\hadoop-trunk\hadoop-common-project\hadoop-common\src\main\java\org\apache\hadoop\http\HttpServer2Metrics.java,130,67,0,1,0,68
 hadoop-trunk\hadoop-trunk\hadoop-yarn-project\hadoop-yarn\hadoop-yarn-common\src\test\java\org\apache\hadoop\yarn\util\TestRackResolver.java,130,17,9,2,2,30
 hadoop-trunk\hadoop-trunk\hadoop-common-project\hadoop-common\src\test\java\org\apache\hadoop\io\TestBytesWritable.java,130,84,17,10,10,121
 hadoop-trunk\hadoop-trunk\hadoop-yarn-project\hadoop-yarn\hadoop-yarn-server\hadoop-yarn-server-common\src\test\java\org\apache\hadoop\yarn\TestResourceTrackerPBClientImpl.java,130,32,2,7,7,48
 hadoop-trunk\hadoop-trunk\hadoop-hdfs-project\hadoop-hdfs\src\test\java\org\apache\hadoop\hdfs\TestBlockTokenWrappingQOP.java,130,21,4,2,6,33
 hadoop-trunk\hadoop-trunk\hadoop-yarn-project\hadoop-yarn\hadoop-yarn-server\hadoop-yarn-server-nodemanager\src\test\java\org\apache\hadoop\yarn\server\nodemanager\TestLocalDirsHandlerService.java,130,14,3,1,2,20
 hadoop-trunk\hadoop-trunk\hadoop-hdfs-project\hadoop-hdfs-rbf\src\main\java\org\apache\hadoop\hdfs\server\federation\router\RouterCacheAdmin.java,130,31,6,2,1,40
 hadoop-trunk\hadoop-trunk\hadoop-common-project\hadoop-common\src\test\java\org\apache\hadoop\test\TestGenericTestUtils.java,130,16,1,1,3,21
 hadoop-trunk\hadoop-trunk\hadoop-mapreduce-project\hadoop-mapreduce-client\hadoop-mapreduce-client-core\src\main\java\org\apache\hadoop\mapred\MapOutputFile.java,130,17,3,1,2,23
 hadoop-trunk\hadoop-trunk\hadoop-yarn-project\hadoop-yarn\hadoop-yarn-server\hadoop-yarn-server-nodemanager\src\main\java\org\apache\hadoop\yarn\server\nodemanager\amrmproxy\AbstractRequestInterceptor.java,130,15,0,5,4,24
 hadoop-trunk\hadoop-trunk\hadoop-hdfs-project\hadoop-hdfs\src\test\java\org\apache\hadoop\hdfs\server\namenode\TestAddBlockRetry.java,130,16,2,2,0,20
 hadoop-trunk\hadoop-trunk\hadoop-tools\hadoop-aws\src\test\java\org\apache\hadoop\fs\s3a\TestS3AGetFileStatus.java,130,14,1,1,0,16
 hadoop-trunk\hadoop-trunk\hadoop-yarn-project\hadoop-yarn\hadoop-yarn-server\hadoop-yarn-server-resourcemanager\src\test\java\org\apache\hadoop\yarn\server\resourcemanager\recovery\TestZKRMStateStoreZKClientConnections.java,130,27,3,3,4,37
 hadoop-trunk\hadoop-trunk\hadoop-tools\hadoop-datajoin\src\main\java\org\apache\hadoop\contrib\utils\join\DataJoinJob.java,130,30,16,3,0,49
 hadoop-trunk\hadoop-trunk\hadoop-yarn-project\hadoop-yarn\hadoop-yarn-server\hadoop-yarn-server-nodemanager\src\test\java\org\apache\hadoop\yarn\server\nodemanager\containermanager\localizer\TestLocalResource.java,130,32,15,15,4,66
 hadoop-trunk\hadoop-trunk\hadoop-mapreduce-project\hadoop-mapreduce-client\hadoop-mapreduce-client-nativetask\src\test\java\org\apache\hadoop\mapred\nativetask\testutil\ResultVerifier.java,130,23,4,7,0,34
 hadoop-trunk\hadoop-trunk\hadoop-hdfs-project\hadoop-hdfs\src\test\java\org\apache\hadoop\tools\TestTools.java,130,35,10,2,3,50
 kafka-trunk\kafka-trunk\streams\src\main\java\org\apache\kafka\streams\state\internals\MemoryNavigableLRUCache.java,130,0,2,25,0,27
 kafka-trunk\kafka-trunk\tools\src\test\java\org\apache\kafka\tools\ProducerPerformanceTest.java,130,0,0,13,8,21
 kafka-trunk\kafka-trunk\streams\src\test\java\org\apache\kafka\streams\integration\JoinStoreIntegrationTest.java,130,0,3,26,1,30
 pulsar-master\pulsar-master\pulsar-common\src\main\java\org\apache\pulsar\common\policies\data\stats\PublisherStatsImpl.java,130,43,1,7,0,51
 pulsar-master\pulsar-master\pulsar-broker\src\main\java\org\apache\pulsar\broker\service\nonpersistent\NonPersistentStickyKeyDispatcherMultipleConsumers.java,130,50,1,30,0,81
 pulsar-master\pulsar-master\pulsar-broker\src\test\java\org\apache\pulsar\broker\service\schema\ClientGetSchemaTest.java,130,53,1,29,0,83
 rocketmq-develop\rocketmq-develop\broker\src\main\java\org\apache\rocketmq\broker\filter\ExpressionMessageFilter.java,130,41,5,19,3,68
 rocketmq-develop\rocketmq-develop\store\src\main\java\org\apache\rocketmq\store\AppendMessageResult.java,130,104,0,3,0,107
 skywalking-master\skywalking-master\oap-server\server-alarm-plugin\src\main\java\org\apache\skywalking\oap\server\core\alarm\provider\grpc\GRPCCallback.java,130,31,1,16,0,48
 skywalking-master\skywalking-master\oap-server\server-cluster-plugin\cluster-etcd-plugin\src\test\java\org\apache\skywalking\oap\server\cluster\plugin\etcd\ITClusterEtcdPluginTest.java,130,36,4,14,0,54
 zookeeper-master\zookeeper-master\zookeeper-server\src\test\java\org\apache\zookeeper\common\ZKHostnameVerifierTest.java,130,0,4,7,0,11
 zookeeper-master\zookeeper-master\zookeeper-server\src\test\java\org\apache\zookeeper\server\quorum\LearnerSyncThrottlerTest.java,130,0,4,11,2,17
 zookeeper-master\zookeeper-master\zookeeper-server\src\test\java\org\apache\zookeeper\server\quorum\auth\QuorumAuthTestBase.java,130,0,1,18,6,25
 zookeeper-master\zookeeper-master\zookeeper-server\src\test\java\org\apache\zookeeper\test\LoadFromLogNoServerTest.java,130,0,42,19,0,61
 dubbo-3.0\dubbo-3.0\dubbo-cluster\src\main\java\org\apache\dubbo\rpc\cluster\configurator\parser\model\ConfigItem.java,131,79,0,9,0,88
 dubbo-3.0\dubbo-3.0\dubbo-cluster\src\test\java\org\apache\dubbo\rpc\cluster\support\ClusterUtilsTest.java,131,26,0,21,0,47
 hadoop-trunk\hadoop-trunk\hadoop-yarn-project\hadoop-yarn\hadoop-yarn-server\hadoop-yarn-server-common\src\main\java\org\apache\hadoop\yarn\server\federation\store\records\impl\pb\ApplicationHomeSubClusterPBImpl.java,131,27,44,5,0,76
 hadoop-trunk\hadoop-trunk\hadoop-hdfs-project\hadoop-hdfs\src\main\java\org\apache\hadoop\hdfs\server\sps\ExternalSPSFilePathCollector.java,131,19,2,1,1,23
 hadoop-trunk\hadoop-trunk\hadoop-yarn-project\hadoop-yarn\hadoop-yarn-common\src\main\java\org\apache\hadoop\yarn\api\protocolrecords\impl\pb\GetNodesToLabelsResponsePBImpl.java,131,30,47,3,0,80
 hadoop-trunk\hadoop-trunk\hadoop-mapreduce-project\hadoop-mapreduce-client\hadoop-mapreduce-client-jobclient\src\test\java\org\apache\hadoop\mapred\TestCombineSequenceFileInputFormat.java,131,45,3,1,1,50
 hadoop-trunk\hadoop-trunk\hadoop-mapreduce-project\hadoop-mapreduce-client\hadoop-mapreduce-client-nativetask\src\main\java\org\apache\hadoop\mapred\nativetask\util\LocalJobOutputFiles.java,131,60,1,10,0,71
 hadoop-trunk\hadoop-trunk\hadoop-yarn-project\hadoop-yarn\hadoop-yarn-server\hadoop-yarn-server-tests\src\test\java\org\apache\hadoop\yarn\server\timelineservice\TestTimelineServiceClientIntegration.java,131,10,0,7,0,17
 hadoop-trunk\hadoop-trunk\hadoop-yarn-project\hadoop-yarn\hadoop-yarn-server\hadoop-yarn-server-timelineservice\src\test\java\org\apache\hadoop\yarn\server\timelineservice\reader\TestTimelineReaderWebServicesBasicAcl.java,131,16,3,1,1,21
 hadoop-trunk\hadoop-trunk\hadoop-tools\hadoop-aws\src\main\java\org\apache\hadoop\fs\s3a\auth\delegation\RoleTokenBinding.java,131,10,2,5,0,17
 hadoop-trunk\hadoop-trunk\hadoop-hdfs-project\hadoop-hdfs\src\test\java\org\apache\hadoop\hdfs\util\HostsFileWriter.java,131,38,1,1,0,40
 hadoop-trunk\hadoop-trunk\hadoop-cloud-storage-project\hadoop-cos\src\test\java\org\apache\hadoop\fs\cosn\TestCosNInputStream.java,131,23,13,1,4,41
 hadoop-trunk\hadoop-trunk\hadoop-common-project\hadoop-common\src\test\java\org\apache\hadoop\ipc\TestReuseRpcConnections.java,131,6,4,1,0,11
 hadoop-trunk\hadoop-trunk\hadoop-yarn-project\hadoop-yarn\hadoop-yarn-api\src\main\java\org\apache\hadoop\yarn\api\protocolrecords\RegisterApplicationMasterRequest.java,131,17,1,5,0,23
 hadoop-trunk\hadoop-trunk\hadoop-common-project\hadoop-common\src\test\java\org\apache\hadoop\fs\viewfs\TestRegexMountPoint.java,131,13,12,1,5,31
 hadoop-trunk\hadoop-trunk\hadoop-yarn-project\hadoop-yarn\hadoop-yarn-server\hadoop-yarn-server-nodemanager\src\main\java\org\apache\hadoop\yarn\server\nodemanager\webapp\dao\gpu\PerGpuDeviceInformation.java,131,46,0,1,6,53
 hadoop-trunk\hadoop-trunk\hadoop-common-project\hadoop-common\src\main\java\org\apache\hadoop\metrics2\lib\Interns.java,131,36,3,1,0,40
 hadoop-trunk\hadoop-trunk\hadoop-common-project\hadoop-common\src\test\java\org\apache\hadoop\util\TestHttpExceptionUtils.java,131,10,5,3,3,21
 hadoop-trunk\hadoop-trunk\hadoop-yarn-project\hadoop-yarn\hadoop-yarn-server\hadoop-yarn-server-nodemanager\src\test\java\org\apache\hadoop\yarn\server\nodemanager\containermanager\linux\runtime\TestHdfsManifestToResourcesPlugin.java,131,16,3,5,1,25
 hadoop-trunk\hadoop-trunk\hadoop-yarn-project\hadoop-yarn\hadoop-yarn-server\hadoop-yarn-server-nodemanager\src\test\java\org\apache\hadoop\yarn\server\nodemanager\containermanager\linux\resources\TestNetworkPacketTaggingHandlerImpl.java,131,20,2,5,0,27
 hadoop-trunk\hadoop-trunk\hadoop-yarn-project\hadoop-yarn\hadoop-yarn-common\src\main\java\org\apache\hadoop\yarn\api\protocolrecords\impl\pb\ContainerUpdateRequestPBImpl.java,131,20,42,3,0,65
 kafka-trunk\kafka-trunk\clients\src\test\java\org\apache\kafka\common\requests\LeaveGroupResponseTest.java,131,0,5,30,6,41
 kafka-trunk\kafka-trunk\clients\src\main\java\org\apache\kafka\common\requests\FetchMetadata.java,131,0,4,7,0,11
 kafka-trunk\kafka-trunk\clients\src\main\java\org\apache\kafka\common\security\oauthbearer\secured\BasicOAuthBearerToken.java,131,0,0,30,2,32
 kafka-trunk\kafka-trunk\trogdor\src\main\java\org\apache\kafka\trogdor\workload\SustainedConnectionSpec.java,131,0,0,9,4,13
 kafka-trunk\kafka-trunk\core\src\main\java\kafka\server\builders\ReplicaManagerBuilder.java,131,0,6,21,5,32
 kafka-trunk\kafka-trunk\connect\runtime\src\main\java\org\apache\kafka\connect\runtime\distributed\EagerAssignor.java,131,0,5,48,0,53
 kafka-trunk\kafka-trunk\streams\src\test\java\org\apache\kafka\streams\state\internals\InMemoryLRUCacheStoreTest.java,131,0,0,7,0,7
 kafka-trunk\kafka-trunk\clients\src\test\java\org\apache\kafka\common\network\SslTransportTls12Tls13Test.java,131,0,2,38,0,40
 pulsar-master\pulsar-master\pulsar-io\twitter\src\main\java\org\apache\pulsar\io\twitter\TwitterFireHoseConfig.java,131,39,1,17,0,57
 pulsar-master\pulsar-master\pulsar-common\src\main\java\org\apache\pulsar\common\stats\JvmMetrics.java,131,34,3,16,0,53
 pulsar-master\pulsar-master\pulsar-common\src\main\java\org\apache\pulsar\common\nar\NarUnpacker.java,131,25,4,16,0,45
 pulsar-master\pulsar-master\pulsar-client\src\main\java\org\apache\pulsar\client\impl\BatchMessageIdImpl.java,131,55,2,9,0,66
 rocketmq-develop\rocketmq-develop\tools\src\main\java\org\apache\rocketmq\tools\command\topic\UpdateTopicPermSubCommand.java,131,23,3,18,1,45
 rocketmq-develop\rocketmq-develop\broker\src\main\java\org\apache\rocketmq\broker\filtersrv\FilterServerManager.java,131,44,2,12,1,59
 zookeeper-master\zookeeper-master\zookeeper-it\src\main\java\org\apache\zookeeper\test\system\SimpleSysTest.java,131,0,12,11,0,23
 dubbo-3.0\dubbo-3.0\dubbo-cluster\src\test\java\org\apache\dubbo\rpc\cluster\support\merger\DefaultProviderURLMergeProcessorTest.java,132,40,0,34,0,74
 dubbo-3.0\dubbo-3.0\dubbo-common\src\test\java\org\apache\dubbo\common\model\person\BigPerson.java,132,75,16,6,2,99
 dubbo-3.0\dubbo-3.0\dubbo-common\src\test\java\org\apache\dubbo\rpc\model\person\BigPerson.java,132,75,16,6,2,99
 dubbo-3.0\dubbo-3.0\dubbo-common\src\main\java\org\apache\dubbo\common\BaseServiceMetadata.java,132,66,1,5,2,74
 hadoop-trunk\hadoop-trunk\hadoop-mapreduce-project\hadoop-mapreduce-client\hadoop-mapreduce-client-nativetask\src\main\java\org\apache\hadoop\mapred\nativetask\util\NativeTaskOutputFiles.java,132,68,0,17,0,85
 hadoop-trunk\hadoop-trunk\hadoop-yarn-project\hadoop-yarn\hadoop-yarn-server\hadoop-yarn-server-timelineservice-documentstore\src\main\java\org\apache\hadoop\yarn\server\timelineservice\documentstore\collection\document\entity\TimelineMetricSubDoc.java,132,42,2,3,2,49
 hadoop-trunk\hadoop-trunk\hadoop-common-project\hadoop-common\src\test\java\org\apache\hadoop\crypto\key\TestCachingKeyProvider.java,132,25,5,1,0,31
 hadoop-trunk\hadoop-trunk\hadoop-tools\hadoop-openstack\src\main\java\org\apache\hadoop\fs\swift\util\DurationStats.java,132,35,3,1,1,40
 hadoop-trunk\hadoop-trunk\hadoop-hdfs-project\hadoop-hdfs\src\test\java\org\apache\hadoop\hdfs\server\datanode\web\webhdfs\TestParameterParser.java,132,11,5,4,2,22
 hadoop-trunk\hadoop-trunk\hadoop-common-project\hadoop-common\src\test\java\org\apache\hadoop\fs\viewfs\TestViewFileSystemOverloadSchemeLocalFileSystem.java,132,18,0,1,1,20
 hadoop-trunk\hadoop-trunk\hadoop-tools\hadoop-streaming\src\main\java\org\apache\hadoop\typedbytes\TypedBytesRecordInput.java,132,64,14,1,1,80
 hadoop-trunk\hadoop-trunk\hadoop-yarn-project\hadoop-yarn\hadoop-yarn-server\hadoop-yarn-server-common\src\main\java\org\apache\hadoop\yarn\server\federation\policies\router\LocalityRouterPolicy.java,132,9,6,4,0,19
 hadoop-trunk\hadoop-trunk\hadoop-hdfs-project\hadoop-hdfs-client\src\main\java\org\apache\hadoop\hdfs\HdfsConfiguration.java,132,7,1,1,0,9
 hadoop-trunk\hadoop-trunk\hadoop-common-project\hadoop-common\src\test\java\org\apache\hadoop\fs\audit\TestCommonAuditContext.java,132,9,4,5,0,18
 hadoop-trunk\hadoop-trunk\hadoop-common-project\hadoop-common\src\main\java\org\apache\hadoop\metrics2\filter\AbstractPatternFilter.java,132,33,4,1,0,38
 hadoop-trunk\hadoop-trunk\hadoop-tools\hadoop-aws\src\test\java\org\apache\hadoop\fs\s3a\ITestS3AFailureHandling.java,132,15,8,3,1,27
 hadoop-trunk\hadoop-trunk\hadoop-mapreduce-project\hadoop-mapreduce-client\hadoop-mapreduce-client-jobclient\src\test\java\org\apache\hadoop\mapreduce\TestChild.java,132,65,10,3,0,78
 hadoop-trunk\hadoop-trunk\hadoop-yarn-project\hadoop-yarn\hadoop-yarn-server\hadoop-yarn-server-nodemanager\src\main\java\org\apache\hadoop\yarn\server\nodemanager\containermanager\resourceplugin\fpga\FpgaDiscoverer.java,132,25,1,9,1,36
 hadoop-trunk\hadoop-trunk\hadoop-yarn-project\hadoop-yarn\hadoop-yarn-server\hadoop-yarn-server-resourcemanager\src\test\java\org\apache\hadoop\yarn\server\resourcemanager\resourcetracker\TestNMExpiry.java,132,36,2,10,2,50
 hadoop-trunk\hadoop-trunk\hadoop-hdfs-project\hadoop-hdfs\src\test\java\org\apache\hadoop\hdfs\server\namenode\TestAllowFormat.java,132,39,3,9,2,53
 hadoop-trunk\hadoop-trunk\hadoop-common-project\hadoop-common\src\main\java\org\apache\hadoop\fs\http\AbstractHttpFileSystem.java,132,40,1,3,0,44
 hadoop-trunk\hadoop-trunk\hadoop-yarn-project\hadoop-yarn\hadoop-yarn-server\hadoop-yarn-server-common\src\main\java\org\apache\hadoop\yarn\server\webapp\dao\ContainerInfo.java,132,66,0,1,0,67
 hadoop-trunk\hadoop-trunk\hadoop-yarn-project\hadoop-yarn\hadoop-yarn-common\src\main\java\org\apache\hadoop\yarn\api\protocolrecords\impl\pb\StartContainerRequestPBImpl.java,132,51,47,9,0,107
 hadoop-trunk\hadoop-trunk\hadoop-yarn-project\hadoop-yarn\hadoop-yarn-common\src\main\java\org\apache\hadoop\yarn\server\api\protocolrecords\impl\pb\NodeToAttributesPBImpl.java,132,19,34,1,0,54
 kafka-trunk\kafka-trunk\trogdor\src\main\java\org\apache\kafka\trogdor\fault\DegradedNetworkFaultWorker.java,132,0,0,27,1,28
 kafka-trunk\kafka-trunk\connect\runtime\src\test\java\org\apache\kafka\connect\integration\MonitorableSourceConnector.java,132,0,7,23,1,31
 kafka-trunk\kafka-trunk\clients\src\generated\java\org\apache\kafka\common\message\DescribeConfigsRequestDataJsonConverter.java,132,0,0,30,0,30
 kafka-trunk\kafka-trunk\metadata\src\main\java\org\apache\kafka\metadata\authorizer\StandardAuthorizer.java,132,0,3,11,0,14
 pulsar-master\pulsar-master\buildtools\src\main\java\org\apache\pulsar\tests\ThreadDumpUtil.java,132,31,3,18,0,52
 pulsar-master\pulsar-master\pulsar-io\elastic-search\src\test\java\org\apache\pulsar\io\elasticsearch\ElasticSearchClientSslTests.java,132,54,0,39,0,93
 pulsar-master\pulsar-master\pulsar-io\solr\src\test\java\org\apache\pulsar\io\solr\SolrSinkConfigTest.java,132,13,1,5,0,19
 pulsar-master\pulsar-master\pulsar-common\src\main\java\org\apache\pulsar\common\util\ThreadDumpUtil.java,132,31,3,18,0,52
 pulsar-master\pulsar-master\pulsar-io\docs\src\main\java\org\apache\pulsar\io\docs\ConnectorDocGenerator.java,132,26,3,12,0,41
 pulsar-master\pulsar-master\managed-ledger\src\test\java\org\apache\bookkeeper\mledger\impl\ManagedCursorPropertiesTest.java,132,17,0,8,0,25
 pulsar-master\pulsar-master\pulsar-websocket\src\main\java\org\apache\pulsar\websocket\stats\ProxyStats.java,132,45,0,18,0,63
 rocketmq-develop\rocketmq-develop\common\src\test\java\org\apache\rocketmq\common\utils\IOTinyUtilsTest.java,132,25,9,7,2,43
 skywalking-master\skywalking-master\oap-server\server-query-plugin\query-graphql-plugin\src\main\java\org\apache\skywalking\oap\query\graphql\resolver\MetricQuery.java,132,31,0,17,0,48
 skywalking-master\skywalking-master\oap-server\server-core\src\main\java\org\apache\skywalking\oap\server\core\query\type\HeatMap.java,132,31,0,8,0,39
 zookeeper-master\zookeeper-master\zookeeper-server\src\main\java\org\apache\zookeeper\server\quorum\auth\SaslQuorumAuthServer.java,132,0,13,17,0,30
 zookeeper-master\zookeeper-master\zookeeper-server\src\main\java\org\apache\zookeeper\server\quorum\ObserverRequestProcessor.java,132,0,6,9,1,16
 zookeeper-master\zookeeper-master\zookeeper-server\src\main\java\org\apache\zookeeper\cli\ReconfigCommand.java,132,0,8,29,8,45
 zookeeper-master\zookeeper-master\zookeeper-server\src\main\java\org\apache\zookeeper\common\ZKTrustManager.java,132,0,1,19,0,20
 dubbo-3.0\dubbo-3.0\dubbo-registry\dubbo-registry-api\src\test\java\org\apache\dubbo\registry\integration\DynamicDirectoryTest.java,133,29,10,20,0,59
 dubbo-3.0\dubbo-3.0\dubbo-remoting\dubbo-remoting-http\src\main\java\org\apache\dubbo\remoting\http\jetty\JettyLoggerAdapter.java,133,58,0,1,0,59
 dubbo-3.0\dubbo-3.0\dubbo-rpc\dubbo-rpc-api\src\test\java\org\apache\dubbo\rpc\support\MockInvocation.java,133,55,2,2,1,60
 hadoop-trunk\hadoop-trunk\hadoop-mapreduce-project\hadoop-mapreduce-client\hadoop-mapreduce-client-jobclient\src\test\java\org\apache\hadoop\mapred\BigMapOutput.java,133,74,5,4,5,88
 hadoop-trunk\hadoop-trunk\hadoop-yarn-project\hadoop-yarn\hadoop-yarn-server\hadoop-yarn-server-resourcemanager\src\test\java\org\apache\hadoop\yarn\server\resourcemanager\scheduler\TestConfigurationMutationACLPolicies.java,133,19,1,3,0,23
 hadoop-trunk\hadoop-trunk\hadoop-yarn-project\hadoop-yarn\hadoop-yarn-applications\hadoop-yarn-services\hadoop-yarn-services-api\src\test\java\org\apache\hadoop\yarn\service\client\TestSecureApiServiceClient.java,133,40,3,1,1,45
 hadoop-trunk\hadoop-trunk\hadoop-hdfs-project\hadoop-hdfs\src\test\java\org\apache\hadoop\TestRefreshCallQueue.java,133,30,8,2,7,47
 hadoop-trunk\hadoop-trunk\hadoop-hdfs-project\hadoop-hdfs\src\test\java\org\apache\hadoop\hdfs\TestFSOutputSummer.java,133,103,2,2,2,109
 hadoop-trunk\hadoop-trunk\hadoop-mapreduce-project\hadoop-mapreduce-client\hadoop-mapreduce-client-shuffle\src\main\java\org\apache\hadoop\mapred\FadvisedFileRegion.java,133,69,2,1,0,72
 hadoop-trunk\hadoop-trunk\hadoop-common-project\hadoop-common\src\test\java\org\apache\hadoop\fs\contract\AbstractContractAppendTest.java,133,26,2,4,0,32
 hadoop-trunk\hadoop-trunk\hadoop-tools\hadoop-azure\src\main\java\org\apache\hadoop\fs\azurebfs\utils\TextFileBasedIdentityHandler.java,133,33,9,18,0,60
 hadoop-trunk\hadoop-trunk\hadoop-yarn-project\hadoop-yarn\hadoop-yarn-common\src\main\java\org\apache\hadoop\yarn\api\protocolrecords\impl\pb\IncreaseContainersResourceRequestPBImpl.java,133,24,42,4,0,70
 hadoop-trunk\hadoop-trunk\hadoop-hdfs-project\hadoop-hdfs\src\test\java\org\apache\hadoop\hdfs\server\namenode\TestAuthorizationContext.java,133,14,1,1,3,19
 hadoop-trunk\hadoop-trunk\hadoop-common-project\hadoop-common\src\main\java\org\apache\hadoop\fs\LocalFileSystem.java,133,52,2,2,0,56
 hadoop-trunk\hadoop-trunk\hadoop-common-project\hadoop-common\src\test\java\org\apache\hadoop\util\TestSysInfoWindows.java,133,56,1,1,0,58
 hadoop-trunk\hadoop-trunk\hadoop-common-project\hadoop-common\src\main\java\org\apache\hadoop\io\compress\zlib\ZlibFactory.java,133,58,6,3,0,67
 hadoop-trunk\hadoop-trunk\hadoop-mapreduce-project\hadoop-mapreduce-client\hadoop-mapreduce-client-app\src\test\java\org\apache\hadoop\mapreduce\v2\app\MockAppContext.java,133,65,1,3,5,74
 hadoop-trunk\hadoop-trunk\hadoop-common-project\hadoop-common\src\main\java\org\apache\hadoop\fs\Stat.java,133,43,4,3,1,51
 hadoop-trunk\hadoop-trunk\hadoop-yarn-project\hadoop-yarn\hadoop-yarn-client\src\main\java\org\apache\hadoop\yarn\client\cli\QueueCLI.java,133,18,3,1,0,22
 hadoop-trunk\hadoop-trunk\hadoop-hdfs-project\hadoop-hdfs\src\test\java\org\apache\hadoop\hdfs\security\TestDelegationTokenForProxyUser.java,133,50,10,6,3,69
 hadoop-trunk\hadoop-trunk\hadoop-tools\hadoop-azure\src\main\java\org\apache\hadoop\fs\azure\SelfThrottlingIntercept.java,133,52,8,17,0,77
 hadoop-trunk\hadoop-trunk\hadoop-mapreduce-project\hadoop-mapreduce-client\hadoop-mapreduce-client-jobclient\src\test\java\org\apache\hadoop\mapred\TestFileOutputFormat.java,133,25,9,1,0,35
 hadoop-trunk\hadoop-trunk\hadoop-yarn-project\hadoop-yarn\hadoop-yarn-server\hadoop-yarn-server-resourcemanager\src\main\java\org\apache\hadoop\yarn\server\resourcemanager\scheduler\capacity\preemption\PreemptionManager.java,133,40,2,2,0,44
 hadoop-trunk\hadoop-trunk\hadoop-hdfs-project\hadoop-hdfs\src\main\java\org\apache\hadoop\hdfs\server\common\MetricsLoggerTask.java,133,19,12,1,0,32
 hadoop-trunk\hadoop-trunk\hadoop-common-project\hadoop-common\src\test\java\org\apache\hadoop\io\compress\TestCompressionStreamReuse.java,133,17,7,1,1,26
 hadoop-trunk\hadoop-trunk\hadoop-yarn-project\hadoop-yarn\hadoop-yarn-api\src\main\java\org\apache\hadoop\yarn\api\records\impl\LightWeightResource.java,133,29,8,2,0,39
 hadoop-trunk\hadoop-trunk\hadoop-yarn-project\hadoop-yarn\hadoop-yarn-server\hadoop-yarn-server-web-proxy\src\main\java\org\apache\hadoop\yarn\server\webproxy\AppReportFetcher.java,133,29,2,3,4,38
 hadoop-trunk\hadoop-trunk\hadoop-hdfs-project\hadoop-hdfs-nfs\src\test\java\org\apache\hadoop\hdfs\nfs\TestOutOfOrderWrite.java,133,51,4,1,0,56
 hadoop-trunk\hadoop-trunk\hadoop-hdfs-project\hadoop-hdfs\src\test\java\org\apache\hadoop\hdfs\TestSafeModeWithStripedFile.java,133,19,4,1,1,25
 kafka-trunk\kafka-trunk\connect\mirror\src\test\java\org\apache\kafka\connect\mirror\MirrorSourceTaskTest.java,133,0,0,43,5,48
 kafka-trunk\kafka-trunk\clients\src\generated\java\org\apache\kafka\common\message\AlterUserScramCredentialsRequestDataJsonConverter.java,133,0,0,38,0,38
 kafka-trunk\kafka-trunk\clients\src\test\java\org\apache\kafka\clients\NodeApiVersionsTest.java,133,0,1,28,0,29
 kafka-trunk\kafka-trunk\clients\src\generated\java\org\apache\kafka\common\message\AlterConfigsRequestDataJsonConverter.java,133,0,0,27,0,27
 kafka-trunk\kafka-trunk\metadata\src\generated\java\org\apache\kafka\common\metadata\PartitionRecordJsonConverter.java,133,0,0,32,0,32
 kafka-trunk\kafka-trunk\clients\src\generated\java\org\apache\kafka\common\message\VoteResponseDataJsonConverter.java,133,0,0,29,0,29
 kafka-trunk\kafka-trunk\metadata\src\test\java\org\apache\kafka\controller\ProducerIdControlManagerTest.java,133,0,1,17,0,18
 pulsar-master\pulsar-master\pulsar-proxy\src\test\java\org\apache\pulsar\proxy\server\ProxyPrometheusMetricsTest.java,133,26,3,15,0,44
 pulsar-master\pulsar-master\pulsar-testclient\src\main\java\org\apache\pulsar\testclient\utils\FixedColumnLengthTableMaker.java,133,22,0,12,0,34
 pulsar-master\pulsar-master\pulsar-client-1x-base\pulsar-client-1x\src\main\java\org\apache\pulsar\client\impl\v1\PulsarClientV1Impl.java,133,50,3,19,0,72
 pulsar-master\pulsar-master\pulsar-functions\worker\src\main\java\org\apache\pulsar\functions\worker\service\WorkerServiceLoader.java,133,28,2,15,0,45
 pulsar-master\pulsar-master\pulsar-common\src\main\java\org\apache\pulsar\common\policies\data\TopicPolicies.java,133,81,0,2,0,83
 pulsar-master\pulsar-master\pulsar-client-tools\src\main\java\org\apache\pulsar\admin\cli\CmdSchemas.java,133,40,3,23,0,66
 pulsar-master\pulsar-master\pulsar-client\src\test\java\org\apache\pulsar\client\impl\MemoryLimitControllerTest.java,133,24,0,1,0,25
 pulsar-master\pulsar-master\pulsar-common\src\test\java\org\apache\pulsar\common\policies\data\LocalPolicesTest.java,133,40,4,21,0,65
 rocketmq-develop\rocketmq-develop\namesrv\src\main\java\org\apache\rocketmq\namesrv\NamesrvStartup.java,133,31,3,15,7,56
 shardingsphere-master\shardingsphere-master\shardingsphere-jdbc\shardingsphere-jdbc-spring\shardingsphere-jdbc-core-spring\shardingsphere-jdbc-core-spring-boot-starter\src\test\java\org\apache\shardingsphere\spring\boot\SpringBootStarterTest.java,133,65,0,44,0,109
 skywalking-master\skywalking-master\oap-server\server-configuration\configuration-nacos\src\main\java\org\apache\skywalking\oap\server\configuration\nacos\NacosConfigWatcherRegister.java,133,30,0,15,0,45
 dubbo-3.0\dubbo-3.0\dubbo-rpc\dubbo-rpc-api\src\test\java\org\apache\dubbo\rpc\support\MockInvokerTest.java,134,16,0,7,0,23
 hadoop-trunk\hadoop-trunk\hadoop-tools\hadoop-kafka\src\test\java\org\apache\hadoop\metrics2\impl\TestKafkaMetrics.java,134,14,5,1,7,27
 hadoop-trunk\hadoop-trunk\hadoop-yarn-project\hadoop-yarn\hadoop-yarn-api\src\main\java\org\apache\hadoop\yarn\api\records\ApplicationAttemptId.java,134,30,7,2,0,39
 hadoop-trunk\hadoop-trunk\hadoop-tools\hadoop-rumen\src\main\java\org\apache\hadoop\tools\rumen\JobHistoryUtils.java,134,11,8,1,0,20
 hadoop-trunk\hadoop-trunk\hadoop-tools\hadoop-aws\src\test\java\org\apache\hadoop\fs\s3a\commit\magic\ITestS3AHugeMagicCommits.java,134,13,2,1,0,16
 hadoop-trunk\hadoop-trunk\hadoop-hdfs-project\hadoop-hdfs\src\test\java\org\apache\hadoop\hdfs\server\datanode\TestDataNodeFaultInjector.java,134,13,3,1,1,18
 hadoop-trunk\hadoop-trunk\hadoop-mapreduce-project\hadoop-mapreduce-client\hadoop-mapreduce-client-core\src\main\java\org\apache\hadoop\mapred\lib\ChainReducer.java,134,38,5,1,0,44
 hadoop-trunk\hadoop-trunk\hadoop-mapreduce-project\hadoop-mapreduce-client\hadoop-mapreduce-client-core\src\main\java\org\apache\hadoop\mapreduce\lib\db\DateSplitter.java,134,33,10,13,6,62
 hadoop-trunk\hadoop-trunk\hadoop-common-project\hadoop-common\src\test\java\org\apache\hadoop\io\erasurecode\TestCodecRegistry.java,134,10,0,2,12,24
 hadoop-trunk\hadoop-trunk\hadoop-hdfs-project\hadoop-hdfs\src\test\java\org\apache\hadoop\hdfs\TestFetchImage.java,134,28,1,2,6,37
 hadoop-trunk\hadoop-trunk\hadoop-hdfs-project\hadoop-hdfs\src\test\java\org\apache\hadoop\hdfs\TestMissingBlocksAlert.java,134,36,4,2,0,42
 hadoop-trunk\hadoop-trunk\hadoop-hdfs-project\hadoop-hdfs\src\test\java\org\apache\hadoop\hdfs\TestFileStatusSerialization.java,134,17,29,2,0,48
 hadoop-trunk\hadoop-trunk\hadoop-hdfs-project\hadoop-hdfs\src\test\java\org\apache\hadoop\hdfs\server\datanode\TestDataXceiverLazyPersistHint.java,134,19,6,1,2,28
 hadoop-trunk\hadoop-trunk\hadoop-yarn-project\hadoop-yarn\hadoop-yarn-client\src\test\java\org\apache\hadoop\yarn\client\api\impl\BaseAMRMProxyE2ETest.java,134,14,1,4,0,19
 hadoop-trunk\hadoop-trunk\hadoop-yarn-project\hadoop-yarn\hadoop-yarn-common\src\main\java\org\apache\hadoop\yarn\api\protocolrecords\impl\pb\GetNewApplicationResponsePBImpl.java,134,50,47,6,0,103
 hadoop-trunk\hadoop-trunk\hadoop-mapreduce-project\hadoop-mapreduce-client\hadoop-mapreduce-client-core\src\test\java\org\apache\hadoop\mapred\TestOldMethodsJobID.java,134,82,1,5,0,88
 hadoop-trunk\hadoop-trunk\hadoop-yarn-project\hadoop-yarn\hadoop-yarn-server\hadoop-yarn-server-common\src\main\java\org\apache\hadoop\yarn\server\api\protocolrecords\impl\pb\GetTimelineCollectorContextResponsePBImpl.java,134,25,43,4,0,72
 hadoop-trunk\hadoop-trunk\hadoop-yarn-project\hadoop-yarn\hadoop-yarn-server\hadoop-yarn-server-nodemanager\src\main\java\org\apache\hadoop\yarn\server\nodemanager\containermanager\scheduler\AllocationBasedResourceUtilizationTracker.java,134,23,2,3,1,29
 hadoop-trunk\hadoop-trunk\hadoop-mapreduce-project\hadoop-mapreduce-client\hadoop-mapreduce-client-jobclient\src\test\java\org\apache\hadoop\mapred\TestMapOutputType.java,134,47,10,2,0,59
 hadoop-trunk\hadoop-trunk\hadoop-common-project\hadoop-common\src\main\java\org\apache\hadoop\crypto\JceCtrCryptoCodec.java,134,56,2,4,5,67
 hadoop-trunk\hadoop-trunk\hadoop-tools\hadoop-aws\src\main\java\org\apache\hadoop\fs\s3a\auth\delegation\FullCredentialsTokenBinding.java,134,5,1,2,0,8
 kafka-trunk\kafka-trunk\streams\test-utils\src\test\java\org\apache\kafka\streams\test\TestRecordTest.java,134,0,2,29,5,36
 kafka-trunk\kafka-trunk\clients\src\test\java\org\apache\kafka\common\security\oauthbearer\secured\HttpAccessTokenRetrieverTest.java,134,0,1,25,1,27
 kafka-trunk\kafka-trunk\clients\src\test\java\org\apache\kafka\common\protocol\SendBuilderTest.java,134,0,0,6,0,6
 kafka-trunk\kafka-trunk\connect\runtime\src\test\java\org\apache\kafka\connect\runtime\WorkerConfigTest.java,134,0,0,28,0,28
 kafka-trunk\kafka-trunk\streams\src\test\java\org\apache\kafka\streams\kstream\WindowedSerdesTest.java,134,0,1,46,9,56
 pulsar-master\pulsar-master\pulsar-broker\src\test\java\org\apache\pulsar\broker\service\GracefulExecutorServicesShutdownTest.java,134,26,0,19,0,45
 pulsar-master\pulsar-master\pulsar-broker\src\main\java\org\apache\pulsar\broker\stats\prometheus\AggregatedNamespaceStats.java,134,78,0,19,0,97
 pulsar-master\pulsar-master\pulsar-common\src\main\java\org\apache\pulsar\common\policies\data\stats\ConsumerStatsImpl.java,134,46,1,6,0,53
 pulsar-master\pulsar-master\pulsar-broker\src\test\java\org\apache\pulsar\broker\admin\TopicsAuthTest.java,134,59,5,22,0,86
 pulsar-master\pulsar-master\pulsar-broker-common\src\main\java\org\apache\pulsar\broker\authentication\AuthenticationService.java,134,45,2,28,0,75
 pulsar-master\pulsar-master\pulsar-broker\src\main\java\org\apache\pulsar\broker\loadbalance\impl\UniformLoadShedder.java,134,59,0,52,0,111
 pulsar-master\pulsar-master\pulsar-broker\src\test\java\org\apache\pulsar\client\impl\MessageIdTest.java,134,32,0,21,0,53
 rocketmq-develop\rocketmq-develop\tools\src\test\java\org\apache\rocketmq\tools\command\message\ConsumeMessageCommandTest.java,134,39,24,28,10,101
 rocketmq-develop\rocketmq-develop\tools\src\main\java\org\apache\rocketmq\tools\command\message\SendMessageCommand.java,134,25,0,14,2,41
 skywalking-master\skywalking-master\oap-server\server-storage-plugin\storage-jdbc-hikaricp-plugin\src\main\java\org\apache\skywalking\oap\server\storage\plugin\jdbc\postgresql\PostgreSQLStorageProvider.java,134,48,1,70,0,119
 skywalking-master\skywalking-master\oap-server\server-library\library-datacarrier-queue\src\main\java\org\apache\skywalking\oap\server\library\datacarrier\DataCarrier.java,134,77,0,26,0,103
 zookeeper-master\zookeeper-master\zookeeper-server\src\main\java\org\apache\zookeeper\server\controller\ControllerService.java,134,0,4,16,4,24
 zookeeper-master\zookeeper-master\zookeeper-server\src\main\java\org\apache\zookeeper\server\util\OSMXBean.java,134,0,7,11,5,23
 dubbo-3.0\dubbo-3.0\dubbo-metadata\dubbo-metadata-processor\src\test\java\org\apache\dubbo\metadata\annotation\processing\model\SimpleTypeModel.java,135,93,1,1,0,95
 dubbo-3.0\dubbo-3.0\dubbo-cluster\src\main\java\org\apache\dubbo\rpc\cluster\router\mesh\route\MeshRuleCache.java,135,51,2,24,0,77
 dubbo-3.0\dubbo-3.0\dubbo-cluster\src\test\java\org\apache\dubbo\rpc\cluster\directory\MockDirInvocation.java,135,56,2,2,0,60
 dubbo-3.0\dubbo-3.0\dubbo-common\src\main\java\org\apache\dubbo\common\utils\AtomicPositiveInteger.java,135,40,2,7,0,49
 hadoop-trunk\hadoop-trunk\hadoop-yarn-project\hadoop-yarn\hadoop-yarn-common\src\main\java\org\apache\hadoop\yarn\logaggregation\ContainerLogsRequest.java,135,97,1,1,6,105
 hadoop-trunk\hadoop-trunk\hadoop-yarn-project\hadoop-yarn\hadoop-yarn-server\hadoop-yarn-server-nodemanager\src\main\java\org\apache\hadoop\yarn\server\nodemanager\containermanager\linux\resources\CGroupsMemoryResourceHandlerImpl.java,135,27,5,4,0,36
 hadoop-trunk\hadoop-trunk\hadoop-yarn-project\hadoop-yarn\hadoop-yarn-server\hadoop-yarn-server-nodemanager\src\test\java\org\apache\hadoop\yarn\server\nodemanager\containermanager\resourceplugin\gpu\TestGpuResourcePlugin.java,135,10,0,6,2,18
 hadoop-trunk\hadoop-trunk\hadoop-tools\hadoop-rumen\src\main\java\org\apache\hadoop\tools\rumen\LoggedNetworkTopology.java,135,41,1,1,1,44
 hadoop-trunk\hadoop-trunk\hadoop-hdfs-project\hadoop-hdfs-rbf\src\main\java\org\apache\hadoop\hdfs\server\federation\store\driver\impl\StateStoreFileSystemImpl.java,135,20,2,1,3,26
 hadoop-trunk\hadoop-trunk\hadoop-yarn-project\hadoop-yarn\hadoop-yarn-server\hadoop-yarn-server-nodemanager\src\test\java\org\apache\hadoop\yarn\server\nodemanager\containermanager\linux\resources\numa\TestNumaResourceHandlerImpl.java,135,27,0,7,4,38
 hadoop-trunk\hadoop-trunk\hadoop-mapreduce-project\hadoop-mapreduce-client\hadoop-mapreduce-client-hs\src\main\java\org\apache\hadoop\mapreduce\v2\hs\CompletedTask.java,135,29,0,2,3,34
 hadoop-trunk\hadoop-trunk\hadoop-common-project\hadoop-common\src\main\java\org\apache\hadoop\service\ServiceStateModel.java,135,26,2,1,0,29
 hadoop-trunk\hadoop-trunk\hadoop-tools\hadoop-openstack\src\test\java\org\apache\hadoop\fs\swift\TestSwiftFileSystemBlockLocation.java,135,15,3,1,0,19
 hadoop-trunk\hadoop-trunk\hadoop-hdfs-project\hadoop-hdfs\src\test\java\org\apache\hadoop\hdfs\qjournal\QJMTestUtil.java,135,52,0,4,0,56
 hadoop-trunk\hadoop-trunk\hadoop-hdfs-project\hadoop-hdfs\src\test\java\org\apache\hadoop\hdfs\server\blockmanagement\TestUnderReplicatedBlocks.java,135,23,10,2,0,35
 hadoop-trunk\hadoop-trunk\hadoop-tools\hadoop-azure\src\main\java\org\apache\hadoop\fs\azurebfs\utils\TracingContext.java,135,58,4,3,2,67
 hadoop-trunk\hadoop-trunk\hadoop-yarn-project\hadoop-yarn\hadoop-yarn-common\src\main\java\org\apache\hadoop\yarn\api\records\impl\pb\PreemptionMessagePBImpl.java,135,32,46,1,0,79
 hadoop-trunk\hadoop-trunk\hadoop-tools\hadoop-openstack\src\test\java\org\apache\hadoop\fs\swift\TestSwiftObjectPath.java,135,27,4,6,1,38
 hadoop-trunk\hadoop-trunk\hadoop-mapreduce-project\hadoop-mapreduce-client\hadoop-mapreduce-client-core\src\test\java\org\apache\hadoop\mapreduce\lib\db\TestDbClasses.java,135,21,4,7,0,32
 hadoop-trunk\hadoop-trunk\hadoop-yarn-project\hadoop-yarn\hadoop-yarn-api\src\main\java\org\apache\hadoop\yarn\api\records\timelineservice\TimelineDomain.java,135,22,2,1,0,25
 hadoop-trunk\hadoop-trunk\hadoop-yarn-project\hadoop-yarn\hadoop-yarn-common\src\main\java\org\apache\hadoop\yarn\api\protocolrecords\impl\pb\UpdateApplicationPriorityRequestPBImpl.java,135,34,48,5,0,87
 hadoop-trunk\hadoop-trunk\hadoop-hdfs-project\hadoop-hdfs\src\test\java\org\apache\hadoop\hdfs\tools\offlineImageViewer\TestOfflineImageViewerForStoragePolicy.java,135,11,6,2,3,22
 hadoop-trunk\hadoop-trunk\hadoop-common-project\hadoop-common\src\main\java\org\apache\hadoop\util\ReadWriteDiskValidatorMetrics.java,135,18,2,1,1,22
 hadoop-trunk\hadoop-trunk\hadoop-common-project\hadoop-common\src\test\java\org\apache\hadoop\ipc\TestProtoBufRPCCompatibility.java,135,35,35,4,0,74
 kafka-trunk\kafka-trunk\clients\src\main\java\org\apache\kafka\common\security\oauthbearer\internals\unsecured\OAuthBearerUnsecuredValidatorCallbackHandler.java,135,0,8,38,0,46
 kafka-trunk\kafka-trunk\clients\src\test\java\org\apache\kafka\common\security\oauthbearer\secured\ClaimValidationUtilsTest.java,135,0,0,21,2,23
 kafka-trunk\kafka-trunk\clients\src\main\java\org\apache\kafka\common\network\NetworkReceive.java,135,0,6,8,2,16
 kafka-trunk\kafka-trunk\connect\transforms\src\test\java\org\apache\kafka\connect\transforms\SetSchemaMetadataTest.java,135,0,0,20,1,21
 kafka-trunk\kafka-trunk\streams\src\test\java\org\apache\kafka\streams\processor\internals\ProcessorMetadataTest.java,135,0,2,3,0,5
 kafka-trunk\kafka-trunk\metadata\src\test\java\org\apache\kafka\metadata\authorizer\MockAuthorizableRequestContext.java,135,0,0,2,2,4
 kafka-trunk\kafka-trunk\clients\src\generated\java\org\apache\kafka\common\message\OffsetForLeaderEpochResponseDataJsonConverter.java,135,0,0,34,0,34
 kafka-trunk\kafka-trunk\streams\examples\src\test\java\org\apache\kafka\streams\examples\docs\DeveloperGuideTesting.java,135,0,1,20,2,23
 kafka-trunk\kafka-trunk\clients\src\test\java\org\apache\kafka\common\utils\ImplicitLinkedHashMultiCollectionTest.java,135,0,2,15,0,17
 kafka-trunk\kafka-trunk\trogdor\src\main\java\org\apache\kafka\trogdor\workload\ProduceBenchSpec.java,135,0,0,16,5,21
 pulsar-master\pulsar-master\pulsar-metadata\src\test\java\org\apache\pulsar\metadata\MetadataStoreBatchingTest.java,135,45,1,21,0,67
 pulsar-master\pulsar-master\pulsar-broker\src\test\java\org\apache\pulsar\broker\stats\prometheus\AggregatedNamespaceStatsTest.java,135,89,0,7,0,96
 pulsar-master\pulsar-master\pulsar-client\src\test\java\org\apache\pulsar\client\impl\schema\SupportVersioningKeyValueSchemaTest.java,135,40,0,28,0,68
 pulsar-master\pulsar-master\pulsar-common\src\main\java\org\apache\pulsar\common\util\keystoretls\SSLContextValidatorEngine.java,135,34,3,18,0,55
 rocketmq-develop\rocketmq-develop\logging\src\main\java\org\apache\rocketmq\logging\inner\Level.java,135,64,8,1,1,74
 rocketmq-develop\rocketmq-develop\client\src\test\java\org\apache\rocketmq\client\impl\factory\MQClientInstanceTest.java,135,43,0,26,0,69
 rocketmq-develop\rocketmq-develop\test\src\test\java\org\apache\rocketmq\test\client\producer\order\OrderMsgWithTagIT.java,135,29,1,15,6,51
 skywalking-master\skywalking-master\oap-server\server-storage-plugin\storage-jdbc-hikaricp-plugin\src\main\java\org\apache\skywalking\oap\server\storage\plugin\jdbc\mysql\MySQLStorageProvider.java,135,52,1,68,0,121
 skywalking-master\skywalking-master\oap-server\server-storage-plugin\storage-elasticsearch-plugin\src\main\java\org\apache\skywalking\oap\server\storage\plugin\elasticsearch\query\TraceQueryEsDAO.java,135,44,2,28,0,74
 skywalking-master\skywalking-master\oap-server\server-receiver-plugin\envoy-metrics-receiver-plugin\src\test\java\org\apache\skywalking\oap\server\receiver\envoy\als\k8s\K8SALSServiceMeshHTTPAnalysisTest.java,135,39,4,30,0,73
 zookeeper-master\zookeeper-master\zookeeper-server\src\main\java\org\apache\zookeeper\server\util\SerializeUtils.java,135,0,36,7,0,43
 zookeeper-master\zookeeper-master\zookeeper-server\src\test\java\org\apache\zookeeper\test\NonRecoverableErrorTest.java,135,0,10,15,0,25
 dubbo-3.0\dubbo-3.0\dubbo-remoting\dubbo-remoting-api\src\main\java\org\apache\dubbo\remoting\telnet\support\TelnetUtils.java,136,16,5,6,0,27
 dubbo-3.0\dubbo-3.0\dubbo-compatible\src\test\java\org\apache\dubbo\service\MockInvocation.java,136,58,2,2,0,62
 dubbo-3.0\dubbo-3.0\dubbo-config\dubbo-config-spring\src\test\java\org\apache\dubbo\config\spring\JavaConfigBeanTest.java,136,28,0,17,0,45
 hadoop-trunk\hadoop-trunk\hadoop-yarn-project\hadoop-yarn\hadoop-yarn-client\src\test\java\org\apache\hadoop\yarn\client\api\impl\TestSharedCacheClientImpl.java,136,23,0,4,5,32
 hadoop-trunk\hadoop-trunk\hadoop-yarn-project\hadoop-yarn\hadoop-yarn-common\src\main\java\org\apache\hadoop\yarn\api\records\impl\pb\NodeAttributePBImpl.java,136,29,43,1,0,73
 hadoop-trunk\hadoop-trunk\hadoop-yarn-project\hadoop-yarn\hadoop-yarn-server\hadoop-yarn-server-resourcemanager\src\test\java\org\apache\hadoop\yarn\server\resourcemanager\MockRMAppSubmitter.java,136,17,2,3,0,22
 hadoop-trunk\hadoop-trunk\hadoop-yarn-project\hadoop-yarn\hadoop-yarn-server\hadoop-yarn-server-common\src\test\java\org\apache\hadoop\yarn\server\federation\utils\FederationStateStoreTestUtil.java,136,46,0,13,0,59
 hadoop-trunk\hadoop-trunk\hadoop-yarn-project\hadoop-yarn\hadoop-yarn-server\hadoop-yarn-server-resourcemanager\src\main\java\org\apache\hadoop\yarn\server\resourcemanager\scheduler\common\ResourceCommitRequest.java,136,37,2,3,9,51
 hadoop-trunk\hadoop-trunk\hadoop-yarn-project\hadoop-yarn\hadoop-yarn-server\hadoop-yarn-server-router\src\main\java\org\apache\hadoop\yarn\server\router\Router.java,136,27,3,1,2,33
 hadoop-trunk\hadoop-trunk\hadoop-yarn-project\hadoop-yarn\hadoop-yarn-server\hadoop-yarn-server-resourcemanager\src\test\java\org\apache\hadoop\yarn\server\resourcemanager\scheduler\fair\converter\FSConfigConverterTestCommons.java,136,38,5,4,7,54
 hadoop-trunk\hadoop-trunk\hadoop-yarn-project\hadoop-yarn\hadoop-yarn-common\src\main\java\org\apache\hadoop\yarn\factories\impl\pb\RpcServerFactoryPBImpl.java,136,65,9,10,3,87
 hadoop-trunk\hadoop-trunk\hadoop-hdfs-project\hadoop-hdfs\src\test\java\org\apache\hadoop\hdfs\server\namenode\TestEditLogFileInputStream.java,136,35,19,4,5,63
 hadoop-trunk\hadoop-trunk\hadoop-hdfs-project\hadoop-hdfs\src\test\java\org\apache\hadoop\hdfs\server\namenode\ha\TestHAMetrics.java,136,33,0,1,0,34
 hadoop-trunk\hadoop-trunk\hadoop-common-project\hadoop-common\src\test\java\org\apache\hadoop\fs\statistics\TestIOStatisticsStore.java,136,49,0,8,0,57
 hadoop-trunk\hadoop-trunk\hadoop-mapreduce-project\hadoop-mapreduce-client\hadoop-mapreduce-client-nativetask\src\main\java\org\apache\hadoop\mapred\nativetask\buffer\ByteBufferDataWriter.java,136,41,1,2,0,44
 hadoop-trunk\hadoop-trunk\hadoop-tools\hadoop-aws\src\test\java\org\apache\hadoop\fs\s3a\select\ITestS3SelectMRJob.java,136,13,2,3,5,23
 hadoop-trunk\hadoop-trunk\hadoop-yarn-project\hadoop-yarn\hadoop-yarn-common\src\test\java\org\apache\hadoop\yarn\webapp\hamlet2\TestHamlet.java,136,20,10,1,1,32
 hadoop-trunk\hadoop-trunk\hadoop-tools\hadoop-openstack\src\test\java\org\apache\hadoop\fs\swift\TestSwiftFileSystemLsOperations.java,136,14,1,2,0,17
 hadoop-trunk\hadoop-trunk\hadoop-yarn-project\hadoop-yarn\hadoop-yarn-server\hadoop-yarn-server-sharedcachemanager\src\test\java\org\apache\hadoop\yarn\server\sharedcachemanager\TestSharedCacheUploaderService.java,136,18,3,4,3,28
 hadoop-trunk\hadoop-trunk\hadoop-yarn-project\hadoop-yarn\hadoop-yarn-server\hadoop-yarn-server-nodemanager\src\test\java\org\apache\hadoop\yarn\server\nodemanager\health\TestNodeHealthScriptRunner.java,136,12,0,1,0,13
 hadoop-trunk\hadoop-trunk\hadoop-hdfs-project\hadoop-hdfs-rbf\src\test\java\org\apache\hadoop\hdfs\server\federation\store\records\TestMembershipState.java,136,38,0,3,0,41
 hadoop-trunk\hadoop-trunk\hadoop-yarn-project\hadoop-yarn\hadoop-yarn-applications\hadoop-yarn-services\hadoop-yarn-services-core\src\main\java\org\apache\hadoop\yarn\service\containerlaunch\ClasspathConstructor.java,136,42,2,2,0,46
 kafka-trunk\kafka-trunk\clients\src\test\java\org\apache\kafka\clients\consumer\internals\ConsumerMetadataTest.java,136,0,5,30,1,36
 kafka-trunk\kafka-trunk\metadata\src\test\java\org\apache\kafka\controller\FeatureControlManagerTest.java,136,0,1,16,0,17
 kafka-trunk\kafka-trunk\clients\src\main\java\org\apache\kafka\common\memory\GarbageCollectedMemoryPool.java,136,0,4,35,1,40
 pulsar-master\pulsar-master\pulsar-functions\instance\src\main\java\org\apache\pulsar\functions\instance\stats\ComponentStatsManager.java,136,70,0,18,0,88
 pulsar-master\pulsar-master\pulsar-broker\src\test\java\org\apache\pulsar\broker\namespace\NamespaceOwnershipListenerTests.java,136,25,2,13,0,40
 pulsar-master\pulsar-master\pulsar-broker\src\test\java\org\apache\pulsar\broker\service\ConsumedLedgersTrimTest.java,136,35,12,21,0,68
 rocketmq-develop\rocketmq-develop\test\src\main\java\org\apache\rocketmq\test\util\MQAdmin.java,136,48,6,15,10,79
 rocketmq-develop\rocketmq-develop\common\src\main\java\org\apache\rocketmq\common\protocol\header\SendMessageRequestHeader.java,136,90,1,2,0,93
 skywalking-master\skywalking-master\oap-server\server-core\src\main\java\org\apache\skywalking\oap\server\core\profiling\ebpf\EBPFProfilingMutationService.java,136,39,2,29,0,70
 zookeeper-master\zookeeper-master\zookeeper-server\src\test\java\org\apache\zookeeper\test\PersistentRecursiveWatcherTest.java,136,0,24,30,0,54
 zookeeper-master\zookeeper-master\zookeeper-jute\src\main\java\org\apache\jute\compiler\JMap.java,136,0,0,21,0,21
 dubbo-3.0\dubbo-3.0\dubbo-common\src\main\java\org\apache\dubbo\common\compiler\support\CtClassBuilder.java,137,58,0,4,5,67
 dubbo-3.0\dubbo-3.0\dubbo-common\src\main\java\org\apache\dubbo\common\url\component\ServiceConfigURL.java,137,115,4,21,0,140
 dubbo-3.0\dubbo-3.0\dubbo-common\src\main\java\org\apache\dubbo\common\cache\FileCacheStoreFactory.java,137,35,6,12,2,55
 dubbo-3.0\dubbo-3.0\dubbo-test\dubbo-test-check\src\main\java\org\apache\dubbo\test\check\registrycenter\initializer\DownloadZookeeperInitializer.java,137,49,3,33,9,94
 hadoop-trunk\hadoop-trunk\hadoop-yarn-project\hadoop-yarn\hadoop-yarn-server\hadoop-yarn-server-common\src\main\java\org\apache\hadoop\yarn\server\webapp\WrappedLogMetaRequest.java,137,40,1,3,3,47
 hadoop-trunk\hadoop-trunk\hadoop-common-project\hadoop-minikdc\src\test\java\org\apache\hadoop\minikdc\TestMiniKdc.java,137,18,0,1,0,19
 hadoop-trunk\hadoop-trunk\hadoop-tools\hadoop-aws\src\test\java\org\apache\hadoop\fs\s3a\auth\ITestJceksIO.java,137,17,4,5,2,28
 hadoop-trunk\hadoop-trunk\hadoop-yarn-project\hadoop-yarn\hadoop-yarn-server\hadoop-yarn-server-nodemanager\src\main\java\org\apache\hadoop\yarn\server\nodemanager\containermanager\linux\resources\CGroupsBlkioResourceHandlerImpl.java,137,22,7,4,0,33
 hadoop-trunk\hadoop-trunk\hadoop-yarn-project\hadoop-yarn\hadoop-yarn-api\src\main\java\org\apache\hadoop\yarn\api\records\ReservationAllocationState.java,137,5,0,1,0,6
 hadoop-trunk\hadoop-trunk\hadoop-tools\hadoop-sls\src\main\java\org\apache\hadoop\yarn\sls\AMDefinitionRumen.java,137,35,0,2,2,39
 hadoop-trunk\hadoop-trunk\hadoop-common-project\hadoop-common\src\test\java\org\apache\hadoop\io\file\tfile\TestVLong.java,137,44,3,1,3,51
 hadoop-trunk\hadoop-trunk\hadoop-common-project\hadoop-common\src\test\java\org\apache\hadoop\util\TestClasspath.java,137,27,13,2,2,44
 hadoop-trunk\hadoop-trunk\hadoop-hdfs-project\hadoop-hdfs\src\test\java\org\apache\hadoop\hdfs\protocol\datatransfer\sasl\TestSaslDataTransferExpiredBlockToken.java,137,30,0,9,4,43
 hadoop-trunk\hadoop-trunk\hadoop-mapreduce-project\hadoop-mapreduce-client\hadoop-mapreduce-client-jobclient\src\test\java\org\apache\hadoop\mapred\ClusterMapReduceTestCase.java,137,9,1,2,0,12
 hadoop-trunk\hadoop-trunk\hadoop-mapreduce-project\hadoop-mapreduce-client\hadoop-mapreduce-client-nativetask\src\main\java\org\apache\hadoop\mapred\nativetask\util\ReadWriteBuffer.java,137,113,4,1,3,121
 hadoop-trunk\hadoop-trunk\hadoop-common-project\hadoop-common\src\test\java\org\apache\hadoop\io\TestMapWritable.java,137,13,11,2,3,29
 hadoop-trunk\hadoop-trunk\hadoop-yarn-project\hadoop-yarn\hadoop-yarn-server\hadoop-yarn-server-resourcemanager\src\main\java\org\apache\hadoop\yarn\server\resourcemanager\scheduler\capacity\AutoCreatedLeafQueue.java,137,29,2,11,0,42
 hadoop-trunk\hadoop-trunk\hadoop-mapreduce-project\hadoop-mapreduce-client\hadoop-mapreduce-client-jobclient\src\test\java\org\apache\hadoop\mapreduce\v2\TestMRJobsWithHistoryService.java,137,27,9,2,1,39
 kafka-trunk\kafka-trunk\connect\runtime\src\test\java\org\apache\kafka\connect\util\TestFuture.java,137,0,8,6,4,18
 kafka-trunk\kafka-trunk\connect\runtime\src\main\java\org\apache\kafka\connect\tools\SchemaSourceTask.java,137,0,0,14,0,14
 kafka-trunk\kafka-trunk\clients\src\generated\java\org\apache\kafka\common\message\WriteTxnMarkersRequestDataJsonConverter.java,137,0,0,36,0,36
 kafka-trunk\kafka-trunk\storage\src\test\java\org\apache\kafka\server\log\remote\storage\InmemoryRemoteLogMetadataManager.java,137,0,0,50,3,53
 kafka-trunk\kafka-trunk\streams\test-utils\src\test\java\org\apache\kafka\streams\test\MockProcessorContextStateStoreTest.java,137,0,2,28,0,30
 kafka-trunk\kafka-trunk\streams\src\main\java\org\apache\kafka\streams\query\Position.java,137,0,1,29,1,31
 pulsar-master\pulsar-master\pulsar-proxy\src\main\java\org\apache\pulsar\proxy\server\ServiceChannelInitializer.java,137,39,0,22,0,61
 pulsar-master\pulsar-master\pulsar-common\src\main\java\org\apache\pulsar\common\policies\impl\NamespaceIsolationPolicyImpl.java,137,52,0,15,0,67
 pulsar-master\pulsar-master\pulsar-common\src\main\java\org\apache\pulsar\common\util\CmdGenerateDocs.java,137,30,7,13,0,50
 pulsar-master\pulsar-master\pulsar-broker\src\main\java\org\apache\pulsar\broker\service\PrecisPublishLimiter.java,137,57,6,20,0,83
 pulsar-master\pulsar-master\pulsar-broker\src\main\java\org\apache\pulsar\broker\resourcegroup\ResourceGroupNamespaceConfigListener.java,137,51,7,23,0,81
 puzzle-game-master\puzzle-game-master\core\src\com\jbgames\game\helpers\PathFinder.java,137,56,13,3,0,72
 rocketmq-develop\rocketmq-develop\tools\src\main\java\org\apache\rocketmq\tools\command\message\PrintMessageSubCommand.java,137,34,14,21,3,72
 rocketmq-develop\rocketmq-develop\logging\src\main\java\org\apache\rocketmq\logging\Slf4jLoggerFactory.java,137,68,1,1,1,71
 skywalking-master\skywalking-master\oap-server\server-storage-plugin\storage-tidb-plugin\src\main\java\org\apache\skywalking\oap\server\storage\plugin\jdbc\tidb\TiDBStorageProvider.java,137,52,1,73,0,126
 skywalking-master\skywalking-master\oap-server\server-storage-plugin\storage-elasticsearch-plugin\src\main\java\org\apache\skywalking\oap\server\storage\plugin\elasticsearch\query\ESEventQueryDAO.java,137,33,0,33,0,66
 zookeeper-master\zookeeper-master\zookeeper-server\src\main\java\org\apache\zookeeper\server\quorum\FollowerZooKeeperServer.java,137,0,8,19,0,27
 zookeeper-master\zookeeper-master\zookeeper-server\src\main\java\org\apache\zookeeper\ZooDefs.java,137,0,70,8,0,78
 dubbo-3.0\dubbo-3.0\dubbo-configcenter\dubbo-configcenter-zookeeper\src\test\java\org\apache\dubbo\configcenter\support\zookeeper\ZookeeperDynamicConfigurationTest.java,138,58,11,28,0,97
 dubbo-3.0\dubbo-3.0\dubbo-rpc\dubbo-rpc-api\src\test\java\org\apache\dubbo\rpc\filter\CompatibleFilterFilterTest.java,138,22,0,11,0,33
 dubbo-3.0\dubbo-3.0\dubbo-remoting\dubbo-remoting-api\src\main\java\org\apache\dubbo\remoting\transport\AbstractServer.java,138,46,10,17,7,80
 dubbo-3.0\dubbo-3.0\dubbo-rpc\dubbo-rpc-triple\src\main\java\org\apache\dubbo\rpc\protocol\tri\TripleProtocol.java,138,46,2,20,0,68
 dubbo-3.0\dubbo-3.0\dubbo-common\src\test\java\org\apache\dubbo\common\io\BytesTest.java,138,75,1,11,15,102
 hadoop-trunk\hadoop-trunk\hadoop-common-project\hadoop-common\src\main\java\org\apache\hadoop\metrics2\lib\MutableQuantiles.java,138,39,0,2,6,47
 hadoop-trunk\hadoop-trunk\hadoop-yarn-project\hadoop-yarn\hadoop-yarn-common\src\main\java\org\apache\hadoop\yarn\api\records\impl\pb\URLPBImpl.java,138,43,57,1,0,101
 hadoop-trunk\hadoop-trunk\hadoop-yarn-project\hadoop-yarn\hadoop-yarn-server\hadoop-yarn-server-nodemanager\src\test\java\org\apache\hadoop\yarn\server\nodemanager\containermanager\localizer\TestLocalCacheDirectoryManager.java,138,13,1,5,0,19
 hadoop-trunk\hadoop-trunk\hadoop-yarn-project\hadoop-yarn\hadoop-yarn-api\src\main\java\org\apache\hadoop\yarn\api\records\URL.java,138,20,0,2,0,22
 hadoop-trunk\hadoop-trunk\hadoop-yarn-project\hadoop-yarn\hadoop-yarn-applications\hadoop-yarn-applications-catalog\hadoop-yarn-applications-catalog-webapp\src\main\java\org\apache\hadoop\yarn\appcatalog\controller\AppListController.java,138,8,2,2,0,12
 hadoop-trunk\hadoop-trunk\hadoop-yarn-project\hadoop-yarn\hadoop-yarn-server\hadoop-yarn-server-common\src\main\java\org\apache\hadoop\yarn\server\webapp\ContainerBlock.java,138,19,0,1,1,21
 hadoop-trunk\hadoop-trunk\hadoop-mapreduce-project\hadoop-mapreduce-examples\src\main\java\org\apache\hadoop\examples\terasort\TeraValidate.java,138,51,2,1,0,54
 hadoop-trunk\hadoop-trunk\hadoop-mapreduce-project\hadoop-mapreduce-client\hadoop-mapreduce-client-nativetask\src\test\java\org\apache\hadoop\mapred\nativetask\buffer\TestByteBufferReadWrite.java,138,49,7,3,8,67
 hadoop-trunk\hadoop-trunk\hadoop-hdfs-project\hadoop-hdfs\src\main\java\org\apache\hadoop\hdfs\server\datanode\fsdataset\impl\PmemMappableBlockLoader.java,138,31,4,1,0,36
 hadoop-trunk\hadoop-trunk\hadoop-yarn-project\hadoop-yarn\hadoop-yarn-common\src\main\java\org\apache\hadoop\yarn\api\records\impl\pb\YarnClusterMetricsPBImpl.java,138,40,59,1,0,100
 hadoop-trunk\hadoop-trunk\hadoop-yarn-project\hadoop-yarn\hadoop-yarn-server\hadoop-yarn-server-nodemanager\src\test\java\org\apache\hadoop\yarn\server\nodemanager\nodelabels\TestConfigurationNodeLabelsProvider.java,138,22,1,2,0,25
 hadoop-trunk\hadoop-trunk\hadoop-hdfs-project\hadoop-hdfs\src\test\java\org\apache\hadoop\hdfs\server\namenode\TestNameNodeOptionParsing.java,138,21,1,5,0,27
 hadoop-trunk\hadoop-trunk\hadoop-hdfs-project\hadoop-hdfs\src\test\java\org\apache\hadoop\hdfs\qjournal\client\TestIPCLoggerChannel.java,138,41,5,3,0,49
 hadoop-trunk\hadoop-trunk\hadoop-yarn-project\hadoop-yarn\hadoop-yarn-applications\hadoop-yarn-applications-mawo\hadoop-yarn-applications-mawo-core\src\main\java\org\apache\hadoop\applications\mawo\server\worker\WorkerId.java,138,2,0,1,3,6
 hadoop-trunk\hadoop-trunk\hadoop-yarn-project\hadoop-yarn\hadoop-yarn-server\hadoop-yarn-server-resourcemanager\src\main\java\org\apache\hadoop\yarn\server\resourcemanager\monitor\invariants\MetricsInvariantChecker.java,138,20,8,2,0,30
 hadoop-trunk\hadoop-trunk\hadoop-yarn-project\hadoop-yarn\hadoop-yarn-common\src\main\java\org\apache\hadoop\yarn\api\protocolrecords\impl\pb\ReservationUpdateRequestPBImpl.java,138,33,46,4,0,83
 hadoop-trunk\hadoop-trunk\hadoop-common-project\hadoop-common\src\test\java\org\apache\hadoop\security\TestWhitelistBasedResolver.java,138,68,26,26,0,120
 hadoop-trunk\hadoop-trunk\hadoop-yarn-project\hadoop-yarn\hadoop-yarn-server\hadoop-yarn-server-resourcemanager\src\main\java\org\apache\hadoop\yarn\server\resourcemanager\scheduler\common\fica\FiCaSchedulerNode.java,138,50,1,3,1,55
 kafka-trunk\kafka-trunk\clients\src\generated\java\org\apache\kafka\common\message\AlterClientQuotasResponseDataJsonConverter.java,138,0,0,27,0,27
 kafka-trunk\kafka-trunk\clients\src\test\java\org\apache\kafka\common\requests\LeaderAndIsrResponseTest.java,138,0,0,33,0,33
 kafka-trunk\kafka-trunk\clients\src\test\java\org\apache\kafka\clients\consumer\internals\OffsetForLeaderEpochClientTest.java,138,0,3,23,1,27
 kafka-trunk\kafka-trunk\clients\src\generated\java\org\apache\kafka\common\message\CreatePartitionsRequestDataJsonConverter.java,138,0,0,35,0,35
 kafka-trunk\kafka-trunk\connect\runtime\src\test\java\org\apache\kafka\connect\util\ConnectUtilsTest.java,138,0,0,20,0,20
 kafka-trunk\kafka-trunk\clients\src\test\java\org\apache\kafka\clients\admin\internals\DescribeConsumerGroupsHandlerTest.java,138,0,3,29,2,34
 kafka-trunk\kafka-trunk\clients\src\generated\java\org\apache\kafka\common\message\DeleteAclsRequestDataJsonConverter.java,138,0,0,29,0,29
 pulsar-master\pulsar-master\pulsar-proxy\src\test\java\org\apache\pulsar\proxy\extensions\SimpleProxyExtensionTestBase.java,138,41,4,22,0,67
 pulsar-master\pulsar-master\pulsar-io\file\src\main\java\org\apache\pulsar\io\file\FileSourceConfig.java,138,27,1,21,0,49
 pulsar-master\pulsar-master\pulsar-broker\src\test\java\org\apache\pulsar\broker\intercept\BrokerInterceptorWithClassLoaderTest.java,138,92,0,54,0,146
 pulsar-master\pulsar-master\pulsar-broker\src\test\java\org\apache\pulsar\client\api\ServiceUrlProviderTest.java,138,31,4,16,0,51
 rocketmq-develop\rocketmq-develop\client\src\test\java\org\apache\rocketmq\client\trace\TransactionMQProducerWithTraceTest.java,138,51,8,25,7,91
 skywalking-master\skywalking-master\oap-server\server-receiver-plugin\skywalking-sharing-server-plugin\src\main\java\org\apache\skywalking\oap\server\receiver\sharing\server\SharingServerModuleProvider.java,138,37,3,26,0,66
 skywalking-master\skywalking-master\oap-server\server-storage-plugin\storage-jdbc-hikaricp-plugin\src\main\java\org\apache\skywalking\oap\server\storage\plugin\jdbc\h2\H2StorageProvider.java,138,50,1,72,0,123
 skywalking-master\skywalking-master\oap-server\server-core\src\main\java\org\apache\skywalking\oap\server\core\profiling\ebpf\analyze\EBPFProfilingAnalyzer.java,138,56,2,22,0,80
 zookeeper-master\zookeeper-master\zookeeper-server\src\test\java\org\apache\zookeeper\server\watch\WatcherCleanerTest.java,138,0,2,13,3,18
 dubbo-3.0\dubbo-3.0\dubbo-cluster\src\main\java\org\apache\dubbo\rpc\cluster\router\RouterSnapshotNode.java,139,66,0,7,0,73
 hadoop-trunk\hadoop-trunk\hadoop-hdfs-project\hadoop-hdfs\src\test\java\org\apache\hadoop\hdfs\server\namenode\TestNameNodeMetadataConsistency.java,139,17,4,1,3,25
 hadoop-trunk\hadoop-trunk\hadoop-mapreduce-project\hadoop-mapreduce-client\hadoop-mapreduce-client-core\src\main\java\org\apache\hadoop\mapreduce\lib\aggregate\ValueAggregatorJob.java,139,60,3,2,1,66
 hadoop-trunk\hadoop-trunk\hadoop-hdfs-project\hadoop-hdfs\src\test\java\org\apache\hadoop\hdfs\server\datanode\web\TestHostRestrictingAuthorizationFilterHandler.java,139,18,7,1,0,26
 hadoop-trunk\hadoop-trunk\hadoop-hdfs-project\hadoop-hdfs-client\src\main\java\org\apache\hadoop\hdfs\protocol\CacheDirectiveStats.java,139,31,2,1,0,34
 hadoop-trunk\hadoop-trunk\hadoop-yarn-project\hadoop-yarn\hadoop-yarn-server\hadoop-yarn-server-nodemanager\src\test\java\org\apache\hadoop\yarn\server\nodemanager\containermanager\TestNMProxy.java,139,29,0,1,0,30
 hadoop-trunk\hadoop-trunk\hadoop-yarn-project\hadoop-yarn\hadoop-yarn-common\src\main\java\org\apache\hadoop\yarn\api\records\impl\pb\StrictPreemptionContractPBImpl.java,139,28,44,4,0,76
 hadoop-trunk\hadoop-trunk\hadoop-yarn-project\hadoop-yarn\hadoop-yarn-server\hadoop-yarn-server-applicationhistoryservice\src\test\java\org\apache\hadoop\yarn\server\timeline\TestTimelineDataManager.java,139,16,0,2,3,21
 hadoop-trunk\hadoop-trunk\hadoop-hdfs-project\hadoop-hdfs\src\test\java\org\apache\hadoop\hdfs\server\datanode\fsdataset\impl\TestLazyPersistReplicaPlacement.java,139,17,8,2,0,27
 hadoop-trunk\hadoop-trunk\hadoop-tools\hadoop-azure\src\test\java\org\apache\hadoop\fs\azurebfs\ITestAbfsStreamStatistics.java,139,12,1,4,10,27
 hadoop-trunk\hadoop-trunk\hadoop-yarn-project\hadoop-yarn\hadoop-yarn-server\hadoop-yarn-server-applicationhistoryservice\src\main\java\org\apache\hadoop\yarn\server\applicationhistoryservice\records\ApplicationAttemptHistoryData.java,139,66,0,1,4,71
 hadoop-trunk\hadoop-trunk\hadoop-tools\hadoop-distcp\src\test\java\org\apache\hadoop\tools\mapred\TestUniformSizeInputFormat.java,139,51,4,6,0,61
 hadoop-trunk\hadoop-trunk\hadoop-tools\hadoop-azure\src\test\java\org\apache\hadoop\fs\azurebfs\TestAbfsConfigurationFieldsValidation.java,139,61,10,49,0,120
 hadoop-trunk\hadoop-trunk\hadoop-hdfs-project\hadoop-hdfs\src\test\java\org\apache\hadoop\hdfs\TestTrashWithEncryptionZones.java,139,29,6,1,3,39
 hadoop-trunk\hadoop-trunk\hadoop-yarn-project\hadoop-yarn\hadoop-yarn-api\src\main\java\org\apache\hadoop\yarn\api\records\timeline\TimelineEvent.java,139,46,10,1,5,62
 hadoop-trunk\hadoop-trunk\hadoop-hdfs-project\hadoop-hdfs\src\main\java\org\apache\hadoop\hdfs\security\token\block\BlockPoolTokenSecretManager.java,139,96,0,3,0,99
 hadoop-trunk\hadoop-trunk\hadoop-common-project\hadoop-registry\src\test\java\org\apache\hadoop\registry\secure\TestSecureRegistry.java,139,12,5,3,2,22
 hadoop-trunk\hadoop-trunk\hadoop-common-project\hadoop-common\src\test\java\org\apache\hadoop\test\TimedOutTestsListener.java,139,34,1,2,3,40
 hadoop-trunk\hadoop-trunk\hadoop-yarn-project\hadoop-yarn\hadoop-yarn-server\hadoop-yarn-server-resourcemanager\src\test\java\org\apache\hadoop\yarn\server\resourcemanager\scheduler\capacity\TestCapacitySchedulerWorkflowPriorityMapping.java,139,23,1,17,0,41
 hadoop-trunk\hadoop-trunk\hadoop-yarn-project\hadoop-yarn\hadoop-yarn-client\src\main\java\org\apache\hadoop\yarn\client\api\AHSClient.java,139,15,0,1,0,16
 hadoop-trunk\hadoop-trunk\hadoop-yarn-project\hadoop-yarn\hadoop-yarn-server\hadoop-yarn-server-sharedcachemanager\src\main\java\org\apache\hadoop\yarn\server\sharedcachemanager\ClientProtocolService.java,139,24,1,6,1,32
 hadoop-trunk\hadoop-trunk\hadoop-common-project\hadoop-common\src\main\java\org\apache\hadoop\metrics2\lib\MutableMetricsFactory.java,139,46,0,2,0,48
 hadoop-trunk\hadoop-trunk\hadoop-yarn-project\hadoop-yarn\hadoop-yarn-common\src\main\java\org\apache\hadoop\yarn\api\records\impl\pb\ResourceAllocationRequestPBImpl.java,139,26,45,2,0,73
 hadoop-trunk\hadoop-trunk\hadoop-yarn-project\hadoop-yarn\hadoop-yarn-server\hadoop-yarn-server-nodemanager\src\main\java\org\apache\hadoop\yarn\server\nodemanager\containermanager\records\AuxServiceRecord.java,139,55,2,1,3,61
 hadoop-trunk\hadoop-trunk\hadoop-tools\hadoop-fs2img\src\test\java\org\apache\hadoop\hdfs\server\namenode\TestSingleUGIResolver.java,139,47,8,1,0,56
 hadoop-trunk\hadoop-trunk\hadoop-common-project\hadoop-kms\src\test\java\org\apache\hadoop\crypto\key\kms\server\MiniKMS.java,139,50,2,2,6,60
 hadoop-trunk\hadoop-trunk\hadoop-yarn-project\hadoop-yarn\hadoop-yarn-applications\hadoop-yarn-services\hadoop-yarn-services-core\src\test\java\org\apache\hadoop\yarn\service\provider\TestProviderUtils.java,139,10,8,1,0,19
 hadoop-trunk\hadoop-trunk\hadoop-hdfs-project\hadoop-hdfs\src\test\java\org\apache\hadoop\hdfs\server\namenode\ha\TestInitializeSharedEdits.java,139,33,0,2,0,35
 hadoop-trunk\hadoop-trunk\hadoop-common-project\hadoop-common\src\test\java\org\apache\hadoop\util\TestLineReader.java,139,0,2,1,0,3
 hadoop-trunk\hadoop-trunk\hadoop-yarn-project\hadoop-yarn\hadoop-yarn-common\src\main\java\org\apache\hadoop\yarn\api\protocolrecords\impl\pb\GetClusterNodesResponsePBImpl.java,139,35,45,3,0,83
 hadoop-trunk\hadoop-trunk\hadoop-hdfs-project\hadoop-hdfs\src\main\java\org\apache\hadoop\hdfs\server\namenode\top\window\RollingWindow.java,139,22,3,4,0,29
 hadoop-trunk\hadoop-trunk\hadoop-yarn-project\hadoop-yarn\hadoop-yarn-server\hadoop-yarn-server-common\src\test\java\org\apache\hadoop\yarn\server\federation\policies\BaseFederationPoliciesTest.java,139,59,0,7,11,77
 kafka-trunk\kafka-trunk\streams\src\test\java\org\apache\kafka\streams\integration\ResetPartitionTimeIntegrationTest.java,139,0,0,28,1,29
 kafka-trunk\kafka-trunk\metadata\src\test\java\org\apache\kafka\metalog\LocalLogManagerTestEnv.java,139,0,2,9,1,12
 kafka-trunk\kafka-trunk\connect\runtime\src\main\java\org\apache\kafka\connect\runtime\SinkConnectorConfig.java,139,0,0,31,1,32
 kafka-trunk\kafka-trunk\core\src\test\java\kafka\test\junit\ClusterTestExtensions.java,139,0,2,38,0,40
 pulsar-master\pulsar-master\pulsar-broker\src\main\java\org\apache\pulsar\broker\stats\prometheus\metrics\PrometheusTextFormatUtil.java,139,79,1,36,0,116
 pulsar-master\pulsar-master\pulsar-broker\src\test\java\org\apache\pulsar\client\api\MemoryLimitTest.java,139,35,5,8,0,48
 pulsar-master\pulsar-master\pulsar-io\rabbitmq\src\test\java\org\apache\pulsar\io\rabbitmq\source\RabbitMQSourceConfigTest.java,139,8,0,1,0,9
 pulsar-master\pulsar-master\pulsar-io\canal\src\main\java\org\apache\pulsar\io\canal\CanalAbstractSource.java,139,39,4,14,0,57
 pulsar-master\pulsar-master\pulsar-functions\worker\src\main\java\org\apache\pulsar\functions\worker\FunctionAssignmentTailer.java,139,44,4,14,0,62
 pulsar-master\pulsar-master\pulsar-broker\src\test\java\org\apache\pulsar\broker\service\ConsistentHashingStickyKeyConsumerSelectorTest.java,139,111,2,14,0,127
 rocketmq-develop\rocketmq-develop\test\src\test\java\org\apache\rocketmq\test\base\BaseConf.java,139,109,4,19,12,144
 rocketmq-develop\rocketmq-develop\broker\src\test\java\org\apache\rocketmq\broker\BrokerOuterAPITest.java,139,54,16,27,10,107
 rocketmq-develop\rocketmq-develop\common\src\main\java\org\apache\rocketmq\common\topic\TopicValidator.java,139,49,1,15,3,68
 rocketmq-develop\rocketmq-develop\broker\src\main\java\org\apache\rocketmq\broker\mqtrace\ConsumeMessageContext.java,139,103,0,2,2,107
 rocketmq-develop\rocketmq-develop\broker\src\main\java\org\apache\rocketmq\broker\longpolling\PullRequestHoldService.java,139,48,7,21,1,77
 rocketmq-develop\rocketmq-develop\common\src\main\java\org\apache\rocketmq\common\ServiceThread.java,139,46,11,7,0,64
 skywalking-master\skywalking-master\oap-server\server-core\src\main\java\org\apache\skywalking\oap\server\core\analysis\manual\relation\instance\ServiceInstanceRelationServerSideMetrics.java,139,47,1,21,0,69
 skywalking-master\skywalking-master\oap-server\server-core\src\main\java\org\apache\skywalking\oap\server\core\analysis\manual\relation\instance\ServiceInstanceRelationClientSideMetrics.java,139,47,1,21,0,69
 skywalking-master\skywalking-master\oap-server\oal-rt\src\test\java\org\apache\skywalking\oal\rt\parser\DeepAnalysisTest.java,139,28,19,23,0,70
 zookeeper-master\zookeeper-master\zookeeper-server\src\test\java\org\apache\zookeeper\common\PathTrieTest.java,139,0,0,3,3,6
 dubbo-3.0\dubbo-3.0\dubbo-common\src\test\java\org\apache\dubbo\common\utils\MethodUtilsTest.java,140,37,0,9,0,46
 dubbo-3.0\dubbo-3.0\dubbo-common\src\test\java\org\apache\dubbo\common\config\configcenter\file\FileSystemDynamicConfigurationTest.java,140,30,4,14,2,50
 dubbo-3.0\dubbo-3.0\dubbo-metadata\dubbo-metadata-processor\src\main\java\org\apache\dubbo\metadata\annotation\processing\rest\DefaultServiceRestMetadataResolver.java,140,66,1,30,0,97
 hadoop-trunk\hadoop-trunk\hadoop-yarn-project\hadoop-yarn\hadoop-yarn-server\hadoop-yarn-server-nodemanager\src\main\java\org\apache\hadoop\yarn\server\nodemanager\webapp\ContainerLogsUtils.java,140,53,4,14,0,71
 hadoop-trunk\hadoop-trunk\hadoop-yarn-project\hadoop-yarn\hadoop-yarn-server\hadoop-yarn-server-resourcemanager\src\test\java\org\apache\hadoop\yarn\server\resourcemanager\scheduler\fair\FakeSchedulable.java,140,100,1,1,11,113
 hadoop-trunk\hadoop-trunk\hadoop-mapreduce-project\hadoop-mapreduce-client\hadoop-mapreduce-client-jobclient\src\test\java\org\apache\hadoop\mapreduce\lib\input\TestCombineSequenceFileInputFormat.java,140,52,3,2,2,59
 hadoop-trunk\hadoop-trunk\hadoop-tools\hadoop-distcp\src\main\java\org\apache\hadoop\tools\util\ThrottledInputStream.java,140,32,0,3,0,35
 hadoop-trunk\hadoop-trunk\hadoop-hdfs-project\hadoop-hdfs\src\test\java\org\apache\hadoop\hdfs\server\namenode\TestNameNodeMetricsLogger.java,140,30,5,1,1,37
 hadoop-trunk\hadoop-trunk\hadoop-yarn-project\hadoop-yarn\hadoop-yarn-common\src\main\java\org\apache\hadoop\yarn\api\protocolrecords\impl\pb\GetQueueUserAclsInfoResponsePBImpl.java,140,34,45,6,0,85
 hadoop-trunk\hadoop-trunk\hadoop-common-project\hadoop-common\src\main\java\org\apache\hadoop\fs\GlobPattern.java,140,14,1,1,2,18
 hadoop-trunk\hadoop-trunk\hadoop-yarn-project\hadoop-yarn\hadoop-yarn-server\hadoop-yarn-server-resourcemanager\src\main\java\org\apache\hadoop\yarn\server\resourcemanager\webapp\dao\ResourceRequestInfo.java,140,75,1,1,6,83
 hadoop-trunk\hadoop-trunk\hadoop-yarn-project\hadoop-yarn\hadoop-yarn-server\hadoop-yarn-server-resourcemanager\src\test\java\org\apache\hadoop\yarn\server\resourcemanager\reservation\TestFairSchedulerPlanFollower.java,140,37,5,9,1,52
 hadoop-trunk\hadoop-trunk\hadoop-tools\hadoop-aws\src\main\java\org\apache\hadoop\fs\s3a\impl\MkdirOperation.java,140,6,1,1,0,8
 hadoop-trunk\hadoop-trunk\hadoop-common-project\hadoop-common\src\main\java\org\apache\hadoop\util\HttpExceptionUtils.java,140,17,7,1,1,26
 hadoop-trunk\hadoop-trunk\hadoop-hdfs-project\hadoop-hdfs\src\main\java\org\apache\hadoop\hdfs\server\blockmanagement\StorageTypeStats.java,140,54,0,1,0,55
 hadoop-trunk\hadoop-trunk\hadoop-mapreduce-project\hadoop-mapreduce-client\hadoop-mapreduce-client-jobclient\src\test\java\org\apache\hadoop\mapreduce\TestNewCombinerGrouping.java,140,25,2,1,4,32
 hadoop-trunk\hadoop-trunk\hadoop-common-project\hadoop-common\src\main\java\org\apache\hadoop\fs\StorageStatistics.java,140,46,29,1,0,76
 hadoop-trunk\hadoop-trunk\hadoop-yarn-project\hadoop-yarn\hadoop-yarn-server\hadoop-yarn-server-common\src\main\java\org\apache\hadoop\yarn\server\api\protocolrecords\RemoteNode.java,140,17,0,1,0,18
 hadoop-trunk\hadoop-trunk\hadoop-yarn-project\hadoop-yarn\hadoop-yarn-server\hadoop-yarn-server-resourcemanager\src\main\java\org\apache\hadoop\yarn\server\resourcemanager\placement\FSPlacementRule.java,140,15,2,4,2,23
 kafka-trunk\kafka-trunk\core\src\main\java\kafka\server\builders\LogManagerBuilder.java,140,0,7,20,4,31
 kafka-trunk\kafka-trunk\storage\src\test\java\org\apache\kafka\server\log\remote\metadata\storage\TopicBasedRemoteLogMetadataManagerRestartTest.java,140,0,0,51,0,51
 kafka-trunk\kafka-trunk\clients\src\test\java\org\apache\kafka\common\utils\ConfigUtilsTest.java,140,0,0,9,0,9
 kafka-trunk\kafka-trunk\clients\src\test\java\org\apache\kafka\clients\admin\internals\RemoveMembersFromConsumerGroupHandlerTest.java,140,0,3,23,1,27
 kafka-trunk\kafka-trunk\connect\runtime\src\main\java\org\apache\kafka\connect\runtime\WorkerSinkTaskContext.java,140,0,0,12,3,15
 kafka-trunk\kafka-trunk\clients\src\generated\java\org\apache\kafka\common\message\IncrementalAlterConfigsRequestDataJsonConverter.java,140,0,0,33,0,33
 kafka-trunk\kafka-trunk\connect\runtime\src\main\java\org\apache\kafka\connect\runtime\rest\util\SSLUtils.java,140,0,12,33,0,45
 kafka-trunk\kafka-trunk\clients\src\main\java\org\apache\kafka\common\resource\ResourcePatternFilter.java,140,0,7,21,0,28
 kafka-trunk\kafka-trunk\jmh-benchmarks\src\main\java\org\apache\kafka\jmh\metadata\MetadataRequestBenchmark.java,140,0,1,27,0,28
 kafka-trunk\kafka-trunk\server-common\src\main\java\org\apache\kafka\server\metrics\KafkaYammerMetrics.java,140,0,3,15,0,18
 LittleBooks-master\LittleBooks-master\app\src\main\java\com\example\littlebooks\NewBook.java,140,108,15,13,0,136
 LittleBooks-master\LittleBooks-master\app\src\main\java\com\example\littlebooks\MainActivityT.java,140,59,6,10,0,75
 pulsar-master\pulsar-master\pulsar-proxy\src\test\java\org\apache\pulsar\proxy\server\ProxyKeyStoreTlsTestWithoutAuth.java,140,65,10,25,0,100
 pulsar-master\pulsar-master\pulsar-broker\src\main\java\org\apache\pulsar\broker\namespace\OwnedBundle.java,140,44,3,23,0,70
 pulsar-master\pulsar-master\pulsar-functions\utils\src\main\java\org\apache\pulsar\functions\utils\io\ConnectorUtils.java,140,40,5,25,0,70
 pulsar-master\pulsar-master\pulsar-broker\src\test\java\org\apache\pulsar\broker\delayed\InMemoryDeliveryTrackerTest.java,140,52,0,8,0,60
 pulsar-master\pulsar-master\pulsar-broker\src\test\java\org\apache\pulsar\broker\admin\ResourceGroupsTest.java,140,34,11,11,0,56
 pulsar-master\pulsar-master\pulsar-io\netty\src\test\java\org\apache\pulsar\io\netty\server\NettyServerTest.java,140,26,2,2,0,30
 rocketmq-develop\rocketmq-develop\acl\src\main\java\org\apache\rocketmq\acl\common\SessionCredentials.java,140,72,11,7,0,90
 rocketmq-develop\rocketmq-develop\remoting\src\main\java\org\apache\rocketmq\remoting\netty\NettyClientConfig.java,140,111,0,14,0,125
 shardingsphere-master\shardingsphere-master\shardingsphere-kernel\shardingsphere-data-pipeline\shardingsphere-data-pipeline-core\src\main\java\org\apache\shardingsphere\data\pipeline\core\sqlbuilder\AbstractPipelineSQLBuilder.java,140,67,0,27,0,94
 skywalking-master\skywalking-master\oap-server\server-configuration\grpc-configuration-sync\src\test\java\org\apache\skywalking\oap\server\configuration\grpc\GRPCConfigurationTest.java,140,38,5,15,0,58
 skywalking-master\skywalking-master\oap-server\server-receiver-plugin\envoy-metrics-receiver-plugin\src\main\java\org\apache\skywalking\oap\server\receiver\envoy\als\tcp\k8s\K8sALSServiceMeshTCPAnalysis.java,140,46,1,35,0,82
 zookeeper-master\zookeeper-master\zookeeper-server\src\test\java\org\apache\zookeeper\server\quorum\QuorumRequestPipelineTest.java,140,0,29,17,8,54
 dubbo-3.0\dubbo-3.0\dubbo-common\src\main\java\org\apache\dubbo\common\deploy\AbstractDeployer.java,141,44,13,8,2,67
 dubbo-3.0\dubbo-3.0\dubbo-common\src\main\java\org\apache\dubbo\common\config\configcenter\TreePathDynamicConfiguration.java,141,66,0,25,0,91
 dubbo-3.0\dubbo-3.0\dubbo-config\dubbo-config-api\src\test\java\org\apache\dubbo\config\url\RpcConfigGetSetProxy.java,141,38,4,4,0,46
 hadoop-trunk\hadoop-trunk\hadoop-tools\hadoop-aws\src\test\java\org\apache\hadoop\fs\s3a\performance\ITestS3AMkdirCost.java,141,4,3,4,0,11
 hadoop-trunk\hadoop-trunk\hadoop-hdfs-project\hadoop-hdfs-httpfs\src\test\java\org\apache\hadoop\test\TestJettyHelper.java,141,30,3,7,1,41
 hadoop-trunk\hadoop-trunk\hadoop-tools\hadoop-aws\src\main\java\org\apache\hadoop\fs\s3a\commit\MagicCommitIntegration.java,141,20,2,1,1,24
 hadoop-trunk\hadoop-trunk\hadoop-tools\hadoop-azure\src\test\java\org\apache\hadoop\fs\azurebfs\ITestAzureBlobFileSystemOauth.java,141,27,6,25,2,60
 hadoop-trunk\hadoop-trunk\hadoop-tools\hadoop-gridmix\src\test\java\org\apache\hadoop\mapred\gridmix\TestUserResolve.java,141,18,2,1,0,21
 hadoop-trunk\hadoop-trunk\hadoop-tools\hadoop-azure\src\test\java\org\apache\hadoop\fs\azure\TestKeyPageBlobDirectories.java,141,17,0,6,0,23
 hadoop-trunk\hadoop-trunk\hadoop-yarn-project\hadoop-yarn\hadoop-yarn-server\hadoop-yarn-server-nodemanager\src\main\java\org\apache\hadoop\yarn\server\nodemanager\webapp\dao\ContainerInfo.java,141,63,2,2,2,69
 hadoop-trunk\hadoop-trunk\hadoop-common-project\hadoop-common\src\test\java\org\apache\hadoop\fs\viewfs\TestViewfsFileStatus.java,141,9,5,1,6,21
 hadoop-trunk\hadoop-trunk\hadoop-hdfs-project\hadoop-hdfs\src\main\java\org\apache\hadoop\hdfs\server\datanode\FinalizedReplica.java,141,51,3,1,2,57
 hadoop-trunk\hadoop-trunk\hadoop-hdfs-project\hadoop-hdfs\src\test\java\org\apache\hadoop\fs\viewfs\TestViewFsWithAcls.java,141,28,8,6,3,45
 hadoop-trunk\hadoop-trunk\hadoop-common-project\hadoop-common\src\main\java\org\apache\hadoop\util\bloom\Filter.java,141,67,2,5,0,74
 hadoop-trunk\hadoop-trunk\hadoop-mapreduce-project\hadoop-mapreduce-client\hadoop-mapreduce-client-hs\src\test\java\org\apache\hadoop\mapreduce\v2\hs\webapp\dao\TestJobInfo.java,141,51,3,5,3,62
 hadoop-trunk\hadoop-trunk\hadoop-common-project\hadoop-nfs\src\main\java\org\apache\hadoop\nfs\nfs3\Nfs3Status.java,141,65,0,1,1,67
 hadoop-trunk\hadoop-trunk\hadoop-yarn-project\hadoop-yarn\hadoop-yarn-common\src\test\java\org\apache\hadoop\yarn\ipc\TestRPCUtil.java,141,18,4,1,0,23
 hadoop-trunk\hadoop-trunk\hadoop-yarn-project\hadoop-yarn\hadoop-yarn-server\hadoop-yarn-server-common\src\main\java\org\apache\hadoop\yarn\server\api\records\OpportunisticContainersStatus.java,141,1,0,1,0,2
 hadoop-trunk\hadoop-trunk\hadoop-hdfs-project\hadoop-hdfs\src\test\java\org\apache\hadoop\hdfs\TestIsMethodSupported.java,141,33,4,7,0,44
 hadoop-trunk\hadoop-trunk\hadoop-hdfs-project\hadoop-hdfs-client\src\main\java\org\apache\hadoop\hdfs\XAttrHelper.java,141,38,3,1,0,42
 hadoop-trunk\hadoop-trunk\hadoop-hdfs-project\hadoop-hdfs\src\main\java\org\apache\hadoop\hdfs\server\namenode\FSImageCompression.java,141,30,1,3,0,34
 hadoop-trunk\hadoop-trunk\hadoop-tools\hadoop-rumen\src\main\java\org\apache\hadoop\tools\rumen\TaskAttempt20LineEventEmitter.java,141,30,7,4,1,42
 kafka-trunk\kafka-trunk\clients\src\generated\java\org\apache\kafka\common\message\VoteRequestDataJsonConverter.java,141,0,0,29,0,29
 kafka-trunk\kafka-trunk\clients\src\generated\java\org\apache\kafka\common\message\WriteTxnMarkersResponseDataJsonConverter.java,141,0,0,40,0,40
 kafka-trunk\kafka-trunk\streams\src\test\java\org\apache\kafka\streams\state\internals\TimestampedKeyValueStoreBuilderTest.java,141,0,0,20,2,22
 kafka-trunk\kafka-trunk\connect\transforms\src\main\java\org\apache\kafka\connect\transforms\SetSchemaMetadata.java,141,0,3,22,0,25
 pulsar-master\pulsar-master\pulsar-proxy\src\test\java\org\apache\pulsar\proxy\server\AuthedAdminProxyHandlerTest.java,141,39,6,26,0,71
 pulsar-master\pulsar-master\pulsar-proxy\src\test\java\org\apache\pulsar\proxy\server\SuperUserAuthedAdminProxyHandlerTest.java,141,37,5,25,0,67
 pulsar-master\pulsar-master\pulsar-broker\src\main\java\org\apache\pulsar\broker\admin\v2\Bookies.java,141,54,6,34,0,94
 pulsar-master\pulsar-master\pulsar-common\src\main\java\org\apache\pulsar\common\api\raw\MessageParser.java,141,60,4,29,0,93
 pulsar-master\pulsar-master\pulsar-metadata\src\test\java\org\apache\pulsar\metadata\ZKSessionTest.java,141,45,0,15,0,60
 skywalking-master\skywalking-master\oap-server\microbench\src\main\java\org\apache\skywalking\oap\server\microbench\library\datacarrier\common\AtomicRangeIntegerBenchmark.java,141,46,0,31,0,77
 skywalking-master\skywalking-master\oap-server\server-core\src\test\java\org\apache\skywalking\oap\server\core\remote\RemoteServiceHandlerTestCase.java,141,31,7,14,0,52
 zookeeper-master\zookeeper-master\zookeeper-jute\src\main\java\org\apache\jute\BinaryInputArchive.java,141,0,6,4,1,11
 zookeeper-master\zookeeper-master\zookeeper-server\src\test\java\org\apache\zookeeper\ClientRequestTimeoutTest.java,141,0,7,10,2,19
 zookeeper-master\zookeeper-master\zookeeper-server\src\main\java\org\apache\zookeeper\server\ServerConfig.java,141,0,0,3,1,4
 zookeeper-master\zookeeper-master\zookeeper-jute\src\main\java\org\apache\jute\compiler\JVector.java,141,0,0,19,0,19
 dubbo-3.0\dubbo-3.0\dubbo-compatible\src\test\java\org\apache\dubbo\config\RegistryConfigTest.java,142,25,0,2,0,27
 dubbo-3.0\dubbo-3.0\dubbo-configcenter\dubbo-configcenter-nacos\src\test\java\org\apache\dubbo\configcenter\support\nacos\NacosDynamicConfigurationTest.java,142,40,12,9,0,61
 dubbo-3.0\dubbo-3.0\dubbo-cluster\src\main\java\org\apache\dubbo\rpc\cluster\support\FailbackClusterInvoker.java,142,65,10,24,0,99
 dubbo-3.0\dubbo-3.0\dubbo-common\src\main\java\org\apache\dubbo\rpc\model\ModuleModel.java,142,46,1,10,9,66
 dubbo-3.0\dubbo-3.0\dubbo-common\src\main\java\org\apache\dubbo\rpc\model\ReflectionMethodDescriptor.java,142,55,2,16,5,78
 hadoop-trunk\hadoop-trunk\hadoop-hdfs-project\hadoop-hdfs\src\test\java\org\apache\hadoop\hdfs\server\blockmanagement\TestBlockTokenWithShortCircuitRead.java,142,17,7,5,1,30
 hadoop-trunk\hadoop-trunk\hadoop-common-project\hadoop-common\src\main\java\org\apache\hadoop\io\erasurecode\rawcoder\RSRawDecoder.java,142,19,4,1,6,30
 hadoop-trunk\hadoop-trunk\hadoop-yarn-project\hadoop-yarn\hadoop-yarn-common\src\test\java\org\apache\hadoop\yarn\webapp\test\WebAppTests.java,142,50,2,2,4,58
 hadoop-trunk\hadoop-trunk\hadoop-yarn-project\hadoop-yarn\hadoop-yarn-server\hadoop-yarn-server-common\src\main\java\org\apache\hadoop\yarn\server\api\protocolrecords\NMContainerStatus.java,142,52,3,1,0,56
 hadoop-trunk\hadoop-trunk\hadoop-hdfs-project\hadoop-hdfs\src\test\java\org\apache\hadoop\hdfs\server\datanode\TestFsDatasetCacheRevocation.java,142,22,0,1,2,25
 hadoop-trunk\hadoop-trunk\hadoop-tools\hadoop-azure\src\test\java\org\apache\hadoop\fs\azure\ITestListPerformance.java,142,20,6,3,0,29
 hadoop-trunk\hadoop-trunk\hadoop-common-project\hadoop-nfs\src\main\java\org\apache\hadoop\oncrpc\RpcCallCache.java,142,59,2,2,2,65
 hadoop-trunk\hadoop-trunk\hadoop-hdfs-project\hadoop-hdfs\src\test\java\org\apache\hadoop\hdfs\server\namenode\TestAclConfigFlag.java,142,21,5,1,0,27
 hadoop-trunk\hadoop-trunk\hadoop-yarn-project\hadoop-yarn\hadoop-yarn-common\src\main\java\org\apache\hadoop\yarn\api\records\impl\pb\ResourceBlacklistRequestPBImpl.java,142,37,33,2,0,72
 hadoop-trunk\hadoop-trunk\hadoop-hdfs-project\hadoop-hdfs\src\test\java\org\apache\hadoop\hdfs\server\namenode\TestCheckPointForSecurityTokens.java,142,34,4,10,2,50
 hadoop-trunk\hadoop-trunk\hadoop-yarn-project\hadoop-yarn\hadoop-yarn-server\hadoop-yarn-server-timelineservice-documentstore\src\test\java\org\apache\hadoop\yarn\server\timelineservice\documentstore\collection\TestDocumentOperations.java,142,8,0,7,0,15
 kafka-trunk\kafka-trunk\streams\src\main\java\org\apache\kafka\streams\state\internals\RocksDbIndexedTimeOrderedWindowBytesStoreSupplier.java,142,0,0,20,0,20
 kafka-trunk\kafka-trunk\connect\transforms\src\test\java\org\apache\kafka\connect\transforms\ReplaceFieldTest.java,142,0,0,9,0,9
 kafka-trunk\kafka-trunk\clients\src\main\java\org\apache\kafka\clients\admin\NewTopic.java,142,0,2,21,3,26
 kafka-trunk\kafka-trunk\clients\src\test\java\org\apache\kafka\clients\consumer\internals\ConsumerInterceptorsTest.java,142,0,9,33,4,46
 kafka-trunk\kafka-trunk\clients\src\test\java\org\apache\kafka\common\feature\FeaturesTest.java,142,0,4,43,2,49
 pulsar-master\pulsar-master\pulsar-proxy\src\main\java\org\apache\pulsar\proxy\server\BrokerProxyValidator.java,142,48,0,22,0,70
 pulsar-master\pulsar-master\pulsar-broker\src\test\java\org\apache\pulsar\client\impl\ClientWithSocks5ProxyTest.java,142,22,1,4,0,27
 pulsar-master\pulsar-master\tiered-storage\file-system\src\main\java\org\apache\bookkeeper\mledger\offload\filesystem\impl\FileStoreBackedReadHandleImpl.java,142,39,3,17,0,59
 pulsar-master\pulsar-master\pulsar-common\src\test\java\org\apache\pulsar\common\util\keystoretls\JettySslContextFactoryWithAutoRefreshTest.java,142,39,3,28,0,70
 pulsar-master\pulsar-master\pulsar-package-management\filesystem-storage\src\test\java\org\apache\pulsar\packages\management\storage\filesystem\FileSystemPackagesStorageTest.java,142,35,0,13,0,48
 pulsar-master\pulsar-master\pulsar-common\src\main\java\org\apache\pulsar\common\policies\impl\NamespaceIsolationPolicies.java,142,37,0,14,0,51
 pulsar-master\pulsar-master\pulsar-common\src\main\java\org\apache\pulsar\common\util\collections\ConcurrentBitSet.java,142,20,0,2,0,22
 skywalking-master\skywalking-master\oap-server\server-alarm-plugin\src\main\java\org\apache\skywalking\oap\server\core\alarm\provider\NotifyHandler.java,142,47,0,42,0,89
 skywalking-master\skywalking-master\oap-server\server-storage-plugin\storage-jdbc-hikaricp-plugin\src\main\java\org\apache\skywalking\oap\server\storage\plugin\jdbc\h2\dao\H2SQLExecutor.java,142,65,0,33,0,98
 skywalking-master\skywalking-master\oap-server\server-configuration\configuration-etcd\src\test\java\org\apache\skywalking\oap\server\configuration\etcd\ITEtcdConfigurationTest.java,142,48,7,32,0,87
 skywalking-master\skywalking-master\oap-server\analyzer\agent-analyzer\src\main\java\org\apache\skywalking\oap\server\analyzer\provider\trace\TraceSamplingPolicyWatcher.java,142,59,6,34,0,99
 zookeeper-master\zookeeper-master\zookeeper-server\src\main\java\org\apache\zookeeper\server\quorum\Vote.java,142,0,3,9,0,12
 zookeeper-master\zookeeper-master\zookeeper-server\src\main\java\org\apache\zookeeper\server\quorum\LearnerZooKeeperServer.java,142,0,1,9,2,12
 zookeeper-master\zookeeper-master\zookeeper-server\src\test\java\org\apache\zookeeper\server\ZooKeeperServerMaxCnxnsTest.java,142,0,3,19,0,22
 dubbo-3.0\dubbo-3.0\dubbo-plugin\dubbo-qos\src\main\java\org\apache\dubbo\qos\command\impl\CountTelnet.java,143,21,1,7,0,29
 dubbo-3.0\dubbo-3.0\dubbo-remoting\dubbo-remoting-api\src\main\java\org\apache\dubbo\remoting\transport\CodecSupport.java,143,64,4,24,1,93
 hadoop-trunk\hadoop-trunk\hadoop-hdfs-project\hadoop-hdfs\src\test\java\org\apache\hadoop\hdfs\server\namenode\ha\TestSeveralNameNodes.java,143,26,4,2,1,33
 hadoop-trunk\hadoop-trunk\hadoop-common-project\hadoop-common\src\test\java\org\apache\hadoop\util\TestChunkedArrayList.java,143,33,29,1,0,63
 hadoop-trunk\hadoop-trunk\hadoop-common-project\hadoop-common\src\main\java\org\apache\hadoop\ha\protocolPB\HAServiceProtocolServerSideTranslatorPB.java,143,49,49,15,0,113
 hadoop-trunk\hadoop-trunk\hadoop-tools\hadoop-rumen\src\main\java\org\apache\hadoop\tools\rumen\ParsedJob.java,143,28,2,1,4,35
 hadoop-trunk\hadoop-trunk\hadoop-hdfs-project\hadoop-hdfs\src\test\java\org\apache\hadoop\fs\viewfs\TestViewFileSystemWithAcls.java,143,27,5,8,5,45
 hadoop-trunk\hadoop-trunk\hadoop-yarn-project\hadoop-yarn\hadoop-yarn-common\src\main\java\org\apache\hadoop\yarn\server\api\protocolrecords\impl\pb\ReplaceLabelsOnNodeRequestPBImpl.java,143,29,46,6,0,81
 hadoop-trunk\hadoop-trunk\hadoop-common-project\hadoop-common\src\main\java\org\apache\hadoop\crypto\key\UserProvider.java,143,28,0,2,0,30
 hadoop-trunk\hadoop-trunk\hadoop-yarn-project\hadoop-yarn\hadoop-yarn-server\hadoop-yarn-server-applicationhistoryservice\src\main\java\org\apache\hadoop\yarn\server\timeline\security\TimelineACLsManager.java,143,40,3,1,0,44
 hadoop-trunk\hadoop-trunk\hadoop-common-project\hadoop-auth\src\test\java\org\apache\hadoop\security\authentication\util\TestSigner.java,143,16,10,4,2,32
 hadoop-trunk\hadoop-trunk\hadoop-yarn-project\hadoop-yarn\hadoop-yarn-server\hadoop-yarn-server-nodemanager\src\main\java\org\apache\hadoop\yarn\server\nodemanager\webapp\WebServer.java,143,27,1,1,3,32
 hadoop-trunk\hadoop-trunk\hadoop-yarn-project\hadoop-yarn\hadoop-yarn-common\src\main\java\org\apache\hadoop\yarn\api\protocolrecords\impl\pb\ReInitializeContainerRequestPBImpl.java,143,35,46,8,0,89
 hadoop-trunk\hadoop-trunk\hadoop-mapreduce-project\hadoop-mapreduce-client\hadoop-mapreduce-client-core\src\main\java\org\apache\hadoop\mapreduce\counters\CounterGroupFactory.java,143,34,8,1,0,43
 hadoop-trunk\hadoop-trunk\hadoop-yarn-project\hadoop-yarn\hadoop-yarn-server\hadoop-yarn-server-resourcemanager\src\test\java\org\apache\hadoop\yarn\server\resourcemanager\reservation\TestPeriodicRLESparseResourceAllocation.java,143,135,2,2,0,139
 hadoop-trunk\hadoop-trunk\hadoop-yarn-project\hadoop-yarn\hadoop-yarn-common\src\main\java\org\apache\hadoop\yarn\api\protocolrecords\impl\pb\GetAllResourceTypeInfoResponsePBImpl.java,143,22,42,6,0,70
 hadoop-trunk\hadoop-trunk\hadoop-hdfs-project\hadoop-hdfs-rbf\src\main\java\org\apache\hadoop\hdfs\server\federation\router\RouterNamenodeProtocol.java,143,28,0,1,1,30
 hadoop-trunk\hadoop-trunk\hadoop-hdfs-project\hadoop-hdfs\src\test\java\org\apache\hadoop\hdfs\TestWriteStripedFileWithFailure.java,143,36,4,3,0,43
 hadoop-trunk\hadoop-trunk\hadoop-hdfs-project\hadoop-hdfs\src\main\java\org\apache\hadoop\hdfs\server\namenode\NetworkTopologyServlet.java,143,29,4,1,0,34
 hadoop-trunk\hadoop-trunk\hadoop-hdfs-project\hadoop-hdfs-rbf\src\test\java\org\apache\hadoop\hdfs\server\federation\router\TestRouterRefreshSuperUserGroupsConfiguration.java,143,17,7,2,2,28
 kafka-trunk\kafka-trunk\clients\src\test\java\org\apache\kafka\common\memory\GarbageCollectedMemoryPoolTest.java,143,0,2,11,0,13
 pulsar-master\pulsar-master\pulsar-broker-common\src\main\java\org\apache\pulsar\broker\resources\TenantResources.java,143,76,2,33,0,111
 pulsar-master\pulsar-master\pulsar-broker\src\main\java\org\apache\pulsar\broker\service\PulsarChannelInitializer.java,143,44,2,23,0,69
 pulsar-master\pulsar-master\pulsar-io\influxdb\src\test\java\org\apache\pulsar\io\influxdb\v2\InfluxDBSinkTest.java,143,46,0,15,0,61
 pulsar-master\pulsar-master\managed-ledger\src\test\java\org\apache\bookkeeper\mledger\impl\ManagedLedgerFactoryShutdownTest.java,143,47,1,29,0,77
 rocketmq-develop\rocketmq-develop\common\src\test\java\org\apache\rocketmq\common\UtilAllTest.java,143,44,4,11,1,60
 rocketmq-develop\rocketmq-develop\remoting\src\main\java\org\apache\rocketmq\remoting\netty\NettyServerConfig.java,143,111,1,7,0,119
 shardingsphere-master\shardingsphere-master\shardingsphere-features\shardingsphere-shadow\shardingsphere-shadow-core\src\main\java\org\apache\shardingsphere\shadow\route\engine\dml\AbstractShadowDMLStatementRouteEngine.java,143,49,2,35,0,86
 skywalking-master\skywalking-master\oap-server\analyzer\log-analyzer\src\main\java\org\apache\skywalking\oap\log\analyzer\dsl\spec\filter\FilterSpec.java,143,27,0,9,0,36
 zookeeper-master\zookeeper-master\zookeeper-server\src\main\java\org\apache\zookeeper\server\quorum\FollowerRequestProcessor.java,143,0,6,14,1,21
 zookeeper-master\zookeeper-master\zookeeper-server\src\test\java\org\apache\zookeeper\common\PEMFileLoaderTest.java,143,0,0,19,0,19
 zookeeper-master\zookeeper-master\zookeeper-server\src\test\java\org\apache\zookeeper\common\PathUtilsTest.java,143,0,20,1,0,21
 zookeeper-master\zookeeper-master\zookeeper-server\src\test\java\org\apache\zookeeper\test\RecoveryTest.java,143,0,12,21,0,33
 dubbo-3.0\dubbo-3.0\dubbo-remoting\dubbo-remoting-netty\src\test\java\org\apache\dubbo\remoting\exchange\support\header\HeartbeatHandlerTest.java,144,58,2,17,0,77
 dubbo-3.0\dubbo-3.0\dubbo-registry\dubbo-registry-api\src\main\java\org\apache\dubbo\registry\ListenerRegistryWrapper.java,144,31,4,5,0,40
 dubbo-3.0\dubbo-3.0\dubbo-rpc\dubbo-rpc-dubbo\src\main\java\org\apache\dubbo\rpc\protocol\dubbo\DubboInvoker.java,144,48,2,23,0,73
 dubbo-3.0\dubbo-3.0\dubbo-remoting\dubbo-remoting-api\src\test\java\org\apache\dubbo\remoting\handler\WrappedChannelHandlerTest.java,144,50,3,16,2,71
 dubbo-3.0\dubbo-3.0\dubbo-registry\dubbo-registry-multiple\src\test\java\org\apache\dubbo\registry\multiple\MultipleRegistry2S2RTest.java,144,65,6,43,0,114
 hadoop-trunk\hadoop-trunk\hadoop-tools\hadoop-archive-logs\src\test\java\org\apache\hadoop\tools\TestHadoopArchiveLogsRunner.java,144,27,13,1,4,45
 hadoop-trunk\hadoop-trunk\hadoop-mapreduce-project\hadoop-mapreduce-client\hadoop-mapreduce-client-common\src\main\java\org\apache\hadoop\mapreduce\v2\api\protocolrecords\impl\pb\GetTaskReportsResponsePBImpl.java,144,46,41,6,0,93
 hadoop-trunk\hadoop-trunk\hadoop-yarn-project\hadoop-yarn\hadoop-yarn-server\hadoop-yarn-server-resourcemanager\src\main\java\org\apache\hadoop\yarn\server\resourcemanager\webapp\dao\PartitionQueueCapacitiesInfo.java,144,110,1,1,4,116
 hadoop-trunk\hadoop-trunk\hadoop-hdfs-project\hadoop-hdfs\src\test\java\org\apache\hadoop\hdfs\qjournal\server\TestJournalNodeRespectsBindHostKeys.java,144,23,9,6,0,38
 hadoop-trunk\hadoop-trunk\hadoop-yarn-project\hadoop-yarn\hadoop-yarn-common\src\main\java\org\apache\hadoop\yarn\util\resource\DefaultResourceCalculator.java,144,73,3,2,1,79
 hadoop-trunk\hadoop-trunk\hadoop-hdfs-project\hadoop-hdfs\src\test\java\org\apache\hadoop\fs\TestUrlStreamHandler.java,144,22,9,3,0,34
 hadoop-trunk\hadoop-trunk\hadoop-hdfs-project\hadoop-hdfs\src\main\java\org\apache\hadoop\hdfs\server\namenode\EditLogOutputStream.java,144,29,1,1,0,31
 hadoop-trunk\hadoop-trunk\hadoop-mapreduce-project\hadoop-mapreduce-client\hadoop-mapreduce-client-common\src\main\java\org\apache\hadoop\mapreduce\v2\api\protocolrecords\impl\pb\GetTaskAttemptCompletionEventsResponsePBImpl.java,144,53,41,15,0,109
 hadoop-trunk\hadoop-trunk\hadoop-yarn-project\hadoop-yarn\hadoop-yarn-common\src\main\java\org\apache\hadoop\yarn\api\protocolrecords\impl\pb\GetContainersResponsePBImpl.java,144,24,42,3,0,69
 hadoop-trunk\hadoop-trunk\hadoop-mapreduce-project\hadoop-mapreduce-client\hadoop-mapreduce-client-core\src\main\java\org\apache\hadoop\mapreduce\lib\aggregate\ValueHistogram.java,144,20,3,1,1,25
 hadoop-trunk\hadoop-trunk\hadoop-yarn-project\hadoop-yarn\hadoop-yarn-server\hadoop-yarn-server-resourcemanager\src\test\java\org\apache\hadoop\yarn\server\resourcemanager\applicationsmanager\TestSchedulerNegotiator.java,144,9,2,10,0,21
 hadoop-trunk\hadoop-trunk\hadoop-yarn-project\hadoop-yarn\hadoop-yarn-server\hadoop-yarn-server-common\src\main\java\org\apache\hadoop\yarn\server\api\protocolrecords\impl\pb\RemoteNodePBImpl.java,144,26,49,3,0,78
 hadoop-trunk\hadoop-trunk\hadoop-tools\hadoop-azure\src\test\java\org\apache\hadoop\fs\azure\ITestAzureConcurrentOutOfBandIo.java,144,27,4,3,0,34
 hadoop-trunk\hadoop-trunk\hadoop-yarn-project\hadoop-yarn\hadoop-yarn-server\hadoop-yarn-server-resourcemanager\src\test\java\org\apache\hadoop\yarn\server\resourcemanager\volume\csi\TestVolumeMetaData.java,144,12,4,2,0,18
 hadoop-trunk\hadoop-trunk\hadoop-tools\hadoop-azure\src\test\java\org\apache\hadoop\fs\azurebfs\extensions\StubAbfsTokenIdentifier.java,144,14,0,2,0,16
 hadoop-trunk\hadoop-trunk\hadoop-yarn-project\hadoop-yarn\hadoop-yarn-common\src\main\java\org\apache\hadoop\yarn\api\protocolrecords\impl\pb\ReservationListRequestPBImpl.java,144,28,51,1,0,80
 kafka-trunk\kafka-trunk\streams\src\test\java\org\apache\kafka\streams\processor\internals\ProcessorNodeTest.java,144,0,3,34,0,37
 kafka-trunk\kafka-trunk\clients\src\test\java\org\apache\kafka\clients\consumer\CooperativeStickyAssignorTest.java,144,0,0,47,0,47
 kafka-trunk\kafka-trunk\streams\src\test\java\org\apache\kafka\streams\processor\internals\StreamsRebalanceListenerTest.java,144,0,2,17,0,19
 kafka-trunk\kafka-trunk\examples\src\main\java\kafka\examples\ExactlyOnceMessageProcessor.java,144,0,4,33,0,37
 kafka-trunk\kafka-trunk\clients\src\test\java\org\apache\kafka\clients\admin\internals\ListTransactionsHandlerTest.java,144,0,1,20,0,21
 kafka-trunk\kafka-trunk\streams\src\test\java\org\apache\kafka\streams\integration\OptimizedKTableIntegrationTest.java,144,0,1,35,1,37
 kafka-trunk\kafka-trunk\clients\src\generated\java\org\apache\kafka\common\message\ElectLeadersResponseDataJsonConverter.java,144,0,0,34,0,34
 kafka-trunk\kafka-trunk\clients\src\generated\java\org\apache\kafka\common\message\DescribeClusterResponseDataJsonConverter.java,144,0,0,34,0,34
 kafka-trunk\kafka-trunk\streams\src\test\java\org\apache\kafka\streams\integration\TaskMetadataIntegrationTest.java,144,0,2,28,3,33
 kafka-trunk\kafka-trunk\clients\src\generated\java\org\apache\kafka\common\message\LeaveGroupRequestDataJsonConverter.java,144,0,0,24,0,24
 kafka-trunk\kafka-trunk\raft\src\main\java\org\apache\kafka\raft\FollowerState.java,144,0,5,7,1,13
 kafka-trunk\kafka-trunk\clients\src\test\java\org\apache\kafka\common\acl\ResourcePatternFilterTest.java,144,0,1,6,0,7
 pulsar-master\pulsar-master\pulsar-client-1x-base\pulsar-client-1x\src\main\java\org\apache\pulsar\client\api\ReaderConfiguration.java,144,33,0,15,0,48
 pulsar-master\pulsar-master\pulsar-broker-auth-sasl\src\main\java\org\apache\pulsar\broker\authentication\PulsarSaslServer.java,144,41,4,21,0,66
 rocketmq-develop\rocketmq-develop\store\src\test\java\org\apache\rocketmq\store\ScheduleMessageServiceTest.java,144,48,8,29,2,87
 dubbo-3.0\dubbo-3.0\dubbo-config\dubbo-config-spring\src\main\java\org\apache\dubbo\config\spring\reference\ReferenceBeanManager.java,145,59,3,27,0,89
 dubbo-3.0\dubbo-3.0\dubbo-config\dubbo-config-spring\src\main\java\org\apache\dubbo\config\spring\util\DubboAnnotationUtils.java,145,41,2,26,0,69
 dubbo-3.0\dubbo-3.0\dubbo-remoting\dubbo-remoting-zookeeper-curator5\src\test\java\org\apache\dubbo\remoting\zookeeper\curator5\Curator5ZookeeperClientTest.java,145,36,3,11,0,50
 hadoop-trunk\hadoop-trunk\hadoop-hdfs-project\hadoop-hdfs-rbf\src\main\java\org\apache\hadoop\hdfs\server\federation\store\records\MembershipStats.java,145,56,1,2,0,59
 hadoop-trunk\hadoop-trunk\hadoop-common-project\hadoop-common\src\test\java\org\apache\hadoop\log\TestLogThrottlingHelper.java,145,44,0,1,0,45
 hadoop-trunk\hadoop-trunk\hadoop-hdfs-project\hadoop-hdfs\src\main\java\org\apache\hadoop\hdfs\server\datanode\metrics\OutlierDetector.java,145,28,6,1,0,35
 hadoop-trunk\hadoop-trunk\hadoop-mapreduce-project\hadoop-mapreduce-client\hadoop-mapreduce-client-common\src\main\java\org\apache\hadoop\mapreduce\v2\api\records\impl\pb\TaskAttemptCompletionEventPBImpl.java,145,50,62,10,0,122
 hadoop-trunk\hadoop-trunk\hadoop-tools\hadoop-azure\src\main\java\org\apache\hadoop\fs\azurebfs\services\AbfsInputStreamContext.java,145,66,1,3,0,70
 hadoop-trunk\hadoop-trunk\hadoop-mapreduce-project\hadoop-mapreduce-client\hadoop-mapreduce-client-hs\src\main\java\org\apache\hadoop\mapreduce\v2\hs\HistoryServerStateStoreService.java,145,29,0,1,2,32
 hadoop-trunk\hadoop-trunk\hadoop-mapreduce-project\hadoop-mapreduce-client\hadoop-mapreduce-client-core\src\main\java\org\apache\hadoop\mapreduce\jobhistory\TaskFailedEvent.java,145,80,28,1,0,109
 hadoop-trunk\hadoop-trunk\hadoop-yarn-project\hadoop-yarn\hadoop-yarn-server\hadoop-yarn-server-nodemanager\src\main\java\org\apache\hadoop\yarn\server\nodemanager\containermanager\container\SlidingWindowRetryPolicy.java,145,25,1,1,0,27
 hadoop-trunk\hadoop-trunk\hadoop-mapreduce-project\hadoop-mapreduce-client\hadoop-mapreduce-client-common\src\main\java\org\apache\hadoop\mapreduce\v2\util\MRWebAppUtil.java,145,51,2,2,0,55
 hadoop-trunk\hadoop-trunk\hadoop-mapreduce-project\hadoop-mapreduce-client\hadoop-mapreduce-client-jobclient\src\test\java\org\apache\hadoop\mapred\TestSequenceFileInputFilter.java,145,103,10,8,0,121
 hadoop-trunk\hadoop-trunk\hadoop-common-project\hadoop-common\src\main\java\org\apache\hadoop\metrics2\lib\MutableRatesWithAggregation.java,145,24,0,2,0,26
 hadoop-trunk\hadoop-trunk\hadoop-yarn-project\hadoop-yarn\hadoop-yarn-common\src\main\java\org\apache\hadoop\yarn\server\api\protocolrecords\impl\pb\UpdateNodeResourceRequestPBImpl.java,145,46,50,6,0,102
 kafka-trunk\kafka-trunk\clients\src\main\java\org\apache\kafka\clients\consumer\internals\ConsumerProtocol.java,145,0,9,34,0,43
 kafka-trunk\kafka-trunk\metadata\src\generated\java\org\apache\kafka\common\metadata\PartitionChangeRecordJsonConverter.java,145,0,0,24,0,24
 kafka-trunk\kafka-trunk\clients\src\generated\java\org\apache\kafka\common\message\EndQuorumEpochRequestDataJsonConverter.java,145,0,0,33,0,33
 kafka-trunk\kafka-trunk\clients\src\main\java\org\apache\kafka\common\security\oauthbearer\internals\OAuthBearerSaslClient.java,145,0,11,27,2,40
 kafka-trunk\kafka-trunk\clients\src\main\java\org\apache\kafka\clients\admin\internals\PartitionLeaderStrategy.java,145,0,6,29,1,36
 kafka-trunk\kafka-trunk\core\src\generated\java\kafka\internals\generated\TransactionLogKey.java,145,0,0,14,3,17
 kafka-trunk\kafka-trunk\storage\src\main\java\org\apache\kafka\server\log\remote\metadata\storage\RemotePartitionMetadataStore.java,145,0,0,51,0,51
 pulsar-master\pulsar-master\pulsar-broker\src\test\java\org\apache\pulsar\client\api\PulsarMultiListenersWithInternalListenerNameTest.java,145,49,1,25,0,75
 pulsar-master\pulsar-master\pulsar-broker\src\main\java\org\apache\pulsar\broker\stats\metrics\ManagedLedgerMetrics.java,145,40,0,27,0,67
 pulsar-master\pulsar-master\pulsar-proxy\src\test\java\org\apache\pulsar\proxy\server\ProxyAdditionalServletTest.java,145,33,5,22,0,60
 pulsar-master\pulsar-master\pulsar-functions\runtime\src\main\java\org\apache\pulsar\functions\runtime\kubernetes\KubernetesRuntimeFactoryConfig.java,145,88,0,35,0,123
 pulsar-master\pulsar-master\pulsar-client-tools\src\test\java\org\apache\pulsar\admin\cli\TestCmdPackages.java,145,58,1,20,0,79
 pulsar-master\pulsar-master\pulsar-metadata\src\test\java\org\apache\pulsar\metadata\bookkeeper\PulsarRegistrationClientTest.java,145,44,3,20,0,67
rocketmq-develop\rocketmq-develop\openmessaging\src\main\java\io\openmessaging\rocketmq\consumer\PullConsumerImpl.java,145,39,1,13,0,53
 rocketmq-develop\rocketmq-develop\filter\src\test\java\org\apache\rocketmq\filter\BloomFilterTest.java,145,50,2,13,2,67
 shardingsphere-master\shardingsphere-master\shardingsphere-kernel\shardingsphere-data-pipeline\shardingsphere-data-pipeline-core\src\main\java\org\apache\shardingsphere\data\pipeline\core\ingest\dumper\AbstractInventoryDumper.java,145,61,2,41,0,104
 skywalking-master\skywalking-master\oap-server\server-core\src\main\java\org\apache\skywalking\oap\server\core\analysis\meter\function\HistogramFunction.java,145,33,3,12,0,48
 skywalking-master\skywalking-master\oap-server\server-storage-plugin\storage-iotdb-plugin\src\main\java\org\apache\skywalking\oap\server\storage\plugin\iotdb\profile\IoTDBProfileThreadSnapshotQueryDAO.java,145,77,2,58,0,137
 skywalking-master\skywalking-master\oap-server\server-core\src\main\java\org\apache\skywalking\oap\server\core\analysis\TimeBucket.java,145,60,2,9,0,71
 zookeeper-master\zookeeper-master\zookeeper-server\src\main\java\org\apache\zookeeper\server\auth\DigestAuthenticationProvider.java,145,0,7,13,0,20
 zookeeper-master\zookeeper-master\zookeeper-server\src\test\java\org\apache\zookeeper\server\PrepRequestProcessorMetricsTest.java,145,0,14,17,4,35
 zookeeper-master\zookeeper-master\zookeeper-server\src\main\java\org\apache\zookeeper\server\watch\WatcherCleaner.java,145,0,1,17,1,19
 dubbo-3.0\dubbo-3.0\dubbo-cluster\src\test\java\org\apache\dubbo\rpc\cluster\configurator\parser\ConfigParserTest.java,146,42,6,23,0,71
 dubbo-3.0\dubbo-3.0\dubbo-compatible\src\test\java\org\apache\dubbo\config\ApplicationConfigTest.java,146,21,0,3,0,24
 dubbo-3.0\dubbo-3.0\dubbo-config\dubbo-config-api\src\test\java\org\apache\dubbo\config\integration\single\exportmetadata\SingleRegistryCenterExportMetadataIntegrationTest.java,146,35,2,25,0,62
 dubbo-3.0\dubbo-3.0\dubbo-config\dubbo-config-api\src\main\java\org\apache\dubbo\config\metadata\ConfigurableMetadataServiceExporter.java,146,39,3,17,0,59
 hadoop-trunk\hadoop-trunk\hadoop-common-project\hadoop-common\src\test\java\org\apache\hadoop\fs\TestFileSystemInitialization.java,146,21,3,1,4,29
 hadoop-trunk\hadoop-trunk\hadoop-hdfs-project\hadoop-hdfs\src\main\java\org\apache\hadoop\hdfs\util\MD5FileUtils.java,146,37,4,1,1,43
 hadoop-trunk\hadoop-trunk\hadoop-tools\hadoop-aws\src\test\java\org\apache\hadoop\fs\s3a\AbstractTestS3AEncryption.java,146,19,3,5,0,27
 hadoop-trunk\hadoop-trunk\hadoop-yarn-project\hadoop-yarn\hadoop-yarn-applications\hadoop-yarn-services\hadoop-yarn-services-core\src\main\java\org\apache\hadoop\yarn\service\api\records\ReadinessCheck.java,146,54,2,5,6,67
 hadoop-trunk\hadoop-trunk\hadoop-yarn-project\hadoop-yarn\hadoop-yarn-applications\hadoop-yarn-services\hadoop-yarn-services-core\src\test\java\org\apache\hadoop\yarn\service\MockRunningServiceContext.java,146,17,5,2,1,25
 hadoop-trunk\hadoop-trunk\hadoop-yarn-project\hadoop-yarn\hadoop-yarn-server\hadoop-yarn-server-nodemanager\src\test\java\org\apache\hadoop\yarn\server\nodemanager\containermanager\linux\runtime\TestDelegatingLinuxContainerRuntime.java,146,17,2,5,3,27
 hadoop-trunk\hadoop-trunk\hadoop-yarn-project\hadoop-yarn\hadoop-yarn-common\src\main\java\org\apache\hadoop\yarn\client\api\TimelineClient.java,146,7,1,1,0,9
 hadoop-trunk\hadoop-trunk\hadoop-hdfs-project\hadoop-hdfs\src\test\java\org\apache\hadoop\hdfs\server\blockmanagement\TestCorruptReplicaInfo.java,146,35,7,1,0,43
 hadoop-trunk\hadoop-trunk\hadoop-mapreduce-project\hadoop-mapreduce-client\hadoop-mapreduce-client-core\src\test\java\org\apache\hadoop\mapreduce\lib\output\committer\manifest\TestTaskManifestFileIO.java,146,11,1,7,0,19
 hadoop-trunk\hadoop-trunk\hadoop-common-project\hadoop-common\src\main\java\org\apache\hadoop\security\alias\LocalKeyStoreProvider.java,146,23,13,1,0,37
 hadoop-trunk\hadoop-trunk\hadoop-hdfs-project\hadoop-hdfs\src\main\java\org\apache\hadoop\hdfs\server\datanode\metrics\DataNodePeerMetrics.java,146,40,3,9,2,54
 hadoop-trunk\hadoop-trunk\hadoop-mapreduce-project\hadoop-mapreduce-client\hadoop-mapreduce-client-core\src\main\java\org\apache\hadoop\mapreduce\jobhistory\TaskAttemptFinishedEvent.java,146,78,31,1,0,110
 kafka-trunk\kafka-trunk\trogdor\src\test\java\org\apache\kafka\trogdor\workload\ExternalCommandWorkerTest.java,146,0,4,14,0,18
 kafka-trunk\kafka-trunk\server-common\src\main\java\org\apache\kafka\server\common\CheckpointFile.java,146,0,3,15,0,18
 kafka-trunk\kafka-trunk\clients\src\main\java\org\apache\kafka\common\utils\SecurityUtils.java,146,0,4,25,0,29
 kafka-trunk\kafka-trunk\connect\runtime\src\test\java\org\apache\kafka\connect\runtime\SourceTaskOffsetCommitterTest.java,146,0,3,9,2,14
 pulsar-master\pulsar-master\pulsar-io\mongo\src\test\java\org\apache\pulsar\io\mongodb\MongoSinkTest.java,146,30,2,4,0,36
 pulsar-master\pulsar-master\pulsar-broker\src\test\java\org\apache\pulsar\broker\admin\BookiesApiTest.java,146,13,6,6,0,25
 rocketmq-develop\rocketmq-develop\store\src\test\java\org\apache\rocketmq\store\StoreTestBase.java,146,47,5,10,1,63
 rocketmq-develop\rocketmq-develop\broker\src\main\java\org\apache\rocketmq\broker\client\ProducerManager.java,146,52,6,29,4,91
 rocketmq-develop\rocketmq-develop\openmessaging\src\main\java\io\openmessaging\rocketmq\utils\OMSUtil.java,146,30,1,15,0,46
 rocketmq-develop\rocketmq-develop\common\src\main\java\org\apache\rocketmq\common\protocol\body\ProcessQueueInfo.java,146,105,0,8,0,113
 skywalking-master\skywalking-master\oap-server\server-core\src\main\java\org\apache\skywalking\oap\server\core\analysis\manual\instance\InstanceTraffic.java,146,37,1,13,0,51
 skywalking-master\skywalking-master\oap-server\server-receiver-plugin\envoy-metrics-receiver-plugin\src\main\java\org\apache\skywalking\oap\server\receiver\envoy\als\k8s\K8sALSServiceMeshHTTPAnalysis.java,146,46,1,34,0,81
 zookeeper-master\zookeeper-master\zookeeper-server\src\test\java\org\apache\zookeeper\server\quorum\LeaderWithObserverTest.java,146,0,5,23,3,31
 zookeeper-master\zookeeper-master\zookeeper-contrib\zookeeper-contrib-zooinspector\src\main\java\org\apache\zookeeper\inspector\gui\nodeviewer\NodeViewerACL.java,146,0,2,3,1,6
 dubbo-3.0\dubbo-3.0\dubbo-config\dubbo-config-api\src\test\java\org\apache\dubbo\config\integration\single\injvm\SingleRegistryCenterInjvmIntegrationTest.java,147,30,2,21,0,53
 dubbo-3.0\dubbo-3.0\dubbo-rpc\dubbo-rpc-triple\src\main\java\org\apache\dubbo\rpc\protocol\tri\frame\TriDecoder.java,147,37,0,10,0,47
 dubbo-3.0\dubbo-3.0\dubbo-rpc\dubbo-rpc-triple\src\main\java\org\apache\dubbo\rpc\protocol\tri\DeadlineFuture.java,147,64,2,18,0,84
 dubbo-3.0\dubbo-3.0\dubbo-cluster\src\main\java\org\apache\dubbo\rpc\cluster\support\MergeableClusterInvoker.java,147,35,4,22,0,61
 dubbo-3.0\dubbo-3.0\dubbo-common\src\main\java\org\apache\dubbo\common\url\component\DubboServiceAddressURL.java,147,52,0,13,3,68
 dubbo-3.0\dubbo-3.0\dubbo-registry\dubbo-registry-api\src\main\java\org\apache\dubbo\registry\client\metadata\MetadataUtils.java,147,57,5,40,0,102
 dubbo-3.0\dubbo-3.0\dubbo-remoting\dubbo-remoting-api\src\main\java\org\apache\dubbo\remoting\api\PortUnificationServer.java,147,43,3,19,2,67
 hadoop-trunk\hadoop-trunk\hadoop-yarn-project\hadoop-yarn\hadoop-yarn-client\src\main\java\org\apache\hadoop\yarn\client\SCMAdmin.java,147,21,1,4,0,26
 hadoop-trunk\hadoop-trunk\hadoop-tools\hadoop-azure\src\test\java\org\apache\hadoop\fs\azure\ITestContainerChecks.java,147,11,3,1,0,15
 hadoop-trunk\hadoop-trunk\hadoop-mapreduce-project\hadoop-mapreduce-client\hadoop-mapreduce-client-core\src\main\java\org\apache\hadoop\mapreduce\jobhistory\JobUnsuccessfulCompletionEvent.java,147,68,33,1,0,102
 hadoop-trunk\hadoop-trunk\hadoop-tools\hadoop-azure\src\test\java\org\apache\hadoop\fs\azure\TestNativeAzureFileSystemConcurrency.java,147,13,2,4,1,20
 hadoop-trunk\hadoop-trunk\hadoop-yarn-project\hadoop-yarn\hadoop-yarn-common\src\test\java\org\apache\hadoop\yarn\api\TestPlacementConstraintPBConversion.java,147,13,17,8,0,38
 hadoop-trunk\hadoop-trunk\hadoop-yarn-project\hadoop-yarn\hadoop-yarn-server\hadoop-yarn-server-resourcemanager\src\main\java\org\apache\hadoop\yarn\server\resourcemanager\reservation\ReservationSchedulerConfiguration.java,147,45,0,5,0,50
 hadoop-trunk\hadoop-trunk\hadoop-mapreduce-project\hadoop-mapreduce-client\hadoop-mapreduce-client-jobclient\src\test\java\org\apache\hadoop\mapreduce\TestMapReduceLazyOutput.java,147,51,16,1,2,70
 hadoop-trunk\hadoop-trunk\hadoop-yarn-project\hadoop-yarn\hadoop-yarn-applications\hadoop-yarn-services\hadoop-yarn-services-core\src\main\java\org\apache\hadoop\yarn\service\utils\PublishedConfiguration.java,147,43,4,1,0,48
 hadoop-trunk\hadoop-trunk\hadoop-yarn-project\hadoop-yarn\hadoop-yarn-server\hadoop-yarn-server-resourcemanager\src\test\java\org\apache\hadoop\yarn\server\resourcemanager\reservation\BaseSharingPolicyTest.java,147,38,10,4,2,54
 hadoop-trunk\hadoop-trunk\hadoop-tools\hadoop-azure\src\test\java\org\apache\hadoop\fs\azure\TestNativeAzureFileSystemUploadLogic.java,147,23,1,11,0,35
 hadoop-trunk\hadoop-trunk\hadoop-yarn-project\hadoop-yarn\hadoop-yarn-common\src\main\java\org\apache\hadoop\yarn\api\protocolrecords\impl\pb\GetClusterNodeLabelsResponsePBImpl.java,147,25,42,3,0,70
 hadoop-trunk\hadoop-trunk\hadoop-yarn-project\hadoop-yarn\hadoop-yarn-applications\hadoop-yarn-services\hadoop-yarn-services-core\src\main\java\org\apache\hadoop\yarn\service\containerlaunch\JavaCommandLineBuilder.java,147,37,0,3,1,41
 hadoop-trunk\hadoop-trunk\hadoop-yarn-project\hadoop-yarn\hadoop-yarn-server\hadoop-yarn-server-resourcemanager\src\main\java\org\apache\hadoop\yarn\server\resourcemanager\scheduler\capacity\allocator\AbstractContainerAllocator.java,147,36,1,12,3,52
 hadoop-trunk\hadoop-trunk\hadoop-tools\hadoop-azure\src\main\java\org\apache\hadoop\fs\azurebfs\services\ExponentialRetryPolicy.java,147,26,2,13,0,41
 hadoop-trunk\hadoop-trunk\hadoop-tools\hadoop-aws\src\test\java\org\apache\hadoop\fs\s3a\ITestS3AEndpointRegion.java,147,13,0,2,0,15
 hadoop-trunk\hadoop-trunk\hadoop-hdfs-project\hadoop-hdfs\src\test\java\org\apache\hadoop\hdfs\server\blockmanagement\TestNodeCount.java,147,57,4,5,2,68
 hadoop-trunk\hadoop-trunk\hadoop-common-project\hadoop-common\src\main\java\org\apache\hadoop\util\VersionInfo.java,147,37,11,1,0,49
 kafka-trunk\kafka-trunk\streams\src\test\java\org\apache\kafka\streams\state\internals\InMemoryWindowStoreTest.java,147,0,1,33,2,36
 kafka-trunk\kafka-trunk\storage\src\test\java\org\apache\kafka\server\log\remote\storage\InmemoryRemoteStorageManager.java,147,0,0,50,0,50
 kafka-trunk\kafka-trunk\streams\src\test\java\org\apache\kafka\streams\state\internals\OffsetCheckpointTest.java,147,0,2,18,2,22
 kafka-trunk\kafka-trunk\connect\runtime\src\main\java\org\apache\kafka\connect\runtime\rest\entities\ConfigKeyInfo.java,147,0,2,2,2,6
 kafka-trunk\kafka-trunk\core\src\generated\java\kafka\internals\generated\GroupMetadataKey.java,147,0,0,11,3,14
 kafka-trunk\kafka-trunk\streams\src\test\java\org\apache\kafka\streams\state\internals\ChangeLoggingTimestampedWindowBytesStoreTest.java,147,0,0,14,0,14
 kafka-trunk\kafka-trunk\streams\src\test\java\org\apache\kafka\streams\integration\KTableKTableForeignKeyJoinMaterializationIntegrationTest.java,147,0,2,21,1,24
 rocketmq-develop\rocketmq-develop\common\src\main\java\org\apache\rocketmq\common\protocol\header\ReplyMessageRequestHeader.java,147,99,1,1,0,101
 shardingsphere-master\shardingsphere-master\shardingsphere-test\shardingsphere-integration-test\shardingsphere-integration-test-suite\src\test\java\org\apache\shardingsphere\test\integration\engine\ddl\BaseDDLIT.java,147,53,1,39,0,93
 skywalking-master\skywalking-master\oap-server\server-core\src\test\java\org\apache\skywalking\oap\server\core\analysis\metrics\PxxMetricsTest.java,147,64,1,2,0,67
 skywalking-master\skywalking-master\oap-server\server-library\library-util\src\main\java\org\apache\skywalking\oap\server\library\util\prometheus\parser\Context.java,147,39,7,19,1,66
 druid-master\druid-master\extensions-contrib\influx-extensions\target\generated-sources\antlr4\org\apache\druid\data\input\influx\InfluxLineProtocolBaseListener.java,148,51,24,19,0,94
 dubbo-3.0\dubbo-3.0\dubbo-config\dubbo-config-api\src\test\java\org\apache\dubbo\config\AbstractServiceConfigTest.java,148,31,0,9,0,40
 dubbo-3.0\dubbo-3.0\dubbo-rpc\dubbo-rpc-api\src\main\java\org\apache\dubbo\rpc\filter\AccessLogFilter.java,148,44,5,21,3,73
 dubbo-3.0\dubbo-3.0\dubbo-test\dubbo-test-spring\src\main\java\org\apache\dubbo\test\spring\SpringJavaConfigBeanTest.java,148,30,0,16,0,46
 dubbo-3.0\dubbo-3.0\dubbo-common\src\main\java\org\apache\dubbo\rpc\model\ConsumerModel.java,148,67,0,18,1,86
 dubbo-3.0\dubbo-3.0\dubbo-config\dubbo-config-api\src\test\java\org\apache\dubbo\config\integration\multiple\injvm\MultipleRegistryCenterInjvmIntegrationTest.java,148,31,2,22,0,55
 dubbo-3.0\dubbo-3.0\dubbo-configcenter\dubbo-configcenter-apollo\src\test\java\org\apache\dubbo\configcenter\support\apollo\ApolloDynamicConfigurationTest.java,148,40,2,18,0,60
 dubbo-3.0\dubbo-3.0\dubbo-metadata\dubbo-metadata-processor\src\test\java\org\apache\dubbo\metadata\annotation\processing\util\MethodUtilsTest.java,148,32,2,21,0,55
 hadoop-trunk\hadoop-trunk\hadoop-tools\hadoop-fs2img\src\test\java\org\apache\hadoop\hdfs\server\namenode\RandomTreeWalk.java,148,58,4,1,8,71
 hadoop-trunk\hadoop-trunk\hadoop-mapreduce-project\hadoop-mapreduce-client\hadoop-mapreduce-client-core\src\main\java\org\apache\hadoop\mapreduce\lib\output\committer\manifest\impl\ManifestStoreOperationsThroughFileSystem.java,148,27,1,6,3,37
 hadoop-trunk\hadoop-trunk\hadoop-common-project\hadoop-kms\src\main\java\org\apache\hadoop\crypto\key\kms\server\KMSWebServer.java,148,28,0,6,0,34
 hadoop-trunk\hadoop-trunk\hadoop-yarn-project\hadoop-yarn\hadoop-yarn-client\src\test\java\org\apache\hadoop\yarn\client\cli\TestClusterCLI.java,148,50,1,26,9,86
 hadoop-trunk\hadoop-trunk\hadoop-common-project\hadoop-common\src\test\java\org\apache\hadoop\fs\TestAfsCheckPath.java,148,60,2,2,2,66
 hadoop-trunk\hadoop-trunk\hadoop-hdfs-project\hadoop-hdfs\src\test\java\org\apache\hadoop\hdfs\TestHDFSTrash.java,148,39,3,1,5,48
 hadoop-trunk\hadoop-trunk\hadoop-yarn-project\hadoop-yarn\hadoop-yarn-server\hadoop-yarn-server-nodemanager\src\test\java\org\apache\hadoop\yarn\server\nodemanager\containermanager\BaseContainerSchedulerTest.java,148,35,1,12,2,50
 hadoop-trunk\hadoop-trunk\hadoop-hdfs-project\hadoop-hdfs\src\test\java\org\apache\hadoop\hdfs\server\blockmanagement\TestBlockReportLease.java,148,9,0,3,2,14
 hadoop-trunk\hadoop-trunk\hadoop-hdfs-project\hadoop-hdfs-client\src\main\java\org\apache\hadoop\hdfs\protocol\HdfsNamedFileStatus.java,148,47,4,1,2,54
 hadoop-trunk\hadoop-trunk\hadoop-yarn-project\hadoop-yarn\hadoop-yarn-server\hadoop-yarn-server-nodemanager\src\test\java\org\apache\hadoop\yarn\server\nodemanager\webapp\dao\gpu\TestGpuDeviceInformationParser.java,148,29,0,1,0,30
 hadoop-trunk\hadoop-trunk\hadoop-mapreduce-project\hadoop-mapreduce-client\hadoop-mapreduce-client-hs\src\main\java\org\apache\hadoop\mapreduce\v2\hs\CompletedTaskAttempt.java,148,31,1,1,3,36
 hadoop-trunk\hadoop-trunk\hadoop-mapreduce-project\hadoop-mapreduce-client\hadoop-mapreduce-client-core\src\main\java\org\apache\hadoop\mapreduce\lib\output\committer\manifest\stages\ValidateRenamedFilesStage.java,148,6,0,9,0,15
 hadoop-trunk\hadoop-trunk\hadoop-yarn-project\hadoop-yarn\hadoop-yarn-server\hadoop-yarn-server-resourcemanager\src\main\java\org\apache\hadoop\yarn\server\resourcemanager\monitor\SchedulingMonitorManager.java,148,27,4,2,2,35
 kafka-trunk\kafka-trunk\metadata\src\generated\java\org\apache\kafka\common\metadata\UnfenceBrokerRecord.java,148,0,0,7,2,9
 kafka-trunk\kafka-trunk\clients\src\main\java\org\apache\kafka\common\requests\ListOffsetsRequest.java,148,0,94,21,2,117
 kafka-trunk\kafka-trunk\connect\runtime\src\main\java\org\apache\kafka\connect\storage\OffsetStorageWriter.java,148,0,5,49,1,55
 kafka-trunk\kafka-trunk\clients\src\generated\java\org\apache\kafka\common\message\SnapshotHeaderRecord.java,148,0,0,10,2,12
 kafka-trunk\kafka-trunk\clients\src\generated\java\org\apache\kafka\common\message\SaslHandshakeRequestData.java,148,0,0,13,2,15
 kafka-trunk\kafka-trunk\metadata\src\generated\java\org\apache\kafka\common\metadata\FenceBrokerRecord.java,148,0,0,7,2,9
 kafka-trunk\kafka-trunk\metadata\src\generated\java\org\apache\kafka\common\metadata\UnregisterBrokerRecord.java,148,0,0,7,2,9
 kafka-trunk\kafka-trunk\clients\src\generated\java\org\apache\kafka\common\message\MetadataRequestDataJsonConverter.java,148,0,0,32,0,32
 kafka-trunk\kafka-trunk\streams\src\test\java\org\apache\kafka\streams\integration\StandbyTaskCreationIntegrationTest.java,148,0,4,27,1,32
 kafka-trunk\kafka-trunk\clients\src\test\java\org\apache\kafka\common\metrics\stats\HistogramTest.java,148,0,6,8,0,14
 kafka-trunk\kafka-trunk\clients\src\main\java\org\apache\kafka\common\security\oauthbearer\secured\OAuthBearerLoginCallbackHandler.java,148,0,7,58,0,65
 kafka-trunk\kafka-trunk\clients\src\generated\java\org\apache\kafka\common\message\AllocateProducerIdsRequestData.java,148,0,0,11,1,12
 pulsar-master\pulsar-master\pulsar-client-1x-base\pulsar-client-1x\src\main\java\org\apache\pulsar\client\impl\v1\ConsumerV1Impl.java,148,79,0,8,0,87
 pulsar-master\pulsar-master\pulsar-broker\src\test\java\org\apache\pulsar\io\PulsarFunctionAdminTest.java,148,69,7,24,0,100
 pulsar-master\pulsar-master\pulsar-client\src\main\java\org\apache\pulsar\client\impl\schema\AbstractStructSchema.java,148,62,2,11,0,75
 pulsar-master\pulsar-master\managed-ledger\src\main\java\org\apache\bookkeeper\mledger\impl\EntryImpl.java,148,31,0,4,0,35
 rocketmq-develop\rocketmq-develop\test\src\main\java\org\apache\rocketmq\test\client\rmq\RMQNormalProducer.java,148,59,0,7,13,79
 rocketmq-develop\rocketmq-develop\namesrv\src\main\java\org\apache\rocketmq\namesrv\NamesrvController.java,148,64,1,17,7,89
 skywalking-master\skywalking-master\oap-server\server-library\library-datacarrier-queue\src\main\java\org\apache\skywalking\oap\server\library\datacarrier\consumer\MultipleChannelsConsumer.java,148,43,5,12,0,60
 dubbo-3.0\dubbo-3.0\dubbo-common\src\main\java\org\apache\dubbo\rpc\model\ServiceModel.java,149,92,0,10,11,113
 hadoop-trunk\hadoop-trunk\hadoop-yarn-project\hadoop-yarn\hadoop-yarn-server\hadoop-yarn-server-resourcemanager\src\main\java\org\apache\hadoop\yarn\server\resourcemanager\scheduler\fair\converter\FSYarnSiteConverter.java,149,25,0,11,0,36
 hadoop-trunk\hadoop-trunk\hadoop-tools\hadoop-rumen\src\main\java\org\apache\hadoop\tools\rumen\Task20LineHistoryEventEmitter.java,149,29,8,1,0,38
 hadoop-trunk\hadoop-trunk\hadoop-yarn-project\hadoop-yarn\hadoop-yarn-api\src\main\java\org\apache\hadoop\yarn\api\records\timeline\TimelineDomain.java,149,51,2,1,3,57
 hadoop-trunk\hadoop-trunk\hadoop-tools\hadoop-azure\src\test\java\org\apache\hadoop\fs\azure\TestClientThrottlingAnalyzer.java,149,23,0,4,0,27
 hadoop-trunk\hadoop-trunk\hadoop-common-project\hadoop-nfs\src\main\java\org\apache\hadoop\nfs\nfs3\request\SetAttr3.java,149,64,2,1,3,70
 hadoop-trunk\hadoop-trunk\hadoop-common-project\hadoop-common\src\test\java\org\apache\hadoop\http\TestAuthenticationSessionCookie.java,149,29,3,1,4,37
 hadoop-trunk\hadoop-trunk\hadoop-mapreduce-project\hadoop-mapreduce-client\hadoop-mapreduce-client-core\src\main\java\org\apache\hadoop\mapreduce\lib\output\PathOutputCommitterFactory.java,149,9,0,1,0,10
 hadoop-trunk\hadoop-trunk\hadoop-yarn-project\hadoop-yarn\hadoop-yarn-server\hadoop-yarn-server-common\src\main\java\org\apache\hadoop\yarn\server\api\protocolrecords\impl\pb\LogAggregationReportPBImpl.java,149,34,54,3,0,91
 hadoop-trunk\hadoop-trunk\hadoop-yarn-project\hadoop-yarn\hadoop-yarn-common\src\main\java\org\apache\hadoop\yarn\api\protocolrecords\impl\pb\GetApplicationAttemptsResponsePBImpl.java,149,24,42,5,0,71
 hadoop-trunk\hadoop-trunk\hadoop-hdfs-project\hadoop-hdfs-rbf\src\main\java\org\apache\hadoop\hdfs\server\federation\router\RouterSafemodeService.java,149,13,4,1,1,19
 hadoop-trunk\hadoop-trunk\hadoop-yarn-project\hadoop-yarn\hadoop-yarn-common\src\test\java\org\apache\hadoop\yarn\server\security\TestApplicationACLsManager.java,149,61,0,24,0,85
 hadoop-trunk\hadoop-trunk\hadoop-tools\hadoop-azure\src\test\java\org\apache\hadoop\fs\azurebfs\services\TestAbfsClientThrottlingAnalyzer.java,149,24,0,4,0,28
 hadoop-trunk\hadoop-trunk\hadoop-tools\hadoop-rumen\src\main\java\org\apache\hadoop\tools\rumen\datatypes\NodeName.java,149,59,4,1,4,68
 hadoop-trunk\hadoop-trunk\hadoop-yarn-project\hadoop-yarn\hadoop-yarn-server\hadoop-yarn-server-resourcemanager\src\test\java\org\apache\hadoop\yarn\server\resourcemanager\TestMoveApplication.java,149,38,0,7,3,48
 hadoop-trunk\hadoop-trunk\hadoop-hdfs-project\hadoop-hdfs\src\test\java\org\apache\hadoop\hdfs\server\namenode\ha\TestFailureOfSharedDir.java,149,16,0,6,0,22
 hadoop-trunk\hadoop-trunk\hadoop-yarn-project\hadoop-yarn\hadoop-yarn-server\hadoop-yarn-server-timelineservice-hbase\hadoop-yarn-server-timelineservice-hbase-common\src\main\java\org\apache\hadoop\yarn\server\timelineservice\storage\domain\DomainRowKey.java,149,19,1,3,0,23
 kafka-trunk\kafka-trunk\clients\src\generated\java\org\apache\kafka\common\message\ResponseHeaderData.java,149,0,0,10,2,12
 kafka-trunk\kafka-trunk\clients\src\main\java\org\apache\kafka\common\security\oauthbearer\secured\ValidatorAccessTokenValidator.java,149,0,7,47,0,54
 kafka-trunk\kafka-trunk\connect\runtime\src\main\java\org\apache\kafka\connect\runtime\SourceConnectorConfig.java,149,0,1,44,0,45
 kafka-trunk\kafka-trunk\clients\src\main\java\org\apache\kafka\common\feature\Features.java,149,0,1,20,1,22
 kafka-trunk\kafka-trunk\clients\src\test\java\org\apache\kafka\clients\admin\internals\AlterConsumerGroupOffsetsHandlerTest.java,149,0,2,18,2,22
 pulsar-master\pulsar-master\tests\integration\src\test\java\org\apache\pulsar\tests\integration\io\sources\SourceTester.java,149,73,8,14,0,95
 pulsar-master\pulsar-master\pulsar-broker\src\test\java\org\apache\pulsar\broker\admin\AdminApiDelayedDelivery.java,149,46,2,25,0,73
 pulsar-master\pulsar-master\pulsar-package-management\bookkeeper-storage\src\main\java\org\apache\pulsar\packages\management\storage\bookkeeper\BookKeeperPackagesStorage.java,149,45,0,24,0,69
 pulsar-master\pulsar-master\pulsar-broker\src\test\java\org\apache\pulsar\client\api\MultiTopicsConsumerTest.java,149,40,4,21,0,65
 pulsar-master\pulsar-master\pulsar-broker\src\main\java\org\apache\pulsar\broker\admin\impl\ResourceGroupsBase.java,149,49,15,32,0,96
 pulsar-master\pulsar-master\pulsar-io\kinesis\src\main\java\org\apache\pulsar\io\kinesis\KinesisSourceConfig.java,149,50,0,24,0,74
 rocketmq-develop\rocketmq-develop\store\src\test\java\stats\BrokerStatsManagerTest.java,149,72,0,42,0,114
 rocketmq-develop\rocketmq-develop\remoting\src\test\java\org\apache\rocketmq\remoting\protocol\RocketMQSerializableTest.java,149,64,5,14,1,84
 dubbo-3.0\dubbo-3.0\dubbo-config\dubbo-config-api\src\test\java\org\apache\dubbo\config\integration\multiple\exportmetadata\MultipleRegistryCenterExportMetadataIntegrationTest.java,150,37,2,27,0,66
 hadoop-trunk\hadoop-trunk\hadoop-tools\hadoop-azure\src\test\java\org\apache\hadoop\fs\azurebfs\TestTracingContext.java,150,12,1,5,1,19
 hadoop-trunk\hadoop-trunk\hadoop-yarn-project\hadoop-yarn\hadoop-yarn-server\hadoop-yarn-server-resourcemanager\src\main\java\org\apache\hadoop\yarn\server\resourcemanager\recovery\NullRMStateStore.java,150,39,4,10,0,53
 hadoop-trunk\hadoop-trunk\hadoop-common-project\hadoop-common\src\main\java\org\apache\hadoop\fs\FsServerDefaults.java,150,122,1,1,0,124
 hadoop-trunk\hadoop-trunk\hadoop-yarn-project\hadoop-yarn\hadoop-yarn-server\hadoop-yarn-server-common\src\main\java\org\apache\hadoop\yarn\server\scheduler\SchedulerRequestKey.java,150,33,1,1,4,39
 hadoop-trunk\hadoop-trunk\hadoop-yarn-project\hadoop-yarn\hadoop-yarn-applications\hadoop-yarn-services\hadoop-yarn-services-core\src\main\java\org\apache\hadoop\yarn\service\api\records\Resource.java,150,58,4,6,3,71
 hadoop-trunk\hadoop-trunk\hadoop-hdfs-project\hadoop-hdfs-client\src\main\java\org\apache\hadoop\hdfs\StripedDataStreamer.java,150,30,3,2,1,36
 hadoop-trunk\hadoop-trunk\hadoop-common-project\hadoop-common\src\main\java\org\apache\hadoop\security\token\SecretManager.java,150,30,4,3,0,37
 hadoop-trunk\hadoop-trunk\hadoop-tools\hadoop-gridmix\src\main\java\org\apache\hadoop\mapred\gridmix\SerialJobFactory.java,150,19,3,3,0,25
 hadoop-trunk\hadoop-trunk\hadoop-mapreduce-project\hadoop-mapreduce-client\hadoop-mapreduce-client-jobclient\src\test\java\org\apache\hadoop\mapred\TestMultipleLevelCaching.java,150,46,8,2,0,56
 hadoop-trunk\hadoop-trunk\hadoop-hdfs-project\hadoop-hdfs\src\test\java\org\apache\hadoop\hdfs\server\datanode\fsdataset\impl\TestReservedSpaceCalculator.java,150,80,0,7,0,87
 hadoop-trunk\hadoop-trunk\hadoop-yarn-project\hadoop-yarn\hadoop-yarn-common\src\main\java\org\apache\hadoop\yarn\api\protocolrecords\impl\pb\ReservationSubmissionRequestPBImpl.java,150,34,53,4,0,91
 hadoop-trunk\hadoop-trunk\hadoop-mapreduce-project\hadoop-mapreduce-client\hadoop-mapreduce-client-core\src\main\java\org\apache\hadoop\mapred\JobEndNotifier.java,150,47,20,2,0,69
 hadoop-trunk\hadoop-trunk\hadoop-tools\hadoop-gridmix\src\test\java\org\apache\hadoop\mapred\gridmix\TestFilePool.java,150,36,4,2,5,47
 hadoop-trunk\hadoop-trunk\hadoop-tools\hadoop-aws\src\test\java\org\apache\hadoop\fs\s3a\audit\ITestAuditAccessChecks.java,150,8,2,6,0,16
 kafka-trunk\kafka-trunk\core\src\test\java\kafka\testkit\TestKitNodes.java,150,0,0,11,0,11
 kafka-trunk\kafka-trunk\connect\api\src\main\java\org\apache\kafka\connect\connector\ConnectRecord.java,150,0,2,14,0,16
 kafka-trunk\kafka-trunk\clients\src\main\java\org\apache\kafka\common\metrics\stats\Frequencies.java,150,0,0,30,3,33
 kafka-trunk\kafka-trunk\streams\src\main\java\org\apache\kafka\streams\processor\internals\assignment\CopartitionedTopicsEnforcer.java,150,0,0,48,0,48
 kafka-trunk\kafka-trunk\connect\runtime\src\main\java\org\apache\kafka\connect\runtime\errors\WorkerErrantRecordReporter.java,150,0,0,23,1,24
 pulsar-master\pulsar-master\pulsar-io\elastic-search\src\main\java\org\apache\pulsar\io\elasticsearch\client\RestClient.java,150,58,2,26,0,86
 pulsar-master\pulsar-master\pulsar-io\netty\src\main\java\org\apache\pulsar\io\netty\server\NettyServer.java,150,56,0,10,0,66
 pulsar-master\pulsar-master\pulsar-io\hbase\src\main\java\org\apache\pulsar\io\hbase\sink\HbaseAbstractSink.java,150,45,4,17,0,66
 pulsar-master\pulsar-master\pulsar-functions\instance\src\main\java\org\apache\pulsar\functions\instance\state\BKStateStoreProviderImpl.java,150,54,2,28,0,84
 pulsar-master\pulsar-master\pulsar-io\elastic-search\src\main\java\org\apache\pulsar\io\elasticsearch\client\elastic\ElasticSearchJavaRestClient.java,150,52,5,21,0,78
 rocketmq-develop\rocketmq-develop\client\src\test\java\org\apache\rocketmq\client\trace\DefaultMQConsumerWithOpenTracingTest.java,150,55,4,26,2,87
 rocketmq-develop\rocketmq-develop\client\src\main\java\org\apache\rocketmq\client\trace\TraceBean.java,150,98,0,2,0,100
 dubbo-3.0\dubbo-3.0\dubbo-common\src\test\java\org\apache\dubbo\common\compiler\support\ClassUtilsTest.java,151,48,3,34,0,85
 dubbo-3.0\dubbo-3.0\dubbo-common\src\test\java\org\apache\dubbo\common\io\StreamUtilsTest.java,151,17,7,8,11,43
 dubbo-3.0\dubbo-3.0\dubbo-monitor\dubbo-monitor-default\src\main\java\org\apache\dubbo\monitor\dubbo\DubboMonitor.java,151,43,5,23,0,71
 dubbo-3.0\dubbo-3.0\dubbo-common\src\main\java\org\apache\dubbo\metadata\definition\model\TypeDefinition.java,151,51,1,4,6,62
 dubbo-3.0\dubbo-3.0\dubbo-metadata\dubbo-metadata-report-redis\src\main\java\org\apache\dubbo\metadata\store\redis\RedisMetadataReport.java,151,84,12,39,0,135
 hadoop-trunk\hadoop-trunk\hadoop-yarn-project\hadoop-yarn\hadoop-yarn-server\hadoop-yarn-server-resourcemanager\src\test\java\org\apache\hadoop\yarn\server\resourcemanager\volume\csi\TestVolumeLifecycle.java,151,10,8,7,1,26
 hadoop-trunk\hadoop-trunk\hadoop-hdfs-project\hadoop-hdfs-rbf\src\test\java\org\apache\hadoop\hdfs\server\federation\router\TestRouterNamenodeWebScheme.java,151,8,0,4,1,13
 hadoop-trunk\hadoop-trunk\hadoop-common-project\hadoop-common\src\main\java\org\apache\hadoop\crypto\OpensslCtrCryptoCodec.java,151,61,2,2,6,71
 hadoop-trunk\hadoop-trunk\hadoop-tools\hadoop-openstack\src\test\java\org\apache\hadoop\fs\swift\TestSwiftConfig.java,151,34,10,20,1,65
 hadoop-trunk\hadoop-trunk\hadoop-hdfs-project\hadoop-hdfs\src\test\java\org\apache\hadoop\hdfs\TestErasureCodingMultipleRacks.java,151,16,4,4,0,24
 hadoop-trunk\hadoop-trunk\hadoop-common-project\hadoop-auth\src\main\java\org\apache\hadoop\security\authentication\server\MultiSchemeAuthenticationHandler.java,151,28,8,2,2,40
 hadoop-trunk\hadoop-trunk\hadoop-tools\hadoop-azure\src\test\java\org\apache\hadoop\fs\azurebfs\extensions\TestDTManagerLifecycle.java,151,12,1,6,0,19
 hadoop-trunk\hadoop-trunk\hadoop-common-project\hadoop-common\src\main\java\org\apache\hadoop\util\CrcComposer.java,151,49,1,1,0,51
 hadoop-trunk\hadoop-trunk\hadoop-hdfs-project\hadoop-hdfs\src\test\java\org\apache\hadoop\hdfs\TestRead.java,151,44,5,3,2,54
 hadoop-trunk\hadoop-trunk\hadoop-mapreduce-project\hadoop-mapreduce-client\hadoop-mapreduce-client-core\src\main\java\org\apache\hadoop\mapreduce\jobhistory\JobFinishedEvent.java,151,80,37,1,0,118
 hadoop-trunk\hadoop-trunk\hadoop-hdfs-project\hadoop-hdfs-httpfs\src\main\java\org\apache\hadoop\lib\server\BaseService.java,151,15,4,5,1,25
 hadoop-trunk\hadoop-trunk\hadoop-yarn-project\hadoop-yarn\hadoop-yarn-api\src\main\java\org\apache\hadoop\yarn\api\records\timeline\TimelineEvents.java,151,44,4,1,3,52
 hadoop-trunk\hadoop-trunk\hadoop-tools\hadoop-aws\src\test\java\org\apache\hadoop\fs\s3a\scale\S3AScaleTestBase.java,151,17,2,2,4,25
 hadoop-trunk\hadoop-trunk\hadoop-hdfs-project\hadoop-hdfs-httpfs\src\test\java\org\apache\hadoop\test\HadoopUsersConfTestHelper.java,151,31,3,20,1,55
 hadoop-trunk\hadoop-trunk\hadoop-hdfs-project\hadoop-hdfs-httpfs\src\test\java\org\apache\hadoop\test\TestHFSTestCase.java,151,37,3,5,5,50
 kafka-trunk\kafka-trunk\streams\src\test\java\org\apache\kafka\streams\processor\internals\metrics\ProcessorNodeMetricsTest.java,151,0,0,25,0,25
 kafka-trunk\kafka-trunk\connect\runtime\src\test\java\org\apache\kafka\connect\util\RetryUtilTest.java,151,0,3,23,3,29
 kafka-trunk\kafka-trunk\streams\src\test\java\org\apache\kafka\streams\kstream\internals\suppress\KTableSuppressProcessorMetricsTest.java,151,0,0,14,0,14
 kafka-trunk\kafka-trunk\clients\src\test\java\org\apache\kafka\common\security\oauthbearer\secured\AccessTokenBuilder.java,151,0,6,3,2,11
 pulsar-master\pulsar-master\pulsar-client\src\main\java\org\apache\pulsar\client\impl\ProducerBase.java,151,68,1,10,0,79
 pulsar-master\pulsar-master\pulsar-functions\instance\src\main\java\org\apache\pulsar\functions\instance\JavaInstance.java,151,41,2,9,0,52
 pulsar-master\pulsar-master\pulsar-io\kinesis\src\test\java\org\apache\pulsar\io\kinesis\KinesisSourceConfigTests.java,151,47,0,18,0,65
 skywalking-master\skywalking-master\oap-server\server-storage-plugin\storage-iotdb-plugin\src\main\java\org\apache\skywalking\oap\server\storage\plugin\iotdb\utils\IoTDBDataConverter.java,151,57,0,32,0,89
 dubbo-3.0\dubbo-3.0\dubbo-remoting\dubbo-remoting-api\src\main\java\org\apache\dubbo\remoting\exchange\Response.java,152,55,1,3,0,59
 dubbo-3.0\dubbo-3.0\dubbo-common\src\main\java\org\apache\dubbo\rpc\model\ProviderModel.java,152,78,4,10,7,99
 dubbo-3.0\dubbo-3.0\dubbo-spring-boot\dubbo-spring-boot-compatible\autoconfigure\src\main\java\org\apache\dubbo\spring\boot\util\DubboUtils.java,152,55,1,26,0,82
 hadoop-trunk\hadoop-trunk\hadoop-common-project\hadoop-common\src\test\java\org\apache\hadoop\fs\viewfs\TestViewFileSystemDelegationTokenSupport.java,152,76,2,4,0,82
 hadoop-trunk\hadoop-trunk\hadoop-common-project\hadoop-common\src\test\java\org\apache\hadoop\fs\TestListFiles.java,152,38,1,1,1,41
 hadoop-trunk\hadoop-trunk\hadoop-common-project\hadoop-common\src\test\java\org\apache\hadoop\net\TestTableMapping.java,152,16,4,2,0,22
 hadoop-trunk\hadoop-trunk\hadoop-yarn-project\hadoop-yarn\hadoop-yarn-server\hadoop-yarn-server-resourcemanager\src\test\java\org\apache\hadoop\yarn\server\resourcemanager\reservation\planning\TestReservationAgents.java,152,53,13,6,1,73
 hadoop-trunk\hadoop-trunk\hadoop-common-project\hadoop-common\src\test\java\org\apache\hadoop\fs\FCStatisticsBaseTest.java,152,45,4,4,5,58
 hadoop-trunk\hadoop-trunk\hadoop-common-project\hadoop-common\src\test\java\org\apache\hadoop\fs\contract\AbstractContractMkdirTest.java,152,14,0,2,0,16
 hadoop-trunk\hadoop-trunk\hadoop-hdfs-project\hadoop-hdfs\src\test\java\org\apache\hadoop\hdfs\server\namenode\ha\TestFailoverWithBlockTokensEnabled.java,152,48,2,6,1,57
 hadoop-trunk\hadoop-trunk\hadoop-common-project\hadoop-common\src\test\java\org\apache\hadoop\metrics2\lib\TestMutableRollingAverages.java,152,24,6,1,1,32
 hadoop-trunk\hadoop-trunk\hadoop-hdfs-project\hadoop-hdfs\src\test\java\org\apache\hadoop\hdfs\server\namenode\TestReencryptionHandler.java,152,21,30,2,3,56
 hadoop-trunk\hadoop-trunk\hadoop-hdfs-project\hadoop-hdfs-rbf\src\test\java\org\apache\hadoop\hdfs\server\federation\router\TestRouterFsck.java,152,14,2,9,1,26
 hadoop-trunk\hadoop-trunk\hadoop-yarn-project\hadoop-yarn\hadoop-yarn-common\src\main\java\org\apache\hadoop\yarn\api\records\impl\pb\QueueUserACLInfoPBImpl.java,152,40,51,1,0,92
 hadoop-trunk\hadoop-trunk\hadoop-yarn-project\hadoop-yarn\hadoop-yarn-server\hadoop-yarn-server-applicationhistoryservice\src\main\java\org\apache\hadoop\yarn\server\timeline\TimelineDataManagerMetrics.java,152,97,1,1,1,100
 hadoop-trunk\hadoop-trunk\hadoop-tools\hadoop-aws\src\main\java\org\apache\hadoop\fs\s3a\statistics\impl\ForwardingIOStatisticsStore.java,152,30,0,1,1,32
 hadoop-trunk\hadoop-trunk\hadoop-yarn-project\hadoop-yarn\hadoop-yarn-applications\hadoop-yarn-applications-catalog\hadoop-yarn-applications-catalog-webapp\src\main\java\org\apache\hadoop\yarn\appcatalog\application\YarnServiceClient.java,152,27,2,1,0,30
 hadoop-trunk\hadoop-trunk\hadoop-yarn-project\hadoop-yarn\hadoop-yarn-server\hadoop-yarn-server-resourcemanager\src\test\java\org\apache\hadoop\yarn\server\resourcemanager\scheduler\capacity\TestCapacitySchedulerQueueACLs.java,152,23,0,1,1,25
 hadoop-trunk\hadoop-trunk\hadoop-tools\hadoop-rumen\src\main\java\org\apache\hadoop\tools\rumen\AbstractClusterStory.java,152,59,5,1,27,92
 hadoop-trunk\hadoop-trunk\hadoop-common-project\hadoop-common\src\test\java\org\apache\hadoop\test\TestTimedOutTestsListener.java,152,61,7,1,14,83
 hadoop-trunk\hadoop-trunk\hadoop-yarn-project\hadoop-yarn\hadoop-yarn-server\hadoop-yarn-server-resourcemanager\src\test\java\org\apache\hadoop\yarn\server\resourcemanager\webapp\TestRMWebServicesHttpStaticUserPermissions.java,152,18,3,4,2,27
 kafka-trunk\kafka-trunk\clients\src\main\java\org\apache\kafka\common\config\SslConfigs.java,152,0,1,74,0,75
 kafka-trunk\kafka-trunk\connect\runtime\src\main\java\org\apache\kafka\connect\storage\MemoryConfigBackingStore.java,152,0,14,12,0,26
 kafka-trunk\kafka-trunk\clients\src\generated\java\org\apache\kafka\common\message\AlterPartitionReassignmentsResponseDataJsonConverter.java,152,0,0,38,0,38
 kafka-trunk\kafka-trunk\clients\src\main\java\org\apache\kafka\common\protocol\types\TaggedFields.java,152,0,3,10,1,14
 pulsar-master\pulsar-master\pulsar-proxy\src\test\java\org\apache\pulsar\proxy\server\ProxyKeyStoreTlsTestWithAuth.java,152,66,11,23,0,100
 pulsar-master\pulsar-master\pulsar-functions\instance\src\main\java\org\apache\pulsar\functions\source\PulsarSource.java,152,53,0,25,0,78
 pulsar-master\pulsar-master\pulsar-broker\src\test\java\org\apache\pulsar\broker\BrokerAdditionalServletTest.java,152,45,6,25,0,76
 pulsar-master\pulsar-master\pulsar-common\src\test\java\org\apache\pulsar\common\policies\impl\NamespaceIsolationPoliciesTest.java,152,34,1,27,0,62
 pulsar-master\pulsar-master\pulsar-proxy\src\test\java\org\apache\pulsar\proxy\server\ProxyStatsTest.java,152,34,5,28,0,67
 rocketmq-develop\rocketmq-develop\common\src\main\java\org\apache\rocketmq\common\subscription\SubscriptionGroupConfig.java,152,101,14,11,0,126
 rocketmq-develop\rocketmq-develop\common\src\main\java\org\apache\rocketmq\common\protocol\NamespaceUtil.java,152,58,2,25,0,85
 skywalking-master\skywalking-master\oap-server\server-query-plugin\query-graphql-plugin\src\main\java\org\apache\skywalking\oap\query\graphql\resolver\AlarmQuery.java,152,37,2,27,0,66
 zookeeper-master\zookeeper-master\zookeeper-server\src\test\java\org\apache\zookeeper\server\ZooKeeperServerTest.java,152,0,4,10,1,15
 dubbo-3.0\dubbo-3.0\dubbo-cluster\src\test\java\org\apache\dubbo\rpc\cluster\router\file\FileRouterEngineTest.java,153,65,6,19,0,90
 dubbo-3.0\dubbo-3.0\dubbo-test\dubbo-test-check\src\main\java\org\apache\dubbo\test\check\registrycenter\config\ZookeeperConfig.java,153,22,0,14,2,38
 dubbo-3.0\dubbo-3.0\dubbo-rpc\dubbo-rpc-triple\src\main\java\org\apache\dubbo\rpc\protocol\tri\call\ReflectionAbstractServerCall.java,153,32,2,12,0,46
 dubbo-3.0\dubbo-3.0\dubbo-remoting\dubbo-remoting-zookeeper-curator5\src\test\java\org\apache\dubbo\remoting\zookeeper\curator5\support\AbstractZookeeperTransporterTest.java,153,77,2,56,0,135
 dubbo-3.0\dubbo-3.0\dubbo-remoting\dubbo-remoting-api\src\main\java\org\apache\dubbo\remoting\zookeeper\AbstractZookeeperTransporter.java,153,42,6,23,2,73
 hadoop-trunk\hadoop-trunk\hadoop-common-project\hadoop-common\src\main\java\org\apache\hadoop\metrics2\sink\PrometheusMetricsSink.java,153,27,7,4,3,41
 hadoop-trunk\hadoop-trunk\hadoop-common-project\hadoop-common\src\test\java\org\apache\hadoop\io\TestSortedMapWritable.java,153,38,12,13,5,68
 hadoop-trunk\hadoop-trunk\hadoop-hdfs-project\hadoop-hdfs\src\main\java\org\apache\hadoop\hdfs\server\datanode\SecureDataNodeStarter.java,153,47,3,2,5,57
 hadoop-trunk\hadoop-trunk\hadoop-yarn-project\hadoop-yarn\hadoop-yarn-server\hadoop-yarn-server-resourcemanager\src\test\java\org\apache\hadoop\yarn\server\resourcemanager\placement\csmappingrule\TestMappingRuleActions.java,153,18,2,1,1,22
 hadoop-trunk\hadoop-trunk\hadoop-common-project\hadoop-common\src\main\java\org\apache\hadoop\io\erasurecode\rawcoder\RawErasureEncoder.java,153,16,0,1,0,17
 hadoop-trunk\hadoop-trunk\hadoop-hdfs-project\hadoop-hdfs\src\test\java\org\apache\hadoop\hdfs\server\namenode\snapshot\TestSnapshotManager.java,153,16,0,1,2,19
 hadoop-trunk\hadoop-trunk\hadoop-mapreduce-project\hadoop-mapreduce-client\hadoop-mapreduce-client-jobclient\src\test\java\org\apache\hadoop\mapred\TestJavaSerialization.java,153,29,6,2,2,39
 hadoop-trunk\hadoop-trunk\hadoop-hdfs-project\hadoop-hdfs\src\test\java\org\apache\hadoop\hdfs\server\namenode\TestFSNamesystemLockReport.java,153,33,0,5,5,43
 hadoop-trunk\hadoop-trunk\hadoop-common-project\hadoop-common\src\test\java\org\apache\hadoop\fs\contract\AbstractContractEtagTest.java,153,8,2,8,0,18
 hadoop-trunk\hadoop-trunk\hadoop-common-project\hadoop-common\src\test\java\org\apache\hadoop\io\TestSequenceFileSync.java,153,39,0,1,0,40
 hadoop-trunk\hadoop-trunk\hadoop-yarn-project\hadoop-yarn\hadoop-yarn-server\hadoop-yarn-server-resourcemanager\src\main\java\org\apache\hadoop\yarn\server\resourcemanager\webapp\dao\CapacitySchedulerLeafQueueInfo.java,153,85,1,7,3,96
 hadoop-trunk\hadoop-trunk\hadoop-common-project\hadoop-common\src\test\java\org\apache\hadoop\io\TestUTF8.java,153,44,0,1,0,45
 hadoop-trunk\hadoop-trunk\hadoop-common-project\hadoop-common\src\test\java\org\apache\hadoop\util\TestIntrusiveCollection.java,153,16,4,1,0,21
 hadoop-trunk\hadoop-trunk\hadoop-hdfs-project\hadoop-hdfs\src\main\java\org\apache\hadoop\hdfs\tools\offlineImageViewer\PBImageDelimitedTextWriter.java,153,44,14,5,1,64
 hadoop-trunk\hadoop-trunk\hadoop-mapreduce-project\hadoop-mapreduce-client\hadoop-mapreduce-client-app\src\main\java\org\apache\hadoop\mapreduce\v2\app\webapp\JobBlock.java,153,21,0,11,0,32
 hadoop-trunk\hadoop-trunk\hadoop-common-project\hadoop-common\src\test\java\org\apache\hadoop\fs\shell\find\TestResult.java,153,21,7,1,1,30
 hadoop-trunk\hadoop-trunk\hadoop-yarn-project\hadoop-yarn\hadoop-yarn-server\hadoop-yarn-server-resourcemanager\src\test\java\org\apache\hadoop\yarn\server\resourcemanager\resource\TestResourceProfiles.java,153,36,3,2,0,41
 kafka-trunk\kafka-trunk\clients\src\main\java\org\apache\kafka\common\internals\PartitionStates.java,153,0,7,18,1,26
 kafka-trunk\kafka-trunk\streams\src\test\java\org\apache\kafka\streams\integration\ConsistencyVectorIntegrationTest.java,153,0,1,29,1,31
 pulsar-master\pulsar-master\tiered-storage\jcloud\src\test\java\org\apache\bookkeeper\mledger\offload\jcloud\impl\BufferedOffloadStreamTest.java,153,31,10,10,0,51
 pulsar-master\pulsar-master\pulsar-functions\runtime\src\test\java\org\apache\pulsar\functions\auth\KubernetesSecretsTokenAuthProviderTest.java,153,64,0,55,0,119
 rocketmq-develop\rocketmq-develop\tools\src\main\java\org\apache\rocketmq\tools\command\acl\UpdateAccessConfigSubCommand.java,153,33,0,26,3,62
 skywalking-master\skywalking-master\oap-server\server-storage-plugin\storage-jdbc-hikaricp-plugin\src\main\java\org\apache\skywalking\oap\server\storage\plugin\jdbc\h2\dao\H2LogQueryDAO.java,153,41,2,28,0,71
 skywalking-master\skywalking-master\oap-server\server-storage-plugin\storage-elasticsearch-plugin\src\test\java\org\apache\skywalking\oap\server\storage\plugin\elasticsearch\base\AnalyzerSettingTest.java,153,13,21,10,0,44
 zookeeper-master\zookeeper-master\zookeeper-server\src\test\java\org\apache\zookeeper\test\EmptiedSnapshotRecoveryTest.java,153,0,7,23,1,31
 dubbo-3.0\dubbo-3.0\dubbo-common\src\main\java\org\apache\dubbo\common\threadpool\ThreadlessExecutor.java,154,50,2,16,2,70
 dubbo-3.0\dubbo-3.0\dubbo-remoting\dubbo-remoting-zookeeper\src\test\java\org\apache\dubbo\remoting\zookeeper\curator\support\AbstractZookeeperTransporterTest.java,154,78,2,55,0,135
 hadoop-trunk\hadoop-trunk\hadoop-yarn-project\hadoop-yarn\hadoop-yarn-server\hadoop-yarn-server-applicationhistoryservice\src\main\java\org\apache\hadoop\yarn\server\timeline\recovery\TimelineStateStore.java,154,20,0,1,2,23
 hadoop-trunk\hadoop-trunk\hadoop-hdfs-project\hadoop-hdfs\src\main\java\org\apache\hadoop\hdfs\util\EnumCounters.java,154,40,1,1,0,42
 hadoop-trunk\hadoop-trunk\hadoop-mapreduce-project\hadoop-mapreduce-client\hadoop-mapreduce-client-core\src\main\java\org\apache\hadoop\mapreduce\lib\input\CombineFileSplit.java,154,106,2,1,4,113
 hadoop-trunk\hadoop-trunk\hadoop-hdfs-project\hadoop-hdfs\src\main\java\org\apache\hadoop\hdfs\server\blockmanagement\BlockStoragePolicySuite.java,154,30,1,1,1,33
 hadoop-trunk\hadoop-trunk\hadoop-yarn-project\hadoop-yarn\hadoop-yarn-common\src\main\java\org\apache\hadoop\yarn\api\impl\pb\service\ApplicationHistoryProtocolPBServiceImpl.java,154,31,55,39,0,125
 hadoop-trunk\hadoop-trunk\hadoop-mapreduce-project\hadoop-mapreduce-client\hadoop-mapreduce-client-app\src\test\java\org\apache\hadoop\mapred\TestLocalContainerLauncher.java,154,28,3,2,6,39
 hadoop-trunk\hadoop-trunk\hadoop-hdfs-project\hadoop-hdfs\src\main\java\org\apache\hadoop\hdfs\server\namenode\EditsDoubleBuffer.java,154,52,3,2,1,58
 hadoop-trunk\hadoop-trunk\hadoop-yarn-project\hadoop-yarn\hadoop-yarn-client\src\test\java\org\apache\hadoop\yarn\client\api\impl\BaseAMRMClientTest.java,154,54,0,3,0,57
 hadoop-trunk\hadoop-trunk\hadoop-yarn-project\hadoop-yarn\hadoop-yarn-server\hadoop-yarn-server-common\src\main\java\org\apache\hadoop\yarn\server\api\protocolrecords\impl\pb\DistributedSchedulingAllocateResponsePBImpl.java,154,24,43,4,0,71
 hadoop-trunk\hadoop-trunk\hadoop-tools\hadoop-aws\src\test\java\org\apache\hadoop\fs\s3a\commit\ITestS3ACommitterFactory.java,154,12,7,1,0,20
 hadoop-trunk\hadoop-trunk\hadoop-mapreduce-project\hadoop-mapreduce-client\hadoop-mapreduce-client-app\src\main\java\org\apache\hadoop\mapreduce\v2\app\metrics\MRAppMetrics.java,154,101,9,1,0,111
 hadoop-trunk\hadoop-trunk\hadoop-mapreduce-project\hadoop-mapreduce-client\hadoop-mapreduce-client-core\src\main\java\org\apache\hadoop\mapreduce\security\SpillCallBackPathsFinder.java,154,22,0,1,0,23
 kafka-trunk\kafka-trunk\metadata\src\generated\java\org\apache\kafka\common\metadata\RemoveFeatureLevelRecord.java,154,0,0,10,3,13
 kafka-trunk\kafka-trunk\clients\src\main\java\org\apache\kafka\common\security\oauthbearer\secured\ClaimValidationUtils.java,154,0,9,28,0,37
 kafka-trunk\kafka-trunk\clients\src\main\java\org\apache\kafka\clients\admin\internals\CoordinatorStrategy.java,154,0,5,23,1,29
 kafka-trunk\kafka-trunk\streams\src\test\java\org\apache\kafka\streams\kstream\internals\KStreamKTableLeftJoinTest.java,154,0,2,24,2,28
 kafka-trunk\kafka-trunk\clients\src\main\java\org\apache\kafka\common\security\plain\internals\PlainSaslServer.java,154,0,13,28,0,41
 pulsar-master\pulsar-master\pulsar-client-admin\src\main\java\org\apache\pulsar\client\admin\internal\PulsarAdminBuilderImpl.java,154,85,3,20,0,108
 pulsar-master\pulsar-master\pulsar-broker\src\main\java\org\apache\pulsar\PulsarClusterMetadataTeardown.java,154,52,2,31,0,85
 pulsar-master\pulsar-master\pulsar-testclient\src\test\java\org\apache\pulsar\testclient\PerformanceProducerTest.java,154,34,2,16,0,52
 rocketmq-develop\rocketmq-develop\store\src\main\java\org\apache\rocketmq\store\DispatchRequest.java,154,79,0,2,4,85
 skywalking-master\skywalking-master\oap-server\server-alarm-plugin\src\test\java\org\apache\skywalking\oap\server\core\alarm\provider\AlarmRulesWatcherTest.java,154,53,5,41,0,99
zookeeper-master\zookeeper-master\zookeeper-server\src\main\java\org\apache\zookeeper\cli\DelQuotaCommand.java,154,0,9,2,2,13
 dubbo-3.0\dubbo-3.0\dubbo-compatible\src\test\java\org\apache\dubbo\config\ProviderConfigTest.java,155,35,0,1,0,36
 hadoop-trunk\hadoop-trunk\hadoop-mapreduce-project\hadoop-mapreduce-client\hadoop-mapreduce-client-hs\src\test\java\org\apache\hadoop\mapreduce\v2\hs\TestJobHistoryServer.java,155,37,3,10,0,50
 hadoop-trunk\hadoop-trunk\hadoop-hdfs-project\hadoop-hdfs-rbf\src\main\java\org\apache\hadoop\hdfs\server\federation\store\records\RouterState.java,155,40,4,2,0,46
 hadoop-trunk\hadoop-trunk\hadoop-common-project\hadoop-nfs\src\main\java\org\apache\hadoop\nfs\nfs3\FileHandle.java,155,83,2,1,0,86
 hadoop-trunk\hadoop-trunk\hadoop-hdfs-project\hadoop-hdfs\src\test\java\org\apache\hadoop\hdfs\server\namenode\TestNNThroughputBenchmark.java,155,21,0,1,0,22
 hadoop-trunk\hadoop-trunk\hadoop-yarn-project\hadoop-yarn\hadoop-yarn-client\src\test\java\org\apache\hadoop\yarn\client\TestResourceManagerAdministrationProtocolPBClientImpl.java,155,18,5,17,1,41
 hadoop-trunk\hadoop-trunk\hadoop-yarn-project\hadoop-yarn\hadoop-yarn-server\hadoop-yarn-server-resourcemanager\src\test\java\org\apache\hadoop\yarn\server\resourcemanager\scheduler\fair\converter\TestFSConfigToCSConfigRuleHandler.java,155,14,1,10,0,25
 hadoop-trunk\hadoop-trunk\hadoop-common-project\hadoop-common\src\main\java\org\apache\hadoop\metrics2\lib\MutableStat.java,155,83,1,1,2,87
 hadoop-trunk\hadoop-trunk\hadoop-tools\hadoop-azure\src\test\java\org\apache\hadoop\fs\azure\ITestOutOfBandAzureBlobOperationsLive.java,155,24,9,6,0,39
 hadoop-trunk\hadoop-trunk\hadoop-hdfs-project\hadoop-hdfs\src\main\java\org\apache\hadoop\hdfs\server\datanode\fsdataset\impl\MappableBlockLoader.java,155,23,0,1,0,24
 hadoop-trunk\hadoop-trunk\hadoop-yarn-project\hadoop-yarn\hadoop-yarn-server\hadoop-yarn-server-resourcemanager\src\test\java\org\apache\hadoop\yarn\server\resourcemanager\scheduler\capacity\TestAutoCreatedQueueTemplate.java,155,37,0,2,0,39
 hadoop-trunk\hadoop-trunk\hadoop-yarn-project\hadoop-yarn\hadoop-yarn-server\hadoop-yarn-server-common\src\main\java\org\apache\hadoop\yarn\server\federation\policies\manager\AbstractPolicyManager.java,155,26,5,8,0,39
 hadoop-trunk\hadoop-trunk\hadoop-tools\hadoop-gridmix\src\test\java\org\apache\hadoop\mapred\gridmix\TestHighRamJob.java,155,128,1,1,5,135
 hadoop-trunk\hadoop-trunk\hadoop-hdfs-project\hadoop-hdfs\src\test\java\org\apache\hadoop\hdfs\server\blockmanagement\TestSequentialBlockId.java,155,22,14,1,4,41
 hadoop-trunk\hadoop-trunk\hadoop-yarn-project\hadoop-yarn\hadoop-yarn-server\hadoop-yarn-server-common\src\test\java\org\apache\hadoop\yarn\server\federation\resolver\TestDefaultSubClusterResolver.java,155,9,0,1,4,14
 hadoop-trunk\hadoop-trunk\hadoop-mapreduce-project\hadoop-mapreduce-client\hadoop-mapreduce-client-jobclient\src\test\java\org\apache\hadoop\mapred\TestOldCombinerGrouping.java,155,29,7,1,4,41
 kafka-trunk\kafka-trunk\streams\src\test\java\org\apache\kafka\streams\state\internals\WindowStoreBuilderTest.java,155,0,0,17,2,19
 kafka-trunk\kafka-trunk\streams\src\test\java\org\apache\kafka\streams\state\internals\MergedSortedCacheWrappedWindowStoreKeyValueIteratorTest.java,155,0,2,31,4,37
 kafka-trunk\kafka-trunk\core\src\main\java\kafka\server\builders\KafkaApisBuilder.java,155,0,14,18,7,39
 kafka-trunk\kafka-trunk\clients\src\main\java\org\apache\kafka\common\security\scram\internals\ScramFormatter.java,155,0,3,27,0,30
 pulsar-master\pulsar-master\pulsar-broker\src\test\java\org\apache\pulsar\broker\admin\AdminApiSchemaValidationEnforced.java,155,44,1,33,0,78
 pulsar-master\pulsar-master\pulsar-config-validation\src\main\java\org\apache\pulsar\config\validation\ConfigValidationUtils.java,155,37,1,19,0,57
 pulsar-master\pulsar-master\pulsar-proxy\src\test\java\org\apache\pulsar\proxy\server\ProxyWithoutServiceDiscoveryTest.java,155,45,6,25,0,76
 pulsar-master\pulsar-master\pulsar-broker\src\test\java\org\apache\pulsar\broker\auth\PortForwarder.java,155,43,1,14,0,58
 rocketmq-develop\rocketmq-develop\broker\src\main\java\org\apache\rocketmq\broker\client\ConsumerManager.java,155,60,3,31,0,94
 rocketmq-develop\rocketmq-develop\namesrv\src\test\java\org\apache\rocketmq\namesrv\routeinfo\RouteInfoManagerTestBase.java,155,91,0,29,2,122
 skywalking-master\skywalking-master\oap-server\server-core\src\main\java\org\apache\skywalking\oap\server\core\config\group\openapi\EndpointGroupingRuleReader4Openapi.java,155,55,2,28,0,85
 dubbo-3.0\dubbo-3.0\dubbo-common\src\main\java\org\apache\dubbo\config\ConsumerConfig.java,156,70,2,8,0,80
 dubbo-3.0\dubbo-3.0\dubbo-registry\dubbo-registry-zookeeper\src\test\java\org\apache\dubbo\registry\zookeeper\ZookeeperRegistryTest.java,156,34,0,9,0,43
 dubbo-3.0\dubbo-3.0\dubbo-common\src\main\java\org\apache\dubbo\common\url\component\PathURLAddress.java,156,83,2,11,0,96
 hadoop-trunk\hadoop-trunk\hadoop-common-project\hadoop-common\src\test\java\org\apache\hadoop\io\TestGenericWritable.java,156,62,8,4,3,77
 hadoop-trunk\hadoop-trunk\hadoop-tools\hadoop-sls\src\main\java\org\apache\hadoop\yarn\sls\scheduler\TaskRunner.java,156,66,6,1,0,73
 hadoop-trunk\hadoop-trunk\hadoop-mapreduce-project\hadoop-mapreduce-client\hadoop-mapreduce-client-core\src\main\java\org\apache\hadoop\mapred\lib\aggregate\ValueAggregatorJob.java,156,67,3,5,2,77
 hadoop-trunk\hadoop-trunk\hadoop-tools\hadoop-aws\src\test\java\org\apache\hadoop\fs\s3a\scale\ITestS3AMultipartUploadSizeLimits.java,156,10,0,8,0,18
 hadoop-trunk\hadoop-trunk\hadoop-mapreduce-project\hadoop-mapreduce-client\hadoop-mapreduce-client-core\src\main\java\org\apache\hadoop\mapred\jobcontrol\Job.java,156,39,3,2,0,44
 hadoop-trunk\hadoop-trunk\hadoop-hdfs-project\hadoop-hdfs\src\main\java\org\apache\hadoop\hdfs\server\protocol\NamespaceInfo.java,156,116,2,1,0,119
 hadoop-trunk\hadoop-trunk\hadoop-hdfs-project\hadoop-hdfs\src\test\java\org\apache\hadoop\hdfs\server\datanode\fsdataset\impl\TestLazyPersistLockedMemory.java,156,14,12,2,0,28
 hadoop-trunk\hadoop-trunk\hadoop-yarn-project\hadoop-yarn\hadoop-yarn-server\hadoop-yarn-server-resourcemanager\src\main\java\org\apache\hadoop\yarn\server\resourcemanager\scheduler\capacity\conf\YarnConfigurationStore.java,156,10,1,2,1,14
 hadoop-trunk\hadoop-trunk\hadoop-common-project\hadoop-common\src\main\java\org\apache\hadoop\util\MachineList.java,156,35,8,3,1,47
 hadoop-trunk\hadoop-trunk\hadoop-mapreduce-project\hadoop-mapreduce-client\hadoop-mapreduce-client-core\src\main\java\org\apache\hadoop\mapreduce\jobhistory\AMStartedEvent.java,156,41,23,1,0,65
 hadoop-trunk\hadoop-trunk\hadoop-mapreduce-project\hadoop-mapreduce-client\hadoop-mapreduce-client-nativetask\src\main\java\org\apache\hadoop\mapred\nativetask\NativeRuntime.java,156,63,15,5,0,83
 hadoop-trunk\hadoop-trunk\hadoop-hdfs-project\hadoop-hdfs\src\test\java\org\apache\hadoop\hdfs\qjournal\MiniQJMHACluster.java,156,56,2,8,4,70
 hadoop-trunk\hadoop-trunk\hadoop-yarn-project\hadoop-yarn\hadoop-yarn-server\hadoop-yarn-server-common\src\test\java\org\apache\hadoop\yarn\server\api\protocolrecords\TestProtocolRecords.java,156,30,14,5,0,49
 hadoop-trunk\hadoop-trunk\hadoop-hdfs-project\hadoop-hdfs\src\main\java\org\apache\hadoop\hdfs\server\sps\ExternalSPSBlockMoveTaskHandler.java,156,29,6,2,2,39
 hadoop-trunk\hadoop-trunk\hadoop-common-project\hadoop-common\src\main\java\org\apache\hadoop\service\CompositeService.java,156,24,2,1,1,28
 hadoop-trunk\hadoop-trunk\hadoop-mapreduce-project\hadoop-mapreduce-client\hadoop-mapreduce-client-jobclient\src\test\java\org\apache\hadoop\mapreduce\lib\input\TestMRSequenceFileInputFilter.java,156,53,8,4,0,65
 hadoop-trunk\hadoop-trunk\hadoop-yarn-project\hadoop-yarn\hadoop-yarn-applications\hadoop-yarn-applications-catalog\hadoop-yarn-applications-catalog-webapp\src\main\java\org\apache\hadoop\yarn\appcatalog\controller\AppStoreController.java,156,11,2,2,0,15
 kafka-trunk\kafka-trunk\clients\src\generated\java\org\apache\kafka\common\message\ListOffsetsRequestDataJsonConverter.java,156,0,0,35,0,35
 kafka-trunk\kafka-trunk\clients\src\test\java\org\apache\kafka\common\security\auth\DefaultKafkaPrincipalBuilderTest.java,156,0,0,28,3,31
 kafka-trunk\kafka-trunk\clients\src\generated\java\org\apache\kafka\common\message\ProduceRequestDataJsonConverter.java,156,0,0,32,0,32
 LittleBooks-master\LittleBooks-master\app\src\main\java\com\example\littlebooks\Register.java,156,64,5,17,0,86
 pulsar-master\pulsar-master\pulsar-broker\src\test\java\org\apache\pulsar\broker\service\PrecisTopicPublishRateThrottleTest.java,156,57,6,30,0,93
 pulsar-master\pulsar-master\pulsar-broker\src\main\java\org\apache\pulsar\broker\intercept\ManagedLedgerInterceptorImpl.java,156,66,3,36,0,105
 rocketmq-develop\rocketmq-develop\common\src\main\java\org\apache\rocketmq\common\filter\impl\PolishExpr.java,156,45,8,14,0,67
 rocketmq-develop\rocketmq-develop\tools\src\main\java\org\apache\rocketmq\tools\command\message\QueryMsgByUniqueKeySubCommand.java,156,41,1,25,3,70
 rocketmq-develop\rocketmq-develop\common\src\main\java\org\apache\rocketmq\common\protocol\heartbeat\SubscriptionData.java,156,91,16,5,4,116
 skywalking-master\skywalking-master\oap-server\analyzer\meter-analyzer\src\test\java\org\apache\skywalking\oap\meter\analyzer\dsl\AggregationTest.java,156,109,13,48,0,170
 dubbo-3.0\dubbo-3.0\dubbo-spring-boot\dubbo-spring-boot-compatible\actuator\src\test\java\org\apache\dubbo\spring\boot\actuate\autoconfigure\DubboEndpointAutoConfigurationTest.java,157,40,3,26,0,69
 dubbo-3.0\dubbo-3.0\dubbo-common\src\main\java\org\apache\dubbo\common\utils\LogHelper.java,157,51,1,1,0,53
 dubbo-3.0\dubbo-3.0\dubbo-registry\dubbo-registry-api\src\main\java\org\apache\dubbo\registry\support\RegistryManager.java,157,46,10,7,0,63
 hadoop-trunk\hadoop-trunk\hadoop-hdfs-project\hadoop-hdfs\src\test\java\org\apache\hadoop\hdfs\server\datanode\TestDnRespectsBlockReportSplitThreshold.java,157,35,3,5,3,46
 hadoop-trunk\hadoop-trunk\hadoop-tools\hadoop-federation-balance\src\main\java\org\apache\hadoop\tools\fedbalance\procedure\BalanceJournalInfoHDFS.java,157,20,11,2,2,35
 hadoop-trunk\hadoop-trunk\hadoop-tools\hadoop-azure\src\test\java\org\apache\hadoop\fs\azurebfs\ITestWasbAbfsCompatibility.java,157,25,1,7,5,38
 hadoop-trunk\hadoop-trunk\hadoop-hdfs-project\hadoop-hdfs-nfs\src\test\java\org\apache\hadoop\hdfs\nfs\nfs3\TestReaddir.java,157,40,12,1,0,53
 hadoop-trunk\hadoop-trunk\hadoop-yarn-project\hadoop-yarn\hadoop-yarn-common\src\test\java\org\apache\hadoop\yarn\client\TestClientRMProxy.java,157,9,9,1,2,21
 hadoop-trunk\hadoop-trunk\hadoop-maven-plugins\src\main\java\org\apache\hadoop\maven\plugin\util\Exec.java,157,21,2,3,1,27
 hadoop-trunk\hadoop-trunk\hadoop-hdfs-project\hadoop-hdfs\src\test\java\org\apache\hadoop\hdfs\server\datanode\TestDeleteBlockPool.java,157,35,1,2,0,38
 hadoop-trunk\hadoop-trunk\hadoop-mapreduce-project\hadoop-mapreduce-client\hadoop-mapreduce-client-jobclient\src\test\java\org\apache\hadoop\mapred\TestLazyOutput.java,157,54,20,1,3,78
 hadoop-trunk\hadoop-trunk\hadoop-yarn-project\hadoop-yarn\hadoop-yarn-api\src\main\java\org\apache\hadoop\yarn\api\records\timelineservice\FlowActivityEntity.java,157,55,2,1,1,59
 hadoop-trunk\hadoop-trunk\hadoop-yarn-project\hadoop-yarn\hadoop-yarn-server\hadoop-yarn-server-nodemanager\src\main\java\org\apache\hadoop\yarn\server\nodemanager\containermanager\linux\resources\gpu\GpuResourceHandlerImpl.java,157,38,6,17,5,66
 hadoop-trunk\hadoop-trunk\hadoop-mapreduce-project\hadoop-mapreduce-client\hadoop-mapreduce-client-app\src\main\java\org\apache\hadoop\mapred\MapReduceChildJVM.java,157,26,3,3,0,32
 hadoop-trunk\hadoop-trunk\hadoop-common-project\hadoop-common\src\main\java\org\apache\hadoop\ha\NodeFencer.java,157,52,8,3,0,63
 hadoop-trunk\hadoop-trunk\hadoop-hdfs-project\hadoop-hdfs\src\test\java\org\apache\hadoop\hdfs\TestListFilesInFileContext.java,157,40,0,1,1,42
 hadoop-trunk\hadoop-trunk\hadoop-hdfs-project\hadoop-hdfs\src\test\java\org\apache\hadoop\hdfs\TestViewDistributedFileSystem.java,157,15,7,3,0,25
 hadoop-trunk\hadoop-trunk\hadoop-mapreduce-project\hadoop-mapreduce-client\hadoop-mapreduce-client-common\src\test\java\org\apache\hadoop\mapreduce\v2\TestRPCFactories.java,157,47,2,19,7,75
 hadoop-trunk\hadoop-trunk\hadoop-tools\hadoop-aws\src\test\java\org\apache\hadoop\fs\s3a\ITestS3AUnbuffer.java,157,15,0,4,0,19
 hadoop-trunk\hadoop-trunk\hadoop-tools\hadoop-sls\src\main\java\org\apache\hadoop\yarn\sls\AMDefinitionSLS.java,157,37,3,3,2,45
 hadoop-trunk\hadoop-trunk\hadoop-common-project\hadoop-auth-examples\src\main\java\org\apache\hadoop\security\authentication\examples\RequestLoggerFilter.java,157,41,5,8,0,54
 hadoop-trunk\hadoop-trunk\hadoop-tools\hadoop-distcp\src\test\java\org\apache\hadoop\tools\TestExternalCall.java,157,26,7,4,4,41
 hadoop-trunk\hadoop-trunk\hadoop-yarn-project\hadoop-yarn\hadoop-yarn-server\hadoop-yarn-server-resourcemanager\src\test\java\org\apache\hadoop\yarn\server\resourcemanager\TestApplicationMasterServiceCapacity.java,157,25,0,7,1,33
 kafka-trunk\kafka-trunk\clients\src\main\java\org\apache\kafka\clients\consumer\internals\FetcherMetricsRegistry.java,157,0,0,34,0,34
 kafka-trunk\kafka-trunk\jmh-benchmarks\src\main\java\org\apache\kafka\jmh\server\PartitionCreationBench.java,157,0,9,20,1,30
 kafka-trunk\kafka-trunk\connect\runtime\src\main\java\org\apache\kafka\connect\runtime\StateTracker.java,157,0,2,19,0,21
 kafka-trunk\kafka-trunk\connect\runtime\src\test\java\org\apache\kafka\connect\runtime\WorkerTestUtils.java,157,0,0,29,0,29
 kafka-trunk\kafka-trunk\streams\src\main\java\org\apache\kafka\streams\processor\TaskId.java,157,0,1,26,1,28
 kafka-trunk\kafka-trunk\connect\runtime\src\test\java\org\apache\kafka\connect\runtime\rest\resources\LoggingResourceTest.java,157,0,0,10,9,19
 pulsar-master\pulsar-master\pulsar-broker\src\test\java\org\apache\pulsar\broker\service\BatchMessageWithBatchIndexLevelTest.java,157,34,1,16,0,51
 pulsar-master\pulsar-master\pulsar-client\src\main\java\org\apache\pulsar\client\impl\ConsumerInterceptors.java,157,68,8,46,0,122
 pulsar-master\pulsar-master\pulsar-client\src\main\java\org\apache\pulsar\client\impl\HttpLookupService.java,157,57,3,29,0,89
 pulsar-master\pulsar-master\pulsar-functions\instance\src\main\java\org\apache\pulsar\functions\instance\state\BKStateStoreImpl.java,157,57,4,13,0,74
 pulsar-master\pulsar-master\pulsar-websocket\src\main\java\org\apache\pulsar\websocket\service\WebSocketProxyConfiguration.java,157,82,1,28,0,111
 pulsar-master\pulsar-master\pulsar-sql\presto-pulsar\src\main\java\org\apache\pulsar\sql\presto\PulsarConnectorCache.java,157,65,8,37,0,110
 pulsar-master\pulsar-master\tests\integration\src\test\java\org\apache\pulsar\tests\integration\topologies\PulsarTestBase.java,157,42,0,14,0,56
 pulsar-master\pulsar-master\pulsar-proxy\src\main\java\org\apache\pulsar\proxy\server\ParserProxyHandler.java,157,55,3,23,0,81
 rocketmq-develop\rocketmq-develop\client\src\main\java\org\apache\rocketmq\client\trace\TraceView.java,157,98,0,4,1,103
 rocketmq-develop\rocketmq-develop\test\src\test\java\org\apache\rocketmq\test\base\IntegrationTestBase.java,157,65,6,23,9,103
 skywalking-master\skywalking-master\oap-server\server-storage-plugin\storage-elasticsearch-plugin\src\main\java\org\apache\skywalking\oap\server\storage\plugin\elasticsearch\StorageModuleElasticsearchProvider.java,157,47,3,66,0,116
 zookeeper-master\zookeeper-master\zookeeper-server\src\test\java\org\apache\zookeeper\test\ZkDatabaseCorruptionTest.java,157,0,7,8,4,19
 dubbo-3.0\dubbo-3.0\dubbo-remoting\dubbo-remoting-zookeeper\src\test\java\org\apache\dubbo\remoting\zookeeper\curator\CuratorZookeeperClientTest.java,158,38,2,10,0,50
 hadoop-trunk\hadoop-trunk\hadoop-hdfs-project\hadoop-hdfs\src\test\java\org\apache\hadoop\hdfs\server\namenode\TestGetContentSummaryWithPermission.java,158,32,1,1,0,34
 hadoop-trunk\hadoop-trunk\hadoop-tools\hadoop-azure\src\main\java\org\apache\hadoop\fs\azure\WasbFsck.java,158,22,2,3,2,29
 hadoop-trunk\hadoop-trunk\hadoop-yarn-project\hadoop-yarn\hadoop-yarn-applications\hadoop-yarn-services\hadoop-yarn-services-core\src\main\java\org\apache\hadoop\yarn\service\utils\ClientRegistryBinder.java,158,26,2,6,1,35
 hadoop-trunk\hadoop-trunk\hadoop-hdfs-project\hadoop-hdfs-client\src\main\java\org\apache\hadoop\hdfs\protocol\datatransfer\ReplaceDatanodeOnFailure.java,158,48,0,6,0,54
 hadoop-trunk\hadoop-trunk\hadoop-mapreduce-project\hadoop-mapreduce-client\hadoop-mapreduce-client-app\src\main\java\org\apache\hadoop\mapreduce\v2\app\speculate\SimpleExponentialTaskRuntimeEstimator.java,158,6,1,3,0,10
 hadoop-trunk\hadoop-trunk\hadoop-hdfs-project\hadoop-hdfs\src\test\java\org\apache\hadoop\hdfs\server\namenode\ha\TestBootstrapStandbyWithQJM.java,158,22,3,2,0,27
 hadoop-trunk\hadoop-trunk\hadoop-common-project\hadoop-common\src\main\java\org\apache\hadoop\fs\GlobExpander.java,158,24,7,2,0,33
 hadoop-trunk\hadoop-trunk\hadoop-hdfs-project\hadoop-hdfs\src\main\java\org\apache\hadoop\hdfs\server\namenode\InotifyFSEditLogOpTranslator.java,158,15,1,1,17,34
 hadoop-trunk\hadoop-trunk\hadoop-common-project\hadoop-common\src\main\java\org\apache\hadoop\io\erasurecode\rawcoder\DecodingValidator.java,158,21,0,1,0,22
 hadoop-trunk\hadoop-trunk\hadoop-common-project\hadoop-registry\src\test\java\org\apache\hadoop\registry\client\binding\TestRegistryPathUtils.java,158,33,6,1,0,40
 hadoop-trunk\hadoop-trunk\hadoop-common-project\hadoop-common\src\main\java\org\apache\hadoop\security\authorize\DefaultImpersonationProvider.java,158,58,1,4,3,66
 hadoop-trunk\hadoop-trunk\hadoop-yarn-project\hadoop-yarn\hadoop-yarn-server\hadoop-yarn-server-resourcemanager\src\main\java\org\apache\hadoop\yarn\server\resourcemanager\webapp\SchedulerPageUtil.java,158,22,0,19,0,41
 hadoop-trunk\hadoop-trunk\hadoop-common-project\hadoop-common\src\main\java\org\apache\hadoop\util\bloom\BloomFilter.java,158,96,0,14,0,110
 hadoop-trunk\hadoop-trunk\hadoop-yarn-project\hadoop-yarn\hadoop-yarn-server\hadoop-yarn-server-nodemanager\src\main\java\org\apache\hadoop\yarn\server\nodemanager\containermanager\linux\privileged\PrivilegedOperation.java,158,93,0,2,0,95
 hadoop-trunk\hadoop-trunk\hadoop-yarn-project\hadoop-yarn\hadoop-yarn-common\src\main\java\org\apache\hadoop\yarn\api\records\impl\pb\UpdateContainerRequestPBImpl.java,158,26,47,1,0,74
 hadoop-trunk\hadoop-trunk\hadoop-hdfs-project\hadoop-hdfs\src\main\java\org\apache\hadoop\hdfs\server\sps\ExternalSPSContext.java,158,36,3,4,2,45
 hadoop-trunk\hadoop-trunk\hadoop-common-project\hadoop-auth\src\main\java\org\apache\hadoop\security\authentication\server\PseudoAuthenticationHandler.java,158,27,2,14,0,43
 hadoop-trunk\hadoop-trunk\hadoop-mapreduce-project\hadoop-mapreduce-client\hadoop-mapreduce-client-app\src\main\java\org\apache\hadoop\mapreduce\v2\app\speculate\ExponentiallySmoothedTaskRuntimeEstimator.java,158,48,0,6,0,54
 kafka-trunk\kafka-trunk\clients\src\generated\java\org\apache\kafka\common\message\AlterPartitionRequestDataJsonConverter.java,158,0,0,38,0,38
 kafka-trunk\kafka-trunk\clients\src\main\java\org\apache\kafka\common\utils\Timer.java,158,0,4,35,1,40
 pulsar-master\pulsar-master\pulsar-package-management\core\src\test\java\org\apache\pulsar\packages\management\core\impl\PackagesManagementImplTest.java,158,27,0,22,0,49
 pulsar-master\pulsar-master\pulsar-io\file\src\main\java\org\apache\pulsar\io\file\FileListingThread.java,158,43,2,22,0,67
 pulsar-master\pulsar-master\pulsar-broker\src\main\java\org\apache\pulsar\broker\TimeAverageMessageData.java,158,53,1,9,0,63
 pulsar-master\pulsar-master\pulsar-common\src\main\java\org\apache\pulsar\common\policies\data\stats\SubscriptionStatsImpl.java,158,49,0,13,0,62
 pulsar-master\pulsar-master\tests\integration\src\test\java\org\apache\pulsar\tests\integration\functions\java\PulsarFunctionsJavaTest.java,158,33,2,13,0,48
 pulsar-master\pulsar-master\pulsar-common\src\test\java\org\apache\pulsar\common\compression\CompressorCodecTest.java,158,67,0,23,0,90
 rocketmq-develop\rocketmq-develop\broker\src\test\java\org\apache\rocketmq\broker\transaction\queue\TransactionalMessageBridgeTest.java,158,60,0,30,1,91
 rocketmq-develop\rocketmq-develop\common\src\main\java\org\apache\rocketmq\common\protocol\body\RegisterBrokerBody.java,158,56,1,26,5,88
 zookeeper-master\zookeeper-master\zookeeper-server\src\test\java\org\apache\zookeeper\test\ResponseCacheTest.java,158,0,11,17,0,28
 zookeeper-master\zookeeper-master\zookeeper-contrib\zookeeper-contrib-zooinspector\src\main\java\org\apache\zookeeper\inspector\gui\nodeviewer\NodeViewerMetaData.java,158,0,5,6,1,12
 dubbo-3.0\dubbo-3.0\dubbo-compatible\src\test\java\org\apache\dubbo\config\MethodConfigTest.java,159,34,0,13,0,47
 hadoop-trunk\hadoop-trunk\hadoop-tools\hadoop-streaming\src\test\java\org\apache\hadoop\streaming\TestStreamingOutputKeyValueTypes.java,159,27,0,1,0,28
 hadoop-trunk\hadoop-trunk\hadoop-hdfs-project\hadoop-hdfs\src\test\java\org\apache\hadoop\hdfs\TestDFSInotifyEventInputStreamKerberized.java,159,22,6,17,0,45
 hadoop-trunk\hadoop-trunk\hadoop-yarn-project\hadoop-yarn\hadoop-yarn-common\src\main\java\org\apache\hadoop\yarn\util\ResourceCalculatorProcessTree.java,159,17,5,4,1,27
 hadoop-trunk\hadoop-trunk\hadoop-mapreduce-project\hadoop-mapreduce-examples\src\main\java\org\apache\hadoop\examples\WordMean.java,159,33,3,2,0,38
 hadoop-trunk\hadoop-trunk\hadoop-hdfs-project\hadoop-hdfs-client\src\test\java\org\apache\hadoop\hdfs\web\TestWebHDFSOAuth2.java,159,65,1,14,0,80
 hadoop-trunk\hadoop-trunk\hadoop-common-project\hadoop-common\src\test\java\org\apache\hadoop\io\compress\TestCodecPool.java,159,28,1,4,11,44
 hadoop-trunk\hadoop-trunk\hadoop-yarn-project\hadoop-yarn\hadoop-yarn-server\hadoop-yarn-server-nodemanager\src\test\java\org\apache\hadoop\yarn\server\nodemanager\DummyContainerManager.java,159,42,13,22,6,83
 hadoop-trunk\hadoop-trunk\hadoop-common-project\hadoop-common\src\main\java\org\apache\hadoop\util\ChunkedArrayList.java,159,32,0,1,0,33
 hadoop-trunk\hadoop-trunk\hadoop-hdfs-project\hadoop-hdfs-rbf\src\test\java\org\apache\hadoop\hdfs\rbfbalance\TestMountTableProcedure.java,159,20,6,8,0,34
 hadoop-trunk\hadoop-trunk\hadoop-hdfs-project\hadoop-hdfs-rbf\src\test\java\org\apache\hadoop\hdfs\server\federation\router\TestRouterFederationRenameBase.java,159,24,1,7,1,33
 hadoop-trunk\hadoop-trunk\hadoop-yarn-project\hadoop-yarn\hadoop-yarn-server\hadoop-yarn-server-applicationhistoryservice\src\main\java\org\apache\hadoop\yarn\server\applicationhistoryservice\records\ContainerHistoryData.java,159,78,0,1,10,89
 hadoop-trunk\hadoop-trunk\hadoop-yarn-project\hadoop-yarn\hadoop-yarn-server\hadoop-yarn-server-resourcemanager\src\test\java\org\apache\hadoop\yarn\server\resourcemanager\TestRMHAForAsyncScheduler.java,159,32,0,6,2,40
 hadoop-trunk\hadoop-trunk\hadoop-yarn-project\hadoop-yarn\hadoop-yarn-common\src\main\java\org\apache\hadoop\yarn\api\records\impl\pb\ContainerRetryContextPBImpl.java,159,39,52,2,0,93
 hadoop-trunk\hadoop-trunk\hadoop-yarn-project\hadoop-yarn\hadoop-yarn-common\src\main\java\org\apache\hadoop\yarn\api\records\impl\pb\LocalizationStatusPBImpl.java,159,30,43,2,0,75
 hadoop-trunk\hadoop-trunk\hadoop-common-project\hadoop-common\src\test\java\org\apache\hadoop\io\TestSetFile.java,159,64,23,5,5,97
 kafka-trunk\kafka-trunk\clients\src\generated\java\org\apache\kafka\common\message\DescribeUserScramCredentialsResponseDataJsonConverter.java,159,0,0,38,0,38
 kafka-trunk\kafka-trunk\connect\runtime\src\test\java\org\apache\kafka\connect\runtime\rest\util\SSLUtilsTest.java,159,0,0,41,0,41
 kafka-trunk\kafka-trunk\connect\runtime\src\test\java\org\apache\kafka\connect\integration\StartAndStopCounter.java,159,0,0,20,0,20
 kafka-trunk\kafka-trunk\clients\src\main\java\org\apache\kafka\common\requests\RequestContext.java,159,0,8,11,0,19
 kafka-trunk\kafka-trunk\trogdor\src\main\java\org\apache\kafka\trogdor\workload\ConsumeBenchSpec.java,159,0,1,37,4,42
 pulsar-master\pulsar-master\pulsar-io\flume\src\test\java\org\apache\pulsar\io\flume\node\TestApplication.java,159,24,0,5,0,29
 pulsar-master\pulsar-master\pulsar-client\src\test\java\org\apache\pulsar\client\impl\BackoffTest.java,159,98,1,5,0,104
 pulsar-master\pulsar-master\pulsar-broker-common\src\main\java\org\apache\pulsar\broker\resources\BaseResources.java,159,84,16,27,0,127
 rocketmq-develop\rocketmq-develop\broker\src\main\java\org\apache\rocketmq\broker\subscription\SubscriptionGroupManager.java,159,71,2,38,3,114
 rocketmq-develop\rocketmq-develop\tools\src\main\java\org\apache\rocketmq\tools\command\topic\UpdateTopicSubCommand.java,159,30,0,23,1,54
 dubbo-3.0\dubbo-3.0\dubbo-cluster\src\main\java\org\apache\dubbo\rpc\cluster\support\wrapper\MockClusterInvoker.java,160,43,1,19,0,63
 dubbo-3.0\dubbo-3.0\dubbo-common\src\test\java\org\apache\dubbo\common\config\configcenter\AbstractDynamicConfigurationTest.java,160,49,2,25,4,80
 hadoop-trunk\hadoop-trunk\hadoop-mapreduce-project\hadoop-mapreduce-client\hadoop-mapreduce-client-core\src\main\java\org\apache\hadoop\mapreduce\task\reduce\Shuffle.java,160,49,6,1,1,57
 hadoop-trunk\hadoop-trunk\hadoop-common-project\hadoop-kms\src\main\java\org\apache\hadoop\crypto\key\kms\server\KMSConfiguration.java,160,57,3,2,0,62
 hadoop-trunk\hadoop-trunk\hadoop-yarn-project\hadoop-yarn\hadoop-yarn-server\hadoop-yarn-server-common\src\main\java\org\apache\hadoop\yarn\server\scheduler\OpportunisticContainerContext.java,160,35,8,5,4,52
 hadoop-trunk\hadoop-trunk\hadoop-tools\hadoop-gridmix\src\test\java\org\apache\hadoop\mapred\gridmix\TestGridmixSubmission.java,160,26,8,2,5,41
 hadoop-trunk\hadoop-trunk\hadoop-common-project\hadoop-common\src\main\java\org\apache\hadoop\metrics2\util\MetricsCache.java,160,34,2,1,0,37
 hadoop-trunk\hadoop-trunk\hadoop-yarn-project\hadoop-yarn\hadoop-yarn-server\hadoop-yarn-server-resourcemanager\src\test\java\org\apache\hadoop\yarn\webapp\TestRMWithCSRFFilter.java,160,36,4,7,0,47
 hadoop-trunk\hadoop-trunk\hadoop-hdfs-project\hadoop-hdfs\src\main\java\org\apache\hadoop\hdfs\server\diskbalancer\planner\NodePlan.java,160,25,0,1,2,28
 hadoop-trunk\hadoop-trunk\hadoop-tools\hadoop-aliyun\src\test\java\org\apache\hadoop\fs\aliyun\oss\TestAliyunOSSInputStream.java,160,56,14,1,2,73
 hadoop-trunk\hadoop-trunk\hadoop-mapreduce-project\hadoop-mapreduce-client\hadoop-mapreduce-client-core\src\main\java\org\apache\hadoop\mapreduce\checkpoint\FSCheckpointService.java,160,47,2,1,1,51
 hadoop-trunk\hadoop-trunk\hadoop-common-project\hadoop-common\src\main\java\org\apache\hadoop\fs\shell\TouchCommands.java,160,41,1,3,1,46
 hadoop-trunk\hadoop-trunk\hadoop-yarn-project\hadoop-yarn\hadoop-yarn-server\hadoop-yarn-server-tests\src\test\java\org\apache\hadoop\yarn\server\ContainerTokenIdentifierForTest.java,160,75,38,4,0,117
 hadoop-trunk\hadoop-trunk\hadoop-common-project\hadoop-common\src\main\java\org\apache\hadoop\io\DefaultStringifier.java,160,42,3,1,0,46
 hadoop-trunk\hadoop-trunk\hadoop-tools\hadoop-fs2img\src\main\java\org\apache\hadoop\hdfs\server\namenode\UGIResolver.java,160,43,0,1,0,44
 hadoop-trunk\hadoop-trunk\hadoop-yarn-project\hadoop-yarn\hadoop-yarn-common\src\main\java\org\apache\hadoop\yarn\logaggregation\filecontroller\tfile\TFileAggregatedLogsBlock.java,160,26,10,2,1,39
 hadoop-trunk\hadoop-trunk\hadoop-yarn-project\hadoop-yarn\hadoop-yarn-server\hadoop-yarn-server-tests\src\test\java\org\apache\hadoop\yarn\server\TestRMNMSecretKeys.java,160,39,1,5,3,48
 hadoop-trunk\hadoop-trunk\hadoop-yarn-project\hadoop-yarn\hadoop-yarn-common\src\main\java\org\apache\hadoop\yarn\logaggregation\filecontroller\LogAggregationFileControllerFactory.java,160,12,4,1,2,19
 hadoop-trunk\hadoop-trunk\hadoop-hdfs-project\hadoop-hdfs-client\src\main\java\org\apache\hadoop\hdfs\LocatedBlocksRefresher.java,160,47,5,17,1,70
 kafka-trunk\kafka-trunk\connect\runtime\src\main\java\org\apache\kafka\connect\runtime\rest\resources\LoggingResource.java,160,0,0,14,0,14
 kafka-trunk\kafka-trunk\clients\src\test\java\org\apache\kafka\common\security\oauthbearer\secured\RefreshingHttpsJwksTest.java,160,0,0,25,1,26
 kafka-trunk\kafka-trunk\connect\api\src\main\java\org\apache\kafka\connect\data\SchemaProjector.java,160,0,3,26,0,29
 pulsar-master\pulsar-master\pulsar-broker\src\main\java\org\apache\pulsar\broker\service\persistent\PersistentMessageExpiryMonitor.java,160,77,3,34,0,114
 pulsar-master\pulsar-master\pulsar-metadata\src\test\java\org\apache\pulsar\metadata\TestZKServer.java,160,40,4,6,0,50
 pulsar-master\pulsar-master\pulsar-client\src\test\java\org\apache\pulsar\client\impl\schema\generic\GenericSchemaImplTest.java,160,35,1,21,0,57
 pulsar-master\pulsar-master\pulsar-common\src\main\java\org\apache\pulsar\common\util\collections\ConcurrentSortedLongPairSet.java,160,61,0,17,0,78
 pulsar-master\pulsar-master\pulsar-io\mongo\src\main\java\org\apache\pulsar\io\mongodb\MongoSink.java,160,44,2,13,0,59
 pulsar-master\pulsar-master\pulsar-sql\presto-pulsar\src\test\java\org\apache\pulsar\sql\presto\TestReadChunkedMessages.java,160,37,3,19,0,59
 pulsar-master\pulsar-master\pulsar-sql\presto-pulsar\src\test\java\org\apache\pulsar\sql\presto\decoder\json\JsonDecoderTestUtil.java,160,42,3,23,0,68
 pulsar-master\pulsar-master\pulsar-common\src\main\java\org\apache\pulsar\common\nar\NarClassLoader.java,160,57,3,47,0,107
 pulsar-master\pulsar-master\pulsar-client\src\test\java\org\apache\pulsar\client\impl\schema\generic\GenericSchemaTest.java,160,35,0,21,0,56
 rocketmq-develop\rocketmq-develop\broker\src\test\java\org\apache\rocketmq\broker\filter\CommitLogDispatcherCalcBitMapTest.java,160,37,2,10,0,49
 skywalking-master\skywalking-master\oap-server\server-core\src\main\java\org\apache\skywalking\oap\server\core\profiling\trace\analyze\ProfileAnalyzer.java,160,72,5,30,0,107
 zookeeper-master\zookeeper-master\zookeeper-server\src\test\java\org\apache\zookeeper\common\PKCS12FileLoaderTest.java,160,0,0,22,0,22
 hadoop-trunk\hadoop-trunk\hadoop-yarn-project\hadoop-yarn\hadoop-yarn-common\src\main\java\org\apache\hadoop\yarn\api\records\impl\pb\TokenPBImpl.java,161,40,51,1,0,92
 hadoop-trunk\hadoop-trunk\hadoop-yarn-project\hadoop-yarn\hadoop-yarn-server\hadoop-yarn-server-resourcemanager\src\test\java\org\apache\hadoop\yarn\server\resourcemanager\reservation\TestCapacitySchedulerPlanFollower.java,161,39,5,8,1,53
 hadoop-trunk\hadoop-trunk\hadoop-hdfs-project\hadoop-hdfs-client\src\main\java\org\apache\hadoop\hdfs\protocol\datatransfer\PacketHeader.java,161,57,39,3,0,99
 hadoop-trunk\hadoop-trunk\hadoop-hdfs-project\hadoop-hdfs\src\test\java\org\apache\hadoop\hdfs\server\namenode\CreateEditsLog.java,161,82,9,3,0,94
 hadoop-trunk\hadoop-trunk\hadoop-mapreduce-project\hadoop-mapreduce-client\hadoop-mapreduce-client-common\src\main\java\org\apache\hadoop\mapreduce\v2\api\records\impl\pb\CountersPBImpl.java,161,56,43,5,0,104
 hadoop-trunk\hadoop-trunk\hadoop-yarn-project\hadoop-yarn\hadoop-yarn-server\hadoop-yarn-server-nodemanager\src\test\java\org\apache\hadoop\yarn\server\nodemanager\api\protocolrecords\impl\pb\TestPBRecordImpl.java,161,32,22,15,0,69
 hadoop-trunk\hadoop-trunk\hadoop-yarn-project\hadoop-yarn\hadoop-yarn-common\src\main\java\org\apache\hadoop\yarn\api\resource\PlacementConstraintTransformations.java,161,31,0,7,0,38
 hadoop-trunk\hadoop-trunk\hadoop-yarn-project\hadoop-yarn\hadoop-yarn-server\hadoop-yarn-server-resourcemanager\src\main\java\org\apache\hadoop\yarn\server\resourcemanager\scheduler\capacity\PlanQueue.java,161,27,1,4,1,33
 hadoop-trunk\hadoop-trunk\hadoop-tools\hadoop-aws\src\test\java\org\apache\hadoop\fs\s3a\ITestS3ABucketExistence.java,161,23,0,7,0,30
 kafka-trunk\kafka-trunk\clients\src\main\java\org\apache\kafka\common\record\LazyDownConversionRecords.java,161,0,8,31,0,39
 kafka-trunk\kafka-trunk\streams\src\test\java\org\apache\kafka\streams\integration\GlobalThreadShutDownOrderTest.java,161,0,1,15,2,18
 pulsar-master\pulsar-master\pulsar-broker\src\main\java\org\apache\pulsar\broker\admin\v2\Worker.java,161,72,3,22,0,97
 pulsar-master\pulsar-master\pulsar-client\src\main\java\org\apache\pulsar\client\impl\ZeroQueueConsumerImpl.java,161,58,6,24,0,88
 pulsar-master\pulsar-master\pulsar-functions\worker\src\main\java\org\apache\pulsar\functions\worker\rest\WorkerServer.java,161,68,4,35,0,107
 rocketmq-develop\rocketmq-develop\test\src\test\java\org\apache\rocketmq\test\client\consumer\tag\TagMessageWithMulConsumerIT.java,161,37,1,24,4,66
 rocketmq-develop\rocketmq-develop\broker\src\main\java\org\apache\rocketmq\broker\processor\ClientManageProcessor.java,161,49,2,28,1,80
 rocketmq-develop\rocketmq-develop\tools\src\main\java\org\apache\rocketmq\tools\command\consumer\UpdateSubGroupSubCommand.java,161,30,0,24,1,55
 shardingsphere-master\shardingsphere-master\shardingsphere-agent\shardingsphere-agent-plugins\shardingsphere-agent-plugin-metrics\shardingsphere-agent-metrics-prometheus\src\main\java\org\apache\shardingsphere\agent\metrics\prometheus\wrapper\PrometheusWrapperFactory.java,161,44,3,25,0,72
 skywalking-master\skywalking-master\oap-server\server-cluster-plugin\cluster-consul-plugin\src\test\java\org\apache\skywalking\oap\server\cluster\plugin\consul\ConsulCoordinatorTest.java,161,35,3,9,0,47
 zookeeper-master\zookeeper-master\zookeeper-server\src\test\java\org\apache\zookeeper\common\BCFKSFileLoaderTest.java,161,0,0,19,0,19
 hadoop-trunk\hadoop-trunk\hadoop-hdfs-project\hadoop-hdfs\src\main\java\org\apache\hadoop\hdfs\server\namenode\NameNodeResourceChecker.java,162,44,2,3,1,50
 hadoop-trunk\hadoop-trunk\hadoop-tools\hadoop-aws\src\test\java\org\apache\hadoop\fs\s3a\audit\TestLoggingAuditor.java,162,3,2,2,2,9
 hadoop-trunk\hadoop-trunk\hadoop-tools\hadoop-aws\src\test\java\org\apache\hadoop\fs\s3a\scale\NanoTimerStats.java,162,23,2,1,1,27
 hadoop-trunk\hadoop-trunk\hadoop-yarn-project\hadoop-yarn\hadoop-yarn-server\hadoop-yarn-server-nodemanager\src\main\java\org\apache\hadoop\yarn\server\nodemanager\containermanager\deletion\task\FileDeletionTask.java,162,20,12,3,3,38
 hadoop-trunk\hadoop-trunk\hadoop-yarn-project\hadoop-yarn\hadoop-yarn-server\hadoop-yarn-server-nodemanager\src\main\java\org\apache\hadoop\yarn\server\nodemanager\containermanager\volume\csi\ContainerVolumePublisher.java,162,20,9,5,2,36
 hadoop-trunk\hadoop-trunk\hadoop-tools\hadoop-distcp\src\test\java\org\apache\hadoop\tools\util\TestProducerConsumer.java,162,49,14,2,4,69
 hadoop-trunk\hadoop-trunk\hadoop-hdfs-project\hadoop-hdfs-client\src\test\java\org\apache\hadoop\hdfs\TestDFSOpsCountStatistics.java,162,12,3,2,1,18
 hadoop-trunk\hadoop-trunk\hadoop-tools\hadoop-aliyun\src\test\java\org\apache\hadoop\fs\aliyun\oss\TestAliyunOSSBlockOutputStream.java,162,77,8,4,0,89
 hadoop-trunk\hadoop-trunk\hadoop-mapreduce-project\hadoop-mapreduce-client\hadoop-mapreduce-client-app\src\main\java\org\apache\hadoop\mapreduce\v2\app\webapp\CountersBlock.java,162,34,1,5,0,40
 kafka-trunk\kafka-trunk\clients\src\main\java\org\apache\kafka\common\security\oauthbearer\internals\OAuthBearerClientInitialResponse.java,162,0,8,25,0,33
 kafka-trunk\kafka-trunk\clients\src\main\java\org\apache\kafka\common\serialization\ListDeserializer.java,162,0,7,35,0,42
 kafka-trunk\kafka-trunk\clients\src\test\java\org\apache\kafka\common\metrics\JmxReporterTest.java,162,0,0,42,0,42
 kafka-trunk\kafka-trunk\clients\src\test\java\org\apache\kafka\clients\admin\internals\DeleteConsumerGroupOffsetsHandlerTest.java,162,0,2,35,1,38
 pulsar-master\pulsar-master\pulsar-sql\presto-pulsar\src\test\java\org\apache\pulsar\sql\presto\decoder\avro\AvroDecoderTestUtil.java,162,46,3,24,0,73
 pulsar-master\pulsar-master\pulsar-broker\src\test\java\org\apache\pulsar\client\api\ProducerCreationTest.java,162,47,4,30,0,81
 rocketmq-develop\rocketmq-develop\common\src\main\java\org\apache\rocketmq\common\TopicConfig.java,162,98,9,7,3,117
 rocketmq-develop\rocketmq-develop\client\src\main\java\org\apache\rocketmq\client\latency\LatencyFaultToleranceImpl.java,162,42,10,10,0,62
 zookeeper-master\zookeeper-master\zookeeper-server\src\test\java\org\apache\zookeeper\server\quorum\LeaderBeanTest.java,162,0,6,10,0,16
 zookeeper-master\zookeeper-master\zookeeper-server\src\main\java\org\apache\zookeeper\server\DatadirCleanupManager.java,162,0,0,4,0,4
 zookeeper-master\zookeeper-master\zookeeper-jute\src\test\java\org\apache\jute\BinaryInputArchiveTest.java,162,0,1,4,7,12
 hadoop-trunk\hadoop-trunk\hadoop-common-project\hadoop-common\src\test\java\org\apache\hadoop\ipc\TestRPCCompatibility.java,163,68,13,4,2,87
 hadoop-trunk\hadoop-trunk\hadoop-hdfs-project\hadoop-hdfs-rbf\src\test\java\org\apache\hadoop\hdfs\server\federation\router\TestRouterRpcSingleNS.java,163,14,20,3,8,45
 hadoop-trunk\hadoop-trunk\hadoop-tools\hadoop-aws\src\test\java\org\apache\hadoop\fs\s3a\ITestS3ABlockOutputArray.java,163,26,4,1,0,31
 hadoop-trunk\hadoop-trunk\hadoop-tools\hadoop-aws\src\main\java\org\apache\hadoop\fs\s3a\impl\StoreContextBuilder.java,163,51,0,1,2,54
 hadoop-trunk\hadoop-trunk\hadoop-common-project\hadoop-common\src\test\java\org\apache\hadoop\http\TestServletFilter.java,163,58,12,3,5,78
 hadoop-trunk\hadoop-trunk\hadoop-tools\hadoop-fs2img\src\main\java\org\apache\hadoop\hdfs\server\namenode\TreePath.java,163,63,20,5,6,94
 hadoop-trunk\hadoop-trunk\hadoop-yarn-project\hadoop-yarn\hadoop-yarn-common\src\main\java\org\apache\hadoop\yarn\util\ConverterUtils.java,163,37,1,1,0,39
 hadoop-trunk\hadoop-trunk\hadoop-yarn-project\hadoop-yarn\hadoop-yarn-server\hadoop-yarn-server-common\src\test\java\org\apache\hadoop\yarn\server\federation\utils\TestFederationStateStoreFacade.java,163,26,3,4,5,38
 hadoop-trunk\hadoop-trunk\hadoop-yarn-project\hadoop-yarn\hadoop-yarn-server\hadoop-yarn-server-resourcemanager\src\test\java\org\apache\hadoop\yarn\server\resourcemanager\scheduler\TestClusterNodeTracker.java,163,35,1,2,1,39
 hadoop-trunk\hadoop-trunk\hadoop-yarn-project\hadoop-yarn\hadoop-yarn-api\src\main\java\org\apache\hadoop\yarn\api\records\LogAggregationContext.java,163,20,0,2,0,22
 hadoop-trunk\hadoop-trunk\hadoop-yarn-project\hadoop-yarn\hadoop-yarn-server\hadoop-yarn-server-common\src\main\java\org\apache\hadoop\yarn\server\scheduler\ResourceRequestSet.java,163,16,0,1,1,18
 hadoop-trunk\hadoop-trunk\hadoop-yarn-project\hadoop-yarn\hadoop-yarn-server\hadoop-yarn-server-common\src\test\java\org\apache\hadoop\yarn\lib\TestZKClient.java,163,48,8,1,4,61
 hadoop-trunk\hadoop-trunk\hadoop-mapreduce-project\hadoop-mapreduce-client\hadoop-mapreduce-client-hs\src\test\java\org\apache\hadoop\mapreduce\v2\hs\TestJHSDelegationTokenSecretManager.java,163,26,2,4,0,32
 hadoop-trunk\hadoop-trunk\hadoop-hdfs-project\hadoop-hdfs\src\test\java\org\apache\hadoop\hdfs\server\namenode\TestTransferFsImage.java,163,27,1,4,16,48
 hadoop-trunk\hadoop-trunk\hadoop-tools\hadoop-aws\src\test\java\org\apache\hadoop\fs\s3a\scale\ITestS3AConcurrentOps.java,163,26,6,1,1,34
 hadoop-trunk\hadoop-trunk\hadoop-tools\hadoop-azure\src\test\java\org\apache\hadoop\fs\azurebfs\utils\DelegationSASGenerator.java,163,46,2,7,1,56
 hadoop-trunk\hadoop-trunk\hadoop-tools\hadoop-azure\src\main\java\org\apache\hadoop\fs\azure\SelfRenewingLease.java,163,24,10,2,2,38
 pulsar-master\pulsar-master\tests\integration\src\test\java\org\apache\pulsar\tests\integration\cli\ClusterMetadataTearDownTest.java,163,41,2,20,0,63
 pulsar-master\pulsar-master\pulsar-proxy\src\test\java\org\apache\pulsar\proxy\server\ProxyAuthenticatedProducerConsumerTest.java,163,48,7,27,0,82
 pulsar-master\pulsar-master\pulsar-broker\src\test\java\org\apache\pulsar\broker\intercept\InterceptFilterOutTest.java,163,42,1,29,0,72
 pulsar-master\pulsar-master\pulsar-broker\src\test\java\org\apache\pulsar\broker\service\plugin\FilterEntryTest.java,163,33,3,19,0,55
 pulsar-master\pulsar-master\pulsar-functions\worker\src\test\java\org\apache\pulsar\functions\worker\executor\MockExecutorController.java,163,52,0,16,0,68
 pulsar-master\pulsar-master\pulsar-broker\src\main\java\org\apache\pulsar\broker\stats\prometheus\metrics\DataSketchesOpStatsLogger.java,163,45,4,6,0,55
 rocketmq-develop\rocketmq-develop\client\src\test\java\org\apache\rocketmq\client\trace\DefaultMQProducerWithTraceTest.java,163,57,11,23,7,98
 zookeeper-master\zookeeper-master\zookeeper-server\src\test\java\org\apache\zookeeper\server\watch\RecursiveWatchQtyTest.java,163,0,3,9,1,13
 dubbo-3.0\dubbo-3.0\dubbo-metadata\dubbo-metadata-api\src\main\java\org\apache\dubbo\metadata\rest\RestMethodMetadata.java,164,88,0,4,0,92
 hadoop-trunk\hadoop-trunk\hadoop-hdfs-project\hadoop-hdfs-rbf\src\main\java\org\apache\hadoop\hdfs\server\federation\router\PeriodicService.java,164,8,2,2,1,13
 hadoop-trunk\hadoop-trunk\hadoop-hdfs-project\hadoop-hdfs\src\test\java\org\apache\hadoop\hdfs\server\namenode\TestNetworkTopologyServlet.java,164,21,3,1,1,26
 hadoop-trunk\hadoop-trunk\hadoop-hdfs-project\hadoop-hdfs\src\test\java\org\apache\hadoop\hdfs\server\datanode\TestDataXceiverBackwardsCompat.java,164,23,9,2,22,56
 hadoop-trunk\hadoop-trunk\hadoop-hdfs-project\hadoop-hdfs-client\src\main\java\org\apache\hadoop\hdfs\shortcircuit\DomainSocketFactory.java,164,52,5,4,0,61
 hadoop-trunk\hadoop-trunk\hadoop-tools\hadoop-openstack\src\main\java\org\apache\hadoop\fs\swift\auth\entities\Endpoint.java,164,50,0,1,0,51
 hadoop-trunk\hadoop-trunk\hadoop-mapreduce-project\hadoop-mapreduce-client\hadoop-mapreduce-client-core\src\main\java\org\apache\hadoop\mapreduce\jobhistory\EventReader.java,164,18,41,33,0,92
 hadoop-trunk\hadoop-trunk\hadoop-yarn-project\hadoop-yarn\hadoop-yarn-server\hadoop-yarn-server-resourcemanager\src\test\java\org\apache\hadoop\yarn\server\resourcemanager\placement\TestPlacementRuleFS.java,164,29,2,5,1,37
 hadoop-trunk\hadoop-trunk\hadoop-common-project\hadoop-common\src\main\java\org\apache\hadoop\log\Log4Json.java,164,42,3,18,0,63
 hadoop-trunk\hadoop-trunk\hadoop-tools\hadoop-aws\src\main\java\org\apache\hadoop\fs\s3a\statistics\S3AInputStreamStatistics.java,164,18,0,1,0,19
 hadoop-trunk\hadoop-trunk\hadoop-yarn-project\hadoop-yarn\hadoop-yarn-server\hadoop-yarn-server-resourcemanager\src\main\java\org\apache\hadoop\yarn\server\resourcemanager\scheduler\fair\SchedulingPolicy.java,164,18,4,6,0,28
 hadoop-trunk\hadoop-trunk\hadoop-common-project\hadoop-common\src\test\java\org\apache\hadoop\fs\TestRawLocalFileSystemContract.java,164,15,5,1,1,22
 hadoop-trunk\hadoop-trunk\hadoop-tools\hadoop-azure\src\test\java\org\apache\hadoop\fs\azurebfs\ITestGetNameSpaceEnabled.java,164,20,4,10,5,39
 hadoop-trunk\hadoop-trunk\hadoop-common-project\hadoop-common\src\test\java\org\apache\hadoop\ha\TestNodeFencer.java,164,58,3,4,9,74
 kafka-trunk\kafka-trunk\clients\src\main\java\org\apache\kafka\common\requests\LeaderAndIsrRequest.java,164,0,116,24,4,144
 kafka-trunk\kafka-trunk\connect\runtime\src\test\java\org\apache\kafka\connect\integration\RestExtensionIntegrationTest.java,164,0,2,28,3,33
 pulsar-master\pulsar-master\pulsar-metadata\src\main\java\org\apache\pulsar\metadata\impl\FaultInjectionMetadataStore.java,164,74,0,16,0,90
 pulsar-master\pulsar-master\pulsar-client-tools\src\main\java\org\apache\pulsar\admin\cli\CmdTransactions.java,164,58,1,37,0,96
 pulsar-master\pulsar-master\pulsar-client\src\main\java\org\apache\pulsar\client\impl\ConnectionHandler.java,164,57,16,16,0,89
 rocketmq-develop\rocketmq-develop\store\src\test\java\org\apache\rocketmq\store\HATest.java,164,106,8,25,3,142
 rocketmq-develop\rocketmq-develop\test\src\test\java\org\apache\rocketmq\test\client\consumer\tag\TagMessageWith1ConsumerIT.java,164,51,1,27,10,89
 zookeeper-master\zookeeper-master\zookeeper-contrib\zookeeper-contrib-loggraph\src\main\java\org\apache\zookeeper\graph\MergedLogSource.java,164,0,14,10,6,30
 dubbo-3.0\dubbo-3.0\dubbo-config\dubbo-config-spring\src\main\java\org\apache\dubbo\config\spring\context\DubboSpringInitializer.java,165,58,7,33,0,98
 hadoop-trunk\hadoop-trunk\hadoop-tools\hadoop-resourceestimator\src\main\java\org\apache\hadoop\resourceestimator\translator\impl\RmSingleLineParser.java,165,23,1,2,0,26
 hadoop-trunk\hadoop-trunk\hadoop-yarn-project\hadoop-yarn\hadoop-yarn-server\hadoop-yarn-server-resourcemanager\src\test\java\org\apache\hadoop\yarn\server\resourcemanager\webapp\TestRMWebAppFairScheduler.java,165,16,1,9,0,26
 hadoop-trunk\hadoop-trunk\hadoop-yarn-project\hadoop-yarn\hadoop-yarn-server\hadoop-yarn-server-nodemanager\src\main\java\org\apache\hadoop\yarn\server\nodemanager\containermanager\launcher\ContainerCleanup.java,165,32,7,9,0,48
 hadoop-trunk\hadoop-trunk\hadoop-hdfs-project\hadoop-hdfs\src\main\java\org\apache\hadoop\hdfs\server\datanode\fsdataset\impl\NativePmemMappableBlockLoader.java,165,27,2,1,0,30
 hadoop-trunk\hadoop-trunk\hadoop-yarn-project\hadoop-yarn\hadoop-yarn-server\hadoop-yarn-server-nodemanager\src\main\java\org\apache\hadoop\yarn\server\nodemanager\containermanager\launcher\ContainerRelaunch.java,165,24,2,6,0,32
 hadoop-trunk\hadoop-trunk\hadoop-tools\hadoop-distcp\src\test\java\org\apache\hadoop\tools\mapred\lib\TestDynamicInputFormat.java,165,52,13,3,0,68
 hadoop-trunk\hadoop-trunk\hadoop-tools\hadoop-aws\src\test\java\org\apache\hadoop\fs\s3a\audit\TestAuditIntegration.java,165,5,2,6,0,13
 hadoop-trunk\hadoop-trunk\hadoop-yarn-project\hadoop-yarn\hadoop-yarn-api\src\main\java\org\apache\hadoop\yarn\api\records\ApplicationAttemptReport.java,165,44,0,1,0,45
 hadoop-trunk\hadoop-trunk\hadoop-yarn-project\hadoop-yarn\hadoop-yarn-server\hadoop-yarn-server-nodemanager\src\test\java\org\apache\hadoop\yarn\server\nodemanager\TestNodeManager.java,165,28,9,6,3,46
 hadoop-trunk\hadoop-trunk\hadoop-tools\hadoop-azure\src\test\java\org\apache\hadoop\fs\azure\InMemoryBlockBlobStore.java,165,82,15,2,4,103
 hadoop-trunk\hadoop-trunk\hadoop-hdfs-project\hadoop-hdfs\src\test\java\org\apache\hadoop\hdfs\TestDFSRename.java,165,51,8,3,2,64
 hadoop-trunk\hadoop-trunk\hadoop-common-project\hadoop-common\src\test\java\org\apache\hadoop\fs\contract\AbstractFSContract.java,165,30,2,3,0,35
 hadoop-trunk\hadoop-trunk\hadoop-yarn-project\hadoop-yarn\hadoop-yarn-server\hadoop-yarn-server-resourcemanager\src\test\java\org\apache\hadoop\yarn\server\resourcemanager\TestApplicationMasterServiceInterceptor.java,165,40,3,6,2,51
 hadoop-trunk\hadoop-trunk\hadoop-yarn-project\hadoop-yarn\hadoop-yarn-server\hadoop-yarn-server-resourcemanager\src\test\java\org\apache\hadoop\yarn\server\resourcemanager\scheduler\capacity\TestApplicationPriorityACLs.java,165,33,5,3,5,46
 kafka-trunk\kafka-trunk\clients\src\test\java\org\apache\kafka\common\security\oauthbearer\secured\OAuthBearerTest.java,165,0,9,10,1,20
 kafka-trunk\kafka-trunk\connect\runtime\src\test\java\org\apache\kafka\connect\runtime\MockConnectMetrics.java,165,0,2,33,0,35
 kafka-trunk\kafka-trunk\streams\src\test\java\org\apache\kafka\streams\state\internals\ListValueStoreTest.java,165,0,1,8,0,9
 kafka-trunk\kafka-trunk\raft\src\test\java\org\apache\kafka\raft\CandidateStateTest.java,165,0,3,10,3,16
 kafka-trunk\kafka-trunk\clients\src\main\java\org\apache\kafka\common\protocol\Protocol.java,165,0,5,3,0,8
 kafka-trunk\kafka-trunk\clients\src\generated\java\org\apache\kafka\common\message\JoinGroupRequestDataJsonConverter.java,165,0,0,32,0,32
 pulsar-master\pulsar-master\managed-ledger\src\main\java\org\apache\bookkeeper\mledger\ManagedLedgerException.java,165,73,0,16,0,89
 rocketmq-develop\rocketmq-develop\acl\src\test\java\org\apache\rocketmq\acl\common\PermissionTest.java,165,55,1,12,0,68
 zookeeper-master\zookeeper-master\zookeeper-recipes\zookeeper-recipes-lock\src\test\java\org\apache\zookeeper\recipes\lock\ZNodeNameTest.java,165,0,0,7,1,8
 zookeeper-master\zookeeper-master\zookeeper-server\src\main\java\org\apache\zookeeper\server\quorum\auth\SaslQuorumAuthLearner.java,165,0,16,31,0,47
 hadoop-trunk\hadoop-trunk\hadoop-yarn-project\hadoop-yarn\hadoop-yarn-server\hadoop-yarn-server-resourcemanager\src\main\java\org\apache\hadoop\yarn\server\resourcemanager\scheduler\capacity\AbstractManagedParentQueue.java,166,30,1,4,0,35
 hadoop-trunk\hadoop-trunk\hadoop-hdfs-project\hadoop-hdfs\src\test\java\org\apache\hadoop\hdfs\server\datanode\TestDataNodeMetricsLogger.java,166,34,5,2,1,42
 hadoop-trunk\hadoop-trunk\hadoop-common-project\hadoop-common\src\test\java\org\apache\hadoop\util\TestWeakReferenceMap.java,166,11,0,1,0,12
 hadoop-trunk\hadoop-trunk\hadoop-tools\hadoop-dynamometer\hadoop-dynamometer-workload\src\main\java\org\apache\hadoop\tools\dynamometer\workloadgenerator\WorkloadDriver.java,166,19,19,2,1,41
 hadoop-trunk\hadoop-trunk\hadoop-yarn-project\hadoop-yarn\hadoop-yarn-api\src\main\java\org\apache\hadoop\yarn\api\records\timeline\TimelinePutResponse.java,166,41,2,2,1,46
 hadoop-trunk\hadoop-trunk\hadoop-tools\hadoop-aws\src\main\java\org\apache\hadoop\fs\s3a\statistics\impl\BondedS3AStatisticsContext.java,166,13,0,1,0,14
 hadoop-trunk\hadoop-trunk\hadoop-common-project\hadoop-common\src\test\java\org\apache\hadoop\util\TestCacheableIPList.java,166,31,37,4,0,72
 hadoop-trunk\hadoop-trunk\hadoop-mapreduce-project\hadoop-mapreduce-client\hadoop-mapreduce-client-jobclient\src\test\java\org\apache\hadoop\mapreduce\lib\input\TestMultipleInputs.java,166,29,15,3,3,50
 hadoop-trunk\hadoop-trunk\hadoop-tools\hadoop-aws\src\test\java\org\apache\hadoop\fs\s3a\audit\AbstractAuditingTest.java,166,12,2,3,0,17
 hadoop-trunk\hadoop-trunk\hadoop-hdfs-project\hadoop-hdfs\src\test\java\org\apache\hadoop\hdfs\qjournal\TestNNWithQJM.java,166,30,2,1,1,34
 kafka-trunk\kafka-trunk\clients\src\main\java\org\apache\kafka\common\header\internals\RecordHeaders.java,166,0,5,4,0,9
 kafka-trunk\kafka-trunk\connect\runtime\src\main\java\org\apache\kafka\connect\runtime\errors\DeadLetterQueueReporter.java,166,0,4,42,4,50
 kafka-trunk\kafka-trunk\streams\src\main\java\org\apache\kafka\streams\processor\internals\AbstractTask.java,166,0,1,21,3,25
 kafka-trunk\kafka-trunk\streams\src\test\java\org\apache\kafka\streams\kstream\TimeWindowsTest.java,166,0,4,31,5,40
 kafka-trunk\kafka-trunk\clients\src\test\java\org\apache\kafka\test\Microbenchmarks.java,166,0,15,9,2,26
 kafka-trunk\kafka-trunk\streams\src\test\java\org\apache\kafka\streams\integration\PurgeRepartitionTopicIntegrationTest.java,166,0,2,33,5,40
 kafka-trunk\kafka-trunk\clients\src\generated\java\org\apache\kafka\common\message\SyncGroupRequestDataJsonConverter.java,166,0,0,30,0,30
 pulsar-master\pulsar-master\pulsar-broker\src\test\java\org\apache\pulsar\client\impl\TransactionClientConnectTest.java,166,71,9,43,0,123
 pulsar-master\pulsar-master\pulsar-sql\presto-pulsar\src\test\java\org\apache\pulsar\sql\presto\decoder\protobufnative\ProtobufNativeDecoderTestUtil.java,166,41,2,21,0,64
 pulsar-master\pulsar-master\pulsar-common\src\test\java\org\apache\pulsar\common\naming\NamespaceNameTest.java,166,10,20,9,0,39
 pulsar-master\pulsar-master\pulsar-broker\src\test\java\org\apache\pulsar\io\PulsarBatchSourceE2ETest.java,166,57,5,42,0,104
 skywalking-master\skywalking-master\oap-server\server-storage-plugin\storage-influxdb-plugin\src\main\java\org\apache\skywalking\oap\server\storage\plugin\influxdb\query\MetricsQuery.java,166,32,1,26,0,59
 skywalking-master\skywalking-master\oap-server\server-storage-plugin\storage-jdbc-hikaricp-plugin\src\main\java\org\apache\skywalking\oap\server\storage\plugin\jdbc\h2\dao\H2EventQueryDAO.java,166,36,6,27,0,69
 zookeeper-master\zookeeper-master\zookeeper-server\src\test\java\org\apache\zookeeper\test\StatTest.java,166,0,21,11,1,33
 zookeeper-master\zookeeper-master\zookeeper-server\src\main\java\org\apache\zookeeper\server\ContainerManager.java,166,0,11,19,1,31
 zookeeper-master\zookeeper-master\zookeeper-server\src\test\java\org\apache\zookeeper\server\SnapshotDigestTest.java,166,0,8,16,0,24
 zookeeper-master\zookeeper-master\zookeeper-server\src\test\java\org\apache\zookeeper\test\AtomicFileOutputStreamTest.java,166,0,11,8,24,43
 dubbo-3.0\dubbo-3.0\dubbo-rpc\dubbo-rpc-dubbo\src\test\java\org\apache\dubbo\rpc\protocol\dubbo\support\EnumBak.java,167,40,0,31,0,71
 dubbo-3.0\dubbo-3.0\dubbo-config\dubbo-config-api\src\test\java\org\apache\dubbo\config\integration\multiple\servicediscoveryregistry\MultipleRegistryCenterServiceDiscoveryRegistryIntegrationTest.java,167,46,4,32,0,82
 hadoop-trunk\hadoop-trunk\hadoop-yarn-project\hadoop-yarn\hadoop-yarn-common\src\test\java\org\apache\hadoop\yarn\util\TestApps.java,167,6,2,1,1,10
 hadoop-trunk\hadoop-trunk\hadoop-yarn-project\hadoop-yarn\hadoop-yarn-api\src\main\java\org\apache\hadoop\yarn\api\records\SchedulingRequest.java,167,27,0,1,1,29
 hadoop-trunk\hadoop-trunk\hadoop-yarn-project\hadoop-yarn\hadoop-yarn-server\hadoop-yarn-server-resourcemanager\src\test\java\org\apache\hadoop\yarn\server\resourcemanager\reservation\TestSchedulerPlanFollowerBase.java,167,56,2,10,0,68
 hadoop-trunk\hadoop-trunk\hadoop-common-project\hadoop-common\src\test\java\org\apache\hadoop\security\ssl\TestReloadingX509KeyManager.java,167,50,12,17,8,87
 hadoop-trunk\hadoop-trunk\hadoop-yarn-project\hadoop-yarn\hadoop-yarn-common\src\test\java\org\apache\hadoop\yarn\TestContainerResourceIncreaseRPC.java,167,39,3,5,1,48
 hadoop-trunk\hadoop-trunk\hadoop-hdfs-project\hadoop-hdfs\src\main\java\org\apache\hadoop\hdfs\server\blockmanagement\AvailableSpaceBlockPlacementPolicy.java,167,60,7,21,0,88
 hadoop-trunk\hadoop-trunk\hadoop-tools\hadoop-streaming\src\main\java\org\apache\hadoop\streaming\StreamUtil.java,167,40,8,5,2,55
 hadoop-trunk\hadoop-trunk\hadoop-hdfs-project\hadoop-hdfs-httpfs\src\main\java\org\apache\hadoop\fs\http\server\HttpFSServerWebServer.java,167,33,1,9,0,43
 hadoop-trunk\hadoop-trunk\hadoop-mapreduce-project\hadoop-mapreduce-client\hadoop-mapreduce-client-hs\src\test\java\org\apache\hadoop\mapreduce\v2\hs\TestHistoryServerLeveldbStateStoreService.java,167,9,0,2,4,15
 hadoop-trunk\hadoop-trunk\hadoop-mapreduce-project\hadoop-mapreduce-client\hadoop-mapreduce-client-core\src\test\java\org\apache\hadoop\mapred\TestJobEndNotifier.java,167,37,10,1,14,62
 hadoop-trunk\hadoop-trunk\hadoop-hdfs-project\hadoop-hdfs-rbf\src\main\java\org\apache\hadoop\hdfs\server\federation\store\driver\StateStoreDriver.java,167,5,2,2,3,12
 hadoop-trunk\hadoop-trunk\hadoop-common-project\hadoop-common\src\test\java\org\apache\hadoop\util\JarFinder.java,167,30,10,1,8,49
 hadoop-trunk\hadoop-trunk\hadoop-common-project\hadoop-common\src\main\java\org\apache\hadoop\ha\HAServiceTarget.java,167,37,0,2,0,39
 hadoop-trunk\hadoop-trunk\hadoop-yarn-project\hadoop-yarn\hadoop-yarn-common\src\main\java\org\apache\hadoop\yarn\api\protocolrecords\impl\pb\NodePublishVolumeRequestPBImpl.java,167,35,52,3,0,90
 hadoop-trunk\hadoop-trunk\hadoop-hdfs-project\hadoop-hdfs\src\test\java\org\apache\hadoop\hdfs\server\namenode\TestBlockPlacementPolicyRackFaultTolerant.java,167,40,3,5,0,48
 hadoop-trunk\hadoop-trunk\hadoop-hdfs-project\hadoop-hdfs\src\test\java\org\apache\hadoop\fs\viewfs\TestViewFsDefaultValue.java,167,52,0,10,0,62
 hadoop-trunk\hadoop-trunk\hadoop-mapreduce-project\hadoop-mapreduce-client\hadoop-mapreduce-client-core\src\test\java\org\apache\hadoop\mapreduce\security\TestTokenCache.java,167,40,8,1,0,49
 hadoop-trunk\hadoop-trunk\hadoop-tools\hadoop-aws\src\main\java\org\apache\hadoop\fs\s3a\commit\staging\PartitionedStagingCommitter.java,167,10,1,2,0,13
 hadoop-trunk\hadoop-trunk\hadoop-hdfs-project\hadoop-hdfs-client\src\main\java\org\apache\hadoop\hdfs\protocol\LocatedBlocks.java,167,52,3,2,5,62
 hadoop-trunk\hadoop-trunk\hadoop-yarn-project\hadoop-yarn\hadoop-yarn-server\hadoop-yarn-server-resourcemanager\src\main\java\org\apache\hadoop\yarn\server\resourcemanager\webapp\RMAppBlock.java,167,22,1,2,0,25
 hadoop-trunk\hadoop-trunk\hadoop-common-project\hadoop-common\src\test\java\org\apache\hadoop\ipc\TestServer.java,167,52,14,3,2,71
 kafka-trunk\kafka-trunk\metadata\src\generated\java\org\apache\kafka\common\metadata\ProducerIdsRecord.java,167,0,0,11,2,13
 kafka-trunk\kafka-trunk\streams\src\test\java\org\apache\kafka\streams\integration\utils\KafkaEmbedded.java,167,0,6,28,8,42
 kafka-trunk\kafka-trunk\clients\src\generated\java\org\apache\kafka\common\message\BrokerRegistrationResponseData.java,167,0,0,12,1,13
 kafka-trunk\kafka-trunk\connect\transforms\src\test\java\org\apache\kafka\connect\transforms\InsertFieldTest.java,167,0,0,32,0,32
 kafka-trunk\kafka-trunk\streams\src\test\java\org\apache\kafka\streams\state\internals\ReadOnlyWindowStoreFacadeTest.java,167,0,0,43,0,43
 kafka-trunk\kafka-trunk\jmh-benchmarks\src\main\java\org\apache\kafka\jmh\acl\AclAuthorizerBenchmark.java,167,0,6,36,0,42
 kafka-trunk\kafka-trunk\connect\runtime\src\main\java\org\apache\kafka\connect\runtime\rest\RestClient.java,167,0,3,37,2,42
 kafka-trunk\kafka-trunk\clients\src\generated\java\org\apache\kafka\common\message\UpdateMetadataResponseData.java,167,0,0,11,1,12
 pulsar-master\pulsar-master\pulsar-testclient\src\test\java\org\apache\pulsar\testclient\Oauth2PerformanceTransactionTest.java,167,50,5,30,0,85
 pulsar-master\pulsar-master\pulsar-functions\instance\src\main\java\org\apache\pulsar\functions\instance\InstanceUtils.java,167,84,1,45,0,130
 pulsar-master\pulsar-master\pulsar-client-admin\src\main\java\org\apache\pulsar\client\admin\internal\BrokerStatsImpl.java,167,49,0,15,0,64
 pulsar-master\pulsar-master\pulsar-websocket\src\test\java\org\apache\pulsar\websocket\ReaderHandlerTest.java,167,30,4,20,0,54
 pulsar-master\pulsar-master\pulsar-io\kafka-connect-adaptor\src\test\java\org\apache\pulsar\io\kafka\connect\PulsarSchemaToKafkaSchemaTest.java,167,51,0,25,0,76
 rocketmq-develop\rocketmq-develop\openmessaging\src\main\java\io\openmessaging\rocketmq\consumer\PushConsumerImpl.java,167,49,5,23,2,79
 rocketmq-develop\rocketmq-develop\remoting\src\main\java\org\apache\rocketmq\remoting\common\RemotingHelper.java,167,25,4,13,1,43
 skywalking-master\skywalking-master\oap-server\server-core\src\main\java\org\apache\skywalking\oap\server\core\profiling\ebpf\analyze\EBPFProfilingStackNode.java,167,44,0,17,0,61
 skywalking-master\skywalking-master\oap-server\server-storage-plugin\storage-influxdb-plugin\src\main\java\org\apache\skywalking\oap\server\storage\plugin\influxdb\query\ProfileThreadSnapshotQuery.java,167,58,0,26,0,84
 dubbo-3.0\dubbo-3.0\dubbo-cluster\src\main\java\org\apache\dubbo\rpc\cluster\router\state\AbstractStateRouter.java,168,70,3,21,0,94
 hadoop-trunk\hadoop-trunk\hadoop-yarn-project\hadoop-yarn\hadoop-yarn-applications\hadoop-yarn-services\hadoop-yarn-services-core\src\main\java\org\apache\hadoop\yarn\service\containerlaunch\ContainerLaunchService.java,168,80,3,2,5,90
 hadoop-trunk\hadoop-trunk\hadoop-yarn-project\hadoop-yarn\hadoop-yarn-server\hadoop-yarn-server-resourcemanager\src\main\java\org\apache\hadoop\yarn\server\resourcemanager\volume\csi\lifecycle\VolumeImpl.java,168,27,5,8,3,43
 hadoop-trunk\hadoop-trunk\hadoop-common-project\hadoop-registry\src\test\java\org\apache\hadoop\registry\cli\TestRegistryCli.java,168,40,4,20,3,67
 hadoop-trunk\hadoop-trunk\hadoop-hdfs-project\hadoop-hdfs\src\test\java\org\apache\hadoop\hdfs\server\balancer\TestBalancerService.java,168,22,0,4,2,28
 hadoop-trunk\hadoop-trunk\hadoop-yarn-project\hadoop-yarn\hadoop-yarn-server\hadoop-yarn-server-sharedcachemanager\src\main\java\org\apache\hadoop\yarn\server\sharedcachemanager\CleanerService.java,168,21,4,4,1,30
 hadoop-trunk\hadoop-trunk\hadoop-common-project\hadoop-common\src\test\java\org\apache\hadoop\fs\viewfs\ViewFsTestSetup.java,168,65,3,5,2,75
 hadoop-trunk\hadoop-trunk\hadoop-yarn-project\hadoop-yarn\hadoop-yarn-server\hadoop-yarn-server-resourcemanager\src\main\java\org\apache\hadoop\yarn\server\resourcemanager\nodelabels\RMDelegatedNodeLabelsUpdater.java,168,24,3,3,1,31
 hadoop-trunk\hadoop-trunk\hadoop-mapreduce-project\hadoop-mapreduce-client\hadoop-mapreduce-client-jobclient\src\test\java\org\apache\hadoop\mapreduce\v2\TestMROldApiJobs.java,168,56,12,15,2,85
 hadoop-trunk\hadoop-trunk\hadoop-hdfs-project\hadoop-hdfs\src\test\java\org\apache\hadoop\hdfs\server\datanode\TestHSync.java,168,40,0,7,1,48
 kafka-trunk\kafka-trunk\clients\src\generated\java\org\apache\kafka\common\message\DescribeTransactionsResponseDataJsonConverter.java,168,0,0,47,0,47
 kafka-trunk\kafka-trunk\connect\transforms\src\main\java\org\apache\kafka\connect\transforms\MaskField.java,168,0,4,31,0,35
 kafka-trunk\kafka-trunk\streams\src\main\java\org\apache\kafka\streams\state\internals\OffsetCheckpoint.java,168,0,4,31,0,35
 kafka-trunk\kafka-trunk\clients\src\generated\java\org\apache\kafka\common\message\AlterPartitionResponseDataJsonConverter.java,168,0,0,41,0,41
 pulsar-master\pulsar-master\pulsar-broker\src\main\java\org\apache\pulsar\broker\systopic\TopicPoliciesSystemTopicClient.java,168,44,6,16,0,66
 pulsar-master\pulsar-master\pulsar-common\src\test\java\org\apache\pulsar\common\util\ReflectionsTest.java,168,30,6,10,0,46
 pulsar-master\pulsar-master\pulsar-broker\src\test\java\org\apache\pulsar\client\impl\ProducerSemaphoreTest.java,168,43,1,34,0,78
 pulsar-master\pulsar-master\pulsar-client-admin\src\main\java\org\apache\pulsar\client\admin\internal\WorkerImpl.java,168,67,0,29,0,96
 skywalking-master\skywalking-master\oap-server\server-core\src\main\java\org\apache\skywalking\oap\server\core\analysis\meter\function\avg\AvgHistogramFunction.java,168,46,2,19,0,67
 dubbo-3.0\dubbo-3.0\dubbo-common\src\test\java\org\apache\dubbo\common\timer\HashedWheelTimerTest.java,169,47,4,8,8,67
 dubbo-3.0\dubbo-3.0\dubbo-config\dubbo-config-spring\src\test\java\org\apache\dubbo\config\spring\impl\MethodCallbackImpl.java,169,39,0,2,0,41
 hadoop-trunk\hadoop-trunk\hadoop-common-project\hadoop-common\src\test\java\org\apache\hadoop\fs\shell\TestCopyToLocal.java,169,46,5,2,0,53
 hadoop-trunk\hadoop-trunk\hadoop-tools\hadoop-aws\src\test\java\org\apache\hadoop\fs\s3a\impl\TestRequestFactory.java,169,12,5,2,2,21
 hadoop-trunk\hadoop-trunk\hadoop-tools\hadoop-aws\src\test\java\org\apache\hadoop\fs\s3a\auth\delegation\TestS3ADelegationTokenSupport.java,169,13,2,3,2,20
 hadoop-trunk\hadoop-trunk\hadoop-hdfs-project\hadoop-hdfs-rbf\src\test\java\org\apache\hadoop\hdfs\server\federation\security\TestRouterHttpDelegationToken.java,169,22,1,4,0,27
 hadoop-trunk\hadoop-trunk\hadoop-tools\hadoop-aws\src\test\java\org\apache\hadoop\fs\s3a\impl\ITestXAttrCost.java,169,8,0,6,0,14
 hadoop-trunk\hadoop-trunk\hadoop-yarn-project\hadoop-yarn\hadoop-yarn-server\hadoop-yarn-server-sharedcachemanager\src\main\java\org\apache\hadoop\yarn\server\sharedcachemanager\store\SCMStore.java,169,19,2,2,0,23
 hadoop-trunk\hadoop-trunk\hadoop-yarn-project\hadoop-yarn\hadoop-yarn-server\hadoop-yarn-server-resourcemanager\src\test\java\org\apache\hadoop\yarn\server\resourcemanager\scheduler\fair\converter\TestFSConfigToCSConfigConverterMain.java,169,16,0,6,3,25
 hadoop-trunk\hadoop-trunk\hadoop-common-project\hadoop-common\src\test\java\org\apache\hadoop\fs\shell\TestCpCommand.java,169,46,5,2,0,53
 hadoop-trunk\hadoop-trunk\hadoop-mapreduce-project\hadoop-mapreduce-client\hadoop-mapreduce-client-hs\src\main\java\org\apache\hadoop\mapreduce\v2\hs\webapp\HsTasksBlock.java,169,34,3,5,0,42
 hadoop-trunk\hadoop-trunk\hadoop-yarn-project\hadoop-yarn\hadoop-yarn-server\hadoop-yarn-server-resourcemanager\src\test\java\org\apache\hadoop\yarn\server\resourcemanager\webapp\helper\ResourceRequestsXmlVerifications.java,169,30,1,3,0,34
 hadoop-trunk\hadoop-trunk\hadoop-yarn-project\hadoop-yarn\hadoop-yarn-server\hadoop-yarn-server-resourcemanager\src\test\java\org\apache\hadoop\yarn\server\resourcemanager\reservation\TestReservationSystem.java,169,37,5,11,3,56
 hadoop-trunk\hadoop-trunk\hadoop-mapreduce-project\hadoop-mapreduce-client\hadoop-mapreduce-client-hs\src\main\java\org\apache\hadoop\mapreduce\v2\hs\webapp\HsJobBlock.java,169,39,0,6,0,45
 kafka-trunk\kafka-trunk\trogdor\src\test\java\org\apache\kafka\trogdor\common\ExpectedTasks.java,169,0,12,14,0,26
 kafka-trunk\kafka-trunk\clients\src\generated\java\org\apache\kafka\common\message\LeaderAndIsrResponseDataJsonConverter.java,169,0,0,45,0,45
 kafka-trunk\kafka-trunk\connect\runtime\src\test\java\org\apache\kafka\connect\runtime\TransformationConfigTest.java,169,0,0,23,12,35
 kafka-trunk\kafka-trunk\metadata\src\main\java\org\apache\kafka\controller\AclControlManager.java,169,0,4,20,1,25
 kafka-trunk\kafka-trunk\metadata\src\test\java\org\apache\kafka\metadata\authorizer\ClusterMetadataAuthorizerTest.java,169,0,4,39,0,43
 kafka-trunk\kafka-trunk\streams\src\test\java\org\apache\kafka\streams\integration\AbstractJoinIntegrationTest.java,169,0,3,37,1,41
 pulsar-master\pulsar-master\pulsar-metadata\src\main\java\org\apache\pulsar\metadata\api\MetadataStoreException.java,169,51,0,5,0,56
 pulsar-master\pulsar-master\pulsar-broker\src\test\java\org\apache\pulsar\client\processor\MessagePayloadProcessorTest.java,169,44,0,21,0,65
 pulsar-master\pulsar-master\pulsar-broker\src\test\java\org\apache\pulsar\client\impl\PulsarTestClient.java,169,69,5,41,0,115
 pulsar-master\pulsar-master\pulsar-client-tools\src\main\java\org\apache\pulsar\admin\cli\CmdBrokers.java,169,31,0,21,0,52
 pulsar-master\pulsar-master\pulsar-broker\src\test\java\org\apache\pulsar\broker\loadbalance\impl\OverloadShedderTest.java,169,59,0,9,0,68
 pulsar-master\pulsar-master\pulsar-broker\src\main\java\org\apache\pulsar\broker\admin\impl\PackagesBase.java,169,105,7,48,0,160
 rocketmq-develop\rocketmq-develop\tools\src\main\java\org\apache\rocketmq\tools\command\stats\StatsAllSubCommand.java,169,30,7,15,9,61
 rocketmq-develop\rocketmq-develop\store\src\test\java\org\apache\rocketmq\store\dledger\MixCommitlogTest.java,169,99,0,40,3,142
 shardingsphere-master\shardingsphere-master\shardingsphere-kernel\shardingsphere-data-pipeline\shardingsphere-data-pipeline-core\src\main\java\org\apache\shardingsphere\data\pipeline\core\importer\AbstractImporter.java,169,63,3,35,0,101
 zookeeper-master\zookeeper-master\zookeeper-server\src\test\java\org\apache\zookeeper\test\SessionUpgradeTest.java,169,0,19,20,0,39
 zookeeper-master\zookeeper-master\zookeeper-server\src\main\java\org\apache\zookeeper\common\SSLContextAndOptions.java,169,0,6,27,5,38
 zookeeper-master\zookeeper-master\zookeeper-server\src\main\java\org\apache\zookeeper\server\util\JvmPauseMonitor.java,169,0,4,17,0,21
 dubbo-3.0\dubbo-3.0\dubbo-spring-boot\dubbo-spring-boot-compatible\autoconfigure\src\main\java\org\apache\dubbo\spring\boot\context\event\AwaitingNonWebApplicationListener.java,170,56,1,23,0,80
 dubbo-3.0\dubbo-3.0\dubbo-common\src\main\java\org\apache\dubbo\common\threadlocal\InternalThreadLocal.java,170,36,1,20,0,57
 dubbo-3.0\dubbo-3.0\dubbo-remoting\dubbo-remoting-api\src\test\java\org\apache\dubbo\remoting\exchange\support\DefaultFutureTest.java,170,49,2,22,1,74
 hadoop-trunk\hadoop-trunk\hadoop-hdfs-project\hadoop-hdfs\src\test\java\org\apache\hadoop\hdfs\server\datanode\checker\TestThrottledAsyncCheckerTimeout.java,170,29,8,4,3,44
 hadoop-trunk\hadoop-trunk\hadoop-tools\hadoop-aws\src\test\java\org\apache\hadoop\fs\s3a\auth\delegation\AbstractDelegationIT.java,170,13,0,4,0,17
 hadoop-trunk\hadoop-trunk\hadoop-yarn-project\hadoop-yarn\hadoop-yarn-common\src\main\java\org\apache\hadoop\yarn\api\records\impl\pb\SerializedExceptionPBImpl.java,170,41,50,2,0,93
 hadoop-trunk\hadoop-trunk\hadoop-tools\hadoop-rumen\src\main\java\org\apache\hadoop\tools\rumen\DeskewedJobTraceReader.java,170,32,5,2,0,39
 hadoop-trunk\hadoop-trunk\hadoop-yarn-project\hadoop-yarn\hadoop-yarn-server\hadoop-yarn-server-nodemanager\src\test\java\org\apache\hadoop\yarn\server\nodemanager\util\TestNodeManagerHardwareUtils.java,170,37,0,1,0,38
 hadoop-trunk\hadoop-trunk\hadoop-hdfs-project\hadoop-hdfs\src\test\java\org\apache\hadoop\hdfs\server\namenode\TestCommitBlockSynchronization.java,170,15,6,1,5,27
 hadoop-trunk\hadoop-trunk\hadoop-yarn-project\hadoop-yarn\hadoop-yarn-applications\hadoop-yarn-applications-unmanaged-am-launcher\src\test\java\org\apache\hadoop\yarn\applications\unmanagedamlauncher\TestUnmanagedAMLauncher.java,170,27,16,6,8,57
 hadoop-trunk\hadoop-trunk\hadoop-yarn-project\hadoop-yarn\hadoop-yarn-server\hadoop-yarn-server-resourcemanager\src\main\java\org\apache\hadoop\yarn\server\resourcemanager\webapp\dao\CapacitySchedulerInfo.java,170,86,5,9,4,104
 hadoop-trunk\hadoop-trunk\hadoop-yarn-project\hadoop-yarn\hadoop-yarn-api\src\main\java\org\apache\hadoop\yarn\api\records\ResourceTypeInfo.java,170,15,0,1,0,16
 kafka-trunk\kafka-trunk\clients\src\generated\java\org\apache\kafka\common\message\EnvelopeResponseData.java,170,0,0,10,3,13
 kafka-trunk\kafka-trunk\clients\src\generated\java\org\apache\kafka\common\message\DescribeDelegationTokenResponseDataJsonConverter.java,170,0,0,46,0,46
 pulsar-master\pulsar-master\pulsar-broker\src\main\java\org\apache\pulsar\common\naming\NamespaceBundles.java,170,75,4,15,0,94
 rocketmq-develop\rocketmq-develop\namesrv\src\main\java\org\apache\rocketmq\namesrv\kvconfig\KVConfigManager.java,170,43,5,20,2,70
 zookeeper-master\zookeeper-master\zookeeper-server\src\test\java\org\apache\zookeeper\GetEphemeralsTest.java,170,0,7,29,0,36
 dubbo-3.0\dubbo-3.0\dubbo-config\dubbo-config-api\src\test\java\org\apache\dubbo\config\AbstractReferenceConfigTest.java,171,25,0,14,0,39
 hadoop-trunk\hadoop-trunk\hadoop-yarn-project\hadoop-yarn\hadoop-yarn-server\hadoop-yarn-server-applicationhistoryservice\src\test\java\org\apache\hadoop\yarn\server\applicationhistoryservice\TestMemoryApplicationHistoryStore.java,171,12,0,4,0,16
 hadoop-trunk\hadoop-trunk\hadoop-yarn-project\hadoop-yarn\hadoop-yarn-server\hadoop-yarn-server-resourcemanager\src\main\java\org\apache\hadoop\yarn\server\resourcemanager\scheduler\capacity\conf\QueueCapacityConfigParser.java,171,28,0,9,0,37
 hadoop-trunk\hadoop-trunk\hadoop-hdfs-project\hadoop-hdfs\src\test\java\org\apache\hadoop\hdfs\qjournal\TestSecureNNWithQJM.java,171,23,3,17,0,43
 hadoop-trunk\hadoop-trunk\hadoop-hdfs-project\hadoop-hdfs\src\test\java\org\apache\hadoop\hdfs\server\datanode\fsdataset\impl\TestDatanodeRestart.java,171,49,12,3,4,68
 hadoop-trunk\hadoop-trunk\hadoop-hdfs-project\hadoop-hdfs-httpfs\src\main\java\org\apache\hadoop\lib\util\Check.java,171,36,1,10,0,47
 hadoop-trunk\hadoop-trunk\hadoop-yarn-project\hadoop-yarn\hadoop-yarn-server\hadoop-yarn-server-common\src\test\java\org\apache\hadoop\yarn\server\federation\policies\TestRouterPolicyFacade.java,171,18,4,12,3,37
 hadoop-trunk\hadoop-trunk\hadoop-yarn-project\hadoop-yarn\hadoop-yarn-server\hadoop-yarn-server-nodemanager\src\test\java\org\apache\hadoop\yarn\server\nodemanager\containermanager\resourceplugin\gpu\TestNvidiaDockerV1CommandPlugin.java,171,15,15,8,2,40
 hadoop-trunk\hadoop-trunk\hadoop-mapreduce-project\hadoop-mapreduce-client\hadoop-mapreduce-client-common\src\main\java\org\apache\hadoop\mapreduce\v2\api\records\impl\pb\AMInfoPBImpl.java,171,44,65,1,0,110
 hadoop-trunk\hadoop-trunk\hadoop-mapreduce-project\hadoop-mapreduce-client\hadoop-mapreduce-client-core\src\main\java\org\apache\hadoop\mapred\PeriodicStatsAccumulator.java,171,44,1,1,0,46
 hadoop-trunk\hadoop-trunk\hadoop-yarn-project\hadoop-yarn\hadoop-yarn-server\hadoop-yarn-server-resourcemanager\src\main\java\org\apache\hadoop\yarn\server\resourcemanager\webapp\FairSchedulerAppsBlock.java,171,34,0,6,2,42
 hadoop-trunk\hadoop-trunk\hadoop-common-project\hadoop-common\src\test\java\org\apache\hadoop\metrics2\impl\TestGraphiteMetrics.java,171,42,14,13,0,69
 hadoop-trunk\hadoop-trunk\hadoop-yarn-project\hadoop-yarn\hadoop-yarn-server\hadoop-yarn-server-resourcemanager\src\test\java\org\apache\hadoop\yarn\server\resourcemanager\scheduler\fair\TestMaxRunningAppsEnforcer.java,171,36,0,7,0,43
 hadoop-trunk\hadoop-trunk\hadoop-tools\hadoop-aws\src\test\java\org\apache\hadoop\fs\s3a\commit\staging\integration\ITestStagingCommitProtocol.java,171,34,1,2,0,37
 hadoop-trunk\hadoop-trunk\hadoop-yarn-project\hadoop-yarn\hadoop-yarn-server\hadoop-yarn-server-applicationhistoryservice\src\test\java\org\apache\hadoop\yarn\server\timeline\recovery\TestLeveldbTimelineStateStore.java,171,17,7,4,4,32
 hadoop-trunk\hadoop-trunk\hadoop-yarn-project\hadoop-yarn\hadoop-yarn-client\src\test\java\org\apache\hadoop\yarn\client\TestApplicationClientProtocolOnHA.java,171,24,0,1,1,26
 hadoop-trunk\hadoop-trunk\hadoop-yarn-project\hadoop-yarn\hadoop-yarn-api\src\main\java\org\apache\hadoop\yarn\api\records\LocalResource.java,171,55,0,3,0,58
 hadoop-trunk\hadoop-trunk\hadoop-yarn-project\hadoop-yarn\hadoop-yarn-server\hadoop-yarn-server-applicationhistoryservice\src\main\java\org\apache\hadoop\yarn\server\applicationhistoryservice\ApplicationHistoryClientService.java,171,33,11,6,0,50
 hadoop-trunk\hadoop-trunk\hadoop-hdfs-project\hadoop-hdfs-rbf\src\test\java\org\apache\hadoop\hdfs\server\federation\fairness\TestRouterRpcFairnessPolicyController.java,171,47,1,5,0,53
 kafka-trunk\kafka-trunk\streams\src\test\java\org\apache\kafka\streams\state\internals\ChangeLoggingWindowBytesStoreTest.java,171,0,0,17,0,17
 kafka-trunk\kafka-trunk\streams\src\test\java\org\apache\kafka\streams\kstream\internals\SuppressTopologyTest.java,171,0,0,24,0,24
 pulsar-master\pulsar-master\pulsar-broker\src\test\java\org\apache\pulsar\io\PulsarSourceE2ETest.java,171,58,3,40,0,101
 pulsar-master\pulsar-master\pulsar-common\src\main\java\org\apache\pulsar\common\util\FutureUtil.java,171,61,1,36,0,98
 pulsar-master\pulsar-master\pulsar-io\kinesis\src\main\java\org\apache\pulsar\io\kinesis\json\JsonConverter.java,171,53,2,22,0,77
 zookeeper-master\zookeeper-master\zookeeper-server\src\test\java\org\apache\zookeeper\client\ZKClientConfigTest.java,171,0,11,9,4,24
 zookeeper-master\zookeeper-master\zookeeper-server\src\test\java\org\apache\zookeeper\test\ClientSSLTest.java,171,0,5,38,0,43
 dubbo-3.0\dubbo-3.0\dubbo-monitor\dubbo-monitor-api\src\test\java\org\apache\dubbo\monitor\support\MonitorFilterTest.java,172,47,4,27,0,78
 hadoop-trunk\hadoop-trunk\hadoop-hdfs-project\hadoop-hdfs\src\test\java\org\apache\hadoop\hdfs\TestFileAppendRestart.java,172,55,0,3,0,58
 hadoop-trunk\hadoop-trunk\hadoop-common-project\hadoop-common\src\test\java\org\apache\hadoop\metrics2\lib\TestMetricsAnnotations.java,172,85,6,1,0,92
 hadoop-trunk\hadoop-trunk\hadoop-mapreduce-project\hadoop-mapreduce-client\hadoop-mapreduce-client-common\src\main\java\org\apache\hadoop\mapreduce\v2\api\records\impl\pb\CounterGroupPBImpl.java,172,57,57,4,0,118
 hadoop-trunk\hadoop-trunk\hadoop-mapreduce-project\hadoop-mapreduce-client\hadoop-mapreduce-client-jobclient\src\test\java\org\apache\hadoop\mapred\TestLocalJobSubmission.java,172,13,11,1,4,29
 hadoop-trunk\hadoop-trunk\hadoop-hdfs-project\hadoop-hdfs-rbf\src\test\java\org\apache\hadoop\hdfs\server\federation\router\TestRouterNetworkTopologyServlet.java,172,25,1,3,1,30
 hadoop-trunk\hadoop-trunk\hadoop-hdfs-project\hadoop-hdfs\src\test\java\org\apache\hadoop\hdfs\server\namenode\ha\TestEditLogsDuringFailover.java,172,37,6,5,17,65
 hadoop-trunk\hadoop-trunk\hadoop-mapreduce-project\hadoop-mapreduce-client\hadoop-mapreduce-client-app\src\main\java\org\apache\hadoop\mapreduce\v2\app\speculate\StartEndTimesBase.java,172,31,1,2,0,34
 hadoop-trunk\hadoop-trunk\hadoop-yarn-project\hadoop-yarn\hadoop-yarn-server\hadoop-yarn-server-resourcemanager\src\test\java\org\apache\hadoop\yarn\server\resourcemanager\scheduler\constraint\TestAllocationTagsNamespace.java,172,15,5,1,5,26
 hadoop-trunk\hadoop-trunk\hadoop-hdfs-project\hadoop-hdfs\src\test\java\org\apache\hadoop\hdfs\server\namenode\TestStoragePolicySummary.java,172,148,0,8,0,156
 hadoop-trunk\hadoop-trunk\hadoop-yarn-project\hadoop-yarn\hadoop-yarn-applications\hadoop-yarn-services\hadoop-yarn-services-core\src\main\java\org\apache\hadoop\yarn\service\utils\PublishedConfigurationOutputter.java,172,44,0,3,1,48
 hadoop-trunk\hadoop-trunk\hadoop-hdfs-project\hadoop-hdfs-client\src\main\java\org\apache\hadoop\hdfs\DFSOpsCountStatistics.java,172,95,0,1,0,96
 hadoop-trunk\hadoop-trunk\hadoop-common-project\hadoop-registry\src\test\java\org\apache\hadoop\registry\secure\TestRegistrySecurityHelper.java,172,45,3,1,0,49
 hadoop-trunk\hadoop-trunk\hadoop-yarn-project\hadoop-yarn\hadoop-yarn-server\hadoop-yarn-server-common\src\main\java\org\apache\hadoop\yarn\server\utils\LeveldbIterator.java,172,17,0,1,0,18
 hadoop-trunk\hadoop-trunk\hadoop-mapreduce-project\hadoop-mapreduce-client\hadoop-mapreduce-client-jobclient\src\test\java\org\apache\hadoop\mapreduce\lib\output\TestMRSequenceFileAsBinaryOutputFormat.java,172,40,1,2,4,47
 hadoop-trunk\hadoop-trunk\hadoop-hdfs-project\hadoop-hdfs\src\test\java\org\apache\hadoop\hdfs\server\namenode\TestDeadDatanode.java,172,38,5,3,0,46
 hadoop-trunk\hadoop-trunk\hadoop-hdfs-project\hadoop-hdfs-rbf\src\main\java\org\apache\hadoop\hdfs\server\federation\router\ErasureCoding.java,172,35,1,4,1,41
 hadoop-trunk\hadoop-trunk\hadoop-mapreduce-project\hadoop-mapreduce-examples\src\main\java\org\apache\hadoop\examples\WordMedian.java,172,31,4,2,0,37
 kafka-trunk\kafka-trunk\streams\src\test\java\org\apache\kafka\streams\processor\internals\ChangelogTopicsTest.java,172,0,0,67,0,67
 kafka-trunk\kafka-trunk\streams\src\test\java\org\apache\kafka\streams\processor\internals\CopartitionedTopicsEnforcerTest.java,172,0,0,37,0,37
 kafka-trunk\kafka-trunk\storage\src\main\java\org\apache\kafka\server\log\remote\metadata\storage\RemoteLogSegmentMetadataSnapshot.java,172,0,2,26,0,28
 pulsar-master\pulsar-master\pulsar-client\src\main\java\org\apache\pulsar\client\impl\MultiTopicsReaderImpl.java,172,58,1,22,0,81
 pulsar-master\pulsar-master\pulsar-broker\src\test\java\org\apache\pulsar\broker\service\persistent\ReplicatedSubscriptionsSnapshotBuilderTest.java,172,48,1,15,0,64
 pulsar-master\pulsar-master\pulsar-broker\src\test\java\org\apache\pulsar\websocket\proxy\ProxyAuthenticationTest.java,172,44,5,20,0,69
 rocketmq-develop\rocketmq-develop\broker\src\test\java\org\apache\rocketmq\broker\processor\PullMessageProcessorTest.java,172,76,8,39,0,123
 skywalking-master\skywalking-master\oap-server\server-storage-plugin\storage-influxdb-plugin\src\main\java\org\apache\skywalking\oap\server\storage\plugin\influxdb\query\TraceQuery.java,172,54,1,23,0,78
 dubbo-3.0\dubbo-3.0\dubbo-cluster\src\main\java\org\apache\dubbo\rpc\cluster\loadbalance\ConsistentHashLoadBalance.java,173,72,2,19,0,93
 hadoop-trunk\hadoop-trunk\hadoop-mapreduce-project\hadoop-mapreduce-client\hadoop-mapreduce-client-common\src\test\java\org\apache\hadoop\mapreduce\TestTypeConverter.java,173,51,10,19,2,82
 hadoop-trunk\hadoop-trunk\hadoop-hdfs-project\hadoop-hdfs\src\test\java\org\apache\hadoop\hdfs\server\datanode\TestDatanodeProtocolRetryPolicy.java,173,31,4,1,3,39
 hadoop-trunk\hadoop-trunk\hadoop-common-project\hadoop-common\src\main\java\org\apache\hadoop\io\retry\RetryUtils.java,173,41,4,1,0,46
 hadoop-trunk\hadoop-trunk\hadoop-mapreduce-project\hadoop-mapreduce-examples\src\main\java\org\apache\hadoop\examples\WordStandardDeviation.java,173,38,5,2,0,45
 hadoop-trunk\hadoop-trunk\hadoop-yarn-project\hadoop-yarn\hadoop-yarn-server\hadoop-yarn-server-resourcemanager\src\main\java\org\apache\hadoop\yarn\server\resourcemanager\security\RMDelegationTokenSecretManager.java,173,33,5,3,0,41
 hadoop-trunk\hadoop-trunk\hadoop-yarn-project\hadoop-yarn\hadoop-yarn-server\hadoop-yarn-server-nodemanager\src\test\java\org\apache\hadoop\yarn\server\nodemanager\nodelabels\TestScriptBasedNodeLabelsProvider.java,173,22,0,1,0,23
 hadoop-trunk\hadoop-trunk\hadoop-yarn-project\hadoop-yarn\hadoop-yarn-server\hadoop-yarn-server-resourcemanager\src\test\java\org\apache\hadoop\yarn\server\resourcemanager\webapp\TestNodesPage.java,173,29,15,3,6,53
 hadoop-trunk\hadoop-trunk\hadoop-common-project\hadoop-common\src\main\java\org\apache\hadoop\util\ProtoUtil.java,173,57,38,4,0,99
 hadoop-trunk\hadoop-trunk\hadoop-common-project\hadoop-common\src\test\java\org\apache\hadoop\test\MultithreadedTestUtil.java,173,27,6,1,5,39
 hadoop-trunk\hadoop-trunk\hadoop-mapreduce-project\hadoop-mapreduce-client\hadoop-mapreduce-client-core\src\main\java\org\apache\hadoop\mapreduce\split\JobSplit.java,173,123,2,2,7,134
 hadoop-trunk\hadoop-trunk\hadoop-common-project\hadoop-common\src\test\java\org\apache\hadoop\fs\TestCommandFormat.java,173,58,1,1,22,82
 hadoop-trunk\hadoop-trunk\hadoop-yarn-project\hadoop-yarn\hadoop-yarn-server\hadoop-yarn-server-applicationhistoryservice\src\main\java\org\apache\hadoop\yarn\server\applicationhistoryservice\records\impl\pb\ContainerFinishDataPBImpl.java,173,40,60,4,0,104
 hadoop-trunk\hadoop-trunk\hadoop-yarn-project\hadoop-yarn\hadoop-yarn-server\hadoop-yarn-server-applicationhistoryservice\src\main\java\org\apache\hadoop\yarn\server\timeline\security\TimelineV1DelegationTokenSecretManagerService.java,173,38,11,4,1,54
 hadoop-trunk\hadoop-trunk\hadoop-yarn-project\hadoop-yarn\hadoop-yarn-common\src\main\java\org\apache\hadoop\yarn\api\records\impl\pb\ReservationRequestsPBImpl.java,173,32,55,3,0,90
 kafka-trunk\kafka-trunk\clients\src\test\java\org\apache\kafka\common\security\oauthbearer\internals\OAuthBearerSaslServerTest.java,173,0,3,44,1,48
 kafka-trunk\kafka-trunk\metadata\src\generated\java\org\apache\kafka\common\metadata\TopicRecord.java,173,0,0,10,3,13
 kafka-trunk\kafka-trunk\raft\src\main\java\org\apache\kafka\raft\internals\KafkaRaftMetrics.java,173,0,0,35,1,36
 kafka-trunk\kafka-trunk\clients\src\test\java\org\apache\kafka\common\requests\FetchRequestTest.java,173,0,0,52,0,52
 pulsar-master\pulsar-master\pulsar-broker\src\test\java\org\apache\pulsar\websocket\proxy\v1\V1_ProxyAuthenticationTest.java,173,46,6,20,0,72
 pulsar-master\pulsar-master\pulsar-broker\src\test\java\org\apache\pulsar\broker\admin\AdminApiMaxUnackedMessages.java,173,71,0,35,0,106
 shardingsphere-master\shardingsphere-master\shardingsphere-jdbc\shardingsphere-jdbc-core\src\main\java\org\apache\shardingsphere\driver\jdbc\adapter\AbstractStatementAdapter.java,173,63,3,35,0,101
 skywalking-master\skywalking-master\oap-server\server-storage-plugin\storage-iotdb-plugin\src\main\java\org\apache\skywalking\oap\server\storage\plugin\iotdb\query\IoTDBEventQueryDAO.java,173,32,0,27,0,59
 zookeeper-master\zookeeper-master\zookeeper-server\src\main\java\org\apache\zookeeper\server\DataNode.java,173,0,23,7,0,30
 dubbo-3.0\dubbo-3.0\dubbo-metadata\dubbo-metadata-processor\src\test\java\org\apache\dubbo\metadata\annotation\processing\util\AnnotationUtilsTest.java,174,46,1,42,0,89
 hadoop-trunk\hadoop-trunk\hadoop-mapreduce-project\hadoop-mapreduce-client\hadoop-mapreduce-client-core\src\main\java\org\apache\hadoop\mapred\FileOutputCommitter.java,174,88,11,7,0,106
 hadoop-trunk\hadoop-trunk\hadoop-hdfs-project\hadoop-hdfs\src\test\java\org\apache\hadoop\hdfs\server\namenode\sps\TestBlockStorageMovementAttemptedItems.java,174,28,11,2,6,47
 hadoop-trunk\hadoop-trunk\hadoop-yarn-project\hadoop-yarn\hadoop-yarn-server\hadoop-yarn-server-resourcemanager\src\test\java\org\apache\hadoop\yarn\server\resourcemanager\applicationsmanager\TestASMStateMachine.java,174,8,0,12,0,20
 hadoop-trunk\hadoop-trunk\hadoop-yarn-project\hadoop-yarn\hadoop-yarn-server\hadoop-yarn-server-resourcemanager\src\main\java\org\apache\hadoop\yarn\server\resourcemanager\scheduler\AbstractResourceUsage.java,174,55,5,2,0,62
 hadoop-trunk\hadoop-trunk\hadoop-yarn-project\hadoop-yarn\hadoop-yarn-common\src\main\java\org\apache\hadoop\yarn\api\records\impl\pb\LogAggregationContextPBImpl.java,174,44,56,3,0,103
 hadoop-trunk\hadoop-trunk\hadoop-common-project\hadoop-common\src\main\java\org\apache\hadoop\metrics2\util\SampleStat.java,174,57,5,1,0,63
 hadoop-trunk\hadoop-trunk\hadoop-common-project\hadoop-common\src\main\java\org\apache\hadoop\fs\LocatedFileStatus.java,174,73,15,1,3,92
 hadoop-trunk\hadoop-trunk\hadoop-yarn-project\hadoop-yarn\hadoop-yarn-server\hadoop-yarn-server-timelineservice-documentstore\src\main\java\org\apache\hadoop\yarn\server\timelineservice\documentstore\reader\TimelineCollectionReader.java,174,18,3,10,0,31
 hadoop-trunk\hadoop-trunk\hadoop-mapreduce-project\hadoop-mapreduce-client\hadoop-mapreduce-client-core\src\main\java\org\apache\hadoop\mapreduce\lib\fieldsel\FieldSelectionHelper.java,174,72,2,7,7,88
 hadoop-trunk\hadoop-trunk\hadoop-mapreduce-project\hadoop-mapreduce-client\hadoop-mapreduce-client-jobclient\src\main\java\org\apache\hadoop\mapred\NotRunningJob.java,174,38,4,18,0,60
 hadoop-trunk\hadoop-trunk\hadoop-yarn-project\hadoop-yarn\hadoop-yarn-server\hadoop-yarn-server-resourcemanager\src\test\java\org\apache\hadoop\yarn\server\resourcemanager\applicationsmanager\TestAMLaunchFailure.java,174,11,3,14,0,28
 kafka-trunk\kafka-trunk\clients\src\generated\java\org\apache\kafka\common\message\DescribeTransactionsRequestData.java,174,0,0,22,3,25
 kafka-trunk\kafka-trunk\clients\src\generated\java\org\apache\kafka\common\message\FetchSnapshotRequestDataJsonConverter.java,174,0,0,40,0,40
 pulsar-master\pulsar-master\pulsar-broker-common\src\main\java\org\apache\pulsar\common\configuration\PulsarConfigurationLoader.java,174,57,7,32,0,96
 pulsar-master\pulsar-master\pulsar-functions\runtime\src\main\java\org\apache\pulsar\functions\runtime\thread\ThreadRuntimeFactory.java,174,121,3,40,0,164
 rocketmq-develop\rocketmq-develop\common\src\main\java\org\apache\rocketmq\common\protocol\header\SendMessageRequestHeaderV2.java,174,95,1,14,0,110
 rocketmq-develop\rocketmq-develop\remoting\src\main\java\org\apache\rocketmq\remoting\netty\TlsHelper.java,174,48,4,62,1,115
 rocketmq-develop\rocketmq-develop\tools\src\main\java\org\apache\rocketmq\tools\command\cluster\CLusterSendMsgRTCommand.java,174,39,5,21,3,68
 zookeeper-master\zookeeper-master\zookeeper-server\src\test\java\org\apache\zookeeper\server\FinalRequestProcessorTest.java,174,0,77,37,0,114
 dubbo-3.0\dubbo-3.0\dubbo-config\dubbo-config-spring\src\test\java\org\apache\dubbo\config\spring\beans\factory\annotation\ReferenceCreatorTest.java,175,54,1,26,0,81
 hadoop-trunk\hadoop-trunk\hadoop-hdfs-project\hadoop-hdfs\src\test\java\org\apache\hadoop\hdfs\client\impl\TestBlockReaderLocalLegacy.java,175,35,9,5,0,49
 hadoop-trunk\hadoop-trunk\hadoop-hdfs-project\hadoop-hdfs\src\test\java\org\apache\hadoop\hdfs\server\blockmanagement\TestBlockReportRateLimiting.java,175,47,9,6,3,65
 hadoop-trunk\hadoop-trunk\hadoop-yarn-project\hadoop-yarn\hadoop-yarn-server\hadoop-yarn-server-nodemanager\src\main\java\org\apache\hadoop\yarn\server\nodemanager\NMAuditLogger.java,175,102,1,6,0,109
 hadoop-trunk\hadoop-trunk\hadoop-yarn-project\hadoop-yarn\hadoop-yarn-server\hadoop-yarn-server-nodemanager\src\main\java\org\apache\hadoop\yarn\server\nodemanager\containermanager\linux\resources\numa\NumaNodeResource.java,175,35,3,2,0,40
 hadoop-trunk\hadoop-trunk\hadoop-yarn-project\hadoop-yarn\hadoop-yarn-api\src\main\java\org\apache\hadoop\yarn\api\records\ReservationRequest.java,175,34,8,1,0,43
 hadoop-trunk\hadoop-trunk\hadoop-hdfs-project\hadoop-hdfs-client\src\main\java\org\apache\hadoop\hdfs\protocol\SnapshotStatus.java,175,40,2,1,6,49
 hadoop-trunk\hadoop-trunk\hadoop-tools\hadoop-streaming\src\main\java\org\apache\hadoop\typedbytes\TypedBytesWritableOutput.java,175,68,5,2,1,76
 kafka-trunk\kafka-trunk\clients\src\generated\java\org\apache\kafka\common\message\AddOffsetsToTxnResponseData.java,175,0,0,13,1,14
 kafka-trunk\kafka-trunk\metadata\src\test\java\org\apache\kafka\controller\ClusterControlManagerTest.java,175,0,1,23,0,24
 kafka-trunk\kafka-trunk\clients\src\test\java\org\apache\kafka\common\requests\LeaderAndIsrRequestTest.java,175,0,1,25,0,26
 kafka-trunk\kafka-trunk\clients\src\generated\java\org\apache\kafka\common\message\EndTxnResponseData.java,175,0,0,12,1,13
 kafka-trunk\kafka-trunk\connect\runtime\src\test\java\org\apache\kafka\connect\util\LoggingContextTest.java,175,0,0,21,3,24
 kafka-trunk\kafka-trunk\clients\src\generated\java\org\apache\kafka\common\message\AlterClientQuotasRequestDataJsonConverter.java,175,0,0,35,0,35
 pulsar-master\pulsar-master\pulsar-broker\src\test\java\org\apache\pulsar\client\impl\AdminApiKeyStoreTlsAuthTest.java,175,71,11,27,0,109
 pulsar-master\pulsar-master\pulsar-client-admin-api\src\main\java\org\apache\pulsar\common\policies\data\Policies.java,175,164,1,46,0,211
 rocketmq-develop\rocketmq-develop\client\src\main\java\org\apache\rocketmq\client\consumer\MQPullConsumerScheduleService.java,175,78,3,19,7,107
 rocketmq-develop\rocketmq-develop\common\src\main\java\org\apache\rocketmq\common\protocol\RequestCode.java,175,96,0,2,0,98
 shardingsphere-master\shardingsphere-master\shardingsphere-proxy\shardingsphere-proxy-backend\src\main\java\org\apache\shardingsphere\proxy\backend\communication\DatabaseCommunicationEngine.java,175,99,0,55,0,154
 dubbo-3.0\dubbo-3.0\dubbo-cluster\src\test\java\org\apache\dubbo\rpc\cluster\router\mesh\rule\virtualservice\match\DubboAttachmentMatchTest.java,176,26,0,24,0,50
 hadoop-trunk\hadoop-trunk\hadoop-tools\hadoop-streaming\src\main\java\org\apache\hadoop\streaming\JarBuilder.java,176,53,25,7,1,86
 hadoop-trunk\hadoop-trunk\hadoop-yarn-project\hadoop-yarn\hadoop-yarn-server\hadoop-yarn-server-nodemanager\src\main\java\org\apache\hadoop\yarn\server\nodemanager\containermanager\localizer\LocalCacheDirectoryManager.java,176,27,2,2,0,31
 hadoop-trunk\hadoop-trunk\hadoop-tools\hadoop-aws\src\test\java\org\apache\hadoop\fs\s3a\performance\ITestS3ARenameCost.java,176,8,5,1,0,14
 hadoop-trunk\hadoop-trunk\hadoop-common-project\hadoop-common\src\main\java\org\apache\hadoop\fs\FsShellPermissions.java,176,83,8,5,0,96
 hadoop-trunk\hadoop-trunk\hadoop-yarn-project\hadoop-yarn\hadoop-yarn-api\src\main\java\org\apache\hadoop\yarn\api\records\UpdateContainerRequest.java,176,20,0,2,0,22
 hadoop-trunk\hadoop-trunk\hadoop-common-project\hadoop-common\src\test\java\org\apache\hadoop\io\file\tfile\TestTFileUnsortedByteArrays.java,176,39,6,1,20,66
 hadoop-trunk\hadoop-trunk\hadoop-tools\hadoop-resourceestimator\src\main\java\org\apache\hadoop\resourceestimator\solver\preprocess\SolverPreprocessor.java,176,7,8,5,0,20
 hadoop-trunk\hadoop-trunk\hadoop-common-project\hadoop-common\src\test\java\org\apache\hadoop\service\launcher\TestServiceLauncher.java,176,25,5,7,0,37
 hadoop-trunk\hadoop-trunk\hadoop-hdfs-project\hadoop-hdfs\src\test\java\org\apache\hadoop\hdfs\server\datanode\fsdataset\TestRoundRobinVolumeChoosingPolicy.java,176,35,3,3,0,41
 hadoop-trunk\hadoop-trunk\hadoop-mapreduce-project\hadoop-mapreduce-client\hadoop-mapreduce-client-jobclient\src\test\java\org\apache\hadoop\mapred\HadoopTestCase.java,176,30,8,7,0,45
 hadoop-trunk\hadoop-trunk\hadoop-yarn-project\hadoop-yarn\hadoop-yarn-server\hadoop-yarn-server-resourcemanager\src\test\java\org\apache\hadoop\yarn\server\resourcemanager\RMHATestBase.java,176,51,1,3,4,59
 hadoop-trunk\hadoop-trunk\hadoop-yarn-project\hadoop-yarn\hadoop-yarn-server\hadoop-yarn-server-applicationhistoryservice\src\main\java\org\apache\hadoop\yarn\server\applicationhistoryservice\records\impl\pb\ApplicationAttemptStartDataPBImpl.java,176,41,58,5,0,104
 hadoop-trunk\hadoop-trunk\hadoop-hdfs-project\hadoop-hdfs-client\src\main\java\org\apache\hadoop\hdfs\web\URLConnectionFactory.java,176,40,0,1,0,41
 hadoop-trunk\hadoop-trunk\hadoop-yarn-project\hadoop-yarn\hadoop-yarn-server\hadoop-yarn-server-resourcemanager\src\test\java\org\apache\hadoop\yarn\server\resourcemanager\recovery\TestLeveldbRMStateStore.java,176,38,0,1,0,39
 kafka-trunk\kafka-trunk\clients\src\main\java\org\apache\kafka\common\requests\WriteTxnMarkersRequest.java,176,0,68,20,3,91
 kafka-trunk\kafka-trunk\streams\examples\src\main\java\org\apache\kafka\streams\examples\pageview\PageViewTypedDemo.java,176,0,5,41,10,56
 kafka-trunk\kafka-trunk\clients\src\main\java\org\apache\kafka\common\KafkaFuture.java,176,0,1,43,0,44
 pulsar-master\pulsar-master\pulsar-broker\src\test\java\org\apache\pulsar\broker\service\persistent\MessageRedeliveryControllerTest.java,176,103,2,20,0,125
 skywalking-master\skywalking-master\oap-server\server-configuration\configuration-api\src\test\java\org\apache\skywalking\oap\server\configuration\api\ConfigWatcherRegisterTest.java,176,43,6,23,7,79
 zookeeper-master\zookeeper-master\zookeeper-server\src\test\java\org\apache\zookeeper\server\util\CircularBufferTest.java,176,0,2,6,1,9
 hadoop-trunk\hadoop-trunk\hadoop-tools\hadoop-aws\src\test\java\org\apache\hadoop\fs\s3a\TestS3AExceptionTranslation.java,177,46,9,1,0,56
 hadoop-trunk\hadoop-trunk\hadoop-common-project\hadoop-common\src\main\java\org\apache\hadoop\security\SaslOutputStream.java,177,37,1,1,2,41
 hadoop-trunk\hadoop-trunk\hadoop-tools\hadoop-azure\src\main\java\org\apache\hadoop\fs\azure\SecureWasbRemoteCallHelper.java,177,19,5,3,0,27
 hadoop-trunk\hadoop-trunk\hadoop-yarn-project\hadoop-yarn\hadoop-yarn-server\hadoop-yarn-server-resourcemanager\src\main\java\org\apache\hadoop\yarn\server\resourcemanager\reservation\InMemoryReservationAllocation.java,177,79,4,2,6,91
 hadoop-trunk\hadoop-trunk\hadoop-common-project\hadoop-common\src\main\java\org\apache\hadoop\io\erasurecode\rawcoder\RawErasureDecoder.java,177,19,0,2,0,21
 hadoop-trunk\hadoop-trunk\hadoop-yarn-project\hadoop-yarn\hadoop-yarn-server\hadoop-yarn-server-router\src\test\java\org\apache\hadoop\yarn\server\router\clientrm\TestRouterYarnClientUtils.java,177,31,0,1,0,32
 hadoop-trunk\hadoop-trunk\hadoop-common-project\hadoop-common\src\test\java\org\apache\hadoop\util\TestReflectionUtils.java,177,59,17,5,3,84
 hadoop-trunk\hadoop-trunk\hadoop-yarn-project\hadoop-yarn\hadoop-yarn-server\hadoop-yarn-server-resourcemanager\src\test\java\org\apache\hadoop\yarn\server\resourcemanager\reservation\TestInMemoryReservationAllocation.java,177,60,5,2,0,67
 hadoop-trunk\hadoop-trunk\hadoop-hdfs-project\hadoop-hdfs\src\test\java\org\apache\hadoop\hdfs\server\blockmanagement\TestBlockInfo.java,177,24,13,2,2,41
 hadoop-trunk\hadoop-trunk\hadoop-yarn-project\hadoop-yarn\hadoop-yarn-server\hadoop-yarn-server-resourcemanager\src\main\java\org\apache\hadoop\yarn\server\resourcemanager\security\RMContainerTokenSecretManager.java,177,46,4,3,0,53
 hadoop-trunk\hadoop-trunk\hadoop-tools\hadoop-rumen\src\main\java\org\apache\hadoop\tools\rumen\datatypes\FileName.java,177,73,2,1,4,80
 kafka-trunk\kafka-trunk\clients\src\main\java\org\apache\kafka\common\requests\MetadataRequest.java,177,0,130,23,3,156
 kafka-trunk\kafka-trunk\streams\src\test\java\org\apache\kafka\streams\state\internals\BufferValueTest.java,177,0,0,49,2,51
 kafka-trunk\kafka-trunk\clients\src\test\java\org\apache\kafka\clients\admin\internals\AbortTransactionHandlerTest.java,177,0,0,43,0,43
 kafka-trunk\kafka-trunk\streams\src\test\java\org\apache\kafka\streams\state\internals\MergedSortedCacheWrappedWindowStoreIteratorTest.java,177,0,1,48,13,62
 kafka-trunk\kafka-trunk\clients\src\main\java\org\apache\kafka\common\security\oauthbearer\internals\unsecured\OAuthBearerValidationUtils.java,177,0,9,36,0,45
 kafka-trunk\kafka-trunk\clients\src\main\java\org\apache\kafka\clients\CommonClientConfigs.java,177,0,2,107,0,109
 kafka-trunk\kafka-trunk\streams\src\main\java\org\apache\kafka\streams\processor\internals\metrics\ProcessorNodeMetrics.java,177,0,1,36,0,37
 pulsar-master\pulsar-master\pulsar-client-admin\src\test\java\org\apache\pulsar\client\admin\internal\SinksImplTest.java,177,31,0,24,0,55
 pulsar-master\pulsar-master\pulsar-client\src\main\java\org\apache\pulsar\client\impl\PatternMultiTopicsConsumerImpl.java,177,77,7,37,0,121
 pulsar-master\pulsar-master\pulsar-client-admin\src\main\java\org\apache\pulsar\client\admin\internal\PackagesImpl.java,177,89,0,34,0,123
 pulsar-master\pulsar-master\pulsar-broker\src\test\java\org\apache\pulsar\broker\stats\ConsumerStatsTest.java,177,34,0,21,0,55
 pulsar-master\pulsar-master\pulsar-common\src\main\java\org\apache\pulsar\policies\data\loadbalancer\NamespaceUsage.java,177,102,0,5,0,107
 skywalking-master\skywalking-master\oap-server\server-core\src\main\java\org\apache\skywalking\oap\server\core\analysis\worker\MetricsStreamProcessor.java,177,68,0,44,0,112
 zookeeper-master\zookeeper-master\zookeeper-server\src\test\java\org\apache\zookeeper\server\quorum\QuorumPeerConfigTest.java,177,0,2,16,0,18
 dubbo-3.0\dubbo-3.0\dubbo-common\src\test\java\org\apache\dubbo\common\utils\AtomicPositiveIntegerTest.java,178,50,0,3,1,54
 hadoop-trunk\hadoop-trunk\hadoop-yarn-project\hadoop-yarn\hadoop-yarn-server\hadoop-yarn-server-resourcemanager\src\test\java\org\apache\hadoop\yarn\server\resourcemanager\webapp\TestRMWebServiceAppsNodelabel.java,178,33,2,5,0,40
 hadoop-trunk\hadoop-trunk\hadoop-tools\hadoop-rumen\src\main\java\org\apache\hadoop\tools\rumen\Hadoop20JHParser.java,178,34,3,1,0,38
 hadoop-trunk\hadoop-trunk\hadoop-yarn-project\hadoop-yarn\hadoop-yarn-server\hadoop-yarn-server-resourcemanager\src\main\java\org\apache\hadoop\yarn\server\resourcemanager\preprocessor\SubmissionContextPreProcessor.java,178,26,8,1,2,37
 hadoop-trunk\hadoop-trunk\hadoop-common-project\hadoop-common\src\test\java\org\apache\hadoop\ipc\TestRpcServerHandoff.java,178,42,6,1,5,54
 hadoop-trunk\hadoop-trunk\hadoop-hdfs-project\hadoop-hdfs-rbf\src\test\java\org\apache\hadoop\hdfs\server\federation\resolver\order\TestAvailableSpaceResolver.java,178,14,0,9,0,23
 hadoop-trunk\hadoop-trunk\hadoop-yarn-project\hadoop-yarn\hadoop-yarn-server\hadoop-yarn-server-resourcemanager\src\test\java\org\apache\hadoop\yarn\server\resourcemanager\placement\MockQueueHierarchyBuilder.java,178,51,3,6,1,61
 hadoop-trunk\hadoop-trunk\hadoop-common-project\hadoop-common\src\test\java\org\apache\hadoop\util\TestConfTest.java,178,18,1,2,14,35
 hadoop-trunk\hadoop-trunk\hadoop-yarn-project\hadoop-yarn\hadoop-yarn-server\hadoop-yarn-server-resourcemanager\src\main\java\org\apache\hadoop\yarn\server\resourcemanager\scheduler\capacity\CSAssignment.java,178,116,0,3,14,133
 hadoop-trunk\hadoop-trunk\hadoop-common-project\hadoop-nfs\src\main\java\org\apache\hadoop\nfs\nfs3\Nfs3Constant.java,178,119,2,4,0,125
 hadoop-trunk\hadoop-trunk\hadoop-common-project\hadoop-common\src\test\java\org\apache\hadoop\ipc\TestRetryCache.java,178,40,0,1,4,45
 hadoop-trunk\hadoop-trunk\hadoop-yarn-project\hadoop-yarn\hadoop-yarn-server\hadoop-yarn-server-applicationhistoryservice\src\test\java\org\apache\hadoop\yarn\server\applicationhistoryservice\TestApplicationHistoryServer.java,178,22,4,6,23,55
 kafka-trunk\kafka-trunk\trogdor\src\main\java\org\apache\kafka\trogdor\workload\Histogram.java,178,0,5,15,1,21
 kafka-trunk\kafka-trunk\streams\src\test\java\org\apache\kafka\streams\state\internals\TimestampedWindowStoreBuilderTest.java,178,0,0,20,2,22
 kafka-trunk\kafka-trunk\streams\src\test\java\org\apache\kafka\streams\kstream\SuppressedTest.java,178,0,0,38,0,38
 kafka-trunk\kafka-trunk\clients\src\generated\java\org\apache\kafka\common\message\DescribeAclsResponseDataJsonConverter.java,178,0,0,39,0,39
 kafka-trunk\kafka-trunk\clients\src\generated\java\org\apache\kafka\common\message\SaslAuthenticateRequestData.java,178,0,0,13,3,16
 pulsar-master\pulsar-master\pulsar-common\src\test\java\org\apache\pulsar\common\policies\impl\NamespaceIsolationPolicyImplTest.java,178,53,3,26,0,82
 pulsar-master\pulsar-master\pulsar-broker\src\test\java\org\apache\pulsar\common\naming\NamespaceBundleTest.java,178,71,9,34,0,114
 rocketmq-develop\rocketmq-develop\acl\src\main\java\org\apache\rocketmq\acl\plain\PlainAccessResource.java,178,106,2,4,3,115
 zookeeper-master\zookeeper-master\zookeeper-server\src\main\java\org\apache\zookeeper\server\admin\ReadAheadEndpoint.java,178,0,0,5,0,5
 dubbo-3.0\dubbo-3.0\dubbo-common\src\main\java\org\apache\dubbo\common\logger\slf4j\Slf4jLogger.java,179,62,5,16,0,83
 hadoop-trunk\hadoop-trunk\hadoop-hdfs-project\hadoop-hdfs-rbf\src\main\java\org\apache\hadoop\hdfs\server\federation\store\records\impl\pb\RouterStatePBImpl.java,179,39,95,7,0,141
 hadoop-trunk\hadoop-trunk\hadoop-yarn-project\hadoop-yarn\hadoop-yarn-common\src\main\java\org\apache\hadoop\yarn\api\protocolrecords\impl\pb\GetContainerStatusesResponsePBImpl.java,179,37,67,4,0,108
 hadoop-trunk\hadoop-trunk\hadoop-hdfs-project\hadoop-hdfs\src\test\java\org\apache\hadoop\hdfs\client\impl\TestBlockReaderLocalMetrics.java,179,35,3,1,4,43
 hadoop-trunk\hadoop-trunk\hadoop-tools\hadoop-distcp\src\main\java\org\apache\hadoop\tools\DistCpContext.java,179,86,0,1,3,90
 hadoop-trunk\hadoop-trunk\hadoop-yarn-project\hadoop-yarn\hadoop-yarn-applications\hadoop-yarn-services\hadoop-yarn-services-api\src\test\java\org\apache\hadoop\yarn\service\ServiceClientTest.java,179,34,7,1,2,44
 hadoop-trunk\hadoop-trunk\hadoop-common-project\hadoop-common\src\test\java\org\apache\hadoop\util\TestJsonSerialization.java,179,20,6,1,4,31
 hadoop-trunk\hadoop-trunk\hadoop-common-project\hadoop-common\src\test\java\org\apache\hadoop\security\TestCompositeGroupMapping.java,179,82,17,14,0,113
 hadoop-trunk\hadoop-trunk\hadoop-common-project\hadoop-common\src\test\java\org\apache\hadoop\util\TestDiskChecker.java,179,64,22,1,2,89
 hadoop-trunk\hadoop-trunk\hadoop-hdfs-project\hadoop-hdfs\src\test\java\org\apache\hadoop\hdfs\server\blockmanagement\TestSequentialBlockGroupId.java,179,27,17,6,4,54
 hadoop-trunk\hadoop-trunk\hadoop-common-project\hadoop-common\src\test\java\org\apache\hadoop\fs\TestFsShellTouch.java,179,28,8,1,0,37
 hadoop-trunk\hadoop-trunk\hadoop-tools\hadoop-aws\src\test\java\org\apache\hadoop\fs\s3a\TestS3AInputStreamRetry.java,179,21,1,8,4,34
 hadoop-trunk\hadoop-trunk\hadoop-common-project\hadoop-common\src\test\java\org\apache\hadoop\fs\FileContextCreateMkdirBaseTest.java,179,50,4,1,1,56
 hadoop-trunk\hadoop-trunk\hadoop-hdfs-project\hadoop-hdfs\src\test\java\org\apache\hadoop\hdfs\server\datanode\TestBlockPoolManager.java,179,35,6,2,2,45
 hadoop-trunk\hadoop-trunk\hadoop-hdfs-project\hadoop-hdfs-nfs\src\main\java\org\apache\hadoop\hdfs\nfs\nfs3\Nfs3Metrics.java,179,142,0,1,2,145
 kafka-trunk\kafka-trunk\clients\src\main\java\org\apache\kafka\common\protocol\types\Field.java,179,0,1,7,0,8
 kafka-trunk\kafka-trunk\clients\src\test\java\org\apache\kafka\common\network\SaslChannelBuilderTest.java,179,0,1,40,2,43
 kafka-trunk\kafka-trunk\clients\src\main\java\org\apache\kafka\common\requests\StopReplicaRequest.java,179,0,0,26,2,28
 kafka-trunk\kafka-trunk\clients\src\main\java\org\apache\kafka\common\security\oauthbearer\secured\OAuthBearerValidatorCallbackHandler.java,179,0,5,61,0,66
 pulsar-master\pulsar-master\pulsar-functions\utils\src\test\java\org\apache\pulsar\functions\utils\ActionsTest.java,179,41,1,17,0,59
 pulsar-master\pulsar-master\pulsar-metadata\src\main\java\org\apache\pulsar\metadata\impl\LocalMemoryMetadataStore.java,179,63,5,32,0,100
 pulsar-master\pulsar-master\pulsar-functions\worker\src\main\java\org\apache\pulsar\functions\worker\rest\api\v2\WorkerApiV2Resource.java,179,83,3,23,0,109
 skywalking-master\skywalking-master\oap-server\server-core\src\main\java\org\apache\skywalking\oap\server\core\query\TopologyQueryService.java,179,55,0,38,0,93
 skywalking-master\skywalking-master\oap-server\server-core\src\main\java\org\apache\skywalking\oap\server\core\analysis\manual\process\ProcessTraffic.java,179,47,1,12,0,60
 zookeeper-master\zookeeper-master\zookeeper-server\src\main\java\org\apache\zookeeper\server\ZooKeeperServerConf.java,179,0,0,3,0,3
 dubbo-3.0\dubbo-3.0\dubbo-rpc\dubbo-rpc-injvm\src\main\java\org\apache\dubbo\rpc\protocol\injvm\InjvmInvoker.java,180,61,0,33,0,94
 dubbo-3.0\dubbo-3.0\dubbo-spring-boot\dubbo-spring-boot-actuator\src\test\java\org\apache\dubbo\spring\boot\actuate\autoconfigure\DubboEndpointAnnotationAutoConfigurationTest.java,180,57,4,33,0,94
 dubbo-3.0\dubbo-3.0\dubbo-common\src\main\java\org\apache\dubbo\config\nested\PrometheusConfig.java,180,92,0,2,4,98
 hadoop-trunk\hadoop-trunk\hadoop-tools\hadoop-sls\src\main\java\org\apache\hadoop\yarn\sls\scheduler\FairSchedulerMetrics.java,180,30,0,3,2,35
 hadoop-trunk\hadoop-trunk\hadoop-hdfs-project\hadoop-hdfs\src\test\java\org\apache\hadoop\hdfs\TestSeekBug.java,180,68,3,2,6,79
 hadoop-trunk\hadoop-trunk\hadoop-common-project\hadoop-common\src\main\java\org\apache\hadoop\fs\DF.java,180,39,8,1,0,48
 hadoop-trunk\hadoop-trunk\hadoop-yarn-project\hadoop-yarn\hadoop-yarn-applications\hadoop-yarn-services\hadoop-yarn-services-core\src\main\java\org\apache\hadoop\yarn\service\api\records\Configuration.java,180,73,2,5,9,89
 hadoop-trunk\hadoop-trunk\hadoop-yarn-project\hadoop-yarn\hadoop-yarn-server\hadoop-yarn-server-applicationhistoryservice\src\test\java\org\apache\hadoop\yarn\server\timeline\security\TestTimelineACLsManager.java,180,12,0,1,0,13
 hadoop-trunk\hadoop-trunk\hadoop-yarn-project\hadoop-yarn\hadoop-yarn-common\src\test\java\org\apache\hadoop\yarn\conf\TestHAUtil.java,180,25,2,3,2,32
 hadoop-trunk\hadoop-trunk\hadoop-yarn-project\hadoop-yarn\hadoop-yarn-server\hadoop-yarn-server-resourcemanager\src\test\java\org\apache\hadoop\yarn\server\resourcemanager\rmapp\TestNodesListManager.java,180,27,25,2,1,55
 kafka-trunk\kafka-trunk\streams\src\test\java\org\apache\kafka\streams\state\internals\ChangeLoggingTimestampedKeyValueBytesStoreTest.java,180,0,0,21,6,27
 pulsar-master\pulsar-master\pulsar-client\src\test\java\org\apache\pulsar\client\impl\schema\KeyValueSchemaInfoTest.java,180,40,0,28,0,68
 pulsar-master\pulsar-master\pulsar-client-auth-athenz\src\test\java\org\apache\pulsar\client\impl\auth\AuthenticationAthenzTest.java,180,45,7,28,0,80
 pulsar-master\pulsar-master\pulsar-common\src\main\java\org\apache\pulsar\common\policies\data\stats\NonPersistentTopicStatsImpl.java,180,83,0,49,0,132
 rocketmq-develop\rocketmq-develop\client\src\test\java\org\apache\rocketmq\client\impl\consumer\RebalancePushImplTest.java,180,112,7,64,1,184
 zookeeper-master\zookeeper-master\zookeeper-server\src\main\java\org\apache\zookeeper\server\quorum\QuorumZooKeeperServer.java,180,0,9,20,2,31
 hadoop-trunk\hadoop-trunk\hadoop-hdfs-project\hadoop-hdfs\src\main\java\org\apache\hadoop\hdfs\server\namenode\ContentSummaryComputationContext.java,181,69,3,2,4,78
 hadoop-trunk\hadoop-trunk\hadoop-tools\hadoop-extras\src\test\java\org\apache\hadoop\tools\TestDistCh.java,181,102,5,10,4,121
 hadoop-trunk\hadoop-trunk\hadoop-hdfs-project\hadoop-hdfs\src\test\java\org\apache\hadoop\hdfs\server\blockmanagement\TestPendingInvalidateBlock.java,181,21,15,2,1,39
 hadoop-trunk\hadoop-trunk\hadoop-hdfs-project\hadoop-hdfs\src\test\java\org\apache\hadoop\hdfs\server\datanode\TestIncrementalBlockReports.java,181,31,3,5,0,39
 hadoop-trunk\hadoop-trunk\hadoop-hdfs-project\hadoop-hdfs\src\test\java\org\apache\hadoop\hdfs\TestLargeBlock.java,181,37,9,2,2,50
 hadoop-trunk\hadoop-trunk\hadoop-yarn-project\hadoop-yarn\hadoop-yarn-server\hadoop-yarn-server-applicationhistoryservice\src\main\java\org\apache\hadoop\yarn\server\timeline\util\LeveldbUtils.java,181,54,3,4,1,62
 hadoop-trunk\hadoop-trunk\hadoop-tools\hadoop-aws\src\main\java\org\apache\hadoop\fs\s3a\impl\GetContentSummaryOperation.java,181,19,0,12,1,32
 hadoop-trunk\hadoop-trunk\hadoop-mapreduce-project\hadoop-mapreduce-client\hadoop-mapreduce-client-core\src\main\java\org\apache\hadoop\mapreduce\CryptoUtils.java,181,36,2,2,1,41
 hadoop-trunk\hadoop-trunk\hadoop-mapreduce-project\hadoop-mapreduce-client\hadoop-mapreduce-client-core\src\test\java\org\apache\hadoop\mapreduce\tools\TestCLI.java,181,37,17,2,2,58
 hadoop-trunk\hadoop-trunk\hadoop-mapreduce-project\hadoop-mapreduce-client\hadoop-mapreduce-client-core\src\main\java\org\apache\hadoop\mapreduce\lib\db\TextSplitter.java,181,47,3,23,0,73
 hadoop-trunk\hadoop-trunk\hadoop-yarn-project\hadoop-yarn\hadoop-yarn-common\src\test\java\org\apache\hadoop\yarn\TestContainerLaunchRPC.java,181,44,5,7,3,59
 hadoop-trunk\hadoop-trunk\hadoop-common-project\hadoop-common\src\test\java\org\apache\hadoop\metrics2\impl\TestGangliaMetrics.java,181,29,0,3,1,33
 hadoop-trunk\hadoop-trunk\hadoop-mapreduce-project\hadoop-mapreduce-client\hadoop-mapreduce-client-hs\src\main\java\org\apache\hadoop\mapreduce\v2\hs\JobHistoryServer.java,181,41,5,2,1,49
 hadoop-trunk\hadoop-trunk\hadoop-hdfs-project\hadoop-hdfs\src\test\java\org\apache\hadoop\hdfs\server\namenode\TestFileLimit.java,181,53,2,3,1,59
 hadoop-trunk\hadoop-trunk\hadoop-mapreduce-project\hadoop-mapreduce-client\hadoop-mapreduce-client-jobclient\src\test\java\org\apache\hadoop\mapred\TestMiniMRClasspath.java,181,56,21,2,5,84
 kafka-trunk\kafka-trunk\clients\src\generated\java\org\apache\kafka\common\message\ListPartitionReassignmentsResponseDataJsonConverter.java,181,0,0,48,0,48
 kafka-trunk\kafka-trunk\metadata\src\main\java\org\apache\kafka\metadata\BrokerRegistration.java,181,0,1,7,2,10
 kafka-trunk\kafka-trunk\clients\src\generated\java\org\apache\kafka\common\message\BrokerRegistrationRequestDataJsonConverter.java,181,0,0,44,0,44
 pulsar-master\pulsar-master\pulsar-client\src\test\java\org\apache\pulsar\client\impl\MultiTopicsConsumerImplTest.java,181,58,3,40,0,101
 pulsar-master\pulsar-master\pulsar-sql\presto-pulsar\src\test\java\org\apache\pulsar\sql\presto\decoder\primitive\TestPrimitiveDecoder.java,181,84,0,79,0,163
 pulsar-master\pulsar-master\pulsar-broker\src\test\java\org\apache\pulsar\broker\intercept\BrokerInterceptorTest.java,181,66,4,22,0,92
 zookeeper-master\zookeeper-master\zookeeper-server\src\test\java\org\apache\zookeeper\server\util\PortForwarder.java,181,0,11,16,10,37
 hadoop-trunk\hadoop-trunk\hadoop-yarn-project\hadoop-yarn\hadoop-yarn-server\hadoop-yarn-server-applicationhistoryservice\src\main\java\org\apache\hadoop\yarn\server\applicationhistoryservice\records\ApplicationHistoryData.java,182,90,0,1,2,93
 hadoop-trunk\hadoop-trunk\hadoop-hdfs-project\hadoop-hdfs\src\test\java\org\apache\hadoop\hdfs\server\namenode\TestBlockUnderConstruction.java,182,48,14,2,2,66
 hadoop-trunk\hadoop-trunk\hadoop-tools\hadoop-aws\src\test\java\org\apache\hadoop\fs\s3a\ITestBlockingThreadPoolExecutorService.java,182,22,4,1,5,32
 hadoop-trunk\hadoop-trunk\hadoop-tools\hadoop-azure\src\test\java\org\apache\hadoop\fs\azure\MockWasbAuthorizerImpl.java,182,55,3,14,2,74
 hadoop-trunk\hadoop-trunk\hadoop-hdfs-project\hadoop-hdfs-rbf\src\main\java\org\apache\hadoop\hdfs\server\federation\router\security\token\ZKDelegationTokenSecretManagerImpl.java,182,26,2,4,6,38
 hadoop-trunk\hadoop-trunk\hadoop-yarn-project\hadoop-yarn\hadoop-yarn-server\hadoop-yarn-server-common\src\main\java\org\apache\hadoop\yarn\server\webapp\AppsBlock.java,182,24,1,5,0,30
 hadoop-trunk\hadoop-trunk\hadoop-yarn-project\hadoop-yarn\hadoop-yarn-server\hadoop-yarn-server-common\src\test\java\org\apache\hadoop\yarn\server\federation\store\records\TestFederationProtocolRecords.java,182,30,56,57,0,143
 hadoop-trunk\hadoop-trunk\hadoop-yarn-project\hadoop-yarn\hadoop-yarn-server\hadoop-yarn-server-nodemanager\src\test\java\org\apache\hadoop\yarn\server\nodemanager\containermanager\linux\resources\TestTrafficControlBandwidthHandlerImpl.java,182,28,3,6,1,38
 hadoop-trunk\hadoop-trunk\hadoop-hdfs-project\hadoop-hdfs-client\src\main\java\org\apache\hadoop\hdfs\DFSInotifyEventInputStream.java,182,27,0,4,0,31
 hadoop-trunk\hadoop-trunk\hadoop-hdfs-project\hadoop-hdfs\src\test\java\org\apache\hadoop\fs\viewfs\TestViewFileSystemLinkMergeSlash.java,182,28,3,1,4,36
 hadoop-trunk\hadoop-trunk\hadoop-common-project\hadoop-registry\src\test\java\org\apache\hadoop\registry\secure\TestSecureLogins.java,182,19,3,7,2,31
 hadoop-trunk\hadoop-trunk\hadoop-tools\hadoop-resourceestimator\src\main\java\org\apache\hadoop\resourceestimator\common\api\ResourceSkyline.java,182,0,3,2,6,11
 hadoop-trunk\hadoop-trunk\hadoop-hdfs-project\hadoop-hdfs\src\test\java\org\apache\hadoop\hdfs\server\namenode\ha\TestStandbyIsHot.java,182,58,6,6,0,70
 kafka-trunk\kafka-trunk\clients\src\test\java\org\apache\kafka\common\requests\UpdateMetadataRequestTest.java,182,0,11,26,0,37
 kafka-trunk\kafka-trunk\clients\src\main\java\org\apache\kafka\common\config\TopicConfig.java,182,0,0,118,0,118
 pulsar-master\pulsar-master\pulsar-io\kafka-connect-adaptor\src\main\java\org\apache\pulsar\io\kafka\connect\PulsarOffsetBackingStore.java,182,35,3,12,0,50
 pulsar-master\pulsar-master\tests\integration\src\test\java\org\apache\pulsar\tests\integration\presto\TestPrestoQueryTieredStorage.java,182,57,4,22,0,83
 pulsar-master\pulsar-master\tiered-storage\jcloud\src\test\java\org\apache\bookkeeper\mledger\offload\jcloud\provider\TieredStorageConfigurationTests.java,182,62,8,23,0,93
 rocketmq-develop\rocketmq-develop\broker\src\main\java\org\apache\rocketmq\broker\util\ServiceProvider.java,182,55,13,33,9,110
 zookeeper-master\zookeeper-master\zookeeper-server\src\main\java\org\apache\zookeeper\server\quorum\LearnerSessionTracker.java,182,0,6,10,1,17
 dubbo-3.0\dubbo-3.0\dubbo-common\src\main\java\org\apache\dubbo\common\cache\FileCacheStore.java,183,67,5,12,1,85
 dubbo-3.0\dubbo-3.0\dubbo-rpc\dubbo-rpc-api\src\test\java\org\apache\dubbo\rpc\RpcContextTest.java,183,26,7,13,0,46
 dubbo-3.0\dubbo-3.0\dubbo-common\src\test\java\org\apache\dubbo\common\model\person\FullAddress.java,183,104,18,8,0,130
 dubbo-3.0\dubbo-3.0\dubbo-registry\dubbo-registry-api\src\test\java\org\apache\dubbo\registry\client\migration\MigrationRuleListenerTest.java,183,84,1,43,0,128
 dubbo-3.0\dubbo-3.0\dubbo-common\src\test\java\org\apache\dubbo\rpc\model\person\FullAddress.java,183,104,18,8,0,130
 hadoop-trunk\hadoop-trunk\hadoop-hdfs-project\hadoop-hdfs\src\test\java\org\apache\hadoop\hdfs\server\blockmanagement\TestSlowPeerTracker.java,183,22,13,1,0,36
 hadoop-trunk\hadoop-trunk\hadoop-mapreduce-project\hadoop-mapreduce-examples\src\main\java\org\apache\hadoop\examples\dancing\DistributedPentomino.java,183,78,9,2,1,90
 hadoop-trunk\hadoop-trunk\hadoop-tools\hadoop-azure\src\main\java\org\apache\hadoop\fs\azure\AzureLinkedStack.java,183,23,2,1,0,26
 hadoop-trunk\hadoop-trunk\hadoop-hdfs-project\hadoop-hdfs\src\main\java\org\apache\hadoop\hdfs\server\namenode\EditLogInputStream.java,183,39,1,1,0,41
 hadoop-trunk\hadoop-trunk\hadoop-tools\hadoop-aliyun\src\main\java\org\apache\hadoop\fs\aliyun\oss\AliyunOSSBlockOutputStream.java,183,36,5,4,2,47
 hadoop-trunk\hadoop-trunk\hadoop-hdfs-project\hadoop-hdfs-rbf\src\test\java\org\apache\hadoop\hdfs\server\federation\store\TestStateStoreRouterState.java,183,13,0,6,2,21
 hadoop-trunk\hadoop-trunk\hadoop-yarn-project\hadoop-yarn\hadoop-yarn-server\hadoop-yarn-server-resourcemanager\src\test\java\org\apache\hadoop\yarn\server\resourcemanager\placement\TestAppNameMappingPlacementRule.java,183,42,3,7,0,52
 hadoop-trunk\hadoop-trunk\hadoop-common-project\hadoop-common\src\main\java\org\apache\hadoop\util\ZKUtil.java,183,44,2,2,2,50
 hadoop-trunk\hadoop-trunk\hadoop-yarn-project\hadoop-yarn\hadoop-yarn-server\hadoop-yarn-server-resourcemanager\src\main\java\org\apache\hadoop\yarn\server\resourcemanager\scheduler\capacity\AppPriorityACLConfigurationParser.java,183,22,5,1,3,31
 hadoop-trunk\hadoop-trunk\hadoop-mapreduce-project\hadoop-mapreduce-client\hadoop-mapreduce-client-jobclient\src\test\java\org\apache\hadoop\mapreduce\lib\db\TestDataDrivenDBInputFormat.java,183,49,10,1,1,61
 hadoop-trunk\hadoop-trunk\hadoop-mapreduce-project\hadoop-mapreduce-client\hadoop-mapreduce-client-jobclient\src\test\java\org\apache\hadoop\mapred\TestTaskStatus.java,183,46,4,2,2,54
 hadoop-trunk\hadoop-trunk\hadoop-hdfs-project\hadoop-hdfs\src\test\java\org\apache\hadoop\hdfs\server\namenode\snapshot\TestSnapshotFileLength.java,183,22,15,2,8,47
 hadoop-trunk\hadoop-trunk\hadoop-hdfs-project\hadoop-hdfs\src\test\java\org\apache\hadoop\hdfs\server\namenode\snapshot\TestOrderedSnapshotDeletionGc.java,183,32,7,6,2,47
 pulsar-master\pulsar-master\pulsar-client\src\test\java\org\apache\pulsar\client\impl\ConsumerImplTest.java,183,54,5,20,0,79
 pulsar-master\pulsar-master\pulsar-broker\src\test\java\org\apache\pulsar\broker\loadbalance\impl\ThresholdShedderTest.java,183,68,0,16,0,84
 pulsar-master\pulsar-master\pulsar-io\kafka\src\main\java\org\apache\pulsar\io\kafka\KafkaBytesSource.java,183,67,0,44,0,111
 pulsar-master\pulsar-master\pulsar-io\elastic-search\src\main\java\org\apache\pulsar\io\elasticsearch\JsonConverter.java,183,58,2,25,0,85
 shardingsphere-master\shardingsphere-master\shardingsphere-jdbc\shardingsphere-jdbc-core\src\main\java\org\apache\shardingsphere\driver\jdbc\unsupported\AbstractUnsupportedOperationResultSet.java,183,57,0,8,0,65
 zookeeper-master\zookeeper-master\zookeeper-server\src\test\java\org\apache\zookeeper\test\TruncateTest.java,183,0,31,15,3,49
 zookeeper-master\zookeeper-master\zookeeper-server\src\test\java\org\apache\zookeeper\test\SessionTrackerCheckTest.java,183,0,6,7,11,24
 dubbo-3.0\dubbo-3.0\dubbo-common\src\main\java\org\apache\dubbo\config\SslConfig.java,184,136,2,26,0,164
 dubbo-3.0\dubbo-3.0\dubbo-remoting\dubbo-remoting-netty4\src\main\java\org\apache\dubbo\remoting\transport\netty4\NettyServer.java,184,48,10,20,0,78
 hadoop-trunk\hadoop-trunk\hadoop-hdfs-project\hadoop-hdfs-rbf\src\test\java\org\apache\hadoop\hdfs\server\federation\RouterConfigBuilder.java,184,77,3,4,2,86
 hadoop-trunk\hadoop-trunk\hadoop-yarn-project\hadoop-yarn\hadoop-yarn-server\hadoop-yarn-server-nodemanager\src\main\java\org\apache\hadoop\yarn\server\nodemanager\NodeResourceMonitorImpl.java,184,15,5,3,2,25
 hadoop-trunk\hadoop-trunk\hadoop-tools\hadoop-gridmix\src\main\java\org\apache\hadoop\mapred\gridmix\RandomAlgorithms.java,184,80,10,1,1,92
 hadoop-trunk\hadoop-trunk\hadoop-hdfs-project\hadoop-hdfs-rbf\src\test\java\org\apache\hadoop\hdfs\server\federation\router\TestDisableNameservices.java,184,13,2,7,1,23
 hadoop-trunk\hadoop-trunk\hadoop-common-project\hadoop-common\src\test\java\org\apache\hadoop\fs\permission\TestAcl.java,184,32,20,3,1,56
 kafka-trunk\kafka-trunk\streams\src\test\java\org\apache\kafka\streams\state\internals\GlobalStateStoreProviderTest.java,184,0,0,28,0,28
 kafka-trunk\kafka-trunk\streams\src\test\java\org\apache\kafka\streams\integration\KTableKTableForeignKeyJoinDistributedTest.java,184,0,2,33,0,35
 kafka-trunk\kafka-trunk\clients\src\main\java\org\apache\kafka\common\requests\TxnOffsetCommitRequest.java,184,0,0,30,2,32
 pulsar-master\pulsar-master\pulsar-io\dynamodb\src\main\java\org\apache\pulsar\io\dynamodb\DynamoDBSourceConfig.java,184,63,0,33,0,96
 pulsar-master\pulsar-master\pulsar-client-tools\src\main\java\org\apache\pulsar\admin\cli\CliCommand.java,184,49,3,15,0,67
 pulsar-master\pulsar-master\pulsar-broker\src\test\java\org\apache\pulsar\client\api\TokenOauth2AuthenticatedProducerConsumerTest.java,184,58,4,28,0,90
 pulsar-master\pulsar-master\pulsar-client-tools\src\main\java\org\apache\pulsar\client\cli\PulsarClientTool.java,184,76,1,31,0,108
 pulsar-master\pulsar-master\pulsar-functions\runtime\src\test\java\org\apache\pulsar\functions\runtime\RuntimeUtilsTest.java,184,53,2,22,0,77
 rocketmq-develop\rocketmq-develop\tools\src\main\java\org\apache\rocketmq\tools\command\MQAdminStartup.java,184,28,4,20,3,55
 skywalking-master\skywalking-master\oap-server\analyzer\agent-analyzer\src\main\java\org\apache\skywalking\oap\server\analyzer\provider\jvm\JVMSourceDispatcher.java,184,77,2,32,0,111
 zookeeper-master\zookeeper-master\zookeeper-server\src\main\java\org\apache\zookeeper\jmx\MBeanRegistry.java,184,0,8,10,1,19
 zookeeper-master\zookeeper-master\zookeeper-jute\src\main\java\org\apache\jute\compiler\JType.java,184,0,2,19,1,22
 dubbo-3.0\dubbo-3.0\dubbo-rpc\dubbo-rpc-api\src\test\java\org\apache\dubbo\rpc\filter\ActiveLimitFilterTest.java,185,43,1,24,0,68
 dubbo-3.0\dubbo-3.0\dubbo-remoting\dubbo-remoting-api\src\main\java\org\apache\dubbo\remoting\buffer\DynamicChannelBuffer.java,185,84,0,8,0,92
 dubbo-3.0\dubbo-3.0\dubbo-monitor\dubbo-monitor-default\src\main\java\org\apache\dubbo\monitor\dubbo\Statistics.java,185,64,0,2,0,66
 hadoop-trunk\hadoop-trunk\hadoop-hdfs-project\hadoop-hdfs\src\test\java\org\apache\hadoop\hdfs\server\namenode\TestFSNamesystemMBean.java,185,17,2,3,6,28
 hadoop-trunk\hadoop-trunk\hadoop-common-project\hadoop-common\src\test\java\org\apache\hadoop\fs\TestDelegationTokenRenewer.java,185,57,6,2,19,84
 hadoop-trunk\hadoop-trunk\hadoop-mapreduce-project\hadoop-mapreduce-client\hadoop-mapreduce-client-jobclient\src\test\java\org\apache\hadoop\mapred\TestSequenceFileAsBinaryOutputFormat.java,185,51,7,1,5,64
 hadoop-trunk\hadoop-trunk\hadoop-mapreduce-project\hadoop-mapreduce-client\hadoop-mapreduce-client-nativetask\src\test\java\org\apache\hadoop\mapred\nativetask\kvtest\TestInputFile.java,185,87,13,8,3,111
 hadoop-trunk\hadoop-trunk\hadoop-common-project\hadoop-common\src\test\java\org\apache\hadoop\fs\ftp\TestFTPFileSystem.java,185,33,7,1,3,44
 hadoop-trunk\hadoop-trunk\hadoop-hdfs-project\hadoop-hdfs\src\test\java\org\apache\hadoop\hdfs\TestModTime.java,185,31,14,3,4,52
 hadoop-trunk\hadoop-trunk\hadoop-yarn-project\hadoop-yarn\hadoop-yarn-server\hadoop-yarn-server-resourcemanager\src\main\java\org\apache\hadoop\yarn\server\resourcemanager\scheduler\capacity\ConfigurationProperties.java,185,21,0,1,0,22
 hadoop-trunk\hadoop-trunk\hadoop-common-project\hadoop-common\src\test\java\org\apache\hadoop\net\TestNetworkTopologyWithNodeGroup.java,185,76,13,2,0,91
 hadoop-trunk\hadoop-trunk\hadoop-hdfs-project\hadoop-hdfs\src\main\java\org\apache\hadoop\hdfs\server\datanode\fsdataset\impl\FsDatasetUtil.java,185,52,8,1,1,62
 hadoop-trunk\hadoop-trunk\hadoop-hdfs-project\hadoop-hdfs\src\test\java\org\apache\hadoop\hdfs\server\namenode\TestDefaultBlockPlacementPolicy.java,185,24,2,3,1,30
 hadoop-trunk\hadoop-trunk\hadoop-common-project\hadoop-common\src\test\java\org\apache\hadoop\fs\shell\TestCopy.java,185,41,4,2,3,50
 kafka-trunk\kafka-trunk\clients\src\main\java\org\apache\kafka\common\requests\UpdateMetadataRequest.java,185,0,118,41,4,163
 kafka-trunk\kafka-trunk\metadata\src\generated\java\org\apache\kafka\common\metadata\BrokerRegistrationChangeRecord.java,185,0,0,11,2,13
 kafka-trunk\kafka-trunk\clients\src\test\java\org\apache\kafka\common\internals\PartitionStatesTest.java,185,0,2,4,0,6
 pulsar-master\pulsar-master\pulsar-broker\src\test\java\org\apache\pulsar\broker\transaction\buffer\TransactionStablePositionTest.java,185,47,8,27,0,82
 pulsar-master\pulsar-master\pulsar-broker\src\main\java\org\apache\pulsar\broker\BookKeeperClientFactoryImpl.java,185,78,0,62,0,140
 pulsar-master\pulsar-master\pulsar-broker\src\main\java\org\apache\pulsar\client\impl\RawReaderImpl.java,185,53,2,12,0,67
 pulsar-master\pulsar-master\pulsar-client\src\test\java\org\apache\pulsar\client\impl\auth\AuthenticationTokenTest.java,185,22,0,9,0,31
 zookeeper-master\zookeeper-master\zookeeper-server\src\test\java\org\apache\zookeeper\test\ReconfigExceptionTest.java,185,0,27,22,4,53
 dubbo-3.0\dubbo-3.0\dubbo-common\src\main\java\org\apache\dubbo\common\threadpool\manager\FrameworkExecutorRepository.java,186,66,1,31,0,98
 dubbo-3.0\dubbo-3.0\dubbo-common\src\test\java\org\apache\dubbo\common\model\person\PersonInfo.java,186,117,21,9,6,153
 dubbo-3.0\dubbo-3.0\dubbo-common\src\test\java\org\apache\dubbo\rpc\model\person\PersonInfo.java,186,117,21,9,6,153
 dubbo-3.0\dubbo-3.0\dubbo-remoting\dubbo-remoting-api\src\main\java\org\apache\dubbo\remoting\exchange\support\header\HeaderExchangeHandler.java,186,45,4,16,0,65
 hadoop-trunk\hadoop-trunk\hadoop-hdfs-project\hadoop-hdfs\src\main\java\org\apache\hadoop\hdfs\tools\AdminHelper.java,186,35,6,2,0,43
 hadoop-trunk\hadoop-trunk\hadoop-common-project\hadoop-common\src\test\java\org\apache\hadoop\security\ssl\TestReloadingX509TrustManager.java,186,52,10,12,8,82
 hadoop-trunk\hadoop-trunk\hadoop-yarn-project\hadoop-yarn\hadoop-yarn-server\hadoop-yarn-server-resourcemanager\src\main\java\org\apache\hadoop\yarn\server\resourcemanager\webapp\RMAppsBlock.java,186,13,3,2,0,18
 hadoop-trunk\hadoop-trunk\hadoop-hdfs-project\hadoop-hdfs-httpfs\src\test\java\org\apache\hadoop\test\TestHdfsHelper.java,186,47,1,13,1,62
 hadoop-trunk\hadoop-trunk\hadoop-hdfs-project\hadoop-hdfs\src\main\java\org\apache\hadoop\hdfs\server\namenode\INodeReferenceValidation.java,186,48,10,1,1,60
 hadoop-trunk\hadoop-trunk\hadoop-yarn-project\hadoop-yarn\hadoop-yarn-server\hadoop-yarn-server-resourcemanager\src\main\java\org\apache\hadoop\yarn\server\resourcemanager\placement\QueueMapping.java,186,49,4,2,0,55
 hadoop-trunk\hadoop-trunk\hadoop-tools\hadoop-sls\src\main\java\org\apache\hadoop\yarn\sls\RumenToSLSConverter.java,186,29,31,3,0,63
 hadoop-trunk\hadoop-trunk\hadoop-mapreduce-project\hadoop-mapreduce-client\hadoop-mapreduce-client-common\src\main\java\org\apache\hadoop\mapreduce\v2\api\impl\pb\service\MRClientProtocolPBServiceImpl.java,186,74,71,79,0,224
kafka-trunk\kafka-trunk\clients\src\main\java\org\apache\kafka\common\protocol\SendBuilder.java,186,0,0,7,0,7
 kafka-trunk\kafka-trunk\connect\runtime\src\test\java\org\apache\kafka\connect\integration\SourceConnectorsIntegrationTest.java,186,0,0,62,6,68
 kafka-trunk\kafka-trunk\clients\src\main\java\org\apache\kafka\common\network\PlaintextTransportLayer.java,186,0,2,16,1,19
 kafka-trunk\kafka-trunk\clients\src\generated\java\org\apache\kafka\common\message\ControlledShutdownRequestData.java,186,0,0,14,1,15
 kafka-trunk\kafka-trunk\clients\src\test\java\org\apache\kafka\common\security\oauthbearer\secured\OAuthBearerLoginCallbackHandlerTest.java,186,0,0,39,1,40
 kafka-trunk\kafka-trunk\clients\src\generated\java\org\apache\kafka\common\message\AllocateProducerIdsResponseData.java,186,0,0,13,1,14
 kafka-trunk\kafka-trunk\clients\src\main\java\org\apache\kafka\common\utils\Bytes.java,186,0,10,9,2,21
 kafka-trunk\kafka-trunk\streams\src\test\java\org\apache\kafka\streams\kstream\internals\KStreamImplValueJoinerWithKeyTest.java,186,0,6,17,6,29
 pulsar-master\pulsar-master\pulsar-functions\instance\src\test\java\org\apache\pulsar\functions\windowing\WindowFunctionExecutorTest.java,186,89,1,31,0,121
 pulsar-master\pulsar-master\pulsar-client-admin\src\main\java\org\apache\pulsar\client\admin\internal\NonPersistentTopicsImpl.java,186,83,0,30,0,113
 pulsar-master\pulsar-master\pulsar-broker\src\test\java\org\apache\pulsar\client\impl\TableViewTest.java,186,49,12,21,0,82
 pulsar-master\pulsar-master\pulsar-client\src\test\java\org\apache\pulsar\client\impl\PulsarClientImplTest.java,186,45,4,27,0,76
 rocketmq-develop\rocketmq-develop\broker\src\test\java\org\apache\rocketmq\broker\transaction\queue\TransactionalMessageServiceImplTest.java,186,88,3,39,1,131
 shardingsphere-master\shardingsphere-master\shardingsphere-proxy\shardingsphere-proxy-backend\src\main\java\org\apache\shardingsphere\proxy\backend\text\admin\executor\AbstractDatabaseMetadataExecutor.java,186,59,5,36,0,100
 skywalking-master\skywalking-master\oap-server\analyzer\log-analyzer\src\main\java\org\apache\skywalking\oap\log\analyzer\dsl\spec\extractor\ExtractorSpec.java,186,39,0,14,0,53
 skywalking-master\skywalking-master\oap-server\analyzer\meter-analyzer\src\main\java\org\apache\skywalking\oap\meter\analyzer\k8s\K8sInfoRegistry.java,186,40,0,18,0,58
 skywalking-master\skywalking-master\oap-server\server-starter\src\main\java\org\apache\skywalking\oap\server\starter\config\ApplicationConfigLoader.java,186,54,5,40,0,99
 zookeeper-master\zookeeper-master\zookeeper-server\src\test\java\org\apache\zookeeper\test\ThrottledOpHelper.java,186,0,50,10,0,60
 dubbo-3.0\dubbo-3.0\dubbo-metadata\dubbo-metadata-api\src\main\java\org\apache\dubbo\metadata\rest\RequestMetadata.java,187,94,3,12,0,109
 dubbo-3.0\dubbo-3.0\dubbo-cluster\src\main\java\org\apache\dubbo\rpc\cluster\configurator\parser\ConfigParser.java,187,33,2,18,0,53
 dubbo-3.0\dubbo-3.0\dubbo-spring-boot\dubbo-spring-boot-compatible\actuator\src\main\java\org\apache\dubbo\spring\boot\actuate\health\DubboHealthIndicator.java,187,37,0,25,0,62
 dubbo-3.0\dubbo-3.0\dubbo-common\src\test\java\org\apache\dubbo\common\utils\CompatibleTypeUtilsTest.java,187,75,12,41,0,128
 hadoop-trunk\hadoop-trunk\hadoop-hdfs-project\hadoop-hdfs\src\test\java\org\apache\hadoop\hdfs\server\blockmanagement\TestAvailableSpaceBlockPlacementPolicy.java,187,62,8,12,1,83
 hadoop-trunk\hadoop-trunk\hadoop-hdfs-project\hadoop-hdfs\src\main\java\org\apache\hadoop\hdfs\server\blockmanagement\CombinedHostFileManager.java,187,32,2,2,9,45
 hadoop-trunk\hadoop-trunk\hadoop-hdfs-project\hadoop-hdfs-rbf\src\test\java\org\apache\hadoop\hdfs\server\federation\router\TestRouterRPCClientRetries.java,187,19,1,6,8,34
 hadoop-trunk\hadoop-trunk\hadoop-yarn-project\hadoop-yarn\hadoop-yarn-server\hadoop-yarn-server-nodemanager\src\test\java\org\apache\hadoop\yarn\server\nodemanager\containermanager\monitor\TestContainerMetrics.java,187,36,7,3,0,46
 hadoop-trunk\hadoop-trunk\hadoop-yarn-project\hadoop-yarn\hadoop-yarn-server\hadoop-yarn-server-nodemanager\src\test\java\org\apache\hadoop\yarn\server\nodemanager\containermanager\linux\resources\TestCompareResourceCalculators.java,187,42,8,2,3,55
 hadoop-trunk\hadoop-trunk\hadoop-hdfs-project\hadoop-hdfs\src\test\java\org\apache\hadoop\hdfs\tools\offlineImageViewer\TestOfflineImageViewerForAcl.java,187,23,16,1,6,46
 hadoop-trunk\hadoop-trunk\hadoop-common-project\hadoop-common\src\main\java\org\apache\hadoop\util\JvmPauseMonitor.java,187,55,4,3,0,62
 hadoop-trunk\hadoop-trunk\hadoop-yarn-project\hadoop-yarn\hadoop-yarn-common\src\main\java\org\apache\hadoop\yarn\logaggregation\filecontroller\ifile\IndexedFileAggregatedLogsBlock.java,187,26,12,5,2,45
 kafka-trunk\kafka-trunk\connect\runtime\src\test\java\org\apache\kafka\connect\storage\OffsetStorageWriterTest.java,187,0,1,27,2,30
 kafka-trunk\kafka-trunk\clients\src\generated\java\org\apache\kafka\common\message\SaslHandshakeResponseData.java,187,0,0,17,3,20
 kafka-trunk\kafka-trunk\clients\src\main\java\org\apache\kafka\common\security\authenticator\LoginManager.java,187,0,6,48,0,54
 kafka-trunk\kafka-trunk\streams\src\test\java\org\apache\kafka\streams\kstream\JoinWindowsTest.java,187,0,3,52,6,61
 kafka-trunk\kafka-trunk\connect\basic-auth-extension\src\test\java\org\apache\kafka\connect\rest\basic\auth\extension\JaasBasicAuthFilterTest.java,187,0,0,42,2,44
 kafka-trunk\kafka-trunk\clients\src\test\java\org\apache\kafka\clients\admin\internals\DescribeTransactionsHandlerTest.java,187,0,0,33,0,33
 kafka-trunk\kafka-trunk\streams\src\test\java\org\apache\kafka\streams\kstream\internals\foreignkeyjoin\SubscriptionResolverJoinProcessorSupplierTest.java,187,0,3,48,1,52
 kafka-trunk\kafka-trunk\connect\mirror-client\src\test\java\org\apache\kafka\connect\mirror\MirrorClientTest.java,187,0,0,26,0,26
 pulsar-master\pulsar-master\pulsar-common\src\main\java\org\apache\pulsar\common\naming\NamespaceName.java,187,56,7,14,0,77
 pulsar-master\pulsar-master\pulsar-broker\src\test\java\org\apache\pulsar\broker\lookup\http\HttpTopicLookupv2Test.java,187,43,8,27,0,78
 pulsar-master\pulsar-master\pulsar-common\src\main\java\org\apache\pulsar\common\api\raw\RawMessageImpl.java,187,35,2,14,0,51
 rocketmq-develop\rocketmq-develop\remoting\src\main\java\org\apache\rocketmq\remoting\protocol\RocketMQSerializable.java,187,25,10,5,1,41
 skywalking-master\skywalking-master\oap-server\server-storage-plugin\storage-zipkin-elasticsearch-plugin\src\main\java\org\apache\skywalking\oap\server\storage\plugin\zipkin\elasticsearch\ZipkinTraceQueryEsDAO.java,187,44,3,35,0,82
 zookeeper-master\zookeeper-master\zookeeper-server\src\test\java\org\apache\zookeeper\test\PersistentWatcherTest.java,187,0,19,26,0,45
 dubbo-3.0\dubbo-3.0\dubbo-remoting\dubbo-remoting-api\src\test\java\org\apache\dubbo\remoting\PerformanceClientTest.java,188,34,2,21,4,61
 dubbo-3.0\dubbo-3.0\dubbo-common\src\test\java\org\apache\dubbo\common\utils\CollectionUtilsTest.java,188,40,14,16,1,71
 hadoop-trunk\hadoop-trunk\hadoop-hdfs-project\hadoop-hdfs\src\main\java\org\apache\hadoop\hdfs\tools\offlineImageViewer\ImageVisitor.java,188,109,1,1,0,111
 hadoop-trunk\hadoop-trunk\hadoop-yarn-project\hadoop-yarn\hadoop-yarn-server\hadoop-yarn-server-nodemanager\src\test\java\org\apache\hadoop\yarn\server\nodemanager\containermanager\localizer\TestLocalizedResource.java,188,30,0,9,0,39
 hadoop-trunk\hadoop-trunk\hadoop-yarn-project\hadoop-yarn\hadoop-yarn-server\hadoop-yarn-server-tests\src\test\java\org\apache\hadoop\yarn\server\TestMiniYarnClusterNodeUtilization.java,188,45,3,1,1,50
 hadoop-trunk\hadoop-trunk\hadoop-yarn-project\hadoop-yarn\hadoop-yarn-api\src\main\java\org\apache\hadoop\yarn\api\records\ReservationDefinition.java,188,24,1,1,0,26
 hadoop-trunk\hadoop-trunk\hadoop-yarn-project\hadoop-yarn\hadoop-yarn-server\hadoop-yarn-server-resourcemanager\src\main\java\org\apache\hadoop\yarn\server\resourcemanager\scheduler\capacity\WorkflowPriorityMappingsManager.java,188,49,6,1,3,59
 hadoop-trunk\hadoop-trunk\hadoop-hdfs-project\hadoop-hdfs\src\test\java\org\apache\hadoop\hdfs\TestDatanodeReport.java,188,41,6,9,3,59
 hadoop-trunk\hadoop-trunk\hadoop-mapreduce-project\hadoop-mapreduce-client\hadoop-mapreduce-client-core\src\main\java\org\apache\hadoop\mapreduce\OutputCommitter.java,188,52,2,1,0,55
 hadoop-trunk\hadoop-trunk\hadoop-yarn-project\hadoop-yarn\hadoop-yarn-common\src\main\java\org\apache\hadoop\yarn\client\api\impl\TimelineReaderClientImpl.java,188,42,4,4,0,50
 hadoop-trunk\hadoop-trunk\hadoop-mapreduce-project\hadoop-mapreduce-client\hadoop-mapreduce-client-core\src\main\java\org\apache\hadoop\mapred\MROutputFiles.java,188,22,3,1,1,27
 hadoop-trunk\hadoop-trunk\hadoop-tools\hadoop-aws\src\main\java\org\apache\hadoop\fs\s3a\auth\STSClientFactory.java,188,11,2,4,0,17
 kafka-trunk\kafka-trunk\connect\runtime\src\main\java\org\apache\kafka\connect\runtime\distributed\WorkerGroupMember.java,188,0,8,35,0,43
 kafka-trunk\kafka-trunk\storage\src\generated\java\org\apache\kafka\server\log\remote\metadata\storage\generated\RemoteLogSegmentMetadataRecordJsonConverter.java,188,0,0,56,0,56
 kafka-trunk\kafka-trunk\raft\src\main\java\org\apache\kafka\raft\RequestManager.java,188,0,1,8,1,10
 kafka-trunk\kafka-trunk\metadata\src\generated\java\org\apache\kafka\common\metadata\RegisterBrokerRecordJsonConverter.java,188,0,0,45,0,45
 kafka-trunk\kafka-trunk\clients\src\main\java\org\apache\kafka\common\security\oauthbearer\secured\ConfigurationUtils.java,188,0,22,20,1,43
 pulsar-master\pulsar-master\pulsar-client\src\test\java\org\apache\pulsar\client\impl\TypedMessageBuilderImplTest.java,188,79,2,60,0,141
 pulsar-master\pulsar-master\pulsar-metadata\src\main\java\org\apache\pulsar\metadata\bookkeeper\AbstractHierarchicalLedgerManager.java,188,47,2,16,0,65
 rocketmq-develop\rocketmq-develop\store\src\test\java\org\apache\rocketmq\store\schedule\ScheduleMessageServiceTest.java,188,68,3,20,2,93
 zookeeper-master\zookeeper-master\zookeeper-server\src\test\java\org\apache\zookeeper\server\quorum\auth\QuorumAuthUpgradeTest.java,188,0,11,41,0,52
 zookeeper-master\zookeeper-master\zookeeper-server\src\main\java\org\apache\zookeeper\metrics\impl\DefaultMetricsProvider.java,188,0,2,22,0,24
 zookeeper-master\zookeeper-master\zookeeper-server\src\test\java\org\apache\zookeeper\server\quorum\auth\QuorumKerberosHostBasedAuthTest.java,188,0,7,35,0,42
 hadoop-trunk\hadoop-trunk\hadoop-hdfs-project\hadoop-hdfs\src\test\java\org\apache\hadoop\hdfs\server\namenode\TestLargeDirectoryDelete.java,189,48,7,3,5,63
 hadoop-trunk\hadoop-trunk\hadoop-common-project\hadoop-common\src\test\java\org\apache\hadoop\fs\statistics\TestMeanStatistic.java,189,32,0,1,0,33
 hadoop-trunk\hadoop-trunk\hadoop-hdfs-project\hadoop-hdfs\src\test\java\org\apache\hadoop\TestGenericRefresh.java,189,54,4,20,2,80
 hadoop-trunk\hadoop-trunk\hadoop-yarn-project\hadoop-yarn\hadoop-yarn-server\hadoop-yarn-server-timelineservice\src\main\java\org\apache\hadoop\yarn\server\timelineservice\reader\TimelineReaderManager.java,189,24,2,1,2,29
 hadoop-trunk\hadoop-trunk\hadoop-yarn-project\hadoop-yarn\hadoop-yarn-api\src\main\java\org\apache\hadoop\yarn\api\records\QueueConfigurations.java,189,6,0,1,0,7
 hadoop-trunk\hadoop-trunk\hadoop-hdfs-project\hadoop-hdfs\src\main\java\org\apache\hadoop\hdfs\server\common\JspHelper.java,189,47,4,8,0,59
 hadoop-trunk\hadoop-trunk\hadoop-common-project\hadoop-common\src\test\java\org\apache\hadoop\service\TestGlobalStateChangeListener.java,189,20,9,3,0,32
 hadoop-trunk\hadoop-trunk\hadoop-common-project\hadoop-common\src\test\java\org\apache\hadoop\util\TestFindClass.java,189,38,13,1,3,55
 hadoop-trunk\hadoop-trunk\hadoop-common-project\hadoop-common\src\test\java\org\apache\hadoop\io\TestWritable.java,189,86,20,6,3,115
 hadoop-trunk\hadoop-trunk\hadoop-common-project\hadoop-common\src\test\java\org\apache\hadoop\io\TestArrayFile.java,189,63,14,4,4,85
 hadoop-trunk\hadoop-trunk\hadoop-yarn-project\hadoop-yarn\hadoop-yarn-server\hadoop-yarn-server-resourcemanager\src\test\java\org\apache\hadoop\yarn\server\resourcemanager\scheduler\capacity\conf\TestFSSchedulerConfigurationStore.java,189,16,1,1,1,19
 hadoop-trunk\hadoop-trunk\hadoop-hdfs-project\hadoop-hdfs\src\test\java\org\apache\hadoop\hdfs\server\datanode\TestDataNodeErasureCodingMetrics.java,189,38,7,1,1,47
 hadoop-trunk\hadoop-trunk\hadoop-yarn-project\hadoop-yarn\hadoop-yarn-server\hadoop-yarn-server-resourcemanager\src\test\java\org\apache\hadoop\yarn\server\resourcemanager\scheduler\TestAppSchedulingInfo.java,189,21,1,3,4,29
 hadoop-trunk\hadoop-trunk\hadoop-yarn-project\hadoop-yarn\hadoop-yarn-server\hadoop-yarn-server-resourcemanager\src\main\java\org\apache\hadoop\yarn\server\resourcemanager\scheduler\capacity\placement\MappingRuleCreator.java,189,27,0,13,0,40
 hadoop-trunk\hadoop-trunk\hadoop-common-project\hadoop-kms\src\test\java\org\apache\hadoop\crypto\key\kms\server\TestKMSACLs.java,189,7,2,3,1,13
 kafka-trunk\kafka-trunk\clients\src\generated\java\org\apache\kafka\common\message\HeartbeatResponseData.java,189,0,0,13,1,14
 kafka-trunk\kafka-trunk\streams\src\test\java\org\apache\kafka\streams\integration\InternalTopicIntegrationTest.java,189,0,3,38,5,46
 kafka-trunk\kafka-trunk\clients\src\main\java\org\apache\kafka\common\security\ssl\SslPrincipalMapper.java,189,0,0,21,1,22
 kafka-trunk\kafka-trunk\streams\src\test\java\org\apache\kafka\streams\processor\internals\GlobalStateTaskTest.java,189,0,2,17,5,24
 pulsar-master\pulsar-master\pulsar-testclient\src\test\java\org\apache\pulsar\testclient\PerformanceTransactionTest.java,189,52,2,32,0,86
 pulsar-master\pulsar-master\pulsar-broker-common\src\test\java\org\apache\pulsar\broker\authentication\AuthenticationProviderListTest.java,189,74,8,34,0,116
 skywalking-master\skywalking-master\oap-server\server-configuration\configuration-apollo\src\test\java\org\apache\skywalking\oap\server\configuration\apollo\ITApolloConfigurationTest.java,189,80,5,50,0,135
 hadoop-trunk\hadoop-trunk\hadoop-mapreduce-project\hadoop-mapreduce-examples\src\main\java\org\apache\hadoop\examples\SecondarySort.java,190,90,2,3,0,95
 hadoop-trunk\hadoop-trunk\hadoop-tools\hadoop-sls\src\test\java\org\apache\hadoop\yarn\sls\nodemanager\TestNMSimulator.java,190,52,6,3,1,62
 hadoop-trunk\hadoop-trunk\hadoop-yarn-project\hadoop-yarn\hadoop-yarn-applications\hadoop-yarn-services\hadoop-yarn-services-core\src\test\java\org\apache\hadoop\yarn\service\conf\TestAppJsonResolve.java,190,18,5,1,0,24
 hadoop-trunk\hadoop-trunk\hadoop-common-project\hadoop-common\src\main\java\org\apache\hadoop\security\token\delegation\web\DelegationTokenManager.java,190,68,5,6,2,81
 hadoop-trunk\hadoop-trunk\hadoop-yarn-project\hadoop-yarn\hadoop-yarn-applications\hadoop-yarn-services\hadoop-yarn-services-core\src\main\java\org\apache\hadoop\yarn\service\utils\JsonSerDeser.java,190,41,1,2,3,47
 hadoop-trunk\hadoop-trunk\hadoop-mapreduce-project\hadoop-mapreduce-client\hadoop-mapreduce-client-app\src\main\java\org\apache\hadoop\mapreduce\v2\app\TaskHeartbeatHandler.java,190,70,7,2,0,79
 hadoop-trunk\hadoop-trunk\hadoop-common-project\hadoop-common\src\test\java\org\apache\hadoop\fs\shell\TestCopyPreserveFlag.java,190,61,0,1,0,62
 hadoop-trunk\hadoop-trunk\hadoop-yarn-project\hadoop-yarn\hadoop-yarn-server\hadoop-yarn-server-resourcemanager\src\main\java\org\apache\hadoop\yarn\server\resourcemanager\scheduler\capacity\AutoCreatedQueueTemplate.java,190,27,4,6,3,40
 hadoop-trunk\hadoop-trunk\hadoop-mapreduce-project\hadoop-mapreduce-client\hadoop-mapreduce-client-jobclient\src\test\java\org\apache\hadoop\mapred\TestMiniMRClientCluster.java,190,39,5,2,0,46
 hadoop-trunk\hadoop-trunk\hadoop-tools\hadoop-azure\src\test\java\org\apache\hadoop\fs\azure\ITestBlobDataValidation.java,190,40,6,5,2,53
 hadoop-trunk\hadoop-trunk\hadoop-yarn-project\hadoop-yarn\hadoop-yarn-server\hadoop-yarn-server-web-proxy\src\main\java\org\apache\hadoop\yarn\server\webproxy\amfilter\AmIpFilter.java,190,40,5,1,1,47
 hadoop-trunk\hadoop-trunk\hadoop-hdfs-project\hadoop-hdfs\src\main\java\org\apache\hadoop\hdfs\server\diskbalancer\command\ReportCommand.java,190,21,0,5,1,27
 hadoop-trunk\hadoop-trunk\hadoop-common-project\hadoop-common\src\test\java\org\apache\hadoop\util\TestFileBasedIPList.java,190,33,27,1,5,66
 hadoop-trunk\hadoop-trunk\hadoop-hdfs-project\hadoop-hdfs\src\main\java\org\apache\hadoop\hdfs\tools\NNHAServiceTarget.java,190,56,2,2,0,60
 kafka-trunk\kafka-trunk\streams\src\test\java\org\apache\kafka\streams\processor\internals\StreamsAssignmentScaleTest.java,190,0,1,47,0,48
 kafka-trunk\kafka-trunk\streams\src\test\java\org\apache\kafka\streams\query\PositionTest.java,190,0,0,12,0,12
 kafka-trunk\kafka-trunk\core\src\test\java\kafka\test\junit\RaftClusterInvocationContext.java,190,0,0,24,0,24
 rocketmq-develop\rocketmq-develop\client\src\main\java\org\apache\rocketmq\client\consumer\store\LocalFileOffsetStore.java,190,53,6,20,0,79
 zookeeper-master\zookeeper-master\zookeeper-server\src\test\java\org\apache\zookeeper\common\ZKTrustManagerTest.java,190,0,4,39,2,45
 dubbo-3.0\dubbo-3.0\dubbo-metadata\dubbo-metadata-report-redis\src\test\java\org\apache\dubbo\metadata\store\redis\RedisMetadataReportTest.java,191,89,4,37,0,130
 hadoop-trunk\hadoop-trunk\hadoop-common-project\hadoop-common\src\main\java\org\apache\hadoop\net\NodeBase.java,191,108,2,6,3,119
 hadoop-trunk\hadoop-trunk\hadoop-tools\hadoop-azure\src\test\java\org\apache\hadoop\fs\azurebfs\ITestAzureBlobFileSystemE2E.java,191,35,0,12,5,52
 hadoop-trunk\hadoop-trunk\hadoop-hdfs-project\hadoop-hdfs\src\main\java\org\apache\hadoop\hdfs\server\datanode\checker\StorageLocationChecker.java,191,16,7,5,0,28
 hadoop-trunk\hadoop-trunk\hadoop-tools\hadoop-openstack\src\main\java\org\apache\hadoop\fs\swift\http\HttpInputStreamWithRelease.java,191,36,5,3,0,44
 hadoop-trunk\hadoop-trunk\hadoop-yarn-project\hadoop-yarn\hadoop-yarn-server\hadoop-yarn-server-common\src\main\java\org\apache\hadoop\yarn\server\AMHeartbeatRequestHandler.java,191,41,7,1,8,57
 hadoop-trunk\hadoop-trunk\hadoop-mapreduce-project\hadoop-mapreduce-client\hadoop-mapreduce-client-jobclient\src\test\java\org\apache\hadoop\mapreduce\lib\input\TestMRCJCFileInputFormat.java,191,66,6,2,0,74
 hadoop-trunk\hadoop-trunk\hadoop-mapreduce-project\hadoop-mapreduce-client\hadoop-mapreduce-client-app\src\main\java\org\apache\hadoop\mapreduce\v2\app\JobEndNotifier.java,191,43,2,1,5,51
 hadoop-trunk\hadoop-trunk\hadoop-mapreduce-project\hadoop-mapreduce-client\hadoop-mapreduce-client-hs\src\test\java\org\apache\hadoop\mapreduce\v2\hs\MockHistoryJobs.java,191,46,0,3,0,49
 hadoop-trunk\hadoop-trunk\hadoop-mapreduce-project\hadoop-mapreduce-client\hadoop-mapreduce-client-jobclient\src\test\java\org\apache\hadoop\mapred\TestMRCJCFileOutputCommitter.java,191,32,12,4,6,54
 hadoop-trunk\hadoop-trunk\hadoop-common-project\hadoop-common\src\test\java\org\apache\hadoop\security\TestFixKerberosTicketOrder.java,191,13,0,1,2,16
 hadoop-trunk\hadoop-trunk\hadoop-tools\hadoop-sls\src\main\java\org\apache\hadoop\yarn\sls\NMRunner.java,191,66,1,2,7,76
 hadoop-trunk\hadoop-trunk\hadoop-hdfs-project\hadoop-hdfs\src\test\java\org\apache\hadoop\hdfs\DataNodeCluster.java,191,78,17,7,0,102
 kafka-trunk\kafka-trunk\connect\file\src\test\java\org\apache\kafka\connect\file\FileStreamSourceTaskTest.java,191,0,4,23,16,43
 kafka-trunk\kafka-trunk\connect\mirror-client\src\main\java\org\apache\kafka\connect\mirror\MirrorClient.java,191,0,2,30,0,32
 kafka-trunk\kafka-trunk\connect\runtime\src\test\java\org\apache\kafka\connect\integration\ExampleConnectIntegrationTest.java,191,0,0,44,0,44
 rocketmq-develop\rocketmq-develop\tools\src\test\java\org\apache\rocketmq\tools\command\message\QueryMsgByUniqueKeySubCommandTest.java,191,59,11,34,10,114
 zookeeper-master\zookeeper-master\zookeeper-server\src\main\java\org\apache\zookeeper\server\SnapshotFormatter.java,191,0,11,25,5,41
 dubbo-3.0\dubbo-3.0\dubbo-remoting\dubbo-remoting-api\src\main\java\org\apache\dubbo\remoting\buffer\HeapChannelBuffer.java,192,74,0,6,1,81
 dubbo-3.0\dubbo-3.0\dubbo-registry\dubbo-registry-multiple\src\main\java\org\apache\dubbo\registry\multiple\MultipleServiceDiscovery.java,192,98,3,37,0,138
 dubbo-3.0\dubbo-3.0\dubbo-registry\dubbo-registry-api\src\test\java\org\apache\dubbo\registry\client\migration\MigrationInvokerTest.java,192,56,0,31,0,87
 dubbo-3.0\dubbo-3.0\dubbo-rpc\dubbo-rpc-grpc\src\main\java\org\apache\dubbo\rpc\protocol\grpc\GrpcOptionsUtils.java,192,46,7,43,0,96
 hadoop-trunk\hadoop-trunk\hadoop-tools\hadoop-aws\src\main\java\org\apache\hadoop\fs\s3a\auth\AssumedRoleCredentialProvider.java,192,19,1,3,2,25
 hadoop-trunk\hadoop-trunk\hadoop-hdfs-project\hadoop-hdfs\src\main\java\org\apache\hadoop\hdfs\server\datanode\fsdataset\impl\ReservedSpaceCalculator.java,192,60,1,6,3,70
 hadoop-trunk\hadoop-trunk\hadoop-yarn-project\hadoop-yarn\hadoop-yarn-server\hadoop-yarn-server-resourcemanager\src\main\java\org\apache\hadoop\yarn\server\resourcemanager\security\AppPriorityACLsManager.java,192,31,2,2,0,35
 hadoop-trunk\hadoop-trunk\hadoop-tools\hadoop-resourceestimator\src\test\java\org\apache\hadoop\resourceestimator\translator\impl\TestRmParser.java,192,22,0,6,0,28
 hadoop-trunk\hadoop-trunk\hadoop-tools\hadoop-datajoin\src\main\java\org\apache\hadoop\contrib\utils\join\DataJoinReducerBase.java,192,85,12,9,6,112
 hadoop-trunk\hadoop-trunk\hadoop-hdfs-project\hadoop-hdfs\src\test\java\org\apache\hadoop\hdfs\server\datanode\TestDataNodeVolumeMetrics.java,192,15,31,1,3,50
 hadoop-trunk\hadoop-trunk\hadoop-mapreduce-project\hadoop-mapreduce-client\hadoop-mapreduce-client-core\src\main\java\org\apache\hadoop\mapreduce\QueueInfo.java,192,74,0,1,4,79
 hadoop-trunk\hadoop-trunk\hadoop-yarn-project\hadoop-yarn\hadoop-yarn-api\src\main\java\org\apache\hadoop\yarn\api\records\ContainerLaunchContext.java,192,33,0,5,0,38
 kafka-trunk\kafka-trunk\clients\src\main\java\org\apache\kafka\common\security\oauthbearer\OAuthBearerLoginModule.java,192,0,23,40,2,65
 kafka-trunk\kafka-trunk\clients\src\generated\java\org\apache\kafka\common\message\RenewDelegationTokenResponseData.java,192,0,0,18,1,19
 kafka-trunk\kafka-trunk\clients\src\main\java\org\apache\kafka\clients\MetadataCache.java,192,0,2,31,0,33
 kafka-trunk\kafka-trunk\clients\src\generated\java\org\apache\kafka\common\message\ExpireDelegationTokenResponseData.java,192,0,0,18,1,19
 kafka-trunk\kafka-trunk\streams\src\test\java\org\apache\kafka\streams\integration\KTableKTableForeignKeyInnerJoinCustomPartitionerIntegrationTest.java,192,0,0,49,4,53
 kafka-trunk\kafka-trunk\metadata\src\generated\java\org\apache\kafka\common\metadata\FeatureLevelRecord.java,192,0,0,12,3,15
 kafka-trunk\kafka-trunk\clients\src\generated\java\org\apache\kafka\common\message\DescribeLogDirsResponseDataJsonConverter.java,192,0,0,48,0,48
 pulsar-master\pulsar-master\pulsar-client\src\main\java\org\apache\pulsar\client\impl\HttpClient.java,192,67,9,42,0,118
 pulsar-master\pulsar-master\pulsar-functions\worker\src\main\java\org\apache\pulsar\functions\worker\MembershipManager.java,192,48,5,32,0,85
 skywalking-master\skywalking-master\oap-server\server-storage-plugin\storage-jdbc-hikaricp-plugin\src\main\java\org\apache\skywalking\oap\server\storage\plugin\jdbc\h2\dao\H2ProfileThreadSnapshotQueryDAO.java,192,70,2,51,0,123
 dubbo-3.0\dubbo-3.0\dubbo-config\dubbo-config-api\src\test\java\org\apache\dubbo\config\integration\single\exportprovider\SingleRegistryCenterExportProviderIntegrationTest.java,193,51,2,39,0,92
 hadoop-trunk\hadoop-trunk\hadoop-yarn-project\hadoop-yarn\hadoop-yarn-common\src\main\java\org\apache\hadoop\yarn\util\timeline\TimelineUtils.java,193,38,4,1,0,43
 hadoop-trunk\hadoop-trunk\hadoop-yarn-project\hadoop-yarn\hadoop-yarn-server\hadoop-yarn-server-resourcemanager\src\main\java\org\apache\hadoop\yarn\server\resourcemanager\scheduler\capacity\QueuePath.java,193,15,1,4,0,20
 hadoop-trunk\hadoop-trunk\hadoop-tools\hadoop-archive-logs\src\main\java\org\apache\hadoop\tools\HadoopArchiveLogsRunner.java,193,37,9,1,4,51
 hadoop-trunk\hadoop-trunk\hadoop-yarn-project\hadoop-yarn\hadoop-yarn-common\src\main\java\org\apache\hadoop\yarn\api\protocolrecords\impl\pb\StopContainersResponsePBImpl.java,193,36,64,5,0,105
 hadoop-trunk\hadoop-trunk\hadoop-yarn-project\hadoop-yarn\hadoop-yarn-server\hadoop-yarn-server-applicationhistoryservice\src\main\java\org\apache\hadoop\yarn\server\applicationhistoryservice\records\impl\pb\ApplicationFinishDataPBImpl.java,193,42,66,4,0,112
 hadoop-trunk\hadoop-trunk\hadoop-common-project\hadoop-common\src\main\java\org\apache\hadoop\fs\impl\FileSystemMultipartUploader.java,193,36,4,1,2,43
 hadoop-trunk\hadoop-trunk\hadoop-mapreduce-project\hadoop-mapreduce-client\hadoop-mapreduce-client-hs\src\test\java\org\apache\hadoop\mapreduce\v2\hs\TestHistoryServerFileSystemStateStoreService.java,193,11,2,2,6,21
 kafka-trunk\kafka-trunk\clients\src\main\java\org\apache\kafka\clients\producer\internals\SenderMetricsRegistry.java,193,0,1,20,2,23
 kafka-trunk\kafka-trunk\streams\src\main\java\org\apache\kafka\streams\query\StateQueryRequest.java,193,0,0,13,0,13
 pulsar-master\pulsar-master\pulsar-sql\presto-pulsar\src\main\java\org\apache\pulsar\sql\presto\PulsarColumnMetadata.java,193,93,1,15,0,109
 pulsar-master\pulsar-master\pulsar-io\debezium\core\src\test\java\org\apache\pulsar\io\debezium\PulsarDatabaseHistoryTest.java,193,55,3,25,0,83
 pulsar-master\pulsar-master\pulsar-sql\presto-pulsar\src\main\java\org\apache\pulsar\sql\presto\PulsarSplit.java,193,97,1,5,0,103
 pulsar-master\pulsar-master\managed-ledger\src\test\java\org\apache\bookkeeper\mledger\impl\ReadOnlyCursorTest.java,193,33,6,16,0,55
 rocketmq-develop\rocketmq-develop\remoting\src\main\java\org\apache\rocketmq\remoting\common\RemotingUtil.java,193,41,9,18,6,74
 rocketmq-develop\rocketmq-develop\client\src\test\java\org\apache\rocketmq\client\impl\consumer\ConsumeMessageConcurrentlyServiceTest.java,193,83,9,45,6,143
 shardingsphere-master\shardingsphere-master\shardingsphere-jdbc\shardingsphere-jdbc-core\src\main\java\org\apache\shardingsphere\driver\jdbc\unsupported\AbstractUnsupportedGeneratedKeysResultSet.java,193,58,0,21,0,79
 zookeeper-master\zookeeper-master\zookeeper-server\src\main\java\org\apache\zookeeper\server\PurgeTxnLog.java,193,0,1,28,0,29
 zookeeper-master\zookeeper-master\zookeeper-server\src\main\java\org\apache\zookeeper\server\quorum\ReadOnlyZooKeeperServer.java,193,0,2,15,1,18
 zookeeper-master\zookeeper-master\zookeeper-server\src\main\java\org\apache\zookeeper\server\auth\X509AuthenticationProvider.java,193,0,7,24,0,31
 zookeeper-master\zookeeper-master\zookeeper-server\src\test\java\org\apache\zookeeper\server\ConnectionMetricsTest.java,193,0,3,13,0,16
 dubbo-3.0\dubbo-3.0\dubbo-remoting\dubbo-remoting-netty4\src\main\java\org\apache\dubbo\remoting\transport\netty4\NettyClient.java,194,52,9,31,0,92
 hadoop-trunk\hadoop-trunk\hadoop-hdfs-project\hadoop-hdfs\src\test\java\org\apache\hadoop\hdfs\TestDFSInputStreamBlockLocations.java,194,41,4,12,5,62
 hadoop-trunk\hadoop-trunk\hadoop-yarn-project\hadoop-yarn\hadoop-yarn-server\hadoop-yarn-server-common\src\main\java\org\apache\hadoop\yarn\server\api\records\impl\pb\AppCollectorDataPBImpl.java,194,38,55,3,0,96
 hadoop-trunk\hadoop-trunk\hadoop-hdfs-project\hadoop-hdfs\src\test\java\org\apache\hadoop\hdfs\web\TestFSMainOperationsWebHdfs.java,194,41,8,4,2,55
 hadoop-trunk\hadoop-trunk\hadoop-yarn-project\hadoop-yarn\hadoop-yarn-common\src\main\java\org\apache\hadoop\yarn\api\protocolrecords\impl\pb\ContainerUpdateResponsePBImpl.java,194,26,60,4,0,90
 hadoop-trunk\hadoop-trunk\hadoop-yarn-project\hadoop-yarn\hadoop-yarn-api\src\main\java\org\apache\hadoop\yarn\api\protocolrecords\RegisterApplicationMasterResponse.java,194,27,3,4,0,34
 hadoop-trunk\hadoop-trunk\hadoop-hdfs-project\hadoop-hdfs\src\test\java\org\apache\hadoop\hdfs\BenchmarkThroughput.java,194,50,7,1,12,70
 hadoop-trunk\hadoop-trunk\hadoop-hdfs-project\hadoop-hdfs-rbf\src\main\java\org\apache\hadoop\hdfs\server\federation\store\impl\MountTableStoreImpl.java,194,16,0,14,0,30
 hadoop-trunk\hadoop-trunk\hadoop-tools\hadoop-distcp\src\test\java\org\apache\hadoop\tools\TestDistCpWithRawXAttrs.java,194,51,0,1,0,52
 hadoop-trunk\hadoop-trunk\hadoop-tools\hadoop-aws\src\test\java\org\apache\hadoop\fs\s3a\impl\ITestRenameDeleteRace.java,194,2,0,2,0,4
 hadoop-trunk\hadoop-trunk\hadoop-mapreduce-project\hadoop-mapreduce-client\hadoop-mapreduce-client-jobclient\src\test\java\org\apache\hadoop\mapreduce\lib\chain\TestChainErrors.java,194,28,7,1,0,36
 kafka-trunk\kafka-trunk\streams\src\test\java\org\apache\kafka\streams\processor\internals\assignment\AssignmentInfoTest.java,194,0,0,54,0,54
 kafka-trunk\kafka-trunk\clients\src\main\java\org\apache\kafka\common\requests\ProduceResponse.java,194,0,44,18,2,64
 kafka-trunk\kafka-trunk\clients\src\main\java\org\apache\kafka\common\metrics\stats\Histogram.java,194,0,6,16,2,24
 kafka-trunk\kafka-trunk\clients\src\generated\java\org\apache\kafka\common\message\DescribeQuorumResponseDataJsonConverter.java,194,0,0,47,0,47
 kafka-trunk\kafka-trunk\streams\src\test\java\org\apache\kafka\streams\kstream\internals\graph\GraphGraceSearchUtilTest.java,194,0,6,33,2,41
 kafka-trunk\kafka-trunk\clients\src\generated\java\org\apache\kafka\common\message\ListOffsetsResponseDataJsonConverter.java,194,0,0,44,0,44
 kafka-trunk\kafka-trunk\clients\src\test\java\org\apache\kafka\common\requests\OffsetFetchRequestTest.java,194,0,10,23,10,43
 pulsar-master\pulsar-master\pulsar-client\src\test\java\org\apache\pulsar\client\impl\conf\ConfigurationDataUtilsTest.java,194,57,3,21,0,81
 pulsar-master\pulsar-master\pulsar-broker\src\main\java\org\apache\pulsar\broker\admin\v3\Packages.java,194,81,3,27,0,111
 pulsar-master\pulsar-master\pulsar-broker\src\test\java\org\apache\pulsar\common\naming\ServiceConfigurationTest.java,194,66,5,36,0,107
 rocketmq-develop\rocketmq-develop\client\src\test\java\org\apache\rocketmq\client\impl\consumer\ConsumeMessageOrderlyServiceTest.java,194,77,11,41,7,136
 skywalking-master\skywalking-master\oap-server\server-receiver-plugin\envoy-metrics-receiver-plugin\src\main\java\org\apache\skywalking\oap\server\receiver\envoy\als\LogEntry2MetricsAdapter.java,194,42,0,24,0,66
 skywalking-master\skywalking-master\oap-server\server-storage-plugin\storage-jdbc-hikaricp-plugin\src\main\java\org\apache\skywalking\oap\server\storage\plugin\jdbc\h2\dao\H2MetricsQueryDAO.java,194,40,1,29,0,70
 zookeeper-master\zookeeper-master\zookeeper-server\src\main\java\org\apache\zookeeper\server\quorum\LeaderSessionTracker.java,194,0,7,13,0,20
 dubbo-3.0\dubbo-3.0\dubbo-monitor\dubbo-monitor-default\src\test\java\org\apache\dubbo\monitor\dubbo\DubboMonitorTest.java,195,52,11,23,0,86
 hadoop-trunk\hadoop-trunk\hadoop-yarn-project\hadoop-yarn\hadoop-yarn-server\hadoop-yarn-server-timelineservice-hbase-tests\src\test\java\org\apache\hadoop\yarn\server\timelineservice\storage\TestTimelineReaderHBaseDown.java,195,31,0,6,0,37
 hadoop-trunk\hadoop-trunk\hadoop-tools\hadoop-azure\src\test\java\org\apache\hadoop\fs\azure\ITestAzureFileSystemErrorConditions.java,195,26,4,5,4,39
 hadoop-trunk\hadoop-trunk\hadoop-yarn-project\hadoop-yarn\hadoop-yarn-server\hadoop-yarn-server-resourcemanager\src\main\java\org\apache\hadoop\yarn\server\resourcemanager\scheduler\placement\AppPlacementAllocator.java,195,31,5,8,2,46
 hadoop-trunk\hadoop-trunk\hadoop-common-project\hadoop-kms\src\test\java\org\apache\hadoop\crypto\key\kms\server\TestKMSAudit.java,195,18,7,1,3,29
 hadoop-trunk\hadoop-trunk\hadoop-hdfs-project\hadoop-hdfs\src\test\java\org\apache\hadoop\hdfs\server\datanode\TestBpServiceActorScheduler.java,195,23,7,7,0,37
 hadoop-trunk\hadoop-trunk\hadoop-hdfs-project\hadoop-hdfs-rbf\src\main\java\org\apache\hadoop\hdfs\server\federation\resolver\PathLocation.java,195,13,0,1,0,14
 hadoop-trunk\hadoop-trunk\hadoop-common-project\hadoop-common\src\test\java\org\apache\hadoop\conf\TestCommonConfigurationFields.java,195,8,8,2,1,19
 hadoop-trunk\hadoop-trunk\hadoop-yarn-project\hadoop-yarn\hadoop-yarn-common\src\main\java\org\apache\hadoop\yarn\nodelabels\store\AbstractFSNodeStore.java,195,56,12,1,2,71
 kafka-trunk\kafka-trunk\clients\src\generated\java\org\apache\kafka\common\message\DescribeClientQuotasResponseDataJsonConverter.java,195,0,0,38,0,38
 kafka-trunk\kafka-trunk\clients\src\main\java\org\apache\kafka\common\security\oauthbearer\internals\OAuthBearerSaslServer.java,195,0,14,42,1,57
 pulsar-master\pulsar-master\pulsar-metadata\src\test\java\org\apache\pulsar\metadata\bookkeeper\PulsarRegistrationManagerTest.java,195,78,1,24,0,103
 pulsar-master\pulsar-master\pulsar-client\src\main\java\org\apache\pulsar\client\impl\ReaderImpl.java,195,70,3,31,0,104
 pulsar-master\pulsar-master\pulsar-websocket\src\test\java\org\apache\pulsar\websocket\admin\WebSocketWebResourceTest.java,195,42,1,22,0,65
 pulsar-master\pulsar-master\pulsar-io\jdbc\core\src\main\java\org\apache\pulsar\io\jdbc\JdbcAbstractSink.java,195,42,4,16,0,62
 pulsar-master\pulsar-master\pulsar-broker\src\test\java\org\apache\pulsar\client\api\MutualAuthenticationTest.java,195,53,2,18,0,73
 rocketmq-develop\rocketmq-develop\test\src\main\java\org\apache\rocketmq\test\client\rmq\RMQAsyncSendProducer.java,195,89,0,10,19,118
 skywalking-master\skywalking-master\oap-server\server-core\src\test\java\org\apache\skywalking\oap\server\core\analysis\meter\function\PercentileFunctionTest.java,195,46,0,8,0,54
 skywalking-master\skywalking-master\oap-server\server-storage-plugin\storage-elasticsearch-plugin\src\test\java\org\apache\skywalking\oap\server\storage\plugin\elasticsearch\base\IndexStructuresTest.java,195,11,0,9,0,20
 zookeeper-master\zookeeper-master\zookeeper-server\src\main\java\org\apache\zookeeper\server\quorum\QuorumPeerMain.java,195,0,2,29,0,31
 zookeeper-master\zookeeper-master\zookeeper-server\src\test\java\org\apache\zookeeper\server\quorum\EphemeralNodeDeletionTest.java,195,0,22,15,2,39
 dubbo-3.0\dubbo-3.0\dubbo-registry\dubbo-registry-api\src\main\java\org\apache\dubbo\registry\client\metadata\ServiceInstanceMetadataUtils.java,196,84,1,40,0,125
 hadoop-trunk\hadoop-trunk\hadoop-yarn-project\hadoop-yarn\hadoop-yarn-common\src\main\java\org\apache\hadoop\yarn\api\impl\pb\service\ContainerManagementProtocolPBServiceImpl.java,196,53,71,48,0,172
 hadoop-trunk\hadoop-trunk\hadoop-common-project\hadoop-common\src\main\java\org\apache\hadoop\ipc\RpcClientUtil.java,196,58,11,5,1,75
 hadoop-trunk\hadoop-trunk\hadoop-hdfs-project\hadoop-hdfs\src\test\java\org\apache\hadoop\hdfs\server\namenode\snapshot\TestSnapshotReplication.java,196,57,2,2,2,63
 hadoop-trunk\hadoop-trunk\hadoop-yarn-project\hadoop-yarn\hadoop-yarn-server\hadoop-yarn-server-common\src\main\java\org\apache\hadoop\yarn\server\federation\policies\dao\WeightedPolicyInfo.java,196,17,2,2,4,25
 hadoop-trunk\hadoop-trunk\hadoop-common-project\hadoop-common\src\test\java\org\apache\hadoop\io\erasurecode\rawcoder\TestDecodingValidator.java,196,31,2,1,5,39
 hadoop-trunk\hadoop-trunk\hadoop-common-project\hadoop-common\src\main\java\org\apache\hadoop\security\authorize\ServiceAuthorizationManager.java,196,74,6,10,0,90
 hadoop-trunk\hadoop-trunk\hadoop-hdfs-project\hadoop-hdfs-rbf\src\main\java\org\apache\hadoop\hdfs\rbfbalance\MountTableProcedure.java,196,44,2,6,1,53
 hadoop-trunk\hadoop-trunk\hadoop-hdfs-project\hadoop-hdfs-httpfs\src\test\java\org\apache\hadoop\fs\http\server\TestHttpFSServerNoXAttrs.java,196,14,6,1,14,35
 hadoop-trunk\hadoop-trunk\hadoop-tools\hadoop-sls\src\main\java\org\apache\hadoop\yarn\sls\utils\SLSUtils.java,196,30,15,3,0,48
 hadoop-trunk\hadoop-trunk\hadoop-common-project\hadoop-common\src\main\java\org\apache\hadoop\conf\ReconfigurationServlet.java,196,79,11,2,0,92
 kafka-trunk\kafka-trunk\core\src\test\java\kafka\test\ClusterConfig.java,196,0,1,11,6,18
 kafka-trunk\kafka-trunk\metadata\src\test\java\org\apache\kafka\metadata\RecordTestUtils.java,196,0,8,9,1,18
 pulsar-master\pulsar-master\pulsar-client\src\main\java\org\apache\pulsar\client\impl\TopicMessageImpl.java,196,48,0,3,0,51
 pulsar-master\pulsar-master\pulsar-broker-auth-sasl\src\main\java\org\apache\pulsar\broker\authentication\SaslRoleToken.java,196,42,0,16,0,58
 pulsar-master\pulsar-master\pulsar-io\flume\src\main\java\org\apache\pulsar\io\flume\node\Application.java,196,48,13,20,0,81
 pulsar-master\pulsar-master\pulsar-broker\src\test\java\org\apache\pulsar\client\impl\MessageChecksumTest.java,196,56,3,41,0,100
 pulsar-master\pulsar-master\pulsar-proxy\src\test\java\org\apache\pulsar\proxy\server\ProxyWithAuthorizationNegTest.java,196,70,13,39,0,122
 pulsar-master\pulsar-master\pulsar-functions\runtime\src\main\java\org\apache\pulsar\functions\runtime\kubernetes\BasicKubernetesManifestCustomizer.java,196,67,0,35,0,102
 pulsar-master\pulsar-master\pulsar-broker\src\main\java\org\apache\pulsar\broker\intercept\BrokerInterceptors.java,196,78,2,22,0,102
 rocketmq-develop\rocketmq-develop\store\src\test\java\org\apache\rocketmq\store\BatchPutMessageTest.java,196,76,8,25,2,111
 skywalking-master\skywalking-master\oap-server\server-core\src\test\java\org\apache\skywalking\oap\server\core\remote\client\RemoteClientManagerTestCase.java,196,59,7,36,0,102
 zookeeper-master\zookeeper-master\zookeeper-server\src\test\java\org\apache\zookeeper\test\SaslKerberosAuthOverSSLTest.java,196,0,2,32,1,35
 dubbo-3.0\dubbo-3.0\dubbo-config\dubbo-config-api\src\test\java\org\apache\dubbo\config\ProviderConfigTest.java,197,44,0,2,0,46
 dubbo-3.0\dubbo-3.0\dubbo-common\src\main\java\org\apache\dubbo\common\config\ModuleEnvironment.java,197,64,0,14,5,83
 hadoop-trunk\hadoop-trunk\hadoop-mapreduce-project\hadoop-mapreduce-client\hadoop-mapreduce-client-common\src\main\java\org\apache\hadoop\mapreduce\v2\api\impl\pb\client\MRClientProtocolPBClientImpl.java,197,80,43,79,2,204
 hadoop-trunk\hadoop-trunk\hadoop-yarn-project\hadoop-yarn\hadoop-yarn-client\src\test\java\org\apache\hadoop\yarn\client\api\impl\TestAHSv2ClientImpl.java,197,23,0,1,6,30
 hadoop-trunk\hadoop-trunk\hadoop-hdfs-project\hadoop-hdfs\src\test\java\org\apache\hadoop\hdfs\server\namenode\TestGenericJournalConf.java,197,78,14,2,5,99
 hadoop-trunk\hadoop-trunk\hadoop-tools\hadoop-aws\src\test\java\org\apache\hadoop\fs\s3a\ITestLocatedFileStatusFetcher.java,197,14,7,5,1,27
 hadoop-trunk\hadoop-trunk\hadoop-common-project\hadoop-common\src\test\java\org\apache\hadoop\conf\TestConfServlet.java,197,32,4,2,3,41
 hadoop-trunk\hadoop-trunk\hadoop-mapreduce-project\hadoop-mapreduce-client\hadoop-mapreduce-client-jobclient\src\test\java\org\apache\hadoop\mapred\TestTextOutputFormat.java,197,23,2,5,3,33
 hadoop-trunk\hadoop-trunk\hadoop-yarn-project\hadoop-yarn\hadoop-yarn-server\hadoop-yarn-server-nodemanager\src\test\java\org\apache\hadoop\yarn\server\nodemanager\containermanager\localizer\sharedcache\TestSharedCacheUploader.java,197,16,0,6,0,22
 hadoop-trunk\hadoop-trunk\hadoop-tools\hadoop-azure\src\test\java\org\apache\hadoop\fs\azurebfs\services\ITestAbfsPositionedRead.java,197,26,1,4,5,36
 kafka-trunk\kafka-trunk\connect\transforms\src\main\java\org\apache\kafka\connect\transforms\HeaderFrom.java,197,0,1,27,0,28
 kafka-trunk\kafka-trunk\clients\src\test\java\org\apache\kafka\common\security\authenticator\SaslAuthenticatorFailureDelayTest.java,197,0,6,48,6,60
 kafka-trunk\kafka-trunk\clients\src\main\java\org\apache\kafka\common\security\scram\internals\ScramSaslClient.java,197,0,15,39,1,55
 pulsar-master\pulsar-master\pulsar-broker\src\test\java\org\apache\pulsar\compaction\CompactorTest.java,197,37,0,20,0,57
 skywalking-master\skywalking-master\oap-server\server-core\src\main\java\org\apache\skywalking\oap\server\core\profiling\trace\ProfileTaskQueryService.java,197,53,1,30,0,84
 skywalking-master\skywalking-master\oap-server\analyzer\meter-analyzer\src\test\java\org\apache\skywalking\oap\meter\analyzer\dsl\AnalyzerTest.java,197,67,13,33,0,113
 zookeeper-master\zookeeper-master\zookeeper-server\src\test\java\org\apache\zookeeper\server\NettyServerCnxnFactoryTest.java,197,0,2,21,0,23
 zookeeper-master\zookeeper-master\zookeeper-server\src\main\java\org\apache\zookeeper\server\WorkerService.java,197,0,4,12,1,17
 dubbo-3.0\dubbo-3.0\dubbo-remoting\dubbo-remoting-api\src\main\java\org\apache\dubbo\remoting\exchange\support\header\HeaderExchangeClient.java,198,74,2,14,1,91
 dubbo-3.0\dubbo-3.0\dubbo-rpc\dubbo-rpc-grpc\src\main\java\org\apache\dubbo\rpc\protocol\grpc\GrpcProtocol.java,198,63,2,23,0,88
 dubbo-3.0\dubbo-3.0\dubbo-cluster\src\test\java\org\apache\dubbo\rpc\cluster\RouterChainTest.java,198,88,4,30,0,122
 hadoop-trunk\hadoop-trunk\hadoop-mapreduce-project\hadoop-mapreduce-client\hadoop-mapreduce-client-app\src\test\java\org\apache\hadoop\mapreduce\v2\app\webapp\TestAMWebServicesJobConf.java,198,18,4,1,5,28
 hadoop-trunk\hadoop-trunk\hadoop-mapreduce-project\hadoop-mapreduce-client\hadoop-mapreduce-client-jobclient\src\test\java\org\apache\hadoop\mapred\NotificationTestCase.java,198,51,9,2,3,65
 hadoop-trunk\hadoop-trunk\hadoop-mapreduce-project\hadoop-mapreduce-client\hadoop-mapreduce-client-app\src\main\java\org\apache\hadoop\mapred\YarnOutputFiles.java,198,49,3,1,2,55
 hadoop-trunk\hadoop-trunk\hadoop-yarn-project\hadoop-yarn\hadoop-yarn-server\hadoop-yarn-server-resourcemanager\src\test\java\org\apache\hadoop\yarn\server\resourcemanager\resourcetracker\TestNMReconnect.java,198,33,4,11,5,53
 hadoop-trunk\hadoop-trunk\hadoop-common-project\hadoop-common\src\main\java\org\apache\hadoop\http\HtmlQuoting.java,198,53,3,1,0,57
 hadoop-trunk\hadoop-trunk\hadoop-hdfs-project\hadoop-hdfs\src\test\java\org\apache\hadoop\hdfs\client\impl\BlockReaderTestUtil.java,198,76,5,6,7,94
 hadoop-trunk\hadoop-trunk\hadoop-yarn-project\hadoop-yarn\hadoop-yarn-server\hadoop-yarn-server-common\src\main\java\org\apache\hadoop\yarn\server\volume\csi\VolumeMetaData.java,198,56,0,2,0,58
 hadoop-trunk\hadoop-trunk\hadoop-yarn-project\hadoop-yarn\hadoop-yarn-common\src\main\java\org\apache\hadoop\yarn\api\protocolrecords\impl\pb\IncreaseContainersResourceResponsePBImpl.java,198,31,60,5,0,96
 hadoop-trunk\hadoop-trunk\hadoop-common-project\hadoop-registry\src\main\java\org\apache\hadoop\registry\client\binding\RegistryPathUtils.java,198,23,3,1,0,27
 hadoop-trunk\hadoop-trunk\hadoop-common-project\hadoop-common\src\test\java\org\apache\hadoop\security\TestLdapGroupsMappingBase.java,198,39,3,3,1,46
 kafka-trunk\kafka-trunk\clients\src\test\java\org\apache\kafka\common\record\LazyDownConversionRecordsTest.java,198,0,7,52,13,72
 kafka-trunk\kafka-trunk\clients\src\generated\java\org\apache\kafka\common\message\ExpireDelegationTokenRequestData.java,198,0,0,17,3,20
 kafka-trunk\kafka-trunk\clients\src\generated\java\org\apache\kafka\common\message\RenewDelegationTokenRequestData.java,198,0,0,16,3,19
 pulsar-master\pulsar-master\pulsar-common\src\test\java\org\apache\pulsar\common\util\RateLimiterTest.java,198,39,3,14,0,56
 pulsar-master\pulsar-master\pulsar-common\src\test\java\org\apache\pulsar\common\protocol\CommandUtilsTests.java,198,58,13,29,0,100
 rocketmq-develop\rocketmq-develop\common\src\main\java\org\apache\rocketmq\common\message\Message.java,198,115,1,6,4,126
 dubbo-3.0\dubbo-3.0\dubbo-registry\dubbo-registry-nacos\src\main\java\org\apache\dubbo\registry\nacos\NacosServiceName.java,199,72,2,7,0,81
 dubbo-3.0\dubbo-3.0\dubbo-config\dubbo-config-api\src\test\java\org\apache\dubbo\config\integration\multiple\exportprovider\MultipleRegistryCenterExportProviderIntegrationTest.java,199,58,2,43,0,103
 dubbo-3.0\dubbo-3.0\dubbo-common\src\main\java\org\apache\dubbo\common\utils\CompatibleTypeUtils.java,199,23,11,11,8,53
 hadoop-trunk\hadoop-trunk\hadoop-yarn-project\hadoop-yarn\hadoop-yarn-server\hadoop-yarn-server-web-proxy\src\main\java\org\apache\hadoop\yarn\server\webproxy\ProxyUriUtils.java,199,58,2,4,0,64
 hadoop-trunk\hadoop-trunk\hadoop-yarn-project\hadoop-yarn\hadoop-yarn-server\hadoop-yarn-server-nodemanager\src\test\java\org\apache\hadoop\yarn\server\nodemanager\containermanager\linux\privileged\TestPrivilegedOperationExecutor.java,199,31,6,2,0,39
 hadoop-trunk\hadoop-trunk\hadoop-yarn-project\hadoop-yarn\hadoop-yarn-applications\hadoop-yarn-applications-distributedshell\src\test\java\org\apache\hadoop\yarn\applications\distributedshell\TestDSAppMaster.java,199,29,1,2,1,33
 hadoop-trunk\hadoop-trunk\hadoop-hdfs-project\hadoop-hdfs\src\test\java\org\apache\hadoop\hdfs\server\datanode\checker\TestStorageLocationChecker.java,199,32,7,4,0,43
 hadoop-trunk\hadoop-trunk\hadoop-yarn-project\hadoop-yarn\hadoop-yarn-server\hadoop-yarn-server-nodemanager\src\test\java\org\apache\hadoop\yarn\server\nodemanager\containermanager\linux\runtime\TestImageTagToManifestPlugin.java,199,49,9,14,3,75
 hadoop-trunk\hadoop-trunk\hadoop-tools\hadoop-azure\src\test\java\org\apache\hadoop\fs\azurebfs\ITestAzureBlobFileSystemListStatus.java,199,19,0,2,0,21
 hadoop-trunk\hadoop-trunk\hadoop-hdfs-project\hadoop-hdfs\src\test\java\org\apache\hadoop\hdfs\server\namenode\snapshot\TestSnapshottableDirListing.java,199,55,4,3,6,68
 hadoop-trunk\hadoop-trunk\hadoop-hdfs-project\hadoop-hdfs-rbf\src\main\java\org\apache\hadoop\hdfs\server\federation\router\RemoteMethod.java,199,13,2,1,0,16
 kafka-trunk\kafka-trunk\clients\src\main\java\org\apache\kafka\clients\NodeApiVersions.java,199,0,8,25,1,34
 pulsar-master\pulsar-master\pulsar-broker\src\test\java\org\apache\pulsar\broker\service\NonPersistentTopicE2ETest.java,199,35,0,22,0,57
 skywalking-master\skywalking-master\oap-server\server-core\src\main\java\org\apache\skywalking\oap\server\core\query\TraceQueryService.java,199,35,1,20,0,56
 zookeeper-master\zookeeper-master\zookeeper-server\src\test\java\org\apache\zookeeper\server\quorum\auth\QuorumDigestAuthTest.java,199,0,15,25,3,43
 zookeeper-master\zookeeper-master\zookeeper-contrib\zookeeper-contrib-loggraph\src\main\java\org\apache\zookeeper\graph\JsonGenerator.java,199,0,11,12,4,27
 hadoop-trunk\hadoop-trunk\hadoop-yarn-project\hadoop-yarn\hadoop-yarn-common\src\test\java\org\apache\hadoop\yarn\webapp\util\TestWebAppUtils.java,200,53,11,15,1,80
 hadoop-trunk\hadoop-trunk\hadoop-yarn-project\hadoop-yarn\hadoop-yarn-server\hadoop-yarn-server-applicationhistoryservice\src\test\java\org\apache\hadoop\yarn\server\applicationhistoryservice\webapp\TestAHSWebApp.java,200,29,1,9,1,40
 hadoop-trunk\hadoop-trunk\hadoop-tools\hadoop-gridmix\src\test\java\org\apache\hadoop\mapred\gridmix\TestPseudoLocalFs.java,200,21,3,2,0,26
 hadoop-trunk\hadoop-trunk\hadoop-yarn-project\hadoop-yarn\hadoop-yarn-api\src\main\java\org\apache\hadoop\yarn\api\records\ContainerStatus.java,200,41,0,2,0,43
 hadoop-trunk\hadoop-trunk\hadoop-common-project\hadoop-common\src\test\java\org\apache\hadoop\security\TestKDiag.java,200,40,2,2,0,44
 hadoop-trunk\hadoop-trunk\hadoop-yarn-project\hadoop-yarn\hadoop-yarn-server\hadoop-yarn-server-resourcemanager\src\main\java\org\apache\hadoop\yarn\server\resourcemanager\resource\ResourceProfilesManagerImpl.java,200,30,16,1,1,48
 hadoop-trunk\hadoop-trunk\hadoop-tools\hadoop-sls\src\main\java\org\apache\hadoop\yarn\sls\scheduler\RMNodeWrapper.java,200,54,2,2,1,59
 hadoop-trunk\hadoop-trunk\hadoop-yarn-project\hadoop-yarn\hadoop-yarn-server\hadoop-yarn-server-resourcemanager\src\main\java\org\apache\hadoop\yarn\server\resourcemanager\reservation\planning\PlanningAlgorithm.java,200,33,2,8,0,43
 hadoop-trunk\hadoop-trunk\hadoop-common-project\hadoop-common\src\main\java\org\apache\hadoop\util\SemaphoredDelegatingExecutor.java,200,47,0,5,0,52
 kafka-trunk\kafka-trunk\clients\src\generated\java\org\apache\kafka\common\message\UnregisterBrokerResponseData.java,200,0,0,15,2,17
 kafka-trunk\kafka-trunk\clients\src\generated\java\org\apache\kafka\common\message\JoinGroupResponseDataJsonConverter.java,200,0,0,38,0,38
 kafka-trunk\kafka-trunk\streams\src\test\java\org\apache\kafka\streams\state\internals\MeteredTimestampedWindowStoreTest.java,200,0,11,26,4,41
 kafka-trunk\kafka-trunk\streams\src\test\java\org\apache\kafka\streams\state\internals\metrics\RocksDBMetricsRecorderGaugesTest.java,200,0,0,51,0,51
 kafka-trunk\kafka-trunk\clients\src\main\java\org\apache\kafka\common\network\ChannelBuilders.java,200,0,8,66,0,74
 pulsar-master\pulsar-master\pulsar-io\hdfs2\src\main\java\org\apache\pulsar\io\hdfs2\AbstractHdfsConnector.java,200,50,1,27,0,78
 pulsar-master\pulsar-master\pulsar-io\hdfs3\src\main\java\org\apache\pulsar\io\hdfs3\AbstractHdfsConnector.java,200,51,1,27,0,79
 pulsar-master\pulsar-master\pulsar-functions\runtime\src\main\java\org\apache\pulsar\functions\runtime\process\ProcessRuntimeFactory.java,200,108,1,28,0,137
 dubbo-3.0\dubbo-3.0\dubbo-registry\dubbo-registry-api\src\test\java\org\apache\dubbo\registry\client\ServiceDiscoveryRegistryTest.java,201,67,1,48,0,116
 dubbo-3.0\dubbo-3.0\dubbo-metadata\dubbo-metadata-processor\src\test\java\org\apache\dubbo\metadata\annotation\processing\util\FieldUtilsTest.java,201,42,3,16,0,61
 dubbo-3.0\dubbo-3.0\dubbo-config\dubbo-config-spring\src\main\java\org\apache\dubbo\config\spring\reference\ReferenceCreator.java,201,77,2,36,0,115
 dubbo-3.0\dubbo-3.0\dubbo-common\src\main\java\org\apache\dubbo\common\bytecode\Mixin.java,201,33,5,13,0,51
 dubbo-3.0\dubbo-3.0\dubbo-config\dubbo-config-spring\src\test\java\org\apache\dubbo\config\spring\AbstractRegistryService.java,201,78,2,15,0,95
 hadoop-trunk\hadoop-trunk\hadoop-hdfs-project\hadoop-hdfs-rbf\src\main\java\org\apache\hadoop\hdfs\server\federation\router\RouterQuotaManager.java,201,13,2,1,1,17
 hadoop-trunk\hadoop-trunk\hadoop-yarn-project\hadoop-yarn\hadoop-yarn-applications\hadoop-yarn-services\hadoop-yarn-services-core\src\main\java\org\apache\hadoop\yarn\service\conf\YarnServiceConf.java,201,81,1,17,0,99
 hadoop-trunk\hadoop-trunk\hadoop-hdfs-project\hadoop-hdfs\src\test\java\org\apache\hadoop\hdfs\protocol\TestBlockListAsLongs.java,201,68,12,3,2,85
 hadoop-trunk\hadoop-trunk\hadoop-hdfs-project\hadoop-hdfs\src\test\java\org\apache\hadoop\hdfs\protocol\TestLayoutVersion.java,201,42,2,7,0,51
 hadoop-trunk\hadoop-trunk\hadoop-hdfs-project\hadoop-hdfs\src\main\java\org\apache\hadoop\hdfs\server\namenode\NNUpgradeUtil.java,201,32,9,1,2,44
 hadoop-trunk\hadoop-trunk\hadoop-hdfs-project\hadoop-hdfs-rbf\src\test\java\org\apache\hadoop\hdfs\server\federation\store\TestStateStoreMountTable.java,201,13,1,13,1,28
 hadoop-trunk\hadoop-trunk\hadoop-common-project\hadoop-common\src\test\java\org\apache\hadoop\util\TestCrcUtil.java,201,82,1,1,1,85
 hadoop-trunk\hadoop-trunk\hadoop-yarn-project\hadoop-yarn\hadoop-yarn-server\hadoop-yarn-server-applicationhistoryservice\src\main\java\org\apache\hadoop\yarn\server\applicationhistoryservice\records\impl\pb\ApplicationStartDataPBImpl.java,201,44,65,4,0,113
 hadoop-trunk\hadoop-trunk\hadoop-tools\hadoop-azure-datalake\src\test\java\org\apache\hadoop\fs\adl\TestValidateConfiguration.java,201,18,1,1,3,23
 hadoop-trunk\hadoop-trunk\hadoop-yarn-project\hadoop-yarn\hadoop-yarn-server\hadoop-yarn-server-nodemanager\src\test\java\org\apache\hadoop\yarn\server\nodemanager\TestNMAuditLogger.java,201,35,11,1,0,47
 hadoop-trunk\hadoop-trunk\hadoop-yarn-project\hadoop-yarn\hadoop-yarn-server\hadoop-yarn-server-timeline-pluginstorage\src\test\java\org\apache\hadoop\yarn\server\timeline\TestLogInfo.java,201,38,4,7,0,49
 kafka-trunk\kafka-trunk\streams\src\test\java\org\apache\kafka\streams\integration\StreamTableJoinTopologyOptimizationIntegrationTest.java,201,0,2,31,1,34
 kafka-trunk\kafka-trunk\streams\src\test\java\org\apache\kafka\streams\integration\KTableEfficientRangeQueryTest.java,201,0,12,26,8,46
 kafka-trunk\kafka-trunk\clients\src\test\java\org\apache\kafka\common\requests\RequestTestUtils.java,201,0,2,77,0,79
 kafka-trunk\kafka-trunk\clients\src\generated\java\org\apache\kafka\common\message\DescribeProducersResponseDataJsonConverter.java,201,0,0,51,0,51
 pulsar-master\pulsar-master\pulsar-broker\src\test\java\org\apache\pulsar\broker\SLAMonitoringTest.java,201,50,3,28,0,81
 pulsar-master\pulsar-master\pulsar-io\kafka-connect-adaptor\src\main\java\org\apache\pulsar\io\kafka\connect\PulsarKafkaSinkTaskContext.java,201,71,4,23,0,98
 rocketmq-develop\rocketmq-develop\client\src\main\java\org\apache\rocketmq\client\trace\TraceDataEncoder.java,201,109,1,54,0,164
 zookeeper-master\zookeeper-master\zookeeper-server\src\test\java\org\apache\zookeeper\server\quorum\ReconfigFailureCasesTest.java,201,0,12,22,1,35
 hadoop-trunk\hadoop-trunk\hadoop-common-project\hadoop-common\src\main\java\org\apache\hadoop\util\ApplicationClassLoader.java,202,46,4,1,1,52
 hadoop-trunk\hadoop-trunk\hadoop-mapreduce-project\hadoop-mapreduce-client\hadoop-mapreduce-client-core\src\main\java\org\apache\hadoop\mapreduce\TaskReport.java,202,104,2,1,9,116
 hadoop-trunk\hadoop-trunk\hadoop-mapreduce-project\hadoop-mapreduce-client\hadoop-mapreduce-client-jobclient\src\test\java\org\apache\hadoop\mapreduce\TimelineServicePerformance.java,202,53,4,1,0,58
 hadoop-trunk\hadoop-trunk\hadoop-mapreduce-project\hadoop-mapreduce-client\hadoop-mapreduce-client-core\src\main\java\org\apache\hadoop\mapreduce\ClusterMetrics.java,202,103,1,1,0,105
 hadoop-trunk\hadoop-trunk\hadoop-yarn-project\hadoop-yarn\hadoop-yarn-server\hadoop-yarn-server-timeline-pluginstorage\src\test\java\org\apache\hadoop\yarn\server\timeline\PluginStoreTestUtils.java,202,65,2,6,0,73
 hadoop-trunk\hadoop-trunk\hadoop-yarn-project\hadoop-yarn\hadoop-yarn-api\src\main\java\org\apache\hadoop\yarn\api\protocolrecords\ReservationListRequest.java,202,10,0,1,0,11
 hadoop-trunk\hadoop-trunk\hadoop-yarn-project\hadoop-yarn\hadoop-yarn-server\hadoop-yarn-server-resourcemanager\src\main\java\org\apache\hadoop\yarn\server\resourcemanager\webapp\MetricsOverviewTable.java,202,24,1,10,0,35
 hadoop-trunk\hadoop-trunk\hadoop-mapreduce-project\hadoop-mapreduce-client\hadoop-mapreduce-client-hs\src\main\java\org\apache\hadoop\mapreduce\v2\hs\webapp\HsController.java,202,39,10,4,3,56
 hadoop-trunk\hadoop-trunk\hadoop-tools\hadoop-azure\src\main\java\org\apache\hadoop\fs\azurebfs\AbfsCountersImpl.java,202,18,1,3,1,23
 hadoop-trunk\hadoop-trunk\hadoop-common-project\hadoop-common\src\test\java\org\apache\hadoop\util\TestInstrumentedReadWriteLock.java,202,34,0,1,0,35
 kafka-trunk\kafka-trunk\connect\runtime\src\test\java\org\apache\kafka\connect\util\ConvertingFutureCallbackTest.java,202,0,1,19,4,24
 kafka-trunk\kafka-trunk\server-common\src\test\java\org\apache\kafka\queue\KafkaEventQueueTest.java,202,0,5,16,1,22
 pulsar-master\pulsar-master\pulsar-broker\src\test\java\org\apache\pulsar\broker\service\PeerReplicatorTest.java,202,49,3,35,0,87
 pulsar-master\pulsar-master\pulsar-broker\src\test\java\org\apache\pulsar\broker\admin\AdminApiGetLastMessageIdTest.java,202,52,10,20,0,82
 pulsar-master\pulsar-master\pulsar-proxy\src\test\java\org\apache\pulsar\proxy\server\ProxyRolesEnforcementTest.java,202,45,2,19,0,66
 skywalking-master\skywalking-master\oap-server\server-storage-plugin\storage-influxdb-plugin\src\main\java\org\apache\skywalking\oap\server\storage\plugin\influxdb\query\EventQueryDAO.java,202,61,0,48,0,109
 dubbo-3.0\dubbo-3.0\dubbo-cluster\src\test\java\org\apache\dubbo\rpc\cluster\support\wrapper\MockProviderRpcExceptionTest.java,203,100,12,15,0,127
 hadoop-trunk\hadoop-trunk\hadoop-yarn-project\hadoop-yarn\hadoop-yarn-server\hadoop-yarn-server-resourcemanager\src\main\java\org\apache\hadoop\yarn\server\resourcemanager\rmapp\attempt\RMAppAttemptMetrics.java,203,80,4,2,5,91
 hadoop-trunk\hadoop-trunk\hadoop-hdfs-project\hadoop-hdfs\src\main\java\org\apache\hadoop\hdfs\qjournal\server\GetJournalEditServlet.java,203,38,9,2,0,49
 hadoop-trunk\hadoop-trunk\hadoop-yarn-project\hadoop-yarn\hadoop-yarn-server\hadoop-yarn-server-resourcemanager\src\test\java\org\apache\hadoop\yarn\server\resourcemanager\placement\csmappingrule\TestVariableContext.java,203,11,2,1,0,14
 hadoop-trunk\hadoop-trunk\hadoop-yarn-project\hadoop-yarn\hadoop-yarn-server\hadoop-yarn-server-resourcemanager\src\test\java\org\apache\hadoop\yarn\server\resourcemanager\scheduler\capacity\conf\TestQueueCapacityConfigParser.java,203,61,0,39,0,100
 hadoop-trunk\hadoop-trunk\hadoop-yarn-project\hadoop-yarn\hadoop-yarn-common\src\main\java\org\apache\hadoop\yarn\api\records\impl\pb\LocalResourcePBImpl.java,203,52,81,3,0,136
 hadoop-trunk\hadoop-trunk\hadoop-common-project\hadoop-common\src\main\java\org\apache\hadoop\ipc\RpcWritable.java,203,49,2,1,1,53
 hadoop-trunk\hadoop-trunk\hadoop-yarn-project\hadoop-yarn\hadoop-yarn-api\src\test\java\org\apache\hadoop\yarn\conf\TestYarnConfigurationFields.java,203,9,0,7,1,17
 hadoop-trunk\hadoop-trunk\hadoop-yarn-project\hadoop-yarn\hadoop-yarn-server\hadoop-yarn-server-timelineservice-hbase\hadoop-yarn-server-timelineservice-hbase-common\src\main\java\org\apache\hadoop\yarn\server\timelineservice\storage\flow\FlowRunRowKey.java,203,33,1,4,0,38
 kafka-trunk\kafka-trunk\streams\src\main\java\org\apache\kafka\streams\state\internals\AbstractSegments.java,203,0,3,18,1,22
 kafka-trunk\kafka-trunk\clients\src\test\java\org\apache\kafka\common\requests\StopReplicaRequestTest.java,203,0,0,32,0,32
 kafka-trunk\kafka-trunk\clients\src\test\java\org\apache\kafka\test\MockSelector.java,203,0,6,9,4,19
 kafka-trunk\kafka-trunk\streams\src\main\java\org\apache\kafka\streams\kstream\JoinWindows.java,203,0,0,75,0,75
 kafka-trunk\kafka-trunk\streams\src\test\java\org\apache\kafka\streams\integration\KStreamAggregationDedupIntegrationTest.java,203,0,0,33,4,37
 kafka-trunk\kafka-trunk\connect\runtime\src\test\java\org\apache\kafka\connect\runtime\isolation\TestPlugins.java,203,0,3,44,2,49
 kafka-trunk\kafka-trunk\clients\src\generated\java\org\apache\kafka\common\message\DeleteAclsResponseDataJsonConverter.java,203,0,0,45,0,45
 kafka-trunk\kafka-trunk\clients\src\test\java\org\apache\kafka\clients\admin\internals\AllBrokersStrategyIntegrationTest.java,203,0,0,51,0,51
 kafka-trunk\kafka-trunk\connect\api\src\test\java\org\apache\kafka\connect\storage\SimpleHeaderConverterTest.java,203,0,0,20,2,22
 pulsar-master\pulsar-master\pulsar-client\src\main\java\org\apache\pulsar\client\impl\UnAckedMessageRedeliveryTracker.java,203,51,4,23,0,78
 rocketmq-develop\rocketmq-develop\client\src\main\java\org\apache\rocketmq\client\impl\consumer\RebalancePushImpl.java,203,72,6,39,1,118
 zookeeper-master\zookeeper-master\zookeeper-contrib\zookeeper-contrib-rest\src\main\java\org\apache\zookeeper\server\jersey\ZooKeeperService.java,203,0,2,5,2,9
 dubbo-3.0\dubbo-3.0\dubbo-rpc\dubbo-rpc-injvm\src\test\java\org\apache\dubbo\rpc\protocol\injvm\InjvmClassLoaderTest.java,204,70,5,44,0,119
 dubbo-3.0\dubbo-3.0\dubbo-configcenter\dubbo-configcenter-apollo\src\main\java\org\apache\dubbo\configcenter\support\apollo\ApolloDynamicConfiguration.java,204,89,6,43,0,138
 dubbo-3.0\dubbo-3.0\dubbo-rpc\dubbo-rpc-dubbo\src\main\java\org\apache\dubbo\rpc\protocol\dubbo\DubboCodec.java,204,71,3,26,0,100
 hadoop-trunk\hadoop-trunk\hadoop-hdfs-project\hadoop-hdfs\src\test\java\org\apache\hadoop\fs\TestFcHdfsSetUMask.java,204,86,16,2,0,104
 hadoop-trunk\hadoop-trunk\hadoop-tools\hadoop-aws\src\test\java\org\apache\hadoop\fs\s3a\TestBucketConfiguration.java,204,17,0,8,0,25
 hadoop-trunk\hadoop-trunk\hadoop-hdfs-project\hadoop-hdfs\src\test\java\org\apache\hadoop\hdfs\server\datanode\checker\TestDatasetVolumeChecker.java,204,34,16,7,0,57
 hadoop-trunk\hadoop-trunk\hadoop-hdfs-project\hadoop-hdfs-httpfs\src\test\java\org\apache\hadoop\fs\http\server\TestHttpFSServerWebServer.java,204,31,1,9,5,46
 hadoop-trunk\hadoop-trunk\hadoop-mapreduce-project\hadoop-mapreduce-client\hadoop-mapreduce-client-jobclient\src\test\java\org\apache\hadoop\mapred\TestCombineTextInputFormat.java,204,76,8,1,3,88
 hadoop-trunk\hadoop-trunk\hadoop-hdfs-project\hadoop-hdfs\src\test\java\org\apache\hadoop\hdfs\tools\offlineImageViewer\TestOfflineImageViewerForContentSummary.java,204,28,3,1,5,37
 kafka-trunk\kafka-trunk\clients\src\test\java\org\apache\kafka\common\header\internals\RecordHeadersTest.java,204,0,5,2,21,28
 kafka-trunk\kafka-trunk\streams\src\test\java\org\apache\kafka\streams\kstream\internals\KStreamGlobalKTableJoinTest.java,204,0,2,31,3,36
 pulsar-master\pulsar-master\pulsar-broker\src\test\java\org\apache\pulsar\broker\service\MaxMessageSizeTest.java,204,74,5,19,0,98
 pulsar-master\pulsar-master\pulsar-common\src\main\java\org\apache\pulsar\common\util\collections\TripleLongPriorityQueue.java,204,33,1,7,0,41
 pulsar-master\pulsar-master\pulsar-io\kafka\src\test\java\org\apache\pulsar\io\kafka\sink\KafkaAbstractSinkTest.java,204,53,9,16,0,78
 pulsar-master\pulsar-master\pulsar-broker\src\test\java\org\apache\pulsar\broker\admin\TopicMessageTTLTest.java,204,82,3,34,0,119
 pulsar-master\pulsar-master\pulsar-proxy\src\test\java\org\apache\pulsar\proxy\server\ProxyParserTest.java,204,51,0,28,0,79
 pulsar-master\pulsar-master\tests\integration\src\test\java\org\apache\pulsar\tests\integration\io\sources\GenericRecordSourceTest.java,204,60,5,21,0,86
 zookeeper-master\zookeeper-master\zookeeper-server\src\test\java\org\apache\zookeeper\server\ZooKeeperServerStartupTest.java,204,0,8,29,2,39
 dubbo-3.0\dubbo-3.0\dubbo-rpc\dubbo-rpc-api\src\main\java\org\apache\dubbo\rpc\AppResponse.java,205,85,2,14,7,108
 hadoop-trunk\hadoop-trunk\hadoop-yarn-project\hadoop-yarn\hadoop-yarn-server\hadoop-yarn-server-resourcemanager\src\main\java\org\apache\hadoop\yarn\server\resourcemanager\scheduler\fair\policies\FairSharePolicy.java,205,43,6,2,0,51
 hadoop-trunk\hadoop-trunk\hadoop-common-project\hadoop-nfs\src\main\java\org\apache\hadoop\nfs\nfs3\Nfs3FileAttributes.java,205,121,0,2,0,123
 hadoop-trunk\hadoop-trunk\hadoop-yarn-project\hadoop-yarn\hadoop-yarn-server\hadoop-yarn-server-applicationhistoryservice\src\main\java\org\apache\hadoop\yarn\server\applicationhistoryservice\records\impl\pb\ApplicationAttemptFinishDataPBImpl.java,205,45,67,6,0,118
 hadoop-trunk\hadoop-trunk\hadoop-mapreduce-project\hadoop-mapreduce-client\hadoop-mapreduce-client-app\src\test\java\org\apache\hadoop\mapreduce\v2\app\webapp\TestAMWebServicesAttempt.java,205,13,0,2,4,19
 hadoop-trunk\hadoop-trunk\hadoop-common-project\hadoop-nfs\src\test\java\org\apache\hadoop\nfs\TestNfsExports.java,205,49,12,2,6,69
 hadoop-trunk\hadoop-trunk\hadoop-hdfs-project\hadoop-hdfs-client\src\main\java\org\apache\hadoop\hdfs\protocol\SnapshottableDirectoryStatus.java,205,77,5,1,5,88
 hadoop-trunk\hadoop-trunk\hadoop-hdfs-project\hadoop-hdfs\src\main\java\org\apache\hadoop\hdfs\server\datanode\fsdataset\impl\RamDiskReplicaLruTracker.java,205,31,2,7,1,41
 hadoop-trunk\hadoop-trunk\hadoop-yarn-project\hadoop-yarn\hadoop-yarn-client\src\test\java\org\apache\hadoop\yarn\client\api\impl\TestAMRMProxy.java,205,18,1,6,0,25
 kafka-trunk\kafka-trunk\clients\src\generated\java\org\apache\kafka\common\message\BrokerHeartbeatRequestData.java,205,0,0,12,1,13
 kafka-trunk\kafka-trunk\streams\src\test\java\org\apache\kafka\streams\kstream\internals\KTableKTableForeignKeyJoinScenarioTest.java,205,0,3,32,1,36
 kafka-trunk\kafka-trunk\metadata\src\main\java\org\apache\kafka\metadata\KafkaConfigSchema.java,205,0,6,41,2,49
 kafka-trunk\kafka-trunk\clients\src\generated\java\org\apache\kafka\common\message\BrokerHeartbeatResponseData.java,205,0,0,12,1,13
 pulsar-master\pulsar-master\pulsar-broker\src\test\java\org\apache\pulsar\functions\worker\PulsarFunctionTlsTest.java,205,69,3,28,0,100
 pulsar-master\pulsar-master\pulsar-functions\instance\src\test\java\org\apache\pulsar\functions\instance\JavaInstanceTest.java,205,42,1,23,0,66
 pulsar-master\pulsar-master\pulsar-broker\src\main\java\org\apache\pulsar\broker\admin\v3\Transactions.java,205,199,10,90,0,299
 rocketmq-develop\rocketmq-develop\logging\src\main\java\org\apache\rocketmq\logging\inner\Appender.java,205,76,8,4,0,88
 skywalking-master\skywalking-master\oap-server\server-library\library-client\src\test\java\org\apache\skywalking\library\elasticsearch\bulk\ITElasticSearch.java,205,38,2,23,0,63
 skywalking-master\skywalking-master\oap-server\server-core\src\test\java\org\apache\skywalking\oap\server\core\analysis\meter\function\HistogramFunctionTest.java,205,47,0,7,0,54
 zookeeper-master\zookeeper-master\zookeeper-server\src\main\java\org\apache\zookeeper\ClientCnxnSocket.java,205,0,4,8,0,12
 zookeeper-master\zookeeper-master\zookeeper-server\src\main\java\org\apache\zookeeper\StatsTrack.java,205,0,0,2,0,2
 dubbo-3.0\dubbo-3.0\dubbo-common\src\main\java\org\apache\dubbo\common\bytecode\Proxy.java,206,45,1,25,0,71
 dubbo-3.0\dubbo-3.0\dubbo-spring-boot\dubbo-spring-boot-compatible\autoconfigure\src\test\java\org\apache\dubbo\spring\boot\autoconfigure\DubboAutoConfigurationOnMultipleConfigTest.java,206,53,2,13,0,68
 dubbo-3.0\dubbo-3.0\dubbo-common\src\main\java\org\apache\dubbo\common\url\component\ServiceAddressURL.java,206,54,1,9,3,67
 hadoop-trunk\hadoop-trunk\hadoop-yarn-project\hadoop-yarn\hadoop-yarn-server\hadoop-yarn-server-nodemanager\src\main\java\org\apache\hadoop\yarn\server\nodemanager\containermanager\linux\resources\CGroupsCpuResourceHandlerImpl.java,206,34,8,5,0,47
 hadoop-trunk\hadoop-trunk\hadoop-hdfs-project\hadoop-hdfs-rbf\src\main\java\org\apache\hadoop\hdfs\server\federation\router\RouterSnapshot.java,206,40,3,2,1,46
 hadoop-trunk\hadoop-trunk\hadoop-mapreduce-project\hadoop-mapreduce-client\hadoop-mapreduce-client-hs\src\test\java\org\apache\hadoop\mapreduce\v2\hs\webapp\TestHsWebServicesJobConf.java,206,22,4,4,5,35
 hadoop-trunk\hadoop-trunk\hadoop-common-project\hadoop-common\src\test\java\org\apache\hadoop\util\TestNativeCrc32.java,206,40,3,3,0,46
 hadoop-trunk\hadoop-trunk\hadoop-yarn-project\hadoop-yarn\hadoop-yarn-server\hadoop-yarn-server-nodemanager\src\test\java\org\apache\hadoop\yarn\server\nodemanager\health\TestNodeHealthCheckerService.java,206,16,0,1,0,17
 hadoop-trunk\hadoop-trunk\hadoop-yarn-project\hadoop-yarn\hadoop-yarn-common\src\main\java\org\apache\hadoop\yarn\webapp\View.java,206,89,6,2,3,100
 kafka-trunk\kafka-trunk\clients\src\main\java\org\apache\kafka\common\config\SaslConfigs.java,206,0,1,130,0,131
 pulsar-master\pulsar-master\pulsar-proxy\src\test\java\org\apache\pulsar\proxy\server\ProxyAuthenticationTest.java,206,73,3,20,0,96
 rocketmq-develop\rocketmq-develop\client\src\test\java\org\apache\rocketmq\client\consumer\rebalance\AllocateMachineRoomNearByTest.java,206,230,4,29,6,269
 zookeeper-master\zookeeper-master\zookeeper-server\src\test\java\org\apache\zookeeper\server\quorum\RaceConditionTest.java,206,0,6,32,4,42
 zookeeper-master\zookeeper-master\zookeeper-contrib\zookeeper-contrib-zooinspector\src\main\java\org\apache\zookeeper\inspector\gui\ZooInspectorPanel.java,206,0,5,14,3,22
 hadoop-trunk\hadoop-trunk\hadoop-common-project\hadoop-common\src\main\java\org\apache\hadoop\util\bloom\DynamicBloomFilter.java,207,62,5,7,0,74
 hadoop-trunk\hadoop-trunk\hadoop-yarn-project\hadoop-yarn\hadoop-yarn-server\hadoop-yarn-server-nodemanager\src\test\java\org\apache\hadoop\yarn\server\nodemanager\containermanager\linux\resources\TestCGroupsMemoryResourceHandlerImpl.java,207,22,3,4,0,29
 hadoop-trunk\hadoop-trunk\hadoop-common-project\hadoop-registry\src\test\java\org\apache\hadoop\registry\client\impl\TestCuratorService.java,207,38,4,1,1,44
 hadoop-trunk\hadoop-trunk\hadoop-yarn-project\hadoop-yarn\hadoop-yarn-server\hadoop-yarn-server-nodemanager\src\test\java\org\apache\hadoop\yarn\server\nodemanager\containermanager\localizer\TestLocalCacheCleanup.java,207,66,1,2,0,69
 hadoop-trunk\hadoop-trunk\hadoop-hdfs-project\hadoop-hdfs\src\test\java\org\apache\hadoop\hdfs\server\namenode\TestUpgradeDomainBlockPlacementPolicy.java,207,29,0,3,0,32
 hadoop-trunk\hadoop-trunk\hadoop-yarn-project\hadoop-yarn\hadoop-yarn-client\src\main\java\org\apache\hadoop\yarn\client\util\YarnClientUtils.java,207,11,6,1,0,18
 hadoop-trunk\hadoop-trunk\hadoop-hdfs-project\hadoop-hdfs\src\test\java\org\apache\hadoop\hdfs\MiniDFSClusterWithNodeGroup.java,207,137,14,17,3,171
 hadoop-trunk\hadoop-trunk\hadoop-yarn-project\hadoop-yarn\hadoop-yarn-server\hadoop-yarn-server-nodemanager\src\test\java\org\apache\hadoop\yarn\server\nodemanager\nodelabels\TestScriptBasedNodeAttributesProvider.java,207,28,1,1,0,30
 hadoop-trunk\hadoop-trunk\hadoop-common-project\hadoop-common\src\test\java\org\apache\hadoop\net\TestStaticMapping.java,207,23,4,2,1,30
 hadoop-trunk\hadoop-trunk\hadoop-yarn-project\hadoop-yarn\hadoop-yarn-common\src\main\java\org\apache\hadoop\yarn\util\ResourceCalculatorPlugin.java,207,11,3,2,0,16
 hadoop-trunk\hadoop-trunk\hadoop-hdfs-project\hadoop-hdfs\src\test\java\org\apache\hadoop\hdfs\server\namenode\TestNameNodeResourceChecker.java,207,37,3,9,6,55
 rocketmq-develop\rocketmq-develop\broker\src\main\java\org\apache\rocketmq\broker\transaction\jdbc\JDBCTransactionStore.java,207,30,7,9,4,50
 dubbo-3.0\dubbo-3.0\dubbo-config\dubbo-config-spring\src\test\java\org\apache\dubbo\config\spring\EmbeddedZooKeeper.java,208,26,4,12,0,42
 hadoop-trunk\hadoop-trunk\hadoop-hdfs-project\hadoop-hdfs\src\test\java\org\apache\hadoop\hdfs\server\namenode\TestSecurityTokenEditLog.java,208,75,7,16,3,101
 hadoop-trunk\hadoop-trunk\hadoop-yarn-project\hadoop-yarn\hadoop-yarn-server\hadoop-yarn-server-timelineservice-documentstore\src\main\java\org\apache\hadoop\yarn\server\timelineservice\documentstore\collection\document\flowrun\FlowRunDocument.java,208,86,4,6,1,97
 hadoop-trunk\hadoop-trunk\hadoop-common-project\hadoop-auth\src\test\java\org\apache\hadoop\security\authentication\client\AuthenticatorTestCase.java,208,52,13,9,10,84
 hadoop-trunk\hadoop-trunk\hadoop-hdfs-project\hadoop-hdfs\src\test\java\org\apache\hadoop\hdfs\server\datanode\TestIncrementalBrVariations.java,208,47,7,10,1,65
 hadoop-trunk\hadoop-trunk\hadoop-common-project\hadoop-auth\src\test\java\org\apache\hadoop\security\authentication\client\TestKerberosAuthenticator.java,208,48,8,18,2,76
 hadoop-trunk\hadoop-trunk\hadoop-common-project\hadoop-common\src\test\java\org\apache\hadoop\util\TestCrcComposer.java,208,58,2,1,1,62
 hadoop-trunk\hadoop-trunk\hadoop-yarn-project\hadoop-yarn\hadoop-yarn-api\src\main\java\org\apache\hadoop\yarn\api\records\ContainerReport.java,208,51,0,1,0,52
 hadoop-trunk\hadoop-trunk\hadoop-hdfs-project\hadoop-hdfs\src\test\java\org\apache\hadoop\hdfs\qjournal\server\TestJournaledEditsCache.java,208,109,3,1,1,114
 kafka-trunk\kafka-trunk\storage\src\test\java\org\apache\kafka\server\log\remote\storage\InmemoryRemoteStorageManagerTest.java,208,0,0,42,1,43
 kafka-trunk\kafka-trunk\streams\src\test\java\org\apache\kafka\streams\processor\internals\ThreadMetadataImplTest.java,208,0,0,15,0,15
 pulsar-master\pulsar-master\pulsar-client\src\test\java\org\apache\pulsar\client\impl\PartitionedProducerImplTest.java,208,75,3,47,0,125
 pulsar-master\pulsar-master\pulsar-broker\src\test\java\org\apache\pulsar\client\api\AuthenticationTlsHostnameVerificationTest.java,208,77,12,41,0,130
 pulsar-master\pulsar-master\pulsar-common\src\test\java\org\apache\pulsar\common\policies\data\PersistentTopicStatsTest.java,208,33,0,4,0,37
 rocketmq-develop\rocketmq-develop\client\src\main\java\org\apache\rocketmq\client\consumer\store\RemoteBrokerOffsetStore.java,208,76,5,33,2,116
 zookeeper-master\zookeeper-master\zookeeper-server\src\test\java\org\apache\zookeeper\test\ClientHammerTest.java,208,0,13,14,6,33
 zookeeper-master\zookeeper-master\zookeeper-server\src\test\java\org\apache\zookeeper\test\FourLetterWordsTest.java,208,0,9,8,3,20
 dubbo-3.0\dubbo-3.0\dubbo-registry\dubbo-registry-api\src\test\java\org\apache\dubbo\registry\CacheableFailbackRegistryTest.java,209,41,6,13,0,60
 hadoop-trunk\hadoop-trunk\hadoop-mapreduce-project\hadoop-mapreduce-examples\src\main\java\org\apache\hadoop\examples\MultiFileWordCount.java,209,89,4,4,4,101
 hadoop-trunk\hadoop-trunk\hadoop-hdfs-project\hadoop-hdfs\src\test\java\org\apache\hadoop\hdfs\server\diskbalancer\TestDataModels.java,209,38,0,3,0,41
 hadoop-trunk\hadoop-trunk\hadoop-hdfs-project\hadoop-hdfs-rbf\src\test\java\org\apache\hadoop\hdfs\server\federation\router\TestRouterAdminGenericRefresh.java,209,29,0,1,2,32
 hadoop-trunk\hadoop-trunk\hadoop-hdfs-project\hadoop-hdfs\src\test\java\org\apache\hadoop\hdfs\server\namenode\TestEnabledECPolicies.java,209,23,4,1,1,29
 hadoop-trunk\hadoop-trunk\hadoop-common-project\hadoop-common\src\main\java\org\apache\hadoop\metrics2\sink\ganglia\GangliaSink30.java,209,36,5,5,1,47
 hadoop-trunk\hadoop-trunk\hadoop-hdfs-project\hadoop-hdfs-rbf\src\test\java\org\apache\hadoop\hdfs\server\federation\metrics\TestMetricsBase.java,209,36,0,16,0,52
 hadoop-trunk\hadoop-trunk\hadoop-tools\hadoop-azure\src\test\java\org\apache\hadoop\fs\azurebfs\commit\AbstractAbfsClusterITest.java,209,15,3,3,4,25
 hadoop-trunk\hadoop-trunk\hadoop-mapreduce-project\hadoop-mapreduce-client\hadoop-mapreduce-client-jobclient\src\test\java\org\apache\hadoop\mapred\TestReporter.java,209,82,7,1,0,90
 hadoop-trunk\hadoop-trunk\hadoop-yarn-project\hadoop-yarn\hadoop-yarn-applications\hadoop-yarn-services\hadoop-yarn-services-core\src\main\java\org\apache\hadoop\yarn\service\registry\YarnRegistryViewForProviders.java,209,43,5,2,3,53
 hadoop-trunk\hadoop-trunk\hadoop-mapreduce-project\hadoop-mapreduce-client\hadoop-mapreduce-client-app\src\main\java\org\apache\hadoop\mapreduce\v2\app\speculate\forecast\SimpleExponentialSmoothing.java,209,35,1,2,1,39
 hadoop-trunk\hadoop-trunk\hadoop-tools\hadoop-resourceestimator\src\test\java\org\apache\hadoop\resourceestimator\service\TestResourceEstimatorService.java,209,47,8,4,11,70
 kafka-trunk\kafka-trunk\streams\src\test\java\org\apache\kafka\streams\kstream\internals\SlidingWindowedCogroupedKStreamImplTest.java,209,0,2,60,8,70
 kafka-trunk\kafka-trunk\connect\transforms\src\main\java\org\apache\kafka\connect\transforms\ReplaceField.java,209,0,5,22,0,27
 kafka-trunk\kafka-trunk\clients\src\main\java\org\apache\kafka\clients\admin\AdminClientConfig.java,209,0,0,62,0,62
 kafka-trunk\kafka-trunk\streams\src\test\java\org\apache\kafka\streams\state\internals\MergedSortedCacheKeyValueBytesStoreIteratorTest.java,209,0,5,34,5,44
 pulsar-master\pulsar-master\pulsar-broker\src\test\java\org\apache\pulsar\broker\namespace\OwnerShipForCurrentServerTestBase.java,209,76,3,35,0,114
 pulsar-master\pulsar-master\tiered-storage\jcloud\src\test\java\org\apache\bookkeeper\mledger\offload\jcloud\impl\OffloadIndexTest.java,209,86,10,28,0,124
 skywalking-master\skywalking-master\oap-server\server-storage-plugin\storage-jdbc-hikaricp-plugin\src\main\java\org\apache\skywalking\oap\server\storage\plugin\jdbc\h2\dao\H2TraceQueryDAO.java,209,86,2,36,0,124
 dubbo-3.0\dubbo-3.0\dubbo-common\src\main\java\org\apache\dubbo\common\io\StreamUtils.java,210,21,3,4,4,32
 dubbo-3.0\dubbo-3.0\dubbo-registry\dubbo-registry-api\src\test\java\org\apache\dubbo\registry\support\FailbackRegistryTest.java,210,56,12,15,0,83
 hadoop-trunk\hadoop-trunk\hadoop-common-project\hadoop-kms\src\main\java\org\apache\hadoop\crypto\key\kms\server\KMSWebApp.java,210,58,6,1,20,85
 hadoop-trunk\hadoop-trunk\hadoop-mapreduce-project\hadoop-mapreduce-client\hadoop-mapreduce-client-hs\src\test\java\org\apache\hadoop\mapreduce\v2\hs\TestJobHistoryEntities.java,210,104,5,8,0,117
 hadoop-trunk\hadoop-trunk\hadoop-yarn-project\hadoop-yarn\hadoop-yarn-server\hadoop-yarn-server-resourcemanager\src\main\java\org\apache\hadoop\yarn\server\resourcemanager\reservation\planning\StageAllocatorGreedyRLE.java,210,36,3,5,0,44
 hadoop-trunk\hadoop-trunk\hadoop-yarn-project\hadoop-yarn\hadoop-yarn-server\hadoop-yarn-server-resourcemanager\src\main\java\org\apache\hadoop\yarn\server\resourcemanager\webapp\ApplicationsRequestBuilder.java,210,49,4,2,1,56
 hadoop-trunk\hadoop-trunk\hadoop-tools\hadoop-aws\src\test\java\org\apache\hadoop\fs\s3a\commit\TestMagicCommitPaths.java,210,55,3,1,0,59
 hadoop-trunk\hadoop-trunk\hadoop-hdfs-project\hadoop-hdfs\src\test\java\org\apache\hadoop\hdfs\server\datanode\checker\TestThrottledAsyncChecker.java,210,29,0,2,1,32
 hadoop-trunk\hadoop-trunk\hadoop-yarn-project\hadoop-yarn\hadoop-yarn-common\src\main\java\org\apache\hadoop\yarn\api\records\impl\pb\ReservationDefinitionPBImpl.java,210,42,64,2,0,108
 hadoop-trunk\hadoop-trunk\hadoop-hdfs-project\hadoop-hdfs-client\src\main\java\org\apache\hadoop\hdfs\protocol\CachePoolInfo.java,210,51,4,1,2,58
 hadoop-trunk\hadoop-trunk\hadoop-hdfs-project\hadoop-hdfs\src\main\java\org\apache\hadoop\hdfs\protocolPB\NamenodeProtocolServerSideTranslatorPB.java,210,54,85,30,0,169
 hadoop-trunk\hadoop-trunk\hadoop-yarn-project\hadoop-yarn\hadoop-yarn-server\hadoop-yarn-server-resourcemanager\src\main\java\org\apache\hadoop\yarn\server\resourcemanager\webapp\dao\ApplicationSubmissionContextInfo.java,210,142,0,1,8,151
 hadoop-trunk\hadoop-trunk\hadoop-hdfs-project\hadoop-hdfs\src\test\java\org\apache\hadoop\hdfs\server\datanode\web\webhdfs\TestDataNodeUGIProvider.java,210,32,3,7,4,46
 kafka-trunk\kafka-trunk\connect\transforms\src\test\java\org\apache\kafka\connect\transforms\MaskFieldTest.java,210,0,2,32,0,34
 kafka-trunk\kafka-trunk\clients\src\main\java\org\apache\kafka\common\protocol\types\Schema.java,210,0,10,21,2,33
 kafka-trunk\kafka-trunk\streams\src\test\java\org\apache\kafka\streams\integration\KTableSourceTopicRestartIntegrationTest.java,210,0,2,31,0,33
 kafka-trunk\kafka-trunk\connect\runtime\src\test\java\org\apache\kafka\connect\runtime\WorkerMetricsGroupTest.java,210,0,1,25,2,28
 kafka-trunk\kafka-trunk\streams\src\test\java\org\apache\kafka\streams\state\internals\SessionKeySchemaTest.java,210,0,4,36,6,46
 pulsar-master\pulsar-master\pulsar-client\src\main\java\org\apache\pulsar\client\impl\ReaderBuilderImpl.java,210,82,4,24,0,110
 pulsar-master\pulsar-master\pulsar-functions\worker\src\test\java\org\apache\pulsar\functions\worker\LeaderServiceTest.java,210,40,5,19,0,64
 pulsar-master\pulsar-master\pulsar-broker\src\main\java\org\apache\pulsar\broker\service\AbstractDispatcherMultipleConsumers.java,210,72,4,39,0,115
 pulsar-master\pulsar-master\pulsar-package-management\bookkeeper-storage\src\test\java\org\apache\pulsar\packages\management\storage\bookkeeper\BookKeeperPackagesStorageTest.java,210,57,0,32,0,89
 skywalking-master\skywalking-master\oap-server\server-core\src\main\java\org\apache\skywalking\oap\server\core\remote\client\GRPCRemoteClient.java,210,49,9,16,0,74
 dubbo-3.0\dubbo-3.0\dubbo-common\src\main\java\org\apache\dubbo\config\AbstractMethodConfig.java,211,110,0,6,3,119
 hadoop-trunk\hadoop-trunk\hadoop-yarn-project\hadoop-yarn\hadoop-yarn-server\hadoop-yarn-server-applicationhistoryservice\src\main\java\org\apache\hadoop\yarn\server\applicationhistoryservice\ApplicationHistoryManagerImpl.java,211,40,0,7,3,50
 hadoop-trunk\hadoop-trunk\hadoop-hdfs-project\hadoop-hdfs\src\test\java\org\apache\hadoop\hdfs\server\datanode\TestBatchIbr.java,211,41,5,4,3,53
 hadoop-trunk\hadoop-trunk\hadoop-common-project\hadoop-common\src\main\java\org\apache\hadoop\io\FastByteComparisons.java,211,57,20,1,1,79
 hadoop-trunk\hadoop-trunk\hadoop-tools\hadoop-distcp\src\test\java\org\apache\hadoop\tools\mapred\TestDeletedDirTracker.java,211,33,3,1,0,37
 hadoop-trunk\hadoop-trunk\hadoop-yarn-project\hadoop-yarn\hadoop-yarn-server\hadoop-yarn-server-resourcemanager\src\main\java\org\apache\hadoop\yarn\server\resourcemanager\scheduler\capacity\QueueManagementDynamicEditPolicy.java,211,50,15,4,5,74
 hadoop-trunk\hadoop-trunk\hadoop-mapreduce-project\hadoop-mapreduce-client\hadoop-mapreduce-client-hs\src\test\java\org\apache\hadoop\mapreduce\v2\hs\webapp\TestHsJobBlock.java,211,16,4,1,3,24
 hadoop-trunk\hadoop-trunk\hadoop-hdfs-project\hadoop-hdfs-rbf\src\test\java\org\apache\hadoop\hdfs\server\federation\fairness\TestRouterHandlersFairness.java,211,20,1,2,0,23
 kafka-trunk\kafka-trunk\clients\src\main\java\org\apache\kafka\common\security\scram\internals\ScramSaslServer.java,211,0,17,51,0,68
 kafka-trunk\kafka-trunk\core\src\generated\java\kafka\internals\generated\OffsetCommitKey.java,211,0,0,15,4,19
 kafka-trunk\kafka-trunk\connect\file\src\main\java\org\apache\kafka\connect\file\FileStreamSourceTask.java,211,0,18,21,3,42
 pulsar-master\pulsar-master\pulsar-functions\instance\src\main\java\org\apache\pulsar\functions\source\TopicSchema.java,211,122,3,43,0,168
 skywalking-master\skywalking-master\oap-server\server-cluster-plugin\cluster-zookeeper-plugin\src\test\java\org\apache\skywalking\oap\server\cluster\plugin\zookeeper\ITClusterModuleZookeeperProviderFunctionalTest.java,211,57,9,19,0,85
 dubbo-3.0\dubbo-3.0\dubbo-common\src\test\java\org\apache\dubbo\config\AbstractInterfaceConfigTest.java,212,37,0,10,0,47
 dubbo-3.0\dubbo-3.0\dubbo-config\dubbo-config-api\src\test\java\org\apache\dubbo\config\ConsumerConfigTest.java,212,47,0,13,0,60
 dubbo-3.0\dubbo-3.0\dubbo-rpc\dubbo-rpc-rest\src\test\java\org\apache\dubbo\rpc\protocol\rest\RestProtocolTest.java,212,61,1,32,0,94
 hadoop-trunk\hadoop-trunk\hadoop-common-project\hadoop-common\src\main\java\org\apache\hadoop\io\compress\CodecPool.java,212,73,4,7,0,84
 hadoop-trunk\hadoop-trunk\hadoop-common-project\hadoop-common\src\test\java\org\apache\hadoop\ipc\TestSocketFactory.java,212,32,10,6,6,54
 hadoop-trunk\hadoop-trunk\hadoop-yarn-project\hadoop-yarn\hadoop-yarn-server\hadoop-yarn-server-common\src\main\java\org\apache\hadoop\yarn\server\webapp\AppAttemptBlock.java,212,33,3,6,1,43
 hadoop-trunk\hadoop-trunk\hadoop-yarn-project\hadoop-yarn\hadoop-yarn-server\hadoop-yarn-server-resourcemanager\src\main\java\org\apache\hadoop\yarn\server\resourcemanager\monitor\capacity\PreemptableResourceCalculator.java,212,28,1,8,0,37
 hadoop-trunk\hadoop-trunk\hadoop-mapreduce-project\hadoop-mapreduce-client\hadoop-mapreduce-client-core\src\main\java\org\apache\hadoop\mapred\IFileInputStream.java,212,87,4,1,1,93
 hadoop-trunk\hadoop-trunk\hadoop-tools\hadoop-azure\src\main\java\org\apache\hadoop\fs\azurebfs\contracts\services\ListResultEntrySchema.java,212,11,8,1,0,20
 hadoop-trunk\hadoop-trunk\hadoop-tools\hadoop-sls\src\main\java\org\apache\hadoop\yarn\sls\appmaster\StreamAMSimulator.java,212,38,8,1,0,47
 hadoop-trunk\hadoop-trunk\hadoop-yarn-project\hadoop-yarn\hadoop-yarn-applications\hadoop-yarn-applications-mawo\hadoop-yarn-applications-mawo-core\src\main\java\org\apache\hadoop\applications\mawo\server\common\AbstractTask.java,212,0,2,1,4,7
 hadoop-trunk\hadoop-trunk\hadoop-common-project\hadoop-common\src\test\java\org\apache\hadoop\net\TestDNS.java,212,21,11,1,3,36
 hadoop-trunk\hadoop-trunk\hadoop-common-project\hadoop-common\src\main\java\org\apache\hadoop\fs\statistics\impl\DynamicIOStatisticsBuilder.java,212,28,0,1,0,29
 hadoop-trunk\hadoop-trunk\hadoop-common-project\hadoop-common\src\test\java\org\apache\hadoop\ha\TestShellCommandFencer.java,212,34,4,1,0,39
 hadoop-trunk\hadoop-trunk\hadoop-hdfs-project\hadoop-hdfs\src\test\java\org\apache\hadoop\test\MiniDFSClusterManager.java,212,43,5,3,8,59
 hadoop-trunk\hadoop-trunk\hadoop-yarn-project\hadoop-yarn\hadoop-yarn-server\hadoop-yarn-server-nodemanager\src\main\java\org\apache\hadoop\yarn\server\nodemanager\containermanager\linux\resources\fpga\FpgaResourceHandlerImpl.java,212,53,12,21,2,88
 hadoop-trunk\hadoop-trunk\hadoop-mapreduce-project\hadoop-mapreduce-client\hadoop-mapreduce-client-jobclient\src\test\java\org\apache\hadoop\mapreduce\lib\output\TestMRCJCFileOutputCommitter.java,212,32,14,4,4,54
 hadoop-trunk\hadoop-trunk\hadoop-yarn-project\hadoop-yarn\hadoop-yarn-common\src\main\java\org\apache\hadoop\yarn\api\protocolrecords\impl\pb\GetLocalizationStatusesResponsePBImpl.java,212,30,66,6,0,102
 hadoop-trunk\hadoop-trunk\hadoop-tools\hadoop-resourceestimator\src\main\java\org\apache\hadoop\resourceestimator\skylinestore\impl\InMemoryStore.java,212,12,13,7,0,32
 hadoop-trunk\hadoop-trunk\hadoop-hdfs-project\hadoop-hdfs\src\test\java\org\apache\hadoop\hdfs\server\datanode\fsdataset\impl\TestScrLazyPersistFiles.java,212,21,10,2,2,35
 hadoop-trunk\hadoop-trunk\hadoop-yarn-project\hadoop-yarn\hadoop-yarn-server\hadoop-yarn-server-resourcemanager\src\test\java\org\apache\hadoop\yarn\server\resourcemanager\webapp\helper\ResourceRequestsJsonVerifications.java,212,34,1,3,0,38
 kafka-trunk\kafka-trunk\connect\runtime\src\test\java\org\apache\kafka\connect\runtime\isolation\PluginDescTest.java,212,0,4,13,6,23
 kafka-trunk\kafka-trunk\metadata\src\main\java\org\apache\kafka\metadata\PartitionRegistration.java,212,0,4,17,0,21
 pulsar-master\pulsar-master\pulsar-broker\src\test\java\org\apache\pulsar\client\impl\KeyStoreTlsProducerConsumerTestWithoutAuthTest.java,212,79,15,29,0,123
 pulsar-master\pulsar-master\pulsar-websocket\src\main\java\org\apache\pulsar\websocket\AbstractWebSocketHandler.java,212,87,18,47,0,152
 pulsar-master\pulsar-master\pulsar-functions\worker\src\main\java\org\apache\pulsar\functions\worker\rest\api\FunctionsImplV2.java,212,160,3,67,0,230
 zookeeper-master\zookeeper-master\zookeeper-server\src\test\java\org\apache\zookeeper\server\quorum\FLEMalformedNotificationMessageTest.java,212,0,2,36,1,39
 zookeeper-master\zookeeper-master\zookeeper-server\src\main\java\org\apache\zookeeper\server\ServerStats.java,212,0,3,5,1,9
 zookeeper-master\zookeeper-master\zookeeper-server\src\test\java\org\apache\zookeeper\SaslAuthTest.java,212,0,25,22,6,53
 dubbo-3.0\dubbo-3.0\dubbo-common\src\main\java\org\apache\dubbo\config\ModuleConfig.java,213,104,0,6,4,114
 hadoop-trunk\hadoop-trunk\hadoop-hdfs-project\hadoop-hdfs\src\test\java\org\apache\hadoop\hdfs\tools\offlineImageViewer\TestOfflineImageViewerForXAttr.java,213,19,3,7,9,38
 hadoop-trunk\hadoop-trunk\hadoop-yarn-project\hadoop-yarn\hadoop-yarn-server\hadoop-yarn-server-resourcemanager\src\test\java\org\apache\hadoop\yarn\server\resourcemanager\TestAppManagerWithFairScheduler.java,213,18,1,7,1,27
 hadoop-trunk\hadoop-trunk\hadoop-yarn-project\hadoop-yarn\hadoop-yarn-server\hadoop-yarn-server-timelineservice-documentstore\src\main\java\org\apache\hadoop\yarn\server\timelineservice\documentstore\collection\document\entity\TimelineEntityDocument.java,213,91,0,3,6,100
 hadoop-trunk\hadoop-trunk\hadoop-yarn-project\hadoop-yarn\hadoop-yarn-server\hadoop-yarn-server-nodemanager\src\main\java\org\apache\hadoop\yarn\server\nodemanager\amrmproxy\DefaultRequestInterceptor.java,213,30,0,9,0,39
 hadoop-trunk\hadoop-trunk\hadoop-yarn-project\hadoop-yarn\hadoop-yarn-server\hadoop-yarn-server-common\src\main\java\org\apache\hadoop\yarn\server\webapp\ErrorsAndWarningsBlock.java,213,66,1,8,0,75
 hadoop-trunk\hadoop-trunk\hadoop-yarn-project\hadoop-yarn\hadoop-yarn-server\hadoop-yarn-server-resourcemanager\src\test\java\org\apache\hadoop\yarn\server\resourcemanager\scheduler\policy\TestFifoOrderingPolicyWithExclusivePartitions.java,213,34,1,1,0,36
 hadoop-trunk\hadoop-trunk\hadoop-mapreduce-project\hadoop-mapreduce-client\hadoop-mapreduce-client-core\src\main\java\org\apache\hadoop\mapreduce\ContextFactory.java,213,95,16,3,6,120
 hadoop-trunk\hadoop-trunk\hadoop-common-project\hadoop-common\src\main\java\org\apache\hadoop\util\SysInfoWindows.java,213,33,3,1,33,70
 hadoop-trunk\hadoop-trunk\hadoop-yarn-project\hadoop-yarn\hadoop-yarn-server\hadoop-yarn-server-resourcemanager\src\main\java\org\apache\hadoop\yarn\server\resourcemanager\scheduler\fair\allocation\AllocationFileParser.java,213,72,5,6,2,85
 hadoop-trunk\hadoop-trunk\hadoop-tools\hadoop-aws\src\main\java\org\apache\hadoop\fs\s3a\S3AFileStatus.java,213,45,3,1,0,49
 hadoop-trunk\hadoop-trunk\hadoop-yarn-project\hadoop-yarn\hadoop-yarn-server\hadoop-yarn-server-resourcemanager\src\test\java\org\apache\hadoop\yarn\server\resourcemanager\webapp\TestRMWebappAuthentication.java,213,24,4,7,0,35
 kafka-trunk\kafka-trunk\streams\src\test\java\org\apache\kafka\streams\state\internals\NamedCacheTest.java,213,0,0,33,5,38
 kafka-trunk\kafka-trunk\streams\src\test\java\org\apache\kafka\streams\processor\internals\AbstractProcessorContextTest.java,213,0,11,29,1,41
 kafka-trunk\kafka-trunk\clients\src\generated\java\org\apache\kafka\common\message\FetchSnapshotResponseDataJsonConverter.java,213,0,0,50,0,50
 LittleBooks-master\LittleBooks-master\app\src\main\java\com\example\littlebooks\old\MainActivity.java,213,112,17,11,0,140
 pulsar-master\pulsar-master\pulsar-proxy\src\main\java\org\apache\pulsar\proxy\server\WebServer.java,213,79,5,23,0,107
 pulsar-master\pulsar-master\pulsar-client\src\main\java\org\apache\pulsar\client\impl\ControlledClusterFailover.java,213,81,3,32,0,116
 pulsar-master\pulsar-master\pulsar-transaction\coordinator\src\test\java\org\apache\pulsar\transaction\coordinator\TransactionMetadataStoreProviderTest.java,213,52,2,37,0,91
 pulsar-master\pulsar-master\pulsar-common\src\test\java\org\apache\pulsar\common\util\collections\ConcurrentSortedLongPairSetTest.java,213,80,3,6,0,89
 rocketmq-develop\rocketmq-develop\client\src\test\java\org\apache\rocketmq\client\consumer\rebalance\AllocateMessageQueueConsitentHashTest.java,213,81,4,30,6,121
 zookeeper-master\zookeeper-master\zookeeper-server\src\main\java\org\apache\zookeeper\server\ReferenceCountedACLCache.java,213,0,40,6,0,46
 dubbo-3.0\dubbo-3.0\dubbo-rpc\dubbo-rpc-dubbo\src\test\java\org\apache\dubbo\rpc\protocol\dubbo\DubboProtocolTest.java,214,74,2,37,0,113
 dubbo-3.0\dubbo-3.0\dubbo-metadata\dubbo-metadata-report-zookeeper\src\main\java\org\apache\dubbo\metadata\store\zookeeper\ZookeeperMetadataReport.java,214,111,1,30,0,142
 hadoop-trunk\hadoop-trunk\hadoop-mapreduce-project\hadoop-mapreduce-client\hadoop-mapreduce-client-jobclient\src\test\java\org\apache\hadoop\mapreduce\lib\input\TestCombineTextInputFormat.java,214,75,7,2,3,87
 hadoop-trunk\hadoop-trunk\hadoop-yarn-project\hadoop-yarn\hadoop-yarn-server\hadoop-yarn-server-applicationhistoryservice\src\test\java\org\apache\hadoop\yarn\server\applicationhistoryservice\TestApplicationHistoryClientService.java,214,20,0,6,5,31
 hadoop-trunk\hadoop-trunk\hadoop-yarn-project\hadoop-yarn\hadoop-yarn-server\hadoop-yarn-server-nodemanager\src\main\java\org\apache\hadoop\yarn\server\nodemanager\containermanager\loghandler\NonAggregatingLogHandler.java,214,42,15,10,3,70
 hadoop-trunk\hadoop-trunk\hadoop-yarn-project\hadoop-yarn\hadoop-yarn-server\hadoop-yarn-server-timelineservice\src\test\java\org\apache\hadoop\yarn\server\timelineservice\collector\TestPerNodeTimelineCollectorsAuxService.java,214,21,3,4,2,30
 hadoop-trunk\hadoop-trunk\hadoop-common-project\hadoop-common\src\main\java\org\apache\hadoop\io\compress\bzip2\Bzip2Decompressor.java,214,70,6,1,1,78
 hadoop-trunk\hadoop-trunk\hadoop-hdfs-project\hadoop-hdfs\src\test\java\org\apache\hadoop\hdfs\TestQuotaAllowOwner.java,214,13,1,1,8,23
 hadoop-trunk\hadoop-trunk\hadoop-yarn-project\hadoop-yarn\hadoop-yarn-server\hadoop-yarn-server-resourcemanager\src\test\java\org\apache\hadoop\yarn\server\resourcemanager\scheduler\capacity\conf\TestMutableCSConfigurationProvider.java,214,17,2,4,1,24
 hadoop-trunk\hadoop-trunk\hadoop-hdfs-project\hadoop-hdfs\src\test\java\org\apache\hadoop\hdfs\server\datanode\TestReadOnlySharedStorage.java,214,86,24,18,2,130
 hadoop-trunk\hadoop-trunk\hadoop-tools\hadoop-aws\src\test\java\org\apache\hadoop\fs\s3a\commit\magic\ITestMagicCommitProtocol.java,214,32,7,1,0,40
 hadoop-trunk\hadoop-trunk\hadoop-yarn-project\hadoop-yarn\hadoop-yarn-common\src\main\java\org\apache\hadoop\yarn\api\impl\pb\client\ContainerManagementProtocolPBClientImpl.java,214,35,33,32,0,100
 hadoop-trunk\hadoop-trunk\hadoop-yarn-project\hadoop-yarn\hadoop-yarn-api\src\main\java\org\apache\hadoop\yarn\util\UnitsConversionUtil.java,214,35,1,1,0,37
 kafka-trunk\kafka-trunk\streams\src\test\java\org\apache\kafka\streams\kstream\internals\KStreamGlobalKTableLeftJoinTest.java,214,0,2,33,3,38
 kafka-trunk\kafka-trunk\clients\src\generated\java\org\apache\kafka\common\message\CreateTopicsRequestDataJsonConverter.java,214,0,0,50,0,50
 pulsar-master\pulsar-master\managed-ledger\src\test\java\org\apache\bookkeeper\mledger\impl\EntryCacheTest.java,214,76,0,12,0,88
 pulsar-master\pulsar-master\managed-ledger\src\test\java\org\apache\bookkeeper\mledger\impl\MetaStoreImplTest.java,214,65,3,30,0,98
 pulsar-master\pulsar-master\pulsar-functions\utils\src\main\java\org\apache\pulsar\functions\utils\ValidatorUtils.java,214,84,8,60,0,152
 pulsar-master\pulsar-master\pulsar-broker-common\src\main\java\org\apache\pulsar\broker\authentication\AuthenticationProviderList.java,214,47,5,20,0,72
 pulsar-master\pulsar-master\pulsar-broker\src\main\java\org\apache\pulsar\broker\stats\metrics\AbstractMetrics.java,214,74,7,28,0,109
 rocketmq-develop\rocketmq-develop\store\src\test\java\org\apache\rocketmq\store\ConsumeQueueExtTest.java,214,46,2,11,3,62
 hadoop-trunk\hadoop-trunk\hadoop-yarn-project\hadoop-yarn\hadoop-yarn-common\src\main\java\org\apache\hadoop\yarn\api\records\impl\pb\PreemptionContractPBImpl.java,215,36,62,4,0,102
 hadoop-trunk\hadoop-trunk\hadoop-mapreduce-project\hadoop-mapreduce-client\hadoop-mapreduce-client-jobclient\src\test\java\org\apache\hadoop\mapreduce\lib\partition\TestTotalOrderPartitioner.java,215,70,6,2,22,100
 hadoop-trunk\hadoop-trunk\hadoop-common-project\hadoop-common\src\test\java\org\apache\hadoop\fs\shell\TestAclCommands.java,215,59,17,1,0,77
 hadoop-trunk\hadoop-trunk\hadoop-yarn-project\hadoop-yarn\hadoop-yarn-server\hadoop-yarn-server-router\src\main\java\org\apache\hadoop\yarn\server\router\RouterAuditLogger.java,215,106,0,2,0,108
 hadoop-trunk\hadoop-trunk\hadoop-yarn-project\hadoop-yarn\hadoop-yarn-server\hadoop-yarn-server-common\src\main\java\org\apache\hadoop\yarn\server\federation\store\records\impl\pb\SubClusterInfoPBImpl.java,215,43,81,5,0,129
 hadoop-trunk\hadoop-trunk\hadoop-hdfs-project\hadoop-hdfs\src\test\java\org\apache\hadoop\hdfs\server\blockmanagement\TestAvailableSpaceRackFaultTolerantBPP.java,215,50,12,5,2,69
 hadoop-trunk\hadoop-trunk\hadoop-yarn-project\hadoop-yarn\hadoop-yarn-applications\hadoop-yarn-services\hadoop-yarn-services-api\src\test\java\org\apache\hadoop\yarn\service\client\TestSystemServiceManagerImpl.java,215,21,5,1,2,29
 hadoop-trunk\hadoop-trunk\hadoop-mapreduce-project\hadoop-mapreduce-client\hadoop-mapreduce-client-jobclient\src\test\java\org\apache\hadoop\mapreduce\lib\chain\TestMapReduceChain.java,215,54,1,3,0,58
 hadoop-trunk\hadoop-trunk\hadoop-yarn-project\hadoop-yarn\hadoop-yarn-api\src\main\java\org\apache\hadoop\yarn\api\records\ContainerId.java,215,37,7,2,0,46
 hadoop-trunk\hadoop-trunk\hadoop-yarn-project\hadoop-yarn\hadoop-yarn-server\hadoop-yarn-server-nodemanager\src\test\java\org\apache\hadoop\yarn\server\nodemanager\nodelabels\TestConfigurationNodeAttributesProvider.java,215,27,5,1,0,33
 hadoop-trunk\hadoop-trunk\hadoop-yarn-project\hadoop-yarn\hadoop-yarn-server\hadoop-yarn-server-resourcemanager\src\test\java\org\apache\hadoop\yarn\server\resourcemanager\scheduler\constraint\TestPlacementConstraintManagerService.java,215,21,8,5,6,40
 hadoop-trunk\hadoop-trunk\hadoop-mapreduce-project\hadoop-mapreduce-client\hadoop-mapreduce-client-jobclient\src\test\java\org\apache\hadoop\mapreduce\LargeSorter.java,215,100,6,2,1,109
 hadoop-trunk\hadoop-trunk\hadoop-hdfs-project\hadoop-hdfs-rbf\src\main\java\org\apache\hadoop\hdfs\protocolPB\RouterAdminProtocolTranslatorPB.java,215,39,66,72,0,177
 hadoop-trunk\hadoop-trunk\hadoop-common-project\hadoop-auth\src\test\java\org\apache\hadoop\security\authentication\util\TestKerberosUtil.java,215,79,15,5,4,103
 hadoop-trunk\hadoop-trunk\hadoop-hdfs-project\hadoop-hdfs-rbf\src\main\java\org\apache\hadoop\hdfs\server\federation\router\security\RouterSecurityManager.java,215,33,7,3,2,45
 kafka-trunk\kafka-trunk\tools\src\main\java\org\apache\kafka\tools\VerifiableLog4jAppender.java,215,0,2,32,0,34
 pulsar-master\pulsar-master\pulsar-broker\src\test\java\org\apache\pulsar\client\impl\NegativeAcksTest.java,215,189,2,11,0,202
 pulsar-master\pulsar-master\pulsar-broker\src\main\java\org\apache\pulsar\broker\service\PulsarStats.java,215,78,9,29,0,116
 pulsar-master\pulsar-master\pulsar-broker\src\test\java\org\apache\pulsar\client\api\TlsProducerConsumerTest.java,215,66,7,42,0,115
 pulsar-master\pulsar-master\pulsar-broker\src\test\java\org\apache\pulsar\client\impl\PartialPartitionedProducerTest.java,215,52,4,20,0,76
 pulsar-master\pulsar-master\pulsar-broker\src\main\java\org\apache\pulsar\broker\resourcegroup\ResourceUsageTopicTransportManager.java,215,65,3,35,0,103
 rocketmq-develop\rocketmq-develop\broker\src\main\java\org\apache\rocketmq\broker\client\ConsumerGroupInfo.java,215,89,5,18,2,114
 hadoop-trunk\hadoop-trunk\hadoop-yarn-project\hadoop-yarn\hadoop-yarn-server\hadoop-yarn-server-nodemanager\src\main\java\org\apache\hadoop\yarn\server\nodemanager\containermanager\linux\runtime\docker\DockerRunCommand.java,216,100,3,2,1,106
 hadoop-trunk\hadoop-trunk\hadoop-yarn-project\hadoop-yarn\hadoop-yarn-common\src\main\java\org\apache\hadoop\yarn\webapp\Dispatcher.java,216,55,13,1,2,71
 hadoop-trunk\hadoop-trunk\hadoop-mapreduce-project\hadoop-mapreduce-client\hadoop-mapreduce-client-core\src\main\java\org\apache\hadoop\mapreduce\TaskCompletionEvent.java,216,103,2,1,2,108
 hadoop-trunk\hadoop-trunk\hadoop-yarn-project\hadoop-yarn\hadoop-yarn-server\hadoop-yarn-server-nodemanager\src\main\java\org\apache\hadoop\yarn\server\nodemanager\containermanager\localizer\ResourceSet.java,216,34,7,1,3,45
 hadoop-trunk\hadoop-trunk\hadoop-mapreduce-project\hadoop-mapreduce-client\hadoop-mapreduce-client-core\src\test\java\org\apache\hadoop\mapreduce\filecache\TestClientDistributedCacheManager.java,216,37,6,1,0,44
 hadoop-trunk\hadoop-trunk\hadoop-common-project\hadoop-common\src\main\java\org\apache\hadoop\fs\shell\Count.java,216,68,1,1,0,70
 hadoop-trunk\hadoop-trunk\hadoop-yarn-project\hadoop-yarn\hadoop-yarn-server\hadoop-yarn-server-timelineservice-hbase\hadoop-yarn-server-timelineservice-hbase-common\src\main\java\org\apache\hadoop\yarn\server\timelineservice\storage\flow\FlowActivityRowKey.java,216,40,2,5,0,47
 hadoop-trunk\hadoop-trunk\hadoop-yarn-project\hadoop-yarn\hadoop-yarn-server\hadoop-yarn-server-resourcemanager\src\main\java\org\apache\hadoop\yarn\server\resourcemanager\recovery\records\ApplicationStateData.java,216,109,2,5,0,116
 hadoop-trunk\hadoop-trunk\hadoop-yarn-project\hadoop-yarn\hadoop-yarn-applications\hadoop-yarn-services\hadoop-yarn-services-core\src\main\java\org\apache\hadoop\yarn\service\api\records\ConfigFile.java,216,92,2,10,3,107
 hadoop-trunk\hadoop-trunk\hadoop-hdfs-project\hadoop-hdfs\src\test\java\org\apache\hadoop\hdfs\TestDataTransferKeepalive.java,216,71,5,10,3,89
 hadoop-trunk\hadoop-trunk\hadoop-tools\hadoop-azure\src\test\java\org\apache\hadoop\fs\azurebfs\services\ITestAbfsInputStream.java,216,60,4,11,3,78
 hadoop-trunk\hadoop-trunk\hadoop-common-project\hadoop-common\src\test\java\org\apache\hadoop\metrics2\filter\TestPatternFilter.java,216,66,7,6,0,79
 kafka-trunk\kafka-trunk\streams\src\main\java\org\apache\kafka\streams\TopologyConfig.java,216,0,4,53,0,57
 kafka-trunk\kafka-trunk\clients\src\main\java\org\apache\kafka\common\requests\FetchResponse.java,216,0,114,62,3,179
 kafka-trunk\kafka-trunk\clients\src\test\java\org\apache\kafka\clients\consumer\internals\RequestFutureTest.java,216,0,0,17,2,19
 kafka-trunk\kafka-trunk\clients\src\generated\java\org\apache\kafka\common\message\ListGroupsRequestData.java,216,0,0,22,3,25
 kafka-trunk\kafka-trunk\generator\src\test\java\org\apache\kafka\message\VersionConditionalTest.java,216,0,19,15,0,34
 pulsar-master\pulsar-master\pulsar-io\kafka\src\main\java\org\apache\pulsar\io\kafka\KafkaAbstractSource.java,216,83,3,41,0,127
 pulsar-master\pulsar-master\pulsar-common\src\main\java\org\apache\pulsar\common\net\ServiceURI.java,216,42,7,16,0,65
 pulsar-master\pulsar-master\pulsar-sql\presto-pulsar\src\main\java\org\apache\pulsar\sql\presto\PulsarColumnHandle.java,216,68,0,12,0,80
 pulsar-master\pulsar-master\pulsar-broker\src\test\java\org\apache\pulsar\broker\intercept\CounterBrokerInterceptor.java,216,124,2,10,0,136
 zookeeper-master\zookeeper-master\zookeeper-server\src\test\java\org\apache\zookeeper\server\persistence\FileTxnLogTest.java,216,0,37,27,0,64
 dubbo-3.0\dubbo-3.0\dubbo-config\dubbo-config-api\src\main\java\org\apache\dubbo\config\utils\SimpleReferenceCache.java,217,70,4,25,0,99
 dubbo-3.0\dubbo-3.0\dubbo-remoting\dubbo-remoting-api\src\test\java\org\apache\dubbo\remoting\handler\HeaderExchangeHandlerTest.java,217,61,0,27,4,92
 dubbo-3.0\dubbo-3.0\dubbo-config\dubbo-config-api\src\test\java\org\apache\dubbo\config\RegistryConfigTest.java,217,42,0,10,0,52
 hadoop-trunk\hadoop-trunk\hadoop-hdfs-project\hadoop-hdfs\src\test\java\org\apache\hadoop\hdfs\server\namenode\ha\TestUpdateBlockTailing.java,217,32,0,2,0,34
 hadoop-trunk\hadoop-trunk\hadoop-common-project\hadoop-common\src\main\java\org\apache\hadoop\io\compress\DecompressorStream.java,217,51,5,1,0,57
 hadoop-trunk\hadoop-trunk\hadoop-hdfs-project\hadoop-hdfs\src\test\java\org\apache\hadoop\hdfs\TestLocatedBlocksRefresher.java,217,49,2,18,0,69
 hadoop-trunk\hadoop-trunk\hadoop-yarn-project\hadoop-yarn\hadoop-yarn-common\src\main\java\org\apache\hadoop\yarn\webapp\Controller.java,217,117,2,1,4,124
 hadoop-trunk\hadoop-trunk\hadoop-common-project\hadoop-common\src\main\java\org\apache\hadoop\io\ReadaheadPool.java,217,58,7,7,3,75
 kafka-trunk\kafka-trunk\clients\src\generated\java\org\apache\kafka\common\message\DefaultPrincipalData.java,217,0,0,16,4,20
 kafka-trunk\kafka-trunk\streams\src\test\java\org\apache\kafka\streams\integration\KTableKTableForeignKeyInnerJoinMultiIntegrationTest.java,217,0,2,57,0,59
 kafka-trunk\kafka-trunk\clients\src\generated\java\org\apache\kafka\common\message\EnvelopeRequestData.java,217,0,0,17,7,24
 kafka-trunk\kafka-trunk\streams\src\test\java\org\apache\kafka\streams\state\internals\ChangeLoggingSessionBytesStoreTest.java,217,0,0,22,0,22
 pulsar-master\pulsar-master\pulsar-broker\src\test\java\org\apache\pulsar\broker\service\persistent\PersistentTopicTest.java,217,58,1,44,0,103
 pulsar-master\pulsar-master\pulsar-broker\src\test\java\org\apache\pulsar\broker\service\HashRangeExclusiveStickyKeyConsumerSelectorTest.java,217,93,2,27,0,122
 pulsar-master\pulsar-master\tests\integration\src\test\java\org\apache\pulsar\tests\integration\io\sources\debezium\DebeziumOracleDbSourceTester.java,217,44,6,16,0,66
 rocketmq-develop\rocketmq-develop\tools\src\main\java\org\apache\rocketmq\tools\command\message\PrintMessageByQueueCommand.java,217,53,15,29,2,99
 rocketmq-develop\rocketmq-develop\broker\src\main\java\org\apache\rocketmq\broker\offset\ConsumerOffsetManager.java,217,75,2,29,3,109
 skywalking-master\skywalking-master\oap-server\analyzer\meter-analyzer\src\test\java\org\apache\skywalking\oap\meter\analyzer\dsl\IncreaseTest.java,217,150,1,97,0,248
 skywalking-master\skywalking-master\oap-server\server-cluster-plugin\cluster-etcd-plugin\src\test\java\org\apache\skywalking\oap\server\cluster\plugin\etcd\ITClusterModuleEtcdProviderFunctionalTest.java,217,55,9,20,0,84
 hadoop-trunk\hadoop-trunk\hadoop-yarn-project\hadoop-yarn\hadoop-yarn-server\hadoop-yarn-server-resourcemanager\src\test\java\org\apache\hadoop\yarn\server\resourcemanager\scheduler\capacity\TestCapacitySchedulerMultiNodesWithPreemption.java,218,25,6,10,1,42
 hadoop-trunk\hadoop-trunk\hadoop-tools\hadoop-sls\src\main\java\org\apache\hadoop\yarn\sls\appmaster\DAGAMSimulator.java,218,35,5,1,0,41
 hadoop-trunk\hadoop-trunk\hadoop-mapreduce-project\hadoop-mapreduce-client\hadoop-mapreduce-client-app\src\test\java\org\apache\hadoop\mapreduce\v2\app\TestTaskHeartbeatHandler.java,218,45,2,1,0,48
 hadoop-trunk\hadoop-trunk\hadoop-hdfs-project\hadoop-hdfs\src\test\java\org\apache\hadoop\hdfs\server\namenode\TestFSImageWithAcl.java,218,22,5,1,0,28
 hadoop-trunk\hadoop-trunk\hadoop-yarn-project\hadoop-yarn\hadoop-yarn-common\src\test\java\org\apache\hadoop\yarn\conf\TestYarnConfiguration.java,218,14,19,6,0,39
 hadoop-trunk\hadoop-trunk\hadoop-yarn-project\hadoop-yarn\hadoop-yarn-applications\hadoop-yarn-services\hadoop-yarn-services-core\src\main\java\org\apache\hadoop\yarn\service\containerlaunch\AbstractLauncher.java,218,88,1,2,4,95
 hadoop-trunk\hadoop-trunk\hadoop-common-project\hadoop-common\src\main\java\org\apache\hadoop\io\compress\zlib\BuiltInGzipCompressor.java,218,65,0,6,0,71
 hadoop-trunk\hadoop-trunk\hadoop-tools\hadoop-aws\src\test\java\org\apache\hadoop\fs\s3a\auth\delegation\ILoadTestSessionCredentials.java,218,25,5,5,2,37
 hadoop-trunk\hadoop-trunk\hadoop-hdfs-project\hadoop-hdfs-rbf\src\main\java\org\apache\hadoop\hdfs\server\federation\router\RouterQuotaUpdateService.java,218,14,4,3,1,22
 hadoop-trunk\hadoop-trunk\hadoop-yarn-project\hadoop-yarn\hadoop-yarn-server\hadoop-yarn-server-nodemanager\src\main\java\org\apache\hadoop\yarn\server\nodemanager\security\NMContainerTokenSecretManager.java,218,36,6,4,1,47
 hadoop-trunk\hadoop-trunk\hadoop-yarn-project\hadoop-yarn\hadoop-yarn-server\hadoop-yarn-server-resourcemanager\src\test\java\org\apache\hadoop\yarn\server\resourcemanager\scheduler\capacity\policy\TestPriorityUtilizationQueueOrderingPolicy.java,218,253,2,8,0,263
 kafka-trunk\kafka-trunk\clients\src\generated\java\org\apache\kafka\common\message\InitProducerIdResponseData.java,218,0,0,16,1,17
 pulsar-master\pulsar-master\testmocks\src\main\java\org\apache\zookeeper\MockZooKeeperSession.java,218,105,3,30,0,138
 pulsar-master\pulsar-master\pulsar-broker\src\main\java\org\apache\pulsar\broker\service\nonpersistent\NonPersistentReplicator.java,218,61,4,27,0,92
 hadoop-trunk\hadoop-trunk\hadoop-hdfs-project\hadoop-hdfs\src\test\java\org\apache\hadoop\hdfs\TestBlocksScheduledCounter.java,219,30,0,1,0,31
 hadoop-trunk\hadoop-trunk\hadoop-tools\hadoop-azure\src\test\java\org\apache\hadoop\fs\azurebfs\ITestAzureBlobFileSystemDelete.java,219,16,0,9,0,25
 hadoop-trunk\hadoop-trunk\hadoop-yarn-project\hadoop-yarn\hadoop-yarn-server\hadoop-yarn-server-timelineservice-hbase\hadoop-yarn-server-timelineservice-hbase-common\src\main\java\org\apache\hadoop\yarn\server\timelineservice\storage\application\ApplicationRowKey.java,219,41,1,5,0,47
 hadoop-trunk\hadoop-trunk\hadoop-hdfs-project\hadoop-hdfs-rbf\src\main\java\org\apache\hadoop\hdfs\server\federation\router\RouterFederationRename.java,219,30,9,11,3,53
 hadoop-trunk\hadoop-trunk\hadoop-hdfs-project\hadoop-hdfs\src\test\java\org\apache\hadoop\hdfs\server\namenode\web\resources\TestWebHdfsDataLocality.java,219,42,7,2,0,51
 hadoop-trunk\hadoop-trunk\hadoop-yarn-project\hadoop-yarn\hadoop-yarn-server\hadoop-yarn-server-applicationhistoryservice\src\main\java\org\apache\hadoop\yarn\server\applicationhistoryservice\records\impl\pb\ContainerStartDataPBImpl.java,219,56,75,4,0,135
 hadoop-trunk\hadoop-trunk\hadoop-hdfs-project\hadoop-hdfs\src\test\java\org\apache\hadoop\hdfs\server\datanode\DataNodeTestUtils.java,219,55,2,2,0,59
 hadoop-trunk\hadoop-trunk\hadoop-yarn-project\hadoop-yarn\hadoop-yarn-server\hadoop-yarn-server-tests\src\test\java\org\apache\hadoop\yarn\server\TestDiskFailures.java,219,34,7,2,5,48
 kafka-trunk\kafka-trunk\clients\src\generated\java\org\apache\kafka\common\message\ListTransactionsRequestData.java,219,0,0,26,5,31
 kafka-trunk\kafka-trunk\connect\runtime\src\test\java\org\apache\kafka\connect\runtime\distributed\ConnectProtocolCompatibilityTest.java,219,0,1,57,8,66
 kafka-trunk\kafka-trunk\connect\runtime\src\main\java\org\apache\kafka\connect\storage\KafkaOffsetBackingStore.java,219,0,8,51,1,60
 kafka-trunk\kafka-trunk\clients\src\test\java\org\apache\kafka\common\serialization\ListDeserializerTest.java,219,0,15,72,1,88
 pulsar-master\pulsar-master\pulsar-io\kinesis\src\main\java\org\apache\pulsar\io\kinesis\Utils.java,219,69,7,44,0,120
 zookeeper-master\zookeeper-master\zookeeper-server\src\test\java\org\apache\zookeeper\server\CreateTTLTest.java,219,0,72,41,0,113
 zookeeper-master\zookeeper-master\zookeeper-server\src\main\java\org\apache\zookeeper\server\command\FourLetterCommands.java,219,0,5,28,18,51
 hadoop-trunk\hadoop-trunk\hadoop-common-project\hadoop-common\src\main\java\org\apache\hadoop\ha\FailoverController.java,220,39,2,3,1,45
 hadoop-trunk\hadoop-trunk\hadoop-yarn-project\hadoop-yarn\hadoop-yarn-server\hadoop-yarn-server-timelineservice\src\main\java\org\apache\hadoop\yarn\server\timelineservice\collector\PerNodeTimelineCollectorsAuxService.java,220,36,8,1,0,45
 hadoop-trunk\hadoop-trunk\hadoop-common-project\hadoop-common\src\test\java\org\apache\hadoop\fs\contract\AbstractContractRootDirectoryTest.java,220,26,0,6,1,33
 hadoop-trunk\hadoop-trunk\hadoop-yarn-project\hadoop-yarn\hadoop-yarn-server\hadoop-yarn-server-common\src\main\java\org\apache\hadoop\yarn\server\federation\policies\RouterPolicyFacade.java,220,19,1,7,5,32
 hadoop-trunk\hadoop-trunk\hadoop-common-project\hadoop-nfs\src\main\java\org\apache\hadoop\oncrpc\RpcProgram.java,220,96,10,2,0,108
 hadoop-trunk\hadoop-trunk\hadoop-hdfs-project\hadoop-hdfs-nfs\src\main\java\org\apache\hadoop\hdfs\nfs\mount\RpcProgramMountd.java,220,46,12,1,1,60
 hadoop-trunk\hadoop-trunk\hadoop-hdfs-project\hadoop-hdfs-rbf\src\test\java\org\apache\hadoop\hdfs\server\federation\security\TestRouterSecurityManager.java,220,17,14,8,0,39
 hadoop-trunk\hadoop-trunk\hadoop-mapreduce-project\hadoop-mapreduce-examples\src\main\java\org\apache\hadoop\examples\terasort\GenSort.java,220,173,5,11,2,191
 hadoop-trunk\hadoop-trunk\hadoop-yarn-project\hadoop-yarn\hadoop-yarn-server\hadoop-yarn-server-common\src\test\java\org\apache\hadoop\yarn\server\federation\store\impl\HSQLDBFederationStateStore.java,220,23,3,1,48,75
 hadoop-trunk\hadoop-trunk\hadoop-common-project\hadoop-registry\src\main\java\org\apache\hadoop\registry\server\dns\RegistryDNSServer.java,220,25,1,1,1,28
 hadoop-trunk\hadoop-trunk\hadoop-yarn-project\hadoop-yarn\hadoop-yarn-server\hadoop-yarn-server-resourcemanager\src\main\java\org\apache\hadoop\yarn\server\resourcemanager\webapp\RMWebAppFilter.java,220,49,5,1,0,55
 kafka-trunk\kafka-trunk\connect\mirror\src\test\java\org\apache\kafka\connect\mirror\integration\IdentityReplicationIntegrationTest.java,220,0,3,69,15,87
 kafka-trunk\kafka-trunk\clients\src\main\java\org\apache\kafka\clients\admin\internals\AdminMetadataManager.java,220,0,2,14,2,18
 pulsar-master\pulsar-master\pulsar-functions\worker\src\test\java\org\apache\pulsar\functions\worker\FunctionActionerTest.java,220,62,1,60,0,123
 pulsar-master\pulsar-master\pulsar-broker\src\main\java\org\apache\pulsar\broker\service\BacklogQuotaManager.java,220,78,10,55,0,143
 rocketmq-develop\rocketmq-develop\broker\src\main\java\org\apache\rocketmq\broker\mqtrace\SendMessageContext.java,220,159,0,2,2,163
 skywalking-master\skywalking-master\oap-server\server-storage-plugin\storage-iotdb-plugin\src\main\java\org\apache\skywalking\oap\server\storage\plugin\iotdb\query\IoTDBMetadataQueryDAO.java,220,78,2,59,0,139
 hadoop-trunk\hadoop-trunk\hadoop-tools\hadoop-sls\src\test\java\org\apache\hadoop\yarn\sls\scheduler\TestTaskRunner.java,221,85,2,1,20,108
 hadoop-trunk\hadoop-trunk\hadoop-common-project\hadoop-kms\src\main\java\org\apache\hadoop\crypto\key\kms\server\KMSAudit.java,221,56,3,4,0,63
 hadoop-trunk\hadoop-trunk\hadoop-tools\hadoop-sls\src\test\java\org\apache\hadoop\yarn\sls\TestSynthJobGeneration.java,221,20,25,3,0,48
 hadoop-trunk\hadoop-trunk\hadoop-common-project\hadoop-common\src\test\java\org\apache\hadoop\util\TestLightWeightResizableGSet.java,221,40,10,1,1,52
 hadoop-trunk\hadoop-trunk\hadoop-mapreduce-project\hadoop-mapreduce-examples\src\main\java\org\apache\hadoop\examples\RandomWriter.java,221,149,7,2,1,159
 hadoop-trunk\hadoop-trunk\hadoop-mapreduce-project\hadoop-mapreduce-client\hadoop-mapreduce-client-jobclient\src\test\java\org\apache\hadoop\mapreduce\RandomWriter.java,221,150,8,2,1,161
 hadoop-trunk\hadoop-trunk\hadoop-hdfs-project\hadoop-hdfs\src\test\java\org\apache\hadoop\hdfs\server\datanode\fsdataset\impl\TestLazyWriter.java,221,20,18,3,0,41
 hadoop-trunk\hadoop-trunk\hadoop-hdfs-project\hadoop-hdfs\src\main\java\org\apache\hadoop\hdfs\server\namenode\StoragePolicySummary.java,221,78,6,4,0,88
 hadoop-trunk\hadoop-trunk\hadoop-yarn-project\hadoop-yarn\hadoop-yarn-common\src\main\java\org\apache\hadoop\yarn\api\records\impl\pb\ResourceRequestPBImpl.java,221,62,77,1,0,140
 kafka-trunk\kafka-trunk\metadata\src\test\java\org\apache\kafka\timeline\SnapshottableHashTableTest.java,221,0,6,11,0,17
 kafka-trunk\kafka-trunk\clients\src\test\java\org\apache\kafka\common\record\AbstractLegacyRecordBatchTest.java,221,0,4,41,33,78
 kafka-trunk\kafka-trunk\connect\runtime\src\main\java\org\apache\kafka\connect\runtime\distributed\IncrementalCooperativeConnectProtocol.java,221,0,2,52,0,54
 kafka-trunk\kafka-trunk\storage\src\main\java\org\apache\kafka\server\log\remote\metadata\storage\RemoteLogMetadataCache.java,221,0,0,113,0,113
 kafka-trunk\kafka-trunk\streams\src\main\java\org\apache\kafka\streams\processor\internals\ProcessorTopology.java,221,0,0,25,3,28
 pulsar-master\pulsar-master\testmocks\src\main\java\org\apache\bookkeeper\client\PulsarMockLedgerHandle.java,221,89,6,31,2,128
 pulsar-master\pulsar-master\pulsar-broker\src\test\java\org\apache\pulsar\broker\transaction\buffer\TransactionLowWaterMarkTest.java,221,52,13,36,0,101
 pulsar-master\pulsar-master\tiered-storage\jcloud\src\main\java\org\apache\bookkeeper\mledger\offload\jcloud\impl\BlobStoreBackedReadHandleImpl.java,221,78,6,42,0,126
 zookeeper-master\zookeeper-master\zookeeper-server\src\main\java\org\apache\zookeeper\server\RequestThrottler.java,221,0,7,13,4,24
 dubbo-3.0\dubbo-3.0\dubbo-config\dubbo-config-spring\src\main\java\org\apache\dubbo\config\spring\reference\ReferenceBeanSupport.java,222,68,3,43,0,114
 hadoop-trunk\hadoop-trunk\hadoop-common-project\hadoop-common\src\main\java\org\apache\hadoop\io\MD5Hash.java,222,126,14,1,2,143
 hadoop-trunk\hadoop-trunk\hadoop-yarn-project\hadoop-yarn\hadoop-yarn-server\hadoop-yarn-server-applicationhistoryservice\src\main\java\org\apache\hadoop\yarn\server\applicationhistoryservice\MemoryApplicationHistoryStore.java,222,42,0,18,0,60
 hadoop-trunk\hadoop-trunk\hadoop-hdfs-project\hadoop-hdfs\src\test\java\org\apache\hadoop\hdfs\server\datanode\TestDataStorage.java,222,38,0,2,3,43
 hadoop-trunk\hadoop-trunk\hadoop-tools\hadoop-sls\src\main\java\org\apache\hadoop\yarn\sls\nodemanager\NodeInfo.java,222,61,8,3,0,72
 hadoop-trunk\hadoop-trunk\hadoop-common-project\hadoop-common\src\test\java\org\apache\hadoop\http\TestSSLHttpServerConfigs.java,222,77,1,6,4,88
 hadoop-trunk\hadoop-trunk\hadoop-yarn-project\hadoop-yarn\hadoop-yarn-server\hadoop-yarn-server-nodemanager\src\main\java\org\apache\hadoop\yarn\server\nodemanager\logaggregation\tracker\NMLogAggregationStatusTracker.java,222,44,7,2,1,54
 pulsar-master\pulsar-master\pulsar-broker\src\test\java\org\apache\pulsar\io\AbstractPulsarE2ETest.java,222,109,8,50,0,167
 pulsar-master\pulsar-master\pulsar-broker-common\src\main\java\org\apache\pulsar\broker\authorization\MultiRolesTokenAuthorizationProvider.java,222,124,1,59,0,184
 pulsar-master\pulsar-master\pulsar-client-tools\src\main\java\org\apache\pulsar\admin\cli\CmdNamespaceIsolationPolicy.java,222,62,0,42,0,104
 rocketmq-develop\rocketmq-develop\store\src\test\java\org\apache\rocketmq\store\AppendCallbackTest.java,222,88,8,35,6,137
 rocketmq-develop\rocketmq-develop\client\src\main\java\org\apache\rocketmq\client\impl\consumer\PullAPIWrapper.java,222,81,8,32,2,123
 zookeeper-master\zookeeper-master\zookeeper-server\src\test\java\org\apache\zookeeper\server\quorum\MultipleAddressesTest.java,222,0,7,59,0,66
 hadoop-trunk\hadoop-trunk\hadoop-yarn-project\hadoop-yarn\hadoop-yarn-server\hadoop-yarn-server-router\src\test\java\org\apache\hadoop\yarn\server\router\clientrm\TestRouterClientRMService.java,223,6,1,3,0,10
 hadoop-trunk\hadoop-trunk\hadoop-common-project\hadoop-common\src\main\java\org\apache\hadoop\fs\viewfs\ConfigUtil.java,223,51,3,1,0,55
 hadoop-trunk\hadoop-trunk\hadoop-common-project\hadoop-common\src\main\java\org\apache\hadoop\ipc\ProtocolSignature.java,223,89,3,2,3,97
 hadoop-trunk\hadoop-trunk\hadoop-common-project\hadoop-common\src\main\java\org\apache\hadoop\util\hash\JenkinsHash.java,223,123,5,29,11,168
 hadoop-trunk\hadoop-trunk\hadoop-yarn-project\hadoop-yarn\hadoop-yarn-server\hadoop-yarn-server-timelineservice-hbase\hadoop-yarn-server-timelineservice-hbase-server\hadoop-yarn-server-timelineservice-hbase-server-1\src\main\java\org\apache\hadoop\yarn\server\timelineservice\storage\flow\FlowRunCoprocessor.java,223,37,8,3,0,48
 hadoop-trunk\hadoop-trunk\hadoop-yarn-project\hadoop-yarn\hadoop-yarn-common\src\test\java\org\apache\hadoop\yarn\client\api\impl\TestTimelineClientForATS1_5.java,223,34,5,3,5,47
 hadoop-trunk\hadoop-trunk\hadoop-tools\hadoop-sls\src\main\java\org\apache\hadoop\yarn\sls\TaskContainerDefinition.java,223,100,0,3,2,105
 kafka-trunk\kafka-trunk\metadata\src\main\java\org\apache\kafka\metadata\Replicas.java,223,0,25,4,1,30
 kafka-trunk\kafka-trunk\clients\src\generated\java\org\apache\kafka\common\message\DescribeGroupsResponseDataJsonConverter.java,223,0,0,50,0,50
 kafka-trunk\kafka-trunk\streams\src\test\java\org\apache\kafka\streams\integration\StateDirectoryIntegrationTest.java,223,0,7,35,6,48
 kafka-trunk\kafka-trunk\storage\src\main\java\org\apache\kafka\server\log\remote\metadata\storage\RemoteLogMetadataSnapshotFile.java,223,0,2,49,4,55
 pulsar-master\pulsar-master\tests\integration\src\test\java\org\apache\pulsar\tests\integration\io\sources\debezium\PulsarDebeziumSourcesTest.java,223,72,2,50,0,124
 pulsar-master\pulsar-master\pulsar-broker\src\test\java\org\apache\pulsar\broker\resourcegroup\ResourceGroupUsageAggregationTest.java,223,93,5,37,0,135
 skywalking-master\skywalking-master\oap-server\server-receiver-plugin\skywalking-mesh-receiver-plugin\src\main\java\org\apache\skywalking\aop\server\receiver\mesh\TelemetryDataDispatcher.java,223,71,2,41,0,114
 zookeeper-master\zookeeper-master\zookeeper-server\src\main\java\org\apache\zookeeper\server\quorum\LearnerMaster.java,223,0,3,19,2,24
 zookeeper-master\zookeeper-master\zookeeper-server\src\test\java\org\apache\zookeeper\KerberosTicketRenewalTest.java,223,0,3,18,7,28
 dubbo-3.0\dubbo-3.0\dubbo-common\src\main\java\org\apache\dubbo\common\utils\IOUtils.java,224,44,4,13,2,63
 dubbo-3.0\dubbo-3.0\dubbo-common\src\test\java\org\apache\dubbo\common\bytecode\WrapperTest.java,224,84,11,18,0,113
 hadoop-trunk\hadoop-trunk\hadoop-hdfs-project\hadoop-hdfs\src\test\java\org\apache\hadoop\hdfs\server\namenode\TestStartupProgressServlet.java,224,33,3,3,19,58
 hadoop-trunk\hadoop-trunk\hadoop-yarn-project\hadoop-yarn\hadoop-yarn-server\hadoop-yarn-server-resourcemanager\src\test\java\org\apache\hadoop\yarn\server\resourcemanager\scheduler\fair\TestFSAppStarvation.java,224,28,3,2,2,35
 hadoop-trunk\hadoop-trunk\hadoop-common-project\hadoop-common\src\test\java\org\apache\hadoop\metrics2\sink\TestRollingFileSystemSink.java,224,47,20,1,2,70
 hadoop-trunk\hadoop-trunk\hadoop-common-project\hadoop-common\src\main\java\org\apache\hadoop\util\Progress.java,224,70,6,2,0,78
 hadoop-trunk\hadoop-trunk\hadoop-hdfs-project\hadoop-hdfs\src\main\java\org\apache\hadoop\hdfs\server\blockmanagement\BlockPlacementPolicyRackFaultTolerant.java,224,57,4,3,0,64
 kafka-trunk\kafka-trunk\connect\runtime\src\test\java\org\apache\kafka\connect\storage\KafkaStatusBackingStoreFormatTest.java,224,0,1,50,1,52
 kafka-trunk\kafka-trunk\streams\src\main\java\org\apache\kafka\streams\processor\internals\RecordQueue.java,224,0,2,13,1,16
 kafka-trunk\kafka-trunk\streams\src\test\java\org\apache\kafka\streams\kstream\internals\KTableAggregateTest.java,224,0,4,15,0,19
 pulsar-master\pulsar-master\pulsar-broker\src\test\java\org\apache\pulsar\io\PulsarFunctionTlsTest.java,224,98,8,44,0,150
 pulsar-master\pulsar-master\pulsar-package-management\core\src\main\java\org\apache\pulsar\packages\management\core\impl\PackagesManagementImpl.java,224,66,0,35,0,101
 rocketmq-develop\rocketmq-develop\client\src\main\java\org\apache\rocketmq\client\impl\consumer\AssignedMessageQueue.java,224,102,4,23,5,134
 skywalking-master\skywalking-master\oap-server\server-storage-plugin\storage-iotdb-plugin\src\main\java\org\apache\skywalking\oap\server\storage\plugin\iotdb\query\IoTDBMetricsQueryDAO.java,224,49,5,35,0,89
 skywalking-master\skywalking-master\oap-server\server-library\library-util\src\main\java\org\apache\skywalking\oap\server\library\util\MultipleFilesChangeMonitor.java,224,41,4,22,1,68
 zookeeper-master\zookeeper-master\zookeeper-server\src\test\java\org\apache\zookeeper\test\FourLetterWordsWhiteListTest.java,224,0,9,11,0,20
 dubbo-3.0\dubbo-3.0\dubbo-rpc\dubbo-rpc-triple\src\test\java\org\apache\dubbo\rpc\protocol\tri\ReflectionPackableMethodTest.java,225,67,17,51,0,135
 dubbo-3.0\dubbo-3.0\dubbo-common\src\main\java\org\apache\dubbo\common\Parameters.java,225,116,1,9,1,127
 hadoop-trunk\hadoop-trunk\hadoop-mapreduce-project\hadoop-mapreduce-client\hadoop-mapreduce-client-core\src\main\java\org\apache\hadoop\mapreduce\security\TokenCache.java,225,86,5,2,1,94
 hadoop-trunk\hadoop-trunk\hadoop-mapreduce-project\hadoop-mapreduce-client\hadoop-mapreduce-client-hs\src\test\java\org\apache\hadoop\mapreduce\v2\hs\TestJobHistoryEvents.java,225,69,4,5,0,78
 hadoop-trunk\hadoop-trunk\hadoop-common-project\hadoop-common\src\test\java\org\apache\hadoop\log\TestLog4Json.java,225,47,18,1,1,67
 hadoop-trunk\hadoop-trunk\hadoop-tools\hadoop-aws\src\test\java\org\apache\hadoop\fs\s3a\auth\delegation\ITestDelegatedMRJob.java,225,27,5,4,2,38
 hadoop-trunk\hadoop-trunk\hadoop-hdfs-project\hadoop-hdfs\src\main\java\org\apache\hadoop\hdfs\server\diskbalancer\command\PlanCommand.java,225,35,4,1,1,41
 hadoop-trunk\hadoop-trunk\hadoop-mapreduce-project\hadoop-mapreduce-client\hadoop-mapreduce-client-jobclient\src\test\java\org\apache\hadoop\mapred\TestMapProgress.java,225,91,12,7,0,110
 hadoop-trunk\hadoop-trunk\hadoop-yarn-project\hadoop-yarn\hadoop-yarn-server\hadoop-yarn-server-sharedcachemanager\src\test\java\org\apache\hadoop\yarn\server\sharedcachemanager\TestClientSCMProtocolService.java,225,25,7,4,3,39
 hadoop-trunk\hadoop-trunk\hadoop-yarn-project\hadoop-yarn\hadoop-yarn-client\src\test\java\org\apache\hadoop\yarn\client\TestNoHaRMFailoverProxyProvider.java,225,18,24,1,3,46
 hadoop-trunk\hadoop-trunk\hadoop-common-project\hadoop-common\src\main\java\org\apache\hadoop\fs\shell\CommandFormat.java,225,75,7,2,0,84
 hadoop-trunk\hadoop-trunk\hadoop-tools\hadoop-azure\src\main\java\org\apache\hadoop\fs\azurebfs\services\AbfsOutputStreamContext.java,225,109,0,3,6,118
 kafka-trunk\kafka-trunk\streams\src\test\java\org\apache\kafka\streams\state\internals\ChangeLoggingKeyValueBytesStoreTest.java,225,0,5,18,6,29
 pulsar-master\pulsar-master\pulsar-client\src\main\java\org\apache\pulsar\client\impl\MessageIdImpl.java,225,92,3,24,0,119
 pulsar-master\pulsar-master\pulsar-io\kinesis\src\main\java\org\apache\pulsar\io\kinesis\KinesisSink.java,225,115,7,66,0,188
 pulsar-master\pulsar-master\pulsar-broker\src\test\java\org\apache\pulsar\client\impl\KeyStoreTlsProducerConsumerTestWithAuthTest.java,225,75,16,26,0,117
 pulsar-master\pulsar-master\pulsar-io\elastic-search\src\main\java\org\apache\pulsar\io\elasticsearch\client\opensearch\OpenSearchHighLevelRestClient.java,225,90,5,43,0,138
 pulsar-master\pulsar-master\pulsar-broker\src\test\java\org\apache\pulsar\broker\service\NullValueTest.java,225,31,0,10,0,41
 rocketmq-develop\rocketmq-develop\broker\src\main\java\org\apache\rocketmq\broker\processor\EndTransactionProcessor.java,225,64,5,45,1,115
 skywalking-master\skywalking-master\oap-server\server-core\src\test\java\org\apache\skywalking\oap\server\core\analysis\meter\function\avg\AvgHistogramPercentileFunctionTest.java,225,51,2,14,0,67
 zookeeper-master\zookeeper-master\zookeeper-server\src\test\java\org\apache\zookeeper\test\DisconnectedWatcherTest.java,225,0,22,21,0,43
 hadoop-trunk\hadoop-trunk\hadoop-hdfs-project\hadoop-hdfs\src\main\java\org\apache\hadoop\hdfs\tools\DelegationTokenFetcher.java,226,30,2,5,0,37
 hadoop-trunk\hadoop-trunk\hadoop-hdfs-project\hadoop-hdfs\src\main\java\org\apache\hadoop\hdfs\server\diskbalancer\planner\MoveStep.java,226,36,1,1,6,44
 hadoop-trunk\hadoop-trunk\hadoop-mapreduce-project\hadoop-mapreduce-client\hadoop-mapreduce-client-jobclient\src\test\java\org\apache\hadoop\mapred\TestMROpportunisticMaps.java,226,62,9,1,3,75
 hadoop-trunk\hadoop-trunk\hadoop-hdfs-project\hadoop-hdfs\src\main\java\org\apache\hadoop\hdfs\server\diskbalancer\planner\GreedyPlanner.java,226,32,9,1,0,42
 hadoop-trunk\hadoop-trunk\hadoop-yarn-project\hadoop-yarn\hadoop-yarn-server\hadoop-yarn-server-nodemanager\src\main\java\org\apache\hadoop\yarn\server\nodemanager\containermanager\deletion\task\DeletionTask.java,226,35,6,3,4,48
 hadoop-trunk\hadoop-trunk\hadoop-hdfs-project\hadoop-hdfs\src\test\java\org\apache\hadoop\hdfs\server\namenode\top\window\TestRollingWindowManager.java,226,109,9,4,9,131
 hadoop-trunk\hadoop-trunk\hadoop-hdfs-project\hadoop-hdfs\src\test\java\org\apache\hadoop\hdfs\tools\TestDebugAdmin.java,226,49,3,8,7,67
 hadoop-trunk\hadoop-trunk\hadoop-yarn-project\hadoop-yarn\hadoop-yarn-client\src\main\java\org\apache\hadoop\yarn\client\api\impl\ContainerManagementProtocolProxy.java,226,64,3,2,3,72
 hadoop-trunk\hadoop-trunk\hadoop-mapreduce-project\hadoop-mapreduce-client\hadoop-mapreduce-client-jobclient\src\test\java\org\apache\hadoop\mapred\TestKeyValueTextInputFormat.java,226,92,17,4,3,116
 kafka-trunk\kafka-trunk\raft\src\test\java\org\apache\kafka\raft\internals\KafkaRaftMetricsTest.java,226,0,3,72,3,78
 rocketmq-develop\rocketmq-develop\broker\src\test\java\org\apache\rocketmq\broker\processor\SendMessageProcessorTest.java,226,86,12,42,0,140
 zookeeper-master\zookeeper-master\zookeeper-server\src\test\java\org\apache\zookeeper\server\TxnLogDigestTest.java,226,0,13,10,2,25
 zookeeper-master\zookeeper-master\zookeeper-server\src\test\java\org\apache\zookeeper\common\FileChangeWatcherTest.java,226,0,12,20,7,39
 dubbo-3.0\dubbo-3.0\dubbo-cluster\src\main\java\org\apache\dubbo\rpc\cluster\support\wrapper\AbstractCluster.java,227,62,0,29,0,91
 hadoop-trunk\hadoop-trunk\hadoop-hdfs-project\hadoop-hdfs-rbf\src\test\java\org\apache\hadoop\hdfs\server\federation\router\TestRouterSafemode.java,227,23,3,8,0,34
 hadoop-trunk\hadoop-trunk\hadoop-hdfs-project\hadoop-hdfs-nfs\src\main\java\org\apache\hadoop\hdfs\nfs\nfs3\Nfs3Utils.java,227,97,2,2,2,103
 hadoop-trunk\hadoop-trunk\hadoop-common-project\hadoop-auth\src\main\java\org\apache\hadoop\security\authentication\util\AuthToken.java,227,52,2,14,0,68
 hadoop-trunk\hadoop-trunk\hadoop-yarn-project\hadoop-yarn\hadoop-yarn-server\hadoop-yarn-server-resourcemanager\src\test\java\org\apache\hadoop\yarn\server\resourcemanager\TestKillApplicationWithRMHA.java,227,40,0,4,3,47
 hadoop-trunk\hadoop-trunk\hadoop-hdfs-project\hadoop-hdfs\src\test\java\org\apache\hadoop\hdfs\server\datanode\TestDiskError.java,227,35,4,2,4,45
 hadoop-trunk\hadoop-trunk\hadoop-common-project\hadoop-common\src\test\java\org\apache\hadoop\util\bloom\TestBloomFilters.java,227,58,4,11,5,78
 hadoop-trunk\hadoop-trunk\hadoop-yarn-project\hadoop-yarn\hadoop-yarn-common\src\main\java\org\apache\hadoop\yarn\api\records\impl\pb\ReservationAllocationStatePBImpl.java,227,42,68,3,0,113
 hadoop-trunk\hadoop-trunk\hadoop-mapreduce-project\hadoop-mapreduce-client\hadoop-mapreduce-client-jobclient\src\test\java\org\apache\hadoop\mapred\TestJobClients.java,227,43,3,2,14,62
 hadoop-trunk\hadoop-trunk\hadoop-yarn-project\hadoop-yarn\hadoop-yarn-server\hadoop-yarn-server-nodemanager\src\test\java\org\apache\hadoop\yarn\server\nodemanager\containermanager\launcher\TestContainersLauncher.java,227,27,44,5,7,83
 kafka-trunk\kafka-trunk\clients\src\main\java\org\apache\kafka\common\internals\KafkaFutureImpl.java,227,0,6,39,5,50
 kafka-trunk\kafka-trunk\streams\src\main\java\org\apache\kafka\streams\processor\internals\assignment\HighAvailabilityTaskAssignor.java,227,0,3,56,0,59
 skywalking-master\skywalking-master\oap-server\server-library\library-elasticsearch-client\src\test\java\org\apache\skywalking\library\elasticsearch\ITElasticSearchTest.java,227,41,0,28,0,69
 skywalking-master\skywalking-master\oap-server\server-cluster-plugin\cluster-nacos-plugin\src\test\java\org\apache\skywalking\oap\server\cluster\plugin\nacos\ITClusterModuleNacosProviderFunctionalTest.java,227,53,11,18,0,82
 skywalking-master\skywalking-master\oap-server\server-storage-plugin\storage-iotdb-plugin\src\main\java\org\apache\skywalking\oap\server\storage\plugin\iotdb\query\IoTDBTopologyQueryDAO.java,227,103,1,57,0,161
 skywalking-master\skywalking-master\oap-server\server-storage-plugin\storage-elasticsearch-plugin\src\main\java\org\apache\skywalking\oap\server\storage\plugin\elasticsearch\query\MetricsQueryEsDAO.java,227,45,1,40,0,86
 zookeeper-master\zookeeper-master\zookeeper-server\src\test\java\org\apache\zookeeper\EnforceAuthenticationTest.java,227,0,9,38,0,47
 dubbo-3.0\dubbo-3.0\dubbo-rpc\dubbo-rpc-api\src\main\java\org\apache\dubbo\rpc\support\RpcUtils.java,228,78,11,27,3,119
 hadoop-trunk\hadoop-trunk\hadoop-hdfs-project\hadoop-hdfs\src\main\java\org\apache\hadoop\hdfs\tools\offlineEditsViewer\OfflineEditsViewer.java,228,88,5,2,0,95
 hadoop-trunk\hadoop-trunk\hadoop-hdfs-project\hadoop-hdfs\src\test\java\org\apache\hadoop\security\TestRefreshUserMappings.java,228,89,20,7,3,119
 hadoop-trunk\hadoop-trunk\hadoop-common-project\hadoop-registry\src\main\java\org\apache\hadoop\registry\server\services\MicroZookeeperService.java,228,34,4,5,0,43
 hadoop-trunk\hadoop-trunk\hadoop-common-project\hadoop-common\src\main\java\org\apache\hadoop\fs\FSOutputSummer.java,228,102,1,1,1,105
 hadoop-trunk\hadoop-trunk\hadoop-mapreduce-project\hadoop-mapreduce-client\hadoop-mapreduce-client-jobclient\src\test\java\org\apache\hadoop\mapreduce\v2\TestMRJobsWithProfiler.java,228,37,12,1,7,57
 hadoop-trunk\hadoop-trunk\hadoop-yarn-project\hadoop-yarn\hadoop-yarn-api\src\main\java\org\apache\hadoop\yarn\api\records\NodeReport.java,228,67,2,2,0,71
 hadoop-trunk\hadoop-trunk\hadoop-mapreduce-project\hadoop-mapreduce-client\hadoop-mapreduce-client-app\src\main\java\org\apache\hadoop\mapreduce\v2\app\rm\preemption\CheckpointAMPreemptionPolicy.java,228,52,7,2,1,62
 hadoop-trunk\hadoop-trunk\hadoop-yarn-project\hadoop-yarn\hadoop-yarn-server\hadoop-yarn-server-nodemanager\src\test\java\org\apache\hadoop\yarn\server\nodemanager\containermanager\resourceplugin\com\nec\TestVEDeviceDiscoverer.java,228,34,1,2,0,37
 hadoop-trunk\hadoop-trunk\hadoop-yarn-project\hadoop-yarn\hadoop-yarn-server\hadoop-yarn-server-nodemanager\src\test\java\org\apache\hadoop\yarn\server\nodemanager\scheduler\TestDistributedScheduler.java,228,59,2,9,0,70
 hadoop-trunk\hadoop-trunk\hadoop-tools\hadoop-azure\src\test\java\org\apache\hadoop\fs\azure\TestNativeAzureFileSystemBlockCompaction.java,228,31,2,16,1,50
 hadoop-trunk\hadoop-trunk\hadoop-tools\hadoop-aws\src\test\java\org\apache\hadoop\fs\s3a\s3guard\AbstractS3GuardToolTestBase.java,228,27,1,6,1,35
 kafka-trunk\kafka-trunk\streams\src\test\java\org\apache\kafka\streams\state\internals\InMemoryKeyValueStoreTest.java,228,0,4,15,13,32
 kafka-trunk\kafka-trunk\streams\src\test\java\org\apache\kafka\streams\integration\RangeQueryIntegrationTest.java,228,0,6,32,6,44
 pulsar-master\pulsar-master\pulsar-client-admin-api\src\main\java\org\apache\pulsar\client\admin\PulsarAdminException.java,228,99,43,20,0,162
 pulsar-master\pulsar-master\pulsar-broker-auth-sasl\src\main\java\org\apache\pulsar\broker\authentication\AuthenticationProviderSasl.java,228,66,7,49,0,122
 rocketmq-develop\rocketmq-develop\store\src\test\java\org\apache\rocketmq\store\MappedFileQueueTest.java,228,95,2,14,10,121
 skywalking-master\skywalking-master\oap-server\server-core\src\main\java\org\apache\skywalking\oap\server\core\remote\client\RemoteClientManager.java,228,59,4,31,0,94
 hadoop-trunk\hadoop-trunk\hadoop-tools\hadoop-rumen\src\main\java\org\apache\hadoop\tools\rumen\Anonymizer.java,229,61,7,1,0,69
 hadoop-trunk\hadoop-trunk\hadoop-yarn-project\hadoop-yarn\hadoop-yarn-server\hadoop-yarn-server-resourcemanager\src\test\java\org\apache\hadoop\yarn\server\resourcemanager\scheduler\fair\TestComputeFairShares.java,229,88,0,2,0,90
 hadoop-trunk\hadoop-trunk\hadoop-mapreduce-project\hadoop-mapreduce-client\hadoop-mapreduce-client-core\src\main\java\org\apache\hadoop\mapreduce\jobhistory\JobSubmittedEvent.java,229,98,41,2,0,141
 hadoop-trunk\hadoop-trunk\hadoop-hdfs-project\hadoop-hdfs-client\src\main\java\org\apache\hadoop\hdfs\client\impl\SnapshotDiffReportGenerator.java,229,40,1,2,0,43
 hadoop-trunk\hadoop-trunk\hadoop-hdfs-project\hadoop-hdfs\src\main\java\org\apache\hadoop\hdfs\server\namenode\startupprogress\StartupProgress.java,229,47,1,8,1,57
 hadoop-trunk\hadoop-trunk\hadoop-hdfs-project\hadoop-hdfs\src\test\java\org\apache\hadoop\fs\loadGenerator\TestLoadGenerator.java,229,74,18,7,20,119
 hadoop-trunk\hadoop-trunk\hadoop-yarn-project\hadoop-yarn\hadoop-yarn-server\hadoop-yarn-server-resourcemanager\src\main\java\org\apache\hadoop\yarn\server\resourcemanager\monitor\capacity\CapacitySchedulerPreemptionUtils.java,229,35,1,1,0,37
 kafka-trunk\kafka-trunk\clients\src\generated\java\org\apache\kafka\common\message\FindCoordinatorResponseDataJsonConverter.java,229,0,0,42,0,42
 pulsar-master\pulsar-master\pulsar-broker\src\main\java\org\apache\pulsar\broker\service\AbstractReplicator.java,229,120,6,47,0,173
 skywalking-master\skywalking-master\oap-server\server-core\src\test\java\org\apache\skywalking\oap\server\core\config\group\openapi\EndpointNameGroupingRule4OpenapiWatcherTest.java,229,180,3,16,0,199
 zookeeper-master\zookeeper-master\zookeeper-server\src\test\java\org\apache\zookeeper\server\quorum\StandaloneDisabledTest.java,229,0,20,27,7,54
 dubbo-3.0\dubbo-3.0\dubbo-plugin\dubbo-qos\src\main\java\org\apache\dubbo\qos\command\impl\InvokeTelnet.java,230,48,4,24,0,76
 dubbo-3.0\dubbo-3.0\dubbo-plugin\dubbo-qos\src\test\java\org\apache\dubbo\qos\command\impl\InvokeTelnetTest.java,230,90,1,65,0,156
 dubbo-3.0\dubbo-3.0\dubbo-remoting\dubbo-remoting-api\src\main\java\org\apache\dubbo\remoting\exchange\support\header\HeaderExchangeServer.java,230,59,5,16,2,82
 hadoop-trunk\hadoop-trunk\hadoop-hdfs-project\hadoop-hdfs-client\src\main\java\org\apache\hadoop\hdfs\protocol\ZoneReencryptionStatus.java,230,61,6,1,1,69
 hadoop-trunk\hadoop-trunk\hadoop-hdfs-project\hadoop-hdfs\src\main\java\org\apache\hadoop\hdfs\server\datanode\erasurecode\StripedReconstructor.java,230,35,0,1,0,36
 hadoop-trunk\hadoop-trunk\hadoop-hdfs-project\hadoop-hdfs\src\main\java\org\apache\hadoop\hdfs\tools\offlineImageViewer\OfflineImageViewerPB.java,230,20,6,5,0,31
 hadoop-trunk\hadoop-trunk\hadoop-mapreduce-project\hadoop-mapreduce-client\hadoop-mapreduce-client-jobclient\src\test\java\org\apache\hadoop\mapreduce\security\TestJHSSecurity.java,230,41,10,6,4,61
 hadoop-trunk\hadoop-trunk\hadoop-hdfs-project\hadoop-hdfs-rbf\src\main\java\org\apache\hadoop\hdfs\server\federation\metrics\FederationRPCPerformanceMonitor.java,230,32,1,2,4,39
 hadoop-trunk\hadoop-trunk\hadoop-common-project\hadoop-kms\src\test\java\org\apache\hadoop\crypto\key\kms\server\TestKeyAuthorizationKeyProvider.java,230,24,5,8,0,37
 hadoop-trunk\hadoop-trunk\hadoop-mapreduce-project\hadoop-mapreduce-client\hadoop-mapreduce-client-core\src\test\java\org\apache\hadoop\mapred\TestFileInputFormat.java,230,74,21,11,3,109
 kafka-trunk\kafka-trunk\storage\api\src\main\java\org\apache\kafka\server\log\remote\storage\RemoteLogSegmentMetadata.java,230,0,0,27,0,27
 kafka-trunk\kafka-trunk\clients\src\generated\java\org\apache\kafka\common\message\ApiVersionsResponseDataJsonConverter.java,230,0,0,54,0,54
 kafka-trunk\kafka-trunk\raft\src\main\java\org\apache\kafka\raft\RaftConfig.java,230,0,2,42,2,46
 kafka-trunk\kafka-trunk\clients\src\generated\java\org\apache\kafka\common\message\OffsetCommitRequestDataJsonConverter.java,230,0,0,50,0,50
 kafka-trunk\kafka-trunk\metadata\src\test\java\org\apache\kafka\controller\AclControlManagerTest.java,230,0,4,35,2,41
 pulsar-master\pulsar-master\pulsar-broker\src\test\java\org\apache\pulsar\compaction\CompactionRetentionTest.java,230,34,8,19,0,61
 pulsar-master\pulsar-master\pulsar-sql\presto-pulsar\src\test\java\org\apache\pulsar\sql\presto\decoder\protobufnative\TestProtobufNativeDecoder.java,230,95,0,65,0,160
 pulsar-master\pulsar-master\pulsar-functions\worker\src\main\java\org\apache\pulsar\functions\worker\rest\api\v3\SinksApiV3Resource.java,230,113,1,46,0,160
 zookeeper-master\zookeeper-master\zookeeper-recipes\zookeeper-recipes-election\src\test\java\org\apache\zookeeper\recipes\leader\LeaderElectionSupportTest.java,230,0,1,15,1,17
 dubbo-3.0\dubbo-3.0\dubbo-common\src\main\java\org\apache\dubbo\common\beans\factory\ScopeBeanFactory.java,231,94,4,21,0,119
 dubbo-3.0\dubbo-3.0\dubbo-metadata\dubbo-metadata-processor\src\main\java\org\apache\dubbo\metadata\annotation\processing\rest\AbstractServiceRestMetadataResolver.java,231,103,2,66,0,171
 hadoop-trunk\hadoop-trunk\hadoop-yarn-project\hadoop-yarn\hadoop-yarn-server\hadoop-yarn-server-timelineservice\src\main\java\org\apache\hadoop\yarn\server\timelineservice\collector\TimelineCollectorManager.java,231,31,9,1,0,41
 hadoop-trunk\hadoop-trunk\hadoop-common-project\hadoop-common\src\main\java\org\apache\hadoop\security\http\RestCsrfPreventionFilter.java,231,42,2,1,0,45
 hadoop-trunk\hadoop-trunk\hadoop-yarn-project\hadoop-yarn\hadoop-yarn-server\hadoop-yarn-server-nodemanager\src\test\java\org\apache\hadoop\yarn\server\nodemanager\amrmproxy\TestableFederationInterceptor.java,231,62,2,1,9,74
 hadoop-trunk\hadoop-trunk\hadoop-tools\hadoop-azure\src\test\java\org\apache\hadoop\fs\azure\TestBlobMetadata.java,231,17,4,1,0,22
 hadoop-trunk\hadoop-trunk\hadoop-common-project\hadoop-common\src\main\java\org\apache\hadoop\security\http\CrossOriginFilter.java,231,56,8,5,0,69
 hadoop-trunk\hadoop-trunk\hadoop-mapreduce-project\hadoop-mapreduce-client\hadoop-mapreduce-client-hs\src\main\java\org\apache\hadoop\mapreduce\v2\hs\server\HSAdminServer.java,231,42,2,14,2,60
 hadoop-trunk\hadoop-trunk\hadoop-yarn-project\hadoop-yarn\hadoop-yarn-server\hadoop-yarn-server-resourcemanager\src\main\java\org\apache\hadoop\yarn\server\resourcemanager\scheduler\constraint\algorithm\DefaultPlacementAlgorithm.java,231,30,6,14,0,50
 hadoop-trunk\hadoop-trunk\hadoop-hdfs-project\hadoop-hdfs\src\test\java\org\apache\hadoop\hdfs\AppendTestUtil.java,231,150,7,9,5,171
 hadoop-trunk\hadoop-trunk\hadoop-maven-plugins\src\main\java\org\apache\hadoop\maven\plugin\cmakebuilder\CompileMojo.java,231,33,5,1,0,39
 hadoop-trunk\hadoop-trunk\hadoop-mapreduce-project\hadoop-mapreduce-client\hadoop-mapreduce-client-jobclient\src\test\java\org\apache\hadoop\mapreduce\TestTaskContext.java,231,101,8,1,0,110
 hadoop-trunk\hadoop-trunk\hadoop-yarn-project\hadoop-yarn\hadoop-yarn-server\hadoop-yarn-server-resourcemanager\src\main\java\org\apache\hadoop\yarn\server\resourcemanager\scheduler\distributed\ClusterNode.java,231,56,2,1,3,62
 hadoop-trunk\hadoop-trunk\hadoop-tools\hadoop-aws\src\test\java\org\apache\hadoop\fs\s3a\performance\ITestS3ADeleteCost.java,231,9,6,1,1,17
 kafka-trunk\kafka-trunk\clients\src\main\java\org\apache\kafka\common\requests\ApiVersionsResponse.java,231,0,69,25,2,96
 kafka-trunk\kafka-trunk\connect\mirror\src\main\java\org\apache\kafka\connect\mirror\MirrorMaker.java,231,0,3,37,0,40
 pulsar-master\pulsar-master\pulsar-client\src\main\java\org\apache\pulsar\client\impl\TableViewImpl.java,231,51,4,12,0,67
 pulsar-master\pulsar-master\pulsar-broker\src\test\java\org\apache\pulsar\broker\resourcegroup\ResourceGroupServiceTest.java,231,104,4,63,0,171
 pulsar-master\pulsar-master\pulsar-broker\src\main\java\org\apache\pulsar\broker\service\BrokerServiceException.java,231,86,1,24,0,111
 rocketmq-develop\rocketmq-develop\common\src\main\java\org\apache\rocketmq\common\stats\StatsItemSet.java,231,72,6,19,1,98
 rocketmq-develop\rocketmq-develop\broker\src\main\java\org\apache\rocketmq\broker\BrokerStartup.java,231,55,6,31,15,107
 rocketmq-develop\rocketmq-develop\client\src\test\java\org\apache\rocketmq\client\trace\DefaultMQLitePullConsumerWithTraceTest.java,231,83,20,43,2,148
 skywalking-master\skywalking-master\oap-server\server-storage-plugin\storage-elasticsearch-plugin\src\main\java\org\apache\skywalking\oap\server\storage\plugin\elasticsearch\base\StorageEsInstaller.java,231,75,3,53,0,131
 zookeeper-master\zookeeper-master\zookeeper-server\src\main\java\org\apache\zookeeper\server\SyncRequestProcessor.java,231,0,7,18,1,26
 hadoop-trunk\hadoop-trunk\hadoop-yarn-project\hadoop-yarn\hadoop-yarn-server\hadoop-yarn-server-resourcemanager\src\test\java\org\apache\hadoop\yarn\server\resourcemanager\TestLeaderElectorService.java,232,42,5,6,8,61
 hadoop-trunk\hadoop-trunk\hadoop-yarn-project\hadoop-yarn\hadoop-yarn-common\src\test\java\org\apache\hadoop\yarn\util\TestLog4jWarningErrorMetricsAppender.java,232,70,1,7,1,79
 hadoop-trunk\hadoop-trunk\hadoop-mapreduce-project\hadoop-mapreduce-client\hadoop-mapreduce-client-jobclient\src\test\java\org\apache\hadoop\mapred\pipes\TestPipes.java,232,86,13,6,6,111
 hadoop-trunk\hadoop-trunk\hadoop-hdfs-project\hadoop-hdfs-httpfs\src\test\java\org\apache\hadoop\fs\http\server\TestHttpFSServerNoACLs.java,232,13,5,1,17,36
 hadoop-trunk\hadoop-trunk\hadoop-mapreduce-project\hadoop-mapreduce-client\hadoop-mapreduce-client-app\src\test\java\org\apache\hadoop\mapreduce\v2\app\local\TestLocalContainerAllocator.java,232,18,4,6,3,31
 hadoop-trunk\hadoop-trunk\hadoop-yarn-project\hadoop-yarn\hadoop-yarn-common\src\main\java\org\apache\hadoop\yarn\api\records\impl\pb\ResourcePBImpl.java,232,44,39,1,0,84
 hadoop-trunk\hadoop-trunk\hadoop-yarn-project\hadoop-yarn\hadoop-yarn-server\hadoop-yarn-server-router\src\test\java\org\apache\hadoop\yarn\server\router\rmadmin\TestRouterRMAdminService.java,232,6,1,13,0,20
 hadoop-trunk\hadoop-trunk\hadoop-yarn-project\hadoop-yarn\hadoop-yarn-server\hadoop-yarn-server-resourcemanager\src\test\java\org\apache\hadoop\yarn\server\resourcemanager\scheduler\fair\TestAppRunnability.java,232,36,0,8,0,44
 kafka-trunk\kafka-trunk\clients\src\generated\java\org\apache\kafka\common\message\TxnOffsetCommitRequestDataJsonConverter.java,232,0,0,55,0,55
 pulsar-master\pulsar-master\pulsar-client\src\main\java\org\apache\pulsar\client\impl\transaction\TransactionCoordinatorClientImpl.java,232,82,2,38,0,122
 pulsar-master\pulsar-master\pulsar-common\src\main\java\org\apache\pulsar\common\protocol\Markers.java,232,96,0,42,0,138
 pulsar-master\pulsar-master\pulsar-client\src\main\java\org\apache\pulsar\client\impl\UnAckedMessageTracker.java,232,72,5,21,0,98
 pulsar-master\pulsar-master\pulsar-sql\presto-pulsar\src\test\java\org\apache\pulsar\sql\presto\decoder\json\TestJsonDecoder.java,232,80,5,58,0,143
 pulsar-master\pulsar-master\pulsar-broker\src\test\java\org\apache\pulsar\broker\transaction\pendingack\PendingAckInMemoryDeleteTest.java,232,60,7,48,0,115
 rocketmq-develop\rocketmq-develop\tools\src\main\java\org\apache\rocketmq\tools\command\export\ExportMetricsCommand.java,232,75,5,52,2,134
 skywalking-master\skywalking-master\oap-server\server-storage-plugin\storage-influxdb-plugin\src\main\java\org\apache\skywalking\oap\server\storage\plugin\influxdb\query\MetadataQuery.java,232,56,3,38,0,97
 zookeeper-master\zookeeper-master\zookeeper-server\src\main\java\org\apache\zookeeper\server\persistence\Util.java,232,0,11,15,2,28
 zookeeper-master\zookeeper-master\zookeeper-server\src\test\java\org\apache\zookeeper\test\AuthTest.java,232,0,32,18,0,50
 dubbo-3.0\dubbo-3.0\dubbo-common\src\main\java\org\apache\dubbo\rpc\model\ModuleServiceRepository.java,233,130,3,31,4,168
 hadoop-trunk\hadoop-trunk\hadoop-yarn-project\hadoop-yarn\hadoop-yarn-server\hadoop-yarn-server-nodemanager\src\test\java\org\apache\hadoop\yarn\server\nodemanager\containermanager\linux\resources\numa\TestNumaResourceAllocator.java,233,43,23,5,0,71
 hadoop-trunk\hadoop-trunk\hadoop-hdfs-project\hadoop-hdfs\src\main\java\org\apache\hadoop\hdfs\server\blockmanagement\BlockPlacementPolicy.java,233,68,1,2,0,71
 hadoop-trunk\hadoop-trunk\hadoop-mapreduce-project\hadoop-mapreduce-client\hadoop-mapreduce-client-jobclient\src\test\java\org\apache\hadoop\mapred\MiniMRCluster.java,233,164,15,1,1,181
 hadoop-trunk\hadoop-trunk\hadoop-mapreduce-project\hadoop-mapreduce-client\hadoop-mapreduce-client-nativetask\src\test\java\org\apache\hadoop\mapred\nativetask\buffer\TestBufferPushPull.java,233,64,7,7,13,91
 hadoop-trunk\hadoop-trunk\hadoop-common-project\hadoop-common\src\main\java\org\apache\hadoop\metrics2\source\JvmMetrics.java,233,67,5,13,2,87
 kafka-trunk\kafka-trunk\generator\src\test\java\org\apache\kafka\message\MessageDataGeneratorTest.java,233,0,0,41,0,41
 pulsar-master\pulsar-master\pulsar-broker-auth-sasl\src\test\java\org\apache\pulsar\broker\authentication\SaslAuthenticateTest.java,233,31,6,15,0,52
 pulsar-master\pulsar-master\pulsar-client-tools-test\src\test\java\org\apache\pulsar\client\cli\PulsarClientToolTest.java,233,64,16,36,0,116
 pulsar-master\pulsar-master\pulsar-broker\src\test\java\org\apache\pulsar\broker\transaction\buffer\TransactionBufferTest.java,233,49,2,13,0,64
 skywalking-master\skywalking-master\oap-server\server-core\src\test\java\org\apache\skywalking\oap\server\core\analysis\meter\function\avg\AvgHistogramFunctionTest.java,233,53,0,12,0,65
 hadoop-trunk\hadoop-trunk\hadoop-common-project\hadoop-common\src\test\java\org\apache\hadoop\fs\TestLocalFileSystemPermission.java,234,34,6,1,0,41
 hadoop-trunk\hadoop-trunk\hadoop-common-project\hadoop-common\src\test\java\org\apache\hadoop\util\TestInstrumentedLock.java,234,40,2,2,0,44
 hadoop-trunk\hadoop-trunk\hadoop-yarn-project\hadoop-yarn\hadoop-yarn-server\hadoop-yarn-server-web-proxy\src\test\java\org\apache\hadoop\yarn\server\webproxy\amfilter\TestAmFilterInitializer.java,234,19,8,1,0,28
 hadoop-trunk\hadoop-trunk\hadoop-hdfs-project\hadoop-hdfs\src\test\java\org\apache\hadoop\hdfs\TestFsShellPermission.java,234,64,5,2,1,72
 hadoop-trunk\hadoop-trunk\hadoop-yarn-project\hadoop-yarn\hadoop-yarn-server\hadoop-yarn-server-resourcemanager\src\main\java\org\apache\hadoop\yarn\server\resourcemanager\scheduler\fair\converter\FSConfigToCSConfigRuleHandler.java,234,68,4,3,3,78
 hadoop-trunk\hadoop-trunk\hadoop-hdfs-project\hadoop-hdfs\src\test\java\org\apache\hadoop\hdfs\TestCrcCorruption.java,234,99,9,5,2,115
 hadoop-trunk\hadoop-trunk\hadoop-yarn-project\hadoop-yarn\hadoop-yarn-server\hadoop-yarn-server-resourcemanager\src\test\java\org\apache\hadoop\yarn\server\resourcemanager\nodelabels\TestFileSystemNodeAttributeStore.java,234,16,1,1,0,18
 kafka-trunk\kafka-trunk\streams\src\test\java\org\apache\kafka\streams\state\StoresTest.java,234,0,0,46,10,56
 skywalking-master\skywalking-master\oap-server\server-cluster-plugin\cluster-consul-plugin\src\test\java\org\apache\skywalking\oap\server\cluster\plugin\consul\ITClusterModuleConsulProviderFunctionalTest.java,234,65,9,28,0,102
 zookeeper-master\zookeeper-master\zookeeper-server\src\test\java\org\apache\zookeeper\test\AsyncOpsTest.java,234,0,22,2,1,25
 dubbo-3.0\dubbo-3.0\dubbo-common\src\main\java\org\apache\dubbo\config\AbstractReferenceConfig.java,235,102,2,8,1,113
 dubbo-3.0\dubbo-3.0\dubbo-registry\dubbo-registry-multicast\src\test\java\org\apache\dubbo\registry\multicast\MulticastRegistryTest.java,235,50,8,26,0,84
 dubbo-3.0\dubbo-3.0\dubbo-common\src\main\java\org\apache\dubbo\common\url\component\URLAddress.java,235,108,6,8,0,122
 hadoop-trunk\hadoop-trunk\hadoop-yarn-project\hadoop-yarn\hadoop-yarn-server\hadoop-yarn-server-timelineservice\src\test\java\org\apache\hadoop\yarn\server\timelineservice\storage\TestFileSystemTimelineWriterImpl.java,235,38,9,3,2,52
 hadoop-trunk\hadoop-trunk\hadoop-yarn-project\hadoop-yarn\hadoop-yarn-server\hadoop-yarn-server-resourcemanager\src\main\java\org\apache\hadoop\yarn\server\resourcemanager\placement\VariableContext.java,235,16,1,2,0,19
 hadoop-trunk\hadoop-trunk\hadoop-cloud-storage-project\hadoop-cos\src\main\java\org\apache\hadoop\fs\cosn\CosNOutputStream.java,235,36,9,4,2,51
 hadoop-trunk\hadoop-trunk\hadoop-maven-plugins\src\main\java\org\apache\hadoop\maven\plugin\versioninfo\VersionInfoMojo.java,235,59,8,3,3,73
 hadoop-trunk\hadoop-trunk\hadoop-hdfs-project\hadoop-hdfs-httpfs\src\test\java\org\apache\hadoop\fs\http\server\TestHttpFSWithKerberos.java,235,16,6,2,13,37
 hadoop-trunk\hadoop-trunk\hadoop-hdfs-project\hadoop-hdfs\src\main\java\org\apache\hadoop\hdfs\server\blockmanagement\CorruptReplicasMap.java,235,61,8,1,4,74
 hadoop-trunk\hadoop-trunk\hadoop-yarn-project\hadoop-yarn\hadoop-yarn-applications\hadoop-yarn-services\hadoop-yarn-services-core\src\test\java\org\apache\hadoop\yarn\service\timelineservice\TestServiceTimelinePublisher.java,235,38,3,3,9,53
 hadoop-trunk\hadoop-trunk\hadoop-tools\hadoop-distcp\src\test\java\org\apache\hadoop\tools\TestDistCpWithXAttrs.java,235,107,1,3,0,111
 hadoop-trunk\hadoop-trunk\hadoop-tools\hadoop-aws\src\main\java\org\apache\hadoop\fs\s3a\S3ARetryPolicy.java,235,34,3,3,2,42
 hadoop-trunk\hadoop-trunk\hadoop-hdfs-project\hadoop-hdfs-rbf\src\test\java\org\apache\hadoop\hdfs\server\federation\store\records\TestMountTable.java,235,23,0,2,0,25
 hadoop-trunk\hadoop-trunk\hadoop-hdfs-project\hadoop-hdfs\src\main\java\org\apache\hadoop\hdfs\server\namenode\snapshot\Snapshot.java,235,69,0,6,1,76
 kafka-trunk\kafka-trunk\metadata\src\test\java\org\apache\kafka\controller\ConfigurationControlManagerTest.java,235,0,4,34,1,39
 kafka-trunk\kafka-trunk\clients\src\generated\java\org\apache\kafka\common\message\ApiVersionsRequestData.java,235,0,0,29,3,32
 pulsar-master\pulsar-master\pulsar-common\src\main\java\org\apache\pulsar\common\util\RateLimiter.java,235,76,2,34,0,112
 pulsar-master\pulsar-master\pulsar-broker\src\test\java\org\apache\pulsar\broker\BookKeeperClientFactoryImplTest.java,235,56,0,42,0,98
 pulsar-master\pulsar-master\pulsar-broker-auth-sasl\src\test\java\org\apache\pulsar\broker\authentication\ProxySaslAuthenticationTest.java,235,59,4,15,0,78
 rocketmq-develop\rocketmq-develop\client\src\main\java\org\apache\rocketmq\client\impl\ClientRemotingProcessor.java,235,75,7,49,0,131
 zookeeper-master\zookeeper-master\zookeeper-server\src\main\java\org\apache\zookeeper\server\persistence\FileSnap.java,235,0,8,14,2,24
 dubbo-3.0\dubbo-3.0\dubbo-remoting\dubbo-remoting-api\src\main\java\org\apache\dubbo\remoting\buffer\ByteBufferBackedChannelBuffer.java,236,68,3,10,1,82
 dubbo-3.0\dubbo-3.0\dubbo-plugin\dubbo-qos\src\main\java\org\apache\dubbo\qos\textui\TTree.java,236,68,2,7,0,77
 hadoop-trunk\hadoop-trunk\hadoop-hdfs-project\hadoop-hdfs\src\test\java\org\apache\hadoop\hdfs\server\namenode\TestFavoredNodesEndToEnd.java,236,83,8,3,4,98
 hadoop-trunk\hadoop-trunk\hadoop-hdfs-project\hadoop-hdfs\src\test\java\org\apache\hadoop\hdfs\server\blockmanagement\TestHeartbeatHandling.java,236,80,7,19,9,115
 hadoop-trunk\hadoop-trunk\hadoop-hdfs-project\hadoop-hdfs\src\test\java\org\apache\hadoop\hdfs\server\namenode\snapshot\TestOrderedSnapshotDeletion.java,236,37,3,3,0,43
 hadoop-trunk\hadoop-trunk\hadoop-hdfs-project\hadoop-hdfs\src\test\java\org\apache\hadoop\hdfs\TestApplyingStoragePolicy.java,236,14,12,1,19,46
 hadoop-trunk\hadoop-trunk\hadoop-mapreduce-project\hadoop-mapreduce-client\hadoop-mapreduce-client-app\src\test\java\org\apache\hadoop\mapreduce\v2\app\MRAppBenchmark.java,236,68,4,7,3,82
 hadoop-trunk\hadoop-trunk\hadoop-common-project\hadoop-common\src\main\java\org\apache\hadoop\fs\statistics\impl\IOStatisticsStore.java,236,0,0,1,0,1
 hadoop-trunk\hadoop-trunk\hadoop-hdfs-project\hadoop-hdfs-rbf\src\main\java\org\apache\hadoop\hdfs\server\federation\store\records\BaseRecord.java,236,10,0,1,0,11
 hadoop-trunk\hadoop-trunk\hadoop-mapreduce-project\hadoop-mapreduce-client\hadoop-mapreduce-client-core\src\main\java\org\apache\hadoop\mapreduce\util\CountersStrings.java,236,34,5,6,0,45
 hadoop-trunk\hadoop-trunk\hadoop-common-project\hadoop-common\src\main\java\org\apache\hadoop\io\erasurecode\rawcoder\RSLegacyRawDecoder.java,236,42,3,1,4,50
 kafka-trunk\kafka-trunk\clients\src\main\java\org\apache\kafka\common\requests\ProduceRequest.java,236,0,82,33,3,118
 pulsar-master\pulsar-master\pulsar-broker\src\test\java\org\apache\pulsar\broker\transaction\buffer\TransactionBufferClientTest.java,236,69,3,45,0,117
 pulsar-master\pulsar-master\pulsar-io\elastic-search\src\test\java\org\apache\pulsar\io\elasticsearch\ElasticSearchExtractTests.java,236,58,7,48,0,113
 pulsar-master\pulsar-master\pulsar-broker\src\test\java\org\apache\pulsar\broker\intercept\MangedLedgerInterceptorImplTest.java,236,90,7,47,0,144
 rocketmq-develop\rocketmq-develop\common\src\main\java\org\apache\rocketmq\common\message\MessageExt.java,236,153,1,14,0,168
 dubbo-3.0\dubbo-3.0\dubbo-rpc\dubbo-rpc-rest\src\main\java\org\apache\dubbo\rpc\protocol\rest\RestProtocol.java,237,71,5,37,0,113
 dubbo-3.0\dubbo-3.0\dubbo-cluster\src\test\java\org\apache\dubbo\rpc\cluster\router\mesh\route\MeshRuleManagerTest.java,237,92,14,33,0,139
 hadoop-trunk\hadoop-trunk\hadoop-hdfs-project\hadoop-hdfs\src\main\java\org\apache\hadoop\hdfs\tools\DFSZKFailoverController.java,237,41,12,7,0,60
 hadoop-trunk\hadoop-trunk\hadoop-hdfs-project\hadoop-hdfs-rbf\src\main\java\org\apache\hadoop\hdfs\protocolPB\RouterAdminProtocolServerSideTranslatorPB.java,237,44,67,77,0,188
 hadoop-trunk\hadoop-trunk\hadoop-yarn-project\hadoop-yarn\hadoop-yarn-client\src\test\java\org\apache\hadoop\yarn\client\TestFederationRMFailoverProxyProvider.java,237,26,1,7,8,42
 hadoop-trunk\hadoop-trunk\hadoop-yarn-project\hadoop-yarn\hadoop-yarn-server\hadoop-yarn-server-common\src\main\java\org\apache\hadoop\yarn\server\webapp\dao\AppInfo.java,237,125,0,2,0,127
 hadoop-trunk\hadoop-trunk\hadoop-hdfs-project\hadoop-hdfs\src\main\java\org\apache\hadoop\hdfs\server\common\StorageInfo.java,237,113,4,3,0,120
 hadoop-trunk\hadoop-trunk\hadoop-mapreduce-project\hadoop-mapreduce-client\hadoop-mapreduce-client-hs\src\test\java\org\apache\hadoop\mapreduce\v2\hs\webapp\TestHsWebServices.java,237,30,0,2,0,32
 hadoop-trunk\hadoop-trunk\hadoop-common-project\hadoop-common\src\test\java\org\apache\hadoop\fs\shell\find\TestAnd.java,237,14,2,1,1,18
 hadoop-trunk\hadoop-trunk\hadoop-yarn-project\hadoop-yarn\hadoop-yarn-server\hadoop-yarn-server-resourcemanager\src\main\java\org\apache\hadoop\yarn\server\resourcemanager\security\NMTokenSecretManagerInRM.java,237,51,9,2,4,66
 hadoop-trunk\hadoop-trunk\hadoop-tools\hadoop-aws\src\main\java\org\apache\hadoop\fs\s3a\auth\delegation\AbstractDelegationTokenBinding.java,237,13,2,4,1,20
 pulsar-master\pulsar-master\pulsar-transaction\coordinator\src\main\java\org\apache\pulsar\transaction\coordinator\impl\MLTransactionLogImpl.java,237,100,1,37,0,138
 pulsar-master\pulsar-master\pulsar-broker\src\main\java\org\apache\pulsar\broker\service\persistent\SubscribeRateLimiter.java,237,90,1,34,0,125
 rocketmq-develop\rocketmq-develop\broker\src\main\java\org\apache\rocketmq\broker\plugin\AbstractPluginMessageStore.java,237,119,0,16,2,137
 rocketmq-develop\rocketmq-develop\acl\src\test\java\org\apache\rocketmq\acl\plain\PlainPermissionManagerTest.java,237,91,3,40,8,142
 skywalking-master\skywalking-master\oap-server\server-configuration\configuration-api\src\main\java\org\apache\skywalking\oap\server\configuration\api\ConfigWatcherRegister.java,237,70,7,41,1,119
 zookeeper-master\zookeeper-master\zookeeper-server\src\test\java\org\apache\zookeeper\server\quorum\EagerACLFilterTest.java,237,0,26,47,11,84
 zookeeper-master\zookeeper-master\zookeeper-server\src\test\java\org\apache\zookeeper\test\X509AuthTest.java,237,0,19,17,19,55
 hadoop-trunk\hadoop-trunk\hadoop-hdfs-project\hadoop-hdfs\src\test\java\org\apache\hadoop\hdfs\TestSnapshotCommands.java,238,67,4,20,0,91
 hadoop-trunk\hadoop-trunk\hadoop-tools\hadoop-aws\src\main\java\org\apache\hadoop\fs\s3a\audit\AWSRequestAnalyzer.java,238,9,0,14,0,23
 hadoop-trunk\hadoop-trunk\hadoop-mapreduce-project\hadoop-mapreduce-client\hadoop-mapreduce-client-jobclient\src\test\java\org\apache\hadoop\mapred\TestBadRecords.java,238,165,13,1,6,185
 hadoop-trunk\hadoop-trunk\hadoop-hdfs-project\hadoop-hdfs\src\test\java\org\apache\hadoop\hdfs\server\blockmanagement\TestBlockStatsMXBean.java,238,65,4,2,5,76
 hadoop-trunk\hadoop-trunk\hadoop-yarn-project\hadoop-yarn\hadoop-yarn-server\hadoop-yarn-server-nodemanager\src\test\java\org\apache\hadoop\yarn\server\nodemanager\TestContainerExecutor.java,238,67,17,15,3,102
 hadoop-trunk\hadoop-trunk\hadoop-yarn-project\hadoop-yarn\hadoop-yarn-server\hadoop-yarn-server-nodemanager\src\main\java\org\apache\hadoop\yarn\server\nodemanager\containermanager\linux\resources\fpga\FpgaResourceAllocator.java,238,58,4,13,10,85
 kafka-trunk\kafka-trunk\connect\mirror\src\main\java\org\apache\kafka\connect\mirror\MirrorMakerConfig.java,238,0,0,48,1,49
 kafka-trunk\kafka-trunk\clients\src\generated\java\org\apache\kafka\common\message\DeleteGroupsRequestData.java,238,0,0,26,3,29
 kafka-trunk\kafka-trunk\connect\transforms\src\main\java\org\apache\kafka\connect\transforms\InsertField.java,238,0,7,39,0,46
 pulsar-master\pulsar-master\pulsar-sql\presto-pulsar\src\test\java\org\apache\pulsar\sql\presto\decoder\avro\TestAvroDecoder.java,238,83,4,63,0,150
 pulsar-master\pulsar-master\pulsar-common\src\main\java\org\apache\pulsar\common\policies\data\stats\TopicStatsImpl.java,238,65,0,18,0,83
 rocketmq-develop\rocketmq-develop\client\src\test\java\org\apache\rocketmq\client\trace\TraceDataEncoderTest.java,238,50,1,25,0,76
 rocketmq-develop\rocketmq-develop\broker\src\main\java\org\apache\rocketmq\broker\client\rebalance\RebalanceLockManager.java,238,49,4,27,2,82
 rocketmq-develop\rocketmq-develop\store\src\main\java\org\apache\rocketmq\store\index\IndexFile.java,238,88,14,29,6,137
 skywalking-master\skywalking-master\oap-server\server-storage-plugin\storage-elasticsearch-plugin\src\test\java\org\apache\skywalking\oap\server\storage\plugin\elasticsearch\base\MockEsInstallTest.java,238,66,0,38,0,104
 skywalking-master\skywalking-master\oap-server\server-storage-plugin\storage-jdbc-hikaricp-plugin\src\main\java\org\apache\skywalking\oap\server\storage\plugin\jdbc\h2\dao\H2TopologyQueryDAO.java,238,125,1,66,0,192
 zookeeper-master\zookeeper-master\zookeeper-server\src\main\java\org\apache\zookeeper\server\ZooKeeperServerMain.java,238,0,3,21,0,24
 zookeeper-master\zookeeper-master\zookeeper-server\src\main\java\org\apache\zookeeper\util\CircularBlockingQueue.java,238,0,0,3,0,3
 dubbo-3.0\dubbo-3.0\dubbo-cluster\src\main\java\org\apache\dubbo\rpc\cluster\router\tag\TagStateRouter.java,239,95,1,48,0,144
 dubbo-3.0\dubbo-3.0\dubbo-compatible\src\test\java\org\apache\dubbo\generic\GenericServiceTest.java,239,110,2,64,0,176
 hadoop-trunk\hadoop-trunk\hadoop-hdfs-project\hadoop-hdfs-client\src\main\java\org\apache\hadoop\hdfs\protocol\BlockStoragePolicy.java,239,61,2,1,6,70
 hadoop-trunk\hadoop-trunk\hadoop-yarn-project\hadoop-yarn\hadoop-yarn-server\hadoop-yarn-server-resourcemanager\src\test\java\org\apache\hadoop\yarn\server\resourcemanager\scheduler\capacity\TestQueueState.java,239,33,1,3,7,44
 hadoop-trunk\hadoop-trunk\hadoop-hdfs-project\hadoop-hdfs\src\main\java\org\apache\hadoop\hdfs\server\datanode\fsdataset\impl\RamDiskReplicaTracker.java,239,70,11,2,1,84
 hadoop-trunk\hadoop-trunk\hadoop-hdfs-project\hadoop-hdfs\src\test\java\org\apache\hadoop\hdfs\TestDFSInputStream.java,239,59,7,2,13,81
 hadoop-trunk\hadoop-trunk\hadoop-yarn-project\hadoop-yarn\hadoop-yarn-applications\hadoop-yarn-services\hadoop-yarn-services-core\src\main\java\org\apache\hadoop\yarn\service\api\records\PlacementConstraint.java,239,95,2,1,9,107
 hadoop-trunk\hadoop-trunk\hadoop-mapreduce-project\hadoop-mapreduce-client\hadoop-mapreduce-client-core\src\main\java\org\apache\hadoop\mapreduce\jobhistory\MapAttemptFinishedEvent.java,239,123,42,1,0,166
 kafka-trunk\kafka-trunk\streams\src\test\java\org\apache\kafka\streams\processor\internals\RepartitionWithMergeOptimizingTest.java,239,0,3,119,0,122
 pulsar-master\pulsar-master\pulsar-broker-common\src\main\java\org\apache\pulsar\broker\resources\NamespaceResources.java,239,206,2,68,0,276
 pulsar-master\pulsar-master\pulsar-io\kafka-connect-adaptor\src\main\java\org\apache\pulsar\io\kafka\connect\AbstractKafkaConnectSource.java,239,81,6,32,0,119
 rocketmq-develop\rocketmq-develop\filter\src\main\java\org\apache\rocketmq\filter\util\BitsArray.java,239,59,1,5,1,66
 dubbo-3.0\dubbo-3.0\dubbo-cluster\src\test\java\org\apache\dubbo\rpc\cluster\support\FailbackClusterInvokerTest.java,240,93,8,40,0,141
 dubbo-3.0\dubbo-3.0\dubbo-rpc\dubbo-rpc-api\src\main\java\org\apache\dubbo\rpc\protocol\AbstractProxyProtocol.java,240,68,12,15,2,97
 hadoop-trunk\hadoop-trunk\hadoop-mapreduce-project\hadoop-mapreduce-client\hadoop-mapreduce-client-jobclient\src\test\java\org\apache\hadoop\mapreduce\security\TestBinaryTokenFile.java,240,73,3,22,2,100
 hadoop-trunk\hadoop-trunk\hadoop-common-project\hadoop-common\src\test\java\org\apache\hadoop\http\HttpServerFunctionalTest.java,240,61,3,5,1,70
 hadoop-trunk\hadoop-trunk\hadoop-tools\hadoop-azure\src\main\java\org\apache\hadoop\fs\azure\LocalSASKeyGeneratorImpl.java,240,22,0,4,1,27
 hadoop-trunk\hadoop-trunk\hadoop-common-project\hadoop-common\src\test\java\org\apache\hadoop\security\alias\TestCredentialProviderFactory.java,240,48,7,11,5,71
 hadoop-trunk\hadoop-trunk\hadoop-hdfs-project\hadoop-hdfs\src\test\java\org\apache\hadoop\hdfs\tools\TestViewFileSystemOverloadSchemeWithDFSAdmin.java,240,27,4,1,3,35
 hadoop-trunk\hadoop-trunk\hadoop-tools\hadoop-rumen\src\main\java\org\apache\hadoop\tools\rumen\Job20LineHistoryEventEmitter.java,240,40,2,2,0,44
 hadoop-trunk\hadoop-trunk\hadoop-hdfs-project\hadoop-hdfs\src\main\java\org\apache\hadoop\hdfs\NameNodeProxies.java,240,85,2,14,0,101
 kafka-trunk\kafka-trunk\streams\src\test\java\org\apache\kafka\streams\processor\internals\metrics\TaskMetricsTest.java,240,0,0,51,0,51
 kafka-trunk\kafka-trunk\trogdor\src\main\java\org\apache\kafka\trogdor\rest\JsonRestServer.java,240,0,7,41,1,49
 pulsar-master\pulsar-master\pulsar-io\elastic-search\src\test\java\org\apache\pulsar\io\elasticsearch\ElasticSearchConfigTests.java,240,53,0,15,0,68
 pulsar-master\pulsar-master\managed-ledger\src\test\java\org\apache\bookkeeper\mledger\util\RangeCacheTest.java,240,72,3,8,0,83
 pulsar-master\pulsar-master\pulsar-broker\src\test\java\org\apache\pulsar\broker\admin\MockServletContext.java,240,89,16,11,0,116
 zookeeper-master\zookeeper-master\zookeeper-server\src\test\java\org\apache\zookeeper\server\quorum\ReconfigDuringLeaderSyncTest.java,240,0,8,21,2,31
 hadoop-trunk\hadoop-trunk\hadoop-yarn-project\hadoop-yarn\hadoop-yarn-server\hadoop-yarn-server-resourcemanager\src\test\java\org\apache\hadoop\yarn\server\resourcemanager\placement\csmappingrule\TestMappingRuleValidationContextImpl.java,241,15,4,3,0,22
 hadoop-trunk\hadoop-trunk\hadoop-yarn-project\hadoop-yarn\hadoop-yarn-server\hadoop-yarn-server-resourcemanager\src\test\java\org\apache\hadoop\yarn\server\resourcemanager\scheduler\capacity\TestCSMaxRunningAppsEnforcer.java,241,33,1,8,1,43
 hadoop-trunk\hadoop-trunk\hadoop-common-project\hadoop-common\src\test\java\org\apache\hadoop\io\file\tfile\RandomDistribution.java,241,58,9,1,3,71
 hadoop-trunk\hadoop-trunk\hadoop-hdfs-project\hadoop-hdfs\src\main\java\org\apache\hadoop\hdfs\tools\offlineImageViewer\OfflineImageViewer.java,241,65,9,21,0,95
 hadoop-trunk\hadoop-trunk\hadoop-mapreduce-project\hadoop-mapreduce-client\hadoop-mapreduce-client-jobclient\src\test\java\org\apache\hadoop\mapreduce\v2\MiniMRYarnCluster.java,241,46,11,5,1,63
 hadoop-trunk\hadoop-trunk\hadoop-common-project\hadoop-nfs\src\test\java\org\apache\hadoop\oncrpc\TestFrameDecoder.java,241,87,6,8,2,103
 hadoop-trunk\hadoop-trunk\hadoop-yarn-project\hadoop-yarn\hadoop-yarn-server\hadoop-yarn-server-nodemanager\src\main\java\org\apache\hadoop\yarn\server\nodemanager\health\NodeHealthScriptRunner.java,241,27,2,1,0,30
 hadoop-trunk\hadoop-trunk\hadoop-tools\hadoop-openstack\src\test\java\org\apache\hadoop\fs\swift\TestSwiftFileSystemRename.java,241,24,9,1,4,38
 hadoop-trunk\hadoop-trunk\hadoop-mapreduce-project\hadoop-mapreduce-client\hadoop-mapreduce-client-jobclient\src\test\java\org\apache\hadoop\mapred\ThreadedMapBenchmark.java,241,134,18,2,0,154
 hadoop-trunk\hadoop-trunk\hadoop-yarn-project\hadoop-yarn\hadoop-yarn-server\hadoop-yarn-server-resourcemanager\src\main\java\org\apache\hadoop\yarn\server\resourcemanager\scheduler\fair\FSSchedulerNode.java,241,55,5,2,2,64
 hadoop-trunk\hadoop-trunk\hadoop-yarn-project\hadoop-yarn\hadoop-yarn-server\hadoop-yarn-server-nodemanager\src\test\java\org\apache\hadoop\yarn\server\nodemanager\containermanager\linux\resources\TestCGroupsResourceCalculator.java,241,40,1,2,0,43
 kafka-trunk\kafka-trunk\metadata\src\test\java\org\apache\kafka\controller\StripedReplicaPlacerTest.java,241,0,1,20,0,21
 kafka-trunk\kafka-trunk\streams\src\main\java\org\apache\kafka\streams\processor\internals\RepartitionTopics.java,241,0,1,76,2,79
 kafka-trunk\kafka-trunk\clients\src\generated\java\org\apache\kafka\common\message\ProduceResponseDataJsonConverter.java,241,0,0,59,0,59
 zookeeper-master\zookeeper-master\zookeeper-it\src\main\java\org\apache\zookeeper\test\system\BaseSysTest.java,241,0,10,13,8,31
 dubbo-3.0\dubbo-3.0\dubbo-common\src\main\java\org\apache\dubbo\common\threadpool\MemoryLimiter.java,242,51,0,3,1,55
 hadoop-trunk\hadoop-trunk\hadoop-hdfs-project\hadoop-hdfs\src\main\java\org\apache\hadoop\hdfs\server\diskbalancer\datamodel\DiskBalancerDataNode.java,242,17,4,1,1,23
 hadoop-trunk\hadoop-trunk\hadoop-yarn-project\hadoop-yarn\hadoop-yarn-common\src\main\java\org\apache\hadoop\yarn\api\records\impl\pb\QueueConfigurationsPBImpl.java,242,53,77,2,0,132
 hadoop-trunk\hadoop-trunk\hadoop-yarn-project\hadoop-yarn\hadoop-yarn-client\src\main\java\org\apache\hadoop\yarn\client\api\NMClient.java,242,21,3,1,2,27
 hadoop-trunk\hadoop-trunk\hadoop-common-project\hadoop-common\src\test\java\org\apache\hadoop\ha\TestActiveStandbyElectorRealZK.java,242,68,1,1,4,74
 hadoop-trunk\hadoop-trunk\hadoop-hdfs-project\hadoop-hdfs-client\src\main\java\org\apache\hadoop\hdfs\protocol\LocatedBlock.java,242,92,1,2,10,105
 hadoop-trunk\hadoop-trunk\hadoop-hdfs-project\hadoop-hdfs\src\test\java\org\apache\hadoop\hdfs\TestHdfsAdmin.java,242,39,10,1,0,50
 hadoop-trunk\hadoop-trunk\hadoop-hdfs-project\hadoop-hdfs-rbf\src\test\java\org\apache\hadoop\hdfs\server\federation\router\TestRouterTrash.java,242,33,2,2,1,38
 hadoop-trunk\hadoop-trunk\hadoop-yarn-project\hadoop-yarn\hadoop-yarn-common\src\main\java\org\apache\hadoop\yarn\util\WindowsBasedProcessTree.java,242,34,3,3,1,41
 kafka-trunk\kafka-trunk\streams\src\test\java\org\apache\kafka\streams\state\internals\WindowStoreFetchTest.java,242,0,22,32,7,61
 pulsar-master\pulsar-master\tests\integration\src\test\java\org\apache\pulsar\tests\integration\semantics\SemanticsTest.java,242,53,1,25,0,79
 pulsar-master\pulsar-master\pulsar-broker\src\main\java\org\apache\pulsar\broker\web\WebService.java,242,72,6,32,0,110
 pulsar-master\pulsar-master\pulsar-common\src\main\java\org\apache\pulsar\common\sasl\TGTRefreshThread.java,242,71,12,49,0,132
 rocketmq-develop\rocketmq-develop\tools\src\main\java\org\apache\rocketmq\tools\command\cluster\ClusterListSubCommand.java,242,58,2,46,9,115
 skywalking-master\skywalking-master\oap-server\server-alarm-plugin\src\main\java\org\apache\skywalking\oap\server\core\alarm\provider\RulesReader.java,242,64,0,36,0,100
 hadoop-trunk\hadoop-trunk\hadoop-maven-plugins\src\main\java\org\apache\hadoop\maven\plugin\protoc\ProtocRunner.java,243,41,2,1,0,44
 hadoop-trunk\hadoop-trunk\hadoop-common-project\hadoop-common\src\main\java\org\apache\hadoop\fs\shell\find\FindOptions.java,243,23,0,1,8,32
 hadoop-trunk\hadoop-trunk\hadoop-yarn-project\hadoop-yarn\hadoop-yarn-server\hadoop-yarn-server-common\src\main\java\org\apache\hadoop\yarn\server\federation\store\impl\MemoryFederationStateStore.java,243,38,2,35,0,75
 hadoop-trunk\hadoop-trunk\hadoop-yarn-project\hadoop-yarn\hadoop-yarn-api\src\main\java\org\apache\hadoop\yarn\api\records\ApplicationResourceUsageReport.java,243,24,6,3,0,33
 hadoop-trunk\hadoop-trunk\hadoop-common-project\hadoop-common\src\main\java\org\apache\hadoop\fs\permission\AclStatus.java,243,45,2,2,3,52
 hadoop-trunk\hadoop-trunk\hadoop-hdfs-project\hadoop-hdfs\src\main\java\org\apache\hadoop\hdfs\server\blockmanagement\SlowPeerTracker.java,243,37,3,1,1,42
 hadoop-trunk\hadoop-trunk\hadoop-mapreduce-project\hadoop-mapreduce-client\hadoop-mapreduce-client-nativetask\src\main\java\org\apache\hadoop\mapred\nativetask\NativeBatchProcessor.java,243,61,8,2,3,74
 hadoop-trunk\hadoop-trunk\hadoop-mapreduce-project\hadoop-mapreduce-client\hadoop-mapreduce-client-core\src\main\java\org\apache\hadoop\mapreduce\jobhistory\ReduceAttemptFinishedEvent.java,243,131,44,1,0,176
 hadoop-trunk\hadoop-trunk\hadoop-common-project\hadoop-common\src\main\java\org\apache\hadoop\net\ScriptBasedMapping.java,243,43,12,4,1,60
 hadoop-trunk\hadoop-trunk\hadoop-hdfs-project\hadoop-hdfs\src\test\java\org\apache\hadoop\hdfs\server\blockmanagement\TestBlockInfoStriped.java,243,32,47,1,2,82
 kafka-trunk\kafka-trunk\trogdor\src\test\java\org\apache\kafka\trogdor\common\MiniTrogdorCluster.java,243,0,21,20,2,43
 kafka-trunk\kafka-trunk\clients\src\main\java\org\apache\kafka\common\requests\DescribeConfigsResponse.java,243,0,19,40,4,63
 kafka-trunk\kafka-trunk\clients\src\main\java\org\apache\kafka\common\requests\AbstractResponse.java,243,0,3,33,0,36
 pulsar-master\pulsar-master\tiered-storage\jcloud\src\test\java\org\apache\bookkeeper\mledger\offload\jcloud\BlobStoreBackedInputStreamTest.java,243,116,3,28,0,147
 pulsar-master\pulsar-master\pulsar-io\elastic-search\src\main\java\org\apache\pulsar\io\elasticsearch\ElasticSearchSink.java,243,60,6,26,0,92
 pulsar-master\pulsar-master\pulsar-broker\src\test\java\org\apache\pulsar\broker\admin\AdminApiSchemaAutoUpdateTest.java,243,127,1,55,0,183
 rocketmq-develop\rocketmq-develop\filter\src\main\java\org\apache\rocketmq\filter\expression\UnaryExpression.java,243,49,7,6,5,67
 dubbo-3.0\dubbo-3.0\dubbo-common\src\test\java\org\apache\dubbo\common\url\URLParamTest.java,244,42,0,28,0,70
 hadoop-trunk\hadoop-trunk\hadoop-hdfs-project\hadoop-hdfs-client\src\main\java\org\apache\hadoop\hdfs\PeerCache.java,244,47,3,2,0,52
 hadoop-trunk\hadoop-trunk\hadoop-yarn-project\hadoop-yarn\hadoop-yarn-common\src\main\java\org\apache\hadoop\yarn\logaggregation\filecontroller\LogAggregationHtmlBlock.java,244,70,2,2,6,80
 hadoop-trunk\hadoop-trunk\hadoop-hdfs-project\hadoop-hdfs\src\test\java\org\apache\hadoop\hdfs\TestReplaceDatanodeFailureReplication.java,244,29,11,2,3,45
 hadoop-trunk\hadoop-trunk\hadoop-tools\hadoop-azure\src\test\java\org\apache\hadoop\fs\azurebfs\ITestAbfsStatistics.java,244,10,1,3,0,14
 hadoop-trunk\hadoop-trunk\hadoop-hdfs-project\hadoop-hdfs\src\main\java\org\apache\hadoop\hdfs\protocolPB\DatanodeProtocolServerSideTranslatorPB.java,244,60,80,26,0,166
 hadoop-trunk\hadoop-trunk\hadoop-mapreduce-project\hadoop-mapreduce-client\hadoop-mapreduce-client-app\src\test\java\org\apache\hadoop\mapreduce\v2\app\TestMRClientService.java,244,32,6,11,1,50
 hadoop-trunk\hadoop-trunk\hadoop-tools\hadoop-azure\src\main\java\org\apache\hadoop\fs\azure\WasbRemoteCallHelper.java,244,30,9,4,2,45
 hadoop-trunk\hadoop-trunk\hadoop-hdfs-project\hadoop-hdfs-client\src\main\java\org\apache\hadoop\hdfs\protocol\datatransfer\Sender.java,244,30,76,15,2,123
 hadoop-trunk\hadoop-trunk\hadoop-tools\hadoop-sls\src\main\java\org\apache\hadoop\yarn\sls\AMRunner.java,244,79,11,6,6,102
 kafka-trunk\kafka-trunk\streams\src\test\java\org\apache\kafka\streams\tests\SmokeTestClient.java,244,0,11,32,0,43
 zookeeper-master\zookeeper-master\zookeeper-server\src\main\java\org\apache\zookeeper\common\ZKConfig.java,244,0,3,29,0,32
 dubbo-3.0\dubbo-3.0\dubbo-common\src\test\java\org\apache\dubbo\common\utils\ConfigUtilsTest.java,245,67,4,35,2,108
 hadoop-trunk\hadoop-trunk\hadoop-common-project\hadoop-common\src\test\java\org\apache\hadoop\fs\TestFileSystemTokens.java,245,51,2,7,0,60
 hadoop-trunk\hadoop-trunk\hadoop-hdfs-project\hadoop-hdfs\src\test\java\org\apache\hadoop\hdfs\TestRollingUpgradeRollback.java,245,29,1,2,0,32
 hadoop-trunk\hadoop-trunk\hadoop-mapreduce-project\hadoop-mapreduce-examples\src\main\java\org\apache\hadoop\examples\terasort\TeraGen.java,245,93,5,1,3,102
 hadoop-trunk\hadoop-trunk\hadoop-mapreduce-project\hadoop-mapreduce-client\hadoop-mapreduce-client-core\src\main\java\org\apache\hadoop\mapreduce\lib\output\committer\manifest\impl\ManifestStoreOperations.java,245,16,2,6,0,24
 hadoop-trunk\hadoop-trunk\hadoop-yarn-project\hadoop-yarn\hadoop-yarn-server\hadoop-yarn-server-nodemanager\src\main\java\org\apache\hadoop\yarn\server\nodemanager\containermanager\linux\runtime\DefaultLinuxContainerRuntime.java,245,33,7,12,2,54
 hadoop-trunk\hadoop-trunk\hadoop-hdfs-project\hadoop-hdfs\src\test\java\org\apache\hadoop\hdfs\server\datanode\TestDataNodeMXBean.java,245,47,28,3,6,84
 hadoop-trunk\hadoop-trunk\hadoop-tools\hadoop-openstack\src\main\java\org\apache\hadoop\fs\swift\http\SwiftProtocolConstants.java,245,78,0,6,0,84
 pulsar-master\pulsar-master\pulsar-functions\worker\src\main\java\org\apache\pulsar\functions\worker\rest\api\v3\SourcesApiV3Resource.java,245,126,1,56,0,183
 rocketmq-develop\rocketmq-develop\broker\src\test\java\org\apache\rocketmq\broker\filter\ConsumerFilterManagerTest.java,245,62,6,15,0,83
 rocketmq-develop\rocketmq-develop\tools\src\main\java\org\apache\rocketmq\tools\command\message\QueryMsgByIdSubCommand.java,245,29,1,18,5,53
 dubbo-3.0\dubbo-3.0\dubbo-rpc\dubbo-rpc-api\src\main\java\org\apache\dubbo\rpc\TriRpcStatus.java,246,104,1,8,0,113
 hadoop-trunk\hadoop-trunk\hadoop-hdfs-project\hadoop-hdfs\src\test\java\org\apache\hadoop\hdfs\MiniDFSNNTopology.java,246,88,4,4,2,98
 hadoop-trunk\hadoop-trunk\hadoop-mapreduce-project\hadoop-mapreduce-client\hadoop-mapreduce-client-jobclient\src\test\java\org\apache\hadoop\mapred\jobcontrol\TestJobControl.java,246,87,24,13,6,130
 hadoop-trunk\hadoop-trunk\hadoop-common-project\hadoop-common\src\test\java\org\apache\hadoop\crypto\key\TestKeyProvider.java,246,68,12,2,0,82
 hadoop-trunk\hadoop-trunk\hadoop-hdfs-project\hadoop-hdfs\src\test\java\org\apache\hadoop\hdfs\TestByteBufferPread.java,246,24,0,1,1,26
 hadoop-trunk\hadoop-trunk\hadoop-hdfs-project\hadoop-hdfs\src\main\java\org\apache\hadoop\hdfs\server\namenode\EditLogFileOutputStream.java,246,46,2,3,2,53
 hadoop-trunk\hadoop-trunk\hadoop-yarn-project\hadoop-yarn\hadoop-yarn-common\src\test\java\org\apache\hadoop\yarn\logaggregation\filecontroller\TestLogAggregationFileControllerFactory.java,246,48,3,6,7,64
 hadoop-trunk\hadoop-trunk\hadoop-common-project\hadoop-common\src\main\java\org\apache\hadoop\io\BloomMapFile.java,246,148,30,5,1,184
 kafka-trunk\kafka-trunk\streams\src\test\java\org\apache\kafka\streams\integration\HighAvailabilityTaskAssignorIntegrationTest.java,246,0,5,60,1,66
 pulsar-master\pulsar-master\pulsar-common\src\test\java\org\apache\pulsar\common\util\collections\GrowableArrayBlockingQueueTest.java,246,56,3,1,0,60
 pulsar-master\pulsar-master\pulsar-broker\src\test\java\org\apache\pulsar\broker\auth\MockAuthorizationProvider.java,246,216,3,59,0,278
 dubbo-3.0\dubbo-3.0\dubbo-common\src\test\java\org\apache\dubbo\common\threadlocal\InternalThreadLocalTest.java,247,63,16,36,7,122
 dubbo-3.0\dubbo-3.0\dubbo-config\dubbo-config-spring\src\test\java\org\apache\dubbo\config\spring\schema\DubboNamespaceHandlerTest.java,247,88,4,59,0,151
 dubbo-3.0\dubbo-3.0\dubbo-rpc\dubbo-rpc-api\src\main\java\org\apache\dubbo\rpc\RpcContextAttachment.java,247,38,3,4,5,50
 dubbo-3.0\dubbo-3.0\dubbo-common\src\test\java\org\apache\dubbo\common\extension\ExtensionDirectorTest.java,247,88,1,72,3,164
 hadoop-trunk\hadoop-trunk\hadoop-hdfs-project\hadoop-hdfs\src\test\java\org\apache\hadoop\hdfs\server\blockmanagement\TestComputeInvalidateWork.java,247,66,9,1,5,81
 hadoop-trunk\hadoop-trunk\hadoop-hdfs-project\hadoop-hdfs\src\main\java\org\apache\hadoop\hdfs\server\namenode\sps\StoragePolicySatisfyManager.java,247,16,1,1,1,19
 hadoop-trunk\hadoop-trunk\hadoop-tools\hadoop-aws\src\main\java\org\apache\hadoop\fs\s3a\commit\magic\MagicS3GuardCommitter.java,247,25,9,3,1,38
 hadoop-trunk\hadoop-trunk\hadoop-common-project\hadoop-registry\src\main\java\org\apache\hadoop\registry\client\binding\RegistryTypeUtils.java,247,50,5,4,0,59
 hadoop-trunk\hadoop-trunk\hadoop-hdfs-project\hadoop-hdfs-rbf\src\main\java\org\apache\hadoop\hdfs\server\federation\router\MountTableRefresherService.java,247,24,3,3,1,31
 hadoop-trunk\hadoop-trunk\hadoop-common-project\hadoop-common\src\test\java\org\apache\hadoop\conf\TestStorageUnit.java,247,173,0,1,0,174
 hadoop-trunk\hadoop-trunk\hadoop-tools\hadoop-azure\src\test\java\org\apache\hadoop\fs\azurebfs\contract\ITestAbfsFileSystemContractSeek.java,247,40,1,12,0,53
 hadoop-trunk\hadoop-trunk\hadoop-hdfs-project\hadoop-hdfs-client\src\test\java\org\apache\hadoop\hdfs\client\impl\TestLeaseRenewer.java,247,28,8,1,6,43
 kafka-trunk\kafka-trunk\raft\src\main\java\org\apache\kafka\raft\CandidateState.java,247,0,1,22,0,23
 kafka-trunk\kafka-trunk\streams\src\test\java\org\apache\kafka\streams\processor\internals\assignment\LegacySubscriptionInfoSerde.java,247,0,0,23,4,27
 pulsar-master\pulsar-master\pulsar-metadata\src\test\java\org\apache\pulsar\metadata\LeaderElectionTest.java,247,66,9,40,0,115
 rocketmq-develop\rocketmq-develop\broker\src\main\java\org\apache\rocketmq\broker\client\net\Broker2Client.java,247,91,8,57,2,158
 skywalking-master\skywalking-master\oap-server\analyzer\meter-analyzer\src\test\java\org\apache\skywalking\oap\meter\analyzer\dsl\K8sTagTest.java,247,53,1,28,0,82
 dubbo-3.0\dubbo-3.0\dubbo-rpc\dubbo-rpc-api\src\main\java\org\apache\dubbo\rpc\protocol\AbstractInvoker.java,248,90,5,32,2,129
 hadoop-trunk\hadoop-trunk\hadoop-yarn-project\hadoop-yarn\hadoop-yarn-client\src\test\java\org\apache\hadoop\yarn\client\api\impl\TestAMRMClientContainerRequest.java,248,52,5,1,0,58
 hadoop-trunk\hadoop-trunk\hadoop-hdfs-project\hadoop-hdfs\src\test\java\org\apache\hadoop\hdfs\TestMultiThreadedHflush.java,248,66,5,3,0,74
 hadoop-trunk\hadoop-trunk\hadoop-mapreduce-project\hadoop-mapreduce-client\hadoop-mapreduce-client-common\src\test\java\org\apache\hadoop\mapred\TestMRWithDistributedCache.java,248,38,56,2,5,101
 hadoop-trunk\hadoop-trunk\hadoop-common-project\hadoop-common\src\test\java\org\apache\hadoop\metrics2\impl\TestSinkQueue.java,248,38,9,1,3,51
 hadoop-trunk\hadoop-trunk\hadoop-mapreduce-project\hadoop-mapreduce-client\hadoop-mapreduce-client-core\src\test\java\org\apache\hadoop\mapreduce\lib\output\committer\manifest\TestCreateOutputDirectoriesStage.java,248,22,3,21,2,48
 hadoop-trunk\hadoop-trunk\hadoop-common-project\hadoop-common\src\main\java\org\apache\hadoop\util\InstrumentedLock.java,248,76,3,2,0,81
 hadoop-trunk\hadoop-trunk\hadoop-yarn-project\hadoop-yarn\hadoop-yarn-server\hadoop-yarn-server-timelineservice\src\main\java\org\apache\hadoop\yarn\server\timelineservice\reader\TimelineParserForCompareExpr.java,248,34,1,8,1,44
 hadoop-trunk\hadoop-trunk\hadoop-common-project\hadoop-common\src\main\java\org\apache\hadoop\tools\TableListing.java,248,80,7,1,0,88
 hadoop-trunk\hadoop-trunk\hadoop-yarn-project\hadoop-yarn\hadoop-yarn-server\hadoop-yarn-server-nodemanager\src\test\java\org\apache\hadoop\yarn\server\nodemanager\webapp\MockContainer.java,248,69,16,7,0,92
 hadoop-trunk\hadoop-trunk\hadoop-common-project\hadoop-common\src\test\java\org\apache\hadoop\util\TestRunJar.java,248,38,6,3,4,51
 hadoop-trunk\hadoop-trunk\hadoop-mapreduce-project\hadoop-mapreduce-client\hadoop-mapreduce-client-jobclient\src\test\java\org\apache\hadoop\mapreduce\lib\output\TestJobOutputCommitter.java,248,67,4,5,0,76
 hadoop-trunk\hadoop-trunk\hadoop-common-project\hadoop-common\src\test\java\org\apache\hadoop\fs\shell\TestPathData.java,248,78,9,1,1,89
 hadoop-trunk\hadoop-trunk\hadoop-common-project\hadoop-common\src\test\java\org\apache\hadoop\net\unix\TestDomainSocketWatcher.java,248,43,10,2,5,60
 hadoop-trunk\hadoop-trunk\hadoop-hdfs-project\hadoop-hdfs\src\test\java\org\apache\hadoop\hdfs\TestDistributedFileSystemWithECFile.java,248,51,21,1,3,76
 kafka-trunk\kafka-trunk\streams\upgrade-system-tests-23\src\test\java\org\apache\kafka\streams\tests\SmokeTestClient.java,248,0,11,29,2,42
 kafka-trunk\kafka-trunk\streams\upgrade-system-tests-24\src\test\java\org\apache\kafka\streams\tests\SmokeTestClient.java,248,0,11,29,0,40
 kafka-trunk\kafka-trunk\streams\upgrade-system-tests-30\src\test\java\org\apache\kafka\streams\tests\SmokeTestClient.java,248,0,11,30,0,41
 kafka-trunk\kafka-trunk\streams\upgrade-system-tests-28\src\test\java\org\apache\kafka\streams\tests\SmokeTestClient.java,248,0,11,30,0,41
 kafka-trunk\kafka-trunk\streams\upgrade-system-tests-27\src\test\java\org\apache\kafka\streams\tests\SmokeTestClient.java,248,0,11,29,0,40
 kafka-trunk\kafka-trunk\clients\src\generated-test\java\org\apache\kafka\common\message\SimpleRecordsMessageData.java,248,0,0,15,3,18
 kafka-trunk\kafka-trunk\clients\src\test\java\org\apache\kafka\clients\consumer\StickyAssignorTest.java,248,0,0,67,0,67
 kafka-trunk\kafka-trunk\streams\upgrade-system-tests-25\src\test\java\org\apache\kafka\streams\tests\SmokeTestClient.java,248,0,11,29,0,40
 kafka-trunk\kafka-trunk\streams\upgrade-system-tests-22\src\test\java\org\apache\kafka\streams\tests\SmokeTestClient.java,248,0,11,29,0,40
 kafka-trunk\kafka-trunk\streams\upgrade-system-tests-31\src\test\java\org\apache\kafka\streams\tests\SmokeTestClient.java,248,0,11,30,0,41
 kafka-trunk\kafka-trunk\streams\upgrade-system-tests-26\src\test\java\org\apache\kafka\streams\tests\SmokeTestClient.java,248,0,11,29,0,40
 pulsar-master\pulsar-master\pulsar-broker\src\main\java\org\apache\pulsar\broker\admin\v1\NonPersistentTopics.java,248,144,11,71,0,226
 rocketmq-develop\rocketmq-develop\client\src\test\java\org\apache\rocketmq\client\trace\DefaultMQConsumerWithTraceTest.java,248,86,17,39,10,152
 zookeeper-master\zookeeper-master\zookeeper-server\src\main\java\org\apache\zookeeper\server\quorum\Follower.java,248,0,17,16,2,35
 hadoop-trunk\hadoop-trunk\hadoop-yarn-project\hadoop-yarn\hadoop-yarn-server\hadoop-yarn-server-resourcemanager\src\test\java\org\apache\hadoop\yarn\server\resourcemanager\scheduler\capacity\TestWorkPreservingRMRestartForNodeLabel.java,249,51,1,12,2,66
 hadoop-trunk\hadoop-trunk\hadoop-mapreduce-project\hadoop-mapreduce-client\hadoop-mapreduce-client-common\src\main\java\org\apache\hadoop\mapreduce\v2\jobhistory\JHAdminConfig.java,249,83,3,3,2,91
 hadoop-trunk\hadoop-trunk\hadoop-yarn-project\hadoop-yarn\hadoop-yarn-server\hadoop-yarn-server-resourcemanager\src\main\java\org\apache\hadoop\yarn\server\resourcemanager\webapp\dao\NodeInfo.java,249,127,3,3,7,140
 hadoop-trunk\hadoop-trunk\hadoop-common-project\hadoop-common\src\main\java\org\apache\hadoop\io\SecureIOUtils.java,249,68,4,3,0,75
 hadoop-trunk\hadoop-trunk\hadoop-hdfs-project\hadoop-hdfs\src\main\java\org\apache\hadoop\hdfs\server\blockmanagement\SlowDiskTracker.java,249,61,12,1,3,77
 kafka-trunk\kafka-trunk\streams\src\test\java\org\apache\kafka\streams\kstream\internals\SessionWindowedKStreamImplTest.java,249,0,6,43,12,61
 kafka-trunk\kafka-trunk\connect\runtime\src\main\java\org\apache\kafka\connect\runtime\distributed\ClusterConfigState.java,249,0,2,24,6,32
 pulsar-master\pulsar-master\pulsar-broker\src\test\java\org\apache\pulsar\broker\transaction\TransactionConsumeTest.java,249,76,3,39,0,118
 skywalking-master\skywalking-master\oap-server\oal-rt\src\main\java\org\apache\skywalking\oal\rt\parser\OALListener.java,249,107,3,28,0,138
 zookeeper-master\zookeeper-master\zookeeper-server\src\main\java\org\apache\zookeeper\ServerAdminClient.java,249,0,20,6,6,32
 dubbo-3.0\dubbo-3.0\dubbo-common\src\main\java\org\apache\dubbo\common\compiler\support\JdkCompiler.java,250,89,4,37,2,132
 hadoop-trunk\hadoop-trunk\hadoop-hdfs-project\hadoop-hdfs\src\main\java\org\apache\hadoop\hdfs\server\datanode\metrics\DataNodeDiskMetrics.java,250,60,6,8,5,79
 hadoop-trunk\hadoop-trunk\hadoop-yarn-project\hadoop-yarn\hadoop-yarn-common\src\main\java\org\apache\hadoop\yarn\client\RMProxy.java,250,65,9,1,0,75
 hadoop-trunk\hadoop-trunk\hadoop-common-project\hadoop-common\src\main\java\org\apache\hadoop\fs\DelegateToFileSystem.java,250,97,0,2,1,100
 hadoop-trunk\hadoop-trunk\hadoop-common-project\hadoop-registry\src\main\java\org\apache\hadoop\registry\server\dns\ContainerServiceRecordProcessor.java,250,25,7,1,1,34
 hadoop-trunk\hadoop-trunk\hadoop-hdfs-project\hadoop-hdfs\src\test\java\org\apache\hadoop\hdfs\util\TestStripedBlockUtil.java,250,40,6,1,3,50
 hadoop-trunk\hadoop-trunk\hadoop-yarn-project\hadoop-yarn\hadoop-yarn-api\src\main\java\org\apache\hadoop\yarn\api\records\timelineservice\TimelineMetric.java,250,55,6,1,2,64
 hadoop-trunk\hadoop-trunk\hadoop-yarn-project\hadoop-yarn\hadoop-yarn-common\src\main\java\org\apache\hadoop\yarn\webapp\WebApp.java,250,99,8,4,2,113
 hadoop-trunk\hadoop-trunk\hadoop-hdfs-project\hadoop-hdfs-client\src\main\java\org\apache\hadoop\hdfs\protocol\datatransfer\PipelineAck.java,250,100,41,4,0,145
 kafka-trunk\kafka-trunk\connect\mirror\src\main\java\org\apache\kafka\connect\mirror\MirrorSourceTask.java,250,0,13,31,0,44
 kafka-trunk\kafka-trunk\clients\src\test\java\org\apache\kafka\clients\admin\internals\CoordinatorStrategyTest.java,250,0,0,43,0,43
 pulsar-master\pulsar-master\pulsar-broker\src\main\java\org\apache\pulsar\broker\loadbalance\impl\LinuxBrokerHostUsageImpl.java,250,86,4,34,0,124
 pulsar-master\pulsar-master\pulsar-client-admin\src\main\java\org\apache\pulsar\client\admin\internal\BaseResource.java,250,90,7,43,0,140
 pulsar-master\pulsar-master\tests\integration\src\test\java\org\apache\pulsar\tests\integration\io\sources\PulsarIOSourceRunner.java,250,79,5,34,0,118
 skywalking-master\skywalking-master\oap-server\analyzer\meter-analyzer\src\main\java\org\apache\skywalking\oap\meter\analyzer\Analyzer.java,250,56,5,41,0,102
 zookeeper-master\zookeeper-master\zookeeper-server\src\test\java\org\apache\zookeeper\server\quorum\DIFFSyncConsistencyTest.java,250,0,20,36,2,58
 dubbo-3.0\dubbo-3.0\dubbo-cluster\src\test\java\org\apache\dubbo\rpc\cluster\loadbalance\LoadBalanceBaseTest.java,251,170,2,43,0,215
 hadoop-trunk\hadoop-trunk\hadoop-hdfs-project\hadoop-hdfs-client\src\test\java\org\apache\hadoop\hdfs\web\TestByteRangeInputStream.java,251,40,11,2,2,55
 hadoop-trunk\hadoop-trunk\hadoop-hdfs-project\hadoop-hdfs\src\test\java\org\apache\hadoop\hdfs\server\namenode\TestNestedEncryptionZones.java,251,37,3,2,3,45
 hadoop-trunk\hadoop-trunk\hadoop-tools\hadoop-openstack\src\test\java\org\apache\hadoop\fs\swift\TestSwiftFileSystemBasicOps.java,251,25,9,2,1,37
 kafka-trunk\kafka-trunk\metadata\src\main\java\org\apache\kafka\timeline\SnapshotRegistry.java,251,0,5,10,0,15
 pulsar-master\pulsar-master\pulsar-metadata\src\test\java\org\apache\pulsar\metadata\LockManagerTest.java,251,76,2,56,0,134
 pulsar-master\pulsar-master\pulsar-io\file\src\test\java\org\apache\pulsar\io\file\FileListingThreadTests.java,251,74,0,16,0,90
 skywalking-master\skywalking-master\oap-server\server-receiver-plugin\skywalking-zabbix-receiver-plugin\src\main\java\org\apache\skywalking\oap\server\receiver\zabbix\provider\ZabbixMetrics.java,251,80,0,25,0,105
 zookeeper-master\zookeeper-master\zookeeper-server\src\test\java\org\apache\zookeeper\server\admin\CommandsTest.java,251,0,0,25,0,25
 zookeeper-master\zookeeper-master\zookeeper-server\src\test\java\org\apache\zookeeper\test\LoadFromLogTest.java,251,0,30,31,0,61
 dubbo-3.0\dubbo-3.0\dubbo-remoting\dubbo-remoting-api\src\main\java\org\apache\dubbo\remoting\exchange\support\DefaultFuture.java,252,95,3,29,2,129
 hadoop-trunk\hadoop-trunk\hadoop-hdfs-project\hadoop-hdfs\src\test\java\org\apache\hadoop\hdfs\server\namenode\TestAddOverReplicatedStripedBlocks.java,252,24,2,1,9,36
 hadoop-trunk\hadoop-trunk\hadoop-yarn-project\hadoop-yarn\hadoop-yarn-server\hadoop-yarn-server-resourcemanager\src\test\java\org\apache\hadoop\yarn\server\resourcemanager\monitor\capacity\mockframework\ProportionalCapacityPreemptionPolicyMockFramework.java,252,87,3,16,7,113
 hadoop-trunk\hadoop-trunk\hadoop-hdfs-project\hadoop-hdfs-client\src\main\java\org\apache\hadoop\hdfs\server\datanode\DiskBalancerWorkStatus.java,252,60,2,1,5,68
 hadoop-trunk\hadoop-trunk\hadoop-hdfs-project\hadoop-hdfs-client\src\main\java\org\apache\hadoop\hdfs\protocol\SnapshotDiffReport.java,252,102,2,2,6,112
 hadoop-trunk\hadoop-trunk\hadoop-yarn-project\hadoop-yarn\hadoop-yarn-server\hadoop-yarn-server-resourcemanager\src\test\java\org\apache\hadoop\yarn\server\resourcemanager\security\TestRMDelegationTokens.java,252,44,4,4,5,57
 hadoop-trunk\hadoop-trunk\hadoop-hdfs-project\hadoop-hdfs\src\test\java\org\apache\hadoop\hdfs\TestMultipleNNPortQOP.java,252,29,1,8,1,39
 kafka-trunk\kafka-trunk\clients\src\generated\java\org\apache\kafka\common\message\EndTxnRequestData.java,252,0,0,23,2,25
 pulsar-master\pulsar-master\pulsar-broker\src\test\java\org\apache\pulsar\broker\resourcegroup\ResourceGroupConfigListenerTest.java,252,121,5,34,0,160
 pulsar-master\pulsar-master\pulsar-broker\src\main\java\org\apache\pulsar\broker\service\AbstractDispatcherSingleActiveConsumer.java,252,104,3,38,0,145
 zookeeper-master\zookeeper-master\zookeeper-server\src\main\java\org\apache\zookeeper\server\admin\JettyAdminServer.java,252,0,4,33,2,39
 zookeeper-master\zookeeper-master\zookeeper-server\src\test\java\org\apache\zookeeper\server\ReferenceCountedACLCacheTest.java,252,0,75,17,2,94
 dubbo-3.0\dubbo-3.0\dubbo-common\src\main\java\org\apache\dubbo\common\logger\support\FailsafeLogger.java,253,57,45,2,0,104
 hadoop-trunk\hadoop-trunk\hadoop-common-project\hadoop-common\src\main\java\org\apache\hadoop\io\compress\lz4\Lz4Decompressor.java,253,26,4,1,1,32
 hadoop-trunk\hadoop-trunk\hadoop-yarn-project\hadoop-yarn\hadoop-yarn-server\hadoop-yarn-server-resourcemanager\src\test\java\org\apache\hadoop\yarn\server\resourcemanager\scheduler\capacity\TestCapacitySchedulerSchedulingRequestUpdate.java,253,61,0,8,0,69
 hadoop-trunk\hadoop-trunk\hadoop-hdfs-project\hadoop-hdfs\src\test\java\org\apache\hadoop\hdfs\server\blockmanagement\TestRBWBlockInvalidation.java,253,35,4,7,1,47
 hadoop-trunk\hadoop-trunk\hadoop-yarn-project\hadoop-yarn\hadoop-yarn-server\hadoop-yarn-server-nodemanager\src\main\java\org\apache\hadoop\yarn\server\nodemanager\containermanager\resourceplugin\fpga\IntelFpgaOpenclPlugin.java,253,60,16,2,4,82
 hadoop-trunk\hadoop-trunk\hadoop-yarn-project\hadoop-yarn\hadoop-yarn-server\hadoop-yarn-server-resourcemanager\src\main\java\org\apache\hadoop\yarn\server\resourcemanager\webapp\FairSchedulerPage.java,253,69,0,14,2,85
 hadoop-trunk\hadoop-trunk\hadoop-hdfs-project\hadoop-hdfs\src\main\java\org\apache\hadoop\hdfs\server\namenode\NNStorageRetentionManager.java,253,64,4,5,2,75
 hadoop-trunk\hadoop-trunk\hadoop-common-project\hadoop-common\src\test\java\org\apache\hadoop\net\TestSocketIOWithTimeout.java,253,57,6,2,12,77
 hadoop-trunk\hadoop-trunk\hadoop-tools\hadoop-aws\src\test\java\org\apache\hadoop\fs\s3a\ITestS3AClientSideEncryption.java,253,9,4,4,1,18
 hadoop-trunk\hadoop-trunk\hadoop-hdfs-project\hadoop-hdfs-client\src\main\java\org\apache\hadoop\hdfs\server\namenode\ha\RequestHedgingProxyProvider.java,253,26,4,1,0,31
 pulsar-master\pulsar-master\pulsar-broker\src\main\java\org\apache\pulsar\broker\admin\impl\SchemasResourceBase.java,253,108,6,60,0,174
 dubbo-3.0\dubbo-3.0\dubbo-common\src\main\java\org\apache\dubbo\config\context\ConfigManager.java,254,99,2,15,0,116
 hadoop-trunk\hadoop-trunk\hadoop-hdfs-project\hadoop-hdfs\src\test\java\org\apache\hadoop\hdfs\server\namenode\snapshot\TestINodeFileUnderConstructionWithSnapshot.java,254,74,1,4,4,83
 hadoop-trunk\hadoop-trunk\hadoop-yarn-project\hadoop-yarn\hadoop-yarn-server\hadoop-yarn-server-resourcemanager\src\main\java\org\apache\hadoop\yarn\server\resourcemanager\scheduler\fair\allocation\AllocationFileQueueParser.java,254,46,4,1,1,52
 hadoop-trunk\hadoop-trunk\hadoop-yarn-project\hadoop-yarn\hadoop-yarn-applications\hadoop-yarn-applications-catalog\hadoop-yarn-applications-catalog-webapp\src\main\java\org\apache\hadoop\yarn\appcatalog\controller\AppDetailsController.java,254,10,2,1,0,13
 hadoop-trunk\hadoop-trunk\hadoop-hdfs-project\hadoop-hdfs\src\main\java\org\apache\hadoop\hdfs\server\datanode\StorageLocation.java,254,38,3,1,4,46
 kafka-trunk\kafka-trunk\core\src\test\java\kafka\test\junit\ZkClusterInvocationContext.java,254,0,0,29,0,29
 kafka-trunk\kafka-trunk\clients\src\test\java\org\apache\kafka\clients\producer\internals\ProducerBatchTest.java,254,0,7,42,5,54
 kafka-trunk\kafka-trunk\streams\src\main\java\org\apache\kafka\streams\state\internals\AbstractDualSchemaRocksDBSegmentedBytesStore.java,254,0,7,27,2,36
 pulsar-master\pulsar-master\pulsar-client\src\test\java\org\apache\pulsar\client\impl\AutoClusterFailoverTest.java,254,70,18,57,0,145
 pulsar-master\pulsar-master\tiered-storage\jcloud\src\main\java\org\apache\bookkeeper\mledger\offload\jcloud\impl\BlobStoreBackedReadHandleImplV2.java,254,91,3,33,0,127
 zookeeper-master\zookeeper-master\zookeeper-contrib\zookeeper-contrib-zooinspector\src\main\java\org\apache\zookeeper\retry\ZooKeeperRetry.java,254,0,29,3,3,35
 dubbo-3.0\dubbo-3.0\dubbo-test\dubbo-test-check\src\main\java\org\apache\dubbo\test\check\DubboTestChecker.java,255,72,6,27,3,108
 hadoop-trunk\hadoop-trunk\hadoop-hdfs-project\hadoop-hdfs-client\src\main\java\org\apache\hadoop\hdfs\server\datanode\DiskBalancerWorkItem.java,255,38,1,1,0,40
 hadoop-trunk\hadoop-trunk\hadoop-yarn-project\hadoop-yarn\hadoop-yarn-server\hadoop-yarn-server-applicationhistoryservice\src\main\java\org\apache\hadoop\yarn\server\applicationhistoryservice\webapp\AHSWebServices.java,255,93,2,1,0,96
 hadoop-trunk\hadoop-trunk\hadoop-yarn-project\hadoop-yarn\hadoop-yarn-server\hadoop-yarn-server-nodemanager\src\main\java\org\apache\hadoop\yarn\server\nodemanager\recovery\NMNullStateStoreService.java,255,76,53,6,0,135
 hadoop-trunk\hadoop-trunk\hadoop-mapreduce-project\hadoop-mapreduce-client\hadoop-mapreduce-client-jobclient\src\test\java\org\apache\hadoop\mapreduce\lib\partition\TestInputSampler.java,255,83,21,2,1,107
 hadoop-trunk\hadoop-trunk\hadoop-yarn-project\hadoop-yarn\hadoop-yarn-server\hadoop-yarn-server-nodemanager\src\test\java\org\apache\hadoop\yarn\server\nodemanager\webapp\TestNMWebServicesAuxServices.java,255,44,7,4,0,55
 hadoop-trunk\hadoop-trunk\hadoop-hdfs-project\hadoop-hdfs\src\main\java\org\apache\hadoop\hdfs\server\namenode\NameNodeHttpServer.java,255,60,2,9,2,73
 hadoop-trunk\hadoop-trunk\hadoop-yarn-project\hadoop-yarn\hadoop-yarn-api\src\main\java\org\apache\hadoop\yarn\api\records\ResourceUtilization.java,255,46,1,1,2,50
 hadoop-trunk\hadoop-trunk\hadoop-common-project\hadoop-common\src\main\java\org\apache\hadoop\io\compress\snappy\SnappyCompressor.java,255,28,6,1,1,36
 kafka-trunk\kafka-trunk\connect\transforms\src\main\java\org\apache\kafka\connect\transforms\Flatten.java,255,0,4,46,0,50
 kafka-trunk\kafka-trunk\clients\src\test\java\org\apache\kafka\clients\admin\internals\PartitionLeaderStrategyTest.java,255,0,1,35,0,36
 pulsar-master\pulsar-master\tests\integration\src\test\java\org\apache\pulsar\tests\integration\presto\TestPulsarSQLBase.java,255,88,9,38,0,135
 pulsar-master\pulsar-master\pulsar-broker\src\test\java\org\apache\pulsar\client\api\ClientDeduplicationTest.java,255,72,0,41,0,113
 hadoop-trunk\hadoop-trunk\hadoop-yarn-project\hadoop-yarn\hadoop-yarn-common\src\test\java\org\apache\hadoop\yarn\api\BasePBImplRecordsTest.java,256,68,20,3,6,97
 hadoop-trunk\hadoop-trunk\hadoop-yarn-project\hadoop-yarn\hadoop-yarn-server\hadoop-yarn-server-nodemanager\src\main\java\org\apache\hadoop\yarn\server\nodemanager\containermanager\linux\runtime\DelegatingLinuxContainerRuntime.java,256,49,3,7,2,61
 hadoop-trunk\hadoop-trunk\hadoop-hdfs-project\hadoop-hdfs\src\test\java\org\apache\hadoop\hdfs\tools\TestECAdmin.java,256,62,2,1,22,87
 hadoop-trunk\hadoop-trunk\hadoop-yarn-project\hadoop-yarn\hadoop-yarn-server\hadoop-yarn-server-resourcemanager\src\test\java\org\apache\hadoop\yarn\server\resourcemanager\scheduler\capacity\TestCapacitySchedulerDynamicBehavior.java,256,40,7,27,3,77
 hadoop-trunk\hadoop-trunk\hadoop-hdfs-project\hadoop-hdfs\src\test\java\org\apache\hadoop\hdfs\server\namenode\TestFsLimits.java,256,60,7,4,5,76
 hadoop-trunk\hadoop-trunk\hadoop-yarn-project\hadoop-yarn\hadoop-yarn-common\src\main\java\org\apache\hadoop\yarn\logaggregation\AggregatedLogDeletionService.java,256,70,5,7,1,83
 hadoop-trunk\hadoop-trunk\hadoop-tools\hadoop-aws\src\test\java\org\apache\hadoop\fs\s3a\auth\delegation\ITestSessionDelegationTokens.java,256,14,3,7,1,25
 hadoop-trunk\hadoop-trunk\hadoop-hdfs-project\hadoop-hdfs\src\test\java\org\apache\hadoop\hdfs\server\datanode\fsdataset\impl\TestCacheByPmemMappableBlockLoader.java,256,40,10,3,15,68
 hadoop-trunk\hadoop-trunk\hadoop-common-project\hadoop-common\src\test\java\org\apache\hadoop\fs\loadGenerator\StructureGenerator.java,256,187,11,3,2,203
 hadoop-trunk\hadoop-trunk\hadoop-hdfs-project\hadoop-hdfs-client\src\test\java\org\apache\hadoop\hdfs\web\TestTokenAspect.java,256,44,16,3,4,67
 kafka-trunk\kafka-trunk\clients\src\generated\java\org\apache\kafka\common\message\RequestHeaderData.java,256,0,0,22,3,25
 kafka-trunk\kafka-trunk\streams\src\main\java\org\apache\kafka\streams\processor\internals\RecordCollectorImpl.java,256,0,2,50,1,53
 kafka-trunk\kafka-trunk\clients\src\main\java\org\apache\kafka\common\security\scram\internals\ScramMessages.java,256,0,11,22,8,41
 kafka-trunk\kafka-trunk\metadata\src\test\java\org\apache\kafka\controller\BrokerHeartbeatManagerTest.java,256,0,1,18,0,19
 pulsar-master\pulsar-master\pulsar-metadata\src\main\java\org\apache\pulsar\metadata\bookkeeper\PulsarLedgerIdGenerator.java,256,63,8,37,0,108
 pulsar-master\pulsar-master\pulsar-functions\instance\src\main\java\org\apache\pulsar\functions\windowing\WindowManager.java,256,54,1,17,0,72
 rocketmq-develop\rocketmq-develop\test\src\main\java\org\apache\rocketmq\test\lmq\benchmark\BenchLmqStore.java,256,103,3,52,8,166
 zookeeper-master\zookeeper-master\zookeeper-server\src\main\java\org\apache\zookeeper\ZKUtil.java,256,0,7,19,0,26
 hadoop-trunk\hadoop-trunk\hadoop-yarn-project\hadoop-yarn\hadoop-yarn-common\src\main\java\org\apache\hadoop\yarn\server\api\impl\pb\service\ResourceManagerAdministrationProtocolPBServiceImpl.java,257,74,91,80,0,245
 hadoop-trunk\hadoop-trunk\hadoop-mapreduce-project\hadoop-mapreduce-client\hadoop-mapreduce-client-app\src\test\java\org\apache\hadoop\mapreduce\v2\app\commit\TestCommitterEventHandler.java,257,61,6,6,4,77
 hadoop-trunk\hadoop-trunk\hadoop-tools\hadoop-azure\src\test\java\org\apache\hadoop\fs\azurebfs\ITestAbfsListStatusRemoteIterator.java,257,45,4,5,2,56
 hadoop-trunk\hadoop-trunk\hadoop-hdfs-project\hadoop-hdfs\src\test\java\org\apache\hadoop\hdfs\tools\TestDFSHAAdminMiniCluster.java,257,60,2,1,2,65
 hadoop-trunk\hadoop-trunk\hadoop-yarn-project\hadoop-yarn\hadoop-yarn-server\hadoop-yarn-server-resourcemanager\src\main\java\org\apache\hadoop\yarn\server\resourcemanager\placement\csmappingrule\MappingRuleMatchers.java,257,39,0,1,0,40
 hadoop-trunk\hadoop-trunk\hadoop-tools\hadoop-streaming\src\main\java\org\apache\hadoop\streaming\StreamXmlRecordReader.java,257,119,15,13,1,148
 hadoop-trunk\hadoop-trunk\hadoop-hdfs-project\hadoop-hdfs\src\main\java\org\apache\hadoop\hdfs\server\namenode\QuotaCounts.java,257,73,0,1,1,75
 hadoop-trunk\hadoop-trunk\hadoop-hdfs-project\hadoop-hdfs\src\test\java\org\apache\hadoop\hdfs\server\datanode\TestDataNodeVolumeFailureToleration.java,257,52,3,3,5,63
 hadoop-trunk\hadoop-trunk\hadoop-common-project\hadoop-common\src\main\java\org\apache\hadoop\util\GcTimeMonitor.java,257,71,4,2,4,81
 hadoop-trunk\hadoop-trunk\hadoop-hdfs-project\hadoop-hdfs\src\test\java\org\apache\hadoop\hdfs\server\common\TestHostRestrictingAuthorizationFilter.java,257,35,11,4,11,61
 hadoop-trunk\hadoop-trunk\hadoop-common-project\hadoop-registry\src\test\java\org\apache\hadoop\registry\client\impl\TestFSRegistryOperationsService.java,257,16,6,1,1,24
 hadoop-trunk\hadoop-trunk\hadoop-hdfs-project\hadoop-hdfs-rbf\src\test\java\org\apache\hadoop\hdfs\server\federation\router\TestRouter.java,257,18,7,4,0,29
 hadoop-trunk\hadoop-trunk\hadoop-yarn-project\hadoop-yarn\hadoop-yarn-server\hadoop-yarn-server-resourcemanager\src\main\java\org\apache\hadoop\yarn\server\resourcemanager\scheduler\fair\allocation\QueueProperties.java,257,120,0,3,18,141
 kafka-trunk\kafka-trunk\streams\src\test\java\org\apache\kafka\streams\processor\internals\GlobalStreamThreadTest.java,257,0,4,33,4,41
 kafka-trunk\kafka-trunk\metadata\src\test\java\org\apache\kafka\controller\ClientQuotaControlManagerTest.java,257,0,4,75,0,79
 kafka-trunk\kafka-trunk\streams\src\main\java\org\apache\kafka\streams\processor\internals\TaskExecutor.java,257,0,14,46,1,61
 pulsar-master\pulsar-master\pulsar-broker\src\test\java\org\apache\pulsar\client\api\ConsumerRedeliveryTest.java,257,52,0,21,0,73
 pulsar-master\pulsar-master\pulsar-broker\src\test\java\org\apache\pulsar\broker\transaction\TransactionTestBase.java,257,99,3,42,0,144
 pulsar-master\pulsar-master\pulsar-functions\utils\src\test\java\org\apache\pulsar\functions\utils\WindowConfigUtilsTest.java,257,34,0,28,0,62
 pulsar-master\pulsar-master\pulsar-broker-common\src\test\java\org\apache\pulsar\common\configuration\PulsarConfigurationLoaderTest.java,257,105,19,35,0,159
 rocketmq-develop\rocketmq-develop\remoting\src\test\java\org\apache\rocketmq\remoting\TlsTest.java,257,55,12,47,52,166
 dubbo-3.0\dubbo-3.0\dubbo-remoting\dubbo-remoting-api\src\main\java\org\apache\dubbo\remoting\telnet\codec\TelnetCodec.java,258,65,6,17,1,89
 dubbo-3.0\dubbo-3.0\dubbo-common\src\main\java\org\apache\dubbo\rpc\model\ScopeModel.java,258,90,1,13,4,108
 hadoop-trunk\hadoop-trunk\hadoop-hdfs-project\hadoop-hdfs\src\main\java\org\apache\hadoop\hdfs\server\datanode\web\webhdfs\WebHdfsHandler.java,258,47,34,8,2,91
 hadoop-trunk\hadoop-trunk\hadoop-mapreduce-project\hadoop-mapreduce-client\hadoop-mapreduce-client-jobclient\src\test\java\org\apache\hadoop\mapred\lib\TestChainMapReduce.java,258,66,3,1,2,72
 hadoop-trunk\hadoop-trunk\hadoop-hdfs-project\hadoop-hdfs-client\src\main\java\org\apache\hadoop\hdfs\web\ByteRangeInputStream.java,258,85,4,2,3,94
 pulsar-master\pulsar-master\pulsar-broker-common\src\main\java\org\apache\pulsar\bookie\rackawareness\IsolatedBookieEnsemblePlacementPolicy.java,258,103,4,73,0,180
 zookeeper-master\zookeeper-master\zookeeper-server\src\test\java\org\apache\zookeeper\test\ACLTest.java,258,0,48,24,0,72
 hadoop-trunk\hadoop-trunk\hadoop-hdfs-project\hadoop-hdfs\src\main\java\org\apache\hadoop\hdfs\server\namenode\sps\BlockStorageMovementAttemptedItems.java,259,42,4,7,3,56
 hadoop-trunk\hadoop-trunk\hadoop-yarn-project\hadoop-yarn\hadoop-yarn-server\hadoop-yarn-server-nodemanager\src\main\java\org\apache\hadoop\yarn\server\nodemanager\containermanager\resourceplugin\ResourcePluginManager.java,259,38,11,10,3,62
 hadoop-trunk\hadoop-trunk\hadoop-common-project\hadoop-common\src\test\java\org\apache\hadoop\fs\statistics\TestDynamicIOStatistics.java,259,24,2,11,0,37
 hadoop-trunk\hadoop-trunk\hadoop-mapreduce-project\hadoop-mapreduce-client\hadoop-mapreduce-client-core\src\main\java\org\apache\hadoop\mapred\SkipBadRecords.java,259,155,1,3,0,159
 hadoop-trunk\hadoop-trunk\hadoop-mapreduce-project\hadoop-mapreduce-client\hadoop-mapreduce-client-app\src\main\java\org\apache\hadoop\mapreduce\jobhistory\JobSummary.java,259,165,5,1,2,173
 hadoop-trunk\hadoop-trunk\hadoop-yarn-project\hadoop-yarn\hadoop-yarn-server\hadoop-yarn-server-nodemanager\src\test\java\org\apache\hadoop\yarn\server\nodemanager\TestNetworkTagMappingJsonManager.java,259,23,8,5,3,39
 hadoop-trunk\hadoop-trunk\hadoop-common-project\hadoop-common\src\test\java\org\apache\hadoop\net\TestClusterTopology.java,259,47,2,3,2,54
 hadoop-trunk\hadoop-trunk\hadoop-yarn-project\hadoop-yarn\hadoop-yarn-server\hadoop-yarn-server-nodemanager\src\test\java\org\apache\hadoop\yarn\server\nodemanager\TestNodeManagerReboot.java,259,52,6,12,2,72
 shardingsphere-master\shardingsphere-master\shardingsphere-jdbc\shardingsphere-jdbc-core\src\main\java\org\apache\shardingsphere\driver\jdbc\adapter\AbstractPreparedStatementAdapter.java,259,78,0,27,0,105
 skywalking-master\skywalking-master\oap-server\server-receiver-plugin\skywalking-zabbix-receiver-plugin\src\test\java\org\apache\skywalking\oap\server\receiver\zabbix\provider\ZabbixBaseTest.java,259,100,0,36,0,136
 skywalking-master\skywalking-master\oap-server\server-storage-plugin\storage-elasticsearch-plugin\src\main\java\org\apache\skywalking\oap\server\storage\plugin\elasticsearch\query\MetadataQueryEsDAO.java,259,67,1,56,0,124
 dubbo-3.0\dubbo-3.0\dubbo-registry\dubbo-registry-nacos\src\test\java\org\apache\dubbo\registry\nacos\NacosRegistryTest.java,260,66,7,45,0,118
 hadoop-trunk\hadoop-trunk\hadoop-yarn-project\hadoop-yarn\hadoop-yarn-server\hadoop-yarn-server-resourcemanager\src\main\java\org\apache\hadoop\yarn\server\resourcemanager\scheduler\capacity\CSQueueStore.java,260,15,1,1,0,17
 hadoop-trunk\hadoop-trunk\hadoop-yarn-project\hadoop-yarn\hadoop-yarn-server\hadoop-yarn-server-resourcemanager\src\test\java\org\apache\hadoop\yarn\server\resourcemanager\scheduler\capacity\TestCapacitySchedulerMaxParallelApps.java,260,55,2,4,0,61
 hadoop-trunk\hadoop-trunk\hadoop-yarn-project\hadoop-yarn\hadoop-yarn-server\hadoop-yarn-server-nodemanager\src\main\java\org\apache\hadoop\yarn\server\nodemanager\security\NMTokenSecretManagerInNM.java,260,48,5,4,15,72
 hadoop-trunk\hadoop-trunk\hadoop-hdfs-project\hadoop-hdfs\src\test\java\org\apache\hadoop\hdfs\TestSecureEncryptionZoneWithKMS.java,260,44,5,14,5,68
 hadoop-trunk\hadoop-trunk\hadoop-yarn-project\hadoop-yarn\hadoop-yarn-server\hadoop-yarn-server-applicationhistoryservice\src\test\java\org\apache\hadoop\yarn\server\applicationhistoryservice\TestFileSystemApplicationHistoryStore.java,260,36,1,4,7,48
 hadoop-trunk\hadoop-trunk\hadoop-mapreduce-project\hadoop-mapreduce-client\hadoop-mapreduce-client-core\src\main\java\org\apache\hadoop\mapreduce\jobhistory\TaskAttemptUnsuccessfulCompletionEvent.java,260,133,45,1,0,179
 hadoop-trunk\hadoop-trunk\hadoop-common-project\hadoop-common\src\test\java\org\apache\hadoop\security\alias\TestCredShell.java,260,51,3,8,32,94
 hadoop-trunk\hadoop-trunk\hadoop-yarn-project\hadoop-yarn\hadoop-yarn-server\hadoop-yarn-server-resourcemanager\src\test\java\org\apache\hadoop\yarn\server\resourcemanager\scheduler\fair\converter\TestFSYarnSiteConverter.java,260,36,0,9,0,45
 kafka-trunk\kafka-trunk\connect\runtime\src\test\java\org\apache\kafka\connect\integration\ConnectorTopicsIntegrationTest.java,260,0,1,82,0,83
 kafka-trunk\kafka-trunk\metadata\src\main\java\org\apache\kafka\controller\BrokersToIsrs.java,260,0,5,24,0,29
 kafka-trunk\kafka-trunk\clients\src\generated\java\org\apache\kafka\common\message\CreateTopicsResponseDataJsonConverter.java,260,0,0,52,0,52
 pulsar-master\pulsar-master\pulsar-broker\src\test\java\org\apache\pulsar\client\api\NonDurableSubscriptionTest.java,260,69,13,36,0,118
 pulsar-master\pulsar-master\pulsar-broker\src\test\java\org\apache\pulsar\broker\service\BrokerServiceThrottlingTest.java,260,57,6,32,0,95
 pulsar-master\pulsar-master\managed-ledger\src\main\java\org\apache\bookkeeper\mledger\impl\EntryCacheManager.java,260,113,7,37,0,157
 dubbo-3.0\dubbo-3.0\dubbo-registry\dubbo-registry-api\src\main\java\org\apache\dubbo\registry\client\AbstractServiceDiscovery.java,261,105,9,40,0,154
 dubbo-3.0\dubbo-3.0\dubbo-config\dubbo-config-api\src\test\java\org\apache\dubbo\config\ConfigCenterConfigTest.java,261,55,0,26,0,81
 hadoop-trunk\hadoop-trunk\hadoop-mapreduce-project\hadoop-mapreduce-client\hadoop-mapreduce-client-jobclient\src\test\java\org\apache\hadoop\mapreduce\SleepJob.java,261,148,16,2,4,170
 hadoop-trunk\hadoop-trunk\hadoop-mapreduce-project\hadoop-mapreduce-client\hadoop-mapreduce-client-jobclient\src\test\java\org\apache\hadoop\mapred\TestReduceFetchFromPartialMem.java,261,115,15,2,7,139
 hadoop-trunk\hadoop-trunk\hadoop-yarn-project\hadoop-yarn\hadoop-yarn-server\hadoop-yarn-server-timelineservice-hbase\hadoop-yarn-server-timelineservice-hbase-common\src\main\java\org\apache\hadoop\yarn\server\timelineservice\storage\subapplication\SubApplicationRowKey.java,261,47,1,3,0,51
 hadoop-trunk\hadoop-trunk\hadoop-hdfs-project\hadoop-hdfs\src\test\java\org\apache\hadoop\hdfs\TestDFSStripedOutputStreamWithFailure.java,261,25,9,1,4,39
 hadoop-trunk\hadoop-trunk\hadoop-yarn-project\hadoop-yarn\hadoop-yarn-common\src\main\java\org\apache\hadoop\yarn\logaggregation\ExtendedLogMetaRequest.java,261,103,0,1,0,104
 kafka-trunk\kafka-trunk\core\src\generated\java\kafka\internals\generated\OffsetCommitValue.java,261,0,0,13,3,16
 skywalking-master\skywalking-master\oap-server\server-storage-plugin\storage-influxdb-plugin\src\main\java\org\apache\skywalking\oap\server\storage\plugin\influxdb\query\TopologyQuery.java,261,63,0,50,0,113
 dubbo-3.0\dubbo-3.0\dubbo-filter\dubbo-filter-validation\src\main\java\org\apache\dubbo\validation\support\jvalidation\JValidatorNew.java,262,71,7,41,0,119
 dubbo-3.0\dubbo-3.0\dubbo-filter\dubbo-filter-validation\src\main\java\org\apache\dubbo\validation\support\jvalidation\JValidator.java,262,71,7,41,0,119
 hadoop-trunk\hadoop-trunk\hadoop-yarn-project\hadoop-yarn\hadoop-yarn-common\src\test\java\org\apache\hadoop\yarn\api\TestResourcePBImpl.java,262,37,62,1,1,101
 hadoop-trunk\hadoop-trunk\hadoop-yarn-project\hadoop-yarn\hadoop-yarn-server\hadoop-yarn-server-nodemanager\src\main\java\org\apache\hadoop\yarn\server\nodemanager\containermanager\localizer\LocalizedResource.java,262,77,12,12,9,110
 hadoop-trunk\hadoop-trunk\hadoop-mapreduce-project\hadoop-mapreduce-client\hadoop-mapreduce-client-jobclient\src\test\java\org\apache\hadoop\mapreduce\MiniHadoopClusterManager.java,262,38,9,3,7,57
 hadoop-trunk\hadoop-trunk\hadoop-yarn-project\hadoop-yarn\hadoop-yarn-server\hadoop-yarn-server-resourcemanager\src\test\java\org\apache\hadoop\yarn\server\resourcemanager\TestTokenClientRMService.java,262,48,1,2,3,54
 hadoop-trunk\hadoop-trunk\hadoop-mapreduce-project\hadoop-mapreduce-client\hadoop-mapreduce-client-core\src\main\java\org\apache\hadoop\mapreduce\counters\FrameworkCounterGroup.java,262,78,8,2,0,88
 hadoop-trunk\hadoop-trunk\hadoop-mapreduce-project\hadoop-mapreduce-examples\src\test\java\org\apache\hadoop\examples\TestWordStats.java,262,50,20,9,14,93
 kafka-trunk\kafka-trunk\streams\src\test\java\org\apache\kafka\streams\integration\FineGrainedAutoResetIntegrationTest.java,262,0,6,52,6,64
 pulsar-master\pulsar-master\tests\integration\src\test\java\org\apache\pulsar\tests\integration\offload\TestBaseOffload.java,262,79,0,40,0,119
 dubbo-3.0\dubbo-3.0\dubbo-rpc\dubbo-rpc-triple\src\main\java\org\apache\dubbo\rpc\protocol\tri\TripleInvoker.java,263,81,4,40,0,125
 hadoop-trunk\hadoop-trunk\hadoop-yarn-project\hadoop-yarn\hadoop-yarn-server\hadoop-yarn-server-common\src\main\java\org\apache\hadoop\yarn\server\webapp\LogWebService.java,263,69,9,2,3,83
 hadoop-trunk\hadoop-trunk\hadoop-yarn-project\hadoop-yarn\hadoop-yarn-server\hadoop-yarn-server-resourcemanager\src\test\java\org\apache\hadoop\yarn\server\resourcemanager\scheduler\capacity\TestCSAllocateCustomResource.java,263,32,14,10,3,59
 hadoop-trunk\hadoop-trunk\hadoop-hdfs-project\hadoop-hdfs\src\main\java\org\apache\hadoop\hdfs\server\blockmanagement\BlockPlacementPolicyWithUpgradeDomain.java,263,46,7,1,0,54
 hadoop-trunk\hadoop-trunk\hadoop-common-project\hadoop-common\src\main\java\org\apache\hadoop\metrics2\lib\MutableRollingAverages.java,263,39,1,2,0,42
 kafka-trunk\kafka-trunk\trogdor\src\main\java\org\apache\kafka\trogdor\workload\ConnectionStressWorker.java,263,0,4,21,4,29
 kafka-trunk\kafka-trunk\trogdor\src\main\java\org\apache\kafka\trogdor\workload\ConfigurableProducerWorker.java,263,0,3,26,1,30
 kafka-trunk\kafka-trunk\streams\src\test\java\org\apache\kafka\streams\processor\internals\HighAvailabilityStreamsPartitionAssignorTest.java,263,0,0,64,0,64
 kafka-trunk\kafka-trunk\connect\runtime\src\test\java\org\apache\kafka\connect\integration\ErrorHandlingIntegrationTest.java,263,0,5,52,8,65
 hadoop-trunk\hadoop-trunk\hadoop-yarn-project\hadoop-yarn\hadoop-yarn-server\hadoop-yarn-server-resourcemanager\src\main\java\org\apache\hadoop\yarn\server\resourcemanager\scheduler\capacity\conf\LeveldbConfigurationStore.java,264,51,11,1,4,67
 hadoop-trunk\hadoop-trunk\hadoop-common-project\hadoop-common\src\test\java\org\apache\hadoop\fs\TestContentSummary.java,264,75,2,2,0,79
 hadoop-trunk\hadoop-trunk\hadoop-yarn-project\hadoop-yarn\hadoop-yarn-server\hadoop-yarn-server-sharedcachemanager\src\test\java\org\apache\hadoop\yarn\server\sharedcachemanager\store\TestInMemorySCMStore.java,264,27,2,8,4,41
 hadoop-trunk\hadoop-trunk\hadoop-yarn-project\hadoop-yarn\hadoop-yarn-server\hadoop-yarn-server-resourcemanager\src\main\java\org\apache\hadoop\yarn\server\resourcemanager\recovery\records\ApplicationAttemptStateData.java,264,47,2,3,0,52
 hadoop-trunk\hadoop-trunk\hadoop-yarn-project\hadoop-yarn\hadoop-yarn-server\hadoop-yarn-server-nodemanager\src\main\java\org\apache\hadoop\yarn\server\nodemanager\containermanager\resourceplugin\gpu\NvidiaDockerV1CommandPlugin.java,264,39,5,10,1,55
 hadoop-trunk\hadoop-trunk\hadoop-hdfs-project\hadoop-hdfs\src\main\java\org\apache\hadoop\hdfs\qjournal\server\JournalNodeRpcServer.java,264,106,27,13,6,152
 hadoop-trunk\hadoop-trunk\hadoop-hdfs-project\hadoop-hdfs\src\main\java\org\apache\hadoop\hdfs\server\datanode\DataSetLockManager.java,264,66,10,9,2,87
 kafka-trunk\kafka-trunk\clients\src\generated\java\org\apache\kafka\common\message\OffsetFetchRequestDataJsonConverter.java,264,0,0,58,0,58
 kafka-trunk\kafka-trunk\connect\runtime\src\test\java\org\apache\kafka\connect\runtime\distributed\DistributedConfigTest.java,264,0,1,60,0,61
 pulsar-master\pulsar-master\pulsar-proxy\src\test\java\org\apache\pulsar\proxy\server\ProxyTest.java,264,68,2,35,0,105
 pulsar-master\pulsar-master\pulsar-common\src\test\java\org\apache\pulsar\common\naming\TopicNameTest.java,264,42,18,37,0,97
 pulsar-master\pulsar-master\pulsar-functions\runtime\src\main\java\org\apache\pulsar\functions\runtime\thread\ThreadRuntime.java,264,99,4,36,0,139
 pulsar-master\pulsar-master\pulsar-client\src\main\java\org\apache\pulsar\client\impl\TypedMessageBuilderImpl.java,264,75,1,17,0,93
 zookeeper-master\zookeeper-master\zookeeper-server\src\test\java\org\apache\zookeeper\test\HierarchicalQuorumTest.java,264,0,20,26,1,47
 hadoop-trunk\hadoop-trunk\hadoop-tools\hadoop-azure\src\test\java\org\apache\hadoop\fs\azure\TestBlobOperationDescriptor.java,265,14,0,1,2,17
 hadoop-trunk\hadoop-trunk\hadoop-hdfs-project\hadoop-hdfs\src\test\java\org\apache\hadoop\hdfs\server\namenode\TestProcessCorruptBlocks.java,265,73,2,11,0,86
 hadoop-trunk\hadoop-trunk\hadoop-hdfs-project\hadoop-hdfs-rbf\src\test\java\org\apache\hadoop\hdfs\server\federation\router\TestRouterNamenodeHeartbeat.java,265,50,3,12,1,66
 hadoop-trunk\hadoop-trunk\hadoop-yarn-project\hadoop-yarn\hadoop-yarn-common\src\main\java\org\apache\hadoop\yarn\api\records\impl\pb\QueueStatisticsPBImpl.java,265,71,113,1,0,185
 hadoop-trunk\hadoop-trunk\hadoop-tools\hadoop-azure\src\test\java\org\apache\hadoop\fs\azurebfs\extensions\KerberizedAbfsCluster.java,265,45,10,3,4,62
 hadoop-trunk\hadoop-trunk\hadoop-tools\hadoop-aws\src\main\java\org\apache\hadoop\fs\s3a\impl\ChangeTracker.java,265,17,1,1,0,19
 kafka-trunk\kafka-trunk\connect\runtime\src\test\java\org\apache\kafka\connect\integration\SinkConnectorsIntegrationTest.java,265,0,4,36,3,43
 pulsar-master\pulsar-master\pulsar-websocket\src\main\java\org\apache\pulsar\websocket\WebSocketService.java,265,114,0,36,0,150
 zookeeper-master\zookeeper-master\zookeeper-server\src\main\java\org\apache\zookeeper\server\quorum\LeaderZooKeeperServer.java,265,0,2,21,2,25
 zookeeper-master\zookeeper-master\zookeeper-recipes\zookeeper-recipes-queue\src\main\java\org\apache\zookeeper\recipes\queue\DistributedQueue.java,265,0,23,17,0,40
 hadoop-trunk\hadoop-trunk\hadoop-hdfs-project\hadoop-hdfs\src\test\java\org\apache\hadoop\hdfs\TestFileCorruption.java,266,46,15,1,3,65
 hadoop-trunk\hadoop-trunk\hadoop-mapreduce-project\hadoop-mapreduce-client\hadoop-mapreduce-client-hs\src\main\java\org\apache\hadoop\mapreduce\v2\hs\CachedHistoryStorage.java,266,71,11,3,1,86
 hadoop-trunk\hadoop-trunk\hadoop-tools\hadoop-rumen\src\main\java\org\apache\hadoop\tools\rumen\TraceBuilder.java,266,42,24,2,7,75
 hadoop-trunk\hadoop-trunk\hadoop-common-project\hadoop-common\src\main\java\org\apache\hadoop\io\compress\bzip2\Bzip2Compressor.java,266,85,8,1,1,95
 hadoop-trunk\hadoop-trunk\hadoop-common-project\hadoop-common\src\test\java\org\apache\hadoop\metrics2\source\TestJvmMetrics.java,266,42,17,1,2,62
 hadoop-trunk\hadoop-trunk\hadoop-tools\hadoop-gridmix\src\test\java\org\apache\hadoop\mapred\gridmix\DebugJobProducer.java,266,93,26,2,3,124
 hadoop-trunk\hadoop-trunk\hadoop-hdfs-project\hadoop-hdfs-nfs\src\test\java\org\apache\hadoop\hdfs\nfs\nfs3\TestViewfsWithNfs3.java,266,50,18,1,3,72
 hadoop-trunk\hadoop-trunk\hadoop-mapreduce-project\hadoop-mapreduce-client\hadoop-mapreduce-client-jobclient\src\test\java\org\apache\hadoop\mapreduce\lib\join\TestJoinTupleWritable.java,266,106,5,1,12,124
 hadoop-trunk\hadoop-trunk\hadoop-tools\hadoop-azure-datalake\src\test\java\org\apache\hadoop\fs\adl\TestAzureADTokenProvider.java,266,25,15,1,6,47
 hadoop-trunk\hadoop-trunk\hadoop-yarn-project\hadoop-yarn\hadoop-yarn-applications\hadoop-yarn-services\hadoop-yarn-services-core\src\test\java\org\apache\hadoop\yarn\service\client\TestServiceClient.java,266,25,34,6,0,65
 hadoop-trunk\hadoop-trunk\hadoop-yarn-project\hadoop-yarn\hadoop-yarn-server\hadoop-yarn-server-timelineservice\src\main\java\org\apache\hadoop\yarn\server\timelineservice\collector\TimelineCollectorWebService.java,266,33,4,3,0,40
 hadoop-trunk\hadoop-trunk\hadoop-tools\hadoop-azure\src\test\java\org\apache\hadoop\fs\azure\ITestNativeAzureFileSystemLive.java,266,16,2,7,2,27
 hadoop-trunk\hadoop-trunk\hadoop-yarn-project\hadoop-yarn\hadoop-yarn-server\hadoop-yarn-server-resourcemanager\src\main\java\org\apache\hadoop\yarn\server\resourcemanager\scheduler\capacity\CSQueueMetrics.java,266,123,0,3,1,127
 kafka-trunk\kafka-trunk\connect\mirror\src\test\java\org\apache\kafka\connect\mirror\MirrorSourceConnectorTest.java,266,0,2,95,0,97
 kafka-trunk\kafka-trunk\streams\src\test\java\org\apache\kafka\streams\state\internals\SessionStoreFetchTest.java,266,0,17,41,11,69
 kafka-trunk\kafka-trunk\clients\src\main\java\org\apache\kafka\clients\admin\ConfigEntry.java,266,0,4,20,2,26
 pulsar-master\pulsar-master\pulsar-broker\src\test\java\org\apache\pulsar\client\impl\LookupRetryTest.java,266,89,4,36,0,129
 pulsar-master\pulsar-master\pulsar-common\src\main\java\org\apache\pulsar\common\tls\TlsHostnameVerifier.java,266,38,9,24,0,71
 rocketmq-develop\rocketmq-develop\client\src\test\java\org\apache\rocketmq\client\consumer\DefaultMQPushConsumerTest.java,266,100,8,43,7,158
 zookeeper-master\zookeeper-master\zookeeper-server\src\test\java\org\apache\zookeeper\server\BlueThrottleTest.java,266,0,1,30,0,31
 zookeeper-master\zookeeper-master\zookeeper-server\src\test\java\org\apache\zookeeper\server\quorum\ReconfigLegacyTest.java,266,0,5,23,1,29
 hadoop-trunk\hadoop-trunk\hadoop-hdfs-project\hadoop-hdfs\src\main\java\org\apache\hadoop\hdfs\util\LightWeightLinkedSet.java,267,21,1,1,1,24
 hadoop-trunk\hadoop-trunk\hadoop-tools\hadoop-aws\src\test\java\org\apache\hadoop\fs\s3a\auth\ITestCustomSigner.java,267,51,5,4,2,62
 hadoop-trunk\hadoop-trunk\hadoop-tools\hadoop-aws\src\test\java\org\apache\hadoop\fs\s3a\TestSSEConfiguration.java,267,42,13,1,1,57
 hadoop-trunk\hadoop-trunk\hadoop-hdfs-project\hadoop-hdfs\src\test\java\org\apache\hadoop\hdfs\TestErasureCodingPolicyWithSnapshot.java,267,22,2,2,1,27
 hadoop-trunk\hadoop-trunk\hadoop-yarn-project\hadoop-yarn\hadoop-yarn-server\hadoop-yarn-server-timelineservice-hbase\hadoop-yarn-server-timelineservice-hbase-common\src\test\java\org\apache\hadoop\yarn\server\timelineservice\storage\common\TestRowKeys.java,267,45,1,10,0,56
 hadoop-trunk\hadoop-trunk\hadoop-hdfs-project\hadoop-hdfs\src\test\java\org\apache\hadoop\hdfs\server\diskbalancer\TestDiskBalancerRPC.java,267,30,11,5,4,50
 hadoop-trunk\hadoop-trunk\hadoop-common-project\hadoop-common\src\test\java\org\apache\hadoop\io\compress\TestCodecFactory.java,267,40,5,1,0,46
 kafka-trunk\kafka-trunk\clients\src\test\java\org\apache\kafka\clients\producer\internals\ProducerMetadataTest.java,267,0,4,50,0,54
 kafka-trunk\kafka-trunk\raft\src\test\java\org\apache\kafka\raft\LeaderStateTest.java,267,0,7,43,3,53
 hadoop-trunk\hadoop-trunk\hadoop-yarn-project\hadoop-yarn\hadoop-yarn-server\hadoop-yarn-server-resourcemanager\src\main\java\org\apache\hadoop\yarn\server\resourcemanager\scheduler\ResourceUsage.java,268,183,1,1,0,185
 hadoop-trunk\hadoop-trunk\hadoop-yarn-project\hadoop-yarn\hadoop-yarn-server\hadoop-yarn-server-resourcemanager\src\main\java\org\apache\hadoop\yarn\server\resourcemanager\scheduler\fair\converter\FSQueueConverter.java,268,46,4,23,3,76
 hadoop-trunk\hadoop-trunk\hadoop-yarn-project\hadoop-yarn\hadoop-yarn-server\hadoop-yarn-server-timelineservice-hbase\hadoop-yarn-server-timelineservice-hbase-common\src\main\java\org\apache\hadoop\yarn\server\timelineservice\storage\entity\EntityRowKey.java,268,63,1,5,0,69
 hadoop-trunk\hadoop-trunk\hadoop-hdfs-project\hadoop-hdfs\src\test\java\org\apache\hadoop\hdfs\server\namenode\TestMetaSave.java,268,44,35,4,20,103
 hadoop-trunk\hadoop-trunk\hadoop-hdfs-project\hadoop-hdfs\src\test\java\org\apache\hadoop\hdfs\web\TestWebHDFSForHA.java,268,19,6,7,6,38
 hadoop-trunk\hadoop-trunk\hadoop-tools\hadoop-aws\src\test\java\org\apache\hadoop\fs\s3a\audit\TestHttpReferrerAuditHeader.java,268,7,4,4,1,16
 hadoop-trunk\hadoop-trunk\hadoop-mapreduce-project\hadoop-mapreduce-client\hadoop-mapreduce-client-jobclient\src\test\java\org\apache\hadoop\fs\slive\SliveTest.java,268,38,9,2,6,55
 kafka-trunk\kafka-trunk\jmh-benchmarks\src\main\java\org\apache\kafka\jmh\fetcher\ReplicaFetcherThreadBenchmark.java,268,0,3,41,1,45
 pulsar-master\pulsar-master\pulsar-broker\src\test\java\org\apache\pulsar\common\naming\NamespaceBundlesTest.java,268,96,11,56,0,163
 pulsar-master\pulsar-master\pulsar-broker\src\test\java\org\apache\pulsar\broker\admin\TopicPoliciesDisableTest.java,268,73,2,39,0,114
 dubbo-3.0\dubbo-3.0\dubbo-common\src\main\java\org\apache\dubbo\common\config\configcenter\AbstractDynamicConfiguration.java,269,107,2,27,0,136
 hadoop-trunk\hadoop-trunk\hadoop-hdfs-project\hadoop-hdfs\src\test\java\org\apache\hadoop\hdfs\server\namenode\TestNameNodeRespectsBindHostKeys.java,269,40,20,5,0,65
 hadoop-trunk\hadoop-trunk\hadoop-tools\hadoop-distcp\src\main\java\org\apache\hadoop\tools\OptionsParser.java,269,25,4,4,0,33
 hadoop-trunk\hadoop-trunk\hadoop-hdfs-project\hadoop-hdfs-nfs\src\test\java\org\apache\hadoop\hdfs\nfs\nfs3\TestExportsTable.java,269,11,13,1,0,25
 hadoop-trunk\hadoop-trunk\hadoop-common-project\hadoop-common\src\test\java\org\apache\hadoop\fs\TestFileStatus.java,269,92,9,7,0,108
 hadoop-trunk\hadoop-trunk\hadoop-mapreduce-project\hadoop-mapreduce-client\hadoop-mapreduce-client-app\src\test\java\org\apache\hadoop\mapreduce\v2\app\TestCheckpointPreemptionPolicy.java,269,75,7,7,0,89
 hadoop-trunk\hadoop-trunk\hadoop-common-project\hadoop-common\src\main\java\org\apache\hadoop\io\compress\zstd\ZStandardCompressor.java,269,54,7,2,2,65
 kafka-trunk\kafka-trunk\trogdor\src\main\java\org\apache\kafka\trogdor\agent\AgentClient.java,269,0,5,15,6,26
 kafka-trunk\kafka-trunk\metadata\src\generated\java\org\apache\kafka\common\metadata\ConfigRecord.java,269,0,0,25,5,30
 kafka-trunk\kafka-trunk\streams\src\test\java\org\apache\kafka\streams\integration\RocksDBMetricsIntegrationTest.java,269,0,2,61,0,63
 pulsar-master\pulsar-master\pulsar-io\kafka-connect-adaptor\src\main\java\org\apache\pulsar\io\kafka\connect\KafkaConnectSink.java,269,68,3,28,0,99
 rocketmq-develop\rocketmq-develop\tools\src\main\java\org\apache\rocketmq\tools\monitor\MonitorService.java,269,63,21,32,17,133
 zookeeper-master\zookeeper-master\zookeeper-server\src\test\java\org\apache\zookeeper\server\admin\JettyAdminServerTest.java,269,0,13,32,13,58
 hadoop-trunk\hadoop-trunk\hadoop-yarn-project\hadoop-yarn\hadoop-yarn-common\src\main\java\org\apache\hadoop\yarn\util\Apps.java,270,67,2,3,0,72
 hadoop-trunk\hadoop-trunk\hadoop-yarn-project\hadoop-yarn\hadoop-yarn-server\hadoop-yarn-server-timeline-pluginstorage\src\main\java\org\apache\hadoop\yarn\server\timeline\LevelDBCacheTimelineStore.java,270,36,8,1,0,45
 hadoop-trunk\hadoop-trunk\hadoop-tools\hadoop-dynamometer\hadoop-dynamometer-workload\src\main\java\org\apache\hadoop\tools\dynamometer\workloadgenerator\audit\AuditReplayThread.java,270,22,10,7,1,40
 hadoop-trunk\hadoop-trunk\hadoop-hdfs-project\hadoop-hdfs\src\test\java\org\apache\hadoop\hdfs\server\blockmanagement\TestSortLocatedBlock.java,270,68,9,1,0,78
 hadoop-trunk\hadoop-trunk\hadoop-yarn-project\hadoop-yarn\hadoop-yarn-server\hadoop-yarn-server-resourcemanager\src\test\java\org\apache\hadoop\yarn\server\resourcemanager\scheduler\capacity\TestQueueConfigurationAutoRefreshPolicy.java,270,39,0,1,1,41
 kafka-trunk\kafka-trunk\connect\runtime\src\test\java\org\apache\kafka\connect\integration\TransformationIntegrationTest.java,270,0,0,54,0,54
 pulsar-master\pulsar-master\pulsar-broker\src\test\java\org\apache\pulsar\broker\service\persistent\PersistentSubscriptionTest.java,270,119,7,59,0,185
 pulsar-master\pulsar-master\pulsar-broker\src\test\java\org\apache\pulsar\broker\service\RackAwareTest.java,270,50,12,28,0,90
 zookeeper-master\zookeeper-master\zookeeper-server\src\test\java\org\apache\zookeeper\RemoveWatchesCmdTest.java,270,0,26,33,0,59
 hadoop-trunk\hadoop-trunk\hadoop-hdfs-project\hadoop-hdfs\src\test\java\org\apache\hadoop\hdfs\server\datanode\fsdataset\impl\TestPmemCacheRecovery.java,271,38,21,1,16,76
 hadoop-trunk\hadoop-trunk\hadoop-common-project\hadoop-common\src\main\java\org\apache\hadoop\ha\HealthMonitor.java,271,65,14,2,1,82
 hadoop-trunk\hadoop-trunk\hadoop-common-project\hadoop-common\src\test\java\org\apache\hadoop\fs\TestHardLink.java,271,91,24,1,15,131
 kafka-trunk\kafka-trunk\tools\src\main\java\org\apache\kafka\tools\OAuthCompatibilityTool.java,271,0,8,104,4,116
 kafka-trunk\kafka-trunk\streams\src\test\java\org\apache\kafka\streams\integration\SuppressionDurabilityIntegrationTest.java,271,0,3,44,0,47
 kafka-trunk\kafka-trunk\streams\src\test\java\org\apache\kafka\streams\kstream\internals\TimeWindowedKStreamImplTest.java,271,0,6,56,10,72
 kafka-trunk\kafka-trunk\streams\src\test\java\org\apache\kafka\streams\kstream\internals\TimeWindowedCogroupedKStreamImplTest.java,271,0,7,57,8,72
 kafka-trunk\kafka-trunk\clients\src\main\java\org\apache\kafka\common\serialization\Serdes.java,271,0,13,11,0,24
 pulsar-master\pulsar-master\pulsar-broker\src\main\java\org\apache\pulsar\broker\service\AbstractBaseDispatcher.java,271,113,2,50,0,165
 zookeeper-master\zookeeper-master\zookeeper-contrib\zookeeper-contrib-zooinspector\src\main\java\org\apache\zookeeper\inspector\gui\ZooInspectorConnectionPropertiesDialog.java,271,0,6,10,5,21
 hadoop-trunk\hadoop-trunk\hadoop-hdfs-project\hadoop-hdfs\src\test\java\org\apache\hadoop\hdfs\TestDFSStripedOutputStream.java,272,60,12,2,4,78
 hadoop-trunk\hadoop-trunk\hadoop-yarn-project\hadoop-yarn\hadoop-yarn-server\hadoop-yarn-server-nodemanager\src\test\java\org\apache\hadoop\yarn\server\nodemanager\containermanager\linux\resources\TestCGroupElasticMemoryController.java,272,23,1,6,6,36
 hadoop-trunk\hadoop-trunk\hadoop-tools\hadoop-aws\src\test\java\org\apache\hadoop\fs\s3a\impl\TestHeaderProcessing.java,272,19,3,3,0,25
 hadoop-trunk\hadoop-trunk\hadoop-hdfs-project\hadoop-hdfs\src\test\java\org\apache\hadoop\hdfs\server\namenode\TestFSNamesystem.java,272,58,23,4,1,86
 kafka-trunk\kafka-trunk\streams\src\test\java\org\apache\kafka\streams\kstream\internals\KTableMapValuesTest.java,272,0,4,47,1,52
 kafka-trunk\kafka-trunk\clients\src\test\java\org\apache\kafka\common\requests\ProduceRequestTest.java,272,0,0,72,15,87
 pulsar-master\pulsar-master\pulsar-websocket\src\main\java\org\apache\pulsar\websocket\ProducerHandler.java,272,93,10,55,0,158
 hadoop-trunk\hadoop-trunk\hadoop-common-project\hadoop-common\src\test\java\org\apache\hadoop\service\launcher\AbstractServiceLauncherTestBase.java,273,45,4,2,1,52
 hadoop-trunk\hadoop-trunk\hadoop-yarn-project\hadoop-yarn\hadoop-yarn-common\src\main\java\org\apache\hadoop\yarn\api\records\impl\pb\SchedulingRequestPBImpl.java,273,61,72,1,0,134
 hadoop-trunk\hadoop-trunk\hadoop-common-project\hadoop-common\src\test\java\org\apache\hadoop\fs\TestChecksumFileSystem.java,273,111,15,4,10,140
 hadoop-trunk\hadoop-trunk\hadoop-mapreduce-project\hadoop-mapreduce-client\hadoop-mapreduce-client-hs\src\test\java\org\apache\hadoop\mapreduce\v2\hs\TestUnnecessaryBlockingOnHistoryFileInfo.java,273,45,1,1,2,49
 hadoop-trunk\hadoop-trunk\hadoop-mapreduce-project\hadoop-mapreduce-client\hadoop-mapreduce-client-app\src\test\java\org\apache\hadoop\mapreduce\v2\app\TestFail.java,273,70,6,4,3,83
 hadoop-trunk\hadoop-trunk\hadoop-yarn-project\hadoop-yarn\hadoop-yarn-common\src\main\java\org\apache\hadoop\yarn\api\protocolrecords\impl\pb\StartContainersResponsePBImpl.java,273,45,79,5,0,129
 hadoop-trunk\hadoop-trunk\hadoop-tools\hadoop-aws\src\main\java\org\apache\hadoop\fs\s3a\AWSCredentialProviderList.java,273,20,6,1,0,27
 hadoop-trunk\hadoop-trunk\hadoop-common-project\hadoop-common\src\test\java\org\apache\hadoop\util\TestShutdownHookManager.java,273,31,0,3,1,35
 kafka-trunk\kafka-trunk\tools\src\main\java\org\apache\kafka\tools\PushHttpMetricsReporter.java,273,0,6,31,0,37
 pulsar-master\pulsar-master\pulsar-client-admin\src\main\java\org\apache\pulsar\client\admin\internal\http\AsyncHttpConnector.java,273,80,2,41,0,123
 rocketmq-develop\rocketmq-develop\common\src\main\java\org\apache\rocketmq\common\Configuration.java,273,61,7,8,4,80
 skywalking-master\skywalking-master\oap-server\server-core\src\main\java\org\apache\skywalking\oap\server\core\analysis\IDManager.java,273,79,5,30,0,114
 dubbo-3.0\dubbo-3.0\dubbo-cluster\src\test\java\org\apache\dubbo\rpc\cluster\support\ConnectivityValidationTest.java,274,64,0,18,0,82
 hadoop-trunk\hadoop-trunk\hadoop-yarn-project\hadoop-yarn\hadoop-yarn-server\hadoop-yarn-server-nodemanager\src\main\java\org\apache\hadoop\yarn\server\nodemanager\webapp\ContainerLogsPage.java,274,41,10,4,7,62
 hadoop-trunk\hadoop-trunk\hadoop-yarn-project\hadoop-yarn\hadoop-yarn-server\hadoop-yarn-server-resourcemanager\src\test\java\org\apache\hadoop\yarn\server\resourcemanager\applicationsmanager\TestAMRMRPCNodeUpdates.java,274,45,0,3,1,49
 kafka-trunk\kafka-trunk\clients\src\test\java\org\apache\kafka\common\record\FileLogInputStreamTest.java,274,0,11,45,15,71
 kafka-trunk\kafka-trunk\clients\src\test\java\org\apache\kafka\clients\admin\internals\DescribeProducersHandlerTest.java,274,0,0,40,0,40
 kafka-trunk\kafka-trunk\streams\src\main\java\org\apache\kafka\streams\state\internals\RocksDBTimeOrderedSegmentedBytesStore.java,274,0,0,58,0,58
 pulsar-master\pulsar-master\pulsar-metadata\src\main\java\org\apache\pulsar\metadata\bookkeeper\BKCluster.java,274,64,6,21,0,91
 pulsar-master\pulsar-master\pulsar-websocket\src\main\java\org\apache\pulsar\websocket\ReaderHandler.java,274,83,15,46,0,144
 rocketmq-develop\rocketmq-develop\tools\src\main\java\org\apache\rocketmq\tools\command\message\ConsumeMessageCommand.java,274,51,0,27,7,85
 zookeeper-master\zookeeper-master\zookeeper-server\src\test\java\org\apache\zookeeper\server\quorum\WatchLeakTest.java,274,0,24,17,0,41
 hadoop-trunk\hadoop-trunk\hadoop-yarn-project\hadoop-yarn\hadoop-yarn-server\hadoop-yarn-server-resourcemanager\src\main\java\org\apache\hadoop\yarn\server\resourcemanager\reservation\CapacityOverTimePolicy.java,275,39,6,5,1,51
 hadoop-trunk\hadoop-trunk\hadoop-hdfs-project\hadoop-hdfs-client\src\main\java\org\apache\hadoop\hdfs\protocol\datatransfer\PacketReceiver.java,275,43,1,3,3,50
 hadoop-trunk\hadoop-trunk\hadoop-yarn-project\hadoop-yarn\hadoop-yarn-server\hadoop-yarn-server-nodemanager\src\main\java\org\apache\hadoop\yarn\server\nodemanager\containermanager\linux\resources\gpu\GpuResourceAllocator.java,275,45,3,6,1,55
 hadoop-trunk\hadoop-trunk\hadoop-yarn-project\hadoop-yarn\hadoop-yarn-server\hadoop-yarn-server-resourcemanager\src\test\java\org\apache\hadoop\yarn\server\resourcemanager\scheduler\fair\TestFSQueueMetrics.java,275,106,0,1,0,107
 hadoop-trunk\hadoop-trunk\hadoop-yarn-project\hadoop-yarn\hadoop-yarn-server\hadoop-yarn-server-resourcemanager\src\main\java\org\apache\hadoop\yarn\server\resourcemanager\scheduler\capacity\CSQueueUtils.java,275,61,9,9,0,79
 kafka-trunk\kafka-trunk\connect\runtime\src\test\java\org\apache\kafka\connect\integration\InternalTopicsIntegrationTest.java,275,0,0,74,0,74
 pulsar-master\pulsar-master\pulsar-broker\src\main\java\org\apache\pulsar\broker\namespace\OwnershipCache.java,275,86,7,50,0,143
 skywalking-master\skywalking-master\oap-server\server-storage-plugin\storage-jdbc-hikaricp-plugin\src\main\java\org\apache\skywalking\oap\server\storage\plugin\jdbc\h2\dao\H2MetadataQueryDAO.java,275,74,6,46,0,126
 dubbo-3.0\dubbo-3.0\dubbo-config\dubbo-config-spring\src\test\java\org\apache\dubbo\config\spring\reference\ReferenceKeyTest.java,276,157,4,72,0,233
 hadoop-trunk\hadoop-trunk\hadoop-mapreduce-project\hadoop-mapreduce-client\hadoop-mapreduce-client-core\src\test\java\org\apache\hadoop\mapreduce\task\reduce\TestMergeManager.java,276,69,22,5,13,109
 hadoop-trunk\hadoop-trunk\hadoop-mapreduce-project\hadoop-mapreduce-client\hadoop-mapreduce-client-jobclient\src\test\java\org\apache\hadoop\mapred\MRCaching.java,276,93,24,4,11,132
 hadoop-trunk\hadoop-trunk\hadoop-common-project\hadoop-common\src\main\java\org\apache\hadoop\metrics2\sink\ganglia\AbstractGangliaSink.java,276,77,11,3,1,92
 hadoop-trunk\hadoop-trunk\hadoop-tools\hadoop-distcp\src\test\java\org\apache\hadoop\tools\TestDistCpWithAcls.java,276,88,14,1,0,103
 hadoop-trunk\hadoop-trunk\hadoop-yarn-project\hadoop-yarn\hadoop-yarn-common\src\test\java\org\apache\hadoop\yarn\api\records\timelineservice\TestTimelineServiceRecords.java,276,19,20,1,10,50
 hadoop-trunk\hadoop-trunk\hadoop-yarn-project\hadoop-yarn\hadoop-yarn-server\hadoop-yarn-server-resourcemanager\src\main\java\org\apache\hadoop\yarn\server\resourcemanager\monitor\capacity\IntraQueueCandidatesSelector.java,276,37,4,9,0,50
 hadoop-trunk\hadoop-trunk\hadoop-yarn-project\hadoop-yarn\hadoop-yarn-server\hadoop-yarn-server-router\src\test\java\org\apache\hadoop\yarn\server\router\webapp\TestRouterWebServices.java,276,8,1,8,0,17
 kafka-trunk\kafka-trunk\streams\src\test\java\org\apache\kafka\streams\processor\internals\assignment\TaskMovementTest.java,276,0,0,84,0,84
 kafka-trunk\kafka-trunk\connect\mirror\src\main\java\org\apache\kafka\connect\mirror\MirrorCheckpointTask.java,276,0,8,56,0,64
 pulsar-master\pulsar-master\pulsar-functions\instance\src\test\java\org\apache\pulsar\functions\instance\ContextImplTest.java,276,61,23,32,0,116
 skywalking-master\skywalking-master\oap-server\server-receiver-plugin\envoy-metrics-receiver-plugin\src\main\java\org\apache\skywalking\oap\server\receiver\envoy\als\k8s\K8SServiceRegistry.java,276,60,1,30,0,91
 dubbo-3.0\dubbo-3.0\dubbo-metadata\dubbo-metadata-report-zookeeper\src\test\java\org\apache\dubbo\metadata\store\zookeeper\ZookeeperMetadataReportTest.java,277,119,8,72,0,199
 hadoop-trunk\hadoop-trunk\hadoop-hdfs-project\hadoop-hdfs\src\test\java\org\apache\hadoop\hdfs\TestClientReportBadBlock.java,277,65,4,7,9,85
 hadoop-trunk\hadoop-trunk\hadoop-hdfs-project\hadoop-hdfs-rbf\src\test\java\org\apache\hadoop\hdfs\server\federation\router\TestConnectionManager.java,277,88,3,1,1,93
 hadoop-trunk\hadoop-trunk\hadoop-hdfs-project\hadoop-hdfs-client\src\main\java\org\apache\hadoop\hdfs\util\ECPolicyLoader.java,277,12,7,1,0,20
 hadoop-trunk\hadoop-trunk\hadoop-hdfs-project\hadoop-hdfs-rbf\src\main\java\org\apache\hadoop\hdfs\server\federation\metrics\FederationRPCMetrics.java,277,83,1,8,1,93
 hadoop-trunk\hadoop-trunk\hadoop-mapreduce-project\hadoop-mapreduce-client\hadoop-mapreduce-client-jobclient\src\test\java\org\apache\hadoop\mapred\TestTaskCommit.java,277,72,7,3,1,83
 kafka-trunk\kafka-trunk\streams\src\test\java\org\apache\kafka\streams\tools\StreamsResetterTest.java,277,0,1,47,0,48
 dubbo-3.0\dubbo-3.0\dubbo-common\src\test\java\org\apache\dubbo\common\extension\ExtensionLoader_Adaptive_Test.java,278,88,28,42,11,169
 hadoop-trunk\hadoop-trunk\hadoop-yarn-project\hadoop-yarn\hadoop-yarn-server\hadoop-yarn-server-resourcemanager\src\main\java\org\apache\hadoop\yarn\server\resourcemanager\security\AMRMTokenSecretManager.java,278,51,6,5,3,65
 hadoop-trunk\hadoop-trunk\hadoop-yarn-project\hadoop-yarn\hadoop-yarn-common\src\test\java\org\apache\hadoop\yarn\util\resource\TestResources.java,278,149,6,4,1,160
 hadoop-trunk\hadoop-trunk\hadoop-yarn-project\hadoop-yarn\hadoop-yarn-server\hadoop-yarn-server-nodemanager\src\main\java\org\apache\hadoop\yarn\server\nodemanager\containermanager\linux\resources\NetworkTagMappingJsonManager.java,278,96,5,3,5,109
 hadoop-trunk\hadoop-trunk\hadoop-common-project\hadoop-common\src\test\java\org\apache\hadoop\util\TestMachineList.java,278,59,73,4,1,137
 hadoop-trunk\hadoop-trunk\hadoop-common-project\hadoop-common\src\main\java\org\apache\hadoop\metrics2\util\SampleQuantiles.java,278,52,4,1,1,58
 hadoop-trunk\hadoop-trunk\hadoop-yarn-project\hadoop-yarn\hadoop-yarn-server\hadoop-yarn-server-applicationhistoryservice\src\main\java\org\apache\hadoop\yarn\server\applicationhistoryservice\ApplicationHistoryServer.java,278,40,7,6,1,54
 pulsar-master\pulsar-master\pulsar-broker-auth-sasl\src\test\java\org\apache\pulsar\broker\authentication\MiniKdc.java,278,54,7,14,0,75
 pulsar-master\pulsar-master\pulsar-io\file\src\test\java\org\apache\pulsar\io\file\ProcessedFileThreadTests.java,278,82,2,34,0,118
 rocketmq-develop\rocketmq-develop\filter\src\main\java\org\apache\rocketmq\filter\util\BloomFilter.java,278,89,11,14,0,114
 hadoop-trunk\hadoop-trunk\hadoop-hdfs-project\hadoop-hdfs\src\test\java\org\apache\hadoop\hdfs\server\datanode\fsdataset\impl\TestLazyPersistFiles.java,279,44,18,2,0,64
 hadoop-trunk\hadoop-trunk\hadoop-hdfs-project\hadoop-hdfs-client\src\test\java\org\apache\hadoop\hdfs\util\TestECPolicyLoader.java,279,10,6,1,6,23
 hadoop-trunk\hadoop-trunk\hadoop-tools\hadoop-aliyun\src\main\java\org\apache\hadoop\fs\aliyun\oss\AliyunOSSInputStream.java,279,53,2,3,6,64
 hadoop-trunk\hadoop-trunk\hadoop-tools\hadoop-aws\src\main\java\org\apache\hadoop\fs\s3a\InconsistentAmazonS3Client.java,279,54,8,2,0,64
 hadoop-trunk\hadoop-trunk\hadoop-yarn-project\hadoop-yarn\hadoop-yarn-server\hadoop-yarn-server-nodemanager\src\test\java\org\apache\hadoop\yarn\server\nodemanager\containermanager\linux\resources\TestTrafficController.java,279,47,8,9,1,65
 hadoop-trunk\hadoop-trunk\hadoop-mapreduce-project\hadoop-mapreduce-client\hadoop-mapreduce-client-jobclient\src\test\java\org\apache\hadoop\mapreduce\v2\TestSpeculativeExecutionWithMRApp.java,279,43,0,4,1,48
 pulsar-master\pulsar-master\pulsar-broker\src\main\java\org\apache\pulsar\broker\admin\v2\Functions.java,279,160,3,79,0,242
 rocketmq-develop\rocketmq-develop\store\src\main\java\org\apache\rocketmq\store\AllocateMappedFileService.java,279,95,25,39,2,161
 zookeeper-master\zookeeper-master\zookeeper-server\src\main\java\org\apache\zookeeper\server\watch\WatchManager.java,279,0,0,18,0,18
 hadoop-trunk\hadoop-trunk\hadoop-yarn-project\hadoop-yarn\hadoop-yarn-server\hadoop-yarn-server-resourcemanager\src\main\java\org\apache\hadoop\yarn\server\resourcemanager\reservation\ReservationInputValidator.java,280,37,2,2,0,41
 hadoop-trunk\hadoop-trunk\hadoop-common-project\hadoop-common\src\test\java\org\apache\hadoop\metrics2\impl\TestMetricsSourceAdapter.java,280,52,8,2,1,63
 hadoop-trunk\hadoop-trunk\hadoop-tools\hadoop-aws\src\test\java\org\apache\hadoop\fs\contract\s3a\ITestS3AContractSeek.java,280,28,0,4,1,33
 hadoop-trunk\hadoop-trunk\hadoop-yarn-project\hadoop-yarn\hadoop-yarn-common\src\main\java\org\apache\hadoop\yarn\util\resource\ResourceCalculator.java,280,56,0,1,0,57
 hadoop-trunk\hadoop-trunk\hadoop-yarn-project\hadoop-yarn\hadoop-yarn-server\hadoop-yarn-server-router\src\test\java\org\apache\hadoop\yarn\server\router\rmadmin\BaseRouterRMAdminTest.java,280,40,14,25,0,79
 hadoop-trunk\hadoop-trunk\hadoop-hdfs-project\hadoop-hdfs-rbf\src\main\java\org\apache\hadoop\hdfs\server\federation\store\driver\impl\StateStoreZooKeeperImpl.java,280,33,6,3,0,42
 pulsar-master\pulsar-master\pulsar-metadata\src\main\java\org\apache\pulsar\metadata\coordination\impl\ResourceLockImpl.java,280,70,13,34,0,117
 hadoop-trunk\hadoop-trunk\hadoop-tools\hadoop-aws\src\test\java\org\apache\hadoop\fs\s3a\tools\AbstractMarkerToolTest.java,281,24,3,4,4,35
 hadoop-trunk\hadoop-trunk\hadoop-hdfs-project\hadoop-hdfs-rbf\src\test\java\org\apache\hadoop\hdfs\server\federation\router\TestRouterMountTableCacheRefreshSecure.java,281,13,1,11,0,25
 hadoop-trunk\hadoop-trunk\hadoop-yarn-project\hadoop-yarn\hadoop-yarn-server\hadoop-yarn-server-resourcemanager\src\test\java\org\apache\hadoop\yarn\server\resourcemanager\webapp\TestRMWebServicesCapacitySchedDynamicConfig.java,281,46,1,34,0,81
 hadoop-trunk\hadoop-trunk\hadoop-yarn-project\hadoop-yarn\hadoop-yarn-server\hadoop-yarn-server-nodemanager\src\test\java\org\apache\hadoop\yarn\server\nodemanager\containermanager\linux\resources\TestCGroupsCpuResourceHandlerImpl.java,281,30,5,4,2,41
 hadoop-trunk\hadoop-trunk\hadoop-common-project\hadoop-auth\src\main\java\org\apache\hadoop\security\authentication\server\LdapAuthenticationHandler.java,281,31,5,1,2,39
 zookeeper-master\zookeeper-master\zookeeper-server\src\main\java\org\apache\zookeeper\server\persistence\SnapStream.java,281,0,10,15,0,25
 dubbo-3.0\dubbo-3.0\dubbo-config\dubbo-config-spring\src\test\java\org\apache\dubbo\config\spring\beans\factory\annotation\ReferenceAnnotationBeanPostProcessorTest.java,282,104,1,60,0,165
 dubbo-3.0\dubbo-3.0\dubbo-rpc\dubbo-rpc-dubbo\src\test\java\org\apache\dubbo\rpc\protocol\dubbo\ReferenceCountExchangeClientTest.java,282,109,9,52,0,170
 hadoop-trunk\hadoop-trunk\hadoop-tools\hadoop-rumen\src\main\java\org\apache\hadoop\tools\rumen\state\StatePool.java,282,111,8,3,6,128
 hadoop-trunk\hadoop-trunk\hadoop-common-project\hadoop-common\src\test\java\org\apache\hadoop\io\erasurecode\coder\TestErasureCoderBase.java,282,46,0,4,7,57
 hadoop-trunk\hadoop-trunk\hadoop-yarn-project\hadoop-yarn\hadoop-yarn-common\src\main\java\org\apache\hadoop\yarn\api\records\impl\pb\ApplicationAttemptReportPBImpl.java,282,64,94,4,0,162
 hadoop-trunk\hadoop-trunk\hadoop-mapreduce-project\hadoop-mapreduce-client\hadoop-mapreduce-client-app\src\test\java\org\apache\hadoop\mapreduce\v2\app\webapp\TestAppController.java,282,31,3,16,0,50
 hadoop-trunk\hadoop-trunk\hadoop-yarn-project\hadoop-yarn\hadoop-yarn-server\hadoop-yarn-server-resourcemanager\src\main\java\org\apache\hadoop\yarn\server\resourcemanager\scheduler\constraint\TargetApplicationsNamespace.java,282,37,2,5,4,48
 hadoop-trunk\hadoop-trunk\hadoop-mapreduce-project\hadoop-mapreduce-client\hadoop-mapreduce-client-jobclient\src\test\java\org\apache\hadoop\mapred\TestMRCJCFileInputFormat.java,282,113,13,3,3,132
 kafka-trunk\kafka-trunk\connect\runtime\src\main\java\org\apache\kafka\connect\runtime\errors\RetryWithToleranceOperator.java,282,0,2,36,0,38
 kafka-trunk\kafka-trunk\clients\src\generated\java\org\apache\kafka\common\message\DescribeGroupsRequestData.java,282,0,0,31,3,34
 pulsar-master\pulsar-master\pulsar-common\src\test\java\org\apache\pulsar\common\policies\data\OffloadPoliciesTest.java,282,123,4,90,0,217
 pulsar-master\pulsar-master\pulsar-functions\worker\src\main\java\org\apache\pulsar\functions\worker\rest\api\v2\FunctionsApiV2Resource.java,282,163,3,81,0,247
 hadoop-trunk\hadoop-trunk\hadoop-mapreduce-project\hadoop-mapreduce-examples\src\main\java\org\apache\hadoop\examples\pi\Util.java,283,234,32,19,1,286
 hadoop-trunk\hadoop-trunk\hadoop-common-project\hadoop-common\src\test\java\org\apache\hadoop\crypto\key\TestValueQueue.java,283,117,3,2,0,122
 hadoop-trunk\hadoop-trunk\hadoop-hdfs-project\hadoop-hdfs\src\main\java\org\apache\hadoop\hdfs\server\blockmanagement\BlockInfoStriped.java,283,59,1,4,1,65
 hadoop-trunk\hadoop-trunk\hadoop-mapreduce-project\hadoop-mapreduce-client\hadoop-mapreduce-client-jobclient\src\test\java\org\apache\hadoop\mapred\TestJobCleanup.java,283,49,8,3,0,60
 kafka-trunk\kafka-trunk\clients\src\main\java\org\apache\kafka\common\requests\AbstractRequest.java,283,0,4,20,0,24
 kafka-trunk\kafka-trunk\connect\runtime\src\test\java\org\apache\kafka\connect\integration\ConnectWorkerIntegrationTest.java,283,0,0,56,0,56
 zookeeper-master\zookeeper-master\zookeeper-server\src\test\java\org\apache\zookeeper\server\quorum\ReconfigBackupTest.java,283,0,6,39,3,48
 dubbo-3.0\dubbo-3.0\dubbo-plugin\dubbo-qos\src\test\java\org\apache\dubbo\qos\legacy\service\generic\GenericServiceTest.java,284,59,5,34,0,98
 hadoop-trunk\hadoop-trunk\hadoop-mapreduce-project\hadoop-mapreduce-client\hadoop-mapreduce-client-common\src\test\java\org\apache\hadoop\mapred\TestLocalDistributedCacheManager.java,284,80,4,11,9,104
 hadoop-trunk\hadoop-trunk\hadoop-yarn-project\hadoop-yarn\hadoop-yarn-common\src\test\java\org\apache\hadoop\yarn\api\records\timeline\TestTimelineRecords.java,284,20,9,5,6,40
 hadoop-trunk\hadoop-trunk\hadoop-mapreduce-project\hadoop-mapreduce-client\hadoop-mapreduce-client-app\src\test\java\org\apache\hadoop\mapreduce\v2\app\job\impl\TestMapReduceChildJVM.java,284,92,2,4,1,99
 hadoop-trunk\hadoop-trunk\hadoop-yarn-project\hadoop-yarn\hadoop-yarn-server\hadoop-yarn-server-resourcemanager\src\test\java\org\apache\hadoop\yarn\server\resourcemanager\QueueACLsTestBase.java,284,35,0,1,0,36
 kafka-trunk\kafka-trunk\streams\src\test\java\org\apache\kafka\streams\processor\internals\StateManagerUtilTest.java,284,0,0,23,3,26
 pulsar-master\pulsar-master\pulsar-broker\src\test\java\org\apache\pulsar\broker\service\TopicOwnerTest.java,284,103,3,61,0,167
 pulsar-master\pulsar-master\pulsar-common\src\main\java\org\apache\pulsar\policies\data\loadbalancer\ResourceUnitRanking.java,284,165,10,65,0,240
 rocketmq-develop\rocketmq-develop\acl\src\test\java\org\apache\rocketmq\acl\common\AclUtilsTest.java,284,73,27,32,9,141
 hadoop-trunk\hadoop-trunk\hadoop-yarn-project\hadoop-yarn\hadoop-yarn-server\hadoop-yarn-server-common\src\main\java\org\apache\hadoop\yarn\server\federation\store\records\SubClusterInfo.java,285,26,0,1,0,27
 hadoop-trunk\hadoop-trunk\hadoop-common-project\hadoop-common\src\main\java\org\apache\hadoop\fs\BlockLocation.java,285,153,0,1,8,162
 hadoop-trunk\hadoop-trunk\hadoop-yarn-project\hadoop-yarn\hadoop-yarn-server\hadoop-yarn-server-resourcemanager\src\main\java\org\apache\hadoop\yarn\server\resourcemanager\recovery\MemoryRMStateStore.java,285,66,27,5,0,98
 hadoop-trunk\hadoop-trunk\hadoop-yarn-project\hadoop-yarn\hadoop-yarn-server\hadoop-yarn-server-resourcemanager\src\test\java\org\apache\hadoop\yarn\server\resourcemanager\placement\csmappingrule\TestMappingRuleMatchers.java,285,12,0,1,0,13
 hadoop-trunk\hadoop-trunk\hadoop-hdfs-project\hadoop-hdfs-client\src\main\java\org\apache\hadoop\hdfs\protocol\DatanodeID.java,285,92,1,1,0,94
 hadoop-trunk\hadoop-trunk\hadoop-hdfs-project\hadoop-hdfs\src\main\java\org\apache\hadoop\hdfs\protocolPB\ClientDatanodeProtocolServerSideTranslatorPB.java,285,69,103,39,0,211
 hadoop-trunk\hadoop-trunk\hadoop-common-project\hadoop-common\src\main\java\org\apache\hadoop\net\InnerNodeImpl.java,285,90,7,1,1,99
 hadoop-trunk\hadoop-trunk\hadoop-yarn-project\hadoop-yarn\hadoop-yarn-server\hadoop-yarn-server-resourcemanager\src\main\java\org\apache\hadoop\yarn\server\resourcemanager\scheduler\constraint\processor\PlacementConstraintProcessor.java,285,44,7,10,5,66
 hadoop-trunk\hadoop-trunk\hadoop-yarn-project\hadoop-yarn\hadoop-yarn-client\src\test\java\org\apache\hadoop\yarn\client\api\impl\TestAMRMClientPlacementConstraints.java,285,102,19,2,1,124
 kafka-trunk\kafka-trunk\streams\src\main\java\org\apache\kafka\streams\processor\internals\metrics\TaskMetrics.java,285,0,1,64,0,65
 kafka-trunk\kafka-trunk\streams\src\test\java\org\apache\kafka\streams\kstream\internals\SessionWindowedCogroupedKStreamImplTest.java,285,0,7,64,10,81
 kafka-trunk\kafka-trunk\tools\src\test\java\org\apache\kafka\tools\PushHttpMetricsReporterTest.java,285,0,1,22,0,23
 kafka-trunk\kafka-trunk\metadata\src\main\java\org\apache\kafka\controller\ClientQuotaControlManager.java,285,0,1,39,0,40
 pulsar-master\pulsar-master\pulsar-broker\src\test\java\org\apache\pulsar\schema\compatibility\SchemaTypeCompatibilityCheckOnTopicLevelTest.java,285,97,0,84,0,181
 pulsar-master\pulsar-master\pulsar-proxy\src\main\java\org\apache\pulsar\proxy\server\ProxyServiceStarter.java,285,80,6,51,0,137
 rocketmq-develop\rocketmq-develop\common\src\main\java\org\apache\rocketmq\common\protocol\body\ConsumerRunningInfo.java,285,94,12,34,8,148
 hadoop-trunk\hadoop-trunk\hadoop-tools\hadoop-azure\src\test\java\org\apache\hadoop\fs\azurebfs\ITestAbfsNetworkStatistics.java,286,21,9,16,11,57
 hadoop-trunk\hadoop-trunk\hadoop-yarn-project\hadoop-yarn\hadoop-yarn-server\hadoop-yarn-server-resourcemanager\src\main\java\org\apache\hadoop\yarn\server\resourcemanager\monitor\capacity\AbstractPreemptableResourceCalculator.java,286,40,4,2,1,47
 hadoop-trunk\hadoop-trunk\hadoop-tools\hadoop-aws\src\main\java\org\apache\hadoop\fs\s3a\select\SelectTool.java,286,40,5,1,7,53
 hadoop-trunk\hadoop-trunk\hadoop-common-project\hadoop-auth\src\main\java\org\apache\hadoop\security\authentication\server\JWTRedirectAuthenticationHandler.java,286,24,8,1,0,33
 hadoop-trunk\hadoop-trunk\hadoop-yarn-project\hadoop-yarn\hadoop-yarn-server\hadoop-yarn-server-resourcemanager\src\test\java\org\apache\hadoop\yarn\server\resourcemanager\volume\csi\TestVolumeProcessor.java,286,35,5,13,4,57
 hadoop-trunk\hadoop-trunk\hadoop-hdfs-project\hadoop-hdfs-client\src\main\java\org\apache\hadoop\hdfs\shortcircuit\ShortCircuitReplica.java,286,42,9,4,3,58
 hadoop-trunk\hadoop-trunk\hadoop-hdfs-project\hadoop-hdfs\src\test\java\org\apache\hadoop\hdfs\TestWriteReadStripedFile.java,286,70,5,2,2,79
 hadoop-trunk\hadoop-trunk\hadoop-yarn-project\hadoop-yarn\hadoop-yarn-server\hadoop-yarn-server-nodemanager\src\test\java\org\apache\hadoop\yarn\server\nodemanager\containermanager\resourceplugin\fpga\TestFpgaDiscoverer.java,286,32,1,8,4,45
 hadoop-trunk\hadoop-trunk\hadoop-hdfs-project\hadoop-hdfs-rbf\src\test\java\org\apache\hadoop\hdfs\server\federation\resolver\TestNamenodeResolver.java,286,28,1,11,0,40
 kafka-trunk\kafka-trunk\trogdor\src\test\java\org\apache\kafka\trogdor\common\WorkerUtilsTest.java,286,0,0,43,0,43
 skywalking-master\skywalking-master\oap-server\microbench\src\main\java\org\apache\skywalking\oap\server\microbench\library\datacarrier\LinkedArrayBenchmark.java,286,186,2,130,0,318
 skywalking-master\skywalking-master\oap-server\server-alarm-plugin\src\test\java\org\apache\skywalking\oap\server\core\alarm\provider\NotifyHandlerTest.java,286,62,4,49,0,115
 zookeeper-master\zookeeper-master\zookeeper-server\src\test\java\org\apache\zookeeper\test\ReadOnlyModeTest.java,286,0,29,42,0,71
 hadoop-trunk\hadoop-trunk\hadoop-hdfs-project\hadoop-hdfs\src\main\java\org\apache\hadoop\hdfs\tools\DFSHAAdmin.java,287,61,0,2,1,64
 hadoop-trunk\hadoop-trunk\hadoop-hdfs-project\hadoop-hdfs\src\main\java\org\apache\hadoop\hdfs\protocol\datatransfer\Receiver.java,287,87,55,24,0,166
 hadoop-trunk\hadoop-trunk\hadoop-yarn-project\hadoop-yarn\hadoop-yarn-server\hadoop-yarn-server-nodemanager\src\main\java\org\apache\hadoop\yarn\server\nodemanager\containermanager\resourceplugin\deviceframework\DeviceResourceHandlerImpl.java,287,61,12,12,8,93
 hadoop-trunk\hadoop-trunk\hadoop-common-project\hadoop-common\src\main\java\org\apache\hadoop\util\JsonSerialization.java,287,35,2,1,1,39
 hadoop-trunk\hadoop-trunk\hadoop-mapreduce-project\hadoop-mapreduce-client\hadoop-mapreduce-client-jobclient\src\test\java\org\apache\hadoop\mapred\MRBench.java,287,160,20,11,9,200
 hadoop-trunk\hadoop-trunk\hadoop-tools\hadoop-aws\src\test\java\org\apache\hadoop\fs\s3a\commit\AbstractYarnClusterITest.java,287,31,2,3,4,40
 skywalking-master\skywalking-master\oap-server\server-core\src\main\java\org\apache\skywalking\oap\server\core\CoreModuleProvider.java,287,98,0,93,0,191
 dubbo-3.0\dubbo-3.0\dubbo-remoting\dubbo-remoting-api\src\test\java\org\apache\dubbo\remoting\transport\codec\DeprecatedTelnetCodec.java,288,73,9,21,4,107
 hadoop-trunk\hadoop-trunk\hadoop-hdfs-project\hadoop-hdfs\src\main\java\org\apache\hadoop\hdfs\server\namenode\startupprogress\StartupProgressView.java,288,58,0,8,0,66
 hadoop-trunk\hadoop-trunk\hadoop-yarn-project\hadoop-yarn\hadoop-yarn-server\hadoop-yarn-server-resourcemanager\src\main\java\org\apache\hadoop\yarn\server\resourcemanager\scheduler\fair\FSParentQueue.java,288,66,2,4,2,74
 hadoop-trunk\hadoop-trunk\hadoop-tools\hadoop-azure\src\test\java\org\apache\hadoop\fs\azurebfs\services\ITestAbfsInputStreamSmallFileReads.java,288,69,8,7,3,87
 hadoop-trunk\hadoop-trunk\hadoop-yarn-project\hadoop-yarn\hadoop-yarn-server\hadoop-yarn-server-web-proxy\src\test\java\org\apache\hadoop\yarn\server\webproxy\amfilter\TestAmFilter.java,288,51,10,4,3,68
 hadoop-trunk\hadoop-trunk\hadoop-yarn-project\hadoop-yarn\hadoop-yarn-client\src\test\java\org\apache\hadoop\yarn\client\util\TestYarnClientUtils.java,288,9,10,1,0,20
 kafka-trunk\kafka-trunk\clients\src\test\java\org\apache\kafka\common\security\ssl\DefaultSslEngineFactoryTest.java,288,0,0,144,0,144
 dubbo-3.0\dubbo-3.0\dubbo-monitor\dubbo-monitor-default\src\test\java\org\apache\dubbo\monitor\dubbo\MetricsFilterTest.java,289,128,13,57,0,198
 dubbo-3.0\dubbo-3.0\dubbo-spring-boot\dubbo-spring-boot-compatible\autoconfigure\src\main\java\org\apache\dubbo\spring\boot\autoconfigure\DubboConfigurationProperties.java,289,165,0,7,0,172
 dubbo-3.0\dubbo-3.0\dubbo-rpc\dubbo-rpc-api\src\main\java\org\apache\dubbo\rpc\RpcStatus.java,289,50,2,7,0,59
 dubbo-3.0\dubbo-3.0\dubbo-metadata\dubbo-metadata-api\src\main\java\org\apache\dubbo\metadata\rest\AbstractServiceRestMetadataResolver.java,289,95,1,54,0,150
 hadoop-trunk\hadoop-trunk\hadoop-common-project\hadoop-common\src\test\java\org\apache\hadoop\security\token\TestDtUtilShell.java,289,78,8,1,48,135
 hadoop-trunk\hadoop-trunk\hadoop-tools\hadoop-distcp\src\main\java\org\apache\hadoop\tools\CopyListing.java,289,53,1,15,1,70
 hadoop-trunk\hadoop-trunk\hadoop-tools\hadoop-federation-balance\src\main\java\org\apache\hadoop\tools\fedbalance\FedBalance.java,289,46,14,4,0,64
 hadoop-trunk\hadoop-trunk\hadoop-yarn-project\hadoop-yarn\hadoop-yarn-server\hadoop-yarn-server-nodemanager\src\main\java\org\apache\hadoop\yarn\server\nodemanager\containermanager\linux\privileged\PrivilegedOperationExecutor.java,289,36,12,6,1,55
 hadoop-trunk\hadoop-trunk\hadoop-mapreduce-project\hadoop-mapreduce-client\hadoop-mapreduce-client-app\src\test\java\org\apache\hadoop\mapreduce\v2\app\webapp\TestAMWebServices.java,289,46,1,2,0,49
 hadoop-trunk\hadoop-trunk\hadoop-tools\hadoop-resourceestimator\src\main\java\org\apache\hadoop\resourceestimator\solver\impl\LpSolver.java,289,16,5,6,1,28
 hadoop-trunk\hadoop-trunk\hadoop-yarn-project\hadoop-yarn\hadoop-yarn-server\hadoop-yarn-server-resourcemanager\src\main\java\org\apache\hadoop\yarn\server\resourcemanager\scheduler\distributed\CentralizedOpportunisticContainerAllocator.java,289,74,6,1,1,82
 hadoop-trunk\hadoop-trunk\hadoop-hdfs-project\hadoop-hdfs\src\test\java\org\apache\hadoop\hdfs\server\namenode\snapshot\TestNestedSnapshots.java,289,66,9,4,4,83
 kafka-trunk\kafka-trunk\clients\src\generated\java\org\apache\kafka\common\message\AddOffsetsToTxnRequestData.java,289,0,0,30,3,33
 kafka-trunk\kafka-trunk\clients\src\main\java\org\apache\kafka\common\security\oauthbearer\secured\HttpAccessTokenRetriever.java,289,0,18,43,2,63
 pulsar-master\pulsar-master\pulsar-common\src\test\java\org\apache\pulsar\common\net\ServiceURITest.java,289,73,7,20,0,100
 pulsar-master\pulsar-master\pulsar-broker\src\test\java\org\apache\pulsar\broker\transaction\pendingack\PendingAckPersistentTest.java,289,57,16,40,0,113
 zookeeper-master\zookeeper-master\zookeeper-server\src\test\java\org\apache\zookeeper\server\util\QuotaMetricsUtilsTest.java,289,0,19,54,0,73
 zookeeper-master\zookeeper-master\zookeeper-server\src\main\java\org\apache\zookeeper\admin\ZooKeeperAdmin.java,289,0,24,16,0,40
 hadoop-trunk\hadoop-trunk\hadoop-hdfs-project\hadoop-hdfs\src\test\java\org\apache\hadoop\hdfs\TestStateAlignmentContextWithHA.java,290,61,0,1,3,65
 hadoop-trunk\hadoop-trunk\hadoop-yarn-project\hadoop-yarn\hadoop-yarn-server\hadoop-yarn-server-common\src\test\java\org\apache\hadoop\yarn\server\TestAMRMClientRelayer.java,290,61,6,7,2,76
 hadoop-trunk\hadoop-trunk\hadoop-hdfs-project\hadoop-hdfs\src\main\java\org\apache\hadoop\hdfs\server\blockmanagement\BlockIdManager.java,290,67,0,2,0,69
 hadoop-trunk\hadoop-trunk\hadoop-tools\hadoop-azure\src\test\java\org\apache\hadoop\fs\azurebfs\commit\ITestAbfsTerasort.java,290,24,9,9,3,45
 hadoop-trunk\hadoop-trunk\hadoop-yarn-project\hadoop-yarn\hadoop-yarn-api\src\main\java\org\apache\hadoop\yarn\api\records\QueueStatistics.java,290,77,0,1,0,78
 hadoop-trunk\hadoop-trunk\hadoop-hdfs-project\hadoop-hdfs\src\test\java\org\apache\hadoop\hdfs\server\datanode\fsdataset\TestAvailableSpaceVolumeChoosingPolicy.java,290,190,0,12,0,202
 hadoop-trunk\hadoop-trunk\hadoop-yarn-project\hadoop-yarn\hadoop-yarn-applications\hadoop-yarn-services\hadoop-yarn-services-core\src\main\java\org\apache\hadoop\yarn\service\ServiceMaster.java,290,42,16,4,0,62
 pulsar-master\pulsar-master\tiered-storage\jcloud\src\test\java\org\apache\bookkeeper\mledger\offload\jcloud\impl\OffloadIndexV2Test.java,290,120,17,51,0,188
 pulsar-master\pulsar-master\pulsar-client\src\test\java\org\apache\pulsar\client\impl\ConsumerBuilderImplTest.java,290,69,0,18,0,87
 dubbo-3.0\dubbo-3.0\dubbo-rpc\dubbo-rpc-dubbo\src\main\java\org\apache\dubbo\rpc\protocol\dubbo\CallbackServiceCodec.java,291,141,11,72,0,224
 hadoop-trunk\hadoop-trunk\hadoop-common-project\hadoop-registry\src\test\java\org\apache\hadoop\registry\operations\TestRegistryOperations.java,291,28,0,1,1,30
 hadoop-trunk\hadoop-trunk\hadoop-yarn-project\hadoop-yarn\hadoop-yarn-api\src\main\java\org\apache\hadoop\yarn\api\records\QueueInfo.java,291,89,0,2,0,91
 hadoop-trunk\hadoop-trunk\hadoop-tools\hadoop-azure-datalake\src\test\java\org\apache\hadoop\fs\adl\live\TestAdlSupportedCharsetInPath.java,291,33,1,2,0,36
 hadoop-trunk\hadoop-trunk\hadoop-tools\hadoop-sls\src\main\java\org\apache\hadoop\yarn\sls\scheduler\SLSSchedulerCommons.java,291,51,2,14,3,70
 hadoop-trunk\hadoop-trunk\hadoop-yarn-project\hadoop-yarn\hadoop-yarn-server\hadoop-yarn-server-common\src\main\java\org\apache\hadoop\yarn\server\federation\utils\FederationRegistryClient.java,291,33,14,1,3,51
 hadoop-trunk\hadoop-trunk\hadoop-hdfs-project\hadoop-hdfs\src\test\java\org\apache\hadoop\hdfs\server\namenode\TestListOpenFiles.java,291,39,14,2,6,61
 kafka-trunk\kafka-trunk\streams\src\test\java\org\apache\kafka\streams\kstream\internals\KStreamKTableJoinTest.java,291,0,4,64,4,72
 pulsar-master\pulsar-master\pulsar-broker\src\test\java\org\apache\pulsar\functions\worker\PulsarWorkerAssignmentTest.java,291,111,12,56,0,179
 skywalking-master\skywalking-master\oap-server\server-storage-plugin\storage-elasticsearch-plugin\src\main\java\org\apache\skywalking\oap\server\storage\plugin\elasticsearch\query\TopologyQueryEsDAO.java,291,108,0,69,0,177
 zookeeper-master\zookeeper-master\zookeeper-server\src\main\java\org\apache\zookeeper\OpResult.java,291,0,34,12,2,48
 hadoop-trunk\hadoop-trunk\hadoop-hdfs-project\hadoop-hdfs\src\test\java\org\apache\hadoop\hdfs\server\datanode\metrics\TestSlowNodeDetector.java,292,130,3,1,0,134
 hadoop-trunk\hadoop-trunk\hadoop-hdfs-project\hadoop-hdfs\src\main\java\org\apache\hadoop\hdfs\tools\offlineImageViewer\PBImageCorruptionDetector.java,292,50,10,1,2,63
 hadoop-trunk\hadoop-trunk\hadoop-common-project\hadoop-common\src\main\java\org\apache\hadoop\io\compress\lz4\Lz4Compressor.java,292,38,8,1,1,48
 hadoop-trunk\hadoop-trunk\hadoop-common-project\hadoop-common\src\main\java\org\apache\hadoop\fs\viewfs\ViewFileSystemOverloadScheme.java,292,50,10,4,0,64
 kafka-trunk\kafka-trunk\clients\src\main\java\org\apache\kafka\common\requests\OffsetFetchResponse.java,292,0,88,55,3,146
 kafka-trunk\kafka-trunk\streams\src\test\java\org\apache\kafka\streams\integration\LagFetchIntegrationTest.java,292,0,3,65,3,71
 kafka-trunk\kafka-trunk\clients\src\main\java\org\apache\kafka\common\requests\OffsetFetchRequest.java,292,0,152,45,1,198
 pulsar-master\pulsar-master\pulsar-client\src\main\java\org\apache\pulsar\client\impl\ConsumerStatsRecorderImpl.java,292,86,10,20,0,116
 hadoop-trunk\hadoop-trunk\hadoop-mapreduce-project\hadoop-mapreduce-examples\src\main\java\org\apache\hadoop\examples\dancing\Sudoku.java,293,163,9,1,0,173
 hadoop-trunk\hadoop-trunk\hadoop-tools\hadoop-azure\src\test\java\org\apache\hadoop\fs\azurebfs\ITestAzureBlobFileSystemLease.java,293,70,0,52,1,123
 hadoop-trunk\hadoop-trunk\hadoop-hdfs-project\hadoop-hdfs-rbf\src\test\java\org\apache\hadoop\hdfs\server\federation\router\TestRouterFederationRename.java,293,30,2,4,1,37
 hadoop-trunk\hadoop-trunk\hadoop-yarn-project\hadoop-yarn\hadoop-yarn-common\src\main\java\org\apache\hadoop\yarn\client\api\AppAdminClient.java,293,17,1,1,0,19
 hadoop-trunk\hadoop-trunk\hadoop-tools\hadoop-aws\src\test\java\org\apache\hadoop\fs\s3a\select\ITestS3SelectCLI.java,293,40,4,7,4,55
 hadoop-trunk\hadoop-trunk\hadoop-mapreduce-project\hadoop-mapreduce-client\hadoop-mapreduce-client-core\src\test\java\org\apache\hadoop\mapred\TestTaskProgressReporter.java,293,85,13,2,6,106
 kafka-trunk\kafka-trunk\streams\src\test\java\org\apache\kafka\streams\integration\ResetIntegrationTest.java,293,0,4,62,13,79
 pulsar-master\pulsar-master\pulsar-broker\src\test\java\org\apache\pulsar\broker\admin\MaxUnackedMessagesTest.java,293,88,5,44,0,137
 pulsar-master\pulsar-master\pulsar-broker\src\main\java\org\apache\pulsar\broker\stats\prometheus\TransactionAggregator.java,293,171,1,90,0,262
 zookeeper-master\zookeeper-master\zookeeper-server\src\main\java\org\apache\zookeeper\server\ServerCnxnFactory.java,293,0,2,46,3,51
 zookeeper-master\zookeeper-master\zookeeper-server\src\test\java\org\apache\zookeeper\server\CreateContainerTest.java,293,0,61,62,0,123
 dubbo-3.0\dubbo-3.0\dubbo-common\src\main\java\org\apache\dubbo\config\ConfigCenterConfig.java,294,140,1,16,8,165
 hadoop-trunk\hadoop-trunk\hadoop-mapreduce-project\hadoop-mapreduce-client\hadoop-mapreduce-client-core\src\main\java\org\apache\hadoop\mapreduce\filecache\ClientDistributedCacheManager.java,294,89,5,5,0,99
 hadoop-trunk\hadoop-trunk\hadoop-mapreduce-project\hadoop-mapreduce-client\hadoop-mapreduce-client-core\src\test\java\org\apache\hadoop\mapred\TestIndexCache.java,294,64,12,1,9,86
 hadoop-trunk\hadoop-trunk\hadoop-mapreduce-project\hadoop-mapreduce-examples\src\main\java\org\apache\hadoop\examples\QuasiMonteCarlo.java,294,98,5,4,2,109
 hadoop-trunk\hadoop-trunk\hadoop-yarn-project\hadoop-yarn\hadoop-yarn-server\hadoop-yarn-server-common\src\main\java\org\apache\hadoop\yarn\server\api\protocolrecords\impl\pb\RegisterDistributedSchedulingAMResponsePBImpl.java,294,43,70,5,0,118
 hadoop-trunk\hadoop-trunk\hadoop-hdfs-project\hadoop-hdfs\src\test\java\org\apache\hadoop\hdfs\TestRenameWhileOpen.java,294,82,12,5,12,111
 hadoop-trunk\hadoop-trunk\hadoop-hdfs-project\hadoop-hdfs\src\test\java\org\apache\hadoop\hdfs\TestExternalBlockReader.java,294,123,18,3,8,152
 kafka-trunk\kafka-trunk\shell\src\test\java\org\apache\kafka\shell\MetadataNodeManagerTest.java,294,0,0,31,0,31
 dubbo-3.0\dubbo-3.0\dubbo-registry\dubbo-registry-api\src\main\java\org\apache\dubbo\registry\support\CacheableFailbackRegistry.java,295,101,11,48,0,160
 dubbo-3.0\dubbo-3.0\dubbo-config\dubbo-config-api\src\test\java\org\apache\dubbo\config\ApplicationConfigTest.java,295,38,2,7,0,47
 hadoop-trunk\hadoop-trunk\hadoop-yarn-project\hadoop-yarn\hadoop-yarn-server\hadoop-yarn-server-applicationhistoryservice\src\test\java\org\apache\hadoop\yarn\server\timeline\security\TestTimelineAuthenticationFilterForV1.java,295,30,5,4,3,42
 hadoop-trunk\hadoop-trunk\hadoop-yarn-project\hadoop-yarn\hadoop-yarn-server\hadoop-yarn-server-nodemanager\src\test\java\org\apache\hadoop\yarn\server\nodemanager\webapp\TestContainerLogsPage.java,295,47,3,9,0,59
 hadoop-trunk\hadoop-trunk\hadoop-yarn-project\hadoop-yarn\hadoop-yarn-server\hadoop-yarn-server-timelineservice\src\test\java\org\apache\hadoop\yarn\server\timelineservice\collector\TestTimelineCollector.java,295,48,7,3,5,63
 hadoop-trunk\hadoop-trunk\hadoop-tools\hadoop-federation-balance\src\main\java\org\apache\hadoop\tools\fedbalance\FedBalanceContext.java,295,71,2,1,7,81
 hadoop-trunk\hadoop-trunk\hadoop-yarn-project\hadoop-yarn\hadoop-yarn-server\hadoop-yarn-server-resourcemanager\src\main\java\org\apache\hadoop\yarn\server\resourcemanager\scheduler\SchedulerHealth.java,295,90,0,1,4,95
 hadoop-trunk\hadoop-trunk\hadoop-hdfs-project\hadoop-hdfs\src\test\java\org\apache\hadoop\hdfs\server\blockmanagement\TestLowRedundancyBlockQueues.java,295,77,5,1,1,84
 hadoop-trunk\hadoop-trunk\hadoop-tools\hadoop-azure\src\main\java\org\apache\hadoop\fs\azurebfs\oauth2\IdentityTransformer.java,295,83,6,60,0,149
 hadoop-trunk\hadoop-trunk\hadoop-yarn-project\hadoop-yarn\hadoop-yarn-server\hadoop-yarn-server-nodemanager\src\test\java\org\apache\hadoop\yarn\server\nodemanager\containermanager\scheduler\TestContainerSchedulerRecovery.java,295,38,3,5,0,46
 hadoop-trunk\hadoop-trunk\hadoop-yarn-project\hadoop-yarn\hadoop-yarn-server\hadoop-yarn-server-resourcemanager\src\main\java\org\apache\hadoop\yarn\server\resourcemanager\ahs\RMApplicationHistoryWriter.java,295,57,24,16,8,105
 hadoop-trunk\hadoop-trunk\hadoop-yarn-project\hadoop-yarn\hadoop-yarn-applications\hadoop-yarn-services\hadoop-yarn-services-core\src\test\java\org\apache\hadoop\yarn\service\client\TestServiceCLI.java,295,64,2,6,6,78
 hadoop-trunk\hadoop-trunk\hadoop-tools\hadoop-streaming\src\main\java\org\apache\hadoop\streaming\mapreduce\StreamXmlRecordReader.java,295,107,12,1,3,123
 hadoop-trunk\hadoop-trunk\hadoop-mapreduce-project\hadoop-mapreduce-client\hadoop-mapreduce-client-hs\src\main\java\org\apache\hadoop\mapreduce\v2\hs\webapp\dao\JobInfo.java,295,131,10,4,2,147
 kafka-trunk\kafka-trunk\connect\mirror\src\test\java\org\apache\kafka\connect\mirror\MirrorConnectorConfigTest.java,295,0,0,66,0,66
 pulsar-master\pulsar-master\pulsar-broker\src\test\java\org\apache\pulsar\client\impl\BatchMessageIndexAckTest.java,295,45,3,11,0,59
 pulsar-master\pulsar-master\managed-ledger\src\main\java\org\apache\bookkeeper\mledger\impl\ManagedLedgerMBeanImpl.java,295,124,0,11,0,135
 zookeeper-master\zookeeper-master\zookeeper-server\src\main\java\org\apache\zookeeper\server\BlueThrottle.java,295,0,5,32,0,37
 dubbo-3.0\dubbo-3.0\dubbo-config\dubbo-config-api\src\test\java\org\apache\dubbo\config\bootstrap\DubboBootstrapTest.java,296,80,8,47,0,135
 hadoop-trunk\hadoop-trunk\hadoop-hdfs-project\hadoop-hdfs\src\main\java\org\apache\hadoop\hdfs\tools\JMXGet.java,296,64,14,2,4,84
 hadoop-trunk\hadoop-trunk\hadoop-common-project\hadoop-common\src\test\java\org\apache\hadoop\fs\TestFilterFileSystem.java,296,168,67,4,0,239
 hadoop-trunk\hadoop-trunk\hadoop-mapreduce-project\hadoop-mapreduce-client\hadoop-mapreduce-client-jobclient\src\test\java\org\apache\hadoop\mapreduce\TestMapperReducerCleanup.java,296,68,6,1,12,87
 hadoop-trunk\hadoop-trunk\hadoop-yarn-project\hadoop-yarn\hadoop-yarn-server\hadoop-yarn-server-nodemanager\src\main\java\org\apache\hadoop\yarn\server\nodemanager\amrmproxy\AMRMProxyTokenSecretManager.java,296,48,5,3,3,59
 hadoop-trunk\hadoop-trunk\hadoop-yarn-project\hadoop-yarn\hadoop-yarn-server\hadoop-yarn-server-nodemanager\src\main\java\org\apache\hadoop\yarn\server\nodemanager\containermanager\linux\resources\DefaultOOMHandler.java,296,35,5,8,2,50
 hadoop-trunk\hadoop-trunk\hadoop-yarn-project\hadoop-yarn\hadoop-yarn-server\hadoop-yarn-server-resourcemanager\src\test\java\org\apache\hadoop\yarn\server\resourcemanager\monitor\capacity\TestProportionalCapacityPreemptionPolicyIntraQueueWithDRF.java,296,55,1,5,0,61
 hadoop-trunk\hadoop-trunk\hadoop-yarn-project\hadoop-yarn\hadoop-yarn-server\hadoop-yarn-server-nodemanager\src\main\java\org\apache\hadoop\yarn\server\nodemanager\containermanager\linux\resources\CGroupsResourceCalculator.java,296,58,8,2,2,70
 hadoop-trunk\hadoop-trunk\hadoop-yarn-project\hadoop-yarn\hadoop-yarn-server\hadoop-yarn-server-resourcemanager\src\main\java\org\apache\hadoop\yarn\server\resourcemanager\scheduler\capacity\conf\ZKConfigurationStore.java,296,66,6,1,2,75
 rocketmq-develop\rocketmq-develop\client\src\main\java\org\apache\rocketmq\client\ClientConfig.java,296,170,1,21,0,192
 hadoop-trunk\hadoop-trunk\hadoop-common-project\hadoop-common\src\test\java\org\apache\hadoop\fs\contract\AbstractContractCopyFromLocalTest.java,297,50,0,1,4,55
 hadoop-trunk\hadoop-trunk\hadoop-hdfs-project\hadoop-hdfs\src\main\java\org\apache\hadoop\hdfs\server\namenode\FSTreeTraverser.java,297,20,0,3,2,25
 pulsar-master\pulsar-master\pulsar-broker\src\test\java\org\apache\pulsar\broker\service\ExclusiveProducerTest.java,297,67,6,24,0,97
 pulsar-master\pulsar-master\pulsar-functions\worker\src\main\java\org\apache\pulsar\functions\worker\rest\api\WorkerImpl.java,297,94,11,74,0,179
 zookeeper-master\zookeeper-master\zookeeper-server\src\test\java\org\apache\zookeeper\server\quorum\QuorumPeerMainMultiAddressTest.java,297,0,10,69,3,82
 zookeeper-master\zookeeper-master\zookeeper-contrib\zookeeper-contrib-loggraph\src\main\java\org\apache\zookeeper\graph\RandomAccessFileReader.java,297,0,7,8,10,25
 dubbo-3.0\dubbo-3.0\dubbo-rpc\dubbo-rpc-triple\src\main\java\org\apache\dubbo\rpc\protocol\tri\stream\TripleClientStream.java,298,103,0,41,0,144
 hadoop-trunk\hadoop-trunk\hadoop-common-project\hadoop-common\src\test\java\org\apache\hadoop\io\TestIOUtils.java,298,47,31,5,24,107
 hadoop-trunk\hadoop-trunk\hadoop-yarn-project\hadoop-yarn\hadoop-yarn-server\hadoop-yarn-server-resourcemanager\src\test\java\org\apache\hadoop\yarn\server\resourcemanager\scheduler\fair\TestFSLeafQueue.java,298,59,4,7,2,72
 hadoop-trunk\hadoop-trunk\hadoop-hdfs-project\hadoop-hdfs\src\main\java\org\apache\hadoop\hdfs\protocol\LayoutVersion.java,298,132,1,9,1,143
 hadoop-trunk\hadoop-trunk\hadoop-yarn-project\hadoop-yarn\hadoop-yarn-server\hadoop-yarn-server-timelineservice\src\main\java\org\apache\hadoop\yarn\server\timelineservice\reader\TimelineParserForEqualityExpr.java,298,38,1,7,1,47
 pulsar-master\pulsar-master\pulsar-broker\src\test\java\org\apache\pulsar\broker\admin\AdminApiOffloadTest.java,298,85,4,49,0,138
 rocketmq-develop\rocketmq-develop\broker\src\main\java\org\apache\rocketmq\broker\transaction\queue\TransactionalMessageBridge.java,298,122,7,50,4,183
 rocketmq-develop\rocketmq-develop\broker\src\main\java\org\apache\rocketmq\broker\processor\ReplyMessageProcessor.java,298,93,6,66,2,167
 dubbo-3.0\dubbo-3.0\dubbo-common\src\main\java\org\apache\dubbo\common\config\Environment.java,299,118,1,30,9,158
 hadoop-trunk\hadoop-trunk\hadoop-hdfs-project\hadoop-hdfs\src\main\java\org\apache\hadoop\hdfs\qjournal\protocolPB\QJournalProtocolServerSideTranslatorPB.java,299,82,101,46,0,229
 hadoop-trunk\hadoop-trunk\hadoop-hdfs-project\hadoop-hdfs\src\main\java\org\apache\hadoop\hdfs\server\datanode\ProvidedReplica.java,299,94,4,3,6,107
 hadoop-trunk\hadoop-trunk\hadoop-common-project\hadoop-common\src\test\java\org\apache\hadoop\util\TestPreconditions.java,299,16,0,2,19,37
 hadoop-trunk\hadoop-trunk\hadoop-tools\hadoop-aws\src\test\java\org\apache\hadoop\fs\s3a\scale\ILoadTestS3ABulkDeleteThrottling.java,299,40,9,4,3,56
 hadoop-trunk\hadoop-trunk\hadoop-yarn-project\hadoop-yarn\hadoop-yarn-applications\hadoop-yarn-services\hadoop-yarn-services-api\src\test\java\org\apache\hadoop\yarn\service\client\TestApiServiceClient.java,299,47,6,1,1,55
 kafka-trunk\kafka-trunk\clients\src\generated\java\org\apache\kafka\common\message\InitProducerIdRequestData.java,299,0,0,26,2,28
 kafka-trunk\kafka-trunk\connect\api\src\test\java\org\apache\kafka\connect\data\ConnectSchemaTest.java,299,0,0,58,3,61
 kafka-trunk\kafka-trunk\streams\src\test\java\org\apache\kafka\streams\kstream\internals\KTableSourceTest.java,299,0,11,37,0,48
 pulsar-master\pulsar-master\pulsar-broker\src\main\java\org\apache\pulsar\PulsarBrokerStarter.java,299,78,8,55,0,141
 zookeeper-master\zookeeper-master\zookeeper-server\src\test\java\org\apache\zookeeper\test\QuorumUtil.java,299,0,10,27,1,38
 zookeeper-master\zookeeper-master\zookeeper-server\src\test\java\org\apache\zookeeper\test\JMXEnv.java,299,0,14,23,0,37
 hadoop-trunk\hadoop-trunk\hadoop-mapreduce-project\hadoop-mapreduce-examples\src\main\java\org\apache\hadoop\examples\terasort\TeraSort.java,300,123,4,1,2,130
 hadoop-trunk\hadoop-trunk\hadoop-tools\hadoop-aws\src\main\java\org\apache\hadoop\fs\s3a\impl\DirMarkerTracker.java,300,34,3,1,3,41
 hadoop-trunk\hadoop-trunk\hadoop-tools\hadoop-azure\src\test\java\org\apache\hadoop\fs\azure\ITestReadAndSeekPageBlobAfterWrite.java,300,82,21,18,2,123
 hadoop-trunk\hadoop-trunk\hadoop-yarn-project\hadoop-yarn\hadoop-yarn-server\hadoop-yarn-server-nodemanager\src\test\java\org\apache\hadoop\yarn\server\nodemanager\containermanager\resourceplugin\deviceframework\TestDeviceMappingManager.java,300,51,13,11,9,84
 hadoop-trunk\hadoop-trunk\hadoop-common-project\hadoop-common\src\main\java\org\apache\hadoop\fs\permission\AclEntry.java,300,43,2,3,0,48
 hadoop-trunk\hadoop-trunk\hadoop-hdfs-project\hadoop-hdfs\src\test\java\org\apache\hadoop\hdfs\TestFileStatus.java,300,65,4,1,0,70
 hadoop-trunk\hadoop-trunk\hadoop-common-project\hadoop-registry\src\test\java\org\apache\hadoop\registry\RegistryTestHelper.java,300,81,5,6,0,92
 hadoop-trunk\hadoop-trunk\hadoop-yarn-project\hadoop-yarn\hadoop-yarn-server\hadoop-yarn-server-nodemanager\src\main\java\org\apache\hadoop\yarn\server\nodemanager\containermanager\linux\resources\numa\NumaResourceAllocator.java,300,38,7,6,1,52
 kafka-trunk\kafka-trunk\connect\runtime\src\test\java\org\apache\kafka\connect\runtime\errors\ErrorReporterTest.java,300,0,0,82,12,94
 pulsar-master\pulsar-master\pulsar-client-admin\src\main\java\org\apache\pulsar\client\admin\internal\TransactionsImpl.java,300,152,0,68,0,220
 dubbo-3.0\dubbo-3.0\dubbo-registry\dubbo-registry-multiple\src\main\java\org\apache\dubbo\registry\multiple\MultipleRegistry.java,301,131,4,34,0,169
 dubbo-3.0\dubbo-3.0\dubbo-cluster\src\main\java\org\apache\dubbo\rpc\cluster\router\mesh\route\MeshRuleRouter.java,301,122,6,57,0,185
 hadoop-trunk\hadoop-trunk\hadoop-tools\hadoop-streaming\src\main\java\org\apache\hadoop\typedbytes\TypedBytesOutput.java,301,63,15,2,1,81
 hadoop-trunk\hadoop-trunk\hadoop-common-project\hadoop-common\src\main\java\org\apache\hadoop\security\token\delegation\web\DelegationTokenAuthenticator.java,301,81,13,3,1,98
 hadoop-trunk\hadoop-trunk\hadoop-mapreduce-project\hadoop-mapreduce-client\hadoop-mapreduce-client-core\src\main\java\org\apache\hadoop\mapreduce\lib\output\committer\manifest\files\TaskManifest.java,301,60,3,2,5,70
 hadoop-trunk\hadoop-trunk\hadoop-mapreduce-project\hadoop-mapreduce-client\hadoop-mapreduce-client-core\src\main\java\org\apache\hadoop\mapreduce\lib\jobcontrol\JobControl.java,301,115,17,4,2,138
 hadoop-trunk\hadoop-trunk\hadoop-yarn-project\hadoop-yarn\hadoop-yarn-server\hadoop-yarn-server-nodemanager\src\test\java\org\apache\hadoop\yarn\server\nodemanager\containermanager\monitor\TestContainersMonitorResourceChange.java,301,82,7,9,0,98
 kafka-trunk\kafka-trunk\connect\runtime\src\test\java\org\apache\kafka\connect\runtime\WorkerTaskTest.java,301,0,7,14,0,21
 pulsar-master\pulsar-master\pulsar-client-admin\src\main\java\org\apache\pulsar\client\admin\internal\BrokersImpl.java,301,111,0,43,0,154
 dubbo-3.0\dubbo-3.0\dubbo-common\src\main\java\org\apache\dubbo\config\AbstractServiceConfig.java,302,149,1,8,3,161
 dubbo-3.0\dubbo-3.0\dubbo-config\dubbo-config-spring\src\main\java\org\apache\dubbo\config\spring\reference\ReferenceBeanBuilder.java,302,156,0,13,0,169
 hadoop-trunk\hadoop-trunk\hadoop-hdfs-project\hadoop-hdfs\src\main\java\org\apache\hadoop\hdfs\tools\GetConf.java,302,106,0,1,0,107
 hadoop-trunk\hadoop-trunk\hadoop-mapreduce-project\hadoop-mapreduce-client\hadoop-mapreduce-client-core\src\test\java\org\apache\hadoop\mapreduce\TestJobResourceUploaderWithSharedCache.java,302,45,4,1,3,53
 hadoop-trunk\hadoop-trunk\hadoop-hdfs-project\hadoop-hdfs\src\main\java\org\apache\hadoop\hdfs\server\diskbalancer\datamodel\DiskBalancerVolumeSet.java,302,38,4,1,1,44
 hadoop-trunk\hadoop-trunk\hadoop-common-project\hadoop-common\src\test\java\org\apache\hadoop\io\TestBloomMapFile.java,302,38,7,1,4,50
 hadoop-trunk\hadoop-trunk\hadoop-hdfs-project\hadoop-hdfs\src\test\java\org\apache\hadoop\hdfs\util\TestDiff.java,302,82,6,3,1,92
 hadoop-trunk\hadoop-trunk\hadoop-yarn-project\hadoop-yarn\hadoop-yarn-server\hadoop-yarn-server-resourcemanager\src\main\java\org\apache\hadoop\yarn\server\resourcemanager\scheduler\fair\AllocationFileLoaderService.java,302,47,9,6,0,62
 kafka-trunk\kafka-trunk\streams\src\main\java\org\apache\kafka\streams\processor\internals\StandbyTask.java,302,0,5,31,0,36
 pulsar-master\pulsar-master\pulsar-common\src\main\java\org\apache\pulsar\common\util\Reflections.java,302,63,6,29,0,98
 pulsar-master\pulsar-master\pulsar-client\src\test\java\org\apache\pulsar\client\impl\schema\SchemaInfoTest.java,302,20,0,9,0,29
 pulsar-master\pulsar-master\pulsar-metadata\src\main\java\org\apache\pulsar\metadata\bookkeeper\PulsarRegistrationManager.java,302,98,9,60,0,167
 pulsar-master\pulsar-master\pulsar-broker\src\main\java\org\apache\pulsar\utils\auth\tokens\TokensCliUtils.java,302,77,8,36,0,121
 dubbo-3.0\dubbo-3.0\dubbo-registry\dubbo-registry-zookeeper\src\main\java\org\apache\dubbo\registry\zookeeper\ZookeeperRegistry.java,303,93,10,45,0,148
 hadoop-trunk\hadoop-trunk\hadoop-common-project\hadoop-common\src\main\java\org\apache\hadoop\security\ssl\FileBasedKeyStoresFactory.java,303,49,1,11,4,65
 hadoop-trunk\hadoop-trunk\hadoop-yarn-project\hadoop-yarn\hadoop-yarn-applications\hadoop-yarn-services\hadoop-yarn-services-core\src\main\java\org\apache\hadoop\yarn\service\api\records\Container.java,303,138,2,11,11,162
 hadoop-trunk\hadoop-trunk\hadoop-hdfs-project\hadoop-hdfs\src\test\java\org\apache\hadoop\hdfs\server\namenode\TestEditLogJournalFailures.java,303,59,1,2,4,66
 kafka-trunk\kafka-trunk\streams\src\main\java\org\apache\kafka\streams\processor\internals\assignment\StickyTaskAssignor.java,303,0,0,37,3,40
 kafka-trunk\kafka-trunk\clients\src\test\java\org\apache\kafka\clients\consumer\RoundRobinAssignorTest.java,303,0,0,63,0,63
 pulsar-master\pulsar-master\pulsar-io\elastic-search\src\test\java\org\apache\pulsar\io\elasticsearch\ElasticSearchClientTests.java,303,90,1,44,0,135
 pulsar-master\pulsar-master\pulsar-io\elastic-search\src\main\java\org\apache\pulsar\io\elasticsearch\ElasticSearchConfig.java,303,103,4,51,0,158
 dubbo-3.0\dubbo-3.0\dubbo-registry\dubbo-registry-api\src\main\java\org\apache\dubbo\registry\integration\DynamicDirectory.java,304,120,16,32,0,168
 hadoop-trunk\hadoop-trunk\hadoop-common-project\hadoop-common\src\main\java\org\apache\hadoop\io\compress\zstd\ZStandardDecompressor.java,304,63,7,1,2,73
 hadoop-trunk\hadoop-trunk\hadoop-hdfs-project\hadoop-hdfs\src\main\java\org\apache\hadoop\hdfs\tools\StoragePolicyAdmin.java,304,36,0,1,0,37
 hadoop-trunk\hadoop-trunk\hadoop-hdfs-project\hadoop-hdfs\src\test\java\org\apache\hadoop\hdfs\TestSetTimes.java,304,82,30,7,14,133
 hadoop-trunk\hadoop-trunk\hadoop-tools\hadoop-azure\src\main\java\org\apache\hadoop\fs\azurebfs\services\AbfsRestOperation.java,304,78,3,13,2,96
 hadoop-trunk\hadoop-trunk\hadoop-common-project\hadoop-common\src\main\java\org\apache\hadoop\security\alias\AbstractJavaKeyStoreProvider.java,304,66,1,1,4,72
 hadoop-trunk\hadoop-trunk\hadoop-hdfs-project\hadoop-hdfs\src\main\java\org\apache\hadoop\hdfs\server\namenode\sps\BlockStorageMovementNeeded.java,304,43,4,1,1,49
 hadoop-trunk\hadoop-trunk\hadoop-yarn-project\hadoop-yarn\hadoop-yarn-server\hadoop-yarn-server-resourcemanager\src\test\java\org\apache\hadoop\yarn\server\resourcemanager\scheduler\TestSchedulerHealth.java,304,74,21,7,1,103
 hadoop-trunk\hadoop-trunk\hadoop-mapreduce-project\hadoop-mapreduce-client\hadoop-mapreduce-client-hs\src\test\java\org\apache\hadoop\mapreduce\v2\hs\server\TestHSAdminServer.java,304,45,9,1,3,58
 hadoop-trunk\hadoop-trunk\hadoop-yarn-project\hadoop-yarn\hadoop-yarn-server\hadoop-yarn-server-resourcemanager\src\test\java\org\apache\hadoop\yarn\server\resourcemanager\NodeManager.java,304,111,6,12,6,135
 hadoop-trunk\hadoop-trunk\hadoop-yarn-project\hadoop-yarn\hadoop-yarn-server\hadoop-yarn-server-resourcemanager\src\test\java\org\apache\hadoop\yarn\server\resourcemanager\scheduler\capacity\TestCapacitySchedulerNodes.java,304,37,21,26,1,85
 kafka-trunk\kafka-trunk\clients\src\generated\java\org\apache\kafka\common\message\SaslAuthenticateResponseData.java,304,0,0,28,4,32
 kafka-trunk\kafka-trunk\connect\runtime\src\test\java\org\apache\kafka\connect\storage\KafkaStatusBackingStoreTest.java,304,0,0,60,0,60
 pulsar-master\pulsar-master\pulsar-broker\src\test\java\org\apache\pulsar\broker\service\PersistentTopicConcurrentTest.java,304,51,14,27,0,92
 skywalking-master\skywalking-master\oap-server\oal-rt\src\test\java\org\apache\skywalking\oal\rt\parser\ScriptParserTest.java,304,96,0,80,0,176
 dubbo-3.0\dubbo-3.0\dubbo-registry\dubbo-registry-api\src\test\java\org\apache\dubbo\registry\ZKTools.java,305,137,3,25,0,165
 hadoop-trunk\hadoop-trunk\hadoop-hdfs-project\hadoop-hdfs\src\main\java\org\apache\hadoop\hdfs\server\namenode\top\window\RollingWindowManager.java,305,89,5,1,3,98
 kafka-trunk\kafka-trunk\clients\src\test\java\org\apache\kafka\clients\consumer\RangeAssignorTest.java,305,0,6,71,8,85
 kafka-trunk\kafka-trunk\streams\test-utils\src\test\java\org\apache\kafka\streams\test\MockProcessorContextAPITest.java,305,0,2,61,6,69
 pulsar-master\pulsar-master\pulsar-broker\src\main\java\org\apache\pulsar\broker\admin\impl\TenantsBase.java,305,112,23,65,0,200
 pulsar-master\pulsar-master\pulsar-functions\instance\src\test\java\org\apache\pulsar\functions\source\PulsarSourceTest.java,305,121,1,82,0,204
 hadoop-trunk\hadoop-trunk\hadoop-mapreduce-project\hadoop-mapreduce-client\hadoop-mapreduce-client-jobclient\src\test\java\org\apache\hadoop\fs\DistributedFSCheck.java,306,122,27,9,6,164
 hadoop-trunk\hadoop-trunk\hadoop-yarn-project\hadoop-yarn\hadoop-yarn-server\hadoop-yarn-server-resourcemanager\src\test\java\org\apache\hadoop\yarn\server\resourcemanager\scheduler\capacity\TestCSQueueStore.java,306,41,3,1,0,45
 pulsar-master\pulsar-master\pulsar-io\elastic-search\src\main\java\org\apache\pulsar\io\elasticsearch\client\elastic\ElasticBulkProcessor.java,306,110,5,40,0,155
 zookeeper-master\zookeeper-master\zookeeper-server\src\main\java\org\apache\zookeeper\cli\SetQuotaCommand.java,306,0,28,22,0,50
 zookeeper-master\zookeeper-master\zookeeper-server\src\test\java\org\apache\zookeeper\server\RequestThrottlerTest.java,306,0,6,31,3,40
 dubbo-3.0\dubbo-3.0\dubbo-registry\dubbo-registry-api\src\main\java\org\apache\dubbo\registry\client\migration\model\MigrationRule.java,307,113,1,29,0,143
 hadoop-trunk\hadoop-trunk\hadoop-hdfs-project\hadoop-hdfs-httpfs\src\test\java\org\apache\hadoop\fs\http\server\TestHttpFSAccessControlled.java,307,53,9,6,8,76
 hadoop-trunk\hadoop-trunk\hadoop-yarn-project\hadoop-yarn\hadoop-yarn-server\hadoop-yarn-server-nodemanager\src\main\java\org\apache\hadoop\yarn\server\nodemanager\containermanager\resourceplugin\gpu\GpuDiscoverer.java,307,38,4,7,7,56
 hadoop-trunk\hadoop-trunk\hadoop-common-project\hadoop-common\src\main\java\org\apache\hadoop\http\ProfileServlet.java,307,81,5,34,9,129
 kafka-trunk\kafka-trunk\clients\src\main\java\org\apache\kafka\common\metrics\JmxReporter.java,307,0,10,32,1,43
 pulsar-master\pulsar-master\pulsar-broker\src\test\java\org\apache\pulsar\broker\admin\CreateSubscriptionTest.java,307,83,2,59,0,144
 pulsar-master\pulsar-master\pulsar-functions\worker\src\test\java\org\apache\pulsar\functions\worker\rest\api\FunctionsImplTest.java,307,113,15,61,0,189
 pulsar-master\pulsar-master\pulsar-broker\src\test\java\org\apache\pulsar\broker\service\BrokerBkEnsemblesTests.java,307,66,13,46,0,125
 zookeeper-master\zookeeper-master\zookeeper-server\src\test\java\org\apache\zookeeper\common\AtomicFileWritingIdiomTest.java,307,0,2,21,11,34
 hadoop-trunk\hadoop-trunk\hadoop-tools\hadoop-azure\src\test\java\org\apache\hadoop\fs\azurebfs\ITestAbfsIdentityTransformer.java,308,82,1,63,0,146
 hadoop-trunk\hadoop-trunk\hadoop-common-project\hadoop-common\src\main\java\org\apache\hadoop\security\SaslRpcServer.java,308,102,6,1,4,113
 kafka-trunk\kafka-trunk\raft\src\main\java\org\apache\kafka\raft\internals\BatchBuilder.java,308,0,0,17,4,21
 pulsar-master\pulsar-master\pulsar-io\elastic-search\src\main\java\org\apache\pulsar\io\elasticsearch\ElasticSearchClient.java,308,90,5,28,0,123
 rocketmq-develop\rocketmq-develop\store\src\main\java\org\apache\rocketmq\store\stats\BrokerStatsManager.java,308,193,3,62,2,260
 hadoop-trunk\hadoop-trunk\hadoop-hdfs-project\hadoop-hdfs\src\test\java\org\apache\hadoop\hdfs\tools\offlineEditsViewer\TestOfflineEditsViewer.java,309,42,18,3,4,67
 hadoop-trunk\hadoop-trunk\hadoop-common-project\hadoop-registry\src\test\java\org\apache\hadoop\registry\secure\AbstractSecureRegistryTest.java,309,78,5,2,9,94
 hadoop-trunk\hadoop-trunk\hadoop-yarn-project\hadoop-yarn\hadoop-yarn-server\hadoop-yarn-server-router\src\test\java\org\apache\hadoop\yarn\server\router\webapp\MockRESTRequestInterceptor.java,309,177,0,14,0,191
 kafka-trunk\kafka-trunk\metadata\src\main\java\org\apache\kafka\controller\PartitionChangeBuilder.java,309,0,10,29,4,43
 pulsar-master\pulsar-master\tiered-storage\jcloud\src\main\java\org\apache\bookkeeper\mledger\offload\jcloud\provider\TieredStorageConfiguration.java,309,134,1,38,0,173
 zookeeper-master\zookeeper-master\zookeeper-server\src\test\java\org\apache\zookeeper\server\quorum\LearnerTest.java,309,0,19,26,8,53
 dubbo-3.0\dubbo-3.0\dubbo-config\dubbo-config-api\src\test\java\org\apache\dubbo\config\integration\single\SingleRegistryCenterDubboProtocolIntegrationTest.java,310,65,2,51,0,118
 hadoop-trunk\hadoop-trunk\hadoop-yarn-project\hadoop-yarn\hadoop-yarn-server\hadoop-yarn-server-nodemanager\src\main\java\org\apache\hadoop\yarn\server\nodemanager\containermanager\linux\runtime\OCIContainerRuntime.java,310,54,11,11,1,77
 pulsar-master\pulsar-master\pulsar-broker\src\main\java\org\apache\pulsar\broker\transaction\buffer\impl\TransactionBufferHandlerImpl.java,310,123,6,50,0,179
 pulsar-master\pulsar-master\pulsar-broker\src\test\java\org\apache\pulsar\broker\transaction\TransactionProduceTest.java,310,61,7,38,0,106
 dubbo-3.0\dubbo-3.0\dubbo-common\src\main\java\org\apache\dubbo\config\ReferenceConfigBase.java,311,103,4,21,7,135
 hadoop-trunk\hadoop-trunk\hadoop-hdfs-project\hadoop-hdfs\src\test\java\org\apache\hadoop\hdfs\qjournal\client\TestQuorumJournalManagerUnit.java,311,63,15,19,18,115
 hadoop-trunk\hadoop-trunk\hadoop-tools\hadoop-azure\src\test\java\org\apache\hadoop\fs\azurebfs\extensions\ITestAbfsDelegationTokens.java,311,17,1,4,2,24
 kafka-trunk\kafka-trunk\streams\src\main\java\org\apache\kafka\streams\processor\internals\StreamsProducer.java,311,0,2,63,0,65
 kafka-trunk\kafka-trunk\streams\src\test\java\org\apache\kafka\streams\state\internals\KeyValueSegmentsTest.java,311,0,1,36,5,42
 pulsar-master\pulsar-master\managed-ledger\src\main\java\org\apache\bookkeeper\mledger\impl\ManagedCursorContainer.java,311,69,3,20,0,92
 dubbo-3.0\dubbo-3.0\dubbo-registry\dubbo-registry-api\src\main\java\org\apache\dubbo\registry\client\OverrideInstanceAddressURL.java,312,150,5,33,0,188
 dubbo-3.0\dubbo-3.0\dubbo-remoting\dubbo-remoting-api\src\main\java\org\apache\dubbo\remoting\transport\AbstractClient.java,312,80,19,39,10,148
 hadoop-trunk\hadoop-trunk\hadoop-hdfs-project\hadoop-hdfs-nfs\src\main\java\org\apache\hadoop\hdfs\nfs\nfs3\WriteManager.java,312,63,16,1,0,80
 hadoop-trunk\hadoop-trunk\hadoop-common-project\hadoop-common\src\main\java\org\apache\hadoop\io\compress\snappy\SnappyDecompressor.java,312,44,6,2,1,53
 hadoop-trunk\hadoop-trunk\hadoop-yarn-project\hadoop-yarn\hadoop-yarn-client\src\test\java\org\apache\hadoop\yarn\client\api\impl\TestYarnClientImpl.java,312,21,3,8,2,34
 hadoop-trunk\hadoop-trunk\hadoop-hdfs-project\hadoop-hdfs\src\test\java\org\apache\hadoop\hdfs\server\blockmanagement\TestReconstructStripedBlocksWithRackAwareness.java,312,38,7,2,1,48
 hadoop-trunk\hadoop-trunk\hadoop-hdfs-project\hadoop-hdfs\src\main\java\org\apache\hadoop\hdfs\server\datanode\fsdataset\DataNodeVolumeMetrics.java,312,114,0,1,2,117
 hadoop-trunk\hadoop-trunk\hadoop-common-project\hadoop-common\src\main\java\org\apache\hadoop\io\retry\AsyncCallHandler.java,312,53,12,1,2,68
 hadoop-trunk\hadoop-trunk\hadoop-hdfs-project\hadoop-hdfs-client\src\main\java\org\apache\hadoop\hdfs\NameNodeProxiesClient.java,312,80,2,5,4,91
 kafka-trunk\kafka-trunk\streams\src\test\java\org\apache\kafka\streams\state\internals\TimestampedSegmentsTest.java,312,0,1,37,5,43
 pulsar-master\pulsar-master\pulsar-functions\worker\src\main\java\org\apache\pulsar\functions\worker\WorkerStatsManager.java,312,163,9,33,0,205
 hadoop-trunk\hadoop-trunk\hadoop-common-project\hadoop-common\src\test\java\org\apache\hadoop\fs\statistics\TestDurationTracking.java,313,22,2,4,0,28
 hadoop-trunk\hadoop-trunk\hadoop-tools\hadoop-rumen\src\test\java\org\apache\hadoop\tools\rumen\ConcatenatedInputFilesDemuxer.java,313,44,3,1,7,55
 hadoop-trunk\hadoop-trunk\hadoop-mapreduce-project\hadoop-mapreduce-client\hadoop-mapreduce-client-core\src\main\java\org\apache\hadoop\mapreduce\util\ProcessTree.java,313,84,12,1,7,104
 hadoop-trunk\hadoop-trunk\hadoop-yarn-project\hadoop-yarn\hadoop-yarn-server\hadoop-yarn-server-resourcemanager\src\test\java\org\apache\hadoop\yarn\server\resourcemanager\rmapp\MockRMApp.java,313,151,5,3,8,167
 hadoop-trunk\hadoop-trunk\hadoop-hdfs-project\hadoop-hdfs\src\test\java\org\apache\hadoop\hdfs\server\namenode\snapshot\TestDiffListBySkipList.java,313,62,10,4,8,84
 hadoop-trunk\hadoop-trunk\hadoop-hdfs-project\hadoop-hdfs\src\test\java\org\apache\hadoop\hdfs\TestReservedRawPaths.java,313,49,4,1,3,57
 pulsar-master\pulsar-master\pulsar-sql\presto-pulsar\src\main\java\org\apache\pulsar\sql\presto\decoder\avro\PulsarAvroColumnDecoder.java,313,74,0,30,0,104
 pulsar-master\pulsar-master\pulsar-client\src\main\java\org\apache\pulsar\client\impl\ProducerStatsRecorderImpl.java,313,118,29,25,0,172
 dubbo-3.0\dubbo-3.0\dubbo-cluster\src\main\java\org\apache\dubbo\rpc\cluster\RouterChain.java,314,113,10,37,0,160
 hadoop-trunk\hadoop-trunk\hadoop-hdfs-project\hadoop-hdfs-client\src\main\java\org\apache\hadoop\hdfs\ClientContext.java,314,50,7,8,5,70
 hadoop-trunk\hadoop-trunk\hadoop-yarn-project\hadoop-yarn\hadoop-yarn-client\src\main\java\org\apache\hadoop\yarn\client\cli\NodeCLI.java,314,25,8,2,2,37
 hadoop-trunk\hadoop-trunk\hadoop-mapreduce-project\hadoop-mapreduce-client\hadoop-mapreduce-client-jobclient\src\test\java\org\apache\hadoop\mapreduce\util\TestMRAsyncDiskService.java,314,49,6,2,14,71
 hadoop-trunk\hadoop-trunk\hadoop-hdfs-project\hadoop-hdfs\src\test\java\org\apache\hadoop\hdfs\server\datanode\TestDataNodeLifeline.java,314,46,5,11,2,64
 hadoop-trunk\hadoop-trunk\hadoop-hdfs-project\hadoop-hdfs\src\test\java\org\apache\hadoop\hdfs\server\namenode\ha\TestBootstrapStandby.java,314,34,6,6,0,46
 hadoop-trunk\hadoop-trunk\hadoop-common-project\hadoop-common\src\main\java\org\apache\hadoop\jmx\JMXJsonServlet.java,314,125,22,15,0,162
 hadoop-trunk\hadoop-trunk\hadoop-common-project\hadoop-common\src\test\java\org\apache\hadoop\io\erasurecode\rawcoder\TestRawCoderBase.java,314,39,6,3,6,54
 hadoop-trunk\hadoop-trunk\hadoop-common-project\hadoop-common\src\main\java\org\apache\hadoop\ipc\metrics\RpcMetrics.java,314,99,2,1,2,104
 kafka-trunk\kafka-trunk\streams\src\test\java\org\apache\kafka\streams\kstream\internals\InternalStreamsBuilderTest.java,314,0,1,80,1,82
 dubbo-3.0\dubbo-3.0\dubbo-cluster\src\main\java\org\apache\dubbo\rpc\cluster\router\condition\ConditionStateRouter.java,315,89,5,33,0,127
 hadoop-trunk\hadoop-trunk\hadoop-hdfs-project\hadoop-hdfs\src\test\java\org\apache\hadoop\hdfs\TestPersistBlocks.java,315,71,3,5,2,81
 hadoop-trunk\hadoop-trunk\hadoop-hdfs-project\hadoop-hdfs\src\main\java\org\apache\hadoop\hdfs\HAUtil.java,315,75,6,18,2,101
 hadoop-trunk\hadoop-trunk\hadoop-yarn-project\hadoop-yarn\hadoop-yarn-server\hadoop-yarn-server-resourcemanager\src\main\java\org\apache\hadoop\yarn\server\resourcemanager\amlauncher\AMLauncher.java,315,44,10,4,4,62
 hadoop-trunk\hadoop-trunk\hadoop-tools\hadoop-azure\src\test\java\org\apache\hadoop\fs\azure\ITestNativeAzureFileSystemAppend.java,315,60,2,12,3,77
 pulsar-master\pulsar-master\tests\integration\src\test\java\org\apache\pulsar\tests\integration\presto\TestBasicPresto.java,315,139,9,51,0,199
 dubbo-3.0\dubbo-3.0\dubbo-common\src\main\java\org\apache\dubbo\rpc\model\FrameworkModel.java,316,68,8,25,5,106
 dubbo-3.0\dubbo-3.0\dubbo-common\src\main\java\org\apache\dubbo\common\utils\ConfigUtils.java,316,80,22,30,1,133
 hadoop-trunk\hadoop-trunk\hadoop-common-project\hadoop-common\src\main\java\org\apache\hadoop\net\NetworkTopologyWithNodeGroup.java,316,70,8,1,0,79
 hadoop-trunk\hadoop-trunk\hadoop-hdfs-project\hadoop-hdfs\src\main\java\org\apache\hadoop\hdfs\server\blockmanagement\BlockUnderConstructionFeature.java,316,54,2,2,3,61
 hadoop-trunk\hadoop-trunk\hadoop-tools\hadoop-aws\src\test\java\org\apache\hadoop\fs\s3a\select\ITestS3SelectLandsat.java,316,28,5,10,0,43
 hadoop-trunk\hadoop-trunk\hadoop-common-project\hadoop-common\src\test\java\org\apache\hadoop\crypto\key\TestKeyShell.java,316,41,0,3,20,64
 hadoop-trunk\hadoop-trunk\hadoop-yarn-project\hadoop-yarn\hadoop-yarn-server\hadoop-yarn-server-resourcemanager\src\test\java\org\apache\hadoop\yarn\server\resourcemanager\TestRMEmbeddedElector.java,316,59,6,1,2,68
 kafka-trunk\kafka-trunk\clients\src\main\java\org\apache\kafka\clients\producer\internals\BufferPool.java,316,0,10,47,1,58
 kafka-trunk\kafka-trunk\clients\src\generated\java\org\apache\kafka\common\message\StopReplicaRequestDataJsonConverter.java,316,0,0,78,0,78
 kafka-trunk\kafka-trunk\clients\src\test\java\org\apache\kafka\common\security\scram\internals\ScramMessagesTest.java,316,0,8,37,0,45
 pulsar-master\pulsar-master\pulsar-broker\src\main\java\org\apache\pulsar\broker\service\PulsarCommandSenderImpl.java,316,189,2,64,0,255
 pulsar-master\pulsar-master\pulsar-client\src\main\java\org\apache\pulsar\client\impl\ClientBuilderImpl.java,316,135,3,30,0,168
 zookeeper-master\zookeeper-master\zookeeper-server\src\main\java\org\apache\zookeeper\server\SessionTrackerImpl.java,316,0,6,17,1,24
 dubbo-3.0\dubbo-3.0\dubbo-cluster\src\test\java\org\apache\dubbo\rpc\cluster\support\FailoverClusterInvokerTest.java,317,116,16,43,0,175
 hadoop-trunk\hadoop-trunk\hadoop-mapreduce-project\hadoop-mapreduce-client\hadoop-mapreduce-client-hs\src\main\java\org\apache\hadoop\mapreduce\v2\hs\HistoryServerLeveldbStateStoreService.java,317,41,10,1,0,52
 hadoop-trunk\hadoop-trunk\hadoop-hdfs-project\hadoop-hdfs\src\test\java\org\apache\hadoop\hdfs\server\diskbalancer\DiskBalancerTestUtil.java,317,52,10,3,5,70
 hadoop-trunk\hadoop-trunk\hadoop-hdfs-project\hadoop-hdfs-rbf\src\main\java\org\apache\hadoop\hdfs\server\federation\store\records\impl\pb\MountTablePBImpl.java,317,47,102,10,0,159
 hadoop-trunk\hadoop-trunk\hadoop-common-project\hadoop-common\src\main\java\org\apache\hadoop\security\ssl\SSLFactory.java,317,56,7,1,1,65
 hadoop-trunk\hadoop-trunk\hadoop-tools\hadoop-azure\src\test\java\org\apache\hadoop\fs\azurebfs\services\ITestAbfsInputStreamReadFooter.java,317,43,1,6,3,53
 hadoop-trunk\hadoop-trunk\hadoop-hdfs-project\hadoop-hdfs\src\test\java\org\apache\hadoop\hdfs\security\TestDelegationToken.java,317,69,19,13,2,103
 hadoop-trunk\hadoop-trunk\hadoop-mapreduce-project\hadoop-mapreduce-client\hadoop-mapreduce-client-hs\src\main\java\org\apache\hadoop\mapreduce\v2\hs\client\HSAdmin.java,317,30,0,9,0,39
 hadoop-trunk\hadoop-trunk\hadoop-hdfs-project\hadoop-hdfs-rbf\src\main\java\org\apache\hadoop\hdfs\rbfbalance\RouterFedBalance.java,317,47,13,6,0,66
 pulsar-master\pulsar-master\pulsar-client\src\main\java\org\apache\pulsar\client\impl\ProducerBuilderImpl.java,317,134,6,39,0,179
 dubbo-3.0\dubbo-3.0\dubbo-remoting\dubbo-remoting-api\src\main\java\org\apache\dubbo\remoting\buffer\AbstractChannelBuffer.java,318,113,0,2,0,115
 hadoop-trunk\hadoop-trunk\hadoop-yarn-project\hadoop-yarn\hadoop-yarn-server\hadoop-yarn-server-resourcemanager\src\main\java\org\apache\hadoop\yarn\server\resourcemanager\scheduler\capacity\QueueCapacities.java,318,199,2,4,0,205
 hadoop-trunk\hadoop-trunk\hadoop-common-project\hadoop-common\src\test\java\org\apache\hadoop\io\compress\lz4\TestLz4CompressorDecompressor.java,318,98,31,12,10,151
 hadoop-trunk\hadoop-trunk\hadoop-mapreduce-project\hadoop-mapreduce-client\hadoop-mapreduce-client-core\src\test\java\org\apache\hadoop\mapreduce\lib\output\committer\manifest\TestRenameStageFailure.java,318,20,3,15,2,40
 hadoop-trunk\hadoop-trunk\hadoop-tools\hadoop-aws\src\test\java\org\apache\hadoop\fs\s3a\auth\delegation\MiniKerberizedHadoopCluster.java,318,51,18,6,5,80
 hadoop-trunk\hadoop-trunk\hadoop-hdfs-project\hadoop-hdfs\src\test\java\org\apache\hadoop\hdfs\server\namenode\TestAuditLogs.java,318,97,12,13,3,125
 hadoop-trunk\hadoop-trunk\hadoop-hdfs-project\hadoop-hdfs\src\test\java\org\apache\hadoop\hdfs\TestReplaceDatanodeOnFailure.java,318,90,22,4,5,121
 zookeeper-master\zookeeper-master\zookeeper-server\src\test\java\org\apache\zookeeper\test\QuorumBaseOracle_2Nodes.java,318,0,16,23,13,52
 hadoop-trunk\hadoop-trunk\hadoop-mapreduce-project\hadoop-mapreduce-client\hadoop-mapreduce-client-app\src\main\java\org\apache\hadoop\mapreduce\v2\app\webapp\dao\JobInfo.java,319,147,4,5,4,160
 hadoop-trunk\hadoop-trunk\hadoop-yarn-project\hadoop-yarn\hadoop-yarn-server\hadoop-yarn-server-resourcemanager\src\main\java\org\apache\hadoop\yarn\server\resourcemanager\scheduler\capacity\placement\schema\Rule.java,319,279,0,18,6,303
 hadoop-trunk\hadoop-trunk\hadoop-hdfs-project\hadoop-hdfs\src\test\java\org\apache\hadoop\hdfs\tools\TestDFSZKFailoverController.java,319,76,5,3,5,89
 hadoop-trunk\hadoop-trunk\hadoop-common-project\hadoop-common\src\main\java\org\apache\hadoop\io\erasurecode\coder\HHXORErasureDecodingStep.java,319,38,1,1,1,41
 kafka-trunk\kafka-trunk\clients\src\generated\java\org\apache\kafka\common\message\FindCoordinatorRequestData.java,319,0,0,33,4,37
 kafka-trunk\kafka-trunk\metadata\src\generated\java\org\apache\kafka\common\metadata\DelegationTokenRecord.java,319,0,0,31,6,37
 hadoop-trunk\hadoop-trunk\hadoop-mapreduce-project\hadoop-mapreduce-client\hadoop-mapreduce-client-jobclient\src\test\java\org\apache\hadoop\hdfs\NNBenchWithoutMR.java,320,91,14,8,1,114
 hadoop-trunk\hadoop-trunk\hadoop-yarn-project\hadoop-yarn\hadoop-yarn-server\hadoop-yarn-server-resourcemanager\src\main\java\org\apache\hadoop\yarn\server\resourcemanager\webapp\dao\CapacitySchedulerQueueInfo.java,320,173,5,9,10,197
 hadoop-trunk\hadoop-trunk\hadoop-yarn-project\hadoop-yarn\hadoop-yarn-server\hadoop-yarn-server-resourcemanager\src\main\java\org\apache\hadoop\yarn\server\resourcemanager\scheduler\capacity\conf\FSSchedulerConfigurationStore.java,320,33,20,1,1,55
 hadoop-trunk\hadoop-trunk\hadoop-yarn-project\hadoop-yarn\hadoop-yarn-server\hadoop-yarn-server-resourcemanager\src\test\java\org\apache\hadoop\yarn\server\resourcemanager\nodelabels\TestNodeAttributesManager.java,320,45,0,1,1,47
 kafka-trunk\kafka-trunk\connect\runtime\src\test\java\org\apache\kafka\connect\integration\RebalanceSourceConnectorsIntegrationTest.java,320,0,2,66,2,70
 kafka-trunk\kafka-trunk\streams\src\main\java\org\apache\kafka\streams\state\internals\AbstractRocksDBSegmentedBytesStore.java,320,0,4,34,1,39
 pulsar-master\pulsar-master\pulsar-testclient\src\main\java\org\apache\pulsar\testclient\LoadSimulationClient.java,320,88,6,30,0,124
 skywalking-master\skywalking-master\oap-server\server-core\src\main\java\org\apache\skywalking\oap\server\core\analysis\worker\MetricsPersistentWorker.java,320,125,11,55,0,191
 dubbo-3.0\dubbo-3.0\dubbo-common\src\main\java\org\apache\dubbo\config\context\ModuleConfigManager.java,321,139,0,24,1,164
 hadoop-trunk\hadoop-trunk\hadoop-tools\hadoop-azure\src\test\java\org\apache\hadoop\fs\azurebfs\ITestAzureBlobFileSystemAuthorization.java,321,77,8,16,3,104
 hadoop-trunk\hadoop-trunk\hadoop-common-project\hadoop-common\src\main\java\org\apache\hadoop\io\compress\CompressionCodecFactory.java,321,40,5,1,1,47
 hadoop-trunk\hadoop-trunk\hadoop-tools\hadoop-sls\src\test\java\org\apache\hadoop\yarn\sls\appmaster\TestAMSimulator.java,321,49,10,4,3,66
 hadoop-trunk\hadoop-trunk\hadoop-yarn-project\hadoop-yarn\hadoop-yarn-server\hadoop-yarn-server-resourcemanager\src\test\java\org\apache\hadoop\yarn\server\resourcemanager\scheduler\fair\TestFairSchedulerFairShare.java,321,97,5,9,1,112
 hadoop-trunk\hadoop-trunk\hadoop-mapreduce-project\hadoop-mapreduce-client\hadoop-mapreduce-client-jobclient\src\test\java\org\apache\hadoop\mapreduce\lib\input\TestMRKeyValueTextInputFormat.java,321,95,26,4,6,131
 kafka-trunk\kafka-trunk\connect\mirror\src\test\java\org\apache\kafka\connect\mirror\MirrorMakerConfigTest.java,321,0,2,67,0,69
 kafka-trunk\kafka-trunk\trogdor\src\main\java\org\apache\kafka\trogdor\workload\ExternalCommandWorker.java,321,0,14,36,2,52
 kafka-trunk\kafka-trunk\connect\api\src\main\java\org\apache\kafka\connect\data\ConnectSchema.java,321,0,17,50,3,70
 pulsar-master\pulsar-master\pulsar-testclient\src\main\java\org\apache\pulsar\testclient\PerformanceReader.java,321,147,12,60,0,219
 rocketmq-develop\rocketmq-develop\broker\src\test\java\org\apache\rocketmq\broker\filter\MessageStoreWithFilterTest.java,321,147,10,55,5,217
 hadoop-trunk\hadoop-trunk\hadoop-yarn-project\hadoop-yarn\hadoop-yarn-server\hadoop-yarn-server-resourcemanager\src\main\java\org\apache\hadoop\yarn\server\resourcemanager\DecommissioningNodesWatcher.java,322,77,12,2,1,92
 hadoop-trunk\hadoop-trunk\hadoop-hdfs-project\hadoop-hdfs\src\test\java\org\apache\hadoop\hdfs\server\namenode\ha\HATestUtil.java,322,144,4,8,1,157
 hadoop-trunk\hadoop-trunk\hadoop-common-project\hadoop-common\src\test\java\org\apache\hadoop\fs\contract\AbstractContractRenameTest.java,322,55,2,7,0,64
 hadoop-trunk\hadoop-trunk\hadoop-hdfs-project\hadoop-hdfs-rbf\src\main\java\org\apache\hadoop\hdfs\server\federation\store\records\impl\pb\MembershipStatePBImpl.java,322,61,102,8,0,171
 kafka-trunk\kafka-trunk\streams\test-utils\src\test\java\org\apache\kafka\streams\MockProcessorContextTest.java,322,0,17,60,7,84
 dubbo-3.0\dubbo-3.0\dubbo-cluster\src\test\java\org\apache\dubbo\rpc\cluster\router\mesh\route\MeshAppRuleListenerTest.java,323,159,16,55,0,230
 hadoop-trunk\hadoop-trunk\hadoop-hdfs-project\hadoop-hdfs-client\src\main\java\org\apache\hadoop\hdfs\protocol\CacheDirectiveInfo.java,323,47,1,1,0,49
 hadoop-trunk\hadoop-trunk\hadoop-hdfs-project\hadoop-hdfs\src\test\java\org\apache\hadoop\hdfs\TestLeaseRecoveryStriped.java,323,84,10,2,0,96
 kafka-trunk\kafka-trunk\log4j-appender\src\main\java\org\apache\kafka\log4jappender\KafkaLog4jAppender.java,323,0,8,29,3,40
 kafka-trunk\kafka-trunk\clients\src\generated\java\org\apache\kafka\common\message\DescribeUserScramCredentialsRequestData.java,323,0,0,28,6,34
 kafka-trunk\kafka-trunk\clients\src\test\java\org\apache\kafka\common\metrics\SensorTest.java,323,0,3,53,1,57
 pulsar-master\pulsar-master\pulsar-client\src\main\java\org\apache\pulsar\client\impl\BinaryProtoLookupService.java,323,140,5,65,0,210
 zookeeper-master\zookeeper-master\zookeeper-contrib\zookeeper-contrib-loggraph\src\main\java\org\apache\zookeeper\graph\TxnLogSource.java,323,0,51,21,6,78
 hadoop-trunk\hadoop-trunk\hadoop-common-project\hadoop-common\src\main\java\org\apache\hadoop\log\LogThrottlingHelper.java,324,39,0,1,0,40
 hadoop-trunk\hadoop-trunk\hadoop-tools\hadoop-aws\src\test\java\org\apache\hadoop\fs\s3a\commit\AbstractCommitITest.java,324,34,9,2,3,48
 hadoop-trunk\hadoop-trunk\hadoop-common-project\hadoop-common\src\test\java\org\apache\hadoop\security\http\TestRestCsrfPreventionFilter.java,324,15,5,1,0,21
 hadoop-trunk\hadoop-trunk\hadoop-hdfs-project\hadoop-hdfs\src\main\java\org\apache\hadoop\hdfs\server\namenode\snapshot\SnapshotFSImageFormat.java,324,87,3,5,0,95
 hadoop-trunk\hadoop-trunk\hadoop-hdfs-project\hadoop-hdfs-client\src\main\java\org\apache\hadoop\hdfs\DFSPacket.java,324,81,1,1,3,86
 hadoop-trunk\hadoop-trunk\hadoop-yarn-project\hadoop-yarn\hadoop-yarn-server\hadoop-yarn-server-nodemanager\src\main\java\org\apache\hadoop\yarn\server\nodemanager\containermanager\monitor\ContainerMetrics.java,324,129,1,1,0,131
 hadoop-trunk\hadoop-trunk\hadoop-tools\hadoop-aws\src\test\java\org\apache\hadoop\fs\s3a\MockS3AFileSystem.java,324,100,11,3,6,120
 kafka-trunk\kafka-trunk\clients\src\test\java\org\apache\kafka\common\message\SimpleExampleMessageTest.java,324,0,0,25,0,25
 kafka-trunk\kafka-trunk\clients\src\generated\java\org\apache\kafka\common\message\DescribeConfigsResponseDataJsonConverter.java,324,0,0,66,0,66
 kafka-trunk\kafka-trunk\clients\src\test\java\org\apache\kafka\common\utils\ByteUtilsTest.java,324,0,18,50,16,84
 pulsar-master\pulsar-master\pulsar-broker\src\test\java\org\apache\pulsar\schema\compatibility\SchemaTypeCompatibilityCheckTest.java,324,72,0,55,0,127
 pulsar-master\pulsar-master\managed-ledger\src\main\java\org\apache\bookkeeper\mledger\impl\EntryCacheImpl.java,324,103,7,58,0,168
 hadoop-trunk\hadoop-trunk\hadoop-yarn-project\hadoop-yarn\hadoop-yarn-api\src\main\java\org\apache\hadoop\yarn\conf\HAUtil.java,325,65,7,1,1,74
 hadoop-trunk\hadoop-trunk\hadoop-yarn-project\hadoop-yarn\hadoop-yarn-common\src\test\java\org\apache\hadoop\yarn\nodelabels\TestFileSystemNodeLabelsStore.java,325,50,1,1,2,54
 hadoop-trunk\hadoop-trunk\hadoop-hdfs-project\hadoop-hdfs-rbf\src\main\java\org\apache\hadoop\hdfs\server\federation\router\Quota.java,325,29,3,1,2,35
 hadoop-trunk\hadoop-trunk\hadoop-yarn-project\hadoop-yarn\hadoop-yarn-server\hadoop-yarn-server-nodemanager\src\test\java\org\apache\hadoop\yarn\server\nodemanager\timelineservice\TestNMTimelinePublisher.java,325,42,25,7,0,74
 hadoop-trunk\hadoop-trunk\hadoop-common-project\hadoop-common\src\main\java\org\apache\hadoop\security\authorize\AccessControlList.java,325,67,3,4,2,76
 hadoop-trunk\hadoop-trunk\hadoop-hdfs-project\hadoop-hdfs\src\main\java\org\apache\hadoop\hdfs\server\diskbalancer\datamodel\DiskBalancerCluster.java,325,43,5,1,6,55
 kafka-trunk\kafka-trunk\clients\src\main\java\org\apache\kafka\common\security\oauthbearer\internals\unsecured\OAuthBearerUnsecuredJws.java,325,0,20,38,7,65
 kafka-trunk\kafka-trunk\streams\src\test\java\org\apache\kafka\streams\kstream\internals\KGroupedTableImplTest.java,325,0,6,39,1,46
 dubbo-3.0\dubbo-3.0\dubbo-common\src\test\java\org\apache\dubbo\common\utils\AnnotationUtilsTest.java,326,64,7,41,0,112
 hadoop-trunk\hadoop-trunk\hadoop-hdfs-project\hadoop-hdfs\src\test\java\org\apache\hadoop\hdfs\server\common\blockaliasmap\impl\TestInMemoryLevelDBAliasMapClient.java,326,98,7,2,12,119
 hadoop-trunk\hadoop-trunk\hadoop-mapreduce-project\hadoop-mapreduce-client\hadoop-mapreduce-client-core\src\test\java\org\apache\hadoop\mapreduce\lib\output\committer\manifest\impl\UnreliableManifestStoreOperations.java,326,48,1,7,1,57
 hadoop-trunk\hadoop-trunk\hadoop-common-project\hadoop-common\src\test\java\org\apache\hadoop\ha\MiniZKFCCluster.java,326,117,4,7,2,130
 hadoop-trunk\hadoop-trunk\hadoop-mapreduce-project\hadoop-mapreduce-client\hadoop-mapreduce-client-jobclient\src\test\java\org\apache\hadoop\mapreduce\lib\output\TestMRMultipleOutputs.java,326,116,42,2,6,166
 hadoop-trunk\hadoop-trunk\hadoop-yarn-project\hadoop-yarn\hadoop-yarn-server\hadoop-yarn-server-resourcemanager\src\test\java\org\apache\hadoop\yarn\server\resourcemanager\TestResourceManager.java,326,76,14,17,1,108
 kafka-trunk\kafka-trunk\streams\src\test\java\org\apache\kafka\streams\state\internals\SegmentIteratorTest.java,326,0,0,37,53,90
 kafka-trunk\kafka-trunk\metadata\src\main\java\org\apache\kafka\controller\StripedReplicaPlacer.java,326,0,5,66,1,72
 kafka-trunk\kafka-trunk\metadata\src\generated\java\org\apache\kafka\common\metadata\AccessControlRecord.java,326,0,0,25,5,30
 pulsar-master\pulsar-master\pulsar-client\src\main\java\org\apache\pulsar\client\impl\schema\AutoConsumeSchema.java,326,103,7,38,0,148
 zookeeper-master\zookeeper-master\zookeeper-server\src\main\java\org\apache\zookeeper\server\quorum\flexible\QuorumHierarchical.java,326,0,16,10,3,29
 hadoop-trunk\hadoop-trunk\hadoop-yarn-project\hadoop-yarn\hadoop-yarn-client\src\test\java\org\apache\hadoop\yarn\client\cli\TestSchedConfCLI.java,327,47,2,7,7,63
 hadoop-trunk\hadoop-trunk\hadoop-cloud-storage-project\hadoop-cos\src\main\java\org\apache\hadoop\fs\cosn\CosNInputStream.java,327,78,0,1,4,83
 pulsar-master\pulsar-master\tiered-storage\file-system\src\main\java\org\apache\bookkeeper\mledger\offload\filesystem\impl\FileSystemManagedLedgerOffloader.java,327,138,6,44,0,188
 pulsar-master\pulsar-master\pulsar-sql\presto-pulsar\src\main\java\org\apache\pulsar\sql\presto\PulsarConnectorMetricsTracker.java,327,174,20,51,0,245
 hadoop-trunk\hadoop-trunk\hadoop-yarn-project\hadoop-yarn\hadoop-yarn-server\hadoop-yarn-server-resourcemanager\src\main\java\org\apache\hadoop\yarn\server\resourcemanager\scheduler\capacity\conf\MutableCSConfigurationProvider.java,328,54,1,7,1,63
 hadoop-trunk\hadoop-trunk\hadoop-tools\hadoop-sls\src\main\java\org\apache\hadoop\yarn\sls\synthetic\SynthJob.java,328,118,3,1,2,124
 hadoop-trunk\hadoop-trunk\hadoop-tools\hadoop-gridmix\src\test\java\org\apache\hadoop\mapred\gridmix\CommonJobTest.java,328,63,11,17,4,95
 kafka-trunk\kafka-trunk\connect\api\src\test\java\org\apache\kafka\connect\data\StructTest.java,328,0,0,38,8,46
 kafka-trunk\kafka-trunk\core\src\test\java\kafka\test\MockController.java,328,0,4,43,1,48
 pulsar-master\pulsar-master\pulsar-client\src\main\java\org\apache\pulsar\client\impl\AutoClusterFailover.java,328,144,8,58,0,210
 pulsar-master\pulsar-master\pulsar-client\src\test\java\org\apache\pulsar\client\impl\ProducerBuilderImplTest.java,328,86,1,42,0,129
 dubbo-3.0\dubbo-3.0\dubbo-configcenter\dubbo-configcenter-nacos\src\main\java\org\apache\dubbo\configcenter\support\nacos\NacosDynamicConfiguration.java,329,98,8,18,0,124
 hadoop-trunk\hadoop-trunk\hadoop-yarn-project\hadoop-yarn\hadoop-yarn-server\hadoop-yarn-server-resourcemanager\src\test\java\org\apache\hadoop\yarn\server\resourcemanager\webapp\TestRMWebServicesCapacitySched.java,329,79,0,21,2,102
 hadoop-trunk\hadoop-trunk\hadoop-tools\hadoop-aws\src\test\java\org\apache\hadoop\fs\s3a\ITestS3AEncryptionSSEC.java,329,16,4,3,0,23
 kafka-trunk\kafka-trunk\streams\src\test\java\org\apache\kafka\streams\processor\internals\StreamsMetadataStateTest.java,329,0,2,69,4,75
 kafka-trunk\kafka-trunk\streams\src\main\java\org\apache\kafka\streams\processor\internals\assignment\SubscriptionInfo.java,329,0,1,56,3,60
 pulsar-master\pulsar-master\pulsar-functions\runtime\src\main\java\org\apache\pulsar\functions\runtime\JavaInstanceStarter.java,329,150,17,67,0,234
 pulsar-master\pulsar-master\pulsar-proxy\src\test\java\org\apache\pulsar\proxy\server\ProxyWithJwtAuthorizationTest.java,329,82,9,45,0,136
 shardingsphere-master\shardingsphere-master\shardingsphere-features\shardingsphere-sharding\shardingsphere-sharding-core\src\test\java\org\apache\shardingsphere\sharding\metadata\ShardingTableMetaDataBuilderTest.java,329,146,36,99,0,281
 hadoop-trunk\hadoop-trunk\hadoop-yarn-project\hadoop-yarn\hadoop-yarn-server\hadoop-yarn-server-router\src\test\java\org\apache\hadoop\yarn\server\router\webapp\BaseRouterWebServicesTest.java,330,104,0,9,0,113
 hadoop-trunk\hadoop-trunk\hadoop-common-project\hadoop-common\src\main\java\org\apache\hadoop\util\HostsFileReader.java,330,107,9,1,4,121
 hadoop-trunk\hadoop-trunk\hadoop-mapreduce-project\hadoop-mapreduce-client\hadoop-mapreduce-client-jobclient\src\test\java\org\apache\hadoop\mapred\TestMiniMRChildTask.java,330,99,22,2,5,128
 kafka-trunk\kafka-trunk\clients\src\test\java\org\apache\kafka\common\compress\KafkaLZ4Test.java,330,0,13,29,0,42
 pulsar-master\pulsar-master\pulsar-broker\src\main\java\org\apache\pulsar\PulsarClusterMetadataSetup.java,330,117,2,71,0,190
 pulsar-master\pulsar-master\pulsar-broker\src\test\java\org\apache\pulsar\client\impl\MessageRedeliveryTest.java,330,75,9,33,0,117
 dubbo-3.0\dubbo-3.0\dubbo-cluster\src\test\java\org\apache\dubbo\rpc\cluster\router\mesh\route\MeshRuleRouterTest.java,331,201,3,63,0,267
 hadoop-trunk\hadoop-trunk\hadoop-tools\hadoop-rumen\src\main\java\org\apache\hadoop\tools\rumen\LoggedTask.java,331,133,18,1,4,156
 hadoop-trunk\hadoop-trunk\hadoop-mapreduce-project\hadoop-mapreduce-client\hadoop-mapreduce-client-core\src\test\java\org\apache\hadoop\mapreduce\task\reduce\TestShuffleScheduler.java,331,146,7,28,4,185
 hadoop-trunk\hadoop-trunk\hadoop-common-project\hadoop-common\src\main\java\org\apache\hadoop\fs\QuotaUsage.java,331,106,2,1,1,110
 hadoop-trunk\hadoop-trunk\hadoop-hdfs-project\hadoop-hdfs\src\main\java\org\apache\hadoop\hdfs\server\datanode\ShortCircuitRegistry.java,331,87,11,5,1,104
 hadoop-trunk\hadoop-trunk\hadoop-common-project\hadoop-common\src\test\java\org\apache\hadoop\fs\viewfs\TestChRootedFs.java,331,102,6,8,2,118
 hadoop-trunk\hadoop-trunk\hadoop-mapreduce-project\hadoop-mapreduce-client\hadoop-mapreduce-client-app\src\test\java\org\apache\hadoop\mapreduce\v2\app\webapp\TestBlocks.java,331,46,10,1,26,83
 hadoop-trunk\hadoop-trunk\hadoop-yarn-project\hadoop-yarn\hadoop-yarn-server\hadoop-yarn-server-nodemanager\src\test\java\org\apache\hadoop\yarn\server\nodemanager\TestDeletionService.java,331,63,5,4,10,82
 hadoop-trunk\hadoop-trunk\hadoop-yarn-project\hadoop-yarn\hadoop-yarn-server\hadoop-yarn-server-resourcemanager\src\main\java\org\apache\hadoop\yarn\server\resourcemanager\ClusterMetrics.java,331,191,5,3,3,202
 kafka-trunk\kafka-trunk\connect\runtime\src\main\java\org\apache\kafka\connect\runtime\isolation\PluginUtils.java,331,0,3,29,2,34
 pulsar-master\pulsar-master\tiered-storage\jcloud\src\test\java\org\apache\bookkeeper\mledger\offload\jcloud\impl\MockManagedLedger.java,331,164,29,39,0,232
 skywalking-master\skywalking-master\oap-server\analyzer\agent-analyzer\src\test\java\org\apache\skywalking\oap\server\analyzer\provider\trace\TraceSamplingPolicyWatcherTest.java,331,186,0,57,0,243
 hadoop-trunk\hadoop-trunk\hadoop-hdfs-project\hadoop-hdfs\src\test\java\org\apache\hadoop\hdfs\server\datanode\TestDataNodeMultipleRegistrations.java,332,59,26,13,0,98
 hadoop-trunk\hadoop-trunk\hadoop-common-project\hadoop-common\src\main\java\org\apache\hadoop\util\DiskChecker.java,332,56,6,1,0,63
 hadoop-trunk\hadoop-trunk\hadoop-common-project\hadoop-common\src\test\java\org\apache\hadoop\crypto\TestCryptoCodec.java,332,134,23,2,8,167
 hadoop-trunk\hadoop-trunk\hadoop-common-project\hadoop-registry\src\main\java\org\apache\hadoop\registry\server\dns\ApplicationServiceRecordProcessor.java,332,37,7,1,0,45
 hadoop-trunk\hadoop-trunk\hadoop-mapreduce-project\hadoop-mapreduce-client\hadoop-mapreduce-client-common\src\main\java\org\apache\hadoop\mapreduce\v2\jobhistory\FileNameIndexUtils.java,332,58,9,1,0,68
 hadoop-trunk\hadoop-trunk\hadoop-common-project\hadoop-common\src\test\java\org\apache\hadoop\io\retry\TestFailoverProxy.java,332,103,5,10,6,124
 hadoop-trunk\hadoop-trunk\hadoop-hdfs-project\hadoop-hdfs-rbf\src\test\java\org\apache\hadoop\hdfs\server\federation\router\TestRouterMountTableCacheRefresh.java,332,24,4,11,2,41
 kafka-trunk\kafka-trunk\clients\src\test\java\org\apache\kafka\common\network\SslSelectorTest.java,332,0,9,62,2,73
 kafka-trunk\kafka-trunk\clients\src\test\java\org\apache\kafka\common\network\NioEchoServer.java,332,0,19,60,6,85
 pulsar-master\pulsar-master\tests\integration\src\test\java\org\apache\pulsar\tests\integration\compaction\TestCompaction.java,332,92,1,45,0,138
 pulsar-master\pulsar-master\pulsar-client-tools\src\main\java\org\apache\pulsar\admin\cli\PulsarAdminTool.java,332,100,8,42,0,150
 pulsar-master\pulsar-master\pulsar-io\flume\src\test\java\org\apache\pulsar\io\flume\node\TestAbstractConfigurationProvider.java,332,60,1,12,0,73
 zookeeper-master\zookeeper-master\zookeeper-server\src\test\java\org\apache\zookeeper\server\quorum\auth\MiniKdc.java,332,0,7,34,4,45
 hadoop-trunk\hadoop-trunk\hadoop-yarn-project\hadoop-yarn\hadoop-yarn-server\hadoop-yarn-server-resourcemanager\src\main\java\org\apache\hadoop\yarn\server\resourcemanager\scheduler\ContainerUpdateContext.java,333,47,0,3,0,50
 hadoop-trunk\hadoop-trunk\hadoop-hdfs-project\hadoop-hdfs\src\main\java\org\apache\hadoop\hdfs\server\namenode\FsImageValidation.java,333,67,18,5,1,91
 kafka-trunk\kafka-trunk\connect\runtime\src\test\java\org\apache\kafka\connect\integration\ConnectorHandle.java,333,0,0,74,1,75
 pulsar-master\pulsar-master\pulsar-sql\presto-pulsar\src\main\java\org\apache\pulsar\sql\presto\decoder\protobufnative\PulsarProtobufNativeColumnDecoder.java,333,88,1,39,0,128
 dubbo-3.0\dubbo-3.0\dubbo-cluster\src\test\java\org\apache\dubbo\rpc\cluster\router\condition\ConditionStateRouterTest.java,334,142,16,106,0,264
 dubbo-3.0\dubbo-3.0\dubbo-rpc\dubbo-rpc-api\src\test\java\org\apache\dubbo\rpc\support\RpcUtilsTest.java,334,67,77,40,0,184
 dubbo-3.0\dubbo-3.0\dubbo-registry\dubbo-registry-api\src\main\java\org\apache\dubbo\registry\client\DefaultServiceInstance.java,334,161,3,19,0,183
 hadoop-trunk\hadoop-trunk\hadoop-hdfs-project\hadoop-hdfs-client\src\main\java\org\apache\hadoop\hdfs\security\token\block\BlockTokenIdentifier.java,334,90,10,2,8,110
 hadoop-trunk\hadoop-trunk\hadoop-common-project\hadoop-common\src\main\java\org\apache\hadoop\io\UTF8.java,334,158,10,2,1,171
 kafka-trunk\kafka-trunk\clients\src\test\java\org\apache\kafka\common\serialization\SerializationTest.java,334,0,20,83,29,132
 hadoop-trunk\hadoop-trunk\hadoop-mapreduce-project\hadoop-mapreduce-client\hadoop-mapreduce-client-core\src\test\java\org\apache\hadoop\mapreduce\task\reduce\TestMerger.java,336,84,5,11,6,106
 hadoop-trunk\hadoop-trunk\hadoop-yarn-project\hadoop-yarn\hadoop-yarn-server\hadoop-yarn-server-resourcemanager\src\main\java\org\apache\hadoop\yarn\server\resourcemanager\recovery\records\impl\pb\ApplicationStateDataPBImpl.java,336,69,98,7,0,174
 hadoop-trunk\hadoop-trunk\hadoop-yarn-project\hadoop-yarn\hadoop-yarn-common\src\test\java\org\apache\hadoop\yarn\logaggregation\TestAggregatedLogsBlock.java,336,44,4,9,18,75
 hadoop-trunk\hadoop-trunk\hadoop-mapreduce-project\hadoop-mapreduce-client\hadoop-mapreduce-client-jobclient\src\test\java\org\apache\hadoop\mapreduce\util\MRAsyncDiskService.java,336,112,12,4,7,135
 hadoop-trunk\hadoop-trunk\hadoop-hdfs-project\hadoop-hdfs\src\test\java\org\apache\hadoop\hdfs\TestDFSClientFailover.java,336,68,6,9,0,83
 hadoop-trunk\hadoop-trunk\hadoop-tools\hadoop-streaming\src\main\java\org\apache\hadoop\typedbytes\TypedBytesWritableInput.java,336,99,0,1,3,103
 pulsar-master\pulsar-master\tests\integration\src\test\java\org\apache\pulsar\tests\integration\functions\utils\CommandGenerator.java,336,92,5,28,0,125
 rocketmq-develop\rocketmq-develop\remoting\src\main\java\org\apache\rocketmq\remoting\netty\NettyLogger.java,336,91,3,9,0,103
 zookeeper-master\zookeeper-master\zookeeper-server\src\test\java\org\apache\zookeeper\server\PrepRequestProcessorTest.java,336,0,47,34,0,81
 hadoop-trunk\hadoop-trunk\hadoop-hdfs-project\hadoop-hdfs\src\test\java\org\apache\hadoop\hdfs\TestFSInputChecker.java,337,199,6,3,0,208
 hadoop-trunk\hadoop-trunk\hadoop-yarn-project\hadoop-yarn\hadoop-yarn-server\hadoop-yarn-server-resourcemanager\src\test\java\org\apache\hadoop\yarn\server\resourcemanager\applicationsmanager\MockAsm.java,337,67,2,1,4,74
 hadoop-trunk\hadoop-trunk\hadoop-hdfs-project\hadoop-hdfs\src\main\java\org\apache\hadoop\hdfs\server\aliasmap\InMemoryAliasMap.java,337,58,12,3,2,75
 kafka-trunk\kafka-trunk\metadata\src\generated\java\org\apache\kafka\common\metadata\AccessControlEntryRecord.java,337,0,0,25,5,30
 hadoop-trunk\hadoop-trunk\hadoop-common-project\hadoop-common\src\test\java\org\apache\hadoop\fs\sftp\TestSFTPFileSystem.java,338,41,28,1,20,90
 hadoop-trunk\hadoop-trunk\hadoop-common-project\hadoop-common\src\test\java\org\apache\hadoop\security\TestShellBasedIdMapping.java,338,138,10,15,11,174
 hadoop-trunk\hadoop-trunk\hadoop-yarn-project\hadoop-yarn\hadoop-yarn-server\hadoop-yarn-server-resourcemanager\src\test\java\org\apache\hadoop\yarn\server\resourcemanager\scheduler\fair\TestFSAppAttempt.java,338,52,2,7,1,62
 hadoop-trunk\hadoop-trunk\hadoop-hdfs-project\hadoop-hdfs\src\test\java\org\apache\hadoop\hdfs\server\balancer\TestBalancerWithHANameNodes.java,338,33,3,3,3,42
 kafka-trunk\kafka-trunk\connect\runtime\src\test\java\org\apache\kafka\connect\integration\TaskHandle.java,338,0,0,43,2,45
 rocketmq-develop\rocketmq-develop\store\src\main\java\org\apache\rocketmq\store\index\IndexService.java,338,68,12,24,1,105
 zookeeper-master\zookeeper-master\zookeeper-server\src\test\java\org\apache\zookeeper\ClientCnxnSocketFragilityTest.java,338,0,21,15,7,43
 hadoop-trunk\hadoop-trunk\hadoop-yarn-project\hadoop-yarn\hadoop-yarn-common\src\main\java\org\apache\hadoop\yarn\webapp\hamlet2\HamletImpl.java,339,139,14,1,2,156
 hadoop-trunk\hadoop-trunk\hadoop-yarn-project\hadoop-yarn\hadoop-yarn-server\hadoop-yarn-server-resourcemanager\src\test\java\org\apache\hadoop\yarn\server\resourcemanager\TestSubmitApplicationWithRMHA.java,339,31,1,2,0,34
 hadoop-trunk\hadoop-trunk\hadoop-common-project\hadoop-common\src\test\java\org\apache\hadoop\util\TestIndexedSort.java,339,118,21,1,7,147
 hadoop-trunk\hadoop-trunk\hadoop-common-project\hadoop-common\src\test\java\org\apache\hadoop\ipc\MiniRPCBenchmark.java,339,169,22,10,3,204
 hadoop-trunk\hadoop-trunk\hadoop-mapreduce-project\hadoop-mapreduce-examples\src\test\java\org\apache\hadoop\examples\pi\math\TestModular.java,339,132,53,1,0,186
 hadoop-trunk\hadoop-trunk\hadoop-yarn-project\hadoop-yarn\hadoop-yarn-server\hadoop-yarn-server-resourcemanager\src\test\java\org\apache\hadoop\yarn\server\resourcemanager\scheduler\fair\FairSchedulerTestBase.java,339,138,1,14,1,154
 hadoop-trunk\hadoop-trunk\hadoop-hdfs-project\hadoop-hdfs\src\test\java\org\apache\hadoop\hdfs\web\TestWebHdfsTimeouts.java,339,61,12,10,2,85
 pulsar-master\pulsar-master\pulsar-broker\src\test\java\org\apache\pulsar\broker\service\TopicTerminationTest.java,339,65,11,30,0,106
 rocketmq-develop\rocketmq-develop\acl\src\test\java\org\apache\rocketmq\acl\plain\PlainAccessControlFlowTest.java,339,117,3,73,1,194
 rocketmq-develop\rocketmq-develop\broker\src\main\java\org\apache\rocketmq\broker\out\BrokerOuterAPI.java,339,117,5,70,4,196
 dubbo-3.0\dubbo-3.0\compiler\src\main\java\org\apache\dubbo\gen\AbstractGenerator.java,340,136,2,46,0,184
 hadoop-trunk\hadoop-trunk\hadoop-common-project\hadoop-common\src\main\java\org\apache\hadoop\ipc\RetryCache.java,340,126,2,1,4,133
 hadoop-trunk\hadoop-trunk\hadoop-common-project\hadoop-auth\src\main\java\org\apache\hadoop\security\authentication\server\KerberosAuthenticationHandler.java,340,25,5,1,2,33
 hadoop-trunk\hadoop-trunk\hadoop-hdfs-project\hadoop-hdfs\src\main\java\org\apache\hadoop\hdfs\server\diskbalancer\datamodel\DiskBalancerVolume.java,340,35,3,1,0,39
 hadoop-trunk\hadoop-trunk\hadoop-mapreduce-project\hadoop-mapreduce-client\hadoop-mapreduce-client-jobclient\src\test\java\org\apache\hadoop\mapred\TestNetworkedJob.java,340,44,2,2,16,64
 hadoop-trunk\hadoop-trunk\hadoop-tools\hadoop-openstack\src\test\java\org\apache\hadoop\fs\swift\TestFSMainOperationsSwift.java,340,12,0,10,0,22
 hadoop-trunk\hadoop-trunk\hadoop-hdfs-project\hadoop-hdfs\src\main\java\org\apache\hadoop\hdfs\tools\DFSck.java,340,60,29,3,1,93
 hadoop-trunk\hadoop-trunk\hadoop-common-project\hadoop-common\src\main\java\org\apache\hadoop\security\SaslInputStream.java,340,59,12,2,0,73
 hadoop-trunk\hadoop-trunk\hadoop-common-project\hadoop-common\src\test\java\org\apache\hadoop\fs\TestFileSystemCanonicalization.java,340,159,3,5,0,167
 pulsar-master\pulsar-master\pulsar-broker\src\test\java\org\apache\pulsar\broker\service\TransactionMetadataStoreServiceTest.java,340,137,22,89,0,248
 hadoop-trunk\hadoop-trunk\hadoop-yarn-project\hadoop-yarn\hadoop-yarn-server\hadoop-yarn-server-resourcemanager\src\test\java\org\apache\hadoop\yarn\server\resourcemanager\webapp\TestRMWebApp.java,341,100,16,13,2,131
 hadoop-trunk\hadoop-trunk\hadoop-common-project\hadoop-common\src\test\java\org\apache\hadoop\io\retry\TestRetryProxy.java,341,64,13,9,0,86
 kafka-trunk\kafka-trunk\streams\src\test\java\org\apache\kafka\streams\integration\GlobalKTableIntegrationTest.java,341,0,3,50,9,62
 pulsar-master\pulsar-master\pulsar-common\src\main\java\org\apache\pulsar\common\util\collections\ConcurrentOpenLongPairRangeSet.java,341,119,9,57,0,185
 pulsar-master\pulsar-master\tests\integration\src\test\java\org\apache\pulsar\tests\integration\auth\token\PulsarTokenAuthenticationBaseSuite.java,341,64,8,34,0,106
 pulsar-master\pulsar-master\pulsar-sql\presto-pulsar\src\test\java\org\apache\pulsar\sql\presto\TestPulsarMetadata.java,341,99,8,71,0,178
 hadoop-trunk\hadoop-trunk\hadoop-hdfs-project\hadoop-hdfs-rbf\src\test\java\org\apache\hadoop\hdfs\server\federation\metrics\TestRBFMetrics.java,342,16,0,3,0,19
 hadoop-trunk\hadoop-trunk\hadoop-common-project\hadoop-common\src\test\java\org\apache\hadoop\util\TestGenericOptionsParser.java,342,34,1,3,4,42
 hadoop-trunk\hadoop-trunk\hadoop-tools\hadoop-aws\src\test\java\org\apache\hadoop\fs\s3a\audit\impl\TestActiveAuditManagerThreadLeakage.java,342,7,1,5,1,14
 hadoop-trunk\hadoop-trunk\hadoop-common-project\hadoop-common\src\main\java\org\apache\hadoop\util\RunJar.java,342,35,5,1,6,47
 kafka-trunk\kafka-trunk\tools\src\main\java\org\apache\kafka\tools\TransactionalMessageCopier.java,342,0,7,65,0,72
 kafka-trunk\kafka-trunk\streams\src\test\java\org\apache\kafka\streams\integration\StandbyTaskEOSIntegrationTest.java,342,0,1,35,6,42
 pulsar-master\pulsar-master\pulsar-functions\worker\src\main\java\org\apache\pulsar\functions\worker\rest\api\v3\FunctionsApiV3Resource.java,342,177,3,89,0,269
 hadoop-trunk\hadoop-trunk\hadoop-common-project\hadoop-common\src\test\java\org\apache\hadoop\ipc\TestProtoBufRpc.java,343,80,61,4,3,148
 hadoop-trunk\hadoop-trunk\hadoop-hdfs-project\hadoop-hdfs-rbf\src\test\java\org\apache\hadoop\hdfs\server\federation\router\TestRouterUserMappings.java,343,60,12,2,6,80
 hadoop-trunk\hadoop-trunk\hadoop-common-project\hadoop-common\src\test\java\org\apache\hadoop\io\TestSequenceFileAppend.java,343,31,12,2,0,45
 hadoop-trunk\hadoop-trunk\hadoop-common-project\hadoop-auth\src\test\java\org\apache\hadoop\security\authentication\util\TestZKSignerSecretProvider.java,343,19,13,1,14,47
 hadoop-trunk\hadoop-trunk\hadoop-hdfs-project\hadoop-hdfs\src\main\java\org\apache\hadoop\hdfs\server\datanode\web\DatanodeHttpServer.java,343,39,17,5,5,66
 kafka-trunk\kafka-trunk\streams\src\main\java\org\apache\kafka\streams\processor\internals\PartitionGroup.java,343,0,1,49,3,53
 pulsar-master\pulsar-master\pulsar-broker\src\test\java\org\apache\pulsar\broker\admin\AdminApiSchemaTest.java,343,108,7,42,0,157
 pulsar-master\pulsar-master\pulsar-broker-common\src\main\java\org\apache\pulsar\broker\authentication\AuthenticationProviderToken.java,343,127,3,58,0,188
 dubbo-3.0\dubbo-3.0\dubbo-remoting\dubbo-remoting-api\src\test\java\org\apache\dubbo\remoting\codec\TelnetCodecTest.java,344,172,30,36,10,248
 hadoop-trunk\hadoop-trunk\hadoop-yarn-project\hadoop-yarn\hadoop-yarn-server\hadoop-yarn-server-resourcemanager\src\main\java\org\apache\hadoop\yarn\server\resourcemanager\scheduler\activities\ActivitiesLogger.java,344,119,5,3,0,127
 hadoop-trunk\hadoop-trunk\hadoop-yarn-project\hadoop-yarn\hadoop-yarn-server\hadoop-yarn-server-nodemanager\src\main\java\org\apache\hadoop\yarn\server\nodemanager\containermanager\linux\resources\ResourceHandlerModule.java,344,48,20,8,7,83
 hadoop-trunk\hadoop-trunk\hadoop-hdfs-project\hadoop-hdfs\src\main\java\org\apache\hadoop\hdfs\util\XMLUtils.java,344,103,19,2,0,124
 hadoop-trunk\hadoop-trunk\hadoop-hdfs-project\hadoop-hdfs-rbf\src\main\java\org\apache\hadoop\hdfs\server\federation\router\RBFConfigKeys.java,344,149,1,10,0,160
 pulsar-master\pulsar-master\managed-ledger\src\test\java\org\apache\bookkeeper\mledger\impl\EntryCacheManagerTest.java,344,108,0,26,0,134
 rocketmq-develop\rocketmq-develop\store\src\test\java\org\apache\rocketmq\store\dledger\DLedgerCommitlogTest.java,344,152,0,76,11,239
 dubbo-3.0\dubbo-3.0\dubbo-metadata\dubbo-metadata-api\src\test\java\org\apache\dubbo\metadata\report\support\AbstractMetadataReportTest.java,345,178,7,90,0,275
 hadoop-trunk\hadoop-trunk\hadoop-yarn-project\hadoop-yarn\hadoop-yarn-server\hadoop-yarn-server-resourcemanager\src\main\java\org\apache\hadoop\yarn\server\resourcemanager\rmapp\RMAppLogAggregation.java,345,56,2,1,0,59
 hadoop-trunk\hadoop-trunk\hadoop-mapreduce-project\hadoop-mapreduce-client\hadoop-mapreduce-client-app\src\main\java\org\apache\hadoop\mapreduce\v2\app\client\MRClientService.java,345,87,6,21,2,116
 hadoop-trunk\hadoop-trunk\hadoop-mapreduce-project\hadoop-mapreduce-client\hadoop-mapreduce-client-jobclient\src\test\java\org\apache\hadoop\mapred\join\TestTupleWritable.java,345,152,9,13,12,186
 hadoop-trunk\hadoop-trunk\hadoop-hdfs-project\hadoop-hdfs\src\test\java\org\apache\hadoop\hdfs\protocol\datatransfer\sasl\TestSaslDataTransfer.java,345,47,14,3,12,76
 pulsar-master\pulsar-master\pulsar-common\src\test\java\org\apache\pulsar\common\util\collections\GrowablePriorityLongPairQueueTest.java,345,151,5,22,0,178
 pulsar-master\pulsar-master\pulsar-sql\presto-pulsar\src\main\java\org\apache\pulsar\sql\presto\PulsarMetadata.java,345,148,14,77,0,239
 rocketmq-develop\rocketmq-develop\common\src\test\java\org\apache\rocketmq\common\message\MessageDecoderTest.java,345,50,8,25,7,90
 hadoop-trunk\hadoop-trunk\hadoop-yarn-project\hadoop-yarn\hadoop-yarn-server\hadoop-yarn-server-nodemanager\src\main\java\org\apache\hadoop\yarn\server\nodemanager\util\NodeManagerHardwareUtils.java,346,35,7,2,0,44
 hadoop-trunk\hadoop-trunk\hadoop-yarn-project\hadoop-yarn\hadoop-yarn-common\src\main\java\org\apache\hadoop\yarn\api\records\impl\pb\ContainerStatusPBImpl.java,346,70,98,1,0,169
 hadoop-trunk\hadoop-trunk\hadoop-yarn-project\hadoop-yarn\hadoop-yarn-common\src\test\java\org\apache\hadoop\yarn\logaggregation\TestLogAggregationMetaCollector.java,346,49,3,2,0,54
 hadoop-trunk\hadoop-trunk\hadoop-mapreduce-project\hadoop-mapreduce-client\hadoop-mapreduce-client-app\src\test\java\org\apache\hadoop\mapreduce\v2\app\webapp\TestAMWebApp.java,346,53,9,3,15,80
 kafka-trunk\kafka-trunk\streams\src\main\java\org\apache\kafka\streams\state\internals\ThreadCache.java,346,0,2,26,1,29
 kafka-trunk\kafka-trunk\connect\runtime\src\test\java\org\apache\kafka\connect\runtime\SubmittedRecordsTest.java,346,0,0,71,0,71
 pulsar-master\pulsar-master\pulsar-common\src\main\java\org\apache\pulsar\common\util\collections\GrowablePriorityLongPairQueue.java,346,84,1,11,0,96
 pulsar-master\pulsar-master\pulsar-functions\utils\src\test\java\org\apache\pulsar\functions\utils\SourceConfigUtilsTest.java,346,86,7,50,0,143
 pulsar-master\pulsar-master\pulsar-broker\src\test\java\org\apache\pulsar\client\impl\RawReaderTest.java,346,81,2,35,0,118
 zookeeper-master\zookeeper-master\zookeeper-server\src\test\java\org\apache\zookeeper\server\controller\ZooKeeperServerControllerEndToEndTest.java,346,0,22,46,2,70
 hadoop-trunk\hadoop-trunk\hadoop-common-project\hadoop-registry\src\main\java\org\apache\hadoop\registry\client\binding\RegistryUtils.java,347,47,7,3,0,57
 hadoop-trunk\hadoop-trunk\hadoop-common-project\hadoop-common\src\test\java\org\apache\hadoop\fs\TestHarFileSystem.java,347,194,102,10,0,306
 hadoop-trunk\hadoop-trunk\hadoop-common-project\hadoop-common\src\main\java\org\apache\hadoop\log\LogLevel.java,347,78,11,1,2,92
 hadoop-trunk\hadoop-trunk\hadoop-yarn-project\hadoop-yarn\hadoop-yarn-server\hadoop-yarn-server-nodemanager\src\test\java\org\apache\hadoop\yarn\server\nodemanager\TestNodeStatusUpdaterForLabels.java,347,56,7,10,4,77
 hadoop-trunk\hadoop-trunk\hadoop-hdfs-project\hadoop-hdfs\src\test\java\org\apache\hadoop\hdfs\TestUnsetAndChangeDirectoryEcPolicy.java,347,26,5,2,0,33
 pulsar-master\pulsar-master\tests\integration\src\test\java\org\apache\pulsar\tests\integration\functions\java\PulsarWorkerRebalanceDrainTest.java,347,101,15,68,0,184
 pulsar-master\pulsar-master\pulsar-broker\src\test\java\org\apache\pulsar\broker\namespace\OwnershipCacheTest.java,347,75,8,43,0,126
 rocketmq-develop\rocketmq-develop\broker\src\main\java\org\apache\rocketmq\broker\processor\AbstractSendMessageProcessor.java,347,98,12,56,6,172
 dubbo-3.0\dubbo-3.0\dubbo-rpc\dubbo-rpc-dubbo\src\test\java\org\apache\dubbo\rpc\protocol\dubbo\ArgumentCallbackTest.java,348,113,15,23,0,151
 hadoop-trunk\hadoop-trunk\hadoop-common-project\hadoop-auth\src\main\java\org\apache\hadoop\security\authentication\client\KerberosAuthenticator.java,348,57,8,21,2,88
 hadoop-trunk\hadoop-trunk\hadoop-yarn-project\hadoop-yarn\hadoop-yarn-server\hadoop-yarn-server-resourcemanager\src\main\java\org\apache\hadoop\yarn\server\resourcemanager\scheduler\fair\FSQueueMetrics.java,348,87,0,7,0,94
 hadoop-trunk\hadoop-trunk\hadoop-tools\hadoop-openstack\src\test\java\org\apache\hadoop\fs\swift\SwiftFileSystemBaseTest.java,348,80,6,3,4,93
 kafka-trunk\kafka-trunk\streams\src\test\java\org\apache\kafka\streams\integration\StreamsUncaughtExceptionHandlerIntegrationTest.java,348,0,10,80,0,90
 pulsar-master\pulsar-master\pulsar-functions\instance\src\main\java\org\apache\pulsar\functions\instance\stats\SinkStatsManager.java,348,101,5,27,0,133
 pulsar-master\pulsar-master\pulsar-broker\src\main\java\org\apache\pulsar\broker\lookup\TopicLookupBase.java,348,145,15,101,0,261
 pulsar-master\pulsar-master\pulsar-functions\instance\src\main\java\org\apache\pulsar\functions\instance\stats\SourceStatsManager.java,348,105,5,29,0,139
 zookeeper-master\zookeeper-master\zookeeper-server\src\test\java\org\apache\zookeeper\test\SessionTest.java,348,0,38,28,0,66
 hadoop-trunk\hadoop-trunk\hadoop-yarn-project\hadoop-yarn\hadoop-yarn-server\hadoop-yarn-server-timelineservice-documentstore\src\test\java\org\apache\hadoop\yarn\server\timelineservice\documentstore\TestDocumentStoreTimelineReaderImpl.java,349,24,6,15,0,45
 hadoop-trunk\hadoop-trunk\hadoop-tools\hadoop-distcp\src\main\java\org\apache\hadoop\tools\mapred\RetriableFileCopyCommand.java,349,97,12,3,0,112
 hadoop-trunk\hadoop-trunk\hadoop-yarn-project\hadoop-yarn\hadoop-yarn-server\hadoop-yarn-server-resourcemanager\src\main\java\org\apache\hadoop\yarn\server\resourcemanager\reservation\planning\IterativePlanner.java,349,65,9,7,0,81
 hadoop-trunk\hadoop-trunk\hadoop-common-project\hadoop-common\src\main\java\org\apache\hadoop\util\ReflectionUtils.java,349,105,10,3,4,122
 kafka-trunk\kafka-trunk\clients\src\main\java\org\apache\kafka\common\security\kerberos\KerberosLogin.java,349,0,16,76,3,95
 pulsar-master\pulsar-master\pulsar-broker\src\test\java\org\apache\pulsar\PulsarBrokerStarterTest.java,349,115,12,89,0,216
 pulsar-master\pulsar-master\pulsar-io\jdbc\sqlite\src\test\java\org\apache\pulsar\io\jdbc\SqliteJdbcSinkTest.java,349,83,17,33,0,133
 dubbo-3.0\dubbo-3.0\dubbo-config\dubbo-config-api\src\test\java\org\apache\dubbo\config\ProtocolConfigTest.java,350,50,0,5,0,55
 hadoop-trunk\hadoop-trunk\hadoop-mapreduce-project\hadoop-mapreduce-client\hadoop-mapreduce-client-jobclient\src\test\java\org\apache\hadoop\mapred\TestMerge.java,350,104,16,1,4,125
 hadoop-trunk\hadoop-trunk\hadoop-yarn-project\hadoop-yarn\hadoop-yarn-api\src\main\java\org\apache\hadoop\yarn\api\protocolrecords\AllocateRequest.java,350,60,1,2,1,64
 hadoop-trunk\hadoop-trunk\hadoop-yarn-project\hadoop-yarn\hadoop-yarn-server\hadoop-yarn-server-resourcemanager\src\test\java\org\apache\hadoop\yarn\server\resourcemanager\scheduler\policy\TestFairOrderingPolicy.java,350,55,7,7,1,70
 hadoop-trunk\hadoop-trunk\hadoop-yarn-project\hadoop-yarn\hadoop-yarn-server\hadoop-yarn-server-resourcemanager\src\test\java\org\apache\hadoop\yarn\server\resourcemanager\MockNM.java,350,143,1,11,7,162
 hadoop-trunk\hadoop-trunk\hadoop-mapreduce-project\hadoop-mapreduce-client\hadoop-mapreduce-client-hs\src\test\java\org\apache\hadoop\mapreduce\v2\hs\TestHistoryFileManager.java,350,45,2,4,9,60
 kafka-trunk\kafka-trunk\connect\api\src\test\java\org\apache\kafka\connect\data\SchemaBuilderTest.java,350,0,2,37,10,49
 kafka-trunk\kafka-trunk\streams\src\main\java\org\apache\kafka\streams\processor\internals\namedtopology\KafkaStreamsNamedTopologyWrapper.java,350,0,7,96,0,103
 skywalking-master\skywalking-master\oap-server\server-core\src\main\java\org\apache\skywalking\oap\server\core\source\DefaultScopeDefine.java,350,134,3,39,0,176
 zookeeper-master\zookeeper-master\zookeeper-contrib\zookeeper-contrib-loggraph\src\main\java\org\apache\zookeeper\graph\Log4JSource.java,350,0,35,23,8,66
 dubbo-3.0\dubbo-3.0\dubbo-common\src\test\java\org\apache\dubbo\common\utils\UrlUtilsTest.java,351,86,14,50,1,151
 hadoop-trunk\hadoop-trunk\hadoop-hdfs-project\hadoop-hdfs-rbf\src\test\java\org\apache\hadoop\hdfs\server\federation\router\TestRouterNamenodeMonitoring.java,351,21,0,6,1,28
 hadoop-trunk\hadoop-trunk\hadoop-yarn-project\hadoop-yarn\hadoop-yarn-applications\hadoop-yarn-services\hadoop-yarn-services-core\src\main\java\org\apache\hadoop\yarn\service\timelineservice\ServiceTimelinePublisher.java,351,64,7,3,2,76
 hadoop-trunk\hadoop-trunk\hadoop-yarn-project\hadoop-yarn\hadoop-yarn-server\hadoop-yarn-server-common\src\main\java\org\apache\hadoop\yarn\server\api\protocolrecords\impl\pb\NMContainerStatusPBImpl.java,351,79,107,3,0,189
 hadoop-trunk\hadoop-trunk\hadoop-tools\hadoop-aws\src\main\java\org\apache\hadoop\fs\s3a\impl\StoreContext.java,351,73,1,3,3,80
 hadoop-trunk\hadoop-trunk\hadoop-yarn-project\hadoop-yarn\hadoop-yarn-server\hadoop-yarn-server-resourcemanager\src\test\java\org\apache\hadoop\yarn\server\resourcemanager\scheduler\fair\TestContinuousScheduling.java,351,67,24,7,2,100
 kafka-trunk\kafka-trunk\streams\src\main\java\org\apache\kafka\streams\processor\internals\metrics\ThreadMetrics.java,351,0,1,93,0,94
 kafka-trunk\kafka-trunk\streams\src\test\java\org\apache\kafka\streams\state\internals\metrics\StateStoreMetricsTest.java,351,0,0,54,0,54
 rocketmq-develop\rocketmq-develop\tools\src\test\java\org\apache\rocketmq\tools\admin\DefaultMQAdminExtTest.java,351,161,7,104,3,275
 zookeeper-master\zookeeper-master\zookeeper-contrib\zookeeper-contrib-rest\src\main\java\org\apache\zookeeper\server\jersey\resources\ZNodeResource.java,351,0,35,2,1,38
 druid-master\druid-master\core\target\generated-sources\antlr4\org\apache\druid\math\expr\antlr\ExprBaseListener.java,352,104,58,24,0,186
 dubbo-3.0\dubbo-3.0\dubbo-common\src\test\java\org\apache\dubbo\config\context\ConfigManagerTest.java,352,48,22,22,0,92
 hadoop-trunk\hadoop-trunk\hadoop-mapreduce-project\hadoop-mapreduce-client\hadoop-mapreduce-client-core\src\test\java\org\apache\hadoop\mapreduce\lib\output\TestPathOutputCommitter.java,352,78,7,1,4,90
 hadoop-trunk\hadoop-trunk\hadoop-yarn-project\hadoop-yarn\hadoop-yarn-server\hadoop-yarn-server-web-proxy\src\main\java\org\apache\hadoop\yarn\server\webproxy\ProxyCA.java,352,87,4,1,3,95
 hadoop-trunk\hadoop-trunk\hadoop-hdfs-project\hadoop-hdfs\src\test\java\org\apache\hadoop\hdfs\TestHDFSServerPorts.java,352,111,21,10,1,143
 kafka-trunk\kafka-trunk\connect\transforms\src\test\java\org\apache\kafka\connect\transforms\FlattenTest.java,352,0,0,34,4,38
 kafka-trunk\kafka-trunk\connect\runtime\src\test\java\org\apache\kafka\connect\storage\KafkaOffsetBackingStoreTest.java,352,0,2,67,2,71
 kafka-trunk\kafka-trunk\raft\src\main\java\org\apache\kafka\raft\LeaderState.java,352,0,9,45,2,56
 pulsar-master\pulsar-master\pulsar-broker\src\test\java\org\apache\pulsar\client\api\AuthenticatedProducerConsumerTest.java,352,100,11,60,0,171
 hadoop-trunk\hadoop-trunk\hadoop-hdfs-project\hadoop-hdfs-rbf\src\test\java\org\apache\hadoop\hdfs\server\federation\router\TestRouterAllResolver.java,353,20,0,8,6,34
 hadoop-trunk\hadoop-trunk\hadoop-hdfs-project\hadoop-hdfs\src\test\java\org\apache\hadoop\hdfs\server\datanode\TestCachingStrategy.java,353,108,17,13,0,138
 pulsar-master\pulsar-master\pulsar-broker\src\test\java\org\apache\pulsar\client\api\MockBrokerService.java,353,152,9,32,0,193
 hadoop-trunk\hadoop-trunk\hadoop-common-project\hadoop-common\src\main\java\org\apache\hadoop\fs\TrashPolicyDefault.java,354,89,26,6,4,125
 hadoop-trunk\hadoop-trunk\hadoop-mapreduce-project\hadoop-mapreduce-client\hadoop-mapreduce-client-common\src\main\java\org\apache\hadoop\mapreduce\v2\api\records\impl\pb\JobReportPBImpl.java,354,97,122,1,0,220
 kafka-trunk\kafka-trunk\streams\src\main\java\org\apache\kafka\streams\state\internals\PrefixedWindowKeySchemas.java,354,0,0,56,0,56
 kafka-trunk\kafka-trunk\metadata\src\test\java\org\apache\kafka\metadata\authorizer\StandardAuthorizerTest.java,354,0,29,55,0,84
 zookeeper-master\zookeeper-master\zookeeper-server\src\test\java\org\apache\zookeeper\server\persistence\FileTxnSnapLogTest.java,354,0,28,29,0,57
 hadoop-trunk\hadoop-trunk\hadoop-yarn-project\hadoop-yarn\hadoop-yarn-server\hadoop-yarn-server-nodemanager\src\main\java\org\apache\hadoop\yarn\server\nodemanager\containermanager\resourceplugin\deviceframework\DeviceMappingManager.java,355,70,4,5,4,83
 hadoop-trunk\hadoop-trunk\hadoop-mapreduce-project\hadoop-mapreduce-client\hadoop-mapreduce-client-common\src\main\java\org\apache\hadoop\mapreduce\v2\api\records\impl\pb\TaskAttemptReportPBImpl.java,355,98,116,3,0,217
 hadoop-trunk\hadoop-trunk\hadoop-common-project\hadoop-minikdc\src\main\java\org\apache\hadoop\minikdc\MiniKdc.java,355,55,8,1,2,66
 hadoop-trunk\hadoop-trunk\hadoop-hdfs-project\hadoop-hdfs\src\main\java\org\apache\hadoop\hdfs\server\datanode\ReplicaBuilder.java,355,111,0,1,8,120
 hadoop-trunk\hadoop-trunk\hadoop-hdfs-project\hadoop-hdfs\src\main\java\org\apache\hadoop\hdfs\net\DFSNetworkTopology.java,355,26,5,1,0,32
 hadoop-trunk\hadoop-trunk\hadoop-maven-plugins\src\main\java\org\apache\hadoop\maven\plugin\cmakebuilder\TestMojo.java,355,58,25,1,0,84
 pulsar-master\pulsar-master\pulsar-client-1x-base\pulsar-client-1x\src\main\java\org\apache\pulsar\client\api\ClientConfiguration.java,356,74,0,45,0,119
 pulsar-master\pulsar-master\pulsar-broker\src\test\java\org\apache\pulsar\broker\service\BrokerEntryMetadataE2ETest.java,356,64,5,38,0,107
 dubbo-3.0\dubbo-3.0\dubbo-compatible\src\main\java\com\alibaba\dubbo\rpc\RpcContext.java,357,129,3,9,0,141
 hadoop-trunk\hadoop-trunk\hadoop-tools\hadoop-gridmix\src\main\java\org\apache\hadoop\mapred\gridmix\SleepJob.java,357,117,14,3,2,136
 hadoop-trunk\hadoop-trunk\hadoop-hdfs-project\hadoop-hdfs\src\main\java\org\apache\hadoop\hdfs\server\namenode\BackupImage.java,357,61,11,6,0,78
 hadoop-trunk\hadoop-trunk\hadoop-tools\hadoop-aws\src\main\java\org\apache\hadoop\fs\s3a\auth\RoleModel.java,357,61,2,2,0,65
 hadoop-trunk\hadoop-trunk\hadoop-yarn-project\hadoop-yarn\hadoop-yarn-server\hadoop-yarn-server-resourcemanager\src\test\java\org\apache\hadoop\yarn\server\resourcemanager\scheduler\capacity\conf\TestZKConfigurationStore.java,357,40,1,5,3,49
 pulsar-master\pulsar-master\pulsar-broker\src\main\java\org\apache\pulsar\common\naming\NamespaceBundleFactory.java,357,163,10,70,0,243
 dubbo-3.0\dubbo-3.0\dubbo-common\src\test\java\org\apache\dubbo\common\utils\NetUtilsTest.java,358,140,68,53,2,263
 hadoop-trunk\hadoop-trunk\hadoop-yarn-project\hadoop-yarn\hadoop-yarn-server\hadoop-yarn-server-nodemanager\src\test\java\org\apache\hadoop\yarn\server\nodemanager\containermanager\linux\runtime\docker\TestDockerCommandExecutor.java,358,42,11,13,2,68
 hadoop-trunk\hadoop-trunk\hadoop-common-project\hadoop-kms\src\main\java\org\apache\hadoop\crypto\key\kms\server\KeyAuthorizationKeyProvider.java,358,80,4,1,1,86
 kafka-trunk\kafka-trunk\clients\src\generated\java\org\apache\kafka\common\message\DescribeProducersRequestData.java,358,0,0,32,8,40
 zookeeper-master\zookeeper-master\zookeeper-server\src\test\java\org\apache\zookeeper\test\QuorumTest.java,358,0,27,33,1,61
 hadoop-trunk\hadoop-trunk\hadoop-yarn-project\hadoop-yarn\hadoop-yarn-common\src\main\java\org\apache\hadoop\yarn\api\records\impl\pb\ContainerReportPBImpl.java,359,78,108,1,0,187
 hadoop-trunk\hadoop-trunk\hadoop-tools\hadoop-sls\src\main\java\org\apache\hadoop\yarn\sls\appmaster\MRAMSimulator.java,359,59,20,3,0,82
 hadoop-trunk\hadoop-trunk\hadoop-common-project\hadoop-common\src\test\java\org\apache\hadoop\util\TestPureJavaCrc32.java,359,111,6,6,8,131
 hadoop-trunk\hadoop-trunk\hadoop-mapreduce-project\hadoop-mapreduce-client\hadoop-mapreduce-client-jobclient\src\test\java\org\apache\hadoop\mapreduce\lib\join\TestJoinProperties.java,359,154,32,1,0,187
 kafka-trunk\kafka-trunk\streams\src\test\java\org\apache\kafka\streams\processor\internals\NamedTopologyTest.java,359,0,0,51,0,51
 pulsar-master\pulsar-master\pulsar-proxy\src\main\java\org\apache\pulsar\proxy\server\DirectProxyHandler.java,359,146,5,73,0,224
 zookeeper-master\zookeeper-master\zookeeper-server\src\test\java\org\apache\zookeeper\common\X509TestHelpers.java,359,0,3,108,0,111
 hadoop-trunk\hadoop-trunk\hadoop-yarn-project\hadoop-yarn\hadoop-yarn-server\hadoop-yarn-server-resourcemanager\src\test\java\org\apache\hadoop\yarn\server\resourcemanager\TestRMServerUtils.java,360,66,43,5,0,114
 hadoop-trunk\hadoop-trunk\hadoop-mapreduce-project\hadoop-mapreduce-client\hadoop-mapreduce-client-core\src\main\java\org\apache\hadoop\mapreduce\filecache\DistributedCache.java,360,60,9,7,1,77
 hadoop-trunk\hadoop-trunk\hadoop-yarn-project\hadoop-yarn\hadoop-yarn-common\src\main\java\org\apache\hadoop\yarn\event\AsyncDispatcher.java,360,71,17,2,5,95
 hadoop-trunk\hadoop-trunk\hadoop-common-project\hadoop-common\src\main\java\org\apache\hadoop\io\compress\zlib\ZlibDecompressor.java,360,121,9,2,1,133
 hadoop-trunk\hadoop-trunk\hadoop-hdfs-project\hadoop-hdfs\src\main\java\org\apache\hadoop\hdfs\server\datanode\BlockScanner.java,360,65,7,10,2,84
 kafka-trunk\kafka-trunk\connect\runtime\src\test\java\org\apache\kafka\connect\runtime\rest\RestServerTest.java,360,0,20,54,15,89
 kafka-trunk\kafka-trunk\clients\src\generated\java\org\apache\kafka\common\message\HeartbeatRequestData.java,360,0,0,32,4,36
 pulsar-master\pulsar-master\pulsar-functions\worker\src\test\java\org\apache\pulsar\functions\worker\MembershipManagerTest.java,360,91,8,73,0,172
 pulsar-master\pulsar-master\pulsar-functions\runtime\src\main\java\org\apache\pulsar\functions\auth\KubernetesSecretsTokenAuthProvider.java,360,97,5,53,0,155
 pulsar-master\pulsar-master\managed-ledger\src\test\java\org\apache\bookkeeper\mledger\impl\OffloadLedgerDeleteTest.java,360,107,3,46,0,156
 hadoop-trunk\hadoop-trunk\hadoop-yarn-project\hadoop-yarn\hadoop-yarn-client\src\test\java\org\apache\hadoop\yarn\client\api\impl\TestAHSClient.java,361,88,14,6,0,108
 hadoop-trunk\hadoop-trunk\hadoop-yarn-project\hadoop-yarn\hadoop-yarn-server\hadoop-yarn-server-applicationhistoryservice\src\main\java\org\apache\hadoop\yarn\server\timeline\recovery\LeveldbTimelineStateStore.java,361,51,13,6,0,70
 hadoop-trunk\hadoop-trunk\hadoop-common-project\hadoop-common\src\test\java\org\apache\hadoop\ipc\RPCCallBenchmark.java,361,77,11,7,9,104
 hadoop-trunk\hadoop-trunk\hadoop-yarn-project\hadoop-yarn\hadoop-yarn-server\hadoop-yarn-server-timelineservice\src\main\java\org\apache\hadoop\yarn\server\timelineservice\collector\TimelineCollector.java,361,53,4,2,0,59
 hadoop-trunk\hadoop-trunk\hadoop-yarn-project\hadoop-yarn\hadoop-yarn-api\src\main\java\org\apache\hadoop\yarn\api\records\ResourceInformation.java,361,86,1,2,4,93
 kafka-trunk\kafka-trunk\streams\src\test\java\org\apache\kafka\streams\processor\internals\RecordQueueTest.java,361,0,0,52,0,52
 pulsar-master\pulsar-master\pulsar-broker\src\main\java\org\apache\pulsar\PulsarStandalone.java,361,184,4,33,0,221
 pulsar-master\pulsar-master\pulsar-broker\src\test\java\org\apache\pulsar\broker\web\WebServiceTest.java,361,101,20,54,0,175
 hadoop-trunk\hadoop-trunk\hadoop-common-project\hadoop-common\src\test\java\org\apache\hadoop\security\authorize\TestServiceAuthorization.java,362,50,22,11,1,84
 hadoop-trunk\hadoop-trunk\hadoop-common-project\hadoop-common\src\main\java\org\apache\hadoop\security\token\DtUtilShell.java,362,66,31,1,0,98
 hadoop-trunk\hadoop-trunk\hadoop-mapreduce-project\hadoop-mapreduce-client\hadoop-mapreduce-client-hs\src\main\java\org\apache\hadoop\mapreduce\v2\hs\JobHistory.java,362,83,5,5,2,95
 kafka-trunk\kafka-trunk\clients\src\generated\java\org\apache\kafka\common\message\SyncGroupResponseData.java,362,0,0,33,5,38
 pulsar-master\pulsar-master\managed-ledger\src\main\java\org\apache\bookkeeper\mledger\impl\MetaStoreImpl.java,362,124,2,63,0,189
 pulsar-master\pulsar-master\pulsar-broker\src\main\java\org\apache\pulsar\compaction\TwoPhaseCompactor.java,363,121,8,55,0,184
 pulsar-master\pulsar-master\pulsar-metadata\src\main\java\org\apache\pulsar\metadata\impl\EtcdMetadataStore.java,363,100,10,54,0,164
 dubbo-3.0\dubbo-3.0\dubbo-cluster\src\main\java\org\apache\dubbo\rpc\cluster\directory\AbstractDirectory.java,364,115,13,39,0,167
 hadoop-trunk\hadoop-trunk\hadoop-mapreduce-project\hadoop-mapreduce-client\hadoop-mapreduce-client-hs\src\main\java\org\apache\hadoop\mapreduce\v2\hs\HistoryClientService.java,364,66,3,37,1,107
 hadoop-trunk\hadoop-trunk\hadoop-common-project\hadoop-common\src\test\java\org\apache\hadoop\fs\TestHarFileSystemBasics.java,364,44,25,8,3,80
 hadoop-trunk\hadoop-trunk\hadoop-hdfs-project\hadoop-hdfs-rbf\src\test\java\org\apache\hadoop\hdfs\server\federation\router\TestRouterClientRejectOverload.java,364,31,4,6,2,43
 kafka-trunk\kafka-trunk\connect\runtime\src\main\java\org\apache\kafka\connect\runtime\distributed\ConnectProtocol.java,364,0,4,39,2,45
 pulsar-master\pulsar-master\pulsar-functions\worker\src\test\java\org\apache\pulsar\functions\worker\FunctionAssignmentTailerTest.java,364,108,2,79,0,189
 pulsar-master\pulsar-master\pulsar-common\src\main\java\org\apache\pulsar\common\naming\TopicName.java,364,102,2,36,0,140
 hadoop-trunk\hadoop-trunk\hadoop-hdfs-project\hadoop-hdfs\src\test\java\org\apache\hadoop\hdfs\TestBatchedListDirectories.java,365,71,4,1,0,76
 hadoop-trunk\hadoop-trunk\hadoop-mapreduce-project\hadoop-mapreduce-examples\src\main\java\org\apache\hadoop\examples\DBCountPageView.java,365,213,17,7,9,246
 hadoop-trunk\hadoop-trunk\hadoop-hdfs-project\hadoop-hdfs\src\test\java\org\apache\hadoop\hdfs\TestDFSStripedOutputStreamWithFailureBase.java,365,69,13,1,0,83
 kafka-trunk\kafka-trunk\trogdor\src\main\java\org\apache\kafka\trogdor\workload\ProduceBenchWorker.java,365,0,11,30,1,42
 pulsar-master\pulsar-master\pulsar-client\src\test\java\org\apache\pulsar\client\impl\schema\KeyValueSchemaTest.java,365,121,0,99,0,220
 pulsar-master\pulsar-master\pulsar-functions\runtime\src\test\java\org\apache\pulsar\functions\runtime\process\ProcessRuntimeTest.java,365,150,3,72,0,225
 pulsar-master\pulsar-master\pulsar-broker\src\test\java\org\apache\pulsar\broker\stats\TransactionMetricsTest.java,365,119,1,75,0,195
 hadoop-trunk\hadoop-trunk\hadoop-mapreduce-project\hadoop-mapreduce-client\hadoop-mapreduce-client-jobclient\src\test\java\org\apache\hadoop\mapreduce\v2\TestSpeculativeExecution.java,366,91,17,7,2,117
 hadoop-trunk\hadoop-trunk\hadoop-hdfs-project\hadoop-hdfs-httpfs\src\main\java\org\apache\hadoop\lib\service\hadoop\FileSystemAccessService.java,366,97,13,36,3,149
 hadoop-trunk\hadoop-trunk\hadoop-yarn-project\hadoop-yarn\hadoop-yarn-server\hadoop-yarn-server-resourcemanager\src\test\java\org\apache\hadoop\yarn\server\resourcemanager\security\TestAMRMTokens.java,366,48,3,13,2,66
 hadoop-trunk\hadoop-trunk\hadoop-hdfs-project\hadoop-hdfs-client\src\test\java\org\apache\hadoop\hdfs\server\namenode\ha\TestConfiguredFailoverProxyProvider.java,367,55,9,1,0,65
 hadoop-trunk\hadoop-trunk\hadoop-hdfs-project\hadoop-hdfs-httpfs\src\test\java\org\apache\hadoop\lib\service\instrumentation\TestInstrumentationService.java,367,95,2,33,3,133
 hadoop-trunk\hadoop-trunk\hadoop-tools\hadoop-aws\src\main\java\org\apache\hadoop\fs\s3a\auth\delegation\SessionTokenBinding.java,367,15,6,3,4,28
 hadoop-trunk\hadoop-trunk\hadoop-hdfs-project\hadoop-hdfs\src\test\java\org\apache\hadoop\hdfs\server\namenode\snapshot\TestSnapshotBlocksMap.java,367,84,1,4,1,90
 kafka-trunk\kafka-trunk\clients\src\generated\java\org\apache\kafka\common\message\OffsetFetchResponseDataJsonConverter.java,367,0,0,89,0,89
 kafka-trunk\kafka-trunk\clients\src\generated\java\org\apache\kafka\common\message\LeaderChangeMessage.java,367,0,0,23,8,31
 hadoop-trunk\hadoop-trunk\hadoop-yarn-project\hadoop-yarn\hadoop-yarn-server\hadoop-yarn-server-router\src\test\java\org\apache\hadoop\yarn\server\router\TestRouterMetrics.java,368,45,0,4,0,49
 hadoop-trunk\hadoop-trunk\hadoop-hdfs-project\hadoop-hdfs\src\test\java\org\apache\hadoop\hdfs\server\namenode\snapshot\TestXAttrWithSnapshot.java,368,57,56,2,9,124
 pulsar-master\pulsar-master\pulsar-broker\src\main\java\org\apache\pulsar\broker\transaction\pendingack\impl\MLPendingAckStore.java,368,153,8,86,0,247
 pulsar-master\pulsar-master\pulsar-config-validation\src\main\java\org\apache\pulsar\config\validation\ValidatorImpls.java,368,140,7,45,0,192
 pulsar-master\pulsar-master\tests\integration\src\test\java\org\apache\pulsar\tests\integration\utils\DockerUtils.java,368,146,9,73,0,228
 zookeeper-master\zookeeper-master\zookeeper-server\src\test\java\org\apache\zookeeper\audit\Slf4JAuditLoggerTest.java,368,0,26,14,1,41
 dubbo-3.0\dubbo-3.0\dubbo-registry\dubbo-registry-multicast\src\main\java\org\apache\dubbo\registry\multicast\MulticastRegistry.java,369,92,17,29,0,138
 dubbo-3.0\dubbo-3.0\dubbo-common\src\main\java\org\apache\dubbo\common\utils\CollectionUtils.java,369,61,9,9,1,80
 hadoop-trunk\hadoop-trunk\hadoop-hdfs-project\hadoop-hdfs-httpfs\src\main\java\org\apache\hadoop\lib\service\instrumentation\InstrumentationService.java,369,98,19,12,6,135
 hadoop-trunk\hadoop-trunk\hadoop-mapreduce-project\hadoop-mapreduce-client\hadoop-mapreduce-client-app\src\main\java\org\apache\hadoop\mapreduce\v2\app\launcher\ContainerLauncherImpl.java,369,78,11,8,2,99
 hadoop-trunk\hadoop-trunk\hadoop-mapreduce-project\hadoop-mapreduce-client\hadoop-mapreduce-client-jobclient\src\test\java\org\apache\hadoop\mapred\join\TestDatamerge.java,369,122,28,1,1,152
 hadoop-trunk\hadoop-trunk\hadoop-common-project\hadoop-nfs\src\main\java\org\apache\hadoop\nfs\NfsExports.java,369,131,1,3,0,135
 hadoop-trunk\hadoop-trunk\hadoop-common-project\hadoop-common\src\test\java\org\apache\hadoop\security\http\TestCrossOriginFilter.java,369,48,34,28,0,110
 pulsar-master\pulsar-master\pulsar-metadata\src\main\java\org\apache\pulsar\metadata\bookkeeper\PulsarLedgerManager.java,369,130,5,71,0,206
 hadoop-trunk\hadoop-trunk\hadoop-yarn-project\hadoop-yarn\hadoop-yarn-server\hadoop-yarn-server-resourcemanager\src\main\java\org\apache\hadoop\yarn\server\resourcemanager\scheduler\fair\MaxRunningAppsEnforcer.java,370,65,5,4,1,75
 hadoop-trunk\hadoop-trunk\hadoop-hdfs-project\hadoop-hdfs\src\test\java\org\apache\hadoop\hdfs\TestTrashWithSecureEncryptionZones.java,370,57,8,1,6,72
 kafka-trunk\kafka-trunk\metadata\src\test\java\org\apache\kafka\controller\PartitionChangeBuilderTest.java,370,0,2,50,0,52
 kafka-trunk\kafka-trunk\clients\src\test\java\org\apache\kafka\clients\consumer\internals\ConsumerNetworkClientTest.java,370,0,5,41,2,48
 pulsar-master\pulsar-master\pulsar-functions\instance\src\test\java\org\apache\pulsar\functions\source\batch\BatchSourceExecutorTest.java,370,141,13,43,0,197
 hadoop-trunk\hadoop-trunk\hadoop-yarn-project\hadoop-yarn\hadoop-yarn-server\hadoop-yarn-server-resourcemanager\src\main\java\org\apache\hadoop\yarn\server\resourcemanager\monitor\capacity\TempQueuePerPartition.java,371,113,4,5,14,136
 pulsar-master\pulsar-master\pulsar-broker\src\test\java\org\apache\pulsar\broker\service\persistent\MessageDuplicationTest.java,371,143,4,74,0,221
 rocketmq-develop\rocketmq-develop\store\src\main\java\org\apache\rocketmq\store\ha\HAConnection.java,371,94,19,44,4,161
 rocketmq-develop\rocketmq-develop\namesrv\src\test\java\org\apache\rocketmq\namesrv\processor\DefaultRequestProcessorTest.java,371,122,25,83,5,235
 hadoop-trunk\hadoop-trunk\hadoop-tools\hadoop-aws\src\test\java\org\apache\hadoop\fs\s3a\scale\ITestS3ADirectoryPerformance.java,372,31,12,8,1,52
 hadoop-trunk\hadoop-trunk\hadoop-yarn-project\hadoop-yarn\hadoop-yarn-server\hadoop-yarn-server-resourcemanager\src\main\java\org\apache\hadoop\yarn\server\resourcemanager\scheduler\capacity\placement\converter\LegacyMappingRuleToJson.java,372,35,6,3,2,46
 hadoop-trunk\hadoop-trunk\hadoop-yarn-project\hadoop-yarn\hadoop-yarn-server\hadoop-yarn-server-nodemanager\src\test\java\org\apache\hadoop\yarn\server\nodemanager\TestNodeStatusUpdaterForAttributes.java,372,42,9,7,2,60
 kafka-trunk\kafka-trunk\connect\runtime\src\test\java\org\apache\kafka\connect\integration\ConnectorRestartApiIntegrationTest.java,372,0,0,104,0,104
 kafka-trunk\kafka-trunk\metadata\src\test\java\org\apache\kafka\image\TopicsImageTest.java,372,0,1,39,0,40
 pulsar-master\pulsar-master\pulsar-io\common\src\test\java\org\apache\pulsar\io\common\IOConfigUtilsTest.java,372,96,9,24,0,129
 dubbo-3.0\dubbo-3.0\dubbo-common\src\main\java\org\apache\dubbo\common\compiler\support\ClassUtils.java,373,96,5,12,0,113
 dubbo-3.0\dubbo-3.0\dubbo-registry\dubbo-registry-api\src\main\java\org\apache\dubbo\registry\client\ServiceDiscoveryRegistry.java,373,140,11,72,0,223
 hadoop-trunk\hadoop-trunk\hadoop-tools\hadoop-aws\src\test\java\org\apache\hadoop\fs\s3a\ITestS3AMiscOperations.java,373,30,2,6,2,40
 hadoop-trunk\hadoop-trunk\hadoop-yarn-project\hadoop-yarn\hadoop-yarn-server\hadoop-yarn-server-applicationhistoryservice\src\main\java\org\apache\hadoop\yarn\server\timeline\webapp\TimelineWebServices.java,373,106,18,1,1,126
 hadoop-trunk\hadoop-trunk\hadoop-hdfs-project\hadoop-hdfs\src\test\java\org\apache\hadoop\hdfs\server\datanode\TestBlockRecovery2.java,373,45,5,3,3,56
 kafka-trunk\kafka-trunk\streams\src\test\java\org\apache\kafka\streams\integration\IQv2IntegrationTest.java,373,0,5,43,4,52
 pulsar-master\pulsar-master\pulsar-testclient\src\main\java\org\apache\pulsar\testclient\ManagedLedgerWriter.java,373,174,28,62,0,264
 hadoop-trunk\hadoop-trunk\hadoop-tools\hadoop-azure\src\test\java\org\apache\hadoop\fs\azurebfs\ITestAzureBlobFileSystemFlush.java,374,59,10,22,8,99
 hadoop-trunk\hadoop-trunk\hadoop-yarn-project\hadoop-yarn\hadoop-yarn-server\hadoop-yarn-server-nodemanager\src\test\java\org\apache\hadoop\yarn\server\nodemanager\containermanager\linux\runtime\TestJavaSandboxLinuxContainerRuntime.java,374,68,13,26,20,127
 hadoop-trunk\hadoop-trunk\hadoop-hdfs-project\hadoop-hdfs\src\test\java\org\apache\hadoop\hdfs\server\namenode\TestReconstructStripedBlocks.java,374,45,2,5,4,56
 pulsar-master\pulsar-master\pulsar-client-admin\src\main\java\org\apache\pulsar\client\admin\internal\SchemasImpl.java,374,161,0,61,0,222
 pulsar-master\pulsar-master\pulsar-client\src\test\java\org\apache\pulsar\client\impl\MessageIdCompareToTest.java,374,256,11,98,0,365
 hadoop-trunk\hadoop-trunk\hadoop-mapreduce-project\hadoop-mapreduce-client\hadoop-mapreduce-client-core\src\main\java\org\apache\hadoop\mapreduce\jobhistory\HistoryViewer.java,375,260,7,1,3,271
 hadoop-trunk\hadoop-trunk\hadoop-hdfs-project\hadoop-hdfs\src\test\java\org\apache\hadoop\hdfs\server\blockmanagement\TestNameNodePrunesMissingStorages.java,375,62,13,6,8,89
 hadoop-trunk\hadoop-trunk\hadoop-yarn-project\hadoop-yarn\hadoop-yarn-api\src\main\java\org\apache\hadoop\yarn\api\protocolrecords\GetApplicationsRequest.java,375,40,1,1,0,42
 hadoop-trunk\hadoop-trunk\hadoop-tools\hadoop-gridmix\src\test\java\org\apache\hadoop\mapred\gridmix\TestDistCacheEmulation.java,375,138,10,16,3,167
 hadoop-trunk\hadoop-trunk\hadoop-common-project\hadoop-common\src\main\java\org\apache\hadoop\fs\FsShell.java,375,88,6,1,0,95
 hadoop-trunk\hadoop-trunk\hadoop-common-project\hadoop-common\src\test\java\org\apache\hadoop\util\TestHostsFileReader.java,375,46,34,2,75,157
 hadoop-trunk\hadoop-trunk\hadoop-hdfs-project\hadoop-hdfs\src\test\java\org\apache\hadoop\hdfs\server\balancer\TestBalancerWithNodeGroup.java,375,109,3,14,6,132
 kafka-trunk\kafka-trunk\streams\src\test\java\org\apache\kafka\streams\integration\RackAwarenessIntegrationTest.java,375,0,0,110,0,110
 pulsar-master\pulsar-master\pulsar-client-tools\src\main\java\org\apache\pulsar\admin\cli\CmdClusters.java,375,112,3,54,0,169
 rocketmq-develop\rocketmq-develop\client\src\main\java\org\apache\rocketmq\client\trace\AsyncTraceDispatcher.java,375,150,13,37,10,210
 hadoop-trunk\hadoop-trunk\hadoop-yarn-project\hadoop-yarn\hadoop-yarn-server\hadoop-yarn-server-resourcemanager\src\test\java\org\apache\hadoop\yarn\server\resourcemanager\recovery\TestFSRMStateStore.java,376,62,10,10,5,87
 hadoop-trunk\hadoop-trunk\hadoop-mapreduce-project\hadoop-mapreduce-client\hadoop-mapreduce-client-jobclient\src\test\java\org\apache\hadoop\mapred\lib\TestMultipleOutputs.java,376,85,27,2,4,118
 pulsar-master\pulsar-master\pulsar-broker\src\test\java\org\apache\pulsar\broker\service\ReplicatorRateLimiterTest.java,376,129,15,66,0,210
 pulsar-master\pulsar-master\pulsar-client-admin\src\main\java\org\apache\pulsar\client\admin\internal\ClustersImpl.java,376,227,0,87,0,314
 hadoop-trunk\hadoop-trunk\hadoop-common-project\hadoop-common\src\test\java\org\apache\hadoop\log\TestLogLevel.java,377,57,6,1,1,65
 hadoop-trunk\hadoop-trunk\hadoop-yarn-project\hadoop-yarn\hadoop-yarn-common\src\test\java\org\apache\hadoop\yarn\webapp\TestWebApp.java,377,81,6,2,6,95
 pulsar-master\pulsar-master\pulsar-broker\src\test\java\org\apache\pulsar\broker\service\streamingdispatch\StreamingEntryReaderTests.java,377,146,2,63,0,211
 pulsar-master\pulsar-master\pulsar-proxy\src\test\java\org\apache\pulsar\proxy\server\ProxyIsAHttpProxyTest.java,377,79,1,51,0,131
 pulsar-master\pulsar-master\pulsar-broker\src\test\java\org\apache\pulsar\broker\service\persistent\PersistentStickyKeyDispatcherMultipleConsumersTest.java,377,113,7,62,0,182
 pulsar-master\pulsar-master\pulsar-client-1x-base\pulsar-client-1x\src\main\java\org\apache\pulsar\client\api\ConsumerConfiguration.java,377,96,0,52,0,148
 hadoop-trunk\hadoop-trunk\hadoop-yarn-project\hadoop-yarn\hadoop-yarn-server\hadoop-yarn-server-nodemanager\src\test\java\org\apache\hadoop\yarn\server\nodemanager\containermanager\linux\resources\gpu\TestGpuResourceAllocator.java,378,92,4,8,1,105
 hadoop-trunk\hadoop-trunk\hadoop-tools\hadoop-aws\src\test\java\org\apache\hadoop\fs\s3a\ITestS3ATemporaryCredentials.java,378,31,7,8,0,46
 hadoop-trunk\hadoop-trunk\hadoop-common-project\hadoop-common\src\test\java\org\apache\hadoop\security\TestCredentials.java,378,122,17,1,9,149
 hadoop-trunk\hadoop-trunk\hadoop-tools\hadoop-aws\src\main\java\org\apache\hadoop\fs\s3a\select\SelectBinding.java,378,16,3,1,1,21
 hadoop-trunk\hadoop-trunk\hadoop-hdfs-project\hadoop-hdfs\src\test\java\org\apache\hadoop\hdfs\server\namenode\snapshot\TestSnapshotRename.java,378,88,6,3,3,100
 kafka-trunk\kafka-trunk\streams\src\test\java\org\apache\kafka\streams\integration\AbstractResetIntegrationTest.java,378,0,3,83,6,92
 rocketmq-develop\rocketmq-develop\filter\src\main\java\org\apache\rocketmq\filter\expression\ComparisonExpression.java,378,100,22,39,15,176
 zookeeper-master\zookeeper-master\zookeeper-server\src\main\java\org\apache\zookeeper\server\auth\KerberosName.java,378,0,6,24,0,30
 hadoop-trunk\hadoop-trunk\hadoop-yarn-project\hadoop-yarn\hadoop-yarn-server\hadoop-yarn-server-nodemanager\src\test\java\org\apache\hadoop\yarn\server\nodemanager\util\TestCgroupsLCEResourcesHandler.java,379,58,5,2,0,65
 hadoop-trunk\hadoop-trunk\hadoop-mapreduce-project\hadoop-mapreduce-client\hadoop-mapreduce-client-jobclient\src\test\java\org\apache\hadoop\mapred\TestFixedLengthInputFormat.java,379,115,30,1,13,159
 kafka-trunk\kafka-trunk\clients\src\generated\java\org\apache\kafka\common\message\FetchRequestDataJsonConverter.java,379,0,0,72,0,72
 kafka-trunk\kafka-trunk\streams\src\test\java\org\apache\kafka\streams\processor\internals\RepartitionOptimizingTest.java,379,0,5,129,1,135
 zookeeper-master\zookeeper-master\zookeeper-server\src\main\java\org\apache\zookeeper\ClientCnxnSocketNIO.java,379,0,19,18,2,39
 dubbo-3.0\dubbo-3.0\dubbo-common\src\main\java\org\apache\dubbo\common\config\ConfigurationUtils.java,380,165,4,53,2,224
 hadoop-trunk\hadoop-trunk\hadoop-yarn-project\hadoop-yarn\hadoop-yarn-server\hadoop-yarn-server-common\src\main\java\org\apache\hadoop\yarn\server\webapp\AppBlock.java,380,42,3,6,3,54
 kafka-trunk\kafka-trunk\streams\src\main\java\org\apache\kafka\streams\processor\internals\GlobalStateManagerImpl.java,380,0,6,66,1,73
 pulsar-master\pulsar-master\pulsar-proxy\src\main\java\org\apache\pulsar\proxy\server\ProxyService.java,380,158,4,61,0,223
 dubbo-3.0\dubbo-3.0\dubbo-rpc\dubbo-rpc-triple\src\main\java\org\apache\dubbo\rpc\protocol\tri\stream\TripleServerStream.java,381,121,2,51,0,174
 hadoop-trunk\hadoop-trunk\hadoop-yarn-project\hadoop-yarn\hadoop-yarn-server\hadoop-yarn-server-timelineservice\src\test\java\org\apache\hadoop\yarn\server\timelineservice\reader\TestTimelineReaderWhitelistAuthorizationFilter.java,381,22,32,2,3,59
 hadoop-trunk\hadoop-trunk\hadoop-common-project\hadoop-common\src\test\java\org\apache\hadoop\test\MetricsAsserts.java,381,131,8,1,0,140
 hadoop-trunk\hadoop-trunk\hadoop-yarn-project\hadoop-yarn\hadoop-yarn-server\hadoop-yarn-server-resourcemanager\src\main\java\org\apache\hadoop\yarn\server\resourcemanager\scheduler\fair\AllocationConfiguration.java,381,116,4,9,3,132
 hadoop-trunk\hadoop-trunk\hadoop-hdfs-project\hadoop-hdfs\src\test\java\org\apache\hadoop\hdfs\server\datanode\TestSimulatedFSDataset.java,381,115,11,6,1,133
 hadoop-trunk\hadoop-trunk\hadoop-hdfs-project\hadoop-hdfs\src\test\java\org\apache\hadoop\hdfs\server\namenode\ha\TestObserverReadProxyProvider.java,381,56,8,2,3,69
 pulsar-master\pulsar-master\pulsar-common\src\test\java\org\apache\pulsar\common\util\collections\ConcurrentOpenHashSetTest.java,381,70,7,8,0,85
 pulsar-master\pulsar-master\pulsar-broker\src\test\java\org\apache\pulsar\broker\service\BrokerServiceAutoTopicCreationTest.java,381,136,5,96,0,237
 pulsar-master\pulsar-master\pulsar-broker\src\test\java\org\apache\pulsar\broker\service\ReplicatorTestBase.java,381,150,4,30,0,184
 hadoop-trunk\hadoop-trunk\hadoop-hdfs-project\hadoop-hdfs\src\test\java\org\apache\hadoop\security\TestPermissionSymlinks.java,382,65,23,2,9,99
 hadoop-trunk\hadoop-trunk\hadoop-mapreduce-project\hadoop-mapreduce-client\hadoop-mapreduce-client-app\src\test\java\org\apache\hadoop\mapreduce\jobhistory\TestEvents.java,382,55,16,9,0,80
 hadoop-trunk\hadoop-trunk\hadoop-hdfs-project\hadoop-hdfs\src\main\java\org\apache\hadoop\hdfs\server\blockmanagement\DatanodeStorageInfo.java,382,138,4,1,3,146
 hadoop-trunk\hadoop-trunk\hadoop-tools\hadoop-aws\src\main\java\org\apache\hadoop\fs\s3a\impl\DeleteOperation.java,382,14,5,5,2,26
 hadoop-trunk\hadoop-trunk\hadoop-hdfs-project\hadoop-hdfs\src\main\java\org\apache\hadoop\hdfs\tools\CryptoAdmin.java,382,39,0,1,0,40
 dubbo-3.0\dubbo-3.0\dubbo-common\src\main\java\org\apache\dubbo\common\extension\AdaptiveClassCodeGenerator.java,383,158,1,50,16,225
 hadoop-trunk\hadoop-trunk\hadoop-yarn-project\hadoop-yarn\hadoop-yarn-server\hadoop-yarn-server-resourcemanager\src\test\java\org\apache\hadoop\yarn\server\resourcemanager\scheduler\capacity\TestChildQueueOrder.java,383,325,21,14,2,362
 kafka-trunk\kafka-trunk\streams\src\test\java\org\apache\kafka\streams\kstream\internals\SlidingWindowedKStreamImplTest.java,383,0,7,96,10,113
 kafka-trunk\kafka-trunk\clients\src\test\java\org\apache\kafka\clients\producer\internals\BufferPoolTest.java,383,0,13,55,8,76
 kafka-trunk\kafka-trunk\connect\runtime\src\main\java\org\apache\kafka\connect\runtime\rest\resources\ConnectorsResource.java,383,0,10,109,5,124
 rocketmq-develop\rocketmq-develop\broker\src\test\java\org\apache\rocketmq\broker\processor\AdminBrokerProcessorTest.java,383,144,12,99,4,259
 hadoop-trunk\hadoop-trunk\hadoop-hdfs-project\hadoop-hdfs\src\test\java\org\apache\hadoop\hdfs\TestExtendedAcls.java,384,20,6,2,2,30
 hadoop-trunk\hadoop-trunk\hadoop-yarn-project\hadoop-yarn\hadoop-yarn-server\hadoop-yarn-server-nodemanager\src\test\java\org\apache\hadoop\yarn\server\nodemanager\containermanager\resourceplugin\com\nec\TestNECVEPlugin.java,384,54,0,3,0,57
 pulsar-master\pulsar-master\testmocks\src\main\java\org\apache\bookkeeper\client\PulsarMockBookKeeper.java,384,160,15,43,2,220
 zookeeper-master\zookeeper-master\zookeeper-recipes\zookeeper-recipes-election\src\main\java\org\apache\zookeeper\recipes\leader\LeaderElectionSupport.java,384,0,14,31,2,47
 hadoop-trunk\hadoop-trunk\hadoop-yarn-project\hadoop-yarn\hadoop-yarn-common\src\main\java\org\apache\hadoop\yarn\client\api\impl\TimelineConnector.java,385,92,8,8,3,111
 hadoop-trunk\hadoop-trunk\hadoop-hdfs-project\hadoop-hdfs\src\test\java\org\apache\hadoop\hdfs\server\namenode\TestStorageRestore.java,385,124,16,15,3,158
 kafka-trunk\kafka-trunk\streams\src\test\java\org\apache\kafka\streams\kstream\internals\KTableKTableOuterJoinTest.java,385,0,7,126,3,136
 pulsar-master\pulsar-master\pulsar-functions\worker\src\test\java\org\apache\pulsar\functions\worker\FunctionMetaDataManagerTest.java,385,60,0,45,0,105
 pulsar-master\pulsar-master\pulsar-client\src\test\java\org\apache\pulsar\client\impl\AcknowledgementsGroupingTrackerTest.java,385,137,3,41,0,181
 zookeeper-master\zookeeper-master\zookeeper-server\src\main\java\org\apache\zookeeper\server\persistence\TxnLogToolkit.java,385,0,37,32,7,76
 hadoop-trunk\hadoop-trunk\hadoop-yarn-project\hadoop-yarn\hadoop-yarn-applications\hadoop-yarn-services\hadoop-yarn-services-core\src\test\java\org\apache\hadoop\yarn\service\TestServiceManager.java,386,44,3,2,1,50
 hadoop-trunk\hadoop-trunk\hadoop-tools\hadoop-federation-balance\src\main\java\org\apache\hadoop\tools\fedbalance\procedure\BalanceProcedureScheduler.java,386,52,31,4,3,90
 hadoop-trunk\hadoop-trunk\hadoop-tools\hadoop-azure\src\test\java\org\apache\hadoop\fs\azure\ITestOutputStreamSemantics.java,386,45,6,5,2,58
 kafka-trunk\kafka-trunk\clients\src\test\java\org\apache\kafka\common\record\DefaultRecordBatchTest.java,386,0,4,54,46,104
 pulsar-master\pulsar-master\pulsar-common\src\test\java\org\apache\pulsar\common\util\collections\ConcurrentLongLongPairHashMapTest.java,386,155,15,19,0,189
 dubbo-3.0\dubbo-3.0\dubbo-metadata\dubbo-metadata-processor\src\test\java\org\apache\dubbo\metadata\annotation\processing\util\TypeUtilsTest.java,387,83,0,70,0,153
 hadoop-trunk\hadoop-trunk\hadoop-yarn-project\hadoop-yarn\hadoop-yarn-server\hadoop-yarn-server-resourcemanager\src\test\java\org\apache\hadoop\yarn\server\resourcemanager\MockNodes.java,387,189,12,9,0,210
 hadoop-trunk\hadoop-trunk\hadoop-yarn-project\hadoop-yarn\hadoop-yarn-server\hadoop-yarn-server-resourcemanager\src\main\java\org\apache\hadoop\yarn\server\resourcemanager\scheduler\fair\converter\FSConfigToCSConfigArgumentHandler.java,387,96,1,3,0,100
 hadoop-trunk\hadoop-trunk\hadoop-hdfs-project\hadoop-hdfs-client\src\main\java\org\apache\hadoop\hdfs\util\ByteArrayManager.java,387,63,3,1,2,69
 hadoop-trunk\hadoop-trunk\hadoop-hdfs-project\hadoop-hdfs\src\test\java\org\apache\hadoop\hdfs\server\namenode\TestFSPermissionChecker.java,387,89,28,4,9,130
 kafka-trunk\kafka-trunk\clients\src\generated\java\org\apache\kafka\common\message\ListPartitionReassignmentsRequestData.java,387,0,0,44,8,52
 pulsar-master\pulsar-master\managed-ledger\src\test\java\org\apache\bookkeeper\mledger\impl\OffloadPrefixReadTest.java,387,122,4,45,0,171
 hadoop-trunk\hadoop-trunk\hadoop-yarn-project\hadoop-yarn\hadoop-yarn-server\hadoop-yarn-server-resourcemanager\src\test\java\org\apache\hadoop\yarn\server\resourcemanager\scheduler\TestSchedulerApplicationAttempt.java,388,119,3,10,0,132
 zookeeper-master\zookeeper-master\zookeeper-server\src\main\java\org\apache\zookeeper\ZooKeeperMain.java,388,0,15,26,2,43
 hadoop-trunk\hadoop-trunk\hadoop-hdfs-project\hadoop-hdfs-rbf\src\test\java\org\apache\hadoop\hdfs\server\federation\resolver\TestMultipleDestinationResolver.java,389,25,0,2,0,27
 hadoop-trunk\hadoop-trunk\hadoop-yarn-project\hadoop-yarn\hadoop-yarn-common\src\main\java\org\apache\hadoop\yarn\api\records\impl\pb\ContainerPBImpl.java,389,98,108,1,0,207
 hadoop-trunk\hadoop-trunk\hadoop-yarn-project\hadoop-yarn\hadoop-yarn-csi\src\test\java\org\apache\hadoop\yarn\csi\adaptor\TestCsiAdaptorService.java,389,24,15,6,6,51
 hadoop-trunk\hadoop-trunk\hadoop-mapreduce-project\hadoop-mapreduce-client\hadoop-mapreduce-client-hs\src\test\java\org\apache\hadoop\mapreduce\v2\hs\webapp\TestHsWebServicesAcls.java,389,43,6,1,1,51
 hadoop-trunk\hadoop-trunk\hadoop-hdfs-project\hadoop-hdfs-rbf\src\main\java\org\apache\hadoop\hdfs\server\federation\store\StateStoreService.java,389,16,2,3,1,22
 hadoop-trunk\hadoop-trunk\hadoop-yarn-project\hadoop-yarn\hadoop-yarn-server\hadoop-yarn-server-common\src\main\java\org\apache\hadoop\yarn\server\uam\UnmanagedAMPoolManager.java,389,57,6,5,1,69
 kafka-trunk\kafka-trunk\connect\runtime\src\test\java\org\apache\kafka\connect\runtime\errors\RetryWithToleranceOperatorTest.java,389,0,4,66,1,71
 hadoop-trunk\hadoop-trunk\hadoop-yarn-project\hadoop-yarn\hadoop-yarn-common\src\main\java\org\apache\hadoop\yarn\api\protocolrecords\impl\pb\GetApplicationsRequestPBImpl.java,390,92,88,7,0,187
 hadoop-trunk\hadoop-trunk\hadoop-yarn-project\hadoop-yarn\hadoop-yarn-applications\hadoop-yarn-services\hadoop-yarn-services-core\src\test\java\org\apache\hadoop\yarn\service\MockServiceAM.java,390,119,16,3,4,142
 kafka-trunk\kafka-trunk\storage\src\generated\java\org\apache\kafka\server\log\remote\metadata\storage\generated\RemotePartitionDeleteMetadataRecord.java,390,0,0,34,8,42
 kafka-trunk\kafka-trunk\clients\src\main\java\org\apache\kafka\common\requests\FetchRequest.java,390,0,72,50,10,132
 pulsar-master\pulsar-master\pulsar-client\src\test\java\org\apache\pulsar\client\impl\schema\AvroSchemaTest.java,390,130,12,47,0,189
 pulsar-master\pulsar-master\pulsar-sql\presto-pulsar\src\main\java\org\apache\pulsar\sql\presto\PulsarSplitManager.java,390,160,5,94,0,259
 hadoop-trunk\hadoop-trunk\hadoop-mapreduce-project\hadoop-mapreduce-client\hadoop-mapreduce-client-common\src\main\java\org\apache\hadoop\mapreduce\v2\api\records\impl\pb\TaskReportPBImpl.java,391,108,104,3,0,215
 kafka-trunk\kafka-trunk\clients\src\test\java\org\apache\kafka\clients\ClusterConnectionStatesTest.java,391,0,12,77,14,103
 pulsar-master\pulsar-master\managed-ledger\src\test\java\org\apache\bookkeeper\mledger\impl\ManagedCursorConcurrencyTest.java,391,71,7,25,0,103
 zookeeper-master\zookeeper-master\zookeeper-server\src\test\java\org\apache\zookeeper\server\quorum\UnifiedServerSocketModeDetectionTest.java,391,0,5,17,8,30
 dubbo-3.0\dubbo-3.0\dubbo-cluster\src\main\java\org\apache\dubbo\rpc\cluster\support\AbstractClusterInvoker.java,392,127,9,63,0,199
 dubbo-3.0\dubbo-3.0\dubbo-config\dubbo-config-spring\src\test\java\org\apache\dubbo\config\spring\reference\javaconfig\JavaConfigReferenceBeanTest.java,392,116,1,68,0,185
 hadoop-trunk\hadoop-trunk\hadoop-yarn-project\hadoop-yarn\hadoop-yarn-applications\hadoop-yarn-applications-catalog\hadoop-yarn-applications-catalog-webapp\src\main\java\org\apache\hadoop\yarn\appcatalog\application\AppCatalogSolrClient.java,392,72,10,1,4,87
 hadoop-trunk\hadoop-trunk\hadoop-hdfs-project\hadoop-hdfs\src\main\java\org\apache\hadoop\hdfs\server\namenode\TransferFsImage.java,392,121,11,7,1,140
 kafka-trunk\kafka-trunk\connect\api\src\main\java\org\apache\kafka\connect\data\SchemaBuilder.java,392,0,17,28,0,45
 kafka-trunk\kafka-trunk\trogdor\src\main\java\org\apache\kafka\trogdor\workload\RoundTripWorker.java,392,0,15,36,0,51
 rocketmq-develop\rocketmq-develop\client\src\main\java\org\apache\rocketmq\client\impl\MQAdminImpl.java,392,170,5,88,7,270
 dubbo-3.0\dubbo-3.0\dubbo-registry\dubbo-registry-api\src\main\java\org\apache\dubbo\registry\client\ServiceDiscoveryRegistryDirectory.java,393,140,16,90,0,246
 hadoop-trunk\hadoop-trunk\hadoop-mapreduce-project\hadoop-mapreduce-client\hadoop-mapreduce-client-core\src\test\java\org\apache\hadoop\mapred\TestJobConf.java,393,122,28,3,0,153
 hadoop-trunk\hadoop-trunk\hadoop-common-project\hadoop-common\src\test\java\org\apache\hadoop\ha\TestFailoverController.java,393,73,14,19,8,114
 hadoop-trunk\hadoop-trunk\hadoop-hdfs-project\hadoop-hdfs\src\test\java\org\apache\hadoop\hdfs\server\namenode\TestFSDirectory.java,393,119,21,3,2,145
 hadoop-trunk\hadoop-trunk\hadoop-hdfs-project\hadoop-hdfs\src\main\java\org\apache\hadoop\hdfs\server\common\HostRestrictingAuthorizationFilter.java,393,62,21,2,2,87
 kafka-trunk\kafka-trunk\metadata\src\main\java\org\apache\kafka\controller\ClusterControlManager.java,393,0,2,49,0,51
 kafka-trunk\kafka-trunk\streams\src\test\java\org\apache\kafka\streams\integration\StreamStreamJoinIntegrationTest.java,393,0,1,30,1,32
 kafka-trunk\kafka-trunk\clients\src\generated\java\org\apache\kafka\common\message\MetadataResponseDataJsonConverter.java,393,0,0,82,0,82
 kafka-trunk\kafka-trunk\streams\src\test\java\org\apache\kafka\streams\processor\internals\assignment\TaskAssignorConvergenceTest.java,393,0,2,70,7,79
 dubbo-3.0\dubbo-3.0\dubbo-plugin\dubbo-qos\src\test\java\org\apache\dubbo\qos\command\impl\channel\MockNettyChannel.java,394,121,2,12,0,135
 hadoop-trunk\hadoop-trunk\hadoop-tools\hadoop-aws\src\main\java\org\apache\hadoop\fs\s3a\select\SelectInputStream.java,394,25,4,1,0,30
 hadoop-trunk\hadoop-trunk\hadoop-tools\hadoop-azure\src\test\java\org\apache\hadoop\fs\azure\integration\ITestAzureHugeFiles.java,394,35,43,1,0,79
 hadoop-trunk\hadoop-trunk\hadoop-yarn-project\hadoop-yarn\hadoop-yarn-client\src\test\java\org\apache\hadoop\yarn\client\TestRMFailover.java,394,42,12,7,2,63
 hadoop-trunk\hadoop-trunk\hadoop-hdfs-project\hadoop-hdfs\src\test\java\org\apache\hadoop\hdfs\server\namenode\TestNamenodeRetryCache.java,394,93,32,6,16,147
 hadoop-trunk\hadoop-trunk\hadoop-mapreduce-project\hadoop-mapreduce-client\hadoop-mapreduce-client-app\src\test\java\org\apache\hadoop\mapreduce\v2\app\TestKill.java,394,84,2,12,1,99
 hadoop-trunk\hadoop-trunk\hadoop-hdfs-project\hadoop-hdfs-rbf\src\main\java\org\apache\hadoop\hdfs\server\federation\router\ConnectionPool.java,394,39,5,3,3,50
 hadoop-trunk\hadoop-trunk\hadoop-hdfs-project\hadoop-hdfs-client\src\main\java\org\apache\hadoop\hdfs\client\impl\BlockReaderRemote.java,394,109,21,7,2,139
 hadoop-trunk\hadoop-trunk\hadoop-yarn-project\hadoop-yarn\hadoop-yarn-common\src\test\java\org\apache\hadoop\yarn\client\api\impl\TestTimelineClientV2Impl.java,394,49,17,1,2,69
 kafka-trunk\kafka-trunk\clients\src\test\java\org\apache\kafka\common\security\oauthbearer\OAuthBearerLoginModuleTest.java,394,0,6,47,0,53
 hadoop-trunk\hadoop-trunk\hadoop-common-project\hadoop-common\src\test\java\org\apache\hadoop\io\file\tfile\TestTFile.java,395,100,38,1,32,171
 hadoop-trunk\hadoop-trunk\hadoop-tools\hadoop-archive-logs\src\test\java\org\apache\hadoop\tools\TestHadoopArchiveLogs.java,395,107,1,4,2,114
 hadoop-trunk\hadoop-trunk\hadoop-tools\hadoop-federation-balance\src\test\java\org\apache\hadoop\tools\fedbalance\procedure\TestBalanceProcedureScheduler.java,395,73,47,4,4,128
 hadoop-trunk\hadoop-trunk\hadoop-hdfs-project\hadoop-hdfs\src\test\java\org\apache\hadoop\hdfs\tools\TestDFSHAAdmin.java,395,86,6,19,3,114
 hadoop-trunk\hadoop-trunk\hadoop-yarn-project\hadoop-yarn\hadoop-yarn-server\hadoop-yarn-server-resourcemanager\src\test\java\org\apache\hadoop\yarn\server\resourcemanager\Application.java,395,182,11,11,8,212
 hadoop-trunk\hadoop-trunk\hadoop-yarn-project\hadoop-yarn\hadoop-yarn-server\hadoop-yarn-server-resourcemanager\src\test\java\org\apache\hadoop\yarn\server\resourcemanager\TestContainerResourceUsage.java,395,47,8,7,1,63
 kafka-trunk\kafka-trunk\connect\runtime\src\main\java\org\apache\kafka\connect\runtime\rest\RestServer.java,395,0,19,60,0,79
 pulsar-master\pulsar-master\pulsar-common\src\main\java\org\apache\pulsar\common\sasl\KerberosName.java,395,69,3,20,0,92
 hadoop-trunk\hadoop-trunk\hadoop-yarn-project\hadoop-yarn\hadoop-yarn-server\hadoop-yarn-server-resourcemanager\src\test\java\org\apache\hadoop\yarn\server\resourcemanager\TestRMAuditLogger.java,396,124,11,8,2,145
 hadoop-trunk\hadoop-trunk\hadoop-hdfs-project\hadoop-hdfs\src\test\java\org\apache\hadoop\hdfs\server\namenode\TestStripedINodeFile.java,396,76,10,3,7,96
 kafka-trunk\kafka-trunk\streams\src\test\java\org\apache\kafka\streams\kstream\internals\KStreamWindowAggregateTest.java,396,0,9,134,0,143
 kafka-trunk\kafka-trunk\connect\runtime\src\main\java\org\apache\kafka\connect\runtime\ConnectMetrics.java,396,0,3,54,3,60
 hadoop-trunk\hadoop-trunk\hadoop-tools\hadoop-openstack\src\test\java\org\apache\hadoop\fs\swift\TestSwiftFileSystemPartitionedUploads.java,397,40,20,3,4,67
 hadoop-trunk\hadoop-trunk\hadoop-hdfs-project\hadoop-hdfs\src\main\java\org\apache\hadoop\hdfs\net\DFSTopologyNodeImpl.java,397,52,7,1,0,60
 hadoop-trunk\hadoop-trunk\hadoop-hdfs-project\hadoop-hdfs\src\test\java\org\apache\hadoop\hdfs\server\namenode\TestFSNamesystemLock.java,397,39,3,1,1,44
 pulsar-master\pulsar-master\pulsar-metadata\src\test\java\org\apache\pulsar\metadata\MetadataStoreTest.java,397,88,1,48,0,137
 pulsar-master\pulsar-master\tiered-storage\jcloud\src\test\java\org\apache\bookkeeper\mledger\offload\jcloud\impl\BlobStoreManagedLedgerOffloaderStreamingTest.java,397,140,17,82,0,239
 hadoop-trunk\hadoop-trunk\hadoop-common-project\hadoop-common\src\test\java\org\apache\hadoop\metrics2\lib\TestMutableMetrics.java,398,73,5,1,3,82
 hadoop-trunk\hadoop-trunk\hadoop-hdfs-project\hadoop-hdfs\src\test\java\org\apache\hadoop\hdfs\server\namenode\TestNamenodeCapacityReport.java,398,88,16,4,2,110
 hadoop-trunk\hadoop-trunk\hadoop-mapreduce-project\hadoop-mapreduce-client\hadoop-mapreduce-client-app\src\test\java\org\apache\hadoop\mapreduce\v2\app\TestJobEndNotifier.java,398,66,7,1,11,85
 hadoop-trunk\hadoop-trunk\hadoop-yarn-project\hadoop-yarn\hadoop-yarn-server\hadoop-yarn-server-resourcemanager\src\test\java\org\apache\hadoop\yarn\server\resourcemanager\webapp\TestRMWebServicesAppAttempts.java,398,47,3,6,1,57
 hadoop-trunk\hadoop-trunk\hadoop-yarn-project\hadoop-yarn\hadoop-yarn-common\src\main\java\org\apache\hadoop\yarn\logaggregation\LogCLIHelpers.java,398,69,3,3,2,77
 hadoop-trunk\hadoop-trunk\hadoop-common-project\hadoop-common\src\test\java\org\apache\hadoop\io\file\tfile\TestTFileStreams.java,398,116,57,2,29,204
 kafka-trunk\kafka-trunk\clients\src\test\java\org\apache\kafka\common\requests\OffsetFetchResponseTest.java,398,0,12,61,12,85
 pulsar-master\pulsar-master\pulsar-broker\src\test\java\org\apache\pulsar\broker\loadbalance\SimpleLoadManagerImplTest.java,398,185,5,52,0,242
 pulsar-master\pulsar-master\pulsar-client\src\test\java\org\apache\pulsar\client\impl\schema\JSONSchemaTest.java,398,101,38,48,0,187
 rocketmq-develop\rocketmq-develop\store\src\test\java\org\apache\rocketmq\store\ConsumeQueueTest.java,398,127,10,43,6,186
 hadoop-trunk\hadoop-trunk\hadoop-tools\hadoop-aws\src\test\java\org\apache\hadoop\fs\s3a\TestInvoker.java,399,64,6,3,1,74
 kafka-trunk\kafka-trunk\metadata\src\main\java\org\apache\kafka\metadata\authorizer\StandardAuthorizerData.java,399,0,14,56,0,70
 kafka-trunk\kafka-trunk\streams\test-utils\src\test\java\org\apache\kafka\streams\TestTopicsTest.java,399,0,1,91,6,98
 hadoop-trunk\hadoop-trunk\hadoop-hdfs-project\hadoop-hdfs\src\test\java\org\apache\hadoop\hdfs\server\blockmanagement\BlockManagerTestUtil.java,400,114,11,9,0,134
 hadoop-trunk\hadoop-trunk\hadoop-yarn-project\hadoop-yarn\hadoop-yarn-server\hadoop-yarn-server-resourcemanager\src\main\java\org\apache\hadoop\yarn\server\resourcemanager\scheduler\capacity\CSMaxRunningAppsEnforcer.java,400,51,7,2,1,61
 hadoop-trunk\hadoop-trunk\hadoop-hdfs-project\hadoop-hdfs-rbf\src\test\java\org\apache\hadoop\hdfs\server\federation\router\TestRouterRpcMultiDestination.java,400,14,5,5,2,26
 hadoop-trunk\hadoop-trunk\hadoop-yarn-project\hadoop-yarn\hadoop-yarn-server\hadoop-yarn-server-resourcemanager\src\test\java\org\apache\hadoop\yarn\server\resourcemanager\metrics\TestSystemMetricsPublisherForV2.java,401,35,10,6,5,56
 hadoop-trunk\hadoop-trunk\hadoop-hdfs-project\hadoop-hdfs\src\test\java\org\apache\hadoop\hdfs\util\TestLightWeightLinkedSet.java,401,70,7,1,2,80
 hadoop-trunk\hadoop-trunk\hadoop-hdfs-project\hadoop-hdfs\src\main\java\org\apache\hadoop\hdfs\server\datanode\checker\DatasetVolumeChecker.java,401,46,12,12,0,70
 hadoop-trunk\hadoop-trunk\hadoop-tools\hadoop-aws\src\test\java\org\apache\hadoop\fs\s3a\TestStreamChangeTracker.java,401,45,2,2,1,50
 hadoop-trunk\hadoop-trunk\hadoop-mapreduce-project\hadoop-mapreduce-client\hadoop-mapreduce-client-core\src\main\java\org\apache\hadoop\mapred\LocatedFileStatusFetcher.java,401,71,7,9,3,90
 rocketmq-develop\rocketmq-develop\client\src\main\java\org\apache\rocketmq\client\impl\consumer\ProcessQueue.java,401,127,14,24,5,170
 hadoop-trunk\hadoop-trunk\hadoop-yarn-project\hadoop-yarn\hadoop-yarn-server\hadoop-yarn-server-resourcemanager\src\main\java\org\apache\hadoop\yarn\server\resourcemanager\OpportunisticContainerAllocatorAMService.java,402,52,11,22,0,85
 hadoop-trunk\hadoop-trunk\hadoop-mapreduce-project\hadoop-mapreduce-examples\src\main\java\org\apache\hadoop\examples\dancing\DancingLinks.java,402,114,5,3,2,124
 hadoop-trunk\hadoop-trunk\hadoop-yarn-project\hadoop-yarn\hadoop-yarn-server\hadoop-yarn-server-nodemanager\src\main\java\org\apache\hadoop\yarn\server\nodemanager\containermanager\logaggregation\LogAggregationService.java,402,74,14,13,10,111
 pulsar-master\pulsar-master\pulsar-broker\src\test\java\org\apache\pulsar\client\api\SimpleProducerConsumerStatTest.java,402,110,3,39,0,152
 pulsar-master\pulsar-master\tests\integration\src\test\java\org\apache\pulsar\tests\integration\messaging\TopicMessagingBase.java,402,59,2,30,0,91
 pulsar-master\pulsar-master\pulsar-common\src\main\java\org\apache\pulsar\common\util\collections\GrowableArrayBlockingQueue.java,402,79,4,8,0,91
 dubbo-3.0\dubbo-3.0\dubbo-metadata\dubbo-metadata-report-nacos\src\main\java\org\apache\dubbo\metadata\store\nacos\NacosMetadataReport.java,403,189,13,58,0,260
 hadoop-trunk\hadoop-trunk\hadoop-common-project\hadoop-common\src\main\java\org\apache\hadoop\security\Credentials.java,403,81,17,2,0,100
 hadoop-trunk\hadoop-trunk\hadoop-yarn-project\hadoop-yarn\hadoop-yarn-common\src\main\java\org\apache\hadoop\yarn\client\api\impl\TimelineClientImpl.java,403,71,18,10,2,101
 hadoop-trunk\hadoop-trunk\hadoop-tools\hadoop-distcp\src\test\java\org\apache\hadoop\tools\TestDistCpViewFs.java,403,82,3,9,4,98
 hadoop-trunk\hadoop-trunk\hadoop-yarn-project\hadoop-yarn\hadoop-yarn-server\hadoop-yarn-server-nodemanager\src\test\java\org\apache\hadoop\yarn\server\nodemanager\containermanager\logaggregation\TestAppLogAggregatorImpl.java,403,83,15,9,8,115
 kafka-trunk\kafka-trunk\clients\src\generated\java\org\apache\kafka\common\message\AlterUserScramCredentialsResponseData.java,403,0,0,41,7,48
 kafka-trunk\kafka-trunk\connect\runtime\src\main\java\org\apache\kafka\connect\runtime\ConnectMetricsRegistry.java,403,0,0,167,0,167
 pulsar-master\pulsar-master\pulsar-broker\src\test\java\org\apache\pulsar\broker\admin\v3\AdminApiTransactionTest.java,403,140,1,94,0,235
 dubbo-3.0\dubbo-3.0\dubbo-common\src\main\java\org\apache\dubbo\rpc\model\ApplicationModel.java,404,127,2,33,11,173
 hadoop-trunk\hadoop-trunk\hadoop-yarn-project\hadoop-yarn\hadoop-yarn-server\hadoop-yarn-server-resourcemanager\src\main\java\org\apache\hadoop\yarn\server\resourcemanager\webapp\dao\ClusterMetricsInfo.java,404,237,2,4,3,246
 hadoop-trunk\hadoop-trunk\hadoop-hdfs-project\hadoop-hdfs\src\main\java\org\apache\hadoop\hdfs\server\balancer\NameNodeConnector.java,404,129,13,3,7,152
 hadoop-trunk\hadoop-trunk\hadoop-common-project\hadoop-common\src\test\java\org\apache\hadoop\util\Crc32PerformanceTest.java,404,82,4,1,8,95
 hadoop-trunk\hadoop-trunk\hadoop-yarn-project\hadoop-yarn\hadoop-yarn-api\src\main\java\org\apache\hadoop\yarn\api\records\timeline\TimelineEntity.java,404,120,25,2,8,155
 kafka-trunk\kafka-trunk\clients\src\test\java\org\apache\kafka\common\protocol\types\ProtocolSerializationTest.java,404,0,15,37,13,65
 kafka-trunk\kafka-trunk\streams\src\test\java\org\apache\kafka\streams\state\internals\StreamThreadStateStoreProviderTest.java,404,0,1,49,1,51
 pulsar-master\pulsar-master\pulsar-broker\src\test\java\org\apache\pulsar\broker\service\PersistentMessageFinderTest.java,404,137,2,77,0,216
 hadoop-trunk\hadoop-trunk\hadoop-hdfs-project\hadoop-hdfs\src\test\java\org\apache\hadoop\hdfs\server\datanode\TestDataNodeTcpNoDelay.java,405,105,8,2,1,116
 hadoop-trunk\hadoop-trunk\hadoop-hdfs-project\hadoop-hdfs\src\main\java\org\apache\hadoop\hdfs\server\blockmanagement\BlockPlacementPolicyWithNodeGroup.java,405,106,6,3,2,117
 hadoop-trunk\hadoop-trunk\hadoop-common-project\hadoop-common\src\test\java\org\apache\hadoop\security\TestDoAsEffectiveUser.java,405,60,12,6,14,92
 hadoop-trunk\hadoop-trunk\hadoop-yarn-project\hadoop-yarn\hadoop-yarn-server\hadoop-yarn-server-resourcemanager\src\test\java\org\apache\hadoop\yarn\server\resourcemanager\scheduler\capacity\TestCapacitySchedulerPerf.java,405,88,6,16,7,117
 kafka-trunk\kafka-trunk\streams\src\main\java\org\apache\kafka\streams\processor\internals\GlobalStreamThread.java,405,0,9,44,3,56
 pulsar-master\pulsar-master\pulsar-functions\instance\src\main\java\org\apache\pulsar\functions\sink\PulsarSink.java,405,138,4,65,0,207
 zookeeper-master\zookeeper-master\zookeeper-server\src\test\java\org\apache\zookeeper\test\WatcherTest.java,405,0,38,26,1,65
 hadoop-trunk\hadoop-trunk\hadoop-yarn-project\hadoop-yarn\hadoop-yarn-client\src\main\java\org\apache\hadoop\yarn\client\api\async\NMClientAsync.java,406,85,9,1,2,97
 hadoop-trunk\hadoop-trunk\hadoop-yarn-project\hadoop-yarn\hadoop-yarn-common\src\test\java\org\apache\hadoop\yarn\logaggregation\TestAggregatedLogFormat.java,406,53,22,6,4,85
 hadoop-trunk\hadoop-trunk\hadoop-yarn-project\hadoop-yarn\hadoop-yarn-server\hadoop-yarn-server-resourcemanager\src\test\java\org\apache\hadoop\yarn\server\resourcemanager\TestNodeBlacklistingOnAMFailures.java,406,51,3,8,0,62
 kafka-trunk\kafka-trunk\streams\src\test\java\org\apache\kafka\streams\integration\AdjustStreamThreadCountTest.java,406,0,19,80,6,105
 kafka-trunk\kafka-trunk\streams\src\test\java\org\apache\kafka\streams\integration\RestoreIntegrationTest.java,406,0,6,89,3,98
 kafka-trunk\kafka-trunk\streams\src\test\java\org\apache\kafka\streams\processor\internals\RepartitionTopicsTest.java,406,0,0,118,0,118
 kafka-trunk\kafka-trunk\clients\src\main\java\org\apache\kafka\common\security\oauthbearer\internals\expiring\ExpiringCredentialRefreshingLogin.java,406,0,27,108,4,139
 pulsar-master\pulsar-master\pulsar-broker\src\main\java\org\apache\pulsar\broker\stats\prometheus\NamespaceStatsAggregator.java,406,208,1,139,0,348
 zookeeper-master\zookeeper-master\zookeeper-server\src\test\java\org\apache\zookeeper\server\ZxidRolloverTest.java,406,0,15,10,0,25
 dubbo-3.0\dubbo-3.0\dubbo-registry\dubbo-registry-api\src\main\java\org\apache\dubbo\registry\support\FailbackRegistry.java,407,114,16,38,0,168
 hadoop-trunk\hadoop-trunk\hadoop-mapreduce-project\hadoop-mapreduce-client\hadoop-mapreduce-client-jobclient\src\test\java\org\apache\hadoop\mapreduce\lib\partition\TestKeyFieldHelper.java,407,93,19,1,12,125
 hadoop-trunk\hadoop-trunk\hadoop-mapreduce-project\hadoop-mapreduce-client\hadoop-mapreduce-client-jobclient\src\test\java\org\apache\hadoop\mapreduce\MapReduceTestUtil.java,407,170,21,1,6,198
 kafka-trunk\kafka-trunk\streams\src\test\java\org\apache\kafka\streams\state\internals\RocksDBRangeIteratorTest.java,407,0,6,23,14,43
 kafka-trunk\kafka-trunk\streams\src\test\java\org\apache\kafka\streams\state\internals\MeteredTimestampedKeyValueStoreTest.java,407,0,0,48,5,53
 pulsar-master\pulsar-master\tests\integration\src\test\java\org\apache\pulsar\tests\integration\io\sinks\PulsarIOSinkRunner.java,407,109,9,49,0,167
 rocketmq-develop\rocketmq-develop\common\src\main\java\org\apache\rocketmq\common\MixAll.java,407,111,25,35,12,183
 hadoop-trunk\hadoop-trunk\hadoop-hdfs-project\hadoop-hdfs\src\test\java\org\apache\hadoop\hdfs\TestFileConcurrentReader.java,408,71,6,1,2,80
 hadoop-trunk\hadoop-trunk\hadoop-common-project\hadoop-common\src\main\java\org\apache\hadoop\fs\shell\find\Find.java,408,65,3,2,1,71
 hadoop-trunk\hadoop-trunk\hadoop-common-project\hadoop-common\src\main\java\org\apache\hadoop\fs\FilterFs.java,408,172,1,1,0,174
 hadoop-trunk\hadoop-trunk\hadoop-hdfs-project\hadoop-hdfs\src\test\java\org\apache\hadoop\hdfs\server\namenode\TestSnapshotPathINodes.java,409,115,2,8,2,127
 hadoop-trunk\hadoop-trunk\hadoop-mapreduce-project\hadoop-mapreduce-client\hadoop-mapreduce-client-core\src\main\java\org\apache\hadoop\mapreduce\Cluster.java,409,88,5,4,2,99
 hadoop-trunk\hadoop-trunk\hadoop-yarn-project\hadoop-yarn\hadoop-yarn-server\hadoop-yarn-server-applicationhistoryservice\src\test\java\org\apache\hadoop\yarn\server\timeline\TestRollingLevelDBTimelineStore.java,409,42,21,7,6,76
 kafka-trunk\kafka-trunk\streams\src\test\java\org\apache\kafka\streams\processor\internals\metrics\ThreadMetricsTest.java,409,0,3,62,0,65
 rocketmq-develop\rocketmq-develop\client\src\main\java\org\apache\rocketmq\client\impl\consumer\ConsumeMessageConcurrentlyService.java,409,111,14,59,4,188
 hadoop-trunk\hadoop-trunk\hadoop-hdfs-project\hadoop-hdfs\src\main\java\org\apache\hadoop\hdfs\protocol\datatransfer\sasl\SaslDataTransferServer.java,410,67,10,12,2,91
 hadoop-trunk\hadoop-trunk\hadoop-common-project\hadoop-common\src\main\java\org\apache\hadoop\net\DNS.java,410,59,4,2,0,65
 hadoop-trunk\hadoop-trunk\hadoop-hdfs-project\hadoop-hdfs\src\test\java\org\apache\hadoop\hdfs\AdminStatesBaseTest.java,410,125,13,1,1,140
 hadoop-trunk\hadoop-trunk\hadoop-yarn-project\hadoop-yarn\hadoop-yarn-server\hadoop-yarn-server-timelineservice\src\main\java\org\apache\hadoop\yarn\server\timelineservice\collector\NodeTimelineCollectorManager.java,410,66,19,6,3,94
 hadoop-trunk\hadoop-trunk\hadoop-hdfs-project\hadoop-hdfs\src\test\java\org\apache\hadoop\security\TestPermission.java,410,121,48,3,1,173
 rocketmq-develop\rocketmq-develop\client\src\main\java\org\apache\rocketmq\client\consumer\DefaultMQPullConsumer.java,410,282,1,83,5,371
 skywalking-master\skywalking-master\oap-server\server-receiver-plugin\skywalking-trace-receiver-plugin\src\test\java\org\apache\skywalking\oap\server\receiver\trace\provider\parser\listener\RPCAnalysisListenerTest.java,410,110,4,91,0,205
 hadoop-trunk\hadoop-trunk\hadoop-hdfs-project\hadoop-hdfs\src\test\java\org\apache\hadoop\fs\viewfs\TestViewFileSystemLinkRegex.java,411,49,6,2,1,58
 pulsar-master\pulsar-master\pulsar-proxy\src\main\java\org\apache\pulsar\proxy\server\LookupProxyHandler.java,411,139,5,82,0,226
 hadoop-trunk\hadoop-trunk\hadoop-common-project\hadoop-common\src\test\java\org\apache\hadoop\security\TestLdapGroupsMapping.java,412,39,5,5,9,58
 hadoop-trunk\hadoop-trunk\hadoop-mapreduce-project\hadoop-mapreduce-client\hadoop-mapreduce-client-jobclient\src\test\java\org\apache\hadoop\mapreduce\lib\join\TestJoinDatamerge.java,412,108,26,3,0,137
 kafka-trunk\kafka-trunk\raft\src\generated\java\org\apache\kafka\raft\generated\QuorumStateData.java,412,0,0,25,7,32
 zookeeper-master\zookeeper-master\zookeeper-server\src\main\java\org\apache\zookeeper\server\SnapshotComparer.java,412,0,5,61,5,71
 zookeeper-master\zookeeper-master\zookeeper-server\src\test\java\org\apache\zookeeper\server\util\RequestPathMetricsCollectorTest.java,412,0,28,97,4,129
 hadoop-trunk\hadoop-trunk\hadoop-mapreduce-project\hadoop-mapreduce-client\hadoop-mapreduce-client-app\src\main\java\org\apache\hadoop\mapreduce\v2\app\webapp\AppController.java,413,65,10,1,0,76
 hadoop-trunk\hadoop-trunk\hadoop-yarn-project\hadoop-yarn\hadoop-yarn-server\hadoop-yarn-server-common\src\test\java\org\apache\hadoop\yarn\TestRPC.java,413,60,3,9,2,74
 hadoop-trunk\hadoop-trunk\hadoop-yarn-project\hadoop-yarn\hadoop-yarn-common\src\main\java\org\apache\hadoop\yarn\logaggregation\LogAggregationUtils.java,413,73,12,1,1,87
 pulsar-master\pulsar-master\pulsar-testclient\src\main\java\org\apache\pulsar\proxy\socket\client\PerformanceClient.java,413,183,26,80,0,289
 shardingsphere-master\shardingsphere-master\shardingsphere-jdbc\shardingsphere-jdbc-core\src\main\java\org\apache\shardingsphere\driver\jdbc\unsupported\AbstractUnsupportedUpdateOperationResultSet.java,413,163,0,82,0,245
 dubbo-3.0\dubbo-3.0\dubbo-common\src\main\java\org\apache\dubbo\config\ProviderConfig.java,414,198,1,6,0,205
 hadoop-trunk\hadoop-trunk\hadoop-yarn-project\hadoop-yarn\hadoop-yarn-server\hadoop-yarn-server-resourcemanager\src\test\java\org\apache\hadoop\yarn\server\resourcemanager\reservation\ReservationSystemTestUtil.java,414,141,14,13,1,169
 pulsar-master\pulsar-master\managed-ledger\src\main\java\org\apache\bookkeeper\mledger\impl\ManagedLedgerOfflineBacklog.java,414,155,4,112,0,271
 zookeeper-master\zookeeper-master\zookeeper-server\src\main\java\org\apache\zookeeper\Login.java,414,0,15,65,2,82
 dubbo-3.0\dubbo-3.0\dubbo-rpc\dubbo-rpc-triple\src\main\java\org\apache\dubbo\rpc\protocol\tri\ReflectionPackableMethod.java,415,138,0,52,0,190
 hadoop-trunk\hadoop-trunk\hadoop-yarn-project\hadoop-yarn\hadoop-yarn-server\hadoop-yarn-server-resourcemanager\src\main\java\org\apache\hadoop\yarn\server\resourcemanager\reservation\AbstractSchedulerPlanFollower.java,415,95,3,6,1,105
 hadoop-trunk\hadoop-trunk\hadoop-yarn-project\hadoop-yarn\hadoop-yarn-server\hadoop-yarn-server-resourcemanager\src\test\java\org\apache\hadoop\yarn\server\resourcemanager\scheduler\capacity\TestUtils.java,415,216,24,22,4,266
 hadoop-trunk\hadoop-trunk\hadoop-yarn-project\hadoop-yarn\hadoop-yarn-server\hadoop-yarn-server-common\src\main\java\org\apache\hadoop\yarn\server\api\protocolrecords\impl\pb\NodeHeartbeatRequestPBImpl.java,415,86,105,8,0,199
 hadoop-trunk\hadoop-trunk\hadoop-yarn-project\hadoop-yarn\hadoop-yarn-common\src\main\java\org\apache\hadoop\yarn\util\Log4jWarningErrorMetricsAppender.java,415,111,8,4,1,124
 hadoop-trunk\hadoop-trunk\hadoop-tools\hadoop-resourceestimator\src\test\java\org\apache\hadoop\resourceestimator\skylinestore\impl\TestSkylineStore.java,415,37,5,11,4,57
 kafka-trunk\kafka-trunk\clients\src\generated-test\java\org\apache\kafka\common\message\SimpleExampleMessageDataJsonConverter.java,415,0,0,81,2,83
 kafka-trunk\kafka-trunk\connect\runtime\src\test\java\org\apache\kafka\connect\runtime\isolation\SynchronizationTest.java,415,0,4,49,7,60
 kafka-trunk\kafka-trunk\streams\src\test\java\org\apache\kafka\streams\state\internals\MeteredWindowStoreTest.java,415,0,2,59,16,77
 pulsar-master\pulsar-master\pulsar-broker\src\test\java\org\apache\pulsar\client\impl\PatternTopicsConsumerImplAuthTest.java,415,206,11,73,0,290
 pulsar-master\pulsar-master\pulsar-metadata\src\test\java\org\apache\pulsar\metadata\bookkeeper\LedgerManagerIteratorTest.java,415,110,3,49,0,162
 hadoop-trunk\hadoop-trunk\hadoop-yarn-project\hadoop-yarn\hadoop-yarn-common\src\main\java\org\apache\hadoop\yarn\security\ContainerTokenIdentifier.java,416,159,69,3,0,231
 hadoop-trunk\hadoop-trunk\hadoop-common-project\hadoop-common\src\test\java\org\apache\hadoop\conf\TestConfigurationDeprecation.java,416,91,23,4,10,128
 kafka-trunk\kafka-trunk\clients\src\generated\java\org\apache\kafka\common\message\LeaderAndIsrRequestDataJsonConverter.java,416,0,0,101,0,101
 kafka-trunk\kafka-trunk\connect\runtime\src\test\java\org\apache\kafka\connect\runtime\isolation\PluginsTest.java,416,0,3,66,12,81
 zookeeper-master\zookeeper-master\zookeeper-server\src\test\java\org\apache\zookeeper\test\ZooKeeperTestClient.java,416,0,53,47,2,102
 hadoop-trunk\hadoop-trunk\hadoop-common-project\hadoop-common\src\main\java\org\apache\hadoop\fs\permission\FsPermission.java,417,186,13,1,0,200
 hadoop-trunk\hadoop-trunk\hadoop-common-project\hadoop-common\src\test\java\org\apache\hadoop\io\compress\zlib\TestZlibCompressorDecompressor.java,417,138,39,13,11,201
 hadoop-trunk\hadoop-trunk\hadoop-tools\hadoop-azure\src\test\java\org\apache\hadoop\fs\azurebfs\ITestAzureBlobFileSystemDelegationSAS.java,417,52,5,33,7,97
 hadoop-trunk\hadoop-trunk\hadoop-hdfs-project\hadoop-hdfs\src\test\java\org\apache\hadoop\hdfs\TestDFSStorageStateRecovery.java,417,147,19,20,0,186
 kafka-trunk\kafka-trunk\metadata\src\generated\java\org\apache\kafka\common\metadata\UserScramCredentialRecord.java,417,0,0,35,11,46
 kafka-trunk\kafka-trunk\tools\src\main\java\org\apache\kafka\tools\ProducerPerformance.java,417,0,8,45,0,53
 kafka-trunk\kafka-trunk\connect\runtime\src\main\java\org\apache\kafka\connect\runtime\WorkerTask.java,417,0,14,38,0,52
 rocketmq-develop\rocketmq-develop\client\src\test\java\org\apache\rocketmq\client\impl\MQClientAPIImplTest.java,417,192,22,86,8,308
 hadoop-trunk\hadoop-trunk\hadoop-hdfs-project\hadoop-hdfs\src\test\java\org\apache\hadoop\hdfs\TestDeadNodeDetection.java,418,47,10,8,8,73
 hadoop-trunk\hadoop-trunk\hadoop-mapreduce-project\hadoop-mapreduce-client\hadoop-mapreduce-client-jobclient\src\test\java\org\apache\hadoop\mapreduce\lib\input\TestFixedLengthInputFormat.java,418,109,26,1,13,149
 hadoop-trunk\hadoop-trunk\hadoop-tools\hadoop-federation-balance\src\test\java\org\apache\hadoop\tools\fedbalance\TestDistCpProcedure.java,418,69,8,5,3,85
 hadoop-trunk\hadoop-trunk\hadoop-common-project\hadoop-common\src\main\java\org\apache\hadoop\security\token\delegation\web\DelegationTokenAuthenticatedURL.java,418,60,5,7,2,74
 hadoop-trunk\hadoop-trunk\hadoop-yarn-project\hadoop-yarn\hadoop-yarn-server\hadoop-yarn-server-common\src\test\java\org\apache\hadoop\yarn\server\uam\TestUnmanagedApplicationManager.java,418,76,2,5,15,98
 kafka-trunk\kafka-trunk\streams\src\test\java\org\apache\kafka\streams\integration\RegexSourceIntegrationTest.java,418,0,3,96,5,104
 hadoop-trunk\hadoop-trunk\hadoop-yarn-project\hadoop-yarn\hadoop-yarn-client\src\main\java\org\apache\hadoop\yarn\client\cli\SchedConfCLI.java,419,52,1,1,1,55
 hadoop-trunk\hadoop-trunk\hadoop-tools\hadoop-aws\src\test\java\org\apache\hadoop\fs\s3a\ITestS3AFileOperationCost.java,419,33,6,1,4,44
 hadoop-trunk\hadoop-trunk\hadoop-tools\hadoop-gridmix\src\test\java\org\apache\hadoop\mapred\gridmix\TestGridmixMemoryEmulation.java,419,172,1,5,1,179
 hadoop-trunk\hadoop-trunk\hadoop-yarn-project\hadoop-yarn\hadoop-yarn-server\hadoop-yarn-server-nodemanager\src\main\java\org\apache\hadoop\yarn\server\nodemanager\containermanager\linux\resources\CGroupElasticMemoryController.java,419,65,14,12,1,92
 kafka-trunk\kafka-trunk\streams\src\test\java\org\apache\kafka\streams\kstream\internals\suppress\KTableSuppressProcessorTest.java,419,0,0,93,0,93
 hadoop-trunk\hadoop-trunk\hadoop-mapreduce-project\hadoop-mapreduce-client\hadoop-mapreduce-client-jobclient\src\test\java\org\apache\hadoop\fs\loadGenerator\LoadGeneratorMR.java,420,190,6,10,19,225
 hadoop-trunk\hadoop-trunk\hadoop-common-project\hadoop-auth\src\main\java\org\apache\hadoop\security\authentication\util\KerberosUtil.java,420,77,8,2,1,88
 hadoop-trunk\hadoop-trunk\hadoop-hdfs-project\hadoop-hdfs-httpfs\src\test\java\org\apache\hadoop\lib\service\hadoop\TestFileSystemAccessService.java,420,44,7,16,18,85
 kafka-trunk\kafka-trunk\trogdor\src\test\java\org\apache\kafka\trogdor\agent\AgentTest.java,420,0,2,39,2,43
 kafka-trunk\kafka-trunk\streams\src\test\java\org\apache\kafka\streams\state\internals\MeteredKeyValueStoreTest.java,420,0,1,36,10,47
 pulsar-master\pulsar-master\pulsar-websocket\src\main\java\org\apache\pulsar\websocket\ConsumerHandler.java,420,141,18,80,0,239
 pulsar-master\pulsar-master\pulsar-broker\src\main\java\org\apache\pulsar\broker\service\persistent\PersistentStickyKeyDispatcherMultipleConsumers.java,420,142,4,100,0,246
 pulsar-master\pulsar-master\pulsar-client-admin\src\main\java\org\apache\pulsar\client\admin\internal\PulsarAdminImpl.java,420,129,7,39,0,175
 zookeeper-master\zookeeper-master\zookeeper-server\src\main\java\org\apache\zookeeper\client\ZooKeeperSaslClient.java,420,0,31,63,1,95
 dubbo-3.0\dubbo-3.0\dubbo-cluster\src\test\java\org\apache\dubbo\rpc\cluster\merger\ResultMergerTest.java,421,116,10,30,0,156
 dubbo-3.0\dubbo-3.0\dubbo-remoting\dubbo-remoting-netty4\src\main\java\org\apache\dubbo\remoting\transport\netty4\NettyBackedChannelBuffer.java,421,152,0,5,0,157
 hadoop-trunk\hadoop-trunk\hadoop-common-project\hadoop-common\src\test\java\org\apache\hadoop\cli\CLITestHelper.java,421,148,51,1,2,202
 hadoop-trunk\hadoop-trunk\hadoop-mapreduce-project\hadoop-mapreduce-client\hadoop-mapreduce-client-app\src\test\java\org\apache\hadoop\mapreduce\v2\app\TestFetchFailure.java,421,82,43,7,0,132
 kafka-trunk\kafka-trunk\core\src\test\java\kafka\testkit\KafkaClusterTestKit.java,421,0,2,77,5,84
 zookeeper-master\zookeeper-master\zookeeper-server\src\main\java\org\apache\zookeeper\Shell.java,421,0,13,16,3,32
 dubbo-3.0\dubbo-3.0\dubbo-common\src\main\java\org\apache\dubbo\common\bytecode\Wrapper.java,422,94,4,51,1,150
 hadoop-trunk\hadoop-trunk\hadoop-common-project\hadoop-common\src\main\java\org\apache\hadoop\io\retry\RetryInvocationHandler.java,422,101,11,2,1,115
 hadoop-trunk\hadoop-trunk\hadoop-common-project\hadoop-common\src\test\java\org\apache\hadoop\ha\ClientBaseWithFixes.java,422,129,12,9,16,166
 hadoop-trunk\hadoop-trunk\hadoop-yarn-project\hadoop-yarn\hadoop-yarn-applications\hadoop-yarn-applications-distributedshell\src\test\java\org\apache\hadoop\yarn\applications\distributedshell\TestDSTimelineV20.java,422,54,4,5,1,64
 hadoop-trunk\hadoop-trunk\hadoop-common-project\hadoop-common\src\main\java\org\apache\hadoop\metrics2\lib\MetricsRegistry.java,422,132,2,1,0,135
 kafka-trunk\kafka-trunk\metadata\src\generated\java\org\apache\kafka\common\metadata\PartitionRecord.java,422,0,0,28,10,38
 kafka-trunk\kafka-trunk\connect\runtime\src\test\java\org\apache\kafka\connect\util\clusters\EmbeddedKafkaCluster.java,422,0,13,85,9,107
 hadoop-trunk\hadoop-trunk\hadoop-yarn-project\hadoop-yarn\hadoop-yarn-applications\hadoop-yarn-services\hadoop-yarn-services-core\src\main\java\org\apache\hadoop\yarn\service\api\records\Service.java,423,204,4,12,20,240
 hadoop-trunk\hadoop-trunk\hadoop-yarn-project\hadoop-yarn\hadoop-yarn-server\hadoop-yarn-server-resourcemanager\src\test\java\org\apache\hadoop\yarn\server\resourcemanager\scheduler\capacity\TestCapacitySchedulerWithMultiResourceTypes.java,423,69,36,17,6,128
 dubbo-3.0\dubbo-3.0\dubbo-config\dubbo-config-api\src\main\java\org\apache\dubbo\config\deploy\DefaultModuleDeployer.java,424,65,23,31,0,119
 dubbo-3.0\dubbo-3.0\dubbo-remoting\dubbo-remoting-netty\src\main\java\org\apache\dubbo\remoting\transport\netty\NettyBackedChannelBuffer.java,424,155,0,6,0,161
 hadoop-trunk\hadoop-trunk\hadoop-yarn-project\hadoop-yarn\hadoop-yarn-server\hadoop-yarn-server-resourcemanager\src\test\java\org\apache\hadoop\yarn\server\resourcemanager\scheduler\capacity\TestCapacitySchedulerMultiNodes.java,424,71,15,10,5,101
 hadoop-trunk\hadoop-trunk\hadoop-yarn-project\hadoop-yarn\hadoop-yarn-server\hadoop-yarn-server-nodemanager\src\main\java\org\apache\hadoop\yarn\server\nodemanager\util\CgroupsLCEResourcesHandler.java,424,82,13,7,2,104
 hadoop-trunk\hadoop-trunk\hadoop-mapreduce-project\hadoop-mapreduce-client\hadoop-mapreduce-client-core\src\main\java\org\apache\hadoop\mapred\IFile.java,424,243,6,5,4,258
 hadoop-trunk\hadoop-trunk\hadoop-yarn-project\hadoop-yarn\hadoop-yarn-server\hadoop-yarn-server-resourcemanager\src\main\java\org\apache\hadoop\yarn\server\resourcemanager\recovery\records\impl\pb\ApplicationAttemptStateDataPBImpl.java,424,107,102,11,0,220
 kafka-trunk\kafka-trunk\connect\transforms\src\main\java\org\apache\kafka\connect\transforms\Cast.java,424,0,38,65,0,103
 pulsar-master\pulsar-master\pulsar-sql\presto-pulsar\src\test\java\org\apache\pulsar\sql\presto\TestPulsarSplitManager.java,424,155,22,117,0,294
 pulsar-master\pulsar-master\pulsar-broker\src\test\java\org\apache\pulsar\client\api\RetryTopicTest.java,424,95,15,71,0,181
 hadoop-trunk\hadoop-trunk\hadoop-hdfs-project\hadoop-hdfs\src\test\java\org\apache\hadoop\hdfs\server\namenode\TestLeaseManager.java,425,52,19,2,6,79
 hadoop-trunk\hadoop-trunk\hadoop-yarn-project\hadoop-yarn\hadoop-yarn-applications\hadoop-yarn-services\hadoop-yarn-services-core\src\main\java\org\apache\hadoop\yarn\service\provider\ProviderUtils.java,425,92,19,9,1,121
 hadoop-trunk\hadoop-trunk\hadoop-yarn-project\hadoop-yarn\hadoop-yarn-server\hadoop-yarn-server-resourcemanager\src\test\java\org\apache\hadoop\yarn\server\resourcemanager\webapp\TestRMWebServicesDelegationTokenAuthentication.java,425,52,11,18,4,85
 hadoop-trunk\hadoop-trunk\hadoop-common-project\hadoop-common\src\test\java\org\apache\hadoop\util\functional\TestRemoteIterators.java,425,50,3,2,0,55
 hadoop-trunk\hadoop-trunk\hadoop-tools\hadoop-azure\src\test\java\org\apache\hadoop\fs\azurebfs\ITestAzureBlobFileSystemCreate.java,426,37,6,14,0,57
 hadoop-trunk\hadoop-trunk\hadoop-hdfs-project\hadoop-hdfs\src\test\java\org\apache\hadoop\hdfs\server\blockmanagement\TestSlowDiskTracker.java,426,150,16,4,0,170
 hadoop-trunk\hadoop-trunk\hadoop-tools\hadoop-aws\src\test\java\org\apache\hadoop\fs\s3a\TestS3AAWSCredentialsProvider.java,426,39,23,1,1,64
 kafka-trunk\kafka-trunk\streams\src\test\java\org\apache\kafka\streams\kstream\internals\KTableKTableInnerJoinTest.java,426,0,7,108,3,118
 dubbo-3.0\dubbo-3.0\dubbo-remoting\dubbo-remoting-api\src\test\java\org\apache\dubbo\remoting\codec\ExchangeCodecTest.java,427,181,25,52,0,258
 hadoop-trunk\hadoop-trunk\hadoop-hdfs-project\hadoop-hdfs\src\test\java\org\apache\hadoop\hdfs\server\datanode\extdataset\ExternalDatasetImpl.java,427,179,30,4,4,217
 hadoop-trunk\hadoop-trunk\hadoop-common-project\hadoop-auth\src\test\java\org\apache\hadoop\security\authentication\server\TestJWTRedirectAuthenticationHandler.java,427,70,15,15,6,106
 hadoop-trunk\hadoop-trunk\hadoop-yarn-project\hadoop-yarn\hadoop-yarn-common\src\main\java\org\apache\hadoop\yarn\util\FSDownload.java,427,116,16,4,7,143
 pulsar-master\pulsar-master\pulsar-broker\src\test\java\org\apache\pulsar\broker\auth\MockedPulsarServiceBaseTest.java,427,177,9,61,0,247
 pulsar-master\pulsar-master\pulsar-common\src\test\java\org\apache\pulsar\common\util\collections\ConcurrentOpenLongPairRangeSetTest.java,427,401,27,84,0,512
 rocketmq-develop\rocketmq-develop\broker\src\main\java\org\apache\rocketmq\broker\filter\ConsumerFilterManager.java,427,131,10,58,5,204
 zookeeper-master\zookeeper-master\zookeeper-server\src\test\java\org\apache\zookeeper\server\watch\WatchManagerTest.java,427,0,7,20,12,39
 zookeeper-master\zookeeper-master\zookeeper-server\src\test\java\org\apache\zookeeper\test\WatcherFuncTest.java,427,0,82,23,4,109
 hadoop-trunk\hadoop-trunk\hadoop-yarn-project\hadoop-yarn\hadoop-yarn-common\src\main\java\org\apache\hadoop\yarn\api\records\impl\pb\NodeReportPBImpl.java,428,91,105,1,0,197
 hadoop-trunk\hadoop-trunk\hadoop-common-project\hadoop-auth\src\main\java\org\apache\hadoop\security\authentication\util\ZKSignerSecretProvider.java,428,57,8,5,4,74
 hadoop-trunk\hadoop-trunk\hadoop-yarn-project\hadoop-yarn\hadoop-yarn-server\hadoop-yarn-server-resourcemanager\src\test\java\org\apache\hadoop\yarn\server\resourcemanager\scheduler\activities\TestActivitiesManager.java,428,63,9,10,2,84
 hadoop-trunk\hadoop-trunk\hadoop-yarn-project\hadoop-yarn\hadoop-yarn-server\hadoop-yarn-server-resourcemanager\src\test\java\org\apache\hadoop\yarn\server\resourcemanager\MockAM.java,428,213,5,7,7,232
 hadoop-trunk\hadoop-trunk\hadoop-hdfs-project\hadoop-hdfs-rbf\src\main\java\org\apache\hadoop\hdfs\server\federation\store\records\MountTable.java,428,31,2,2,0,35
 kafka-trunk\kafka-trunk\streams\src\main\java\org\apache\kafka\streams\state\internals\RocksDBTimestampedStore.java,428,0,4,57,3,64
 kafka-trunk\kafka-trunk\streams\src\test\java\org\apache\kafka\streams\processor\internals\assignment\SubscriptionInfoTest.java,428,0,1,57,1,59
 hadoop-trunk\hadoop-trunk\hadoop-yarn-project\hadoop-yarn\hadoop-yarn-server\hadoop-yarn-server-resourcemanager\src\main\java\org\apache\hadoop\yarn\server\resourcemanager\scheduler\capacity\ManagedParentQueue.java,429,49,5,13,2,69
 hadoop-trunk\hadoop-trunk\hadoop-hdfs-project\hadoop-hdfs\src\main\java\org\apache\hadoop\hdfs\server\namenode\BackupNode.java,429,132,10,14,2,158
 hadoop-trunk\hadoop-trunk\hadoop-hdfs-project\hadoop-hdfs\src\test\java\org\apache\hadoop\hdfs\server\datanode\TestDataNodeRollingUpgrade.java,429,118,10,14,1,143
 hadoop-trunk\hadoop-trunk\hadoop-common-project\hadoop-common\src\main\java\org\apache\hadoop\security\Groups.java,429,83,10,11,1,105
 kafka-trunk\kafka-trunk\metadata\src\main\java\org\apache\kafka\controller\ConfigurationControlManager.java,429,0,9,48,0,57
 pulsar-master\pulsar-master\pulsar-sql\presto-pulsar\src\main\java\org\apache\pulsar\sql\presto\PulsarConnectorConfig.java,429,262,0,40,0,302
 pulsar-master\pulsar-master\pulsar-broker\src\main\java\org\apache\pulsar\broker\service\persistent\DispatchRateLimiter.java,430,129,4,71,0,204
 hadoop-trunk\hadoop-trunk\hadoop-hdfs-project\hadoop-hdfs-rbf\src\main\java\org\apache\hadoop\hdfs\server\federation\router\NamenodeHeartbeatService.java,431,46,15,5,2,68
 hadoop-trunk\hadoop-trunk\hadoop-hdfs-project\hadoop-hdfs\src\test\java\org\apache\hadoop\hdfs\server\namenode\snapshot\SnapshotTestHelper.java,431,131,11,7,8,157
 hadoop-trunk\hadoop-trunk\hadoop-yarn-project\hadoop-yarn\hadoop-yarn-server\hadoop-yarn-server-resourcemanager\src\main\java\org\apache\hadoop\yarn\server\resourcemanager\reservation\planning\StageAllocatorLowCostAligned.java,431,99,3,5,0,107
 hadoop-trunk\hadoop-trunk\hadoop-hdfs-project\hadoop-hdfs-client\src\main\java\org\apache\hadoop\hdfs\StripeReader.java,431,71,7,2,1,81
 hadoop-trunk\hadoop-trunk\hadoop-common-project\hadoop-common\src\test\java\org\apache\hadoop\util\TestLightWeightCache.java,431,160,2,3,0,165
 hadoop-trunk\hadoop-trunk\hadoop-hdfs-project\hadoop-hdfs\src\test\java\org\apache\hadoop\hdfs\server\namenode\ha\TestEditLogTailer.java,431,83,11,1,4,99
 pulsar-master\pulsar-master\pulsar-proxy\src\test\java\org\apache\pulsar\proxy\server\ProxyWithAuthorizationTest.java,431,147,31,70,0,248
 hadoop-trunk\hadoop-trunk\hadoop-mapreduce-project\hadoop-mapreduce-client\hadoop-mapreduce-client-app\src\test\java\org\apache\hadoop\mapreduce\v2\app\launcher\TestContainerLauncher.java,432,111,9,12,2,134
 hadoop-trunk\hadoop-trunk\hadoop-common-project\hadoop-common\src\test\java\org\apache\hadoop\fs\TestFileSystemCaching.java,432,65,3,7,0,75
 hadoop-trunk\hadoop-trunk\hadoop-yarn-project\hadoop-yarn\hadoop-yarn-server\hadoop-yarn-server-resourcemanager\src\test\java\org\apache\hadoop\yarn\server\resourcemanager\scheduler\capacity\placement\TestMappingRuleCreator.java,432,61,1,10,0,72
 hadoop-trunk\hadoop-trunk\hadoop-yarn-project\hadoop-yarn\hadoop-yarn-server\hadoop-yarn-server-resourcemanager\src\test\java\org\apache\hadoop\yarn\server\resourcemanager\TestApplicationACLs.java,432,44,4,8,0,56
 hadoop-trunk\hadoop-trunk\hadoop-hdfs-project\hadoop-hdfs\src\test\java\org\apache\hadoop\hdfs\server\namenode\TestAddStripedBlocks.java,432,48,1,12,6,67
 pulsar-master\pulsar-master\pulsar-broker\src\test\java\org\apache\pulsar\broker\zookeeper\ClusterMetadataSetupTest.java,432,84,1,38,0,123
 hadoop-trunk\hadoop-trunk\hadoop-yarn-project\hadoop-yarn\hadoop-yarn-client\src\main\java\org\apache\hadoop\yarn\client\api\impl\NMClientImpl.java,433,74,5,6,8,93
 kafka-trunk\kafka-trunk\connect\runtime\src\main\java\org\apache\kafka\connect\runtime\isolation\Plugins.java,433,0,13,81,1,95
 pulsar-master\pulsar-master\pulsar-functions\utils\src\test\java\org\apache\pulsar\functions\utils\SinkConfigUtilsTest.java,433,125,11,79,0,215
 pulsar-master\pulsar-master\tests\integration\src\test\java\org\apache\pulsar\tests\integration\io\sources\AvroKafkaSourceTest.java,433,158,23,55,0,236
 skywalking-master\skywalking-master\oap-server\server-alarm-plugin\src\main\java\org\apache\skywalking\oap\server\core\alarm\provider\RunningRule.java,433,113,7,50,0,170
 hadoop-trunk\hadoop-trunk\hadoop-hdfs-project\hadoop-hdfs\src\test\java\org\apache\hadoop\hdfs\server\namenode\TestNameNodeReconfigure.java,434,55,3,20,2,80
 hadoop-trunk\hadoop-trunk\hadoop-mapreduce-project\hadoop-mapreduce-client\hadoop-mapreduce-client-hs\src\test\java\org\apache\hadoop\mapreduce\v2\hs\webapp\TestBlocks.java,434,74,9,9,35,127
 hadoop-trunk\hadoop-trunk\hadoop-hdfs-project\hadoop-hdfs\src\test\java\org\apache\hadoop\hdfs\server\namenode\startupprogress\TestStartupProgress.java,434,142,11,6,2,161
 hadoop-trunk\hadoop-trunk\hadoop-yarn-project\hadoop-yarn\hadoop-yarn-applications\hadoop-yarn-applications-distributedshell\src\test\java\org\apache\hadoop\yarn\applications\distributedshell\TestDSWithMultipleNodeManager.java,434,37,6,7,1,51
 hadoop-trunk\hadoop-trunk\hadoop-yarn-project\hadoop-yarn\hadoop-yarn-server\hadoop-yarn-server-timelineservice-hbase\hadoop-yarn-server-timelineservice-hbase-client\src\main\java\org\apache\hadoop\yarn\server\timelineservice\storage\reader\TimelineEntityReader.java,434,43,1,13,2,59
 dubbo-3.0\dubbo-3.0\dubbo-common\src\main\java\org\apache\dubbo\config\ServiceConfigBase.java,435,132,8,30,7,177
 hadoop-trunk\hadoop-trunk\hadoop-hdfs-project\hadoop-hdfs\src\test\java\org\apache\hadoop\hdfs\server\namenode\TestNNStorageRetentionManager.java,435,188,3,7,18,216
 rocketmq-develop\rocketmq-develop\broker\src\main\java\org\apache\rocketmq\broker\topic\TopicConfigManager.java,435,115,10,55,3,183
 hadoop-trunk\hadoop-trunk\hadoop-yarn-project\hadoop-yarn\hadoop-yarn-server\hadoop-yarn-server-timelineservice-hbase-tests\src\test\java\org\apache\hadoop\yarn\server\timelineservice\storage\flow\TestHBaseStorageFlowActivity.java,436,46,10,10,3,69
 hadoop-trunk\hadoop-trunk\hadoop-mapreduce-project\hadoop-mapreduce-client\hadoop-mapreduce-client-core\src\test\java\org\apache\hadoop\mapreduce\TestTaskID.java,436,9,27,1,3,40
 hadoop-trunk\hadoop-trunk\hadoop-hdfs-project\hadoop-hdfs\src\test\java\org\apache\hadoop\hdfs\server\namenode\ha\TestStandbyInProgressTail.java,436,72,18,4,3,97
 kafka-trunk\kafka-trunk\streams\src\main\java\org\apache\kafka\streams\processor\internals\assignment\ClientState.java,436,0,3,81,1,85
 pulsar-master\pulsar-master\tests\integration\src\test\java\org\apache\pulsar\tests\integration\functions\PulsarStateTest.java,436,90,2,36,0,128
 pulsar-master\pulsar-master\pulsar-broker\src\test\java\org\apache\pulsar\broker\admin\AdminApiTlsAuthTest.java,436,113,13,57,0,183
 hadoop-trunk\hadoop-trunk\hadoop-hdfs-project\hadoop-hdfs\src\test\java\org\apache\hadoop\hdfs\server\datanode\fsdataset\impl\FsDatasetImplTestUtils.java,437,76,13,3,10,102
 pulsar-master\pulsar-master\pulsar-client-1x-base\pulsar-client-1x\src\main\java\org\apache\pulsar\client\api\ProducerConfiguration.java,437,117,2,60,0,179
 hadoop-trunk\hadoop-trunk\hadoop-common-project\hadoop-common\src\main\java\org\apache\hadoop\fs\CommonConfigurationKeys.java,438,146,1,8,0,155
 hadoop-trunk\hadoop-trunk\hadoop-mapreduce-project\hadoop-mapreduce-examples\src\main\java\org\apache\hadoop\examples\dancing\Pentomino.java,438,206,19,1,6,232
 hadoop-trunk\hadoop-trunk\hadoop-mapreduce-project\hadoop-mapreduce-client\hadoop-mapreduce-client-core\src\main\java\org\apache\hadoop\mapred\join\Parser.java,438,146,26,6,2,180
 hadoop-trunk\hadoop-trunk\hadoop-mapreduce-project\hadoop-mapreduce-client\hadoop-mapreduce-client-jobclient\src\test\java\org\apache\hadoop\mapred\ReliabilityTest.java,438,145,31,6,10,192
 pulsar-master\pulsar-master\pulsar-package-management\bookkeeper-storage\src\test\java\org\apache\pulsar\packages\management\storage\bookkeeper\bookkeeper\test\BookKeeperClusterTestCase.java,438,118,5,40,0,163
 hadoop-trunk\hadoop-trunk\hadoop-common-project\hadoop-common\src\test\java\org\apache\hadoop\service\TestServiceLifecycle.java,439,51,20,3,3,77
 hadoop-trunk\hadoop-trunk\hadoop-hdfs-project\hadoop-hdfs\src\test\java\org\apache\hadoop\hdfs\server\namenode\TestClusterId.java,439,44,18,2,5,69
 hadoop-trunk\hadoop-trunk\hadoop-hdfs-project\hadoop-hdfs\src\test\java\org\apache\hadoop\hdfs\TestAppendSnapshotTruncate.java,439,146,9,4,14,173
 hadoop-trunk\hadoop-trunk\hadoop-common-project\hadoop-common\src\test\java\org\apache\hadoop\crypto\key\TestKeyProviderFactory.java,439,47,27,7,28,109
 kafka-trunk\kafka-trunk\streams\src\test\java\org\apache\kafka\streams\state\internals\RocksDBTimestampedStoreTest.java,439,0,11,97,77,185
 pulsar-master\pulsar-master\pulsar-testclient\src\main\java\org\apache\pulsar\testclient\BrokerMonitor.java,439,162,2,83,0,247
 pulsar-master\pulsar-master\pulsar-sql\presto-pulsar\src\test\java\org\apache\pulsar\sql\presto\TestPulsarRecordCursor.java,439,159,48,121,0,328
 shardingsphere-master\shardingsphere-master\shardingsphere-sql-parser\shardingsphere-sql-parser-dialect\shardingsphere-sql-parser-sql92\src\main\java\org\apache\shardingsphere\sql\parser\sql92\visitor\statement\impl\SQL92StatementSQLVisitor.java,439,125,3,143,0,271
 hadoop-trunk\hadoop-trunk\hadoop-mapreduce-project\hadoop-mapreduce-client\hadoop-mapreduce-client-jobclient\src\test\java\org\apache\hadoop\mapreduce\TestMapReduce.java,440,79,10,1,6,96
 hadoop-trunk\hadoop-trunk\hadoop-hdfs-project\hadoop-hdfs-rbf\src\test\java\org\apache\hadoop\hdfs\server\federation\router\TestRouterAdmin.java,440,29,2,18,0,49
 kafka-trunk\kafka-trunk\clients\src\generated\java\org\apache\kafka\common\message\UpdateFeaturesRequestData.java,440,0,0,37,6,43
 rocketmq-develop\rocketmq-develop\test\src\main\java\org\apache\rocketmq\test\util\StatUtil.java,440,144,10,22,0,176
 hadoop-trunk\hadoop-trunk\hadoop-hdfs-project\hadoop-hdfs\src\main\java\org\apache\hadoop\hdfs\server\datanode\DNConf.java,441,149,9,48,48,254
 hadoop-trunk\hadoop-trunk\hadoop-hdfs-project\hadoop-hdfs\src\test\java\org\apache\hadoop\fs\viewfs\TestViewFileSystemHdfs.java,441,51,10,4,0,65
 kafka-trunk\kafka-trunk\connect\api\src\test\java\org\apache\kafka\connect\data\SchemaProjectorTest.java,441,0,0,132,0,132
 kafka-trunk\kafka-trunk\connect\runtime\src\test\java\org\apache\kafka\connect\runtime\rest\resources\ConnectorPluginsResourceTest.java,441,0,3,84,12,99
 pulsar-master\pulsar-master\pulsar-transaction\coordinator\src\test\java\org\apache\pulsar\transaction\coordinator\MLTransactionMetadataStoreTest.java,441,193,22,153,0,368
 rocketmq-develop\rocketmq-develop\remoting\src\main\java\org\apache\rocketmq\remoting\netty\NettyRemotingServer.java,441,156,6,79,8,249
 hadoop-trunk\hadoop-trunk\hadoop-mapreduce-project\hadoop-mapreduce-client\hadoop-mapreduce-client-jobclient\src\test\java\org\apache\hadoop\mapred\TestComparators.java,442,226,38,1,6,271
 hadoop-trunk\hadoop-trunk\hadoop-yarn-project\hadoop-yarn\hadoop-yarn-server\hadoop-yarn-server-common\src\main\java\org\apache\hadoop\yarn\server\api\records\impl\pb\NodeStatusPBImpl.java,442,113,105,6,0,224
 hadoop-trunk\hadoop-trunk\hadoop-yarn-project\hadoop-yarn\hadoop-yarn-server\hadoop-yarn-server-resourcemanager\src\test\java\org\apache\hadoop\yarn\server\resourcemanager\logaggregationstatus\TestRMAppLogAggregationStatus.java,442,47,10,10,2,69
 hadoop-trunk\hadoop-trunk\hadoop-hdfs-project\hadoop-hdfs\src\test\java\org\apache\hadoop\hdfs\server\namenode\ha\TestConsistentReadsObserver.java,442,53,5,2,2,62
 hadoop-trunk\hadoop-trunk\hadoop-yarn-project\hadoop-yarn\hadoop-yarn-server\hadoop-yarn-server-common\src\main\java\org\apache\hadoop\yarn\server\scheduler\OpportunisticContainerAllocator.java,442,110,3,1,14,128
 pulsar-master\pulsar-master\pulsar-common\src\main\java\org\apache\pulsar\policies\data\loadbalancer\LoadReport.java,442,232,2,17,0,251
 zookeeper-master\zookeeper-master\zookeeper-server\src\test\java\org\apache\zookeeper\server\quorum\CommitProcessorTest.java,442,0,21,41,20,82
 hadoop-trunk\hadoop-trunk\hadoop-yarn-project\hadoop-yarn\hadoop-yarn-client\src\test\java\org\apache\hadoop\yarn\client\api\impl\TestYarnClientWithReservation.java,443,54,2,6,8,70
 hadoop-trunk\hadoop-trunk\hadoop-yarn-project\hadoop-yarn\hadoop-yarn-server\hadoop-yarn-server-resourcemanager\src\test\java\org\apache\hadoop\yarn\server\resourcemanager\security\TestClientToAMTokens.java,443,59,17,7,7,90
 hadoop-trunk\hadoop-trunk\hadoop-hdfs-project\hadoop-hdfs\src\main\java\org\apache\hadoop\hdfs\server\namenode\FSDirXAttrOp.java,443,57,9,6,2,74
 hadoop-trunk\hadoop-trunk\hadoop-hdfs-project\hadoop-hdfs\src\main\java\org\apache\hadoop\hdfs\server\namenode\metrics\NameNodeMetrics.java,443,295,0,1,1,297
 kafka-trunk\kafka-trunk\connect\runtime\src\main\java\org\apache\kafka\connect\runtime\WorkerConfig.java,443,0,0,149,0,149
 pulsar-master\pulsar-master\pulsar-client-tools\src\main\java\org\apache\pulsar\client\cli\CmdConsume.java,443,148,10,60,0,218
 pulsar-master\pulsar-master\pulsar-functions\instance\src\main\java\org\apache\pulsar\functions\instance\stats\FunctionStatsManager.java,443,199,2,45,0,246
 hadoop-trunk\hadoop-trunk\hadoop-hdfs-project\hadoop-hdfs\src\test\java\org\apache\hadoop\hdfs\TestDFSOutputStream.java,444,65,70,11,3,149
 hadoop-trunk\hadoop-trunk\hadoop-mapreduce-project\hadoop-mapreduce-client\hadoop-mapreduce-client-core\src\main\java\org\apache\hadoop\mapred\lib\MultipleOutputs.java,444,81,29,3,1,114
 kafka-trunk\kafka-trunk\trogdor\src\main\java\org\apache\kafka\trogdor\coordinator\CoordinatorClient.java,444,0,5,42,8,55
 pulsar-master\pulsar-master\pulsar-functions\worker\src\main\java\org\apache\pulsar\functions\worker\FunctionMetaDataManager.java,444,149,3,83,0,235
 dubbo-3.0\dubbo-3.0\dubbo-metadata\dubbo-metadata-api\src\main\java\org\apache\dubbo\metadata\report\support\AbstractMetadataReport.java,445,170,13,80,0,263
 hadoop-trunk\hadoop-trunk\hadoop-yarn-project\hadoop-yarn\hadoop-yarn-server\hadoop-yarn-server-nodemanager\src\test\java\org\apache\hadoop\yarn\server\nodemanager\containermanager\BaseContainerManagerTest.java,445,207,18,11,17,253
 hadoop-trunk\hadoop-trunk\hadoop-mapreduce-project\hadoop-mapreduce-client\hadoop-mapreduce-client-jobclient\src\test\java\org\apache\hadoop\mapreduce\TestMRIntermediateDataEncryption.java,445,58,9,1,1,69
 hadoop-trunk\hadoop-trunk\hadoop-tools\hadoop-azure\src\test\java\org\apache\hadoop\fs\azurebfs\TestAccountConfiguration.java,446,66,22,45,1,134
 hadoop-trunk\hadoop-trunk\hadoop-common-project\hadoop-common\src\test\java\org\apache\hadoop\io\compress\snappy\TestSnappyCompressorDecompressor.java,446,120,21,7,9,157
 hadoop-trunk\hadoop-trunk\hadoop-yarn-project\hadoop-yarn\hadoop-yarn-server\hadoop-yarn-server-nodemanager\src\main\java\org\apache\hadoop\yarn\server\nodemanager\containermanager\localizer\ContainerLocalizer.java,446,114,12,11,3,140
 hadoop-trunk\hadoop-trunk\hadoop-yarn-project\hadoop-yarn\hadoop-yarn-server\hadoop-yarn-server-common\src\test\java\org\apache\hadoop\yarn\TestYarnServerApiClasses.java,446,73,34,13,0,120
 hadoop-trunk\hadoop-trunk\hadoop-common-project\hadoop-common\src\test\java\org\apache\hadoop\io\TestText.java,446,161,19,3,8,191
 kafka-trunk\kafka-trunk\connect\mirror\src\main\java\org\apache\kafka\connect\mirror\MirrorSourceConnector.java,446,0,9,85,0,94
 kafka-trunk\kafka-trunk\connect\runtime\src\main\java\org\apache\kafka\connect\runtime\standalone\StandaloneHerder.java,446,0,14,69,0,83
 kafka-trunk\kafka-trunk\streams\src\main\java\org\apache\kafka\streams\state\internals\metrics\StateStoreMetrics.java,446,0,1,70,0,71
 hadoop-trunk\hadoop-trunk\hadoop-yarn-project\hadoop-yarn\hadoop-yarn-server\hadoop-yarn-server-applicationhistoryservice\src\main\java\org\apache\hadoop\yarn\server\timeline\TimelineDataManager.java,447,123,3,2,3,131
 hadoop-trunk\hadoop-trunk\hadoop-hdfs-project\hadoop-hdfs-rbf\src\main\java\org\apache\hadoop\hdfs\server\federation\router\ConnectionManager.java,447,15,7,1,1,24
 hadoop-trunk\hadoop-trunk\hadoop-yarn-project\hadoop-yarn\hadoop-yarn-server\hadoop-yarn-server-common\src\main\java\org\apache\hadoop\yarn\server\utils\BuilderUtils.java,447,278,4,2,0,284
 hadoop-trunk\hadoop-trunk\hadoop-tools\hadoop-azure\src\test\java\org\apache\hadoop\fs\azurebfs\AbstractAbfsIntegrationTest.java,447,116,10,34,6,166
 kafka-trunk\kafka-trunk\metadata\src\generated\java\org\apache\kafka\common\metadata\ClientQuotaRecord.java,447,0,0,41,10,51
 kafka-trunk\kafka-trunk\connect\runtime\src\test\java\org\apache\kafka\connect\runtime\ConnectorConfigTest.java,447,0,10,56,1,67
 hadoop-trunk\hadoop-trunk\hadoop-common-project\hadoop-common\src\main\java\org\apache\hadoop\fs\Globber.java,448,76,7,2,1,86
 hadoop-trunk\hadoop-trunk\hadoop-hdfs-project\hadoop-hdfs-client\src\main\java\org\apache\hadoop\hdfs\shortcircuit\DfsClientShmManager.java,448,64,26,6,4,100
 hadoop-trunk\hadoop-trunk\hadoop-yarn-project\hadoop-yarn\hadoop-yarn-server\hadoop-yarn-server-applicationhistoryservice\src\test\java\org\apache\hadoop\yarn\server\timeline\TestLeveldbTimelineStore.java,448,76,15,7,4,102
 pulsar-master\pulsar-master\pulsar-broker\src\test\java\org\apache\pulsar\client\impl\MessageChunkingTest.java,448,132,12,60,0,204
 pulsar-master\pulsar-master\pulsar-client\src\main\java\org\apache\pulsar\client\impl\PartitionedProducerImpl.java,448,125,7,76,0,208
 pulsar-master\pulsar-master\pulsar-functions\runtime\src\test\java\org\apache\pulsar\functions\runtime\kubernetes\KubernetesRuntimeFactoryTest.java,448,296,20,121,0,437
 hadoop-trunk\hadoop-trunk\hadoop-hdfs-project\hadoop-hdfs-client\src\main\java\org\apache\hadoop\hdfs\client\impl\LeaseRenewer.java,449,84,8,2,1,95
 hadoop-trunk\hadoop-trunk\hadoop-tools\hadoop-distcp\src\main\java\org\apache\hadoop\tools\DistCp.java,449,50,12,4,10,76
 hadoop-trunk\hadoop-trunk\hadoop-common-project\hadoop-common\src\test\java\org\apache\hadoop\security\authorize\TestAccessControlList.java,449,52,8,1,3,64
 kafka-trunk\kafka-trunk\clients\src\generated\java\org\apache\kafka\common\message\CreateDelegationTokenResponseData.java,449,0,0,49,6,55
 kafka-trunk\kafka-trunk\clients\src\generated\java\org\apache\kafka\common\message\FetchResponseDataJsonConverter.java,449,0,0,95,0,95
 rocketmq-develop\rocketmq-develop\client\src\test\java\org\apache\rocketmq\client\producer\DefaultMQProducerTest.java,449,148,20,51,17,236
 dubbo-3.0\dubbo-3.0\dubbo-registry\dubbo-registry-api\src\test\java\org\apache\dubbo\registry\client\event\listener\ServiceInstancesChangedListenerTest.java,450,221,46,110,0,377
 hadoop-trunk\hadoop-trunk\hadoop-common-project\hadoop-common\src\main\java\org\apache\hadoop\service\AbstractService.java,450,42,7,2,5,56
 hadoop-trunk\hadoop-trunk\hadoop-common-project\hadoop-common\src\test\java\org\apache\hadoop\security\TestSecurityUtil.java,450,165,20,11,3,199
 hadoop-trunk\hadoop-trunk\hadoop-yarn-project\hadoop-yarn\hadoop-yarn-server\hadoop-yarn-server-nodemanager\src\main\java\org\apache\hadoop\yarn\server\nodemanager\metrics\NodeManagerMetrics.java,450,255,1,1,1,258
 kafka-trunk\kafka-trunk\connect\transforms\src\main\java\org\apache\kafka\connect\transforms\TimestampConverter.java,450,0,8,70,0,78
 rocketmq-develop\rocketmq-develop\client\src\main\java\org\apache\rocketmq\client\impl\consumer\RebalanceImpl.java,450,154,17,63,8,242
 hadoop-trunk\hadoop-trunk\hadoop-yarn-project\hadoop-yarn\hadoop-yarn-server\hadoop-yarn-server-resourcemanager\src\test\java\org\apache\hadoop\yarn\server\resourcemanager\scheduler\fair\converter\TestQueuePlacementConverter.java,451,48,0,14,3,65
 hadoop-trunk\hadoop-trunk\hadoop-common-project\hadoop-common\src\main\java\org\apache\hadoop\io\compress\zlib\ZlibCompressor.java,451,155,14,3,1,173
 hadoop-trunk\hadoop-trunk\hadoop-yarn-project\hadoop-yarn\hadoop-yarn-server\hadoop-yarn-server-common\src\test\java\org\apache\hadoop\yarn\server\metrics\TestAMRMClientRelayerMetrics.java,451,78,10,7,9,104
 hadoop-trunk\hadoop-trunk\hadoop-yarn-project\hadoop-yarn\hadoop-yarn-server\hadoop-yarn-server-sharedcachemanager\src\main\java\org\apache\hadoop\yarn\server\sharedcachemanager\store\InMemorySCMStore.java,451,57,12,5,0,74
 hadoop-trunk\hadoop-trunk\hadoop-yarn-project\hadoop-yarn\hadoop-yarn-server\hadoop-yarn-server-resourcemanager\src\test\java\org\apache\hadoop\yarn\server\resourcemanager\scheduler\fair\TestSchedulingPolicy.java,451,64,10,4,6,84
 kafka-trunk\kafka-trunk\clients\src\generated\java\org\apache\kafka\common\message\DescribeAclsRequestData.java,451,0,0,42,4,46
 pulsar-master\pulsar-master\pulsar-broker\src\test\java\org\apache\pulsar\broker\service\schema\KeyValueSchemaCompatibilityCheckTest.java,451,247,0,212,0,459
 hadoop-trunk\hadoop-trunk\hadoop-common-project\hadoop-registry\src\main\java\org\apache\hadoop\registry\server\services\RegistryAdminService.java,452,55,7,4,2,68
 hadoop-trunk\hadoop-trunk\hadoop-hdfs-project\hadoop-hdfs\src\main\java\org\apache\hadoop\hdfs\server\namenode\ha\StandbyCheckpointer.java,452,95,8,16,2,121
 hadoop-trunk\hadoop-trunk\hadoop-tools\hadoop-sls\src\main\java\org\apache\hadoop\yarn\sls\SLSRunner.java,452,132,17,14,4,167
 kafka-trunk\kafka-trunk\clients\src\generated\java\org\apache\kafka\common\message\CreateAclsResponseData.java,452,0,0,42,6,48
 kafka-trunk\kafka-trunk\clients\src\main\java\org\apache\kafka\common\requests\MetadataResponse.java,452,0,94,51,3,148
 pulsar-master\pulsar-master\pulsar-client-tools\src\main\java\org\apache\pulsar\client\cli\CmdProduce.java,452,147,15,58,0,220
 skywalking-master\skywalking-master\oap-server\analyzer\meter-analyzer\src\test\java\org\apache\skywalking\oap\meter\analyzer\dsl\ArithmeticTest.java,452,166,1,67,0,234
 hadoop-trunk\hadoop-trunk\hadoop-mapreduce-project\hadoop-mapreduce-client\hadoop-mapreduce-client-core\src\main\java\org\apache\hadoop\mapred\pipes\Submitter.java,453,113,14,7,0,134
 hadoop-trunk\hadoop-trunk\hadoop-hdfs-project\hadoop-hdfs\src\test\java\org\apache\hadoop\hdfs\server\namenode\snapshot\TestFSImageWithOrderedSnapshotDeletion.java,453,64,3,2,1,70
 kafka-trunk\kafka-trunk\connect\runtime\src\main\java\org\apache\kafka\connect\runtime\distributed\DistributedConfig.java,453,0,6,94,1,101
 kafka-trunk\kafka-trunk\streams\src\test\java\org\apache\kafka\streams\kstream\internals\KTableFilterTest.java,453,0,8,82,0,90
 pulsar-master\pulsar-master\pulsar-broker\src\test\java\org\apache\pulsar\io\PulsarSinkE2ETest.java,453,144,2,100,0,246
 pulsar-master\pulsar-master\pulsar-functions\runtime\src\main\java\org\apache\pulsar\functions\runtime\RuntimeUtils.java,453,171,7,95,0,273
 rocketmq-develop\rocketmq-develop\broker\src\main\java\org\apache\rocketmq\broker\transaction\queue\TransactionalMessageServiceImpl.java,453,143,22,81,3,249
 hadoop-trunk\hadoop-trunk\hadoop-yarn-project\hadoop-yarn\hadoop-yarn-server\hadoop-yarn-server-resourcemanager\src\main\java\org\apache\hadoop\yarn\server\resourcemanager\scheduler\fair\converter\FSConfigToCSConfigConverter.java,454,81,2,15,2,100
 kafka-trunk\kafka-trunk\connect\api\src\main\java\org\apache\kafka\connect\header\ConnectHeaders.java,454,0,24,16,0,40
 kafka-trunk\kafka-trunk\streams\src\main\java\org\apache\kafka\streams\processor\internals\assignment\AssignmentInfo.java,454,0,3,74,8,85
 pulsar-master\pulsar-master\tests\integration\src\test\java\org\apache\pulsar\tests\integration\cli\SchemaUpdateStrategyTest.java,454,185,12,101,0,298
 hadoop-trunk\hadoop-trunk\hadoop-common-project\hadoop-common\src\main\java\org\apache\hadoop\fs\ContentSummary.java,455,175,4,1,2,182
 hadoop-trunk\hadoop-trunk\hadoop-mapreduce-project\hadoop-mapreduce-client\hadoop-mapreduce-client-core\src\test\java\org\apache\hadoop\mapreduce\lib\input\TestFileInputFormat.java,455,112,22,11,2,147
 hadoop-trunk\hadoop-trunk\hadoop-mapreduce-project\hadoop-mapreduce-client\hadoop-mapreduce-client-core\src\test\java\org\apache\hadoop\mapreduce\lib\output\TestPathOutputCommitterFactory.java,455,45,5,4,0,54
 hadoop-trunk\hadoop-trunk\hadoop-yarn-project\hadoop-yarn\hadoop-yarn-common\src\main\java\org\apache\hadoop\yarn\api\protocolrecords\impl\pb\AllocateRequestPBImpl.java,455,84,104,7,0,195
 hadoop-trunk\hadoop-trunk\hadoop-common-project\hadoop-common\src\test\java\org\apache\hadoop\security\token\delegation\TestZKDelegationTokenSecretManager.java,455,62,15,11,0,88
 pulsar-master\pulsar-master\pulsar-broker\src\main\java\org\apache\pulsar\broker\service\persistent\MessageDeduplication.java,455,153,14,75,0,242
 pulsar-master\pulsar-master\pulsar-broker\src\test\java\org\apache\pulsar\broker\service\PersistentQueueE2ETest.java,455,86,19,54,0,159
 zookeeper-master\zookeeper-master\zookeeper-server\src\main\java\org\apache\zookeeper\server\Request.java,455,0,34,9,0,43
 dubbo-3.0\dubbo-3.0\dubbo-remoting\dubbo-remoting-api\src\main\java\org\apache\dubbo\remoting\exchange\codec\ExchangeCodec.java,456,172,14,50,0,236
 dubbo-3.0\dubbo-3.0\dubbo-common\src\test\java\org\apache\dubbo\common\utils\StringUtilsTest.java,456,80,0,28,2,110
 hadoop-trunk\hadoop-trunk\hadoop-yarn-project\hadoop-yarn\hadoop-yarn-server\hadoop-yarn-server-nodemanager\src\test\java\org\apache\hadoop\yarn\server\nodemanager\containermanager\resourceplugin\TestResourcePluginManager.java,456,61,9,12,3,85
 hadoop-trunk\hadoop-trunk\hadoop-tools\hadoop-extras\src\main\java\org\apache\hadoop\tools\DistCh.java,456,143,29,3,3,178
 kafka-trunk\kafka-trunk\streams\src\main\java\org\apache\kafka\streams\state\internals\metrics\RocksDBMetricsRecorder.java,456,0,0,133,3,136
 hadoop-trunk\hadoop-trunk\hadoop-common-project\hadoop-common\src\test\java\org\apache\hadoop\io\file\tfile\TestTFileSeek.java,457,143,74,2,14,233
 hadoop-trunk\hadoop-trunk\hadoop-common-project\hadoop-common\src\test\java\org\apache\hadoop\crypto\TestCryptoStreams.java,457,118,13,2,2,135
 hadoop-trunk\hadoop-trunk\hadoop-yarn-project\hadoop-yarn\hadoop-yarn-server\hadoop-yarn-server-resourcemanager\src\main\java\org\apache\hadoop\yarn\server\resourcemanager\ApplicationMasterService.java,457,88,14,18,7,127
 hadoop-trunk\hadoop-trunk\hadoop-tools\hadoop-azure\src\test\java\org\apache\hadoop\fs\azurebfs\ITestSmallWriteOptimization.java,458,142,6,22,3,173
 hadoop-trunk\hadoop-trunk\hadoop-yarn-project\hadoop-yarn\hadoop-yarn-server\hadoop-yarn-server-resourcemanager\src\test\java\org\apache\hadoop\yarn\server\resourcemanager\scheduler\fair\policies\TestDominantResourceFairnessPolicy.java,458,210,14,5,2,231
 hadoop-trunk\hadoop-trunk\hadoop-common-project\hadoop-common\src\test\java\org\apache\hadoop\http\TestSSLHttpServer.java,458,93,6,1,12,112
 kafka-trunk\kafka-trunk\clients\src\test\java\org\apache\kafka\common\record\DefaultRecordTest.java,458,0,6,52,20,78
 kafka-trunk\kafka-trunk\connect\runtime\src\main\java\org\apache\kafka\connect\runtime\isolation\DelegatingClassLoader.java,458,0,5,56,1,62
 kafka-trunk\kafka-trunk\clients\src\generated\java\org\apache\kafka\common\message\ConsumerProtocolAssignment.java,458,0,0,38,11,49
 kafka-trunk\kafka-trunk\core\src\generated\java\kafka\internals\generated\TransactionLogValue.java,458,0,0,47,9,56
 dubbo-3.0\dubbo-3.0\dubbo-common\src\main\java\org\apache\dubbo\config\MethodConfig.java,459,182,4,33,3,222
 hadoop-trunk\hadoop-trunk\hadoop-mapreduce-project\hadoop-mapreduce-client\hadoop-mapreduce-client-app\src\main\java\org\apache\hadoop\mapreduce\v2\app\webapp\AMWebServices.java,459,112,13,10,6,141
 hadoop-trunk\hadoop-trunk\hadoop-mapreduce-project\hadoop-mapreduce-client\hadoop-mapreduce-client-hs\src\main\java\org\apache\hadoop\mapreduce\v2\hs\webapp\HsWebServices.java,459,135,7,7,2,151
 hadoop-trunk\hadoop-trunk\hadoop-yarn-project\hadoop-yarn\hadoop-yarn-server\hadoop-yarn-server-resourcemanager\src\main\java\org\apache\hadoop\yarn\server\resourcemanager\scheduler\ClusterNodeTracker.java,459,70,11,1,2,84
 kafka-trunk\kafka-trunk\storage\src\generated\java\org\apache\kafka\server\log\remote\metadata\storage\generated\RemoteLogSegmentMetadataSnapshotRecord.java,459,0,0,43,6,49
 pulsar-master\pulsar-master\managed-ledger\src\test\java\org\apache\bookkeeper\test\BookKeeperClusterTestCase.java,459,134,5,43,0,182
 zookeeper-master\zookeeper-master\zookeeper-server\src\test\java\org\apache\zookeeper\test\FLETest.java,459,0,33,28,2,63
 dubbo-3.0\dubbo-3.0\dubbo-rpc\dubbo-rpc-dubbo\src\test\java\org\apache\dubbo\rpc\protocol\dubbo\decode\DubboTelnetDecodeTest.java,460,93,1,42,0,136
 hadoop-trunk\hadoop-trunk\hadoop-hdfs-project\hadoop-hdfs\src\main\java\org\apache\hadoop\hdfs\qjournal\server\JournalNodeSyncer.java,462,68,30,3,1,102
 kafka-trunk\kafka-trunk\streams\src\test\java\org\apache\kafka\streams\kstream\internals\KStreamSessionWindowAggregateProcessorTest.java,462,0,9,48,10,67
 kafka-trunk\kafka-trunk\clients\src\generated\java\org\apache\kafka\common\message\StopReplicaResponseData.java,462,0,0,51,6,57
 kafka-trunk\kafka-trunk\clients\src\generated\java\org\apache\kafka\common\message\UpdateMetadataRequestDataJsonConverter.java,462,0,0,111,0,111
 kafka-trunk\kafka-trunk\streams\src\test\java\org\apache\kafka\streams\integration\SuppressionIntegrationTest.java,462,0,1,77,0,78
 pulsar-master\pulsar-master\pulsar-broker\src\test\java\org\apache\pulsar\client\impl\PerMessageUnAcknowledgedRedeliveryTest.java,462,99,47,30,0,176
 hadoop-trunk\hadoop-trunk\hadoop-mapreduce-project\hadoop-mapreduce-client\hadoop-mapreduce-client-app\src\test\java\org\apache\hadoop\mapreduce\v2\app\launcher\TestContainerLauncherImpl.java,463,164,9,19,1,193
 hadoop-trunk\hadoop-trunk\hadoop-hdfs-project\hadoop-hdfs\src\main\java\org\apache\hadoop\hdfs\tools\DiskBalancerCLI.java,463,40,44,1,2,87
 hadoop-trunk\hadoop-trunk\hadoop-hdfs-project\hadoop-hdfs\src\test\java\org\apache\hadoop\hdfs\util\TestLightWeightHashSet.java,463,55,9,2,2,68
 kafka-trunk\kafka-trunk\streams\src\test\java\org\apache\kafka\streams\kstream\internals\graph\StreamsGraphTest.java,463,0,6,164,6,176
 pulsar-master\pulsar-master\pulsar-common\src\test\java\org\apache\pulsar\common\util\collections\ConcurrentLongPairSetTest.java,464,134,8,11,0,153
 hadoop-trunk\hadoop-trunk\hadoop-common-project\hadoop-auth\src\main\java\org\apache\hadoop\security\authentication\util\KerberosName.java,465,74,0,2,1,77
 hadoop-trunk\hadoop-trunk\hadoop-hdfs-project\hadoop-hdfs\src\test\java\org\apache\hadoop\hdfs\TestHFlush.java,465,123,19,24,4,170
 hadoop-trunk\hadoop-trunk\hadoop-hdfs-project\hadoop-hdfs\src\test\java\org\apache\hadoop\fs\permission\TestStickyBit.java,465,90,38,4,2,134
 hadoop-trunk\hadoop-trunk\hadoop-tools\hadoop-aws\src\main\java\org\apache\hadoop\fs\s3a\impl\CopyFromLocalOperation.java,465,40,1,8,1,50
 kafka-trunk\kafka-trunk\tools\src\main\java\org\apache\kafka\tools\ClientCompatibilityTest.java,465,0,18,64,3,85
 hadoop-trunk\hadoop-trunk\hadoop-yarn-project\hadoop-yarn\hadoop-yarn-server\hadoop-yarn-server-resourcemanager\src\main\java\org\apache\hadoop\yarn\server\resourcemanager\metrics\TimelineServiceV2Publisher.java,466,66,12,6,2,86
 hadoop-trunk\hadoop-trunk\hadoop-hdfs-project\hadoop-hdfs\src\test\java\org\apache\hadoop\hdfs\server\namenode\TestFileJournalManager.java,466,170,10,10,6,196
 hadoop-trunk\hadoop-trunk\hadoop-yarn-project\hadoop-yarn\hadoop-yarn-server\hadoop-yarn-server-resourcemanager\src\main\java\org\apache\hadoop\yarn\server\resourcemanager\scheduler\fair\policies\DominantResourceFairnessPolicy.java,467,69,1,4,5,79
 hadoop-trunk\hadoop-trunk\hadoop-yarn-project\hadoop-yarn\hadoop-yarn-applications\hadoop-yarn-services\hadoop-yarn-services-core\src\main\java\org\apache\hadoop\yarn\service\ServiceManager.java,467,62,16,2,2,82
 pulsar-master\pulsar-master\pulsar-broker\src\test\java\org\apache\pulsar\broker\service\persistent\TopicDuplicationTest.java,467,173,5,101,0,279
 skywalking-master\skywalking-master\oap-server\oal-rt\src\main\java\org\apache\skywalking\oal\rt\OALRuntime.java,467,140,22,80,0,242
 zookeeper-master\zookeeper-master\zookeeper-server\src\test\java\org\apache\zookeeper\server\quorum\CommitProcessorMetricsTest.java,467,0,5,45,12,62
 dubbo-3.0\dubbo-3.0\dubbo-registry\dubbo-registry-api\src\test\java\org\apache\dubbo\registry\integration\RegistryProtocolTest.java,468,114,31,100,0,245
 hadoop-trunk\hadoop-trunk\hadoop-yarn-project\hadoop-yarn\hadoop-yarn-server\hadoop-yarn-server-common\src\main\java\org\apache\hadoop\yarn\server\uam\UnmanagedApplicationManager.java,469,57,5,6,5,73
 hadoop-trunk\hadoop-trunk\hadoop-mapreduce-project\hadoop-mapreduce-client\hadoop-mapreduce-client-hs\src\test\java\org\apache\hadoop\mapreduce\v2\hs\TestJobHistory.java,469,99,6,4,4,113
 hadoop-trunk\hadoop-trunk\hadoop-hdfs-project\hadoop-hdfs\src\test\java\org\apache\hadoop\hdfs\qjournal\client\TestQJMWithFaults.java,469,150,22,9,3,184
 hadoop-trunk\hadoop-trunk\hadoop-hdfs-project\hadoop-hdfs\src\test\java\org\apache\hadoop\hdfs\server\diskbalancer\TestPlanner.java,469,83,14,3,1,101
 hadoop-trunk\hadoop-trunk\hadoop-mapreduce-project\hadoop-mapreduce-client\hadoop-mapreduce-client-jobclient\src\main\java\org\apache\hadoop\mapred\ClientServiceDelegate.java,469,112,34,34,12,192
 hadoop-trunk\hadoop-trunk\hadoop-hdfs-project\hadoop-hdfs\src\test\java\org\apache\hadoop\hdfs\TestGetBlocks.java,470,66,9,4,2,81
 hadoop-trunk\hadoop-trunk\hadoop-tools\hadoop-azure\src\main\java\org\apache\hadoop\fs\azurebfs\services\SharedKeyCredentials.java,470,66,5,51,0,122
 hadoop-trunk\hadoop-trunk\hadoop-common-project\hadoop-common\src\main\java\org\apache\hadoop\ipc\ProtobufRpcEngine.java,470,163,23,2,0,188
 hadoop-trunk\hadoop-trunk\hadoop-yarn-project\hadoop-yarn\hadoop-yarn-client\src\test\java\org\apache\hadoop\yarn\client\cli\TestNodeAttributesCLI.java,470,25,43,6,8,82
 dubbo-3.0\dubbo-3.0\dubbo-config\dubbo-config-api\src\test\java\org\apache\dubbo\config\ServiceConfigTest.java,471,74,23,26,0,123
 hadoop-trunk\hadoop-trunk\hadoop-yarn-project\hadoop-yarn\hadoop-yarn-server\hadoop-yarn-server-resourcemanager\src\test\java\org\apache\hadoop\yarn\server\resourcemanager\scheduler\placement\TestSingleConstraintAppPlacementAllocator.java,471,72,13,11,0,96
 kafka-trunk\kafka-trunk\clients\src\generated\java\org\apache\kafka\common\message\DescribeDelegationTokenRequestData.java,471,0,0,56,7,63
 hadoop-trunk\hadoop-trunk\hadoop-hdfs-project\hadoop-hdfs\src\main\java\org\apache\hadoop\hdfs\server\namenode\FSDirAttrOp.java,472,105,14,3,4,126
 kafka-trunk\kafka-trunk\trogdor\src\main\java\org\apache\kafka\trogdor\workload\SustainedConnectionWorker.java,472,0,5,79,1,85
 pulsar-master\pulsar-master\tests\integration\src\test\java\org\apache\pulsar\tests\integration\cli\CLITest.java,472,48,6,27,0,81
 pulsar-master\pulsar-master\pulsar-client\src\main\java\org\apache\pulsar\client\impl\ConsumerBuilderImpl.java,472,219,6,89,0,314
 pulsar-master\pulsar-master\pulsar-broker\src\main\java\org\apache\pulsar\broker\service\nonpersistent\NonPersistentSubscription.java,472,137,4,58,0,199
 pulsar-master\pulsar-master\pulsar-broker\src\test\java\org\apache\pulsar\broker\service\PersistentFailoverE2ETest.java,472,95,31,53,0,179
 hadoop-trunk\hadoop-trunk\hadoop-hdfs-project\hadoop-hdfs\src\test\java\org\apache\hadoop\hdfs\net\TestDFSNetworkTopologyPerformance.java,473,82,4,1,2,89
 hadoop-trunk\hadoop-trunk\hadoop-common-project\hadoop-common\src\test\java\org\apache\hadoop\crypto\key\TestKeyProviderCryptoExtension.java,473,89,17,2,2,110
 hadoop-trunk\hadoop-trunk\hadoop-tools\hadoop-aws\src\test\java\org\apache\hadoop\fs\s3a\performance\AbstractS3ACostTest.java,473,59,6,3,3,71
 kafka-trunk\kafka-trunk\clients\src\generated\java\org\apache\kafka\common\message\CreateDelegationTokenRequestData.java,473,0,0,57,7,64
 zookeeper-master\zookeeper-master\zookeeper-server\src\test\java\org\apache\zookeeper\test\ObserverMasterTest.java,473,0,34,78,8,120
 hadoop-trunk\hadoop-trunk\hadoop-tools\hadoop-streaming\src\main\java\org\apache\hadoop\typedbytes\TypedBytesInput.java,474,65,37,1,2,105
 pulsar-master\pulsar-master\tiered-storage\jcloud\src\test\java\org\apache\bookkeeper\mledger\offload\jcloud\impl\BlobStoreManagedLedgerOffloaderTest.java,474,154,26,100,0,280
 hadoop-trunk\hadoop-trunk\hadoop-tools\hadoop-aws\src\test\java\org\apache\hadoop\fs\s3a\commit\integration\ITestS3ACommitterMRJob.java,475,34,11,5,4,54
 hadoop-trunk\hadoop-trunk\hadoop-mapreduce-project\hadoop-mapreduce-client\hadoop-mapreduce-client-uploader\src\test\java\org\apache\hadoop\mapred\uploader\TestFrameworkUploader.java,475,23,3,2,6,34
 hadoop-trunk\hadoop-trunk\hadoop-yarn-project\hadoop-yarn\hadoop-yarn-server\hadoop-yarn-server-resourcemanager\src\test\java\org\apache\hadoop\yarn\server\resourcemanager\scheduler\capacity\TestIncreaseAllocationExpirer.java,475,84,5,7,1,97
 hadoop-trunk\hadoop-trunk\hadoop-hdfs-project\hadoop-hdfs\src\test\java\org\apache\hadoop\hdfs\web\TestWebHdfsUrl.java,475,61,12,7,0,80
 hadoop-trunk\hadoop-trunk\hadoop-yarn-project\hadoop-yarn\hadoop-yarn-common\src\main\java\org\apache\hadoop\yarn\webapp\WebApps.java,475,177,25,4,5,211
 hadoop-trunk\hadoop-trunk\hadoop-yarn-project\hadoop-yarn\hadoop-yarn-server\hadoop-yarn-server-resourcemanager\src\test\java\org\apache\hadoop\yarn\server\resourcemanager\scheduler\capacity\TestCapacitySchedulerQueueMappingFactory.java,476,25,6,9,0,40
 kafka-trunk\kafka-trunk\storage\src\test\java\org\apache\kafka\server\log\remote\metadata\storage\RemoteLogSegmentLifecycleTest.java,476,0,0,177,0,177
 kafka-trunk\kafka-trunk\storage\src\main\java\org\apache\kafka\server\log\remote\metadata\storage\TopicBasedRemoteLogMetadataManager.java,476,0,11,95,1,107
 hadoop-trunk\hadoop-trunk\hadoop-tools\hadoop-aws\src\main\java\org\apache\hadoop\fs\s3a\impl\ChangeDetectionPolicy.java,477,65,8,2,0,75
 kafka-trunk\kafka-trunk\streams\src\test\java\org\apache\kafka\streams\state\internals\CompositeReadOnlyKeyValueStoreTest.java,477,0,13,52,31,96
 hadoop-trunk\hadoop-trunk\hadoop-tools\hadoop-aws\src\main\java\org\apache\hadoop\fs\s3a\impl\HeaderProcessing.java,478,13,0,3,1,17
 hadoop-trunk\hadoop-trunk\hadoop-hdfs-project\hadoop-hdfs\src\test\java\org\apache\hadoop\hdfs\TestWriteRead.java,478,133,37,13,5,188
 kafka-trunk\kafka-trunk\clients\src\generated\java\org\apache\kafka\common\message\ListTransactionsResponseData.java,478,0,0,62,9,71
 kafka-trunk\kafka-trunk\streams\src\test\java\org\apache\kafka\streams\processor\internals\ActiveTaskCreatorTest.java,478,0,0,65,1,66
 pulsar-master\pulsar-master\pulsar-functions\utils\src\main\java\org\apache\pulsar\functions\utils\FunctionCommon.java,478,184,13,84,0,281
 hadoop-trunk\hadoop-trunk\hadoop-common-project\hadoop-common\src\test\java\org\apache\hadoop\io\compress\zstd\TestZStandardCompressorDecompressor.java,479,84,6,4,2,96
 hadoop-trunk\hadoop-trunk\hadoop-tools\hadoop-azure\src\test\java\org\apache\hadoop\fs\azure\ITestPageBlobInputStream.java,479,71,13,2,3,89
 hadoop-trunk\hadoop-trunk\hadoop-common-project\hadoop-common\src\test\java\org\apache\hadoop\ipc\TestCallQueueManager.java,479,137,11,7,11,166
 pulsar-master\pulsar-master\pulsar-broker\src\main\java\org\apache\pulsar\broker\admin\v2\NonPersistentTopics.java,479,233,31,110,0,374
 pulsar-master\pulsar-master\pulsar-broker\src\main\java\org\apache\pulsar\broker\admin\impl\SourcesBase.java,479,249,47,142,0,438
 pulsar-master\pulsar-master\pulsar-client\src\test\java\org\apache\pulsar\client\impl\schema\SchemaBuilderTest.java,479,170,5,93,0,268
 zookeeper-master\zookeeper-master\zookeeper-server\src\main\java\org\apache\zookeeper\server\quorum\ObserverMaster.java,479,0,37,48,0,85
 hadoop-trunk\hadoop-trunk\hadoop-mapreduce-project\hadoop-mapreduce-client\hadoop-mapreduce-client-common\src\test\java\org\apache\hadoop\mapreduce\v2\jobhistory\TestFileNameIndexUtils.java,480,61,0,1,0,62
 hadoop-trunk\hadoop-trunk\hadoop-hdfs-project\hadoop-hdfs-rbf\src\main\java\org\apache\hadoop\hdfs\server\federation\router\RouterWebHdfsMethods.java,480,46,13,3,1,63
 hadoop-trunk\hadoop-trunk\hadoop-yarn-project\hadoop-yarn\hadoop-yarn-api\src\main\java\org\apache\hadoop\yarn\api\records\Resource.java,480,57,6,2,1,66
 hadoop-trunk\hadoop-trunk\hadoop-hdfs-project\hadoop-hdfs\src\test\java\org\apache\hadoop\hdfs\qjournal\server\TestJournal.java,480,170,35,5,0,210
 hadoop-trunk\hadoop-trunk\hadoop-hdfs-project\hadoop-hdfs\src\test\java\org\apache\hadoop\hdfs\TestEncryptedTransfer.java,481,89,5,6,2,102
 hadoop-trunk\hadoop-trunk\hadoop-yarn-project\hadoop-yarn\hadoop-yarn-server\hadoop-yarn-server-nodemanager\src\test\java\org\apache\hadoop\yarn\server\nodemanager\webapp\TestNMWebServicesContainers.java,481,70,13,8,0,91
 kafka-trunk\kafka-trunk\streams\src\test\java\org\apache\kafka\streams\state\internals\WindowKeySchemaTest.java,481,0,6,123,8,137
 pulsar-master\pulsar-master\pulsar-broker\src\main\java\org\apache\pulsar\broker\service\schema\SchemaRegistryServiceImpl.java,481,172,11,101,0,284
 pulsar-master\pulsar-master\pulsar-client\src\test\java\org\apache\pulsar\client\impl\MessageImplTest.java,481,142,9,95,0,246
 hadoop-trunk\hadoop-trunk\hadoop-hdfs-project\hadoop-hdfs\src\main\java\org\apache\hadoop\hdfs\server\blockmanagement\ProvidedStorageMap.java,482,80,16,2,4,102
 hadoop-trunk\hadoop-trunk\hadoop-yarn-project\hadoop-yarn\hadoop-yarn-server\hadoop-yarn-server-resourcemanager\src\test\java\org\apache\hadoop\yarn\server\resourcemanager\scheduler\fair\converter\TestFSQueueConverter.java,482,57,2,4,0,63
 hadoop-trunk\hadoop-trunk\hadoop-hdfs-project\hadoop-hdfs\src\test\java\org\apache\hadoop\hdfs\server\namenode\TestPersistentStoragePolicySatisfier.java,482,75,8,2,4,89
 kafka-trunk\kafka-trunk\connect\runtime\src\test\java\org\apache\kafka\connect\runtime\isolation\PluginUtilsTest.java,482,0,0,50,0,50
 pulsar-master\pulsar-master\pulsar-broker\src\test\java\org\apache\pulsar\broker\transaction\TopicTransactionBufferRecoverTest.java,482,125,19,86,0,230
 pulsar-master\pulsar-master\pulsar-proxy\src\main\java\org\apache\pulsar\proxy\server\ProxyConnection.java,482,168,4,83,0,255
 hadoop-trunk\hadoop-trunk\hadoop-yarn-project\hadoop-yarn\hadoop-yarn-server\hadoop-yarn-server-common\src\main\java\org\apache\hadoop\yarn\server\webapp\LogServlet.java,483,66,2,3,6,77
 hadoop-trunk\hadoop-trunk\hadoop-mapreduce-project\hadoop-mapreduce-client\hadoop-mapreduce-client-jobclient\src\main\java\org\apache\hadoop\mapred\ResourceMgrDelegate.java,483,157,5,2,4,168
 hadoop-trunk\hadoop-trunk\hadoop-hdfs-project\hadoop-hdfs\src\test\java\org\apache\hadoop\hdfs\TestErasureCodingExerciseAPIs.java,483,23,10,1,0,34
 kafka-trunk\kafka-trunk\streams\src\test\java\org\apache\kafka\streams\state\internals\CompositeReadOnlyWindowStoreTest.java,483,0,31,111,18,160
 kafka-trunk\kafka-trunk\connect\runtime\src\main\java\org\apache\kafka\connect\runtime\WorkerConnector.java,483,0,19,53,5,77
 kafka-trunk\kafka-trunk\streams\src\test\java\org\apache\kafka\streams\kstream\internals\KTableKTableLeftJoinTest.java,483,0,8,129,5,142
 zookeeper-master\zookeeper-master\zookeeper-server\src\main\java\org\apache\zookeeper\ClientCnxnSocketNetty.java,483,0,15,31,1,47
 hadoop-trunk\hadoop-trunk\hadoop-common-project\hadoop-common\src\main\java\org\apache\hadoop\io\IOUtils.java,484,96,19,6,1,122
 hadoop-trunk\hadoop-trunk\hadoop-yarn-project\hadoop-yarn\hadoop-yarn-server\hadoop-yarn-server-nodemanager\src\test\java\org\apache\hadoop\yarn\server\nodemanager\containermanager\monitor\TestContainersMonitor.java,484,70,24,10,20,124
 hadoop-trunk\hadoop-trunk\hadoop-hdfs-project\hadoop-hdfs\src\main\java\org\apache\hadoop\hdfs\server\namenode\INodeAttributeProvider.java,484,231,1,1,12,245
 hadoop-trunk\hadoop-trunk\hadoop-mapreduce-project\hadoop-mapreduce-client\hadoop-mapreduce-client-jobclient\src\test\java\org\apache\hadoop\fs\DFSCIOTest.java,484,240,43,27,13,323
 hadoop-trunk\hadoop-trunk\hadoop-common-project\hadoop-common\src\test\java\org\apache\hadoop\fs\TestPath.java,484,94,10,10,1,115
 pulsar-master\pulsar-master\pulsar-broker\src\test\java\org\apache\pulsar\client\impl\MessagePublishThrottlingTest.java,484,150,25,99,0,274
 pulsar-master\pulsar-master\tiered-storage\jcloud\src\test\java\org\apache\bookkeeper\mledger\offload\jcloud\impl\BlockAwareSegmentInputStreamTest.java,484,194,2,40,0,236
 rocketmq-develop\rocketmq-develop\store\src\test\java\org\apache\rocketmq\store\DefaultMessageStoreCleanFilesTest.java,484,202,16,101,4,323
 hadoop-trunk\hadoop-trunk\hadoop-hdfs-project\hadoop-hdfs\src\main\java\org\apache\hadoop\hdfs\server\namenode\EditLogFileInputStream.java,485,139,19,7,0,165
 zookeeper-master\zookeeper-master\zookeeper-server\src\test\java\org\apache\zookeeper\test\QuorumBase.java,485,0,19,44,28,91
 hadoop-trunk\hadoop-trunk\hadoop-yarn-project\hadoop-yarn\hadoop-yarn-server\hadoop-yarn-server-nodemanager\src\test\java\org\apache\hadoop\yarn\server\nodemanager\containermanager\resourceplugin\gpu\TestGpuDiscoverer.java,486,65,7,5,3,80
 pulsar-master\pulsar-master\pulsar-broker\src\test\java\org\apache\pulsar\broker\loadbalance\AntiAffinityNamespaceGroupTest.java,486,120,5,86,0,211
 dubbo-3.0\dubbo-3.0\dubbo-registry\dubbo-registry-api\src\main\java\org\apache\dubbo\registry\client\migration\MigrationInvoker.java,487,167,9,44,0,220
 hadoop-trunk\hadoop-trunk\hadoop-hdfs-project\hadoop-hdfs\src\test\java\org\apache\hadoop\hdfs\server\namenode\TestDiskspaceQuotaUpdate.java,487,110,11,2,2,125
 pulsar-master\pulsar-master\pulsar-common\src\main\java\org\apache\pulsar\policies\data\loadbalancer\LocalBrokerData.java,487,226,0,33,0,259
 pulsar-master\pulsar-master\pulsar-broker\src\test\java\org\apache\pulsar\functions\worker\PulsarFunctionPublishTest.java,487,174,12,88,0,274
 hadoop-trunk\hadoop-trunk\hadoop-yarn-project\hadoop-yarn\hadoop-yarn-server\hadoop-yarn-server-resourcemanager\src\test\java\org\apache\hadoop\yarn\server\resourcemanager\ahs\TestRMApplicationHistoryWriter.java,488,79,9,12,8,108
 kafka-trunk\kafka-trunk\clients\src\test\java\org\apache\kafka\common\security\ssl\SslFactoryTest.java,488,0,7,77,5,89
 pulsar-master\pulsar-master\pulsar-broker\src\test\java\org\apache\pulsar\broker\service\persistent\DelayedDeliveryTest.java,488,115,8,42,0,165
 pulsar-master\pulsar-master\pulsar-functions\runtime\src\main\java\org\apache\pulsar\functions\runtime\kubernetes\KubernetesRuntimeFactory.java,488,179,8,90,0,277
 zookeeper-master\zookeeper-master\zookeeper-server\src\test\java\org\apache\zookeeper\common\X509TestContext.java,488,0,6,77,2,85
 hadoop-trunk\hadoop-trunk\hadoop-common-project\hadoop-common\src\test\java\org\apache\hadoop\fs\TestLocalDirAllocator.java,489,113,13,7,14,147
 kafka-trunk\kafka-trunk\streams\src\main\java\org\apache\kafka\streams\kstream\internals\InternalStreamsBuilder.java,489,0,7,114,3,124
 kafka-trunk\kafka-trunk\streams\src\test\java\org\apache\kafka\streams\processor\internals\assignment\ClientStateTest.java,489,0,5,93,0,98
 pulsar-master\pulsar-master\managed-ledger\src\test\java\org\apache\bookkeeper\mledger\impl\ManagedLedgerErrorsTest.java,489,84,25,42,0,151
 pulsar-master\pulsar-master\pulsar-functions\utils\src\main\java\org\apache\pulsar\functions\utils\SourceConfigUtils.java,489,147,28,103,0,278
 pulsar-master\pulsar-master\pulsar-io\flume\src\main\java\org\apache\pulsar\io\flume\node\AbstractConfigurationProvider.java,489,106,4,63,0,173
 hadoop-trunk\hadoop-trunk\hadoop-common-project\hadoop-common\src\test\java\org\apache\hadoop\util\TestShell.java,490,94,28,4,10,136
 hadoop-trunk\hadoop-trunk\hadoop-yarn-project\hadoop-yarn\hadoop-yarn-server\hadoop-yarn-server-nodemanager\src\test\java\org\apache\hadoop\yarn\server\nodemanager\TestDirectoryCollection.java,490,142,8,5,2,157
 hadoop-trunk\hadoop-trunk\hadoop-mapreduce-project\hadoop-mapreduce-client\hadoop-mapreduce-client-common\src\test\java\org\apache\hadoop\mapreduce\v2\util\TestMRApps.java,490,146,12,24,10,192
 kafka-trunk\kafka-trunk\metadata\src\generated\java\org\apache\kafka\common\metadata\PartitionChangeRecord.java,490,0,0,31,10,41
 hadoop-trunk\hadoop-trunk\hadoop-tools\hadoop-azure\src\test\java\org\apache\hadoop\fs\azure\metrics\ITestAzureFileSystemInstrumentation.java,491,116,16,39,6,177
 hadoop-trunk\hadoop-trunk\hadoop-yarn-project\hadoop-yarn\hadoop-yarn-server\hadoop-yarn-server-resourcemanager\src\main\java\org\apache\hadoop\yarn\server\resourcemanager\placement\CSMappingPlacementRule.java,491,77,20,8,0,105
 kafka-trunk\kafka-trunk\clients\src\generated\java\org\apache\kafka\common\message\DescribeQuorumRequestData.java,491,0,0,43,10,53
 hadoop-trunk\hadoop-trunk\hadoop-hdfs-project\hadoop-hdfs\src\main\java\org\apache\hadoop\hdfs\server\namenode\INodesInPath.java,492,96,10,8,1,115
 hadoop-trunk\hadoop-trunk\hadoop-hdfs-project\hadoop-hdfs-rbf\src\test\java\org\apache\hadoop\hdfs\server\federation\MockNamenode.java,492,22,14,7,5,48
 hadoop-trunk\hadoop-trunk\hadoop-hdfs-project\hadoop-hdfs\src\test\java\org\apache\hadoop\hdfs\qjournal\server\TestJournalNodeSync.java,492,130,10,1,5,146
 pulsar-master\pulsar-master\pulsar-broker\src\main\java\org\apache\pulsar\broker\admin\impl\TransactionsBase.java,492,177,8,134,0,319
 pulsar-master\pulsar-master\pulsar-broker\src\test\java\org\apache\pulsar\client\impl\ZeroQueueSizeTest.java,492,83,12,52,0,147
 hadoop-trunk\hadoop-trunk\hadoop-mapreduce-project\hadoop-mapreduce-client\hadoop-mapreduce-client-core\src\main\java\org\apache\hadoop\mapreduce\lib\join\Parser.java,493,158,26,6,2,192
 kafka-trunk\kafka-trunk\raft\src\main\java\org\apache\kafka\raft\QuorumState.java,493,0,12,70,2,84
 pulsar-master\pulsar-master\pulsar-io\kafka-connect-adaptor\src\test\java\org\apache\pulsar\io\kafka\connect\KafkaConnectSinkTest.java,493,113,22,43,0,178
 shardingsphere-master\shardingsphere-master\shardingsphere-sql-parser\shardingsphere-sql-parser-dialect\shardingsphere-sql-parser-oracle\src\main\java\org\apache\shardingsphere\sql\parser\oracle\visitor\statement\impl\OracleStatementSQLVisitor.java,493,142,3,168,0,313
 hadoop-trunk\hadoop-trunk\hadoop-common-project\hadoop-common\src\main\java\org\apache\hadoop\security\alias\CredentialShell.java,494,89,22,1,0,112
 hadoop-trunk\hadoop-trunk\hadoop-yarn-project\hadoop-yarn\hadoop-yarn-server\hadoop-yarn-server-resourcemanager\src\test\java\org\apache\hadoop\yarn\server\resourcemanager\webapp\TestApplicationsRequestBuilder.java,494,61,10,2,5,78
 hadoop-trunk\hadoop-trunk\hadoop-common-project\hadoop-common\src\test\java\org\apache\hadoop\ipc\TestAsyncIPC.java,494,110,16,4,8,138
 pulsar-master\pulsar-master\managed-ledger\src\test\java\org\apache\bookkeeper\mledger\impl\ManagedLedgerBkTest.java,494,106,8,60,0,174
 hadoop-trunk\hadoop-trunk\hadoop-common-project\hadoop-common\src\test\java\org\apache\hadoop\security\token\delegation\web\TestDelegationTokenAuthenticationHandlerWithMocks.java,495,44,17,7,6,74
 hadoop-trunk\hadoop-trunk\hadoop-tools\hadoop-aws\src\test\java\org\apache\hadoop\fs\s3a\ITestS3AConfiguration.java,495,71,72,5,5,153
 hadoop-trunk\hadoop-trunk\hadoop-yarn-project\hadoop-yarn\hadoop-yarn-server\hadoop-yarn-server-resourcemanager\src\test\java\org\apache\hadoop\yarn\server\resourcemanager\TestApplicationMasterLauncher.java,495,83,11,10,14,118
 hadoop-trunk\hadoop-trunk\hadoop-common-project\hadoop-common\src\test\java\org\apache\hadoop\ipc\TestDecayRpcScheduler.java,495,121,9,7,3,140
 kafka-trunk\kafka-trunk\connect\runtime\src\main\java\org\apache\kafka\connect\runtime\ConnectorConfig.java,495,0,6,130,0,136
 zookeeper-master\zookeeper-master\zookeeper-server\src\test\java\org\apache\zookeeper\server\quorum\FuzzySnapshotRelatedTest.java,495,0,20,36,5,61
 hadoop-trunk\hadoop-trunk\hadoop-common-project\hadoop-common\src\test\java\org\apache\hadoop\metrics2\sink\RollingFileSystemSinkTestBase.java,496,98,10,4,14,126
 hadoop-trunk\hadoop-trunk\hadoop-hdfs-project\hadoop-hdfs-client\src\main\java\org\apache\hadoop\hdfs\DFSStripedInputStream.java,496,72,6,2,23,103
 hadoop-trunk\hadoop-trunk\hadoop-common-project\hadoop-common\src\test\java\org\apache\hadoop\util\bloom\BloomFilterCommonTester.java,496,123,31,7,35,196
 hadoop-trunk\hadoop-trunk\hadoop-mapreduce-project\hadoop-mapreduce-client\hadoop-mapreduce-client-jobclient\src\test\java\org\apache\hadoop\mapreduce\TestMapCollection.java,496,271,22,2,7,302
 dubbo-3.0\dubbo-3.0\dubbo-registry\dubbo-registry-api\src\main\java\org\apache\dubbo\registry\client\event\listener\ServiceInstancesChangedListener.java,497,178,14,84,0,276
 hadoop-trunk\hadoop-trunk\hadoop-common-project\hadoop-common\src\main\java\org\apache\hadoop\fs\shell\CommandWithDestination.java,497,88,7,4,1,100
 hadoop-trunk\hadoop-trunk\hadoop-hdfs-project\hadoop-hdfs\src\test\java\org\apache\hadoop\hdfs\web\TestWebHdfsTokens.java,497,65,33,20,4,122
 hadoop-trunk\hadoop-trunk\hadoop-common-project\hadoop-common\src\main\java\org\apache\hadoop\ha\HAAdmin.java,497,132,1,6,0,139
 kafka-trunk\kafka-trunk\streams\src\test\java\org\apache\kafka\streams\integration\GlobalKTableEOSIntegrationTest.java,497,0,3,37,6,46
 pulsar-master\pulsar-master\pulsar-broker\src\main\java\org\apache\pulsar\broker\TransactionMetadataStoreService.java,497,204,7,131,0,342
 pulsar-master\pulsar-master\pulsar-broker\src\test\java\org\apache\pulsar\schema\compatibility\SchemaCompatibilityCheckTest.java,497,107,1,62,0,170
 hadoop-trunk\hadoop-trunk\hadoop-yarn-project\hadoop-yarn\hadoop-yarn-server\hadoop-yarn-server-nodemanager\src\main\java\org\apache\hadoop\yarn\server\nodemanager\timelineservice\NMTimelinePublisher.java,498,73,28,13,9,123
 hadoop-trunk\hadoop-trunk\hadoop-tools\hadoop-aws\src\test\java\org\apache\hadoop\fs\s3a\tools\ITestMarkerTool.java,499,36,7,8,0,51
 hadoop-trunk\hadoop-trunk\hadoop-mapreduce-project\hadoop-mapreduce-client\hadoop-mapreduce-client-app\src\test\java\org\apache\hadoop\mapred\TestTaskAttemptListenerImpl.java,499,86,11,5,4,106
 hadoop-trunk\hadoop-trunk\hadoop-yarn-project\hadoop-yarn\hadoop-yarn-server\hadoop-yarn-server-router\src\test\java\org\apache\hadoop\yarn\server\router\clientrm\BaseRouterClientRMTest.java,499,72,25,10,0,107
 dubbo-3.0\dubbo-3.0\dubbo-cluster\src\main\java\org\apache\dubbo\rpc\cluster\router\state\BitList.java,500,125,8,24,0,157
 hadoop-trunk\hadoop-trunk\hadoop-yarn-project\hadoop-yarn\hadoop-yarn-applications\hadoop-yarn-services\hadoop-yarn-services-core\src\test\java\org\apache\hadoop\yarn\service\ServiceTestUtils.java,501,98,12,8,7,125
 hadoop-trunk\hadoop-trunk\hadoop-common-project\hadoop-common\src\test\java\org\apache\hadoop\io\erasurecode\TestCoderBase.java,501,121,6,2,6,135
 kafka-trunk\kafka-trunk\connect\runtime\src\test\java\org\apache\kafka\connect\util\KafkaBasedLogTest.java,501,0,1,75,1,77
 dubbo-3.0\dubbo-3.0\dubbo-common\src\test\java\org\apache\dubbo\common\utils\ReflectUtilsTest.java,502,167,28,75,0,270
 hadoop-trunk\hadoop-trunk\hadoop-yarn-project\hadoop-yarn\hadoop-yarn-server\hadoop-yarn-server-router\src\test\java\org\apache\hadoop\yarn\server\router\webapp\TestFederationInterceptorREST.java,502,19,1,9,0,29
 hadoop-trunk\hadoop-trunk\hadoop-common-project\hadoop-common\src\main\java\org\apache\hadoop\util\GenericOptionsParser.java,502,103,10,8,4,125
 kafka-trunk\kafka-trunk\raft\src\main\java\org\apache\kafka\raft\internals\BatchAccumulator.java,502,0,1,40,1,42
 hadoop-trunk\hadoop-trunk\hadoop-mapreduce-project\hadoop-mapreduce-client\hadoop-mapreduce-client-core\src\main\java\org\apache\hadoop\mapred\ClusterStatus.java,503,172,5,1,3,181
 hadoop-trunk\hadoop-trunk\hadoop-common-project\hadoop-common\src\main\java\org\apache\hadoop\security\token\Token.java,503,87,2,1,9,99
 kafka-trunk\kafka-trunk\clients\src\generated\java\org\apache\kafka\common\message\DescribeClientQuotasRequestData.java,503,0,0,53,7,60
 hadoop-trunk\hadoop-trunk\hadoop-yarn-project\hadoop-yarn\hadoop-yarn-api\src\main\java\org\apache\hadoop\yarn\api\records\ApplicationReport.java,504,180,0,7,0,187
 dubbo-3.0\dubbo-3.0\dubbo-registry\dubbo-registry-api\src\main\java\org\apache\dubbo\registry\integration\RegistryDirectory.java,505,145,14,91,0,250
 hadoop-trunk\hadoop-trunk\hadoop-yarn-project\hadoop-yarn\hadoop-yarn-server\hadoop-yarn-server-resourcemanager\src\test\java\org\apache\hadoop\yarn\server\resourcemanager\TestApplicationCleanup.java,505,95,11,9,1,116
 hadoop-trunk\hadoop-trunk\hadoop-tools\hadoop-rumen\src\main\java\org\apache\hadoop\tools\rumen\Folder.java,505,69,36,3,1,109
 kafka-trunk\kafka-trunk\trogdor\src\main\java\org\apache\kafka\trogdor\workload\ConsumeBenchWorker.java,505,0,8,48,1,57
 pulsar-master\pulsar-master\pulsar-broker\src\main\java\org\apache\pulsar\broker\loadbalance\impl\LoadManagerShared.java,505,132,6,100,0,238
 dubbo-3.0\dubbo-3.0\dubbo-cluster\src\test\java\org\apache\dubbo\rpc\cluster\support\AbstractClusterInvokerTest.java,506,189,11,78,0,278
 hadoop-trunk\hadoop-trunk\hadoop-common-project\hadoop-common\src\test\java\org\apache\hadoop\security\ssl\TestSSLFactory.java,506,64,28,7,3,102
 hadoop-trunk\hadoop-trunk\hadoop-yarn-project\hadoop-yarn\hadoop-yarn-applications\hadoop-yarn-services\hadoop-yarn-services-core\src\main\java\org\apache\hadoop\yarn\service\utils\CoreFileSystem.java,506,116,6,14,4,140
 kafka-trunk\kafka-trunk\clients\src\test\java\org\apache\kafka\test\TestUtils.java,506,0,9,86,10,105
 kafka-trunk\kafka-trunk\connect\runtime\src\test\java\org\apache\kafka\connect\util\clusters\EmbeddedConnectClusterAssertions.java,507,0,1,77,6,84
 kafka-trunk\kafka-trunk\streams\src\test\java\org\apache\kafka\streams\integration\KStreamTransformIntegrationTest.java,507,0,9,36,6,51
 kafka-trunk\kafka-trunk\tools\src\main\java\org\apache\kafka\tools\VerifiableProducer.java,507,0,3,47,1,51
 kafka-trunk\kafka-trunk\clients\src\generated\java\org\apache\kafka\common\message\DeleteGroupsResponseData.java,507,0,0,45,6,51
 zookeeper-master\zookeeper-master\zookeeper-server\src\test\java\org\apache\zookeeper\common\CertificatesToPlayWith.java,507,0,0,30,32,62
 dubbo-3.0\dubbo-3.0\dubbo-common\src\main\java\org\apache\dubbo\config\RegistryConfig.java,508,247,1,20,4,272
 hadoop-trunk\hadoop-trunk\hadoop-mapreduce-project\hadoop-mapreduce-client\hadoop-mapreduce-client-jobclient\src\test\java\org\apache\hadoop\mapred\TestMRTimelineEventHandling.java,508,54,19,5,6,84
 pulsar-master\pulsar-master\pulsar-metadata\src\main\java\org\apache\pulsar\metadata\impl\RocksdbMetadataStore.java,508,103,13,44,0,160
 hadoop-trunk\hadoop-trunk\hadoop-yarn-project\hadoop-yarn\hadoop-yarn-server\hadoop-yarn-server-nodemanager\src\test\java\org\apache\hadoop\yarn\server\nodemanager\containermanager\linux\resources\gpu\TestGpuResourceHandlerImpl.java,509,91,2,16,1,110
 hadoop-trunk\hadoop-trunk\hadoop-tools\hadoop-distcp\src\test\java\org\apache\hadoop\tools\TestFileBasedCopyListing.java,510,73,1,15,4,93
 hadoop-trunk\hadoop-trunk\hadoop-yarn-project\hadoop-yarn\hadoop-yarn-server\hadoop-yarn-server-resourcemanager\src\test\java\org\apache\hadoop\yarn\server\resourcemanager\TestClientRMTokens.java,510,134,24,15,2,175
 hadoop-trunk\hadoop-trunk\hadoop-yarn-project\hadoop-yarn\hadoop-yarn-common\src\main\java\org\apache\hadoop\yarn\api\records\impl\pb\QueueInfoPBImpl.java,510,110,115,3,0,228
 hadoop-trunk\hadoop-trunk\hadoop-yarn-project\hadoop-yarn\hadoop-yarn-applications\hadoop-yarn-services\hadoop-yarn-services-core\src\main\java\org\apache\hadoop\yarn\service\api\records\Component.java,510,205,3,17,26,251
 dubbo-3.0\dubbo-3.0\dubbo-common\src\test\java\org\apache\dubbo\common\beanutil\JavaBeanSerializeUtilTest.java,511,171,15,120,2,308
 hadoop-trunk\hadoop-trunk\hadoop-yarn-project\hadoop-yarn\hadoop-yarn-server\hadoop-yarn-server-nodemanager\src\test\java\org\apache\hadoop\yarn\server\nodemanager\containermanager\loghandler\TestNonAggregatingLogHandler.java,511,114,9,12,1,136
 kafka-trunk\kafka-trunk\streams\src\test\java\org\apache\kafka\streams\state\internals\metrics\RocksDBMetricsTest.java,511,0,1,81,0,82
 rocketmq-develop\rocketmq-develop\remoting\src\main\java\org\apache\rocketmq\remoting\protocol\RemotingCommand.java,511,209,21,45,8,283
 hadoop-trunk\hadoop-trunk\hadoop-hdfs-project\hadoop-hdfs\src\main\java\org\apache\hadoop\hdfs\server\diskbalancer\command\Command.java,512,53,8,4,2,67
 hadoop-trunk\hadoop-trunk\hadoop-hdfs-project\hadoop-hdfs\src\test\java\org\apache\hadoop\hdfs\server\blockmanagement\TestSortLocatedStripedBlock.java,512,57,13,2,7,79
 zookeeper-master\zookeeper-master\zookeeper-server\src\test\java\org\apache\zookeeper\server\quorum\LearnerHandlerTest.java,512,0,32,12,1,45
 dubbo-3.0\dubbo-3.0\dubbo-config\dubbo-config-spring\src\main\java\org\apache\dubbo\config\spring\schema\DubboBeanDefinitionParser.java,513,196,10,112,0,318
 kafka-trunk\kafka-trunk\streams\src\test\java\org\apache\kafka\streams\kstream\internals\KTableImplTest.java,513,0,13,95,24,132
 kafka-trunk\kafka-trunk\streams\src\main\java\org\apache\kafka\streams\state\internals\Murmur3.java,513,0,26,12,28,66
 dubbo-3.0\dubbo-3.0\dubbo-registry\dubbo-registry-api\src\test\java\org\apache\dubbo\registry\support\AbstractRegistryTest.java,514,108,34,55,0,197
 hadoop-trunk\hadoop-trunk\hadoop-tools\hadoop-aws\src\test\java\org\apache\hadoop\fs\s3a\scale\AbstractSTestS3AHugeFiles.java,514,64,52,6,0,122
 hadoop-trunk\hadoop-trunk\hadoop-mapreduce-project\hadoop-mapreduce-client\hadoop-mapreduce-client-jobclient\src\test\java\org\apache\hadoop\mapred\TestClientServiceDelegate.java,514,125,3,30,0,158
 hadoop-trunk\hadoop-trunk\hadoop-mapreduce-project\hadoop-mapreduce-client\hadoop-mapreduce-client-core\src\main\java\org\apache\hadoop\mapreduce\lib\output\committer\manifest\stages\StageConfig.java,514,23,2,6,4,35
 hadoop-trunk\hadoop-trunk\hadoop-common-project\hadoop-common\src\test\java\org\apache\hadoop\fs\viewfs\TestChRootedFileSystem.java,514,127,26,10,0,163
 kafka-trunk\kafka-trunk\connect\runtime\src\test\java\org\apache\kafka\connect\runtime\distributed\WorkerCoordinatorIncrementalTest.java,514,0,16,78,16,110
 hadoop-trunk\hadoop-trunk\hadoop-yarn-project\hadoop-yarn\hadoop-yarn-common\src\test\java\org\apache\hadoop\yarn\client\api\impl\TestTimelineClient.java,515,62,6,5,4,77
 hadoop-trunk\hadoop-trunk\hadoop-hdfs-project\hadoop-hdfs\src\test\java\org\apache\hadoop\hdfs\server\namenode\TestHDFSConcat.java,515,183,18,5,4,210
 hadoop-trunk\hadoop-trunk\hadoop-yarn-project\hadoop-yarn\hadoop-yarn-server\hadoop-yarn-server-common\src\main\java\org\apache\hadoop\yarn\server\webapp\WebServices.java,515,112,2,6,6,126
 kafka-trunk\kafka-trunk\clients\src\generated\java\org\apache\kafka\common\message\CreatePartitionsResponseData.java,515,0,0,51,7,58
 hadoop-trunk\hadoop-trunk\hadoop-yarn-project\hadoop-yarn\hadoop-yarn-common\src\test\java\org\apache\hadoop\yarn\security\TestYARNTokenIdentifier.java,516,107,8,16,0,131
 hadoop-trunk\hadoop-trunk\hadoop-yarn-project\hadoop-yarn\hadoop-yarn-server\hadoop-yarn-server-resourcemanager\src\test\java\org\apache\hadoop\yarn\server\resourcemanager\TestReservationSystemWithRMHA.java,516,74,16,7,0,97
 kafka-trunk\kafka-trunk\streams\src\test\java\org\apache\kafka\streams\integration\TableTableJoinIntegrationTest.java,516,0,1,105,1,107
 kafka-trunk\kafka-trunk\clients\src\main\java\org\apache\kafka\common\record\FileRecords.java,516,0,21,72,1,94
 dubbo-3.0\dubbo-3.0\dubbo-registry\dubbo-registry-api\src\main\java\org\apache\dubbo\registry\support\AbstractRegistry.java,517,118,19,48,0,185
 hadoop-trunk\hadoop-trunk\hadoop-yarn-project\hadoop-yarn\hadoop-yarn-server\hadoop-yarn-server-common\src\main\java\org\apache\hadoop\yarn\server\api\protocolrecords\impl\pb\RegisterNodeManagerRequestPBImpl.java,517,114,104,12,0,230
 hadoop-trunk\hadoop-trunk\hadoop-common-project\hadoop-common\src\main\java\org\apache\hadoop\crypto\key\KeyShell.java,517,92,9,1,0,102
 kafka-trunk\kafka-trunk\clients\src\generated\java\org\apache\kafka\common\message\ControlledShutdownResponseData.java,517,0,0,54,6,60
 rocketmq-develop\rocketmq-develop\client\src\main\java\org\apache\rocketmq\client\impl\consumer\ConsumeMessageOrderlyService.java,517,164,15,92,4,275
 hadoop-trunk\hadoop-trunk\hadoop-hdfs-project\hadoop-hdfs\src\main\java\org\apache\hadoop\hdfs\server\namenode\snapshot\DiffListBySkipList.java,518,60,2,1,0,63
 pulsar-master\pulsar-master\pulsar-zookeeper-utils\src\main\java\org\apache\pulsar\zookeeper\LocalBookkeeperEnsemble.java,518,221,7,48,0,276
 zookeeper-master\zookeeper-master\zookeeper-server\src\test\java\org\apache\zookeeper\server\quorum\ReconfigRecoveryTest.java,518,0,25,52,0,77
 hadoop-trunk\hadoop-trunk\hadoop-tools\hadoop-aws\src\test\java\org\apache\hadoop\fs\s3a\commit\TestTasks.java,520,66,4,2,0,72
 pulsar-master\pulsar-master\pulsar-common\src\main\java\org\apache\pulsar\common\util\SecurityUtility.java,520,255,11,136,0,402
 rocketmq-develop\rocketmq-develop\broker\src\main\java\org\apache\rocketmq\broker\processor\PullMessageProcessor.java,520,161,25,125,8,319
 hadoop-trunk\hadoop-trunk\hadoop-yarn-project\hadoop-yarn\hadoop-yarn-server\hadoop-yarn-server-common\src\main\java\org\apache\hadoop\yarn\server\AMRMClientRelayer.java,521,57,11,7,3,78
 hadoop-trunk\hadoop-trunk\hadoop-yarn-project\hadoop-yarn\hadoop-yarn-server\hadoop-yarn-server-resourcemanager\src\test\java\org\apache\hadoop\yarn\server\resourcemanager\scheduler\fair\TestFairSchedulerPreemption.java,521,75,9,5,3,92
 hadoop-trunk\hadoop-trunk\hadoop-yarn-project\hadoop-yarn\hadoop-yarn-common\src\main\java\org\apache\hadoop\yarn\util\resource\Resources.java,522,197,14,3,2,216
 kafka-trunk\kafka-trunk\connect\api\src\test\java\org\apache\kafka\connect\header\ConnectHeadersTest.java,522,0,4,40,2,46
 rocketmq-develop\rocketmq-develop\client\src\main\java\org\apache\rocketmq\client\consumer\DefaultLitePullConsumer.java,522,286,1,57,3,347
 hadoop-trunk\hadoop-trunk\hadoop-mapreduce-project\hadoop-mapreduce-client\hadoop-mapreduce-client-jobclient\src\test\java\org\apache\hadoop\fs\slive\TestSlive.java,523,70,24,3,11,108
 hadoop-trunk\hadoop-trunk\hadoop-mapreduce-project\hadoop-mapreduce-client\hadoop-mapreduce-client-jobclient\src\test\java\org\apache\hadoop\mapreduce\TestValueIterReset.java,523,113,30,2,4,149
 kafka-trunk\kafka-trunk\clients\src\generated\java\org\apache\kafka\common\message\IncrementalAlterConfigsResponseData.java,523,0,0,56,7,63
 kafka-trunk\kafka-trunk\streams\src\test\java\org\apache\kafka\streams\kstream\internals\KTableTransformValuesTest.java,523,0,6,68,3,77
 hadoop-trunk\hadoop-trunk\hadoop-yarn-project\hadoop-yarn\hadoop-yarn-server\hadoop-yarn-server-resourcemanager\src\main\java\org\apache\hadoop\yarn\server\resourcemanager\metrics\TimelineServiceV1Publisher.java,524,81,18,14,6,119
 hadoop-trunk\hadoop-trunk\hadoop-hdfs-project\hadoop-hdfs\src\main\java\org\apache\hadoop\hdfs\security\token\block\BlockTokenSecretManager.java,525,202,6,9,18,235
 hadoop-trunk\hadoop-trunk\hadoop-tools\hadoop-aws\src\main\java\org\apache\hadoop\fs\s3a\Invoker.java,525,85,4,3,0,92
 kafka-trunk\kafka-trunk\streams\src\main\java\org\apache\kafka\streams\processor\internals\StreamsMetadataState.java,525,0,0,145,13,158
 kafka-trunk\kafka-trunk\clients\src\main\java\org\apache\kafka\clients\producer\ProducerConfig.java,526,0,4,211,0,215
 pulsar-master\pulsar-master\pulsar-broker\src\main\java\org\apache\pulsar\broker\service\SystemTopicBasedTopicPoliciesService.java,526,175,9,99,0,283
 zookeeper-master\zookeeper-master\zookeeper-server\src\test\java\org\apache\zookeeper\server\quorum\QuorumPeerTestBase.java,526,0,17,51,28,96
 hadoop-trunk\hadoop-trunk\hadoop-yarn-project\hadoop-yarn\hadoop-yarn-common\src\test\java\org\apache\hadoop\yarn\logaggregation\TestAggregatedLogDeletionService.java,527,111,8,14,1,134
 pulsar-master\pulsar-master\pulsar-metadata\src\test\java\org\apache\pulsar\metadata\MetadataCacheTest.java,527,164,2,85,0,251
 hadoop-trunk\hadoop-trunk\hadoop-common-project\hadoop-common\src\test\java\org\apache\hadoop\security\token\delegation\TestDelegationToken.java,528,253,31,10,10,304
 hadoop-trunk\hadoop-trunk\hadoop-mapreduce-project\hadoop-mapreduce-client\hadoop-mapreduce-client-app\src\main\java\org\apache\hadoop\mapreduce\v2\app\rm\RMContainerRequestor.java,528,170,18,12,1,201
 hadoop-trunk\hadoop-trunk\hadoop-yarn-project\hadoop-yarn\hadoop-yarn-applications\hadoop-yarn-applications-distributedshell\src\test\java\org\apache\hadoop\yarn\applications\distributedshell\DistributedShellBaseTest.java,528,100,8,1,8,117
 kafka-trunk\kafka-trunk\connect\transforms\src\test\java\org\apache\kafka\connect\transforms\CastTest.java,528,0,0,120,0,120
 hadoop-trunk\hadoop-trunk\hadoop-yarn-project\hadoop-yarn\hadoop-yarn-server\hadoop-yarn-server-resourcemanager\src\main\java\org\apache\hadoop\yarn\server\resourcemanager\webapp\RMAppAttemptBlock.java,529,45,0,14,0,59
 kafka-trunk\kafka-trunk\clients\src\generated\java\org\apache\kafka\common\message\AlterConfigsResponseData.java,529,0,0,53,7,60
 skywalking-master\skywalking-master\oap-server\analyzer\meter-analyzer\src\test\java\org\apache\skywalking\oap\meter\analyzer\dsl\ScopeTest.java,529,172,32,77,0,281
 hadoop-trunk\hadoop-trunk\hadoop-yarn-project\hadoop-yarn\hadoop-yarn-common\src\main\java\org\apache\hadoop\yarn\api\impl\pb\client\ApplicationClientProtocolPBClientImpl.java,530,87,95,115,0,297
 hadoop-trunk\hadoop-trunk\hadoop-hdfs-project\hadoop-hdfs\src\main\java\org\apache\hadoop\hdfs\protocol\BlockListAsLongs.java,530,128,3,3,3,137
 hadoop-trunk\hadoop-trunk\hadoop-hdfs-project\hadoop-hdfs\src\test\java\org\apache\hadoop\hdfs\tools\TestGetConf.java,530,151,12,8,4,175
 kafka-trunk\kafka-trunk\streams\src\test\java\org\apache\kafka\streams\state\internals\MeteredSessionStoreTest.java,530,0,1,65,12,78
 kafka-trunk\kafka-trunk\clients\src\generated\java\org\apache\kafka\common\message\DeleteTopicsRequestData.java,530,0,0,52,8,60
 pulsar-master\pulsar-master\pulsar-broker\src\main\java\org\apache\pulsar\broker\admin\impl\SinksBase.java,531,320,47,213,0,580
 dubbo-3.0\dubbo-3.0\dubbo-common\src\main\java\org\apache\dubbo\common\utils\ClassUtils.java,532,95,9,29,4,137
 hadoop-trunk\hadoop-trunk\hadoop-tools\hadoop-gridmix\src\test\java\org\apache\hadoop\mapred\gridmix\TestCompressionEmulationUtils.java,532,170,16,5,16,207
 hadoop-trunk\hadoop-trunk\hadoop-mapreduce-project\hadoop-mapreduce-client\hadoop-mapreduce-client-core\src\main\java\org\apache\hadoop\mapreduce\task\JobContextImpl.java,532,129,10,5,12,156
 kafka-trunk\kafka-trunk\clients\src\test\java\org\apache\kafka\test\TestSslUtils.java,532,0,19,107,2,128
 pulsar-master\pulsar-master\tests\pulsar-client-shade-test\src\test\java\org\apache\pulsar\tests\integration\SimpleProducerConsumerTest.java,532,180,10,112,0,302
 dubbo-3.0\dubbo-3.0\dubbo-plugin\dubbo-qos\src\main\java\org\apache\dubbo\qos\textui\TTable.java,533,115,3,14,0,132
 kafka-trunk\kafka-trunk\clients\src\generated\java\org\apache\kafka\common\message\ConsumerProtocolSubscription.java,533,0,0,43,13,56
 kafka-trunk\kafka-trunk\streams\src\test\java\org\apache\kafka\streams\integration\StoreQueryIntegrationTest.java,533,0,2,139,2,143
 rocketmq-develop\rocketmq-develop\namesrv\src\main\java\org\apache\rocketmq\namesrv\processor\DefaultRequestProcessor.java,533,157,22,104,1,284
 hadoop-trunk\hadoop-trunk\hadoop-yarn-project\hadoop-yarn\hadoop-yarn-server\hadoop-yarn-server-nodemanager\src\test\java\org\apache\hadoop\yarn\server\nodemanager\containermanager\linux\resources\fpga\TestFpgaResourceHandlerImpl.java,534,87,37,19,4,147
 hadoop-trunk\hadoop-trunk\hadoop-mapreduce-project\hadoop-mapreduce-client\hadoop-mapreduce-client-core\src\main\java\org\apache\hadoop\mapred\QueueManager.java,534,79,10,4,0,93
 hadoop-trunk\hadoop-trunk\hadoop-tools\hadoop-aws\src\test\java\org\apache\hadoop\fs\s3a\auth\TestSignerManager.java,534,113,9,2,10,134
 hadoop-trunk\hadoop-trunk\hadoop-yarn-project\hadoop-yarn\hadoop-yarn-server\hadoop-yarn-server-resourcemanager\src\main\java\org\apache\hadoop\yarn\server\resourcemanager\scheduler\SchedulerNode.java,534,69,10,3,18,100
 pulsar-master\pulsar-master\tests\pulsar-client-all-shade-test\src\test\java\org\apache\pulsar\tests\integration\SimpleProducerConsumerTest.java,534,180,11,112,0,303
 hadoop-trunk\hadoop-trunk\hadoop-common-project\hadoop-common\src\main\java\org\apache\hadoop\io\erasurecode\rawcoder\util\GaloisField.java,535,147,19,1,0,167
 hadoop-trunk\hadoop-trunk\hadoop-yarn-project\hadoop-yarn\hadoop-yarn-server\hadoop-yarn-server-resourcemanager\src\main\java\org\apache\hadoop\yarn\server\resourcemanager\scheduler\SchedulerUtils.java,535,126,9,7,0,142
 hadoop-trunk\hadoop-trunk\hadoop-yarn-project\hadoop-yarn\hadoop-yarn-server\hadoop-yarn-server-resourcemanager\src\test\java\org\apache\hadoop\yarn\server\resourcemanager\ReservationACLsTestBase.java,535,79,7,5,2,93
 hadoop-trunk\hadoop-trunk\hadoop-common-project\hadoop-common\src\test\java\org\apache\hadoop\util\functional\TestTaskPool.java,535,64,4,2,0,70
 pulsar-master\pulsar-master\tests\pulsar-client-admin-shade-test\src\test\java\org\apache\pulsar\tests\integration\SimpleProducerConsumerTest.java,535,180,10,112,0,302
 hadoop-trunk\hadoop-trunk\hadoop-yarn-project\hadoop-yarn\hadoop-yarn-server\hadoop-yarn-server-common\src\test\java\org\apache\hadoop\yarn\server\federation\store\impl\FederationStateStoreBaseTest.java,536,50,1,27,0,78
 zookeeper-master\zookeeper-master\zookeeper-server\src\main\java\org\apache\zookeeper\Op.java,536,0,40,30,2,72
 hadoop-trunk\hadoop-trunk\hadoop-yarn-project\hadoop-yarn\hadoop-yarn-server\hadoop-yarn-server-resourcemanager\src\test\java\org\apache\hadoop\yarn\server\resourcemanager\rmapp\TestApplicationLifetimeMonitor.java,537,75,19,10,3,107
 hadoop-trunk\hadoop-trunk\hadoop-yarn-project\hadoop-yarn\hadoop-yarn-common\src\main\java\org\apache\hadoop\yarn\client\api\impl\TimelineV2ClientImpl.java,537,71,17,3,5,96
 dubbo-3.0\dubbo-3.0\dubbo-common\src\main\java\org\apache\dubbo\config\ProtocolConfig.java,538,273,1,5,2,281
 hadoop-trunk\hadoop-trunk\hadoop-hdfs-project\hadoop-hdfs\src\test\java\org\apache\hadoop\hdfs\server\namenode\TestDecommissioningStatus.java,538,100,13,3,1,117
 hadoop-trunk\hadoop-trunk\hadoop-yarn-project\hadoop-yarn\hadoop-yarn-server\hadoop-yarn-server-resourcemanager\src\main\java\org\apache\hadoop\yarn\server\resourcemanager\RMActiveServiceContext.java,538,243,5,26,0,274
 hadoop-trunk\hadoop-trunk\hadoop-tools\hadoop-distcp\src\test\java\org\apache\hadoop\tools\TestDistCpOptions.java,539,49,4,1,0,54
 hadoop-trunk\hadoop-trunk\hadoop-yarn-project\hadoop-yarn\hadoop-yarn-server\hadoop-yarn-server-resourcemanager\src\main\java\org\apache\hadoop\yarn\server\resourcemanager\nodelabels\RMNodeLabelsManager.java,539,91,5,2,1,99
 hadoop-trunk\hadoop-trunk\hadoop-hdfs-project\hadoop-hdfs\src\test\java\org\apache\hadoop\hdfs\server\datanode\fsdataset\impl\TestFsDatasetCache.java,539,185,16,4,22,227
 rocketmq-develop\rocketmq-develop\tools\src\main\java\org\apache\rocketmq\tools\admin\DefaultMQAdminExt.java,539,370,0,116,0,486
 hadoop-trunk\hadoop-trunk\hadoop-hdfs-project\hadoop-hdfs\src\test\java\org\apache\hadoop\hdfs\web\resources\TestParam.java,540,90,59,4,0,153
 hadoop-trunk\hadoop-trunk\hadoop-hdfs-project\hadoop-hdfs-client\src\main\java\org\apache\hadoop\fs\Hdfs.java,540,178,3,5,1,187
 hadoop-trunk\hadoop-trunk\hadoop-hdfs-project\hadoop-hdfs\src\test\java\org\apache\hadoop\fs\viewfs\TestViewFsLinkFallback.java,540,17,1,1,0,19
 hadoop-trunk\hadoop-trunk\hadoop-yarn-project\hadoop-yarn\hadoop-yarn-common\src\main\java\org\apache\hadoop\yarn\api\protocolrecords\impl\pb\RegisterApplicationMasterResponsePBImpl.java,540,79,104,11,0,194
 hadoop-trunk\hadoop-trunk\hadoop-hdfs-project\hadoop-hdfs\src\test\java\org\apache\hadoop\hdfs\TestFileAppend3.java,540,163,15,23,1,202
 kafka-trunk\kafka-trunk\clients\src\generated\java\org\apache\kafka\common\message\EndQuorumEpochResponseData.java,540,0,0,46,10,56
 kafka-trunk\kafka-trunk\clients\src\generated\java\org\apache\kafka\common\message\BeginQuorumEpochResponseData.java,540,0,0,46,10,56
 pulsar-master\pulsar-master\pulsar-functions\instance\src\test\java\org\apache\pulsar\functions\sink\PulsarSinkTest.java,540,94,10,65,0,169
 hadoop-trunk\hadoop-trunk\hadoop-hdfs-project\hadoop-hdfs\src\test\java\org\apache\hadoop\hdfs\server\namenode\ha\TestObserverNode.java,541,58,5,5,4,72
 hadoop-trunk\hadoop-trunk\hadoop-common-project\hadoop-common\src\main\java\org\apache\hadoop\ipc\WritableRpcEngine.java,541,234,19,5,2,260
 dubbo-3.0\dubbo-3.0\dubbo-common\src\main\java\org\apache\dubbo\config\ApplicationConfig.java,542,268,2,26,6,302
 hadoop-trunk\hadoop-trunk\hadoop-mapreduce-project\hadoop-mapreduce-client\hadoop-mapreduce-client-uploader\src\main\java\org\apache\hadoop\mapred\uploader\FrameworkUploader.java,542,95,53,1,2,151
 hadoop-trunk\hadoop-trunk\hadoop-yarn-project\hadoop-yarn\hadoop-yarn-server\hadoop-yarn-server-router\src\test\java\org\apache\hadoop\yarn\server\router\webapp\TestRouterWebServiceUtil.java,542,65,2,3,41,111
 hadoop-trunk\hadoop-trunk\hadoop-common-project\hadoop-common\src\test\java\org\apache\hadoop\security\TestUGILoginFromKeytab.java,542,35,24,4,0,63
 hadoop-trunk\hadoop-trunk\hadoop-common-project\hadoop-common\src\test\java\org\apache\hadoop\fs\contract\AbstractContractCreateTest.java,542,77,2,7,0,86
 hadoop-trunk\hadoop-trunk\hadoop-hdfs-project\hadoop-hdfs-client\src\main\java\org\apache\hadoop\hdfs\protocol\datatransfer\sasl\SaslDataTransferClient.java,543,112,5,8,6,131
 hadoop-trunk\hadoop-trunk\hadoop-tools\hadoop-azure\src\main\java\org\apache\hadoop\fs\azure\SecureStorageInterfaceImpl.java,543,156,3,30,0,189
 pulsar-master\pulsar-master\pulsar-common\src\test\java\org\apache\pulsar\common\util\collections\ConcurrentLongHashMapTest.java,543,102,6,24,0,132
 hadoop-trunk\hadoop-trunk\hadoop-hdfs-project\hadoop-hdfs\src\test\java\org\apache\hadoop\hdfs\server\namenode\ha\TestHAStateTransitions.java,544,109,12,8,3,132
 hadoop-trunk\hadoop-trunk\hadoop-hdfs-project\hadoop-hdfs-rbf\src\main\java\org\apache\hadoop\hdfs\server\federation\resolver\NamenodeStatusReport.java,544,73,0,3,0,76
 kafka-trunk\kafka-trunk\clients\src\generated\java\org\apache\kafka\common\message\UpdateFeaturesResponseData.java,544,0,0,48,8,56
 rocketmq-develop\rocketmq-develop\common\src\main\java\org\apache\rocketmq\common\message\MessageDecoder.java,544,151,6,41,4,202
 hadoop-trunk\hadoop-trunk\hadoop-common-project\hadoop-common\src\main\java\org\apache\hadoop\fs\LocalDirAllocator.java,545,174,12,5,1,192
 hadoop-trunk\hadoop-trunk\hadoop-mapreduce-project\hadoop-mapreduce-client\hadoop-mapreduce-client-jobclient\src\test\java\org\apache\hadoop\mapred\SortValidator.java,545,300,24,6,13,343
 hadoop-trunk\hadoop-trunk\hadoop-yarn-project\hadoop-yarn\hadoop-yarn-server\hadoop-yarn-server-common\src\main\java\org\apache\hadoop\yarn\server\federation\store\impl\ZookeeperFederationStateStore.java,545,55,14,39,8,116
 hadoop-trunk\hadoop-trunk\hadoop-common-project\hadoop-common\src\main\java\org\apache\hadoop\fs\ChecksumFs.java,546,186,4,5,1,196
 hadoop-trunk\hadoop-trunk\hadoop-tools\hadoop-distcp\src\test\java\org\apache\hadoop\tools\TestIntegration.java,546,163,3,10,6,182
 hadoop-trunk\hadoop-trunk\hadoop-common-project\hadoop-common\src\test\java\org\apache\hadoop\util\TestSysInfoLinux.java,546,348,9,22,64,443
 hadoop-trunk\hadoop-trunk\hadoop-hdfs-project\hadoop-hdfs\src\test\java\org\apache\hadoop\hdfs\TestLeaseRecovery.java,546,75,11,7,6,99
 zookeeper-master\zookeeper-master\zookeeper-metrics-providers\zookeeper-prometheus-metrics\src\main\java\org\apache\zookeeper\metrics\prometheus\PrometheusMetricsProvider.java,546,0,3,60,1,64
 hadoop-trunk\hadoop-trunk\hadoop-yarn-project\hadoop-yarn\hadoop-yarn-server\hadoop-yarn-server-resourcemanager\src\test\java\org\apache\hadoop\yarn\server\resourcemanager\rmcontainer\TestRMContainerImpl.java,547,52,14,22,1,89
 hadoop-trunk\hadoop-trunk\hadoop-hdfs-project\hadoop-hdfs-rbf\src\test\java\org\apache\hadoop\hdfs\server\federation\store\TestStateStoreMembershipState.java,547,39,4,17,1,61
 hadoop-trunk\hadoop-trunk\hadoop-yarn-project\hadoop-yarn\hadoop-yarn-client\src\test\java\org\apache\hadoop\yarn\client\api\async\impl\TestAMRMClientAsync.java,548,134,18,2,12,166
 kafka-trunk\kafka-trunk\metadata\src\main\java\org\apache\kafka\controller\BrokerHeartbeatManager.java,548,0,4,66,0,70
 kafka-trunk\kafka-trunk\clients\src\main\java\org\apache\kafka\clients\FetchSessionHandler.java,548,0,15,88,5,108
 dubbo-3.0\dubbo-3.0\dubbo-cluster\src\test\java\org\apache\dubbo\rpc\cluster\router\state\BitListTest.java,549,134,0,69,0,203
 hadoop-trunk\hadoop-trunk\hadoop-common-project\hadoop-common\src\test\java\org\apache\hadoop\fs\contract\AbstractContractSeekTest.java,549,84,17,6,3,110
 kafka-trunk\kafka-trunk\clients\src\generated\java\org\apache\kafka\common\message\DescribeLogDirsRequestData.java,549,0,0,47,8,55
 hadoop-trunk\hadoop-trunk\hadoop-tools\hadoop-aws\src\main\java\org\apache\hadoop\fs\s3a\impl\RenameOperation.java,550,25,3,3,3,34
 hadoop-trunk\hadoop-trunk\hadoop-mapreduce-project\hadoop-mapreduce-client\hadoop-mapreduce-client-jobclient\src\test\java\org\apache\hadoop\mapred\TestTextInputFormat.java,550,250,44,8,12,314
 kafka-trunk\kafka-trunk\connect\runtime\src\test\java\org\apache\kafka\connect\runtime\WorkerConnectorTest.java,550,0,3,33,3,39
 kafka-trunk\kafka-trunk\storage\src\generated\java\org\apache\kafka\server\log\remote\metadata\storage\generated\RemoteLogSegmentMetadataUpdateRecord.java,550,0,0,49,13,62
 pulsar-master\pulsar-master\pulsar-broker\src\test\java\org\apache\pulsar\client\impl\UnAcknowledgedMessagesTimeoutTest.java,550,136,27,59,0,222
 hadoop-trunk\hadoop-trunk\hadoop-yarn-project\hadoop-yarn\hadoop-yarn-api\src\main\java\org\apache\hadoop\yarn\api\records\ApplicationSubmissionContext.java,551,148,0,6,0,154
 hadoop-trunk\hadoop-trunk\hadoop-hdfs-project\hadoop-hdfs\src\test\java\org\apache\hadoop\hdfs\StripedFileTestUtil.java,551,133,12,5,3,153
 hadoop-trunk\hadoop-trunk\hadoop-yarn-project\hadoop-yarn\hadoop-yarn-common\src\test\java\org\apache\hadoop\yarn\util\resource\TestResourceUtils.java,551,83,9,1,6,99
 pulsar-master\pulsar-master\pulsar-broker-common\src\main\java\org\apache\pulsar\broker\authorization\PulsarAuthorizationProvider.java,551,260,7,149,0,416
 pulsar-master\pulsar-master\pulsar-common\src\main\java\org\apache\pulsar\common\util\collections\ConcurrentOpenHashSet.java,551,170,24,16,0,210
 pulsar-master\pulsar-master\pulsar-functions\utils\src\test\java\org\apache\pulsar\functions\utils\FunctionConfigUtilsTest.java,551,169,8,101,0,278
 dubbo-3.0\dubbo-3.0\dubbo-common\src\main\java\org\apache\dubbo\common\config\configcenter\file\FileSystemDynamicConfiguration.java,552,185,9,55,3,252
 hadoop-trunk\hadoop-trunk\hadoop-common-project\hadoop-common\src\main\java\org\apache\hadoop\fs\shell\PathData.java,552,127,26,3,0,156
 hadoop-trunk\hadoop-trunk\hadoop-tools\hadoop-fs2img\src\main\java\org\apache\hadoop\hdfs\server\namenode\ImageWriter.java,552,143,76,3,0,222
 hadoop-trunk\hadoop-trunk\hadoop-common-project\hadoop-common\src\test\java\org\apache\hadoop\util\TestGSet.java,552,213,10,4,5,232
 zookeeper-master\zookeeper-master\zookeeper-server\src\test\java\org\apache\zookeeper\test\ZooKeeperQuotaTest.java,552,0,64,56,0,120
 hadoop-trunk\hadoop-trunk\hadoop-hdfs-project\hadoop-hdfs\src\test\java\org\apache\hadoop\hdfs\server\namenode\ha\TestPipelinesFailover.java,553,155,10,11,0,176
 dubbo-3.0\dubbo-3.0\dubbo-registry\dubbo-registry-api\src\main\java\org\apache\dubbo\registry\client\InstanceAddressURL.java,554,136,5,25,0,166
 kafka-trunk\kafka-trunk\clients\src\generated\java\org\apache\kafka\common\message\BeginQuorumEpochRequestData.java,554,0,0,50,11,61
 pulsar-master\pulsar-master\pulsar-broker\src\test\java\org\apache\pulsar\client\impl\ReaderTest.java,554,111,23,64,0,198
 rocketmq-develop\rocketmq-develop\store\src\main\java\org\apache\rocketmq\store\MappedFile.java,555,177,29,49,3,258
 dubbo-3.0\dubbo-3.0\dubbo-config\dubbo-config-api\src\main\java\org\apache\dubbo\config\ReferenceConfig.java,557,116,7,70,0,193
 hadoop-trunk\hadoop-trunk\hadoop-yarn-project\hadoop-yarn\hadoop-yarn-api\src\main\java\org\apache\hadoop\yarn\api\records\timelineservice\TimelineEntity.java,557,155,10,1,12,178
 hadoop-trunk\hadoop-trunk\hadoop-hdfs-project\hadoop-hdfs\src\test\java\org\apache\hadoop\hdfs\server\namenode\TestINodeAttributeProvider.java,557,65,26,3,5,99
 pulsar-master\pulsar-master\pulsar-common\src\test\java\org\apache\pulsar\common\util\collections\ConcurrentOpenHashMapTest.java,557,97,7,16,0,120
 hadoop-trunk\hadoop-trunk\hadoop-common-project\hadoop-common\src\test\java\org\apache\hadoop\fs\TestFsShellReturnCode.java,558,138,23,9,12,182
 hadoop-trunk\hadoop-trunk\hadoop-yarn-project\hadoop-yarn\hadoop-yarn-server\hadoop-yarn-server-resourcemanager\src\main\java\org\apache\hadoop\yarn\server\resourcemanager\RMServerUtils.java,559,88,11,3,0,102
 hadoop-trunk\hadoop-trunk\hadoop-yarn-project\hadoop-yarn\hadoop-yarn-common\src\main\java\org\apache\hadoop\yarn\api\impl\pb\service\ApplicationClientProtocolPBServiceImpl.java,559,148,135,164,0,447
 kafka-trunk\kafka-trunk\clients\src\main\java\org\apache\kafka\common\record\DefaultRecord.java,559,0,24,56,1,81
 hadoop-trunk\hadoop-trunk\hadoop-common-project\hadoop-common\src\test\java\org\apache\hadoop\conf\TestReconfiguration.java,560,82,30,2,3,117
 pulsar-master\pulsar-master\pulsar-broker-common\src\main\java\org\apache\pulsar\broker\authorization\AuthorizationService.java,560,336,11,154,0,501
 rocketmq-develop\rocketmq-develop\filter\src\test\java\org\apache\rocketmq\filter\ExpressionTest.java,560,125,28,4,3,160
 hadoop-trunk\hadoop-trunk\hadoop-yarn-project\hadoop-yarn\hadoop-yarn-server\hadoop-yarn-server-resourcemanager\src\main\java\org\apache\hadoop\yarn\server\resourcemanager\reservation\RLESparseResourceAllocation.java,561,61,12,2,2,77
 hadoop-trunk\hadoop-trunk\hadoop-yarn-project\hadoop-yarn\hadoop-yarn-server\hadoop-yarn-server-resourcemanager\src\main\java\org\apache\hadoop\yarn\server\resourcemanager\scheduler\distributed\NodeQueueLoadMonitor.java,561,106,13,5,2,126
 kafka-trunk\kafka-trunk\streams\src\test\java\org\apache\kafka\streams\processor\internals\StandbyTaskTest.java,561,0,4,75,4,83
 kafka-trunk\kafka-trunk\connect\runtime\src\test\java\org\apache\kafka\connect\runtime\ErrorHandlingTaskTest.java,562,0,4,84,2,90
 kafka-trunk\kafka-trunk\streams\upgrade-system-tests-28\src\test\java\org\apache\kafka\streams\tests\SmokeTestDriver.java,562,0,10,86,2,98
 kafka-trunk\kafka-trunk\connect\runtime\src\main\java\org\apache\kafka\connect\runtime\distributed\WorkerCoordinator.java,562,0,15,74,6,95
 kafka-trunk\kafka-trunk\streams\upgrade-system-tests-26\src\test\java\org\apache\kafka\streams\tests\SmokeTestDriver.java,562,0,10,86,0,96
 kafka-trunk\kafka-trunk\streams\upgrade-system-tests-25\src\test\java\org\apache\kafka\streams\tests\SmokeTestDriver.java,562,0,10,86,0,96
 kafka-trunk\kafka-trunk\streams\upgrade-system-tests-24\src\test\java\org\apache\kafka\streams\tests\SmokeTestDriver.java,562,0,10,86,0,96
 kafka-trunk\kafka-trunk\streams\upgrade-system-tests-23\src\test\java\org\apache\kafka\streams\tests\SmokeTestDriver.java,562,0,10,86,0,96
 kafka-trunk\kafka-trunk\streams\upgrade-system-tests-30\src\test\java\org\apache\kafka\streams\tests\SmokeTestDriver.java,562,0,10,86,0,96
 kafka-trunk\kafka-trunk\streams\upgrade-system-tests-31\src\test\java\org\apache\kafka\streams\tests\SmokeTestDriver.java,562,0,10,86,0,96
 kafka-trunk\kafka-trunk\streams\upgrade-system-tests-27\src\test\java\org\apache\kafka\streams\tests\SmokeTestDriver.java,562,0,10,86,0,96
 kafka-trunk\kafka-trunk\streams\src\test\java\org\apache\kafka\streams\tests\SmokeTestDriver.java,562,0,10,86,0,96
 pulsar-master\pulsar-master\pulsar-broker\src\test\java\org\apache\pulsar\broker\service\InactiveTopicDeleteTest.java,562,185,19,123,0,327
 hadoop-trunk\hadoop-trunk\hadoop-yarn-project\hadoop-yarn\hadoop-yarn-server\hadoop-yarn-server-resourcemanager\src\test\java\org\apache\hadoop\yarn\server\resourcemanager\scheduler\capacity\TestCapacitySchedulerWeightMode.java,563,133,3,18,1,155
 skywalking-master\skywalking-master\oap-server\server-alarm-plugin\src\test\java\org\apache\skywalking\oap\server\core\alarm\provider\RunningRuleTest.java,563,182,19,42,0,243
 rocketmq-develop\rocketmq-develop\common\src\main\java\org\apache\rocketmq\common\UtilAll.java,564,146,10,25,9,190
 hadoop-trunk\hadoop-trunk\hadoop-hdfs-project\hadoop-hdfs\src\test\java\org\apache\hadoop\hdfs\web\TestWebHdfsFileSystemContract.java,565,112,31,6,3,152
 kafka-trunk\kafka-trunk\clients\src\generated\java\org\apache\kafka\common\message\AlterPartitionReassignmentsRequestData.java,565,0,0,55,12,67
 hadoop-trunk\hadoop-trunk\hadoop-hdfs-project\hadoop-hdfs\src\test\java\org\apache\hadoop\hdfs\server\blockmanagement\TestBlockTokenWithDFS.java,566,85,5,8,3,101
 hadoop-trunk\hadoop-trunk\hadoop-mapreduce-project\hadoop-mapreduce-client\hadoop-mapreduce-client-jobclient\src\test\java\org\apache\hadoop\io\FileBench.java,566,128,28,1,3,160
 kafka-trunk\kafka-trunk\streams\src\main\java\org\apache\kafka\streams\StreamsBuilder.java,566,0,0,188,2,190
 zookeeper-master\zookeeper-master\zookeeper-contrib\zookeeper-contrib-zooinspector\src\main\java\org\apache\zookeeper\inspector\gui\ZooInspectorNodeViewersDialog.java,566,0,39,34,9,82
 hadoop-trunk\hadoop-trunk\hadoop-hdfs-project\hadoop-hdfs\src\test\java\org\apache\hadoop\hdfs\server\namenode\TestProtectedDirectories.java,567,50,22,3,0,75
 hadoop-trunk\hadoop-trunk\hadoop-hdfs-project\hadoop-hdfs\src\main\java\org\apache\hadoop\hdfs\server\datanode\fsdataset\impl\FsDatasetCache.java,567,115,17,10,3,145
 kafka-trunk\kafka-trunk\clients\src\test\java\org\apache\kafka\common\config\AbstractConfigTest.java,567,0,8,138,2,148
 hadoop-trunk\hadoop-trunk\hadoop-yarn-project\hadoop-yarn\hadoop-yarn-common\src\main\java\org\apache\hadoop\yarn\webapp\util\WebAppUtils.java,568,145,8,8,3,164
 hadoop-trunk\hadoop-trunk\hadoop-hdfs-project\hadoop-hdfs\src\main\java\org\apache\hadoop\hdfs\server\namenode\snapshot\FSImageFormatPBSnapshot.java,569,118,77,13,4,212
 hadoop-trunk\hadoop-trunk\hadoop-hdfs-project\hadoop-hdfs\src\test\java\org\apache\hadoop\hdfs\server\namenode\TestNameEditsConfigs.java,569,119,9,25,16,169
 kafka-trunk\kafka-trunk\connect\runtime\src\test\java\org\apache\kafka\connect\util\TopicCreationTest.java,569,0,0,160,0,160
 kafka-trunk\kafka-trunk\clients\src\generated\java\org\apache\kafka\common\message\LeaveGroupResponseData.java,569,0,0,59,7,66
 rocketmq-develop\rocketmq-develop\remoting\src\main\java\org\apache\rocketmq\remoting\netty\NettyRemotingAbstract.java,569,130,31,89,2,252
 hadoop-trunk\hadoop-trunk\hadoop-hdfs-project\hadoop-hdfs\src\main\java\org\apache\hadoop\hdfs\server\namenode\ha\EditLogTailer.java,570,84,12,20,4,120
 zookeeper-master\zookeeper-master\zookeeper-server\src\main\java\org\apache\zookeeper\server\quorum\CommitProcessor.java,570,0,9,80,0,89
 zookeeper-master\zookeeper-master\zookeeper-server\src\test\java\org\apache\zookeeper\server\PurgeTxnTest.java,570,0,26,82,14,122
 hadoop-trunk\hadoop-trunk\hadoop-yarn-project\hadoop-yarn\hadoop-yarn-server\hadoop-yarn-server-resourcemanager\src\test\java\org\apache\hadoop\yarn\server\resourcemanager\metrics\TestSystemMetricsPublisher.java,571,53,0,13,3,69
 hadoop-trunk\hadoop-trunk\hadoop-hdfs-project\hadoop-hdfs\src\main\java\org\apache\hadoop\hdfs\server\datanode\BlockRecoveryWorker.java,571,101,18,7,1,127
 hadoop-trunk\hadoop-trunk\hadoop-mapreduce-project\hadoop-mapreduce-client\hadoop-mapreduce-client-app\src\main\java\org\apache\hadoop\mapreduce\v2\app\speculate\DefaultSpeculator.java,571,119,13,9,3,144
 pulsar-master\pulsar-master\pulsar-broker\src\test\java\org\apache\pulsar\broker\service\ReplicatorSubscriptionTest.java,571,150,3,105,0,258
 pulsar-master\pulsar-master\pulsar-broker\src\test\java\org\apache\pulsar\client\api\ConsumerBatchReceiveTest.java,571,281,9,72,0,362
 hadoop-trunk\hadoop-trunk\hadoop-hdfs-project\hadoop-hdfs\src\test\java\org\apache\hadoop\hdfs\server\datanode\fsdataset\impl\TestProvidedImpl.java,572,90,16,5,11,122
 hadoop-trunk\hadoop-trunk\hadoop-yarn-project\hadoop-yarn\hadoop-yarn-server\hadoop-yarn-server-router\src\test\java\org\apache\hadoop\yarn\server\router\clientrm\TestFederationClientInterceptor.java,572,28,3,7,0,38
 kafka-trunk\kafka-trunk\streams\upgrade-system-tests-22\src\test\java\org\apache\kafka\streams\tests\SmokeTestDriver.java,572,0,12,87,0,99
 hadoop-trunk\hadoop-trunk\hadoop-yarn-project\hadoop-yarn\hadoop-yarn-server\hadoop-yarn-server-web-proxy\src\test\java\org\apache\hadoop\yarn\server\webproxy\TestProxyCA.java,573,50,7,1,3,61
 hadoop-trunk\hadoop-trunk\hadoop-hdfs-project\hadoop-hdfs-client\src\main\java\org\apache\hadoop\hdfs\DeadNodeDetector.java,573,77,11,16,1,105
 hadoop-trunk\hadoop-trunk\hadoop-hdfs-project\hadoop-hdfs\src\test\java\org\apache\hadoop\hdfs\server\namenode\FSImageTestUtil.java,574,166,24,8,11,209
 kafka-trunk\kafka-trunk\clients\src\main\java\org\apache\kafka\common\record\AbstractLegacyRecordBatch.java,574,0,27,54,0,81
 hadoop-trunk\hadoop-trunk\hadoop-hdfs-project\hadoop-hdfs\src\test\java\org\apache\hadoop\hdfs\server\namenode\TestListCorruptFileBlocks.java,576,123,36,9,3,171
 hadoop-trunk\hadoop-trunk\hadoop-mapreduce-project\hadoop-mapreduce-examples\src\main\java\org\apache\hadoop\examples\BaileyBorweinPlouffe.java,577,203,30,3,2,238
 kafka-trunk\kafka-trunk\clients\src\main\java\org\apache\kafka\clients\Metadata.java,577,0,22,100,1,123
 hadoop-trunk\hadoop-trunk\hadoop-hdfs-project\hadoop-hdfs-rbf\src\test\java\org\apache\hadoop\hdfs\server\federation\store\driver\TestStateStoreDriverBase.java,578,85,10,4,4,103
 hadoop-trunk\hadoop-trunk\hadoop-hdfs-project\hadoop-hdfs\src\test\java\org\apache\hadoop\hdfs\TestDataTransferProtocol.java,578,176,50,11,1,238
 hadoop-trunk\hadoop-trunk\hadoop-hdfs-project\hadoop-hdfs\src\test\java\org\apache\hadoop\hdfs\shortcircuit\TestShortCircuitLocalRead.java,578,249,11,1,3,264
 hadoop-trunk\hadoop-trunk\hadoop-hdfs-project\hadoop-hdfs\src\test\java\org\apache\hadoop\hdfs\TestDFSInotifyEventInputStream.java,579,84,56,39,4,183
 hadoop-trunk\hadoop-trunk\hadoop-yarn-project\hadoop-yarn\hadoop-yarn-server\hadoop-yarn-server-resourcemanager\src\main\java\org\apache\hadoop\yarn\server\resourcemanager\monitor\capacity\FifoIntraQueuePreemptionPlugin.java,579,65,15,14,1,95
 hadoop-trunk\hadoop-trunk\hadoop-hdfs-project\hadoop-hdfs\src\test\java\org\apache\hadoop\hdfs\TestLeaseRecovery2.java,579,156,28,2,9,195
 kafka-trunk\kafka-trunk\clients\src\main\java\org\apache\kafka\common\protocol\types\Struct.java,579,0,32,13,2,47
 kafka-trunk\kafka-trunk\clients\src\generated\java\org\apache\kafka\common\message\OffsetDeleteRequestData.java,579,0,0,57,11,68
 rocketmq-develop\rocketmq-develop\store\src\main\java\org\apache\rocketmq\store\ConsumeQueueExt.java,579,132,21,40,4,197
 hadoop-trunk\hadoop-trunk\hadoop-tools\hadoop-aws\src\test\java\org\apache\hadoop\fs\s3a\scale\ITestS3AInputStreamPerformance.java,580,89,22,9,0,120
 hadoop-trunk\hadoop-trunk\hadoop-yarn-project\hadoop-yarn\hadoop-yarn-server\hadoop-yarn-server-resourcemanager\src\test\java\org\apache\hadoop\yarn\server\resourcemanager\reservation\TestRLESparseResourceAllocation.java,580,358,78,4,9,449
 kafka-trunk\kafka-trunk\clients\src\generated\java\org\apache\kafka\common\message\ListGroupsResponseData.java,580,0,0,61,8,69
 pulsar-master\pulsar-master\pulsar-broker\src\test\java\org\apache\pulsar\broker\namespace\NamespaceServiceTest.java,580,164,20,129,0,313
 hadoop-trunk\hadoop-trunk\hadoop-common-project\hadoop-common\src\main\java\org\apache\hadoop\net\unix\DomainSocket.java,581,95,5,3,4,107
 hadoop-trunk\hadoop-trunk\hadoop-yarn-project\hadoop-yarn\hadoop-yarn-server\hadoop-yarn-server-nodemanager\src\test\java\org\apache\hadoop\yarn\server\nodemanager\containermanager\linux\resources\TestCGroupsHandlerImpl.java,581,23,21,5,6,55
 hadoop-trunk\hadoop-trunk\hadoop-mapreduce-project\hadoop-mapreduce-client\hadoop-mapreduce-client-app\src\main\java\org\apache\hadoop\mapred\LocalContainerLauncher.java,581,93,34,6,5,138
 kafka-trunk\kafka-trunk\streams\src\main\java\org\apache\kafka\streams\processor\internals\TopologyMetadata.java,582,0,9,108,1,118
 pulsar-master\pulsar-master\pulsar-common\src\main\java\org\apache\pulsar\common\util\collections\ConcurrentLongHashMap.java,582,208,24,32,0,264
 hadoop-trunk\hadoop-trunk\hadoop-tools\hadoop-streaming\src\main\java\org\apache\hadoop\streaming\PipeMapRed.java,583,238,51,10,6,305
 hadoop-trunk\hadoop-trunk\hadoop-yarn-project\hadoop-yarn\hadoop-yarn-server\hadoop-yarn-server-resourcemanager\src\test\java\org\apache\hadoop\yarn\server\resourcemanager\scheduler\capacity\TestCapacitySchedulerConfigValidator.java,583,93,15,28,0,136
 hadoop-trunk\hadoop-trunk\hadoop-mapreduce-project\hadoop-mapreduce-client\hadoop-mapreduce-client-core\src\main\java\org\apache\hadoop\mapred\ReduceTask.java,583,251,44,10,20,325
 hadoop-trunk\hadoop-trunk\hadoop-hdfs-project\hadoop-hdfs\src\test\java\org\apache\hadoop\hdfs\server\namenode\ha\TestDNFencing.java,583,116,12,7,1,136
 hadoop-trunk\hadoop-trunk\hadoop-common-project\hadoop-common\src\test\java\org\apache\hadoop\test\TestLambdaTestUtils.java,584,61,2,1,1,65
 hadoop-trunk\hadoop-trunk\hadoop-mapreduce-project\hadoop-mapreduce-client\hadoop-mapreduce-client-core\src\test\java\org\apache\hadoop\mapred\TestFileOutputCommitter.java,584,96,45,2,7,150
 rocketmq-develop\rocketmq-develop\store\src\main\java\org\apache\rocketmq\store\ha\HAService.java,584,118,25,47,7,197
 hadoop-trunk\hadoop-trunk\hadoop-common-project\hadoop-common\src\main\java\org\apache\hadoop\util\DataChecksum.java,585,368,16,3,0,387
 kafka-trunk\kafka-trunk\streams\src\test\java\org\apache\kafka\streams\state\internals\ThreadCacheTest.java,585,0,9,105,17,131
 zookeeper-master\zookeeper-master\zookeeper-contrib\zookeeper-contrib-zooinspector\src\main\java\org\apache\zookeeper\inspector\gui\ZooInspectorTreeView.java,585,0,10,81,1,92
 hadoop-trunk\hadoop-trunk\hadoop-yarn-project\hadoop-yarn\hadoop-yarn-server\hadoop-yarn-server-nodemanager\src\test\java\org\apache\hadoop\yarn\server\nodemanager\recovery\NMMemoryStateStoreService.java,586,157,20,10,0,187
 hadoop-trunk\hadoop-trunk\hadoop-hdfs-project\hadoop-hdfs\src\test\java\org\apache\hadoop\net\TestNetworkTopology.java,586,203,75,2,2,282
 kafka-trunk\kafka-trunk\streams\src\test\java\org\apache\kafka\streams\state\internals\CachingInMemoryKeyValueStoreTest.java,586,0,7,30,33,70
 kafka-trunk\kafka-trunk\clients\src\generated\java\org\apache\kafka\common\message\VoteResponseData.java,586,0,0,46,10,56
 hadoop-trunk\hadoop-trunk\hadoop-common-project\hadoop-common\src\main\java\org\apache\hadoop\util\PureJavaCrc32.java,587,606,4,12,8,630
 hadoop-trunk\hadoop-trunk\hadoop-hdfs-project\hadoop-hdfs\src\main\java\org\apache\hadoop\hdfs\server\namenode\snapshot\DirectorySnapshottableFeature.java,587,78,7,3,2,90
 hadoop-trunk\hadoop-trunk\hadoop-tools\hadoop-aws\src\test\java\org\apache\hadoop\fs\s3a\commit\ITestCommitOperations.java,587,44,10,3,1,58
 hadoop-trunk\hadoop-trunk\hadoop-mapreduce-project\hadoop-mapreduce-client\hadoop-mapreduce-client-app\src\test\java\org\apache\hadoop\mapreduce\v2\app\TestMRApp.java,587,101,3,5,1,110
 zookeeper-master\zookeeper-master\zookeeper-server\src\test\java\org\apache\zookeeper\server\quorum\CommitProcessorConcurrencyTest.java,587,0,67,89,1,157
 hadoop-trunk\hadoop-trunk\hadoop-common-project\hadoop-common\src\test\java\org\apache\hadoop\metrics2\impl\TestMetricsSystemImpl.java,588,129,32,4,2,167
 pulsar-master\pulsar-master\pulsar-functions\worker\src\main\java\org\apache\pulsar\functions\worker\PulsarWorkerService.java,588,163,20,92,0,275
 hadoop-trunk\hadoop-trunk\hadoop-common-project\hadoop-common\src\test\java\org\apache\hadoop\fs\shell\TestCount.java,590,72,25,2,1,100
 hadoop-trunk\hadoop-trunk\hadoop-yarn-project\hadoop-yarn\hadoop-yarn-server\hadoop-yarn-server-timelineservice-hbase\hadoop-yarn-server-timelineservice-hbase-client\src\main\java\org\apache\hadoop\yarn\server\timelineservice\storage\HBaseTimelineWriterImpl.java,590,111,11,39,0,161
 pulsar-master\pulsar-master\pulsar-common\src\main\java\org\apache\pulsar\common\protocol\PulsarDecoder.java,590,176,1,56,0,233
 hadoop-trunk\hadoop-trunk\hadoop-hdfs-project\hadoop-hdfs-client\src\main\java\org\apache\hadoop\hdfs\client\HdfsAdmin.java,591,60,1,2,0,63
 hadoop-trunk\hadoop-trunk\hadoop-hdfs-project\hadoop-hdfs-client\src\main\java\org\apache\hadoop\hdfs\shortcircuit\ShortCircuitShm.java,592,120,26,3,0,149
 kafka-trunk\kafka-trunk\streams\src\test\java\org\apache\kafka\streams\integration\PositionRestartIntegrationTest.java,592,0,2,63,6,71
 pulsar-master\pulsar-master\pulsar-broker\src\test\java\org\apache\pulsar\broker\service\PersistentDispatcherFailoverConsumerTest.java,592,182,7,93,0,282
 hadoop-trunk\hadoop-trunk\hadoop-yarn-project\hadoop-yarn\hadoop-yarn-server\hadoop-yarn-server-resourcemanager\src\main\java\org\apache\hadoop\yarn\server\resourcemanager\webapp\dao\AppInfo.java,593,292,8,5,10,315
 hadoop-trunk\hadoop-trunk\hadoop-tools\hadoop-sls\src\main\java\org\apache\hadoop\yarn\sls\web\SLSWebApp.java,593,190,20,6,1,217
 rocketmq-develop\rocketmq-develop\store\src\main\java\org\apache\rocketmq\store\MappedFileQueue.java,593,156,23,44,7,230
 hadoop-trunk\hadoop-trunk\hadoop-tools\hadoop-azure\src\test\java\org\apache\hadoop\fs\azure\MockStorageInterface.java,594,201,22,24,6,253
 hadoop-trunk\hadoop-trunk\hadoop-hdfs-project\hadoop-hdfs-rbf\src\test\java\org\apache\hadoop\hdfs\server\federation\router\TestRouterFaultTolerant.java,594,53,4,13,1,71
 hadoop-trunk\hadoop-trunk\hadoop-yarn-project\hadoop-yarn\hadoop-yarn-server\hadoop-yarn-server-web-proxy\src\test\java\org\apache\hadoop\yarn\server\webproxy\TestWebAppProxyServlet.java,594,103,16,7,2,128
 hadoop-trunk\hadoop-trunk\hadoop-yarn-project\hadoop-yarn\hadoop-yarn-common\src\test\java\org\apache\hadoop\yarn\nodelabels\TestCommonNodeLabelsManager.java,595,83,37,14,1,135
 hadoop-trunk\hadoop-trunk\hadoop-common-project\hadoop-common\src\test\java\org\apache\hadoop\util\TestWinUtils.java,595,79,6,8,20,113
 hadoop-trunk\hadoop-trunk\hadoop-yarn-project\hadoop-yarn\hadoop-yarn-common\src\main\java\org\apache\hadoop\yarn\logaggregation\filecontroller\LogAggregationFileController.java,596,75,18,4,4,101
 hadoop-trunk\hadoop-trunk\hadoop-hdfs-project\hadoop-hdfs\src\test\java\org\apache\hadoop\hdfs\TestFileChecksum.java,596,106,14,2,2,124
 hadoop-trunk\hadoop-trunk\hadoop-hdfs-project\hadoop-hdfs-client\src\test\java\org\apache\hadoop\hdfs\util\TestByteArrayManager.java,596,188,3,10,2,203
 dubbo-3.0\dubbo-3.0\dubbo-common\src\main\java\org\apache\dubbo\common\utils\UrlUtils.java,597,146,6,81,0,233
 dubbo-3.0\dubbo-3.0\dubbo-config\dubbo-config-api\src\main\java\org\apache\dubbo\config\utils\ConfigValidationUtils.java,597,212,10,105,0,327
 hadoop-trunk\hadoop-trunk\hadoop-yarn-project\hadoop-yarn\hadoop-yarn-server\hadoop-yarn-server-resourcemanager\src\main\java\org\apache\hadoop\yarn\server\resourcemanager\scheduler\activities\ActivitiesManager.java,597,139,16,5,2,162
 hadoop-trunk\hadoop-trunk\hadoop-mapreduce-project\hadoop-mapreduce-client\hadoop-mapreduce-client-app\src\test\java\org\apache\hadoop\mapreduce\v2\app\MockJobs.java,598,126,5,6,9,146
 hadoop-trunk\hadoop-trunk\hadoop-yarn-project\hadoop-yarn\hadoop-yarn-server\hadoop-yarn-server-resourcemanager\src\test\java\org\apache\hadoop\yarn\server\resourcemanager\scheduler\fair\TestQueuePlacementPolicy.java,598,38,2,4,4,48
 hadoop-trunk\hadoop-trunk\hadoop-mapreduce-project\hadoop-mapreduce-client\hadoop-mapreduce-client-core\src\main\java\org\apache\hadoop\mapred\TaskLog.java,598,181,9,2,1,193
 kafka-trunk\kafka-trunk\streams\src\test\java\org\apache\kafka\streams\state\internals\AbstractKeyValueStoreTest.java,598,0,19,59,17,95
 kafka-trunk\kafka-trunk\streams\src\test\java\org\apache\kafka\streams\tests\EosTestDriver.java,598,0,11,185,3,199
 kafka-trunk\kafka-trunk\clients\src\main\java\org\apache\kafka\clients\consumer\ConsumerConfig.java,598,0,3,147,0,150
 hadoop-trunk\hadoop-trunk\hadoop-mapreduce-project\hadoop-mapreduce-client\hadoop-mapreduce-client-core\src\test\java\org\apache\hadoop\mapreduce\lib\input\TestLineRecordReader.java,599,106,18,5,4,133
 hadoop-trunk\hadoop-trunk\hadoop-hdfs-project\hadoop-hdfs\src\test\java\org\apache\hadoop\hdfs\client\impl\TestBlockReaderFactory.java,599,78,36,9,12,135
 hadoop-trunk\hadoop-trunk\hadoop-yarn-project\hadoop-yarn\hadoop-yarn-server\hadoop-yarn-server-resourcemanager\src\main\java\org\apache\hadoop\yarn\server\resourcemanager\RMContextImpl.java,599,188,4,26,3,221
 kafka-trunk\kafka-trunk\clients\src\generated\java\org\apache\kafka\common\message\EndQuorumEpochRequestData.java,599,0,0,55,13,68
 kafka-trunk\kafka-trunk\clients\src\generated\java\org\apache\kafka\common\message\ElectLeadersRequestData.java,599,0,0,54,8,62
 hadoop-trunk\hadoop-trunk\hadoop-mapreduce-project\hadoop-mapreduce-client\hadoop-mapreduce-client-app\src\test\java\org\apache\hadoop\mapreduce\v2\app\webapp\TestAMWebServicesAttempts.java,600,83,4,9,11,107
 pulsar-master\pulsar-master\pulsar-testclient\src\main\java\org\apache\pulsar\testclient\PerformanceConsumer.java,600,269,19,118,0,406
 zookeeper-master\zookeeper-master\zookeeper-server\src\main\java\org\apache\zookeeper\server\FinalRequestProcessor.java,600,0,107,76,1,184
 rocketmq-develop\rocketmq-develop\client\src\test\java\org\apache\rocketmq\client\consumer\DefaultLitePullConsumerTest.java,601,205,37,108,3,353
 hadoop-trunk\hadoop-trunk\hadoop-tools\hadoop-federation-balance\src\main\java\org\apache\hadoop\tools\fedbalance\DistCpProcedure.java,602,69,13,3,1,86
 kafka-trunk\kafka-trunk\clients\src\test\java\org\apache\kafka\common\KafkaFutureTest.java,602,0,3,97,3,103
 dubbo-3.0\dubbo-3.0\dubbo-rpc\dubbo-rpc-api\src\main\java\org\apache\dubbo\rpc\RpcServiceContext.java,603,104,6,19,12,141
 hadoop-trunk\hadoop-trunk\hadoop-hdfs-project\hadoop-hdfs\src\test\java\org\apache\hadoop\hdfs\TestDFSStripedInputStream.java,603,50,13,3,15,81
 hadoop-trunk\hadoop-trunk\hadoop-yarn-project\hadoop-yarn\hadoop-yarn-server\hadoop-yarn-server-resourcemanager\src\test\java\org\apache\hadoop\yarn\server\resourcemanager\scheduler\distributed\TestCentralizedOpportunisticContainerAllocator.java,603,114,12,1,2,129
 pulsar-master\pulsar-master\pulsar-functions\utils\src\main\java\org\apache\pulsar\functions\utils\SinkConfigUtils.java,603,149,19,127,0,295
 hadoop-trunk\hadoop-trunk\hadoop-common-project\hadoop-common\src\main\java\org\apache\hadoop\util\PureJavaCrc32C.java,604,630,1,8,8,647
 kafka-trunk\kafka-trunk\clients\src\main\java\org\apache\kafka\common\metrics\Metrics.java,604,0,8,122,3,133
 kafka-trunk\kafka-trunk\connect\runtime\src\main\java\org\apache\kafka\connect\storage\KafkaStatusBackingStore.java,604,0,17,82,1,100
 dubbo-3.0\dubbo-3.0\dubbo-registry\dubbo-registry-nacos\src\main\java\org\apache\dubbo\registry\nacos\NacosRegistry.java,605,157,10,69,0,236
 hadoop-trunk\hadoop-trunk\hadoop-yarn-project\hadoop-yarn\hadoop-yarn-server\hadoop-yarn-server-resourcemanager\src\test\java\org\apache\hadoop\yarn\server\resourcemanager\webapp\TestRMWebServicesNodeLabels.java,605,138,1,48,0,187
 hadoop-trunk\hadoop-trunk\hadoop-yarn-project\hadoop-yarn\hadoop-yarn-server\hadoop-yarn-server-nodemanager\src\main\java\org\apache\hadoop\yarn\server\nodemanager\webapp\NMWebServices.java,606,87,5,12,6,110
 hadoop-trunk\hadoop-trunk\hadoop-mapreduce-project\hadoop-mapreduce-client\hadoop-mapreduce-client-jobclient\src\test\java\org\apache\hadoop\mapred\TestClientRedirect.java,606,99,18,36,2,155
 hadoop-trunk\hadoop-trunk\hadoop-yarn-project\hadoop-yarn\hadoop-yarn-server\hadoop-yarn-server-resourcemanager\src\test\java\org\apache\hadoop\yarn\server\resourcemanager\scheduler\TestQueueMetricsForCustomResources.java,607,112,6,23,2,143
 hadoop-trunk\hadoop-trunk\hadoop-tools\hadoop-azure\src\test\java\org\apache\hadoop\fs\azure\ITestWasbUriAndConfiguration.java,607,100,17,11,7,135
 hadoop-trunk\hadoop-trunk\hadoop-hdfs-project\hadoop-hdfs-rbf\src\main\java\org\apache\hadoop\hdfs\server\federation\router\RouterClientMetrics.java,608,159,2,1,0,162
 hadoop-trunk\hadoop-trunk\hadoop-yarn-project\hadoop-yarn\hadoop-yarn-server\hadoop-yarn-server-nodemanager\src\test\java\org\apache\hadoop\yarn\server\nodemanager\containermanager\localizer\TestContainerLocalizer.java,608,94,16,5,14,129
 hadoop-trunk\hadoop-trunk\hadoop-tools\hadoop-distcp\src\main\java\org\apache\hadoop\tools\mapred\CopyCommitter.java,608,88,53,21,1,163
 hadoop-trunk\hadoop-trunk\hadoop-yarn-project\hadoop-yarn\hadoop-yarn-server\hadoop-yarn-server-resourcemanager\src\main\java\org\apache\hadoop\yarn\server\resourcemanager\scheduler\fair\QueueManager.java,609,114,6,2,3,125
 hadoop-trunk\hadoop-trunk\hadoop-tools\hadoop-distcp\src\main\java\org\apache\hadoop\tools\util\DistCpUtils.java,609,111,13,10,2,136
 kafka-trunk\kafka-trunk\clients\src\main\java\org\apache\kafka\common\network\KafkaChannel.java,609,0,17,100,2,119
 dubbo-3.0\dubbo-3.0\dubbo-common\src\main\java\org\apache\dubbo\config\context\AbstractConfigManager.java,610,198,15,76,3,292
 kafka-trunk\kafka-trunk\core\src\main\scala\kafka\tools\StreamsResetter.java,610,0,8,150,17,175
 zookeeper-master\zookeeper-master\zookeeper-server\src\main\java\org\apache\zookeeper\server\NettyServerCnxn.java,610,0,29,50,1,80
 hadoop-trunk\hadoop-trunk\hadoop-mapreduce-project\hadoop-mapreduce-client\hadoop-mapreduce-client-common\src\main\java\org\apache\hadoop\mapreduce\v2\jobhistory\JobHistoryUtils.java,611,169,24,27,0,220
 hadoop-trunk\hadoop-trunk\hadoop-yarn-project\hadoop-yarn\hadoop-yarn-server\hadoop-yarn-server-resourcemanager\src\test\java\org\apache\hadoop\yarn\server\resourcemanager\scheduler\constraint\TestAllocationTagsManager.java,611,69,3,2,1,75
 kafka-trunk\kafka-trunk\clients\src\main\java\org\apache\kafka\common\utils\PureJavaCrc32C.java,611,0,1,9,8,18
 rocketmq-develop\rocketmq-develop\store\src\main\java\org\apache\rocketmq\store\ConsumeQueue.java,611,172,19,71,1,263
 hadoop-trunk\hadoop-trunk\hadoop-yarn-project\hadoop-yarn\hadoop-yarn-api\src\main\java\org\apache\hadoop\yarn\api\records\ResourceRequest.java,612,93,10,3,2,108
 hadoop-trunk\hadoop-trunk\hadoop-yarn-project\hadoop-yarn\hadoop-yarn-common\src\main\java\org\apache\hadoop\yarn\util\resource\DominantResourceCalculator.java,612,108,3,2,0,113
 hadoop-trunk\hadoop-trunk\hadoop-hdfs-project\hadoop-hdfs\src\test\java\org\apache\hadoop\hdfs\server\blockmanagement\TestBlocksWithNotEnoughRacks.java,612,95,11,2,0,108
 hadoop-trunk\hadoop-trunk\hadoop-common-project\hadoop-common\src\main\java\org\apache\hadoop\ipc\ProtobufRpcEngine2.java,612,163,26,2,0,191
 hadoop-trunk\hadoop-trunk\hadoop-tools\hadoop-sls\src\main\java\org\apache\hadoop\yarn\sls\synthetic\SynthTraceJobProducer.java,612,336,2,7,3,348
 hadoop-trunk\hadoop-trunk\hadoop-mapreduce-project\hadoop-mapreduce-client\hadoop-mapreduce-client-hs\src\test\java\org\apache\hadoop\mapreduce\v2\hs\webapp\TestHsWebServicesAttempts.java,612,79,4,4,11,98
 pulsar-master\pulsar-master\pulsar-broker\src\test\java\org\apache\pulsar\client\impl\MultiTopicsReaderTest.java,612,142,24,64,0,230
 pulsar-master\pulsar-master\pulsar-functions\worker\src\main\java\org\apache\pulsar\functions\worker\FunctionActioner.java,612,191,15,120,0,326
 hadoop-trunk\hadoop-trunk\hadoop-hdfs-project\hadoop-hdfs\src\main\java\org\apache\hadoop\hdfs\util\LightWeightHashSet.java,613,87,9,3,0,99
 hadoop-trunk\hadoop-trunk\hadoop-common-project\hadoop-common\src\main\java\org\apache\hadoop\security\SaslRpcClient.java,613,99,59,5,0,163
 kafka-trunk\kafka-trunk\clients\src\generated\java\org\apache\kafka\common\message\CreateAclsRequestData.java,613,0,0,67,8,75
 hadoop-trunk\hadoop-trunk\hadoop-common-project\hadoop-common\src\test\java\org\apache\hadoop\security\ssl\KeyStoreTestUtil.java,614,158,10,4,8,180
 hadoop-trunk\hadoop-trunk\hadoop-hdfs-project\hadoop-hdfs\src\main\java\org\apache\hadoop\hdfs\tools\DebugAdmin.java,614,102,17,20,4,143
 rocketmq-develop\rocketmq-develop\store\src\test\java\org\apache\rocketmq\store\DefaultMessageStoreTest.java,614,205,26,84,12,327
 hadoop-trunk\hadoop-trunk\hadoop-yarn-project\hadoop-yarn\hadoop-yarn-server\hadoop-yarn-server-nodemanager\src\test\java\org\apache\hadoop\yarn\server\nodemanager\TestLinuxContainerExecutor.java,615,91,19,14,9,133
 hadoop-trunk\hadoop-trunk\hadoop-hdfs-project\hadoop-hdfs\src\test\java\org\apache\hadoop\hdfs\qjournal\server\TestJournalNode.java,615,160,61,9,3,233
 hadoop-trunk\hadoop-trunk\hadoop-yarn-project\hadoop-yarn\hadoop-yarn-client\src\test\java\org\apache\hadoop\yarn\client\api\impl\TestNMClient.java,616,103,7,5,0,115
 hadoop-trunk\hadoop-trunk\hadoop-hdfs-project\hadoop-hdfs\src\test\java\org\apache\hadoop\hdfs\server\namenode\ha\TestStandbyCheckpoints.java,616,155,5,7,7,174
 hadoop-trunk\hadoop-trunk\hadoop-hdfs-project\hadoop-hdfs\src\main\java\org\apache\hadoop\hdfs\tools\ECAdmin.java,617,71,15,1,2,89
 zookeeper-master\zookeeper-master\zookeeper-server\src\test\java\org\apache\zookeeper\server\ZooKeeperServerMainTest.java,617,0,60,85,8,153
 hadoop-trunk\hadoop-trunk\hadoop-yarn-project\hadoop-yarn\hadoop-yarn-client\src\test\java\org\apache\hadoop\yarn\client\api\impl\TestAMRMClientOnRMRestart.java,618,126,13,10,14,163
 hadoop-trunk\hadoop-trunk\hadoop-yarn-project\hadoop-yarn\hadoop-yarn-server\hadoop-yarn-server-nodemanager\src\main\java\org\apache\hadoop\yarn\server\nodemanager\containermanager\logaggregation\AppLogAggregatorImpl.java,619,166,22,13,16,217
 hadoop-trunk\hadoop-trunk\hadoop-common-project\hadoop-common\src\test\java\org\apache\hadoop\fs\loadGenerator\LoadGenerator.java,619,301,35,8,36,380
 kafka-trunk\kafka-trunk\clients\src\generated\java\org\apache\kafka\common\message\VoteRequestData.java,619,0,0,53,11,64
 kafka-trunk\kafka-trunk\streams\src\main\java\org\apache\kafka\streams\processor\internals\StateDirectory.java,619,0,16,114,0,130
 pulsar-master\pulsar-master\tiered-storage\jcloud\src\main\java\org\apache\bookkeeper\mledger\offload\jcloud\impl\BlobStoreManagedLedgerOffloader.java,619,201,30,111,0,342
 zookeeper-master\zookeeper-master\zookeeper-metrics-providers\zookeeper-prometheus-metrics\src\test\java\org\apache\zookeeper\metrics\prometheus\PrometheusMetricsProviderTest.java,619,0,30,41,0,71
 hadoop-trunk\hadoop-trunk\hadoop-hdfs-project\hadoop-hdfs\src\test\java\org\apache\hadoop\hdfs\server\datanode\TestDataNodeMetrics.java,620,83,10,7,19,119
 hadoop-trunk\hadoop-trunk\hadoop-hdfs-project\hadoop-hdfs\src\test\java\org\apache\hadoop\hdfs\net\TestDFSNetworkTopology.java,620,125,36,1,20,182
 hadoop-trunk\hadoop-trunk\hadoop-common-project\hadoop-common\src\main\java\org\apache\hadoop\crypto\key\JavaKeyStoreProvider.java,621,105,8,5,4,122
 zookeeper-master\zookeeper-master\zookeeper-server\src\main\java\org\apache\zookeeper\server\persistence\FileTxnSnapLog.java,621,0,28,42,4,74
 hadoop-trunk\hadoop-trunk\hadoop-yarn-project\hadoop-yarn\hadoop-yarn-server\hadoop-yarn-server-nodemanager\src\main\java\org\apache\hadoop\yarn\server\nodemanager\containermanager\application\ApplicationImpl.java,622,139,23,18,13,193
 hadoop-trunk\hadoop-trunk\hadoop-hdfs-project\hadoop-hdfs\src\test\java\org\apache\hadoop\hdfs\server\namenode\TestNameNodeRecovery.java,622,168,22,2,3,195
 zookeeper-master\zookeeper-master\zookeeper-server\src\test\java\org\apache\zookeeper\server\quorum\CnxManagerTest.java,622,0,44,50,17,111
 hadoop-trunk\hadoop-trunk\hadoop-hdfs-project\hadoop-hdfs\src\main\java\org\apache\hadoop\hdfs\server\namenode\LeaseManager.java,623,124,23,3,2,152
 kafka-trunk\kafka-trunk\clients\src\generated\java\org\apache\kafka\common\message\DescribeConfigsRequestData.java,623,0,0,71,8,79
 pulsar-master\pulsar-master\pulsar-broker\src\test\java\org\apache\pulsar\client\api\SimpleTypedProducerConsumerTest.java,623,123,29,46,0,198
 hadoop-trunk\hadoop-trunk\hadoop-yarn-project\hadoop-yarn\hadoop-yarn-server\hadoop-yarn-server-resourcemanager\src\main\java\org\apache\hadoop\yarn\server\resourcemanager\scheduler\constraint\AllocationTagsManager.java,624,77,49,1,4,131
 kafka-trunk\kafka-trunk\streams\src\test\java\org\apache\kafka\streams\processor\internals\assignment\ClientTagAwareStandbyTaskAssignorTest.java,626,0,0,168,0,168
 kafka-trunk\kafka-trunk\clients\src\test\java\org\apache\kafka\common\utils\ImplicitLinkedHashCollectionTest.java,628,0,13,53,1,67
 kafka-trunk\kafka-trunk\clients\src\generated\java\org\apache\kafka\common\message\AddPartitionsToTxnRequestData.java,628,0,0,65,9,74
 skywalking-master\skywalking-master\oap-server\analyzer\meter-analyzer\src\main\java\org\apache\skywalking\oap\meter\analyzer\dsl\SampleFamily.java,628,268,14,97,0,379
 hadoop-trunk\hadoop-trunk\hadoop-yarn-project\hadoop-yarn\hadoop-yarn-server\hadoop-yarn-server-web-proxy\src\main\java\org\apache\hadoop\yarn\server\webproxy\WebAppProxyServlet.java,630,82,20,2,8,112
 hadoop-trunk\hadoop-trunk\hadoop-hdfs-project\hadoop-hdfs\src\test\java\org\apache\hadoop\hdfs\server\datanode\fsdataset\impl\TestWriteToReplica.java,630,208,48,14,0,270
 hadoop-trunk\hadoop-trunk\hadoop-yarn-project\hadoop-yarn\hadoop-yarn-server\hadoop-yarn-server-applicationhistoryservice\src\test\java\org\apache\hadoop\yarn\server\applicationhistoryservice\TestApplicationHistoryManagerOnTimelineStore.java,632,103,7,11,11,132
 hadoop-trunk\hadoop-trunk\hadoop-common-project\hadoop-common\src\test\java\org\apache\hadoop\security\authorize\TestProxyUsers.java,632,139,45,21,0,205
 hadoop-trunk\hadoop-trunk\hadoop-yarn-project\hadoop-yarn\hadoop-yarn-server\hadoop-yarn-server-common\src\main\java\org\apache\hadoop\yarn\server\federation\policies\amrmproxy\LocalityMulticastAMRMProxyPolicy.java,633,96,22,6,0,124
 druid-master\druid-master\extensions-contrib\influx-extensions\target\generated-sources\antlr4\org\apache\druid\data\input\influx\InfluxLineProtocolParser.java,634,603,3,38,3,647
 hadoop-trunk\hadoop-trunk\hadoop-tools\hadoop-archive-logs\src\main\java\org\apache\hadoop\tools\HadoopArchiveLogs.java,634,124,23,8,6,161
 hadoop-trunk\hadoop-trunk\hadoop-common-project\hadoop-common\src\test\java\org\apache\hadoop\conf\TestConfigurationFieldsBase.java,634,72,41,4,1,118
 pulsar-master\pulsar-master\managed-ledger\src\main\java\org\apache\bookkeeper\mledger\ManagedLedgerConfig.java,634,233,0,55,0,288
 rocketmq-develop\rocketmq-develop\acl\src\main\java\org\apache\rocketmq\acl\plain\PlainPermissionManager.java,634,253,17,168,6,444
 hadoop-trunk\hadoop-trunk\hadoop-hdfs-project\hadoop-hdfs\src\test\java\org\apache\hadoop\hdfs\server\namenode\snapshot\TestRandomOpsWithSnapshots.java,635,99,39,1,3,142
 pulsar-master\pulsar-master\pulsar-sql\presto-pulsar\src\test\java\org\apache\pulsar\sql\presto\TestPulsarConnector.java,635,335,5,151,0,491
 pulsar-master\pulsar-master\pulsar-common\src\main\java\org\apache\pulsar\common\util\collections\ConcurrentLongLongPairHashMap.java,635,236,4,31,0,271
 hadoop-trunk\hadoop-trunk\hadoop-tools\hadoop-aws\src\main\java\org\apache\hadoop\fs\s3a\auth\delegation\S3ADelegationTokens.java,636,10,9,6,2,27
 kafka-trunk\kafka-trunk\clients\src\main\java\org\apache\kafka\common\security\authenticator\SaslClientAuthenticator.java,636,0,104,141,11,256
 rocketmq-develop\rocketmq-develop\store\src\main\java\org\apache\rocketmq\store\StoreStatsService.java,636,223,21,53,7,304
 hadoop-trunk\hadoop-trunk\hadoop-yarn-project\hadoop-yarn\hadoop-yarn-api\src\main\java\org\apache\hadoop\yarn\api\protocolrecords\AllocateResponse.java,637,111,3,3,1,118
 hadoop-trunk\hadoop-trunk\hadoop-tools\hadoop-aws\src\main\java\org\apache\hadoop\fs\s3a\impl\RequestFactoryImpl.java,637,61,6,3,4,74
 hadoop-trunk\hadoop-trunk\hadoop-common-project\hadoop-auth\src\main\java\org\apache\hadoop\security\authentication\server\AuthenticationFilter.java,637,94,10,33,0,137
 hadoop-trunk\hadoop-trunk\hadoop-mapreduce-project\hadoop-mapreduce-client\hadoop-mapreduce-client-hs\src\test\java\org\apache\hadoop\mapreduce\v2\hs\webapp\TestHsWebServicesJobsQuery.java,637,66,3,10,0,79
 hadoop-trunk\hadoop-trunk\hadoop-tools\hadoop-rumen\src\main\java\org\apache\hadoop\tools\rumen\LoggedJob.java,638,330,8,3,10,351
 kafka-trunk\kafka-trunk\clients\src\main\java\org\apache\kafka\common\security\authenticator\SaslServerAuthenticator.java,638,0,116,150,5,271
 pulsar-master\pulsar-master\pulsar-broker\src\main\java\org\apache\pulsar\broker\resourcegroup\ResourceGroup.java,638,259,7,126,0,392
 kafka-trunk\kafka-trunk\connect\runtime\src\test\java\org\apache\kafka\connect\runtime\WorkerSinkTaskThreadedTest.java,639,0,11,87,6,104
 kafka-trunk\kafka-trunk\clients\src\generated\java\org\apache\kafka\common\message\AlterUserScramCredentialsRequestData.java,639,0,0,62,15,77
 zookeeper-master\zookeeper-master\zookeeper-server\src\test\java\org\apache\zookeeper\test\FollowerResyncConcurrencyTest.java,639,0,42,88,0,130
 hadoop-trunk\hadoop-trunk\hadoop-mapreduce-project\hadoop-mapreduce-client\hadoop-mapreduce-client-core\src\test\java\org\apache\hadoop\mapred\TestLineRecordReader.java,640,117,16,2,4,139
 hadoop-trunk\hadoop-trunk\hadoop-yarn-project\hadoop-yarn\hadoop-yarn-server\hadoop-yarn-server-nodemanager\src\main\java\org\apache\hadoop\yarn\server\nodemanager\DirectoryCollection.java,640,123,10,8,0,141
 kafka-trunk\kafka-trunk\clients\src\main\java\org\apache\kafka\common\config\AbstractConfig.java,640,0,25,118,2,145
 kafka-trunk\kafka-trunk\clients\src\generated\java\org\apache\kafka\common\message\DescribeClusterResponseData.java,640,0,0,54,9,63
 hadoop-trunk\hadoop-trunk\hadoop-yarn-project\hadoop-yarn\hadoop-yarn-server\hadoop-yarn-server-nodemanager\src\test\java\org\apache\hadoop\yarn\server\nodemanager\TestLinuxContainerExecutorWithMocks.java,641,82,7,13,3,105
 kafka-trunk\kafka-trunk\streams\src\main\java\org\apache\kafka\streams\processor\internals\ProcessorStateManager.java,641,0,21,121,3,145
 rocketmq-develop\rocketmq-develop\remoting\src\main\java\org\apache\rocketmq\remoting\netty\NettyRemotingClient.java,641,178,10,95,5,288
 kafka-trunk\kafka-trunk\streams\src\test\java\org\apache\kafka\streams\integration\KTableKTableForeignKeyJoinIntegrationTest.java,642,0,6,100,1,107
 hadoop-trunk\hadoop-trunk\hadoop-tools\hadoop-distcp\src\test\java\org\apache\hadoop\tools\mapred\TestCopyCommitter.java,643,68,35,13,0,116
 dubbo-3.0\dubbo-3.0\dubbo-common\src\main\java\org\apache\dubbo\common\utils\NetUtils.java,644,152,19,47,1,219
 hadoop-trunk\hadoop-trunk\hadoop-yarn-project\hadoop-yarn\hadoop-yarn-server\hadoop-yarn-server-resourcemanager\src\main\java\org\apache\hadoop\yarn\server\resourcemanager\scheduler\fair\FSLeafQueue.java,645,95,9,4,4,112
 hadoop-trunk\hadoop-trunk\hadoop-tools\hadoop-aws\src\main\java\org\apache\hadoop\fs\s3a\WriteOperationHelper.java,645,64,14,2,4,84
 pulsar-master\pulsar-master\pulsar-functions\localrun\src\main\java\org\apache\pulsar\functions\LocalRunner.java,645,280,9,140,0,429
 hadoop-trunk\hadoop-trunk\hadoop-yarn-project\hadoop-yarn\hadoop-yarn-client\src\main\java\org\apache\hadoop\yarn\client\cli\NodeAttributesCLI.java,647,101,16,5,4,126
 kafka-trunk\kafka-trunk\clients\src\main\java\org\apache\kafka\common\record\DefaultRecordBatch.java,647,0,33,101,5,139
 kafka-trunk\kafka-trunk\trogdor\src\test\java\org\apache\kafka\trogdor\coordinator\CoordinatorTest.java,647,0,2,59,0,61
 pulsar-master\pulsar-master\pulsar-client\src\main\java\org\apache\pulsar\client\impl\PersistentAcknowledgmentsGroupingTracker.java,647,220,13,135,0,368
 kafka-trunk\kafka-trunk\raft\src\test\java\org\apache\kafka\raft\MockLog.java,648,0,13,53,0,66
 pulsar-master\pulsar-master\pulsar-common\src\main\java\org\apache\pulsar\common\util\collections\ConcurrentLongPairSet.java,648,204,11,24,0,239
 hadoop-trunk\hadoop-trunk\hadoop-hdfs-project\hadoop-hdfs\src\test\java\org\apache\hadoop\hdfs\server\datanode\fsdataset\impl\LazyPersistTestCase.java,649,118,7,3,0,128
 hadoop-trunk\hadoop-trunk\hadoop-common-project\hadoop-common\src\main\java\org\apache\hadoop\crypto\key\KeyProvider.java,649,149,4,5,3,161
 kafka-trunk\kafka-trunk\connect\transforms\src\test\java\org\apache\kafka\connect\transforms\TimestampConverterTest.java,649,0,6,115,0,121
 hadoop-trunk\hadoop-trunk\hadoop-common-project\hadoop-common\src\main\java\org\apache\hadoop\security\ShellBasedIdMapping.java,650,164,20,17,28,229
 hadoop-trunk\hadoop-trunk\hadoop-yarn-project\hadoop-yarn\hadoop-yarn-server\hadoop-yarn-server-resourcemanager\src\main\java\org\apache\hadoop\yarn\server\resourcemanager\RMAuditLogger.java,650,379,5,13,1,398
 pulsar-master\pulsar-master\pulsar-metadata\src\test\java\org\apache\pulsar\metadata\bookkeeper\LedgerUnderreplicationManagerTest.java,651,158,15,50,0,223
 hadoop-trunk\hadoop-trunk\hadoop-hdfs-project\hadoop-hdfs\src\main\java\org\apache\hadoop\hdfs\server\namenode\FileJournalManager.java,652,214,24,9,13,260
 kafka-trunk\kafka-trunk\clients\src\generated\java\org\apache\kafka\common\message\AlterPartitionReassignmentsResponseData.java,652,0,0,72,12,84
 hadoop-trunk\hadoop-trunk\hadoop-mapreduce-project\hadoop-mapreduce-client\hadoop-mapreduce-client-jobclient\src\test\java\org\apache\hadoop\mapred\GenericMRLoadGenerator.java,653,174,29,5,4,212
 pulsar-master\pulsar-master\tests\integration\src\test\java\org\apache\pulsar\tests\integration\topologies\PulsarCluster.java,653,213,23,95,0,331
 hadoop-trunk\hadoop-trunk\hadoop-common-project\hadoop-common\src\test\java\org\apache\hadoop\ha\TestZKFailoverController.java,654,83,2,2,3,90
 hadoop-trunk\hadoop-trunk\hadoop-tools\hadoop-aliyun\src\main\java\org\apache\hadoop\fs\aliyun\oss\AliyunOSSFileSystemStore.java,654,89,12,1,1,103
 kafka-trunk\kafka-trunk\clients\src\test\java\org\apache\kafka\common\record\FileRecordsTest.java,655,0,16,110,21,147
 kafka-trunk\kafka-trunk\clients\src\generated\java\org\apache\kafka\common\message\MetadataRequestData.java,655,0,0,69,6,75
 hadoop-trunk\hadoop-trunk\hadoop-yarn-project\hadoop-yarn\hadoop-yarn-server\hadoop-yarn-server-resourcemanager\src\test\java\org\apache\hadoop\yarn\server\resourcemanager\scheduler\TestSchedulerOvercommit.java,656,154,4,4,0,162
 hadoop-trunk\hadoop-trunk\hadoop-hdfs-project\hadoop-hdfs\src\test\java\org\apache\hadoop\hdfs\server\datanode\fsdataset\impl\TestFsVolumeList.java,656,131,4,16,13,164
 hadoop-trunk\hadoop-trunk\hadoop-hdfs-project\hadoop-hdfs-client\src\test\java\org\apache\hadoop\hdfs\server\namenode\ha\TestRequestHedgingProxyProvider.java,656,80,90,2,17,189
 rocketmq-develop\rocketmq-develop\broker\src\main\java\org\apache\rocketmq\broker\processor\SendMessageProcessor.java,656,246,5,169,4,424
 pulsar-master\pulsar-master\pulsar-broker\src\main\java\org\apache\pulsar\broker\service\schema\BookkeeperSchemaStorage.java,657,206,7,115,0,328
 hadoop-trunk\hadoop-trunk\hadoop-hdfs-project\hadoop-hdfs-client\src\main\java\org\apache\hadoop\hdfs\inotify\Event.java,659,274,0,2,8,284
 kafka-trunk\kafka-trunk\clients\src\generated\java\org\apache\kafka\common\message\OffsetDeleteResponseData.java,659,0,0,65,10,75
 hadoop-trunk\hadoop-trunk\hadoop-hdfs-project\hadoop-hdfs\src\test\java\org\apache\hadoop\fs\viewfs\TestViewFileSystemOverloadSchemeWithHdfsScheme.java,660,50,23,3,3,79
 hadoop-trunk\hadoop-trunk\hadoop-yarn-project\hadoop-yarn\hadoop-yarn-server\hadoop-yarn-server-resourcemanager\src\test\java\org\apache\hadoop\yarn\server\resourcemanager\scheduler\fair\converter\TestFSConfigToCSConfigConverter.java,660,75,3,25,0,103
 zookeeper-master\zookeeper-master\zookeeper-it\src\main\java\org\apache\zookeeper\test\system\GenerateLoad.java,660,0,44,19,26,89
 hadoop-trunk\hadoop-trunk\hadoop-mapreduce-project\hadoop-mapreduce-client\hadoop-mapreduce-client-common\src\main\java\org\apache\hadoop\mapreduce\v2\util\MRApps.java,661,162,28,15,1,206
 hadoop-trunk\hadoop-trunk\hadoop-tools\hadoop-sls\src\main\java\org\apache\hadoop\yarn\sls\scheduler\SchedulerMetrics.java,661,127,21,10,5,163
 kafka-trunk\kafka-trunk\clients\src\generated\java\org\apache\kafka\common\message\DeleteAclsRequestData.java,661,0,0,68,8,76
 kafka-trunk\kafka-trunk\streams\src\test\java\org\apache\kafka\streams\state\internals\RocksDBWindowStoreTest.java,661,0,2,34,13,49
 hadoop-trunk\hadoop-trunk\hadoop-hdfs-project\hadoop-hdfs\src\main\java\org\apache\hadoop\hdfs\web\JsonUtil.java,662,95,16,2,4,117
 kafka-trunk\kafka-trunk\clients\src\generated\java\org\apache\kafka\common\message\AlterReplicaLogDirsResponseData.java,663,0,0,83,10,93
 kafka-trunk\kafka-trunk\clients\src\generated\java\org\apache\kafka\common\message\DeleteRecordsRequestData.java,663,0,0,64,10,74
 pulsar-master\pulsar-master\managed-ledger\src\test\java\org\apache\bookkeeper\mledger\impl\ManagedCursorContainerTest.java,663,369,29,111,0,509
 hadoop-trunk\hadoop-trunk\hadoop-mapreduce-project\hadoop-mapreduce-client\hadoop-mapreduce-client-jobclient\src\test\java\org\apache\hadoop\mapreduce\GenericMRLoadGenerator.java,664,183,15,2,9,209
 pulsar-master\pulsar-master\pulsar-client-tools\src\main\java\org\apache\pulsar\admin\cli\CmdPersistentTopics.java,664,196,38,131,0,365
 hadoop-trunk\hadoop-trunk\hadoop-tools\hadoop-aws\src\test\java\org\apache\hadoop\fs\s3a\select\AbstractS3SelectTest.java,665,55,2,1,2,60
 hadoop-trunk\hadoop-trunk\hadoop-common-project\hadoop-registry\src\test\java\org\apache\hadoop\registry\server\dns\TestRegistryDNS.java,665,76,41,1,21,139
 hadoop-trunk\hadoop-trunk\hadoop-common-project\hadoop-kms\src\main\java\org\apache\hadoop\crypto\key\kms\server\KMS.java,667,83,13,3,13,112
 hadoop-trunk\hadoop-trunk\hadoop-tools\hadoop-aws\src\test\java\org\apache\hadoop\fs\s3a\impl\ITestPartialRenamesDeletes.java,667,35,19,4,8,66
 pulsar-master\pulsar-master\pulsar-testclient\src\main\java\org\apache\pulsar\testclient\PerformanceTransaction.java,667,322,46,166,0,534
 hadoop-trunk\hadoop-trunk\hadoop-yarn-project\hadoop-yarn\hadoop-yarn-server\hadoop-yarn-server-resourcemanager\src\test\java\org\apache\hadoop\yarn\server\resourcemanager\webapp\TestRMWebServicesForCSWithPartitions.java,669,226,19,14,1,260
 hadoop-trunk\hadoop-trunk\hadoop-yarn-project\hadoop-yarn\hadoop-yarn-server\hadoop-yarn-server-resourcemanager\src\test\java\org\apache\hadoop\yarn\server\resourcemanager\TestRM.java,670,123,12,12,3,150
 kafka-trunk\kafka-trunk\clients\src\generated\java\org\apache\kafka\common\message\DeleteTopicsResponseData.java,670,0,0,61,7,68
 hadoop-trunk\hadoop-trunk\hadoop-common-project\hadoop-common\src\test\java\org\apache\hadoop\fs\contract\AbstractContractGetFileStatusTest.java,671,75,5,1,0,81
 kafka-trunk\kafka-trunk\clients\src\generated\java\org\apache\kafka\common\message\DescribeUserScramCredentialsResponseData.java,671,0,0,70,12,82
 pulsar-master\pulsar-master\pulsar-broker\src\main\java\org\apache\pulsar\broker\rest\TopicsBase.java,671,236,10,179,0,425
 pulsar-master\pulsar-master\pulsar-testclient\src\main\java\org\apache\pulsar\testclient\LoadSimulationController.java,671,169,10,111,0,290
 zookeeper-master\zookeeper-master\zookeeper-server\src\test\java\org\apache\zookeeper\test\ClientBase.java,671,0,16,41,12,69
 hadoop-trunk\hadoop-trunk\hadoop-mapreduce-project\hadoop-mapreduce-client\hadoop-mapreduce-client-jobclient\src\test\java\org\apache\hadoop\mapred\TestConcatenatedCompressedInput.java,672,215,21,15,49,300
 hadoop-trunk\hadoop-trunk\hadoop-yarn-project\hadoop-yarn\hadoop-yarn-server\hadoop-yarn-server-nodemanager\src\main\java\org\apache\hadoop\yarn\server\nodemanager\containermanager\resourceplugin\com\nvidia\NvidiaGPUPluginForRuntimeV2.java,672,110,32,6,4,152
 kafka-trunk\kafka-trunk\clients\src\generated\java\org\apache\kafka\common\message\TxnOffsetCommitResponseData.java,672,0,0,79,10,89
 kafka-trunk\kafka-trunk\clients\src\generated\java\org\apache\kafka\common\message\AlterPartitionRequestData.java,673,0,0,60,12,72
 kafka-trunk\kafka-trunk\clients\src\main\java\org\apache\kafka\clients\consumer\internals\ConsumerNetworkClient.java,673,0,15,99,4,118
 kafka-trunk\kafka-trunk\streams\src\test\java\org\apache\kafka\streams\state\internals\metrics\RocksDBMetricsRecorderTest.java,674,0,1,206,0,207
 kafka-trunk\kafka-trunk\connect\mirror\src\test\java\org\apache\kafka\connect\mirror\integration\MirrorConnectorsIntegrationBaseTest.java,675,0,15,185,29,229
 kafka-trunk\kafka-trunk\streams\src\test\java\org\apache\kafka\streams\integration\MetricsIntegrationTest.java,676,0,31,115,1,147
 hadoop-trunk\hadoop-trunk\hadoop-common-project\hadoop-common\src\main\java\org\apache\hadoop\fs\ftp\FTPFileSystem.java,678,122,25,3,4,154
 hadoop-trunk\hadoop-trunk\hadoop-yarn-project\hadoop-yarn\hadoop-yarn-applications\hadoop-yarn-services\hadoop-yarn-services-api\src\main\java\org\apache\hadoop\yarn\service\client\ApiServiceClient.java,678,89,9,2,13,113
 kafka-trunk\kafka-trunk\clients\src\generated\java\org\apache\kafka\common\message\LeaveGroupRequestData.java,678,0,0,72,10,82
 hadoop-trunk\hadoop-trunk\hadoop-tools\hadoop-aws\src\test\java\org\apache\hadoop\fs\s3a\auth\delegation\ITestSessionDelegationInFileystem.java,679,29,13,9,3,54
 hadoop-trunk\hadoop-trunk\hadoop-hdfs-project\hadoop-hdfs\src\test\java\org\apache\hadoop\hdfs\server\datanode\fsdataset\impl\TestSpaceReservation.java,679,101,26,6,1,134
 dubbo-3.0\dubbo-3.0\dubbo-rpc\dubbo-rpc-dubbo\src\main\java\org\apache\dubbo\rpc\protocol\dubbo\DubboProtocol.java,680,173,13,103,0,289
 hadoop-trunk\hadoop-trunk\hadoop-yarn-project\hadoop-yarn\hadoop-yarn-server\hadoop-yarn-server-resourcemanager\src\test\java\org\apache\hadoop\yarn\server\resourcemanager\webapp\TestRMWebServicesDelegationTokens.java,680,58,8,8,0,74
 hadoop-trunk\hadoop-trunk\hadoop-yarn-project\hadoop-yarn\hadoop-yarn-server\hadoop-yarn-server-resourcemanager\src\test\java\org\apache\hadoop\yarn\server\resourcemanager\scheduler\fair\TestQueueManager.java,681,18,4,2,1,25
 hadoop-trunk\hadoop-trunk\hadoop-hdfs-project\hadoop-hdfs\src\test\java\org\apache\hadoop\hdfs\server\datanode\TestDataNodeReconfiguration.java,681,104,10,74,20,208
 pulsar-master\pulsar-master\pulsar-client-tools\src\main\java\org\apache\pulsar\admin\cli\CmdSources.java,681,259,2,109,0,370
 hadoop-trunk\hadoop-trunk\hadoop-yarn-project\hadoop-yarn\hadoop-yarn-client\src\test\java\org\apache\hadoop\yarn\client\ProtocolHATestBase.java,682,163,35,15,4,217
 hadoop-trunk\hadoop-trunk\hadoop-mapreduce-project\hadoop-mapreduce-examples\src\main\java\org\apache\hadoop\examples\RandomTextWriter.java,682,139,7,3,0,149
 hadoop-trunk\hadoop-trunk\hadoop-yarn-project\hadoop-yarn\hadoop-yarn-server\hadoop-yarn-server-resourcemanager\src\main\java\org\apache\hadoop\yarn\server\resourcemanager\NodesListManager.java,683,151,24,4,2,181
 hadoop-trunk\hadoop-trunk\hadoop-hdfs-project\hadoop-hdfs-rbf\src\test\java\org\apache\hadoop\hdfs\server\federation\resolver\TestMountTableResolver.java,683,54,0,4,1,59
 kafka-trunk\kafka-trunk\streams\src\test\java\org\apache\kafka\streams\kstream\RepartitionTopicNamingTest.java,683,0,8,188,5,201
 dubbo-3.0\dubbo-3.0\dubbo-metadata\dubbo-metadata-api\src\main\java\org\apache\dubbo\metadata\MetadataInfo.java,684,344,23,66,0,433
 hadoop-trunk\hadoop-trunk\hadoop-yarn-project\hadoop-yarn\hadoop-yarn-server\hadoop-yarn-server-resourcemanager\src\main\java\org\apache\hadoop\yarn\server\resourcemanager\nodelabels\NodeAttributesManagerImpl.java,684,140,12,3,7,162
 hadoop-trunk\hadoop-trunk\hadoop-tools\hadoop-azure\src\test\java\org\apache\hadoop\fs\azurebfs\ITestAzureBlobFileSystemRandomRead.java,684,80,14,14,9,117
 kafka-trunk\kafka-trunk\connect\runtime\src\main\java\org\apache\kafka\connect\util\TopicAdmin.java,684,0,10,154,3,167
 pulsar-master\pulsar-master\pulsar-client-tools\src\test\java\org\apache\pulsar\admin\cli\TestCmdSinks.java,685,112,4,19,0,135
 hadoop-trunk\hadoop-trunk\hadoop-hdfs-project\hadoop-hdfs\src\test\java\org\apache\hadoop\hdfs\server\blockmanagement\TestBlockManagerSafeMode.java,686,104,37,4,8,153
 hadoop-trunk\hadoop-trunk\hadoop-yarn-project\hadoop-yarn\hadoop-yarn-server\hadoop-yarn-server-nodemanager\src\main\java\org\apache\hadoop\yarn\server\nodemanager\containermanager\scheduler\ContainerScheduler.java,686,101,21,8,4,134
 hadoop-trunk\hadoop-trunk\hadoop-yarn-project\hadoop-yarn\hadoop-yarn-server\hadoop-yarn-server-nodemanager\src\test\java\org\apache\hadoop\yarn\server\nodemanager\webapp\TestNMWebServicesApps.java,687,84,11,9,0,104
 hadoop-trunk\hadoop-trunk\hadoop-yarn-project\hadoop-yarn\hadoop-yarn-server\hadoop-yarn-server-nodemanager\src\test\java\org\apache\hadoop\yarn\server\nodemanager\amrmproxy\TestAMRMProxyService.java,687,65,26,13,5,109
 hadoop-trunk\hadoop-trunk\hadoop-mapreduce-project\hadoop-mapreduce-client\hadoop-mapreduce-client-jobclient\src\test\java\org\apache\hadoop\mapreduce\RandomTextWriter.java,687,136,6,3,0,145
 hadoop-trunk\hadoop-trunk\hadoop-yarn-project\hadoop-yarn\hadoop-yarn-server\hadoop-yarn-server-nodemanager\src\main\java\org\apache\hadoop\yarn\server\nodemanager\containermanager\localizer\ResourceLocalizationService.java,688,285,64,58,15,422
 hadoop-trunk\hadoop-trunk\hadoop-common-project\hadoop-common\src\main\java\org\apache\hadoop\fs\FilterFileSystem.java,689,281,8,5,2,296
 zookeeper-master\zookeeper-master\zookeeper-server\src\main\java\org\apache\zookeeper\server\ZKDatabase.java,689,0,36,33,6,75
 pulsar-master\pulsar-master\pulsar-broker\src\test\java\org\apache\pulsar\broker\service\ResendRequestTest.java,690,126,79,56,0,261
 hadoop-trunk\hadoop-trunk\hadoop-hdfs-project\hadoop-hdfs-httpfs\src\main\java\org\apache\hadoop\lib\server\Server.java,691,118,28,42,3,191
 hadoop-trunk\hadoop-trunk\hadoop-yarn-project\hadoop-yarn\hadoop-yarn-client\src\test\java\org\apache\hadoop\yarn\client\api\impl\TestOpportunisticContainerAllocationE2E.java,692,88,14,2,4,108
 hadoop-trunk\hadoop-trunk\hadoop-common-project\hadoop-common\src\main\java\org\apache\hadoop\fs\sftp\SFTPFileSystem.java,694,128,16,1,1,146
 kafka-trunk\kafka-trunk\streams\src\test\java\org\apache\kafka\streams\processor\internals\assignment\StickyTaskAssignorTest.java,694,0,2,151,0,153
 hadoop-trunk\hadoop-trunk\hadoop-yarn-project\hadoop-yarn\hadoop-yarn-server\hadoop-yarn-server-resourcemanager\src\test\java\org\apache\hadoop\yarn\server\resourcemanager\placement\TestUserGroupMappingPlacementRule.java,695,75,2,12,0,89
 hadoop-trunk\hadoop-trunk\hadoop-yarn-project\hadoop-yarn\hadoop-yarn-server\hadoop-yarn-server-resourcemanager\src\test\java\org\apache\hadoop\yarn\server\resourcemanager\nodelabels\TestRMNodeLabelsManager.java,695,164,49,12,9,234
 hadoop-trunk\hadoop-trunk\hadoop-hdfs-project\hadoop-hdfs\src\test\java\org\apache\hadoop\hdfs\server\mover\TestStorageMover.java,695,156,7,3,1,167
 hadoop-trunk\hadoop-trunk\hadoop-tools\hadoop-aliyun\src\main\java\org\apache\hadoop\fs\aliyun\oss\AliyunOSSFileSystem.java,695,86,20,3,1,110
 hadoop-trunk\hadoop-trunk\hadoop-hdfs-project\hadoop-hdfs-rbf\src\test\java\org\apache\hadoop\hdfs\server\federation\router\TestRouterMountTable.java,697,45,10,10,1,66
 hadoop-trunk\hadoop-trunk\hadoop-hdfs-project\hadoop-hdfs\src\main\java\org\apache\hadoop\hdfs\server\datanode\metrics\DataNodeMetrics.java,698,427,0,1,2,430
 hadoop-trunk\hadoop-trunk\hadoop-hdfs-project\hadoop-hdfs\src\test\java\org\apache\hadoop\hdfs\TestRollingUpgrade.java,698,107,8,12,0,127
 pulsar-master\pulsar-master\pulsar-broker\src\main\java\org\apache\pulsar\broker\service\Producer.java,699,309,5,87,0,401
 hadoop-trunk\hadoop-trunk\hadoop-common-project\hadoop-common\src\main\java\org\apache\hadoop\util\SysInfoLinux.java,700,105,35,1,4,145
 hadoop-trunk\hadoop-trunk\hadoop-yarn-project\hadoop-yarn\hadoop-yarn-server\hadoop-yarn-server-resourcemanager\src\test\java\org\apache\hadoop\yarn\server\resourcemanager\scheduler\fair\converter\TestFSConfigToCSConfigArgumentHandler.java,700,58,10,3,8,79
 hadoop-trunk\hadoop-trunk\hadoop-yarn-project\hadoop-yarn\hadoop-yarn-common\src\test\java\org\apache\hadoop\yarn\util\TestFSDownload.java,702,176,38,4,27,245
 dubbo-3.0\dubbo-3.0\dubbo-common\src\test\java\org\apache\dubbo\common\extension\ExtensionLoaderTest.java,704,207,57,106,2,372
 hadoop-trunk\hadoop-trunk\hadoop-hdfs-project\hadoop-hdfs\src\main\java\org\apache\hadoop\hdfs\qjournal\client\IPCLoggerChannel.java,705,161,45,15,7,228
 kafka-trunk\kafka-trunk\streams\src\test\java\org\apache\kafka\streams\kstream\internals\KGroupedStreamImplTest.java,705,0,13,162,23,198
 pulsar-master\pulsar-master\pulsar-broker\src\main\java\org\apache\pulsar\broker\admin\impl\FunctionsBase.java,705,342,67,221,0,630
 hadoop-trunk\hadoop-trunk\hadoop-mapreduce-project\hadoop-mapreduce-client\hadoop-mapreduce-client-core\src\main\java\org\apache\hadoop\mapreduce\lib\output\FileOutputCommitter.java,706,167,14,10,2,193
 hadoop-trunk\hadoop-trunk\hadoop-hdfs-project\hadoop-hdfs-nfs\src\test\java\org\apache\hadoop\hdfs\nfs\nfs3\TestWrites.java,707,188,64,10,3,265
 hadoop-trunk\hadoop-trunk\hadoop-tools\hadoop-openstack\src\main\java\org\apache\hadoop\fs\swift\snative\SwiftNativeFileSystem.java,707,98,8,8,3,117
 hadoop-trunk\hadoop-trunk\hadoop-hdfs-project\hadoop-hdfs\src\test\java\org\apache\hadoop\hdfs\TestPread.java,707,206,19,7,15,247
 pulsar-master\pulsar-master\pulsar-client\src\main\java\org\apache\pulsar\client\impl\MessageImpl.java,708,363,7,90,0,460
 kafka-trunk\kafka-trunk\clients\src\generated\java\org\apache\kafka\common\message\AlterPartitionResponseData.java,709,0,0,57,12,69
 kafka-trunk\kafka-trunk\connect\runtime\src\main\java\org\apache\kafka\connect\runtime\distributed\IncrementalCooperativeAssignor.java,710,0,9,193,0,202
 pulsar-master\pulsar-master\managed-ledger\src\test\java\org\apache\bookkeeper\mledger\impl\NonDurableCursorTest.java,710,125,7,44,0,176
 hadoop-trunk\hadoop-trunk\hadoop-yarn-project\hadoop-yarn\hadoop-yarn-server\hadoop-yarn-server-applicationhistoryservice\src\main\java\org\apache\hadoop\yarn\server\applicationhistoryservice\ApplicationHistoryManagerOnTimelineStore.java,711,77,4,15,13,109
 hadoop-trunk\hadoop-trunk\hadoop-common-project\hadoop-common\src\test\java\org\apache\hadoop\net\unix\TestDomainSocket.java,712,228,35,4,6,273
 hadoop-trunk\hadoop-trunk\hadoop-hdfs-project\hadoop-hdfs\src\main\java\org\apache\hadoop\hdfs\server\namenode\JournalSet.java,712,146,12,7,2,167
 hadoop-trunk\hadoop-trunk\hadoop-mapreduce-project\hadoop-mapreduce-client\hadoop-mapreduce-client-jobclient\src\test\java\org\apache\hadoop\mapred\TestMapRed.java,713,166,42,7,9,224
 hadoop-trunk\hadoop-trunk\hadoop-mapreduce-project\hadoop-mapreduce-client\hadoop-mapreduce-client-app\src\test\java\org\apache\hadoop\mapreduce\v2\app\webapp\TestAMWebServicesTasks.java,713,75,4,3,14,96
 hadoop-trunk\hadoop-trunk\hadoop-hdfs-project\hadoop-hdfs\src\test\java\org\apache\hadoop\hdfs\server\namenode\ha\TestDFSUpgradeWithHA.java,713,108,4,7,0,119
 hadoop-trunk\hadoop-trunk\hadoop-yarn-project\hadoop-yarn\hadoop-yarn-applications\hadoop-yarn-services\hadoop-yarn-services-core\src\test\java\org\apache\hadoop\yarn\service\utils\TestServiceApiUtil.java,714,44,55,2,3,104
 hadoop-trunk\hadoop-trunk\hadoop-yarn-project\hadoop-yarn\hadoop-yarn-applications\hadoop-yarn-services\hadoop-yarn-services-core\src\main\java\org\apache\hadoop\yarn\service\utils\ServiceApiUtil.java,715,134,17,7,1,159
 hadoop-trunk\hadoop-trunk\hadoop-mapreduce-project\hadoop-mapreduce-client\hadoop-mapreduce-client-jobclient\src\test\java\org\apache\hadoop\RandomTextWriterJob.java,715,126,6,3,3,138
 hadoop-trunk\hadoop-trunk\hadoop-hdfs-project\hadoop-hdfs-httpfs\src\main\java\org\apache\hadoop\fs\http\server\HttpFSParametersProvider.java,716,21,2,2,0,25
 kafka-trunk\kafka-trunk\clients\src\generated\java\org\apache\kafka\common\message\ListPartitionReassignmentsResponseData.java,716,0,0,85,17,102
 pulsar-master\pulsar-master\pulsar-broker\src\test\java\org\apache\pulsar\broker\loadbalance\LoadBalancerTest.java,716,310,17,138,0,465
 hadoop-trunk\hadoop-trunk\hadoop-yarn-project\hadoop-yarn\hadoop-yarn-server\hadoop-yarn-server-resourcemanager\src\test\java\org\apache\hadoop\yarn\server\resourcemanager\reservation\planning\TestGreedyReservationAgent.java,717,310,32,10,0,352
 hadoop-trunk\hadoop-trunk\hadoop-hdfs-project\hadoop-hdfs\src\main\java\org\apache\hadoop\hdfs\server\datanode\DirectoryScanner.java,717,98,0,11,3,112
 kafka-trunk\kafka-trunk\clients\src\test\java\org\apache\kafka\common\config\ConfigDefTest.java,717,0,26,155,1,182
 kafka-trunk\kafka-trunk\clients\src\test\java\org\apache\kafka\clients\FetchSessionHandlerTest.java,717,0,4,147,0,151
 hadoop-trunk\hadoop-trunk\hadoop-yarn-project\hadoop-yarn\hadoop-yarn-server\hadoop-yarn-server-resourcemanager\src\test\java\org\apache\hadoop\yarn\server\resourcemanager\scheduler\TestPartitionQueueMetrics.java,719,623,5,16,2,646
 hadoop-trunk\hadoop-trunk\hadoop-hdfs-project\hadoop-hdfs\src\test\java\org\apache\hadoop\hdfs\server\datanode\TestDataNodeVolumeFailureReporting.java,719,133,19,7,3,162
 pulsar-master\pulsar-master\pulsar-broker\src\test\java\org\apache\pulsar\broker\service\ReplicatorTopicPoliciesTest.java,719,257,2,175,0,434
 pulsar-master\pulsar-master\pulsar-broker\src\test\java\org\apache\pulsar\client\impl\PatternTopicsConsumerImplTest.java,719,222,27,143,0,392
 hadoop-trunk\hadoop-trunk\hadoop-hdfs-project\hadoop-hdfs\src\main\java\org\apache\hadoop\hdfs\server\namenode\ImageServlet.java,720,170,28,27,0,225
 hadoop-trunk\hadoop-trunk\hadoop-common-project\hadoop-common\src\main\java\org\apache\hadoop\io\retry\RetryPolicies.java,721,330,9,25,0,364
 kafka-trunk\kafka-trunk\clients\src\test\java\org\apache\kafka\clients\producer\MockProducerTest.java,722,0,19,112,18,149
 hadoop-trunk\hadoop-trunk\hadoop-mapreduce-project\hadoop-mapreduce-client\hadoop-mapreduce-client-hs\src\test\java\org\apache\hadoop\mapreduce\v2\hs\webapp\TestHsWebServicesTasks.java,723,78,4,3,14,99
 hadoop-trunk\hadoop-trunk\hadoop-tools\hadoop-aws\src\test\java\org\apache\hadoop\fs\s3a\commit\staging\StagingTestBase.java,724,181,10,1,12,204
 hadoop-trunk\hadoop-trunk\hadoop-yarn-project\hadoop-yarn\hadoop-yarn-server\hadoop-yarn-server-resourcemanager\src\main\java\org\apache\hadoop\yarn\server\resourcemanager\recovery\LeveldbRMStateStore.java,724,115,36,12,0,163
 pulsar-master\pulsar-master\pulsar-broker\src\test\java\org\apache\pulsar\broker\service\SubscriptionSeekTest.java,725,148,1,89,0,238
 hadoop-trunk\hadoop-trunk\hadoop-common-project\hadoop-common\src\test\java\org\apache\hadoop\io\file\tfile\TestTFileByteArrays.java,726,169,55,12,69,305
 hadoop-trunk\hadoop-trunk\hadoop-tools\hadoop-rumen\src\main\java\org\apache\hadoop\tools\rumen\LoggedTaskAttempt.java,726,322,14,2,11,349
 hadoop-trunk\hadoop-trunk\hadoop-yarn-project\hadoop-yarn\hadoop-yarn-server\hadoop-yarn-server-timeline-pluginstorage\src\test\java\org\apache\hadoop\yarn\server\timeline\TestEntityGroupFSTimelineStore.java,727,80,6,6,9,101
 hadoop-trunk\hadoop-trunk\hadoop-yarn-project\hadoop-yarn\hadoop-yarn-server\hadoop-yarn-server-resourcemanager\src\main\java\org\apache\hadoop\yarn\server\resourcemanager\scheduler\fair\FairSchedulerConfiguration.java,728,149,5,11,0,165
 kafka-trunk\kafka-trunk\clients\src\generated\java\org\apache\kafka\common\message\OffsetCommitResponseData.java,728,0,0,75,10,85
 rocketmq-develop\rocketmq-develop\client\src\main\java\org\apache\rocketmq\client\impl\consumer\DefaultMQPullConsumerImpl.java,729,350,13,123,14,500
 hadoop-trunk\hadoop-trunk\hadoop-tools\hadoop-aws\src\test\java\org\apache\hadoop\fs\s3a\performance\ITestDirectoryMarkerListing.java,730,31,5,2,1,39
 hadoop-trunk\hadoop-trunk\hadoop-hdfs-project\hadoop-hdfs\src\test\java\org\apache\hadoop\hdfs\server\namenode\TestStartup.java,730,156,24,16,7,203
 zookeeper-master\zookeeper-master\zookeeper-server\src\main\java\org\apache\zookeeper\server\NIOServerCnxn.java,731,0,23,34,0,57
 hadoop-trunk\hadoop-trunk\hadoop-hdfs-project\hadoop-hdfs\src\main\java\org\apache\hadoop\hdfs\server\namenode\FSImageSerialization.java,732,216,3,10,0,229
 kafka-trunk\kafka-trunk\clients\src\generated\java\org\apache\kafka\common\message\WriteTxnMarkersRequestData.java,732,0,0,77,12,89
 kafka-trunk\kafka-trunk\connect\runtime\src\test\java\org\apache\kafka\connect\integration\BlockingConnectorTest.java,732,0,10,59,4,73
 hadoop-trunk\hadoop-trunk\hadoop-tools\hadoop-rumen\src\main\java\org\apache\hadoop\tools\rumen\JobBuilder.java,734,100,44,10,0,154
 hadoop-trunk\hadoop-trunk\hadoop-hdfs-project\hadoop-hdfs\src\test\java\org\apache\hadoop\hdfs\server\diskbalancer\TestDiskBalancer.java,734,93,14,3,6,116
 hadoop-trunk\hadoop-trunk\hadoop-hdfs-project\hadoop-hdfs\src\main\java\org\apache\hadoop\hdfs\server\datanode\VolumeScanner.java,735,87,16,3,4,110
 kafka-trunk\kafka-trunk\streams\src\test\java\org\apache\kafka\streams\integration\KStreamRepartitionIntegrationTest.java,735,0,3,91,3,97
 zookeeper-master\zookeeper-master\zookeeper-contrib\zookeeper-contrib-zooinspector\src\main\java\org\apache\zookeeper\inspector\manager\ZooInspectorManagerImpl.java,735,0,29,21,14,64
 dubbo-3.0\dubbo-3.0\dubbo-common\src\main\java\org\apache\dubbo\common\timer\HashedWheelTimer.java,736,186,7,68,0,261
 hadoop-trunk\hadoop-trunk\hadoop-tools\hadoop-azure\src\main\java\org\apache\hadoop\fs\azure\StorageInterface.java,736,156,12,68,0,236
 zookeeper-master\zookeeper-master\zookeeper-server\src\main\java\org\apache\zookeeper\server\quorum\UnifiedServerSocket.java,736,0,2,134,1,137
 hadoop-trunk\hadoop-trunk\hadoop-hdfs-project\hadoop-hdfs\src\test\java\org\apache\hadoop\hdfs\server\namenode\TestSaveNamespace.java,737,139,30,2,2,173
 hadoop-trunk\hadoop-trunk\hadoop-yarn-project\hadoop-yarn\hadoop-yarn-server\hadoop-yarn-server-timelineservice\src\test\java\org\apache\hadoop\yarn\server\timelineservice\reader\TestTimelineReaderWebServices.java,737,152,3,3,27,185
 dubbo-3.0\dubbo-3.0\dubbo-config\dubbo-config-api\src\main\java\org\apache\dubbo\config\ServiceConfig.java,739,189,19,95,0,303
 zookeeper-master\zookeeper-master\zookeeper-jute\src\main\java\org\apache\jute\compiler\JRecord.java,739,0,35,102,5,142
 hadoop-trunk\hadoop-trunk\hadoop-mapreduce-project\hadoop-mapreduce-client\hadoop-mapreduce-client-core\src\main\java\org\apache\hadoop\mapreduce\tools\CLI.java,741,167,15,3,2,187
 shardingsphere-master\shardingsphere-master\shardingsphere-jdbc\shardingsphere-jdbc-core\src\main\java\org\apache\shardingsphere\driver\jdbc\adapter\AdaptedDatabaseMetaData.java,741,157,0,9,0,166
 hadoop-trunk\hadoop-trunk\hadoop-hdfs-project\hadoop-hdfs\src\main\java\org\apache\hadoop\hdfs\server\namenode\EncryptionZoneManager.java,743,104,14,5,7,130
 pulsar-master\pulsar-master\pulsar-functions\worker\src\main\java\org\apache\pulsar\functions\worker\rest\api\SourcesImpl.java,743,251,40,229,0,520
 pulsar-master\pulsar-master\pulsar-functions\worker\src\main\java\org\apache\pulsar\functions\worker\rest\api\SinksImpl.java,743,247,40,224,0,511
 pulsar-master\pulsar-master\pulsar-broker\src\test\java\org\apache\pulsar\client\api\ClientErrorsTest.java,743,181,12,118,0,311
 hadoop-trunk\hadoop-trunk\hadoop-yarn-project\hadoop-yarn\hadoop-yarn-server\hadoop-yarn-server-nodemanager\src\test\java\org\apache\hadoop\yarn\server\nodemanager\amrmproxy\BaseAMRMProxyTest.java,744,161,33,25,4,223
 kafka-trunk\kafka-trunk\streams\src\test\java\org\apache\kafka\streams\state\internals\AbstractSessionBytesStoreTest.java,744,0,54,157,56,267
 hadoop-trunk\hadoop-trunk\hadoop-tools\hadoop-distcp\src\main\java\org\apache\hadoop\tools\SimpleCopyListing.java,745,138,27,9,5,179
 pulsar-master\pulsar-master\pulsar-client-tools\src\main\java\org\apache\pulsar\admin\cli\CmdSinks.java,745,292,2,117,0,411
 kafka-trunk\kafka-trunk\streams\src\main\java\org\apache\kafka\streams\processor\internals\InternalTopicManager.java,746,0,22,199,1,222
 hadoop-trunk\hadoop-trunk\hadoop-tools\hadoop-archives\src\test\java\org\apache\hadoop\tools\TestHadoopArchives.java,748,153,21,17,8,199
 pulsar-master\pulsar-master\pulsar-broker\src\test\java\org\apache\pulsar\client\api\DeadLetterTopicTest.java,748,181,19,123,0,323
 hadoop-trunk\hadoop-trunk\hadoop-common-project\hadoop-common\src\test\java\org\apache\hadoop\ipc\TestFairCallQueue.java,749,198,17,13,7,235
 hadoop-trunk\hadoop-trunk\hadoop-yarn-project\hadoop-yarn\hadoop-yarn-applications\hadoop-yarn-services\hadoop-yarn-services-core\src\test\java\org\apache\hadoop\yarn\service\component\instance\TestComponentInstance.java,749,35,12,1,7,55
 pulsar-master\pulsar-master\pulsar-broker\src\test\java\org\apache\pulsar\broker\admin\v1\V1_AdminApi2Test.java,750,226,9,137,0,372
 hadoop-trunk\hadoop-trunk\hadoop-tools\hadoop-aws\src\main\java\org\apache\hadoop\fs\s3a\Listing.java,751,82,6,10,0,98
 hadoop-trunk\hadoop-trunk\hadoop-hdfs-project\hadoop-hdfs\src\test\java\org\apache\hadoop\hdfs\tools\TestDFSAdminWithHA.java,751,120,1,2,64,187
 hadoop-trunk\hadoop-trunk\hadoop-yarn-project\hadoop-yarn\hadoop-yarn-server\hadoop-yarn-server-resourcemanager\src\test\java\org\apache\hadoop\yarn\server\resourcemanager\scheduler\fair\TestFairSchedulerConfiguration.java,752,167,6,3,0,176
 hadoop-trunk\hadoop-trunk\hadoop-common-project\hadoop-common\src\test\java\org\apache\hadoop\io\file\tfile\TestTFileSeqFileComparison.java,752,218,86,8,3,315
 pulsar-master\pulsar-master\pulsar-broker\src\test\java\org\apache\pulsar\functions\worker\PulsarFunctionE2ESecurityTest.java,752,254,41,166,0,461
 hadoop-trunk\hadoop-trunk\hadoop-yarn-project\hadoop-yarn\hadoop-yarn-common\src\main\java\org\apache\hadoop\yarn\api\records\impl\pb\ApplicationReportPBImpl.java,753,165,115,16,0,296
 hadoop-trunk\hadoop-trunk\hadoop-yarn-project\hadoop-yarn\hadoop-yarn-server\hadoop-yarn-server-nodemanager\src\main\java\org\apache\hadoop\yarn\server\nodemanager\recovery\NMStateStoreService.java,753,220,31,10,21,282
 hadoop-trunk\hadoop-trunk\hadoop-cloud-storage-project\hadoop-cos\src\main\java\org\apache\hadoop\fs\cosn\CosNFileSystem.java,755,81,13,1,1,96
 rocketmq-develop\rocketmq-develop\store\src\main\java\org\apache\rocketmq\store\schedule\ScheduleMessageService.java,755,302,24,109,12,447
 hadoop-trunk\hadoop-trunk\hadoop-hdfs-project\hadoop-hdfs\src\main\java\org\apache\hadoop\hdfs\qjournal\client\QuorumJournalManager.java,756,207,62,12,2,283
 hadoop-trunk\hadoop-trunk\hadoop-yarn-project\hadoop-yarn\hadoop-yarn-server\hadoop-yarn-server-resourcemanager\src\test\java\org\apache\hadoop\yarn\server\resourcemanager\scheduler\TestQueueMetrics.java,757,206,3,26,0,235
 pulsar-master\pulsar-master\pulsar-functions\worker\src\main\java\org\apache\pulsar\functions\worker\rest\api\FunctionsImpl.java,758,264,38,240,0,542
 hadoop-trunk\hadoop-trunk\hadoop-mapreduce-project\hadoop-mapreduce-client\hadoop-mapreduce-client-jobclient\src\test\java\org\apache\hadoop\mapred\pipes\TestPipeApplication.java,759,136,22,23,52,233
 hadoop-trunk\hadoop-trunk\hadoop-hdfs-project\hadoop-hdfs\src\main\java\org\apache\hadoop\hdfs\server\blockmanagement\CacheReplicationMonitor.java,759,62,34,4,3,103
 kafka-trunk\kafka-trunk\clients\src\test\java\org\apache\kafka\clients\MockClient.java,760,0,25,84,12,121
 kafka-trunk\kafka-trunk\clients\src\main\java\org\apache\kafka\common\record\MemoryRecords.java,760,0,37,187,5,229
 hadoop-trunk\hadoop-trunk\hadoop-mapreduce-project\hadoop-mapreduce-client\hadoop-mapreduce-client-hs\src\test\java\org\apache\hadoop\mapreduce\v2\hs\webapp\TestHsWebServicesJobs.java,761,73,6,4,3,86
 hadoop-trunk\hadoop-trunk\hadoop-hdfs-project\hadoop-hdfs\src\main\java\org\apache\hadoop\hdfs\server\namenode\ReencryptionHandler.java,761,65,23,13,4,105
 kafka-trunk\kafka-trunk\clients\src\test\java\org\apache\kafka\clients\consumer\internals\SubscriptionStateTest.java,761,0,21,93,4,118
 hadoop-trunk\hadoop-trunk\hadoop-mapreduce-project\hadoop-mapreduce-client\hadoop-mapreduce-client-core\src\main\java\org\apache\hadoop\mapreduce\jobhistory\JobHistoryParser.java,762,319,36,4,23,382
 kafka-trunk\kafka-trunk\clients\src\main\java\org\apache\kafka\common\utils\LogContext.java,762,0,31,51,0,82
 hadoop-trunk\hadoop-trunk\hadoop-hdfs-project\hadoop-hdfs-httpfs\src\test\java\org\apache\hadoop\lib\server\TestServer.java,763,163,21,32,7,223
 hadoop-trunk\hadoop-trunk\hadoop-common-project\hadoop-common\src\test\java\org\apache\hadoop\ha\TestActiveStandbyElector.java,765,85,5,2,3,95
 hadoop-trunk\hadoop-trunk\hadoop-hdfs-project\hadoop-hdfs\src\test\java\org\apache\hadoop\hdfs\TestReconstructStripedFile.java,767,146,13,6,7,172
 kafka-trunk\kafka-trunk\streams\src\main\java\org\apache\kafka\streams\state\internals\metrics\RocksDBMetrics.java,767,0,0,182,0,182
 kafka-trunk\kafka-trunk\streams\src\test\java\org\apache\kafka\streams\processor\internals\ProcessorContextImplTest.java,767,0,2,89,5,96
 zookeeper-master\zookeeper-master\zookeeper-server\src\main\java\org\apache\zookeeper\server\NettyServerCnxnFactory.java,767,0,19,122,1,142
 pulsar-master\pulsar-master\pulsar-broker\src\test\java\org\apache\pulsar\compaction\CompactedTopicTest.java,768,189,2,117,0,308
 hadoop-trunk\hadoop-trunk\hadoop-mapreduce-project\hadoop-mapreduce-client\hadoop-mapreduce-client-core\src\test\java\org\apache\hadoop\mapreduce\task\reduce\TestFetcher.java,769,302,15,14,22,353
 pulsar-master\pulsar-master\pulsar-broker\src\test\java\org\apache\pulsar\broker\service\BrokerBookieIsolationTest.java,770,203,15,163,0,381
 hadoop-trunk\hadoop-trunk\hadoop-mapreduce-project\hadoop-mapreduce-client\hadoop-mapreduce-client-core\src\test\java\org\apache\hadoop\mapreduce\TestJobResourceUploader.java,771,154,13,1,0,168
 hadoop-trunk\hadoop-trunk\hadoop-hdfs-project\hadoop-hdfs\src\main\java\org\apache\hadoop\hdfs\server\namenode\snapshot\SnapshotManager.java,772,174,8,7,2,191
 hadoop-trunk\hadoop-trunk\hadoop-yarn-project\hadoop-yarn\hadoop-yarn-server\hadoop-yarn-server-nodemanager\src\main\java\org\apache\hadoop\yarn\server\nodemanager\containermanager\linux\runtime\RuncContainerRuntime.java,772,145,21,34,4,204
 hadoop-trunk\hadoop-trunk\hadoop-hdfs-project\hadoop-hdfs\src\test\java\org\apache\hadoop\fs\TestEnhancedByteBufferAccess.java,772,255,65,14,6,340
 hadoop-trunk\hadoop-trunk\hadoop-hdfs-project\hadoop-hdfs\src\test\java\org\apache\hadoop\hdfs\server\namenode\TestFSEditLogLoader.java,772,156,19,4,4,183
 kafka-trunk\kafka-trunk\clients\src\generated\java\org\apache\kafka\common\message\ElectLeadersResponseData.java,772,0,0,87,11,98
 hadoop-trunk\hadoop-trunk\hadoop-common-project\hadoop-common\src\test\java\org\apache\hadoop\fs\contract\AbstractContractMultipartUploaderTest.java,774,27,6,2,3,38
 hadoop-trunk\hadoop-trunk\hadoop-yarn-project\hadoop-yarn\hadoop-yarn-applications\hadoop-yarn-applications-distributedshell\src\test\java\org\apache\hadoop\yarn\applications\distributedshell\TestDSTimelineV10.java,774,44,36,1,13,94
 hadoop-trunk\hadoop-trunk\hadoop-hdfs-project\hadoop-hdfs\src\test\java\org\apache\hadoop\hdfs\server\namenode\TestFSImageWithSnapshot.java,775,156,8,4,3,171
 hadoop-trunk\hadoop-trunk\hadoop-tools\hadoop-azure\src\test\java\org\apache\hadoop\fs\azure\ITestFileSystemOperationsWithThreads.java,775,157,10,94,5,266
 pulsar-master\pulsar-master\pulsar-client-admin\src\main\java\org\apache\pulsar\client\admin\internal\FunctionsImpl.java,776,456,3,183,0,642
 hadoop-trunk\hadoop-trunk\hadoop-mapreduce-project\hadoop-mapreduce-client\hadoop-mapreduce-client-hs\src\test\java\org\apache\hadoop\mapreduce\v2\hs\webapp\TestHsWebServicesLogs.java,777,104,3,3,14,124
 kafka-trunk\kafka-trunk\clients\src\test\java\org\apache\kafka\common\record\MemoryRecordsBuilderTest.java,777,0,33,152,36,221
 kafka-trunk\kafka-trunk\streams\src\test\java\org\apache\kafka\streams\processor\internals\StateDirectoryTest.java,779,0,12,99,9,120
 pulsar-master\pulsar-master\pulsar-broker\src\main\java\org\apache\pulsar\broker\resourcegroup\ResourceGroupService.java,779,314,7,160,0,481
 kafka-trunk\kafka-trunk\clients\src\generated\java\org\apache\kafka\common\message\AlterClientQuotasResponseData.java,780,0,0,80,12,92
 hadoop-trunk\hadoop-trunk\hadoop-tools\hadoop-dynamometer\hadoop-dynamometer-infra\src\main\java\org\apache\hadoop\tools\dynamometer\ApplicationMaster.java,782,82,43,1,1,127
 pulsar-master\pulsar-master\pulsar-proxy\src\main\java\org\apache\pulsar\proxy\server\ProxyConfiguration.java,783,259,2,96,0,357
 pulsar-master\pulsar-master\pulsar-broker\src\main\java\org\apache\pulsar\broker\admin\AdminResource.java,783,332,50,185,0,567
 kafka-trunk\kafka-trunk\streams\src\test\java\org\apache\kafka\streams\kstream\internals\SuppressScenarioTest.java,785,0,13,144,1,158
 hadoop-trunk\hadoop-trunk\hadoop-tools\hadoop-azure\src\test\java\org\apache\hadoop\fs\azurebfs\services\TestAbfsInputStream.java,786,148,8,67,6,229
 pulsar-master\pulsar-master\pulsar-broker\src\test\java\org\apache\pulsar\client\api\SubscriptionMessageDispatchThrottlingTest.java,786,209,7,125,0,341
 hadoop-trunk\hadoop-trunk\hadoop-hdfs-project\hadoop-hdfs-rbf\src\main\java\org\apache\hadoop\hdfs\server\federation\router\Router.java,787,37,4,11,8,60
 hadoop-trunk\hadoop-trunk\hadoop-yarn-project\hadoop-yarn\hadoop-yarn-server\hadoop-yarn-server-timelineservice\src\test\java\org\apache\hadoop\yarn\server\timelineservice\storage\TestFileSystemTimelineReaderImpl.java,788,118,34,13,2,167
 pulsar-master\pulsar-master\pulsar-sql\presto-pulsar\src\main\java\org\apache\pulsar\sql\presto\PulsarRecordCursor.java,788,273,16,145,0,434
 hadoop-trunk\hadoop-trunk\hadoop-tools\hadoop-aws\src\main\java\org\apache\hadoop\fs\s3a\commit\staging\StagingCommitter.java,789,85,26,3,1,115
 pulsar-master\pulsar-master\pulsar-functions\instance\src\test\java\org\apache\pulsar\functions\windowing\WindowManagerTest.java,789,569,1,73,0,643
 kafka-trunk\kafka-trunk\clients\src\generated\java\org\apache\kafka\common\message\DescribeTransactionsResponseData.java,790,0,0,78,14,92
 hadoop-trunk\hadoop-trunk\hadoop-yarn-project\hadoop-yarn\hadoop-yarn-server\hadoop-yarn-server-timelineservice-hbase-tests\src\test\java\org\apache\hadoop\yarn\server\timelineservice\storage\flow\TestHBaseStorageFlowRunCompaction.java,791,66,27,8,1,102
 hadoop-trunk\hadoop-trunk\hadoop-yarn-project\hadoop-yarn\hadoop-yarn-server\hadoop-yarn-server-common\src\test\java\org\apache\hadoop\yarn\server\scheduler\TestDistributedOpportunisticContainerAllocator.java,792,110,4,1,2,117
 hadoop-trunk\hadoop-trunk\hadoop-yarn-project\hadoop-yarn\hadoop-yarn-server\hadoop-yarn-server-nodemanager\src\test\java\org\apache\hadoop\yarn\server\nodemanager\webapp\TestNMWebServices.java,792,108,21,13,0,142
 kafka-trunk\kafka-trunk\clients\src\generated\java\org\apache\kafka\common\message\FindCoordinatorResponseData.java,792,0,0,67,10,77
 rocketmq-develop\rocketmq-develop\store\src\main\java\org\apache\rocketmq\store\config\MessageStoreConfig.java,792,649,2,43,0,694
 zookeeper-master\zookeeper-master\zookeeper-server\src\test\java\org\apache\zookeeper\test\ClientTest.java,792,0,127,65,0,192
 zookeeper-master\zookeeper-master\zookeeper-server\src\test\java\org\apache\zookeeper\test\AsyncOps.java,792,0,124,24,9,157
 hadoop-trunk\hadoop-trunk\hadoop-yarn-project\hadoop-yarn\hadoop-yarn-server\hadoop-yarn-server-nodemanager\src\test\java\org\apache\hadoop\yarn\server\nodemanager\containermanager\resourceplugin\com\nvidia\TestNvidiaGPUPluginForRuntimeV2.java,795,148,19,4,4,175
 hadoop-trunk\hadoop-trunk\hadoop-yarn-project\hadoop-yarn\hadoop-yarn-server\hadoop-yarn-server-resourcemanager\src\test\java\org\apache\hadoop\yarn\server\resourcemanager\reservation\TestReservationInputValidator.java,796,169,0,16,0,185
 zookeeper-master\zookeeper-master\zookeeper-server\src\main\java\org\apache\zookeeper\server\admin\Commands.java,796,0,3,76,2,81
 hadoop-trunk\hadoop-trunk\hadoop-hdfs-project\hadoop-hdfs-client\src\main\java\org\apache\hadoop\hdfs\client\impl\BlockReaderFactory.java,798,129,40,7,6,182
 hadoop-trunk\hadoop-trunk\hadoop-common-project\hadoop-common\src\test\java\org\apache\hadoop\io\TestMapFile.java,798,130,47,7,0,184
 kafka-trunk\kafka-trunk\core\src\generated\java\kafka\internals\generated\GroupMetadataValue.java,798,0,0,56,17,73
 dubbo-3.0\dubbo-3.0\dubbo-rpc\dubbo-rpc-api\src\main\java\org\apache\dubbo\rpc\RpcContext.java,799,176,3,31,1,211
 hadoop-trunk\hadoop-trunk\hadoop-hdfs-project\hadoop-hdfs\src\main\java\org\apache\hadoop\hdfs\server\namenode\FSPermissionChecker.java,799,198,8,7,0,213
 kafka-trunk\kafka-trunk\clients\src\generated\java\org\apache\kafka\common\message\OffsetForLeaderEpochRequestData.java,802,0,0,77,10,87
 kafka-trunk\kafka-trunk\streams\src\test\java\org\apache\kafka\streams\processor\internals\assignment\HighAvailabilityTaskAssignorTest.java,803,0,0,273,0,273
 hadoop-trunk\hadoop-trunk\hadoop-mapreduce-project\hadoop-mapreduce-client\hadoop-mapreduce-client-core\src\test\java\org\apache\hadoop\mapreduce\lib\output\TestFileOutputCommitter.java,805,116,43,3,11,173
 kafka-trunk\kafka-trunk\streams\src\test\java\org\apache\kafka\streams\state\internals\AbstractRocksDBSegmentedBytesStoreTest.java,805,0,18,162,31,211
 kafka-trunk\kafka-trunk\clients\src\generated\java\org\apache\kafka\common\message\FetchSnapshotRequestData.java,807,0,0,67,16,83
 kafka-trunk\kafka-trunk\clients\src\generated\java\org\apache\kafka\common\message\SyncGroupRequestData.java,808,0,0,93,13,106
 hadoop-trunk\hadoop-trunk\hadoop-hdfs-project\hadoop-hdfs\src\main\java\org\apache\hadoop\hdfs\server\namenode\INodeReference.java,810,203,2,2,7,214
 kafka-trunk\kafka-trunk\clients\src\generated\java\org\apache\kafka\common\message\AddPartitionsToTxnResponseData.java,810,0,0,93,10,103
 hadoop-trunk\hadoop-trunk\hadoop-yarn-project\hadoop-yarn\hadoop-yarn-server\hadoop-yarn-server-resourcemanager\src\test\java\org\apache\hadoop\yarn\server\resourcemanager\scheduler\capacity\TestApplicationPriority.java,811,115,25,16,9,165
 hadoop-trunk\hadoop-trunk\hadoop-yarn-project\hadoop-yarn\hadoop-yarn-server\hadoop-yarn-server-nodemanager\src\main\java\org\apache\hadoop\yarn\server\nodemanager\amrmproxy\AMRMProxyService.java,813,63,39,11,8,121
 kafka-trunk\kafka-trunk\streams\src\test\java\org\apache\kafka\streams\processor\internals\PartitionGroupTest.java,813,0,7,71,3,81
 pulsar-master\pulsar-master\pulsar-testclient\src\main\java\org\apache\pulsar\testclient\PerformanceProducer.java,813,353,39,155,0,547
 kafka-trunk\kafka-trunk\clients\src\generated\java\org\apache\kafka\common\message\LeaderAndIsrResponseData.java,814,0,0,86,12,98
 hadoop-trunk\hadoop-trunk\hadoop-yarn-project\hadoop-yarn\hadoop-yarn-server\hadoop-yarn-server-resourcemanager\src\test\java\org\apache\hadoop\yarn\server\resourcemanager\scheduler\capacity\TestCapacitySchedulerQueues.java,815,84,12,34,2,132
 hadoop-trunk\hadoop-trunk\hadoop-yarn-project\hadoop-yarn\hadoop-yarn-server\hadoop-yarn-server-resourcemanager\src\main\java\org\apache\hadoop\yarn\server\resourcemanager\scheduler\AppSchedulingInfo.java,816,178,19,13,10,220
 kafka-trunk\kafka-trunk\streams\src\main\java\org\apache\kafka\streams\processor\internals\metrics\StreamsMetricsImpl.java,817,0,1,101,2,104
 hadoop-trunk\hadoop-trunk\hadoop-yarn-project\hadoop-yarn\hadoop-yarn-client\src\main\java\org\apache\hadoop\yarn\client\api\AMRMClient.java,818,253,9,7,12,281
 kafka-trunk\kafka-trunk\streams\src\test\java\org\apache\kafka\streams\state\internals\CachingInMemorySessionStoreTest.java,818,0,30,182,108,320
 kafka-trunk\kafka-trunk\clients\src\generated\java\org\apache\kafka\common\message\CreatePartitionsRequestData.java,818,0,0,78,12,90
 hadoop-trunk\hadoop-trunk\hadoop-tools\hadoop-distcp\src\test\java\org\apache\hadoop\tools\TestDistCpSyncReverseBase.java,819,73,23,2,4,102
 hadoop-trunk\hadoop-trunk\hadoop-hdfs-project\hadoop-hdfs-client\src\main\java\org\apache\hadoop\hdfs\protocol\DatanodeInfo.java,820,337,5,3,4,349
 kafka-trunk\kafka-trunk\clients\src\generated\java\org\apache\kafka\common\message\DeleteRecordsResponseData.java,820,0,0,86,10,96
 hadoop-trunk\hadoop-trunk\hadoop-mapreduce-project\hadoop-mapreduce-client\hadoop-mapreduce-client-app\src\test\java\org\apache\hadoop\mapreduce\v2\app\job\impl\TestTaskImpl.java,821,274,15,5,5,299
 kafka-trunk\kafka-trunk\clients\src\test\java\org\apache\kafka\common\utils\UtilsTest.java,821,0,34,75,19,128
 pulsar-master\pulsar-master\pulsar-broker\src\test\java\org\apache\pulsar\client\api\InterceptorsTest.java,821,266,26,100,0,392
 rocketmq-develop\rocketmq-develop\common\src\main\java\org\apache\rocketmq\common\BrokerConfig.java,821,636,0,48,0,684
 kafka-trunk\kafka-trunk\clients\src\generated\java\org\apache\kafka\common\message\OffsetForLeaderEpochResponseData.java,823,0,0,82,10,92
 kafka-trunk\kafka-trunk\storage\src\generated\java\org\apache\kafka\server\log\remote\metadata\storage\generated\RemoteLogSegmentMetadataRecord.java,823,0,0,73,17,90
 kafka-trunk\kafka-trunk\clients\src\generated\java\org\apache\kafka\common\message\DescribeQuorumResponseData.java,824,0,0,73,16,89
 shardingsphere-master\shardingsphere-master\shardingsphere-sql-parser\shardingsphere-sql-parser-dialect\shardingsphere-sql-parser-mysql\src\main\java\org\apache\shardingsphere\sql\parser\mysql\visitor\format\impl\MySQLFormatSQLVisitor.java,824,134,5,64,0,203
 hadoop-trunk\hadoop-trunk\hadoop-yarn-project\hadoop-yarn\hadoop-yarn-server\hadoop-yarn-server-resourcemanager\src\test\java\org\apache\hadoop\yarn\server\resourcemanager\TestRMHA.java,826,80,26,12,6,124
 kafka-trunk\kafka-trunk\clients\src\generated\java\org\apache\kafka\common\message\ListOffsetsRequestData.java,828,0,0,82,10,92
 hadoop-trunk\hadoop-trunk\hadoop-yarn-project\hadoop-yarn\hadoop-yarn-server\hadoop-yarn-server-resourcemanager\src\test\java\org\apache\hadoop\yarn\server\resourcemanager\scheduler\capacity\TestCapacitySchedulerAutoCreatedQueueBase.java,832,261,24,14,5,304
 pulsar-master\pulsar-master\pulsar-broker\src\test\java\org\apache\pulsar\client\api\BrokerServiceLookupTest.java,832,197,28,139,0,364
 zookeeper-master\zookeeper-master\zookeeper-server\src\main\java\org\apache\zookeeper\server\quorum\Learner.java,833,0,87,88,3,178
 kafka-trunk\kafka-trunk\streams\src\test\java\org\apache\kafka\streams\state\internals\CachingPersistentSessionStoreTest.java,834,0,30,164,108,302
 dubbo-3.0\dubbo-3.0\dubbo-cluster\src\test\java\org\apache\dubbo\rpc\cluster\support\wrapper\MockClusterInvokerTest.java,835,231,35,90,0,356
 pulsar-master\pulsar-master\pulsar-broker\src\test\java\org\apache\pulsar\broker\admin\AdminTest.java,837,220,32,142,0,394
 kafka-trunk\kafka-trunk\clients\src\main\java\org\apache\kafka\common\record\MemoryRecordsBuilder.java,838,0,47,146,3,196
 zookeeper-master\zookeeper-master\zookeeper-server\src\test\java\org\apache\zookeeper\server\quorum\QuorumSSLTest.java,838,0,39,162,17,218
 hadoop-trunk\hadoop-trunk\hadoop-hdfs-project\hadoop-hdfs-rbf\src\test\java\org\apache\hadoop\hdfs\server\federation\router\TestRouterRPCMultipleDestinationMountTableResolver.java,839,91,4,10,2,107
 hadoop-trunk\hadoop-trunk\hadoop-yarn-project\hadoop-yarn\hadoop-yarn-server\hadoop-yarn-server-nodemanager\src\main\java\org\apache\hadoop\yarn\server\nodemanager\ContainerExecutor.java,841,135,17,13,4,169
 hadoop-trunk\hadoop-trunk\hadoop-yarn-project\hadoop-yarn\hadoop-yarn-server\hadoop-yarn-server-resourcemanager\src\test\java\org\apache\hadoop\yarn\server\resourcemanager\scheduler\distributed\TestNodeQueueLoadMonitor.java,842,286,7,1,0,294
 dubbo-3.0\dubbo-3.0\dubbo-common\src\main\java\org\apache\dubbo\config\AbstractInterfaceConfig.java,843,363,7,76,20,466
 hadoop-trunk\hadoop-trunk\hadoop-hdfs-project\hadoop-hdfs\src\main\java\org\apache\hadoop\hdfs\server\mover\Mover.java,843,168,26,9,3,206
 hadoop-trunk\hadoop-trunk\hadoop-hdfs-project\hadoop-hdfs\src\main\java\org\apache\hadoop\hdfs\server\datanode\BlockPoolSliceStorage.java,843,156,18,14,2,190
 pulsar-master\pulsar-master\pulsar-client-tools-test\src\test\java\org\apache\pulsar\admin\cli\CmdFunctionsTest.java,843,170,13,70,0,253
 kafka-trunk\kafka-trunk\connect\runtime\src\test\java\org\apache\kafka\connect\util\TopicAdminTest.java,847,0,9,239,11,259
 hadoop-trunk\hadoop-trunk\hadoop-mapreduce-project\hadoop-mapreduce-client\hadoop-mapreduce-client-app\src\test\java\org\apache\hadoop\mapreduce\v2\app\webapp\TestAMWebServicesJobs.java,850,109,4,5,13,131
 rocketmq-develop\rocketmq-develop\client\src\main\java\org\apache\rocketmq\client\consumer\DefaultMQPushConsumer.java,852,380,3,128,8,519
 pulsar-master\pulsar-master\pulsar-broker-common\src\test\java\org\apache\pulsar\broker\authentication\AuthenticationProviderTokenTest.java,853,189,6,140,0,335
 dubbo-3.0\dubbo-3.0\dubbo-remoting\dubbo-remoting-api\src\test\java\org\apache\dubbo\remoting\buffer\AbstractChannelBufferTest.java,854,143,6,58,0,207
 hadoop-trunk\hadoop-trunk\hadoop-mapreduce-project\hadoop-mapreduce-client\hadoop-mapreduce-client-app\src\test\java\org\apache\hadoop\mapreduce\v2\app\TestRuntimeEstimators.java,854,157,5,19,1,182
 kafka-trunk\kafka-trunk\clients\src\generated\java\org\apache\kafka\common\message\DescribeProducersResponseData.java,854,0,0,75,15,90
 pulsar-master\pulsar-master\pulsar-functions\worker\src\main\java\org\apache\pulsar\functions\worker\SchedulerManager.java,854,232,9,125,0,366
 pulsar-master\pulsar-master\pulsar-broker\src\test\java\org\apache\pulsar\broker\transaction\TransactionTest.java,854,228,64,163,0,455
 zookeeper-master\zookeeper-master\zookeeper-server\src\test\java\org\apache\zookeeper\common\X509UtilTest.java,854,0,77,146,21,244
 hadoop-trunk\hadoop-trunk\hadoop-mapreduce-project\hadoop-mapreduce-client\hadoop-mapreduce-client-core\src\main\java\org\apache\hadoop\mapreduce\lib\chain\Chain.java,858,267,63,3,5,338
 hadoop-trunk\hadoop-trunk\hadoop-yarn-project\hadoop-yarn\hadoop-yarn-client\src\test\java\org\apache\hadoop\yarn\client\api\async\impl\TestNMClientAsync.java,858,161,13,1,1,176
 kafka-trunk\kafka-trunk\clients\src\generated\java\org\apache\kafka\common\message\WriteTxnMarkersResponseData.java,858,0,0,103,14,117
 hadoop-trunk\hadoop-trunk\hadoop-tools\hadoop-archives\src\main\java\org\apache\hadoop\tools\HadoopArchives.java,860,333,13,10,4,360
 kafka-trunk\kafka-trunk\clients\src\generated\java\org\apache\kafka\common\message\AlterReplicaLogDirsRequestData.java,860,0,0,81,13,94
 hadoop-trunk\hadoop-trunk\hadoop-mapreduce-project\hadoop-mapreduce-client\hadoop-mapreduce-client-jobclient\src\test\java\org\apache\hadoop\mapreduce\v2\TestSpeculativeExecOnCluster.java,862,164,31,3,1,199
 hadoop-trunk\hadoop-trunk\hadoop-hdfs-project\hadoop-hdfs\src\test\java\org\apache\hadoop\fs\viewfs\TestViewFileSystemLinkFallback.java,862,27,12,1,6,46
 hadoop-trunk\hadoop-trunk\hadoop-yarn-project\hadoop-yarn\hadoop-yarn-server\hadoop-yarn-server-resourcemanager\src\main\java\org\apache\hadoop\yarn\server\resourcemanager\reservation\InMemoryPlan.java,863,182,16,9,7,214
 hadoop-trunk\hadoop-trunk\hadoop-hdfs-project\hadoop-hdfs\src\test\java\org\apache\hadoop\hdfs\security\token\block\TestBlockToken.java,865,127,19,9,6,161
 kafka-trunk\kafka-trunk\streams\src\test\java\org\apache\kafka\streams\processor\internals\RecordCollectorTest.java,865,0,2,162,8,172
 dubbo-3.0\dubbo-3.0\dubbo-config\dubbo-config-api\src\test\java\org\apache\dubbo\config\bootstrap\MultiInstanceTest.java,866,199,15,134,0,348
 hadoop-trunk\hadoop-trunk\hadoop-yarn-project\hadoop-yarn\hadoop-yarn-server\hadoop-yarn-server-router\src\main\java\org\apache\hadoop\yarn\server\router\webapp\RouterWebServices.java,867,205,5,21,4,235
 hadoop-trunk\hadoop-trunk\hadoop-yarn-project\hadoop-yarn\hadoop-yarn-server\hadoop-yarn-server-resourcemanager\src\main\java\org\apache\hadoop\yarn\server\resourcemanager\rmcontainer\RMContainerImpl.java,868,209,10,11,20,250
 hadoop-trunk\hadoop-trunk\hadoop-common-project\hadoop-common\src\test\java\org\apache\hadoop\io\nativeio\TestNativeIO.java,868,167,93,1,35,296
 kafka-trunk\kafka-trunk\connect\json\src\test\java\org\apache\kafka\connect\json\JsonConverterTest.java,871,0,4,237,57,298
 kafka-trunk\kafka-trunk\streams\src\test\java\org\apache\kafka\streams\integration\NamedTopologyIntegrationTest.java,871,0,4,260,0,264
 pulsar-master\pulsar-master\pulsar-broker\src\main\java\org\apache\pulsar\broker\admin\v1\PersistentTopics.java,871,764,16,291,0,1071
 hadoop-trunk\hadoop-trunk\hadoop-hdfs-project\hadoop-hdfs\src\test\java\org\apache\hadoop\hdfs\server\namenode\snapshot\TestAclWithSnapshot.java,873,202,67,2,5,276
 hadoop-trunk\hadoop-trunk\hadoop-tools\hadoop-azure\src\test\java\org\apache\hadoop\fs\azure\ITestBlockBlobInputStream.java,874,103,35,6,3,147
 hadoop-trunk\hadoop-trunk\hadoop-yarn-project\hadoop-yarn\hadoop-yarn-server\hadoop-yarn-server-tests\src\test\java\org\apache\hadoop\yarn\server\MiniYARNCluster.java,875,187,19,25,9,240
 hadoop-trunk\hadoop-trunk\hadoop-yarn-project\hadoop-yarn\hadoop-yarn-server\hadoop-yarn-server-applicationhistoryservice\src\test\java\org\apache\hadoop\yarn\server\applicationhistoryservice\webapp\TestAHSWebServices.java,879,90,23,8,22,143
 hadoop-trunk\hadoop-trunk\hadoop-yarn-project\hadoop-yarn\hadoop-yarn-server\hadoop-yarn-server-resourcemanager\src\test\java\org\apache\hadoop\yarn\server\resourcemanager\scheduler\constraint\TestPlacementProcessor.java,879,278,19,8,2,307
 hadoop-trunk\hadoop-trunk\hadoop-common-project\hadoop-common\src\main\java\org\apache\hadoop\fs\ChecksumFileSystem.java,880,303,7,16,1,327
 hadoop-trunk\hadoop-trunk\hadoop-hdfs-project\hadoop-hdfs\src\test\java\org\apache\hadoop\hdfs\server\datanode\TestDataNodeVolumeFailure.java,883,214,14,10,7,245
 hadoop-trunk\hadoop-trunk\hadoop-yarn-project\hadoop-yarn\hadoop-yarn-server\hadoop-yarn-server-nodemanager\src\test\java\org\apache\hadoop\yarn\server\nodemanager\amrmproxy\TestFederationInterceptor.java,885,52,12,13,5,82
 hadoop-trunk\hadoop-trunk\hadoop-yarn-project\hadoop-yarn\hadoop-yarn-server\hadoop-yarn-server-resourcemanager\src\main\java\org\apache\hadoop\yarn\server\resourcemanager\scheduler\capacity\allocator\RegularContainerAllocator.java,886,130,13,27,0,170
 hadoop-trunk\hadoop-trunk\hadoop-yarn-project\hadoop-yarn\hadoop-yarn-server\hadoop-yarn-server-resourcemanager\src\test\java\org\apache\hadoop\yarn\server\resourcemanager\scheduler\fair\TestAllocationFileLoaderService.java,887,171,20,24,2,217
 hadoop-trunk\hadoop-trunk\hadoop-yarn-project\hadoop-yarn\hadoop-yarn-api\src\main\java\org\apache\hadoop\yarn\api\resource\PlacementConstraint.java,888,214,3,1,14,232
 hadoop-trunk\hadoop-trunk\hadoop-tools\hadoop-azure\src\test\java\org\apache\hadoop\fs\azurebfs\ITestCustomerProvidedKey.java,889,83,5,27,8,123
 hadoop-trunk\hadoop-trunk\hadoop-hdfs-project\hadoop-hdfs\src\test\java\org\apache\hadoop\hdfs\server\blockmanagement\TestReplicationPolicyWithNodeGroup.java,889,365,22,25,0,412
 hadoop-trunk\hadoop-trunk\hadoop-hdfs-project\hadoop-hdfs\src\test\java\org\apache\hadoop\hdfs\server\diskbalancer\command\TestDiskBalancerCommand.java,889,110,50,3,12,175
 kafka-trunk\kafka-trunk\clients\src\test\java\org\apache\kafka\common\metrics\MetricsTest.java,889,0,14,158,6,178
 pulsar-master\pulsar-master\pulsar-broker\src\main\java\org\apache\pulsar\broker\transaction\pendingack\impl\PendingAckHandleImpl.java,889,313,13,209,0,535
 hadoop-trunk\hadoop-trunk\hadoop-tools\hadoop-azure\src\test\java\org\apache\hadoop\fs\azure\AzureBlobStorageTestAccount.java,890,210,16,29,4,259
 hadoop-trunk\hadoop-trunk\hadoop-tools\hadoop-rumen\src\main\java\org\apache\hadoop\tools\rumen\ZombieJob.java,890,185,48,11,14,258
 hadoop-trunk\hadoop-trunk\hadoop-common-project\hadoop-common\src\test\java\org\apache\hadoop\fs\shell\find\TestFind.java,890,72,38,1,4,115
 zookeeper-master\zookeeper-master\zookeeper-server\src\main\java\org\apache\zookeeper\server\NIOServerCnxnFactory.java,891,0,17,44,3,64
 hadoop-trunk\hadoop-trunk\hadoop-yarn-project\hadoop-yarn\hadoop-yarn-server\hadoop-yarn-server-nodemanager\src\test\java\org\apache\hadoop\yarn\server\nodemanager\containermanager\TestAuxServices.java,892,149,62,11,14,236
 hadoop-trunk\hadoop-trunk\hadoop-hdfs-project\hadoop-hdfs-client\src\main\java\org\apache\hadoop\hdfs\web\JsonUtilClient.java,892,112,33,4,12,161
 hadoop-trunk\hadoop-trunk\hadoop-yarn-project\hadoop-yarn\hadoop-yarn-server\hadoop-yarn-server-resourcemanager\src\test\java\org\apache\hadoop\yarn\server\resourcemanager\scheduler\capacity\TestAbsoluteResourceConfiguration.java,893,271,7,120,8,406
 hadoop-trunk\hadoop-trunk\hadoop-yarn-project\hadoop-yarn\hadoop-yarn-client\src\main\java\org\apache\hadoop\yarn\client\api\YarnClient.java,893,64,1,12,0,77
 kafka-trunk\kafka-trunk\streams\src\main\java\org\apache\kafka\streams\processor\internals\StoreChangelogReader.java,893,0,9,238,1,248
 hadoop-trunk\hadoop-trunk\hadoop-yarn-project\hadoop-yarn\hadoop-yarn-server\hadoop-yarn-server-resourcemanager\src\main\java\org\apache\hadoop\yarn\server\resourcemanager\scheduler\fifo\FifoScheduler.java,894,250,35,34,0,319
 kafka-trunk\kafka-trunk\clients\src\generated\java\org\apache\kafka\common\message\ListOffsetsResponseData.java,895,0,0,98,12,110
 hadoop-trunk\hadoop-trunk\hadoop-yarn-project\hadoop-yarn\hadoop-yarn-server\hadoop-yarn-server-resourcemanager\src\test\java\org\apache\hadoop\yarn\server\resourcemanager\scheduler\capacity\TestCapacitySchedulerNodeLabelUpdate.java,897,243,12,23,6,284
 hadoop-trunk\hadoop-trunk\hadoop-yarn-project\hadoop-yarn\hadoop-yarn-server\hadoop-yarn-server-resourcemanager\src\test\java\org\apache\hadoop\yarn\server\resourcemanager\recovery\RMStateStoreTestBase.java,899,156,94,19,5,274
 hadoop-trunk\hadoop-trunk\hadoop-yarn-project\hadoop-yarn\hadoop-yarn-server\hadoop-yarn-server-resourcemanager\src\test\java\org\apache\hadoop\yarn\server\resourcemanager\monitor\capacity\TestProportionalCapacityPreemptionPolicyIntraQueueUserLimit.java,900,116,0,13,0,129
 hadoop-trunk\hadoop-trunk\hadoop-hdfs-project\hadoop-hdfs\src\test\java\org\apache\hadoop\hdfs\server\namenode\ha\TestHASafeMode.java,900,266,13,12,3,294
 kafka-trunk\kafka-trunk\connect\runtime\src\test\java\org\apache\kafka\connect\runtime\standalone\StandaloneHerderTest.java,900,0,30,181,4,215
 kafka-trunk\kafka-trunk\streams\src\main\java\org\apache\kafka\streams\Topology.java,900,0,1,371,1,373
 dubbo-3.0\dubbo-3.0\dubbo-common\src\main\java\org\apache\dubbo\common\io\Bytes.java,901,319,23,35,1,378
 hadoop-trunk\hadoop-trunk\hadoop-hdfs-project\hadoop-hdfs\src\test\java\org\apache\hadoop\hdfs\server\namenode\TestQuotaByStorageType.java,901,135,17,24,2,178
 hadoop-trunk\hadoop-trunk\hadoop-common-project\hadoop-common\src\main\java\org\apache\hadoop\fs\viewfs\InodeTree.java,901,109,14,1,5,129
 hadoop-trunk\hadoop-trunk\hadoop-yarn-project\hadoop-yarn\hadoop-yarn-common\src\main\java\org\apache\hadoop\yarn\api\protocolrecords\impl\pb\AllocateResponsePBImpl.java,902,144,109,5,0,258
 rocketmq-develop\rocketmq-develop\filter\src\main\java\org\apache\rocketmq\filter\parser\SelectorParserTokenManager.java,902,636,118,13,11,778
 hadoop-trunk\hadoop-trunk\hadoop-mapreduce-project\hadoop-mapreduce-client\hadoop-mapreduce-client-jobclient\src\test\java\org\apache\hadoop\mapred\TestYARNRunner.java,903,204,28,40,10,282
 hadoop-trunk\hadoop-trunk\hadoop-yarn-project\hadoop-yarn\hadoop-yarn-applications\hadoop-yarn-services\hadoop-yarn-services-api\src\main\java\org\apache\hadoop\yarn\service\webapp\ApiServer.java,903,119,26,2,2,149
 hadoop-trunk\hadoop-trunk\hadoop-tools\hadoop-gridmix\src\test\java\org\apache\hadoop\mapred\gridmix\TestGridMixClasses.java,904,230,23,16,4,273
 zookeeper-master\zookeeper-master\zookeeper-server\src\main\java\org\apache\zookeeper\server\quorum\QuorumPeerConfig.java,905,0,61,101,8,170
 kafka-trunk\kafka-trunk\metadata\src\generated\java\org\apache\kafka\common\metadata\RegisterBrokerRecord.java,906,0,0,67,14,81
 rocketmq-develop\rocketmq-develop\acl\src\test\java\org\apache\rocketmq\acl\plain\PlainAccessValidatorTest.java,906,249,22,189,21,481
 hadoop-trunk\hadoop-trunk\hadoop-yarn-project\hadoop-yarn\hadoop-yarn-server\hadoop-yarn-server-nodemanager\src\test\java\org\apache\hadoop\yarn\server\nodemanager\containermanager\linux\runtime\TestRuncContainerRuntime.java,908,95,31,31,9,166
 pulsar-master\pulsar-master\pulsar-broker\src\test\java\org\apache\pulsar\broker\resourcegroup\RGUsageMTAggrWaitForAllMsgsTest.java,908,337,47,183,0,567
 pulsar-master\pulsar-master\managed-ledger\src\main\java\org\apache\bookkeeper\mledger\impl\ManagedLedgerFactoryImpl.java,908,357,15,157,0,529
 hadoop-trunk\hadoop-trunk\hadoop-hdfs-project\hadoop-hdfs\src\test\java\org\apache\hadoop\hdfs\TestErasureCodingPolicies.java,910,106,32,4,7,149
 hadoop-trunk\hadoop-trunk\hadoop-hdfs-project\hadoop-hdfs\src\test\java\org\apache\hadoop\hdfs\shortcircuit\TestShortCircuitCache.java,910,199,35,18,14,266
 zookeeper-master\zookeeper-master\zookeeper-server\src\test\java\org\apache\zookeeper\test\MultiOperationTest.java,910,0,126,160,1,287
 kafka-trunk\kafka-trunk\clients\src\generated\java\org\apache\kafka\common\message\BrokerRegistrationRequestData.java,912,0,0,72,14,86
 pulsar-master\pulsar-master\pulsar-metadata\src\main\java\org\apache\pulsar\metadata\bookkeeper\PulsarLedgerUnderreplicationManager.java,913,268,11,172,0,451
 hadoop-trunk\hadoop-trunk\hadoop-mapreduce-project\hadoop-mapreduce-client\hadoop-mapreduce-client-jobclient\src\main\java\org\apache\hadoop\mapred\YARNRunner.java,914,172,17,8,4,201
 hadoop-trunk\hadoop-trunk\hadoop-common-project\hadoop-common\src\test\java\org\apache\hadoop\crypto\key\kms\TestLoadBalancingKMSClientProvider.java,915,42,40,2,17,101
 hadoop-trunk\hadoop-trunk\hadoop-hdfs-project\hadoop-hdfs-client\src\main\java\org\apache\hadoop\hdfs\client\impl\DfsClientConf.java,916,122,6,56,2,186
 hadoop-trunk\hadoop-trunk\hadoop-tools\hadoop-aws\src\main\java\org\apache\hadoop\fs\s3a\s3guard\S3GuardTool.java,917,128,13,12,3,156
 hadoop-trunk\hadoop-trunk\hadoop-hdfs-project\hadoop-hdfs\src\test\java\org\apache\hadoop\hdfs\protocolPB\TestPBHelper.java,917,217,128,28,5,378
 kafka-trunk\kafka-trunk\clients\src\generated\java\org\apache\kafka\common\message\AlterConfigsRequestData.java,918,0,0,85,12,97
 hadoop-trunk\hadoop-trunk\hadoop-yarn-project\hadoop-yarn\hadoop-yarn-server\hadoop-yarn-server-nodemanager\src\test\java\org\apache\hadoop\yarn\server\nodemanager\containermanager\resourceplugin\deviceframework\TestDevicePluginAdapter.java,919,69,18,22,5,114
 hadoop-trunk\hadoop-trunk\hadoop-hdfs-project\hadoop-hdfs\src\main\java\org\apache\hadoop\hdfs\tools\CacheAdmin.java,920,121,4,5,0,130
 hadoop-trunk\hadoop-trunk\hadoop-tools\hadoop-openstack\src\main\java\org\apache\hadoop\fs\swift\snative\SwiftNativeFileSystemStore.java,922,112,8,19,0,139
 hadoop-trunk\hadoop-trunk\hadoop-yarn-project\hadoop-yarn\hadoop-yarn-server\hadoop-yarn-server-common\src\main\java\org\apache\hadoop\yarn\server\federation\store\impl\SQLFederationStateStore.java,922,114,33,37,0,184
 hadoop-trunk\hadoop-trunk\hadoop-mapreduce-project\hadoop-mapreduce-client\hadoop-mapreduce-client-jobclient\src\test\java\org\apache\hadoop\hdfs\NNBench.java,924,328,56,1,5,390
 hadoop-trunk\hadoop-trunk\hadoop-yarn-project\hadoop-yarn\hadoop-yarn-server\hadoop-yarn-server-nodemanager\src\test\java\org\apache\hadoop\yarn\server\nodemanager\containermanager\localizer\TestLocalResourcesTrackerImpl.java,924,70,16,26,5,117
 kafka-trunk\kafka-trunk\streams\src\test\java\org\apache\kafka\streams\tests\RelationalSmokeTest.java,924,0,11,137,5,153
 pulsar-master\pulsar-master\pulsar-broker\src\test\java\org\apache\pulsar\client\api\AuthorizationProducerConsumerTest.java,925,394,24,212,0,630
 rocketmq-develop\rocketmq-develop\common\src\main\java\org\apache\rocketmq\common\MQVersion.java,928,619,1,1,0,621
 hadoop-trunk\hadoop-trunk\hadoop-yarn-project\hadoop-yarn\hadoop-yarn-server\hadoop-yarn-server-resourcemanager\src\test\java\org\apache\hadoop\yarn\server\resourcemanager\scheduler\capacity\TestApplicationLimits.java,929,348,52,35,11,446
 hadoop-trunk\hadoop-trunk\hadoop-yarn-project\hadoop-yarn\hadoop-yarn-server\hadoop-yarn-server-resourcemanager\src\test\java\org\apache\hadoop\yarn\server\resourcemanager\MockRM.java,930,240,25,28,13,306
 dubbo-3.0\dubbo-3.0\dubbo-common\src\test\java\org\apache\dubbo\common\utils\PojoUtilsTest.java,931,353,57,36,16,462
 hadoop-trunk\hadoop-trunk\hadoop-hdfs-project\hadoop-hdfs\src\main\java\org\apache\hadoop\hdfs\tools\offlineImageViewer\PBImageTextWriter.java,931,180,85,15,0,280
 hadoop-trunk\hadoop-trunk\hadoop-yarn-project\hadoop-yarn\hadoop-yarn-common\src\test\java\org\apache\hadoop\yarn\util\TestProcfsBasedProcessTree.java,932,184,32,6,10,232
 hadoop-trunk\hadoop-trunk\hadoop-yarn-project\hadoop-yarn\hadoop-yarn-server\hadoop-yarn-server-resourcemanager\src\main\java\org\apache\hadoop\yarn\server\resourcemanager\recovery\FileSystemRMStateStore.java,932,153,53,16,38,260
 kafka-trunk\kafka-trunk\clients\src\generated\java\org\apache\kafka\common\message\IncrementalAlterConfigsRequestData.java,932,0,0,91,12,103
 hadoop-trunk\hadoop-trunk\hadoop-yarn-project\hadoop-yarn\hadoop-yarn-client\src\main\java\org\apache\hadoop\yarn\client\api\async\impl\NMClientAsyncImpl.java,933,196,68,8,20,292
 kafka-trunk\kafka-trunk\clients\src\generated\java\org\apache\kafka\common\message\DescribeAclsResponseData.java,933,0,0,95,13,108
 pulsar-master\pulsar-master\pulsar-functions\worker\src\main\java\org\apache\pulsar\functions\worker\FunctionRuntimeManager.java,936,335,15,209,0,559
 hadoop-trunk\hadoop-trunk\hadoop-yarn-project\hadoop-yarn\hadoop-yarn-common\src\main\java\org\apache\hadoop\yarn\client\api\impl\FileSystemTimelineWriter.java,938,198,13,1,2,214
 hadoop-trunk\hadoop-trunk\hadoop-hdfs-project\hadoop-hdfs-httpfs\src\main\java\org\apache\hadoop\fs\http\server\HttpFSServer.java,940,158,22,33,1,214
 kafka-trunk\kafka-trunk\clients\src\generated\java\org\apache\kafka\common\message\JoinGroupRequestData.java,941,0,0,100,13,113
 pulsar-master\pulsar-master\pulsar-broker\src\main\java\org\apache\pulsar\broker\service\Consumer.java,941,386,17,169,0,572
 hadoop-trunk\hadoop-trunk\hadoop-common-project\hadoop-common\src\test\java\org\apache\hadoop\fs\TestLocalFileSystem.java,944,162,49,9,16,236
 dubbo-3.0\dubbo-3.0\dubbo-common\src\main\java\org\apache\dubbo\config\AbstractConfig.java,945,244,33,118,21,416
 pulsar-master\pulsar-master\pulsar-broker\src\test\java\org\apache\pulsar\client\impl\BrokerClientIntegrationTest.java,945,212,42,151,0,405
 rocketmq-develop\rocketmq-develop\store\src\main\java\org\apache\rocketmq\store\dledger\DLedgerCommitLog.java,946,278,15,137,4,434
 kafka-trunk\kafka-trunk\clients\src\generated\java\org\apache\kafka\common\message\ProduceRequestData.java,947,0,0,88,11,99
 kafka-trunk\kafka-trunk\raft\src\test\java\org\apache\kafka\raft\MockLogTest.java,948,0,5,120,52,177
 hadoop-trunk\hadoop-trunk\hadoop-common-project\hadoop-common\src\main\java\org\apache\hadoop\ha\ZKFailoverController.java,949,192,32,11,7,242
 hadoop-trunk\hadoop-trunk\hadoop-yarn-project\hadoop-yarn\hadoop-yarn-applications\hadoop-yarn-services\hadoop-yarn-services-core\src\test\java\org\apache\hadoop\yarn\service\TestYarnNativeServices.java,951,118,7,11,8,144
 kafka-trunk\kafka-trunk\metadata\src\test\java\org\apache\kafka\controller\QuorumControllerTest.java,951,0,1,210,0,211
 kafka-trunk\kafka-trunk\clients\src\main\java\org\apache\kafka\clients\producer\internals\Sender.java,953,0,33,197,4,234
 hadoop-trunk\hadoop-trunk\hadoop-yarn-project\hadoop-yarn\hadoop-yarn-server\hadoop-yarn-server-resourcemanager\src\test\java\org\apache\hadoop\yarn\server\resourcemanager\scheduler\capacity\TestApplicationLimitsByPartition.java,954,119,61,14,5,199
 hadoop-trunk\hadoop-trunk\hadoop-common-project\hadoop-common\src\test\java\org\apache\hadoop\security\token\delegation\web\TestWebDelegationToken.java,955,134,9,18,2,163
 zookeeper-master\zookeeper-master\zookeeper-server\src\main\java\org\apache\zookeeper\KeeperException.java,955,0,25,21,0,46
 hadoop-trunk\hadoop-trunk\hadoop-hdfs-project\hadoop-hdfs-client\src\main\java\org\apache\hadoop\hdfs\util\StripedBlockUtil.java,956,287,6,3,5,301
 hadoop-trunk\hadoop-trunk\hadoop-yarn-project\hadoop-yarn\hadoop-yarn-server\hadoop-yarn-server-resourcemanager\src\test\java\org\apache\hadoop\yarn\server\resourcemanager\webapp\TestRMWebServicesConfigurationMutation.java,956,156,29,66,3,254
 hadoop-trunk\hadoop-trunk\hadoop-yarn-project\hadoop-yarn\hadoop-yarn-client\src\main\java\org\apache\hadoop\yarn\client\cli\RMAdminCLI.java,957,120,16,20,4,160
 kafka-trunk\kafka-trunk\clients\src\test\java\org\apache\kafka\clients\MetadataTest.java,957,0,24,232,3,259
 pulsar-master\pulsar-master\pulsar-functions\utils\src\main\java\org\apache\pulsar\functions\utils\FunctionConfigUtils.java,957,244,29,216,0,489
 hadoop-trunk\hadoop-trunk\hadoop-yarn-project\hadoop-yarn\hadoop-yarn-server\hadoop-yarn-server-nodemanager\src\main\java\org\apache\hadoop\yarn\server\nodemanager\LinuxContainerExecutor.java,958,134,36,51,5,226
 hadoop-trunk\hadoop-trunk\hadoop-hdfs-project\hadoop-hdfs\src\main\java\org\apache\hadoop\hdfs\server\balancer\Balancer.java,959,283,28,22,3,336
 kafka-trunk\kafka-trunk\clients\src\generated\java\org\apache\kafka\common\message\JoinGroupResponseData.java,959,0,0,113,13,126
 hadoop-trunk\hadoop-trunk\hadoop-yarn-project\hadoop-yarn\hadoop-yarn-common\src\test\java\org\apache\hadoop\yarn\api\TestPBImplRecords.java,960,170,100,207,0,477
 hadoop-trunk\hadoop-trunk\hadoop-mapreduce-project\hadoop-mapreduce-client\hadoop-mapreduce-client-hs\src\test\java\org\apache\hadoop\mapreduce\v2\hs\TestJobHistoryParsing.java,961,122,98,8,5,233
 dubbo-3.0\dubbo-3.0\dubbo-config\dubbo-config-api\src\test\java\org\apache\dubbo\config\AbstractConfigTest.java,962,250,68,74,0,392
 hadoop-trunk\hadoop-trunk\hadoop-yarn-project\hadoop-yarn\hadoop-yarn-server\hadoop-yarn-server-resourcemanager\src\main\java\org\apache\hadoop\yarn\server\resourcemanager\RMAppManager.java,962,136,24,19,13,192
 hadoop-trunk\hadoop-trunk\hadoop-hdfs-project\hadoop-hdfs\src\test\java\org\apache\hadoop\hdfs\server\namenode\snapshot\TestOpenFilesWithSnapshot.java,963,78,7,1,8,94
 hadoop-trunk\hadoop-trunk\hadoop-common-project\hadoop-common\src\test\java\org\apache\hadoop\fs\FileSystemContractBaseTest.java,963,131,20,4,4,159
 dubbo-3.0\dubbo-3.0\dubbo-config\dubbo-config-api\src\main\java\org\apache\dubbo\config\deploy\DefaultApplicationDeployer.java,964,173,23,106,0,302
 pulsar-master\pulsar-master\pulsar-broker\src\main\java\org\apache\pulsar\broker\admin\impl\ClustersBase.java,966,262,54,129,0,445
 hadoop-trunk\hadoop-trunk\hadoop-yarn-project\hadoop-yarn\hadoop-yarn-server\hadoop-yarn-server-resourcemanager\src\main\java\org\apache\hadoop\yarn\server\resourcemanager\ResourceTrackerService.java,968,109,30,19,8,166
 kafka-trunk\kafka-trunk\connect\runtime\src\main\java\org\apache\kafka\connect\runtime\Worker.java,969,0,22,222,2,246
 hadoop-trunk\hadoop-trunk\hadoop-yarn-project\hadoop-yarn\hadoop-yarn-server\hadoop-yarn-server-nodemanager\src\main\java\org\apache\hadoop\yarn\server\nodemanager\DefaultContainerExecutor.java,970,140,13,9,1,163
 hadoop-trunk\hadoop-trunk\hadoop-common-project\hadoop-common\src\test\java\org\apache\hadoop\crypto\CryptoStreamsTestBase.java,972,296,28,1,7,332
 hadoop-trunk\hadoop-trunk\hadoop-common-project\hadoop-common\src\main\java\org\apache\hadoop\net\NetworkTopology.java,972,270,19,9,0,298
 hadoop-trunk\hadoop-trunk\hadoop-tools\hadoop-azure-datalake\src\main\java\org\apache\hadoop\fs\adl\AdlFileSystem.java,975,84,10,2,6,102
 shardingsphere-master\shardingsphere-master\shardingsphere-sql-parser\shardingsphere-sql-parser-dialect\shardingsphere-sql-parser-postgresql\src\main\java\org\apache\shardingsphere\sql\parser\postgresql\visitor\statement\impl\PostgreSQLStatementSQLVisitor.java,975,330,3,338,0,671
 hadoop-trunk\hadoop-trunk\hadoop-mapreduce-project\hadoop-mapreduce-client\hadoop-mapreduce-client-common\src\main\java\org\apache\hadoop\mapred\LocalJobRunner.java,976,327,74,17,24,442
 kafka-trunk\kafka-trunk\clients\src\generated\java\org\apache\kafka\common\message\DescribeDelegationTokenResponseData.java,977,0,0,126,16,142
 hadoop-trunk\hadoop-trunk\hadoop-yarn-project\hadoop-yarn\hadoop-yarn-server\hadoop-yarn-server-resourcemanager\src\test\java\org\apache\hadoop\yarn\server\resourcemanager\webapp\TestRMWebServices.java,981,130,16,16,3,165
 hadoop-trunk\hadoop-trunk\hadoop-yarn-project\hadoop-yarn\hadoop-yarn-server\hadoop-yarn-server-applicationhistoryservice\src\test\java\org\apache\hadoop\yarn\server\timeline\webapp\TestTimelineWebServices.java,982,73,84,8,0,165
 hadoop-trunk\hadoop-trunk\hadoop-hdfs-project\hadoop-hdfs-client\src\main\java\org\apache\hadoop\hdfs\shortcircuit\ShortCircuitCache.java,982,111,33,6,1,151
 pulsar-master\pulsar-master\pulsar-broker\src\test\java\org\apache\pulsar\client\impl\TransactionEndToEndTest.java,982,205,46,122,0,373
 hadoop-trunk\hadoop-trunk\hadoop-yarn-project\hadoop-yarn\hadoop-yarn-common\src\main\java\org\apache\hadoop\yarn\util\ProcfsBasedProcessTree.java,985,176,26,8,3,213
 hadoop-trunk\hadoop-trunk\hadoop-common-project\hadoop-common\src\test\java\org\apache\hadoop\test\GenericTestUtils.java,985,200,11,6,10,227
 hadoop-trunk\hadoop-trunk\hadoop-mapreduce-project\hadoop-mapreduce-client\hadoop-mapreduce-client-jobclient\src\test\java\org\apache\hadoop\fs\JHLogAnalyzer.java,986,564,175,8,16,763
 hadoop-trunk\hadoop-trunk\hadoop-yarn-project\hadoop-yarn\hadoop-yarn-server\hadoop-yarn-server-applicationhistoryservice\src\test\java\org\apache\hadoop\yarn\server\timeline\TimelineStoreTestUtils.java,987,370,29,10,4,413
 kafka-trunk\kafka-trunk\clients\src\generated\java\org\apache\kafka\common\message\AlterClientQuotasRequestData.java,988,0,0,97,17,114
 hadoop-trunk\hadoop-trunk\hadoop-yarn-project\hadoop-yarn\hadoop-yarn-server\hadoop-yarn-server-resourcemanager\src\test\java\org\apache\hadoop\yarn\server\resourcemanager\monitor\capacity\TestProportionalCapacityPreemptionPolicyIntraQueue.java,991,196,0,4,0,200
 pulsar-master\pulsar-master\pulsar-broker\src\test\java\org\apache\pulsar\client\api\DispatcherBlockConsumerTest.java,991,258,11,188,0,457
 hadoop-trunk\hadoop-trunk\hadoop-yarn-project\hadoop-yarn\hadoop-yarn-server\hadoop-yarn-server-nodemanager\src\test\java\org\apache\hadoop\yarn\server\nodemanager\containermanager\TestContainerManagerRecovery.java,992,91,17,26,11,145
 kafka-trunk\kafka-trunk\connect\runtime\src\test\java\org\apache\kafka\connect\runtime\rest\resources\ConnectorsResourceTest.java,992,0,8,244,5,257
 hadoop-trunk\hadoop-trunk\hadoop-yarn-project\hadoop-yarn\hadoop-yarn-server\hadoop-yarn-server-resourcemanager\src\test\java\org\apache\hadoop\yarn\server\resourcemanager\webapp\TestRMWebServicesNodes.java,993,222,0,14,1,237
 kafka-trunk\kafka-trunk\clients\src\generated\java\org\apache\kafka\common\message\FetchSnapshotResponseData.java,993,0,0,81,19,100
 pulsar-master\pulsar-master\pulsar-broker\src\test\java\org\apache\pulsar\websocket\proxy\ProxyPublishConsumeTest.java,993,227,8,132,0,367
 hadoop-trunk\hadoop-trunk\hadoop-hdfs-project\hadoop-hdfs\src\test\java\org\apache\hadoop\hdfs\server\blockmanagement\TestDatanodeManager.java,994,163,43,3,5,214
 kafka-trunk\kafka-trunk\clients\src\test\java\org\apache\kafka\clients\consumer\internals\AbstractStickyAssignorTest.java,995,0,34,165,4,203
 kafka-trunk\kafka-trunk\tools\src\test\java\org\apache\kafka\tools\TransactionsCommandTest.java,996,0,24,71,2,97
 hadoop-trunk\hadoop-trunk\hadoop-hdfs-project\hadoop-hdfs\src\main\java\org\apache\hadoop\hdfs\protocolPB\PBHelper.java,997,190,116,55,0,361
 pulsar-master\pulsar-master\pulsar-broker\src\test\java\org\apache\pulsar\client\api\PartitionedProducerConsumerTest.java,997,299,37,158,0,494
 kafka-trunk\kafka-trunk\tools\src\main\java\org\apache\kafka\tools\TransactionsCommand.java,998,0,4,98,0,102
 kafka-trunk\kafka-trunk\clients\src\main\java\org\apache\kafka\common\network\SslTransportLayer.java,998,0,70,170,1,241
 kafka-trunk\kafka-trunk\connect\runtime\src\test\java\org\apache\kafka\connect\runtime\AbstractHerderTest.java,1001,0,14,193,6,213
 hadoop-trunk\hadoop-trunk\hadoop-hdfs-project\hadoop-hdfs\src\main\java\org\apache\hadoop\hdfs\server\datanode\FileIoProvider.java,1002,196,1,1,2,200
 hadoop-trunk\hadoop-trunk\hadoop-yarn-project\hadoop-yarn\hadoop-yarn-common\src\main\java\org\apache\hadoop\yarn\logaggregation\AggregatedLogFormat.java,1002,210,32,4,9,255
 pulsar-master\pulsar-master\pulsar-broker\src\test\java\org\apache\pulsar\client\api\NonPersistentTopicTest.java,1004,250,10,141,0,401
 kafka-trunk\kafka-trunk\streams\src\test\java\org\apache\kafka\streams\integration\StoreUpgradeIntegrationTest.java,1005,0,17,134,10,161
 shardingsphere-master\shardingsphere-master\shardingsphere-sql-parser\shardingsphere-sql-parser-dialect\shardingsphere-sql-parser-opengauss\src\main\java\org\apache\shardingsphere\sql\parser\opengauss\visitor\statement\impl\OpenGaussStatementSQLVisitor.java,1007,342,3,349,0,694
 hadoop-trunk\hadoop-trunk\hadoop-yarn-project\hadoop-yarn\hadoop-yarn-server\hadoop-yarn-server-timelineservice-hbase-tests\src\test\java\org\apache\hadoop\yarn\server\timelineservice\storage\flow\TestHBaseStorageFlowRun.java,1010,90,34,17,1,142
 hadoop-trunk\hadoop-trunk\hadoop-common-project\hadoop-common\src\main\java\org\apache\hadoop\ipc\RPC.java,1012,475,36,10,5,526
 kafka-trunk\kafka-trunk\clients\src\test\java\org\apache\kafka\clients\admin\MockAdminClient.java,1012,0,19,144,5,168
 hadoop-trunk\hadoop-trunk\hadoop-yarn-project\hadoop-yarn\hadoop-yarn-client\src\test\java\org\apache\hadoop\yarn\client\cli\TestRMAdminCLI.java,1013,202,35,24,33,294
 hadoop-trunk\hadoop-trunk\hadoop-hdfs-project\hadoop-hdfs\src\main\java\org\apache\hadoop\hdfs\server\namenode\SecondaryNameNode.java,1016,218,32,15,5,270
 hadoop-trunk\hadoop-trunk\hadoop-tools\hadoop-azure\src\main\java\org\apache\hadoop\fs\azurebfs\AbfsConfiguration.java,1016,353,11,117,7,488
 hadoop-trunk\hadoop-trunk\hadoop-yarn-project\hadoop-yarn\hadoop-yarn-applications\hadoop-yarn-services\hadoop-yarn-services-core\src\main\java\org\apache\hadoop\yarn\service\ServiceScheduler.java,1017,171,71,10,13,265
 hadoop-trunk\hadoop-trunk\hadoop-hdfs-project\hadoop-hdfs\src\test\java\org\apache\hadoop\hdfs\TestDFSUtil.java,1025,324,41,27,5,397
 hadoop-trunk\hadoop-trunk\hadoop-yarn-project\hadoop-yarn\hadoop-yarn-server\hadoop-yarn-server-resourcemanager\src\test\java\org\apache\hadoop\yarn\server\resourcemanager\scheduler\constraint\TestPlacementConstraintsUtil.java,1026,163,46,7,1,217
 hadoop-trunk\hadoop-trunk\hadoop-yarn-project\hadoop-yarn\hadoop-yarn-server\hadoop-yarn-server-resourcemanager\src\test\java\org\apache\hadoop\yarn\server\resourcemanager\reservation\TestInMemoryPlan.java,1026,305,15,5,4,329
 hadoop-trunk\hadoop-trunk\hadoop-tools\hadoop-streaming\src\main\java\org\apache\hadoop\streaming\StreamJob.java,1026,281,43,35,4,363
 hadoop-trunk\hadoop-trunk\hadoop-hdfs-project\hadoop-hdfs\src\test\java\org\apache\hadoop\hdfs\server\namenode\metrics\TestNameNodeMetrics.java,1033,180,8,6,6,200
 pulsar-master\pulsar-master\pulsar-client\src\main\java\org\apache\pulsar\client\impl\ConsumerBase.java,1033,373,22,142,0,537
 kafka-trunk\kafka-trunk\clients\src\generated\java\org\apache\kafka\common\message\DeleteAclsResponseData.java,1034,0,0,116,14,130
 kafka-trunk\kafka-trunk\raft\src\test\java\org\apache\kafka\raft\QuorumStateTest.java,1035,0,4,91,4,99
 kafka-trunk\kafka-trunk\streams\src\test\java\org\apache\kafka\streams\state\internals\CachingPersistentWindowStoreTest.java,1035,0,57,178,62,297
 kafka-trunk\kafka-trunk\clients\src\test\java\org\apache\kafka\common\record\MemoryRecordsTest.java,1035,0,69,170,73,312
 kafka-trunk\kafka-trunk\streams\src\test\java\org\apache\kafka\streams\state\internals\AbstractDualSchemaRocksDBSegmentedBytesStoreTest.java,1036,0,29,180,51,260
 kafka-trunk\kafka-trunk\clients\src\generated\java\org\apache\kafka\common\message\DescribeLogDirsResponseData.java,1036,0,0,110,15,125
 hadoop-trunk\hadoop-trunk\hadoop-common-project\hadoop-common\src\test\java\org\apache\hadoop\service\TestCompositeService.java,1037,166,25,4,6,201
 zookeeper-master\zookeeper-master\zookeeper-server\src\test\java\org\apache\zookeeper\RemoveWatchesTest.java,1037,0,86,124,1,211
 hadoop-trunk\hadoop-trunk\hadoop-hdfs-project\hadoop-hdfs\src\main\java\org\apache\hadoop\hdfs\server\blockmanagement\DatanodeDescriptor.java,1038,289,19,3,10,321
 hadoop-trunk\hadoop-trunk\hadoop-yarn-project\hadoop-yarn\hadoop-yarn-client\src\main\java\org\apache\hadoop\yarn\client\api\impl\YarnClientImpl.java,1039,171,21,22,1,215
 pulsar-master\pulsar-master\pulsar-broker\src\main\java\org\apache\pulsar\broker\web\PulsarWebResource.java,1039,422,25,230,0,677
 kafka-trunk\kafka-trunk\streams\src\test\java\org\apache\kafka\streams\integration\KStreamAggregationIntegrationTest.java,1041,0,6,270,9,285
 pulsar-master\pulsar-master\pulsar-broker\src\test\java\org\apache\pulsar\functions\worker\PulsarFunctionLocalRunTest.java,1041,368,31,180,0,579
 dubbo-3.0\dubbo-3.0\dubbo-common\src\test\java\org\apache\dubbo\common\URLTest.java,1043,263,84,137,6,490
 pulsar-master\pulsar-master\pulsar-client\src\main\java\org\apache\pulsar\client\impl\PulsarClientImpl.java,1044,445,29,201,0,675
 shardingsphere-master\shardingsphere-master\shardingsphere-sql-parser\shardingsphere-sql-parser-dialect\shardingsphere-sql-parser-sqlserver\src\main\java\org\apache\shardingsphere\sql\parser\sqlserver\visitor\statement\impl\SQLServerStatementSQLVisitor.java,1049,311,6,347,0,664
 hadoop-trunk\hadoop-trunk\hadoop-tools\hadoop-azure\src\main\java\org\apache\hadoop\fs\azure\BlockBlobAppendStream.java,1055,67,21,3,2,93
 dubbo-3.0\dubbo-3.0\dubbo-common\src\main\java\org\apache\dubbo\common\url\component\URLParam.java,1057,240,3,92,2,337
 hadoop-trunk\hadoop-trunk\hadoop-hdfs-project\hadoop-hdfs\src\main\java\org\apache\hadoop\hdfs\server\datanode\fsdataset\impl\BlockPoolSlice.java,1057,166,30,14,3,213
 hadoop-trunk\hadoop-trunk\hadoop-hdfs-project\hadoop-hdfs\src\test\java\org\apache\hadoop\hdfs\tools\TestDFSAdmin.java,1058,110,42,13,14,179
 kafka-trunk\kafka-trunk\streams\src\test\java\org\apache\kafka\streams\KafkaStreamsTest.java,1061,0,77,191,4,272
 hadoop-trunk\hadoop-trunk\hadoop-hdfs-project\hadoop-hdfs\src\test\java\org\apache\hadoop\hdfs\server\datanode\TestDataNodeHotSwapVolumes.java,1062,175,33,3,12,223
 hadoop-trunk\hadoop-trunk\hadoop-common-project\hadoop-registry\src\main\java\org\apache\hadoop\registry\client\impl\zk\RegistrySecurity.java,1062,152,19,8,5,184
 pulsar-master\pulsar-master\managed-ledger\src\test\java\org\apache\bookkeeper\mledger\impl\OffloadPrefixTest.java,1063,391,17,159,0,567
 zookeeper-master\zookeeper-master\zookeeper-server\src\main\java\org\apache\zookeeper\server\PrepRequestProcessor.java,1063,0,119,153,6,278
 kafka-trunk\kafka-trunk\streams\src\test\java\org\apache\kafka\streams\processor\internals\GlobalStateManagerImplTest.java,1065,0,15,123,20,158
 kafka-trunk\kafka-trunk\streams\src\test\java\org\apache\kafka\streams\StreamsBuilderTest.java,1066,0,8,168,1,177
 hadoop-trunk\hadoop-trunk\hadoop-hdfs-project\hadoop-hdfs-rbf\src\test\java\org\apache\hadoop\hdfs\server\federation\MiniRouterDFSCluster.java,1068,259,10,29,23,321
 kafka-trunk\kafka-trunk\streams\src\test\java\org\apache\kafka\streams\state\internals\RocksDBStoreTest.java,1070,0,19,155,43,217
 kafka-trunk\kafka-trunk\clients\src\generated\java\org\apache\kafka\common\message\TxnOffsetCommitRequestData.java,1070,0,0,135,15,150
 hadoop-trunk\hadoop-trunk\hadoop-yarn-project\hadoop-yarn\hadoop-yarn-server\hadoop-yarn-server-nodemanager\src\main\java\org\apache\hadoop\yarn\server\nodemanager\containermanager\monitor\ContainersMonitorImpl.java,1073,169,15,8,12,204
 dubbo-3.0\dubbo-3.0\dubbo-config\dubbo-config-spring\src\test\java\org\apache\dubbo\config\spring\ConfigTest.java,1078,218,23,141,0,382
 hadoop-trunk\hadoop-trunk\hadoop-common-project\hadoop-common\src\main\java\org\apache\hadoop\io\nativeio\NativeIO.java,1078,462,41,23,35,561
 kafka-trunk\kafka-trunk\clients\src\generated\java\org\apache\kafka\common\message\DescribeClientQuotasResponseData.java,1079,0,0,108,18,126
 pulsar-master\pulsar-master\pulsar-functions\worker\src\test\java\org\apache\pulsar\functions\worker\SchedulerManagerTest.java,1082,322,44,241,0,607
 hadoop-trunk\hadoop-trunk\hadoop-yarn-project\hadoop-yarn\hadoop-yarn-server\hadoop-yarn-server-resourcemanager\src\test\java\org\apache\hadoop\yarn\server\resourcemanager\scheduler\capacity\TestContainerResizing.java,1087,159,10,12,4,185
 kafka-trunk\kafka-trunk\streams\src\test\java\org\apache\kafka\streams\processor\internals\StoreChangelogReaderTest.java,1087,0,75,264,45,384
 hadoop-trunk\hadoop-trunk\hadoop-yarn-project\hadoop-yarn\hadoop-yarn-applications\hadoop-yarn-services\hadoop-yarn-services-core\src\main\java\org\apache\hadoop\yarn\service\component\instance\ComponentInstance.java,1088,201,45,7,10,263
 pulsar-master\pulsar-master\pulsar-broker\src\main\java\org\apache\pulsar\broker\loadbalance\impl\ModularLoadManagerImpl.java,1088,278,18,198,0,494
 rocketmq-develop\rocketmq-develop\client\src\main\java\org\apache\rocketmq\client\impl\consumer\DefaultLitePullConsumerImpl.java,1088,369,32,159,55,615
 pulsar-master\pulsar-master\pulsar-broker\src\test\java\org\apache\pulsar\io\PulsarFunctionE2ETest.java,1089,334,5,238,0,577
 hadoop-trunk\hadoop-trunk\hadoop-hdfs-project\hadoop-hdfs\src\test\java\org\apache\hadoop\hdfs\server\namenode\TestNameNodeMXBean.java,1090,110,30,3,11,154
 kafka-trunk\kafka-trunk\clients\src\test\java\org\apache\kafka\common\network\SelectorTest.java,1090,0,31,172,9,212
 hadoop-trunk\hadoop-trunk\hadoop-yarn-project\hadoop-yarn\hadoop-yarn-server\hadoop-yarn-server-resourcemanager\src\main\java\org\apache\hadoop\yarn\server\resourcemanager\scheduler\capacity\UsersManager.java,1092,190,17,6,8,221
 kafka-trunk\kafka-trunk\streams\src\test\java\org\apache\kafka\streams\kstream\internals\KStreamKStreamLeftJoinTest.java,1092,0,44,256,2,302
 pulsar-master\pulsar-master\pulsar-broker\src\main\java\org\apache\pulsar\broker\service\persistent\PersistentSubscription.java,1095,400,16,212,0,628
 hadoop-trunk\hadoop-trunk\hadoop-hdfs-project\hadoop-hdfs\src\test\java\org\apache\hadoop\hdfs\server\datanode\TestBlockScanner.java,1096,260,52,10,14,336
 kafka-trunk\kafka-trunk\clients\src\test\java\org\apache\kafka\clients\producer\internals\RecordAccumulatorTest.java,1098,0,31,231,17,279
 pulsar-master\pulsar-master\pulsar-broker\src\test\java\org\apache\pulsar\schema\SchemaTest.java,1098,245,47,157,0,449
 rocketmq-develop\rocketmq-develop\client\src\main\java\org\apache\rocketmq\client\impl\consumer\DefaultMQPushConsumerImpl.java,1098,417,31,191,11,650
 hadoop-trunk\hadoop-trunk\hadoop-hdfs-project\hadoop-hdfs\src\main\java\org\apache\hadoop\hdfs\server\datanode\DiskBalancer.java,1100,115,33,1,4,153
 hadoop-trunk\hadoop-trunk\hadoop-hdfs-project\hadoop-hdfs-client\src\main\java\org\apache\hadoop\hdfs\DFSUtilClient.java,1101,295,27,21,2,345
 kafka-trunk\kafka-trunk\clients\src\main\java\org\apache\kafka\common\protocol\types\Type.java,1101,0,63,73,0,136
 pulsar-master\pulsar-master\testmocks\src\main\java\org\apache\zookeeper\MockZooKeeper.java,1103,261,18,117,1,397
 hadoop-trunk\hadoop-trunk\hadoop-yarn-project\hadoop-yarn\hadoop-yarn-server\hadoop-yarn-server-nodemanager\src\test\java\org\apache\hadoop\yarn\server\nodemanager\containermanager\scheduler\TestContainerSchedulerQueuing.java,1104,103,21,6,0,130
 kafka-trunk\kafka-trunk\clients\src\test\java\org\apache\kafka\clients\NetworkClientTest.java,1105,0,16,161,6,183
 hadoop-trunk\hadoop-trunk\hadoop-hdfs-project\hadoop-hdfs\src\test\java\org\apache\hadoop\hdfs\server\namenode\snapshot\TestSnapshot.java,1107,245,13,16,15,289
 hadoop-trunk\hadoop-trunk\hadoop-yarn-project\hadoop-yarn\hadoop-yarn-common\src\main\java\org\apache\hadoop\yarn\nodelabels\CommonNodeLabelsManager.java,1108,216,17,4,4,241
 kafka-trunk\kafka-trunk\clients\src\generated\java\org\apache\kafka\common\message\CreateTopicsResponseData.java,1109,0,0,97,13,110
 pulsar-master\pulsar-master\pulsar-client-api\src\main\java\org\apache\pulsar\client\api\PulsarClientException.java,1109,166,2,68,0,236
 hadoop-trunk\hadoop-trunk\hadoop-yarn-project\hadoop-yarn\hadoop-yarn-server\hadoop-yarn-server-resourcemanager\src\test\java\org\apache\hadoop\yarn\server\resourcemanager\webapp\TestRMWebServicesReservation.java,1110,128,21,11,18,178
 hadoop-trunk\hadoop-trunk\hadoop-hdfs-project\hadoop-hdfs\src\main\java\org\apache\hadoop\hdfs\server\namenode\NNStorage.java,1113,265,22,5,2,294
 kafka-trunk\kafka-trunk\clients\src\main\java\org\apache\kafka\clients\consumer\internals\SubscriptionState.java,1113,0,24,159,1,184
 pulsar-master\pulsar-master\pulsar-functions\runtime\src\test\java\org\apache\pulsar\functions\runtime\kubernetes\KubernetesRuntimeTest.java,1113,582,13,293,0,888
 hadoop-trunk\hadoop-trunk\hadoop-common-project\hadoop-common\src\test\java\org\apache\hadoop\fs\FSMainOperationsBaseTest.java,1116,291,41,20,10,362
 hadoop-trunk\hadoop-trunk\hadoop-common-project\hadoop-common\src\main\java\org\apache\hadoop\fs\RawLocalFileSystem.java,1116,246,17,13,2,278
 hadoop-trunk\hadoop-trunk\hadoop-yarn-project\hadoop-yarn\hadoop-yarn-server\hadoop-yarn-server-resourcemanager\src\main\java\org\apache\hadoop\yarn\server\resourcemanager\security\DelegationTokenRenewer.java,1116,242,41,11,7,301
 hadoop-trunk\hadoop-trunk\hadoop-mapreduce-project\hadoop-mapreduce-client\hadoop-mapreduce-client-shuffle\src\test\java\org\apache\hadoop\mapred\TestShuffleHandler.java,1117,284,70,4,33,391
 rocketmq-develop\rocketmq-develop\client\src\main\java\org\apache\rocketmq\client\impl\factory\MQClientInstance.java,1119,328,27,161,13,529
 zookeeper-master\zookeeper-master\zookeeper-server\src\main\java\org\apache\zookeeper\server\quorum\LearnerHandler.java,1119,0,85,81,0,166
 kafka-trunk\kafka-trunk\connect\runtime\src\test\java\org\apache\kafka\connect\storage\KafkaConfigBackingStoreTest.java,1120,0,9,383,3,395
 kafka-trunk\kafka-trunk\clients\src\generated\java\org\apache\kafka\common\message\OffsetFetchRequestData.java,1123,0,0,112,21,133
 kafka-trunk\kafka-trunk\streams\src\test\java\org\apache\kafka\streams\state\internals\AbstractWindowBytesStoreTest.java,1124,0,13,141,17,171
 hadoop-trunk\hadoop-trunk\hadoop-mapreduce-project\hadoop-mapreduce-client\hadoop-mapreduce-client-core\src\test\java\org\apache\hadoop\mapreduce\jobhistory\TestHistoryViewerPrinter.java,1128,1055,1,103,3,1162
 hadoop-trunk\hadoop-trunk\hadoop-hdfs-project\hadoop-hdfs\src\test\java\org\apache\hadoop\hdfs\qjournal\client\TestQuorumJournalManager.java,1131,318,19,9,1,347
 hadoop-trunk\hadoop-trunk\hadoop-yarn-project\hadoop-yarn\hadoop-yarn-server\hadoop-yarn-server-resourcemanager\src\test\java\org\apache\hadoop\yarn\server\resourcemanager\reservation\planning\TestAlignedPlanner.java,1134,405,35,10,0,450
 pulsar-master\pulsar-master\pulsar-client\src\main\java\org\apache\pulsar\client\impl\ClientCnx.java,1135,436,39,225,0,700
 pulsar-master\pulsar-master\pulsar-functions\runtime\src\main\java\org\apache\pulsar\functions\runtime\kubernetes\KubernetesRuntime.java,1137,317,19,152,0,488
 kafka-trunk\kafka-trunk\clients\src\generated\java\org\apache\kafka\common\message\OffsetCommitRequestData.java,1142,0,0,141,14,155
 hadoop-trunk\hadoop-trunk\hadoop-hdfs-project\hadoop-hdfs\src\test\java\org\apache\hadoop\hdfs\server\namenode\TestFSImage.java,1144,161,39,3,7,210
 pulsar-master\pulsar-master\pulsar-broker\src\test\java\org\apache\pulsar\broker\admin\PersistentTopicsTest.java,1144,516,15,352,0,883
 hadoop-trunk\hadoop-trunk\hadoop-yarn-project\hadoop-yarn\hadoop-yarn-server\hadoop-yarn-server-resourcemanager\src\test\java\org\apache\hadoop\yarn\server\resourcemanager\scheduler\TestSchedulerUtils.java,1145,112,38,35,1,186
 hadoop-trunk\hadoop-trunk\hadoop-hdfs-project\hadoop-hdfs\src\main\java\org\apache\hadoop\hdfs\qjournal\server\Journal.java,1145,320,65,21,5,411
 kafka-trunk\kafka-trunk\raft\src\test\java\org\apache\kafka\raft\RaftEventSimulationTest.java,1146,0,10,84,7,101
 hadoop-trunk\hadoop-trunk\hadoop-yarn-project\hadoop-yarn\hadoop-yarn-client\src\main\java\org\apache\hadoop\yarn\client\cli\TopCLI.java,1150,345,25,9,13,392
 kafka-trunk\kafka-trunk\streams\test-utils\src\main\java\org\apache\kafka\streams\TopologyTestDriver.java,1150,0,4,232,2,238
 hadoop-trunk\hadoop-trunk\hadoop-yarn-project\hadoop-yarn\hadoop-yarn-server\hadoop-yarn-server-resourcemanager\src\main\java\org\apache\hadoop\yarn\server\resourcemanager\scheduler\common\fica\FiCaSchedulerApp.java,1151,162,19,43,3,227
 hadoop-trunk\hadoop-trunk\hadoop-mapreduce-project\hadoop-mapreduce-client\hadoop-mapreduce-client-hs\src\main\java\org\apache\hadoop\mapreduce\v2\hs\HistoryFileManager.java,1151,226,40,9,3,278
 pulsar-master\pulsar-master\pulsar-functions\worker\src\test\java\org\apache\pulsar\functions\worker\FunctionRuntimeManagerTest.java,1154,313,10,280,0,603
 rocketmq-develop\rocketmq-develop\broker\src\main\java\org\apache\rocketmq\broker\BrokerController.java,1154,461,37,162,38,698
 hadoop-trunk\hadoop-trunk\hadoop-hdfs-project\hadoop-hdfs\src\test\java\org\apache\hadoop\hdfs\TestMaintenanceState.java,1157,124,18,1,15,158
 pulsar-master\pulsar-master\pulsar-broker\src\test\java\org\apache\pulsar\client\api\MessageDispatchThrottlingTest.java,1157,317,15,184,0,516
 zookeeper-master\zookeeper-master\zookeeper-server\src\test\java\org\apache\zookeeper\server\quorum\Zab1_0Test.java,1161,0,116,140,30,286
 hadoop-trunk\hadoop-trunk\hadoop-tools\hadoop-azure\src\main\java\org\apache\hadoop\fs\azurebfs\services\AbfsClient.java,1165,293,51,145,1,490
 hadoop-trunk\hadoop-trunk\hadoop-yarn-project\hadoop-yarn\hadoop-yarn-server\hadoop-yarn-server-resourcemanager\src\test\java\org\apache\hadoop\yarn\server\resourcemanager\scheduler\capacity\TestParentQueue.java,1167,514,62,38,2,616
 hadoop-trunk\hadoop-trunk\hadoop-common-project\hadoop-common\src\main\java\org\apache\hadoop\io\compress\bzip2\CBZip2InputStream.java,1172,251,45,9,0,305
 hadoop-trunk\hadoop-trunk\hadoop-yarn-project\hadoop-yarn\hadoop-yarn-client\src\test\java\org\apache\hadoop\yarn\client\api\impl\TestYarnClient.java,1172,233,44,25,1,303
 pulsar-master\pulsar-master\pulsar-broker\src\test\java\org\apache\pulsar\client\impl\TopicsConsumerImplTest.java,1172,292,55,166,0,513
 zookeeper-master\zookeeper-master\zookeeper-server\src\main\java\org\apache\zookeeper\server\quorum\FastLeaderElection.java,1173,0,38,152,11,201
 kafka-trunk\kafka-trunk\streams\src\test\java\org\apache\kafka\streams\integration\QueryableStateIntegrationTest.java,1174,0,19,176,15,210
 hadoop-trunk\hadoop-trunk\hadoop-yarn-project\hadoop-yarn\hadoop-yarn-server\hadoop-yarn-server-resourcemanager\src\test\java\org\apache\hadoop\yarn\server\resourcemanager\scheduler\capacity\TestCapacitySchedulerAsyncScheduling.java,1177,189,63,25,7,284
 hadoop-trunk\hadoop-trunk\hadoop-common-project\hadoop-common\src\test\java\org\apache\hadoop\io\compress\TestCodec.java,1179,300,54,38,42,434
 hadoop-trunk\hadoop-trunk\hadoop-yarn-project\hadoop-yarn\hadoop-yarn-server\hadoop-yarn-server-resourcemanager\src\test\java\org\apache\hadoop\yarn\server\resourcemanager\scheduler\TestAbstractYarnScheduler.java,1180,155,85,19,2,261
 dubbo-3.0\dubbo-3.0\dubbo-common\src\main\java\org\apache\dubbo\common\extension\ExtensionLoader.java,1181,366,36,134,6,542
 pulsar-master\pulsar-master\pulsar-broker\src\test\java\org\apache\pulsar\client\api\SimpleSchemaTest.java,1184,344,69,202,0,615
 kafka-trunk\kafka-trunk\connect\runtime\src\test\java\org\apache\kafka\connect\runtime\WorkerTest.java,1187,0,5,267,19,291
 hadoop-trunk\hadoop-trunk\hadoop-hdfs-project\hadoop-hdfs\src\test\java\org\apache\hadoop\hdfs\server\namenode\TestINodeFile.java,1188,362,37,15,17,431
 rocketmq-develop\rocketmq-develop\logging\src\main\java\org\apache\rocketmq\logging\inner\LoggingBuilder.java,1188,328,44,45,50,467
 hadoop-trunk\hadoop-trunk\hadoop-hdfs-project\hadoop-hdfs\src\test\java\org\apache\hadoop\hdfs\server\datanode\TestBPOfferService.java,1193,159,16,7,17,199
 pulsar-master\pulsar-master\pulsar-broker\src\main\java\org\apache\pulsar\broker\admin\v1\Namespaces.java,1193,1087,36,419,0,1542
 kafka-trunk\kafka-trunk\streams\src\test\java\org\apache\kafka\streams\processor\internals\StreamsProducerTest.java,1194,0,1,127,6,134
 kafka-trunk\kafka-trunk\clients\src\main\java\org\apache\kafka\clients\consumer\internals\AbstractStickyAssignor.java,1195,0,50,384,0,434
 hadoop-trunk\hadoop-trunk\hadoop-hdfs-project\hadoop-hdfs-rbf\src\test\java\org\apache\hadoop\hdfs\server\federation\router\TestRouterQuota.java,1197,112,7,11,11,141
 hadoop-trunk\hadoop-trunk\hadoop-hdfs-project\hadoop-hdfs\src\main\java\org\apache\hadoop\hdfs\server\namenode\CacheManager.java,1200,170,59,20,2,251
 kafka-trunk\kafka-trunk\streams\src\test\java\org\apache\kafka\streams\kstream\internals\CogroupedKStreamImplTest.java,1206,0,9,329,13,351
 hadoop-trunk\hadoop-trunk\hadoop-yarn-project\hadoop-yarn\hadoop-yarn-server\hadoop-yarn-server-common\src\test\java\org\apache\hadoop\yarn\server\federation\store\utils\TestFederationStateStoreInputValidator.java,1212,52,42,14,14,122
 hadoop-trunk\hadoop-trunk\hadoop-yarn-project\hadoop-yarn\hadoop-yarn-applications\hadoop-yarn-services\hadoop-yarn-services-core\src\main\java\org\apache\hadoop\yarn\service\component\Component.java,1212,233,62,14,13,322
 kafka-trunk\kafka-trunk\streams\src\test\java\org\apache\kafka\streams\processor\internals\metrics\StreamsMetricsImplTest.java,1214,0,5,206,4,215
 hadoop-trunk\hadoop-trunk\hadoop-hdfs-project\hadoop-hdfs\src\test\java\org\apache\hadoop\hdfs\server\namenode\TestAclTransformation.java,1217,106,7,1,0,114
 zookeeper-master\zookeeper-master\zookeeper-server\src\test\java\org\apache\zookeeper\test\ReconfigTest.java,1217,0,38,112,7,157
 hadoop-trunk\hadoop-trunk\hadoop-mapreduce-project\hadoop-mapreduce-client\hadoop-mapreduce-client-app\src\test\java\org\apache\hadoop\mapreduce\v2\app\job\impl\TestJobImpl.java,1218,194,14,8,14,230
 hadoop-trunk\hadoop-trunk\hadoop-common-project\hadoop-common\src\main\java\org\apache\hadoop\util\StringUtils.java,1222,398,30,8,5,441
 hadoop-trunk\hadoop-trunk\hadoop-tools\hadoop-distcp\src\test\java\org\apache\hadoop\tools\TestDistCpSync.java,1222,104,24,5,13,146
 hadoop-trunk\hadoop-trunk\hadoop-yarn-project\hadoop-yarn\hadoop-yarn-server\hadoop-yarn-server-resourcemanager\src\test\java\org\apache\hadoop\yarn\server\resourcemanager\TestOpportunisticContainerAllocatorAMService.java,1222,161,17,35,12,225
 hadoop-trunk\hadoop-trunk\hadoop-hdfs-project\hadoop-hdfs\src\test\java\org\apache\hadoop\hdfs\server\datanode\TestDirectoryScanner.java,1225,219,40,15,8,282
 hadoop-trunk\hadoop-trunk\hadoop-common-project\hadoop-auth\src\test\java\org\apache\hadoop\security\authentication\server\TestAuthenticationFilter.java,1226,152,23,59,18,252
 kafka-trunk\kafka-trunk\clients\src\main\java\org\apache\kafka\clients\NetworkClient.java,1228,0,31,206,2,239
 kafka-trunk\kafka-trunk\streams\src\test\java\org\apache\kafka\streams\StreamsConfigTest.java,1231,0,27,290,7,324
 kafka-trunk\kafka-trunk\clients\src\generated\java\org\apache\kafka\common\message\StopReplicaRequestData.java,1232,0,0,127,22,149
 hadoop-trunk\hadoop-trunk\hadoop-hdfs-project\hadoop-hdfs\src\test\java\org\apache\hadoop\hdfs\server\namenode\TestAuditLoggerWithCommands.java,1233,152,58,2,31,243
 hadoop-trunk\hadoop-trunk\hadoop-yarn-project\hadoop-yarn\hadoop-yarn-server\hadoop-yarn-server-nodemanager\src\test\java\org\apache\hadoop\yarn\server\nodemanager\containermanager\linux\resources\TestDefaultOOMHandler.java,1234,82,2,8,1,93
 pulsar-master\pulsar-master\pulsar-client-tools\src\main\java\org\apache\pulsar\admin\cli\CmdFunctions.java,1235,500,11,225,0,736
 pulsar-master\pulsar-master\pulsar-broker\src\test\java\org\apache\pulsar\broker\service\BacklogQuotaManagerTest.java,1235,319,27,169,0,515
 hadoop-trunk\hadoop-trunk\hadoop-yarn-project\hadoop-yarn\hadoop-yarn-server\hadoop-yarn-server-nodemanager\src\main\java\org\apache\hadoop\yarn\server\nodemanager\containermanager\linux\runtime\DockerLinuxContainerRuntime.java,1236,135,30,28,8,201
 kafka-trunk\kafka-trunk\streams\src\test\java\org\apache\kafka\streams\kstream\internals\KStreamSlidingWindowAggregateTest.java,1236,0,40,319,1,360
 hadoop-trunk\hadoop-trunk\hadoop-yarn-project\hadoop-yarn\hadoop-yarn-server\hadoop-yarn-server-resourcemanager\src\test\java\org\apache\hadoop\yarn\server\resourcemanager\scheduler\capacity\TestQueueParsing.java,1239,487,60,42,0,589
 hadoop-trunk\hadoop-trunk\hadoop-yarn-project\hadoop-yarn\hadoop-yarn-server\hadoop-yarn-server-resourcemanager\src\test\java\org\apache\hadoop\yarn\server\resourcemanager\scheduler\fifo\TestFifoScheduler.java,1242,332,144,50,5,531
 hadoop-trunk\hadoop-trunk\hadoop-hdfs-project\hadoop-hdfs\src\test\java\org\apache\hadoop\hdfs\TestDFSPermission.java,1248,375,38,8,9,430
 kafka-trunk\kafka-trunk\clients\src\generated\java\org\apache\kafka\common\message\ApiVersionsResponseData.java,1248,0,0,114,15,129
 hadoop-trunk\hadoop-trunk\hadoop-hdfs-project\hadoop-hdfs-rbf\src\main\java\org\apache\hadoop\hdfs\tools\federation\RouterAdmin.java,1249,90,46,30,1,167
 hadoop-trunk\hadoop-trunk\hadoop-yarn-project\hadoop-yarn\hadoop-yarn-server\hadoop-yarn-server-resourcemanager\src\test\java\org\apache\hadoop\yarn\server\resourcemanager\applicationsmanager\TestAMRestart.java,1253,141,38,26,4,209
 kafka-trunk\kafka-trunk\streams\src\test\java\org\apache\kafka\streams\kstream\internals\KStreamKStreamOuterJoinTest.java,1255,0,47,285,2,334
 kafka-trunk\kafka-trunk\streams\src\main\java\org\apache\kafka\streams\processor\internals\TaskManager.java,1255,0,22,240,1,263
 hadoop-trunk\hadoop-trunk\hadoop-yarn-project\hadoop-yarn\hadoop-yarn-server\hadoop-yarn-server-router\src\main\java\org\apache\hadoop\yarn\server\router\webapp\FederationInterceptorREST.java,1257,198,18,18,0,234
 kafka-trunk\kafka-trunk\streams\src\test\java\org\apache\kafka\streams\integration\IQv2StoreIntegrationTest.java,1258,0,6,123,20,149
 kafka-trunk\kafka-trunk\clients\src\generated\java\org\apache\kafka\common\message\DescribeGroupsResponseData.java,1258,0,0,161,21,182
 hadoop-trunk\hadoop-trunk\hadoop-common-project\hadoop-common\src\main\java\org\apache\hadoop\fs\HarFileSystem.java,1261,391,17,9,2,419
 kafka-trunk\kafka-trunk\streams\src\main\java\org\apache\kafka\streams\processor\internals\StreamThread.java,1267,0,14,193,9,216
 hadoop-trunk\hadoop-trunk\hadoop-hdfs-project\hadoop-hdfs\src\test\java\org\apache\hadoop\hdfs\tools\offlineImageViewer\TestOfflineImageViewer.java,1271,180,62,21,26,289
 hadoop-trunk\hadoop-trunk\hadoop-mapreduce-project\hadoop-mapreduce-client\hadoop-mapreduce-client-shuffle\src\main\java\org\apache\hadoop\mapred\ShuffleHandler.java,1276,341,59,25,2,427
 hadoop-trunk\hadoop-trunk\hadoop-yarn-project\hadoop-yarn\hadoop-yarn-server\hadoop-yarn-server-resourcemanager\src\main\java\org\apache\hadoop\yarn\server\resourcemanager\scheduler\QueueMetrics.java,1279,435,6,5,22,468
 hadoop-trunk\hadoop-trunk\hadoop-yarn-project\hadoop-yarn\hadoop-yarn-server\hadoop-yarn-server-resourcemanager\src\main\java\org\apache\hadoop\yarn\server\resourcemanager\recovery\RMStateStore.java,1284,294,43,16,7,360
 hadoop-trunk\hadoop-trunk\hadoop-yarn-project\hadoop-yarn\hadoop-yarn-server\hadoop-yarn-server-resourcemanager\src\test\java\org\apache\hadoop\yarn\server\resourcemanager\rmapp\TestRMAppTransitions.java,1285,204,37,29,6,276
 hadoop-trunk\hadoop-trunk\hadoop-yarn-project\hadoop-yarn\hadoop-yarn-server\hadoop-yarn-server-resourcemanager\src\main\java\org\apache\hadoop\yarn\server\resourcemanager\recovery\ZKRMStateStore.java,1289,180,47,13,83,323
 hadoop-trunk\hadoop-trunk\hadoop-hdfs-project\hadoop-hdfs\src\test\java\org\apache\hadoop\hdfs\server\namenode\snapshot\TestSnapshotDeletion.java,1291,334,26,6,4,370
 hadoop-trunk\hadoop-trunk\hadoop-yarn-project\hadoop-yarn\hadoop-yarn-applications\hadoop-yarn-applications-distributedshell\src\main\java\org\apache\hadoop\yarn\applications\distributedshell\Client.java,1292,276,32,59,2,369
 pulsar-master\pulsar-master\pulsar-broker\src\main\java\org\apache\pulsar\broker\namespace\NamespaceService.java,1301,514,34,285,0,833
 hadoop-trunk\hadoop-trunk\hadoop-hdfs-project\hadoop-hdfs\src\main\java\org\apache\hadoop\hdfs\server\namenode\FSImageFormat.java,1316,262,32,26,6,326
 rocketmq-develop\rocketmq-develop\filter\src\main\java\org\apache\rocketmq\filter\parser\SelectorParser.java,1317,427,238,26,2,693
 hadoop-trunk\hadoop-trunk\hadoop-hdfs-project\hadoop-hdfs\src\main\java\org\apache\hadoop\hdfs\server\namenode\FSEditLogLoader.java,1318,286,22,17,0,325
 pulsar-master\pulsar-master\pulsar-broker\src\test\java\org\apache\pulsar\broker\service\BrokerServiceTest.java,1318,295,35,193,0,523
 kafka-trunk\kafka-trunk\clients\src\generated\java\org\apache\kafka\common\message\ProduceResponseData.java,1319,0,0,151,16,167
 hadoop-trunk\hadoop-trunk\hadoop-yarn-project\hadoop-yarn\hadoop-yarn-server\hadoop-yarn-server-resourcemanager\src\test\java\org\apache\hadoop\yarn\server\resourcemanager\scheduler\capacity\TestContainerAllocation.java,1320,221,26,25,9,281
 hadoop-trunk\hadoop-trunk\hadoop-common-project\hadoop-common\src\main\java\org\apache\hadoop\fs\viewfs\ViewFs.java,1321,265,19,5,2,291
 hadoop-trunk\hadoop-trunk\hadoop-hdfs-project\hadoop-hdfs\src\test\java\org\apache\hadoop\hdfs\server\namenode\FSXAttrBaseTest.java,1328,203,114,8,31,356
 hadoop-trunk\hadoop-trunk\hadoop-yarn-project\hadoop-yarn\hadoop-yarn-server\hadoop-yarn-server-router\src\test\java\org\apache\hadoop\yarn\server\router\webapp\TestRouterWebServicesREST.java,1329,89,1,57,5,152
 hadoop-trunk\hadoop-trunk\hadoop-tools\hadoop-distcp\src\test\java\org\apache\hadoop\tools\mapred\TestCopyMapper.java,1338,177,21,33,22,253
 hadoop-trunk\hadoop-trunk\hadoop-mapreduce-project\hadoop-mapreduce-client\hadoop-mapreduce-client-jobclient\src\test\java\org\apache\hadoop\mapreduce\v2\TestMRJobs.java,1340,232,49,12,18,311
 hadoop-trunk\hadoop-trunk\hadoop-common-project\hadoop-common\src\main\java\org\apache\hadoop\util\Shell.java,1340,203,21,4,2,230
 hadoop-trunk\hadoop-trunk\hadoop-hdfs-project\hadoop-hdfs\src\test\java\org\apache\hadoop\hdfs\TestFileCreation.java,1344,233,31,32,9,305
 pulsar-master\pulsar-master\pulsar-broker\src\test\java\org\apache\pulsar\broker\service\ReplicatorTest.java,1349,372,111,228,0,711
 hadoop-trunk\hadoop-trunk\hadoop-yarn-project\hadoop-yarn\hadoop-yarn-server\hadoop-yarn-server-resourcemanager\src\main\java\org\apache\hadoop\yarn\server\resourcemanager\scheduler\capacity\AbstractCSQueue.java,1351,339,17,82,15,453
 hadoop-trunk\hadoop-trunk\hadoop-common-project\hadoop-common\src\main\java\org\apache\hadoop\fs\AbstractFileSystem.java,1355,300,22,6,0,328
 hadoop-trunk\hadoop-trunk\hadoop-hdfs-project\hadoop-hdfs\src\main\java\org\apache\hadoop\hdfs\server\common\Storage.java,1355,378,40,14,2,434
 hadoop-trunk\hadoop-trunk\hadoop-hdfs-project\hadoop-hdfs\src\main\java\org\apache\hadoop\hdfs\server\datanode\DataStorage.java,1361,278,38,7,3,326
 hadoop-trunk\hadoop-trunk\hadoop-tools\hadoop-distcp\src\test\java\org\apache\hadoop\tools\util\TestDistCpUtils.java,1362,324,186,128,2,640
 hadoop-trunk\hadoop-trunk\hadoop-yarn-project\hadoop-yarn\hadoop-yarn-server\hadoop-yarn-server-resourcemanager\src\test\java\org\apache\hadoop\yarn\server\resourcemanager\webapp\TestRMWebServicesAppsModification.java,1364,156,13,15,0,184
 kafka-trunk\kafka-trunk\streams\src\test\java\org\apache\kafka\streams\integration\utils\IntegrationTestUtils.java,1364,0,18,269,12,299
 hadoop-trunk\hadoop-trunk\hadoop-hdfs-project\hadoop-hdfs\src\test\java\org\apache\hadoop\hdfs\server\namenode\ha\TestRetryCacheWithHA.java,1372,393,15,6,11,425
 kafka-trunk\kafka-trunk\streams\src\generated\java\org\apache\kafka\streams\internals\generated\SubscriptionInfoData.java,1378,0,0,100,27,127
 hadoop-trunk\hadoop-trunk\hadoop-common-project\hadoop-common\src\test\java\org\apache\hadoop\fs\SymlinkBaseTest.java,1379,427,30,2,30,489
 hadoop-trunk\hadoop-trunk\hadoop-hdfs-project\hadoop-hdfs\src\main\java\org\apache\hadoop\hdfs\server\namenode\NamenodeFsck.java,1379,311,79,29,3,422
 hadoop-trunk\hadoop-trunk\hadoop-hdfs-project\hadoop-hdfs\src\main\java\org\apache\hadoop\hdfs\server\balancer\Dispatcher.java,1380,380,40,13,11,444
 kafka-trunk\kafka-trunk\clients\src\generated\java\org\apache\kafka\common\message\CreateTopicsRequestData.java,1380,0,0,128,18,146
 pulsar-master\pulsar-master\pulsar-client-admin\src\main\java\org\apache\pulsar\client\admin\internal\TopicPoliciesImpl.java,1380,708,0,217,0,925
 hadoop-trunk\hadoop-trunk\hadoop-tools\hadoop-azure\src\test\java\org\apache\hadoop\fs\azurebfs\ITestAzureBlobFilesystemAcl.java,1382,155,37,11,1,204
 hadoop-trunk\hadoop-trunk\hadoop-yarn-project\hadoop-yarn\hadoop-yarn-server\hadoop-yarn-server-resourcemanager\src\test\java\org\apache\hadoop\yarn\server\resourcemanager\scheduler\capacity\TestCapacitySchedulerApps.java,1385,158,61,65,1,285
 kafka-trunk\kafka-trunk\clients\src\test\java\org\apache\kafka\common\network\SslTransportLayerTest.java,1393,0,21,336,5,362
 zookeeper-master\zookeeper-master\zookeeper-server\src\main\java\org\apache\zookeeper\server\quorum\QuorumCnxManager.java,1393,0,45,137,6,188
 pulsar-master\pulsar-master\pulsar-functions\worker\src\test\java\org\apache\pulsar\functions\worker\rest\api\v2\FunctionApiV2ResourceTest.java,1402,334,11,172,0,517
 kafka-trunk\kafka-trunk\connect\runtime\src\test\java\org\apache\kafka\connect\runtime\distributed\IncrementalCooperativeAssignorTest.java,1404,0,0,273,45,318
 hadoop-trunk\hadoop-trunk\hadoop-yarn-project\hadoop-yarn\hadoop-yarn-server\hadoop-yarn-server-resourcemanager\src\main\java\org\apache\hadoop\yarn\server\resourcemanager\scheduler\SchedulerApplicationAttempt.java,1410,413,20,30,16,479
 hadoop-trunk\hadoop-trunk\hadoop-yarn-project\hadoop-yarn\hadoop-yarn-server\hadoop-yarn-server-resourcemanager\src\test\java\org\apache\hadoop\yarn\server\resourcemanager\TestRMNodeTransitions.java,1411,265,195,57,9,526
 hadoop-trunk\hadoop-trunk\hadoop-common-project\hadoop-common\src\test\java\org\apache\hadoop\fs\shell\TestLs.java,1412,188,32,4,5,229
 hadoop-trunk\hadoop-trunk\hadoop-yarn-project\hadoop-yarn\hadoop-yarn-server\hadoop-yarn-server-resourcemanager\src\test\java\org\apache\hadoop\yarn\server\resourcemanager\monitor\capacity\TestProportionalCapacityPreemptionPolicy.java,1413,1138,9,52,4,1203
 hadoop-trunk\hadoop-trunk\hadoop-yarn-project\hadoop-yarn\hadoop-yarn-server\hadoop-yarn-server-nodemanager\src\main\java\org\apache\hadoop\yarn\server\nodemanager\NodeStatusUpdaterImpl.java,1418,170,47,23,9,249
 shardingsphere-master\shardingsphere-master\shardingsphere-sql-parser\shardingsphere-sql-parser-dialect\shardingsphere-sql-parser-mysql\src\main\java\org\apache\shardingsphere\sql\parser\mysql\visitor\statement\impl\MySQLStatementSQLVisitor.java,1421,443,5,437,0,885
 hadoop-trunk\hadoop-trunk\hadoop-yarn-project\hadoop-yarn\hadoop-yarn-client\src\main\java\org\apache\hadoop\yarn\client\cli\ApplicationCLI.java,1423,175,17,6,1,199
 pulsar-master\pulsar-master\pulsar-client\src\main\java\org\apache\pulsar\client\impl\MultiTopicsConsumerImpl.java,1425,436,23,244,0,703
 hadoop-trunk\hadoop-trunk\hadoop-hdfs-project\hadoop-hdfs\src\test\java\org\apache\hadoop\hdfs\server\namenode\TestFileTruncate.java,1428,204,68,4,8,284
 hadoop-trunk\hadoop-trunk\hadoop-yarn-project\hadoop-yarn\hadoop-yarn-server\hadoop-yarn-server-nodemanager\src\main\java\org\apache\hadoop\yarn\server\nodemanager\containermanager\linux\runtime\runc\RuncContainerExecutorConfig.java,1469,1013,5,3,79,1100
 pulsar-master\pulsar-master\pulsar-functions\worker\src\test\java\org\apache\pulsar\functions\worker\rest\api\v3\SourceApiV3ResourceTest.java,1473,363,14,203,0,580
 hadoop-trunk\hadoop-trunk\hadoop-common-project\hadoop-common\src\test\java\org\apache\hadoop\fs\FileContextMainOperationsBaseTest.java,1474,342,206,12,16,576
 hadoop-trunk\hadoop-trunk\hadoop-hdfs-project\hadoop-hdfs\src\main\java\org\apache\hadoop\hdfs\server\namenode\FSImage.java,1477,375,66,21,5,467
 hadoop-trunk\hadoop-trunk\hadoop-hdfs-project\hadoop-hdfs\src\main\java\org\apache\hadoop\hdfs\server\namenode\web\resources\NamenodeWebHdfsMethods.java,1482,388,18,47,0,453
 kafka-trunk\kafka-trunk\clients\src\main\java\org\apache\kafka\clients\consumer\internals\AbstractCoordinator.java,1495,0,49,306,77,432
 kafka-trunk\kafka-trunk\clients\src\generated\java\org\apache\kafka\common\message\DescribeConfigsResponseData.java,1496,0,0,164,20,184
 hadoop-trunk\hadoop-trunk\hadoop-hdfs-project\hadoop-hdfs\src\main\java\org\apache\hadoop\hdfs\server\datanode\fsdataset\impl\FsVolumeImpl.java,1498,318,25,5,7,355
 rocketmq-develop\rocketmq-develop\broker\src\main\java\org\apache\rocketmq\broker\processor\AdminBrokerProcessor.java,1499,414,65,324,5,808
 kafka-trunk\kafka-trunk\metadata\src\main\java\org\apache\kafka\controller\ReplicationControlManager.java,1506,0,29,303,2,334
 hadoop-trunk\hadoop-trunk\hadoop-yarn-project\hadoop-yarn\hadoop-yarn-server\hadoop-yarn-server-resourcemanager\src\test\java\org\apache\hadoop\yarn\server\resourcemanager\recovery\TestZKRMStateStore.java,1508,309,8,17,8,342
 hadoop-trunk\hadoop-trunk\hadoop-yarn-project\hadoop-yarn\hadoop-yarn-server\hadoop-yarn-server-resourcemanager\src\test\java\org\apache\hadoop\yarn\server\resourcemanager\scheduler\capacity\TestReservations.java,1511,504,117,47,1,669
 hadoop-trunk\hadoop-trunk\hadoop-hdfs-project\hadoop-hdfs-rbf\src\main\java\org\apache\hadoop\hdfs\server\federation\router\RouterRpcClient.java,1520,98,26,12,7,143
 kafka-trunk\kafka-trunk\connect\runtime\src\test\java\org\apache\kafka\connect\runtime\WorkerSourceTaskTest.java,1521,0,23,224,9,256
 hadoop-trunk\hadoop-trunk\hadoop-yarn-project\hadoop-yarn\hadoop-yarn-server\hadoop-yarn-server-nodemanager\src\test\java\org\apache\hadoop\yarn\server\nodemanager\containermanager\container\TestContainer.java,1533,349,26,33,7,415
 rocketmq-develop\rocketmq-develop\client\src\main\java\org\apache\rocketmq\client\impl\producer\DefaultMQProducerImpl.java,1534,546,33,270,10,859
 hadoop-trunk\hadoop-trunk\hadoop-hdfs-project\hadoop-hdfs\src\test\java\org\apache\hadoop\hdfs\server\namenode\snapshot\TestSnapshotDiffReport.java,1538,112,26,2,2,142
 kafka-trunk\kafka-trunk\clients\src\main\java\org\apache\kafka\common\config\ConfigDef.java,1544,0,67,227,3,297
 hadoop-trunk\hadoop-trunk\hadoop-hdfs-project\hadoop-hdfs\src\test\java\org\apache\hadoop\hdfs\server\namenode\NNThroughputBenchmark.java,1550,620,117,20,23,780
 pulsar-master\pulsar-master\pulsar-functions\worker\src\test\java\org\apache\pulsar\functions\worker\rest\api\v3\FunctionApiV3ResourceTest.java,1557,376,15,181,0,572
 pulsar-master\pulsar-master\pulsar-broker\src\test\java\org\apache\pulsar\client\api\TopicReaderTest.java,1558,326,21,176,0,523
 kafka-trunk\kafka-trunk\clients\src\test\java\org\apache\kafka\clients\consumer\internals\AbstractCoordinatorTest.java,1565,0,34,142,5,181
 kafka-trunk\kafka-trunk\clients\src\generated-test\java\org\apache\kafka\common\message\SimpleExampleMessageData.java,1573,0,0,136,36,172
 hadoop-trunk\hadoop-trunk\hadoop-yarn-project\hadoop-yarn\hadoop-yarn-server\hadoop-yarn-server-resourcemanager\src\main\java\org\apache\hadoop\yarn\server\resourcemanager\scheduler\capacity\ParentQueue.java,1581,287,27,73,6,393
 hadoop-trunk\hadoop-trunk\hadoop-hdfs-project\hadoop-hdfs\src\test\java\org\apache\hadoop\hdfs\TestAclsEndToEnd.java,1594,57,17,1,12,87
 hadoop-trunk\hadoop-trunk\hadoop-hdfs-project\hadoop-hdfs\src\test\java\org\apache\hadoop\hdfs\server\namenode\TestCacheDirectives.java,1598,413,81,10,14,518
 pulsar-master\pulsar-master\pulsar-broker\src\test\java\org\apache\pulsar\compaction\CompactionTest.java,1600,311,136,189,0,636
 pulsar-master\pulsar-master\pulsar-functions\worker\src\test\java\org\apache\pulsar\functions\worker\rest\api\v3\SinkApiV3ResourceTest.java,1601,401,15,238,0,654
 hadoop-trunk\hadoop-trunk\hadoop-yarn-project\hadoop-yarn\hadoop-yarn-server\hadoop-yarn-server-resourcemanager\src\test\java\org\apache\hadoop\yarn\server\resourcemanager\webapp\TestRMWebServicesSchedulerActivities.java,1609,230,30,35,10,305
 hadoop-trunk\hadoop-trunk\hadoop-yarn-project\hadoop-yarn\hadoop-yarn-client\src\main\java\org\apache\hadoop\yarn\client\cli\LogsCLI.java,1611,206,8,3,6,223
 kafka-trunk\kafka-trunk\streams\test-utils\src\test\java\org\apache\kafka\streams\TopologyTestDriverTest.java,1618,0,10,221,17,248
 pulsar-master\pulsar-master\pulsar-functions\worker\src\main\java\org\apache\pulsar\functions\worker\rest\api\ComponentImpl.java,1640,550,119,450,0,1119
 kafka-trunk\kafka-trunk\clients\src\generated\java\org\apache\kafka\common\message\OffsetFetchResponseData.java,1645,0,0,179,26,205
 pulsar-master\pulsar-master\pulsar-broker\src\test\java\org\apache\pulsar\broker\admin\NamespacesTest.java,1645,566,50,381,0,997
 zookeeper-master\zookeeper-master\zookeeper-server\src\main\java\org\apache\zookeeper\ClientCnxn.java,1647,0,149,164,15,328
 hadoop-trunk\hadoop-trunk\hadoop-yarn-project\hadoop-yarn\hadoop-yarn-server\hadoop-yarn-server-resourcemanager\src\test\java\org\apache\hadoop\yarn\server\resourcemanager\TestRMAdminService.java,1659,138,79,41,31,289
 hadoop-trunk\hadoop-trunk\hadoop-common-project\hadoop-registry\src\main\java\org\apache\hadoop\registry\server\dns\RegistryDNS.java,1660,188,36,1,11,236
 hadoop-trunk\hadoop-trunk\hadoop-yarn-project\hadoop-yarn\hadoop-yarn-server\hadoop-yarn-server-applicationhistoryservice\src\main\java\org\apache\hadoop\yarn\server\timeline\RollingLevelDBTimelineStore.java,1664,242,31,26,4,303
 kafka-trunk\kafka-trunk\clients\src\generated\java\org\apache\kafka\common\message\FetchRequestData.java,1664,0,0,200,19,219
 hadoop-trunk\hadoop-trunk\hadoop-hdfs-project\hadoop-hdfs\src\test\java\org\apache\hadoop\hdfs\TestQuota.java,1665,236,34,12,29,311
 hadoop-trunk\hadoop-trunk\hadoop-yarn-project\hadoop-yarn\hadoop-yarn-applications\hadoop-yarn-services\hadoop-yarn-services-core\src\main\java\org\apache\hadoop\yarn\service\client\ServiceClient.java,1673,245,112,13,9,379
 kafka-trunk\kafka-trunk\clients\src\generated\java\org\apache\kafka\common\message\LeaderAndIsrRequestData.java,1692,0,0,215,26,241
 zookeeper-master\zookeeper-master\zookeeper-server\src\main\java\org\apache\zookeeper\server\quorum\Leader.java,1692,0,68,167,4,239
 pulsar-master\pulsar-master\pulsar-client-tools\src\main\java\org\apache\pulsar\admin\cli\CmdTopicPolicies.java,1694,656,75,423,0,1154
 hadoop-trunk\hadoop-trunk\hadoop-yarn-project\hadoop-yarn\hadoop-yarn-server\hadoop-yarn-server-nodemanager\src\main\java\org\apache\hadoop\yarn\server\nodemanager\amrmproxy\FederationInterceptor.java,1702,107,65,15,5,192
 hadoop-trunk\hadoop-trunk\hadoop-mapreduce-project\hadoop-mapreduce-client\hadoop-mapreduce-client-app\src\main\java\org\apache\hadoop\mapreduce\v2\app\MRAppMaster.java,1704,401,57,28,18,504
 hadoop-trunk\hadoop-trunk\hadoop-tools\hadoop-aws\src\test\java\org\apache\hadoop\fs\s3a\commit\AbstractITCommitProtocol.java,1708,137,22,8,15,182
 rocketmq-develop\rocketmq-develop\store\src\main\java\org\apache\rocketmq\store\CommitLog.java,1715,572,59,265,16,912
 kafka-trunk\kafka-trunk\clients\src\main\java\org\apache\kafka\clients\producer\internals\TransactionManager.java,1716,0,56,323,9,388
 hadoop-trunk\hadoop-trunk\hadoop-hdfs-project\hadoop-hdfs-rbf\src\test\java\org\apache\hadoop\hdfs\server\federation\router\TestRouterAdminCLI.java,1720,88,10,7,82,187
 hadoop-trunk\hadoop-trunk\hadoop-common-project\hadoop-common\src\test\java\org\apache\hadoop\fs\TestFileUtil.java,1721,242,99,28,22,391
 kafka-trunk\kafka-trunk\streams\src\main\java\org\apache\kafka\streams\state\internals\RocksDBGenericOptionsToDbOptionsColumnFamilyOptionsAdapter.java,1723,0,1,88,0,89
 hadoop-trunk\hadoop-trunk\hadoop-yarn-project\hadoop-yarn\hadoop-yarn-server\hadoop-yarn-server-nodemanager\src\main\java\org\apache\hadoop\yarn\server\nodemanager\recovery\NMLeveldbStateStoreService.java,1732,267,101,12,4,384
 zookeeper-master\zookeeper-master\zookeeper-server\src\test\java\org\apache\zookeeper\server\quorum\QuorumPeerMainTest.java,1737,0,124,262,13,399
 hadoop-trunk\hadoop-trunk\hadoop-yarn-project\hadoop-yarn\hadoop-yarn-server\hadoop-yarn-server-resourcemanager\src\main\java\org\apache\hadoop\yarn\server\resourcemanager\ClientRMService.java,1741,232,20,50,9,311
 kafka-trunk\kafka-trunk\streams\src\main\java\org\apache\kafka\streams\KafkaStreams.java,1744,0,32,404,2,438
 hadoop-trunk\hadoop-trunk\hadoop-hdfs-project\hadoop-hdfs\src\main\java\org\apache\hadoop\hdfs\protocolPB\ClientNamenodeProtocolServerSideTranslatorPB.java,1745,487,117,241,0,845
 hadoop-trunk\hadoop-trunk\hadoop-hdfs-project\hadoop-hdfs\src\test\java\org\apache\hadoop\hdfs\server\namenode\FSAclBaseTest.java,1760,378,148,3,3,532
 hadoop-trunk\hadoop-trunk\hadoop-yarn-project\hadoop-yarn\hadoop-yarn-server\hadoop-yarn-server-nodemanager\src\test\java\org\apache\hadoop\yarn\server\nodemanager\recovery\TestNMLeveldbStateStoreService.java,1762,225,119,23,0,367
 kafka-trunk\kafka-trunk\streams\src\test\java\org\apache\kafka\streams\processor\internals\ProcessorTopologyTest.java,1769,0,2,375,5,382
 pulsar-master\pulsar-master\pulsar-common\src\main\java\org\apache\pulsar\common\protocol\Commands.java,1769,951,11,271,0,1233
 hadoop-trunk\hadoop-trunk\hadoop-mapreduce-project\hadoop-mapreduce-client\hadoop-mapreduce-client-jobclient\src\test\java\org\apache\hadoop\mapreduce\lib\input\TestCombineFileInputFormat.java,1772,327,23,15,10,375
 hadoop-trunk\hadoop-trunk\hadoop-hdfs-project\hadoop-hdfs\src\test\java\org\apache\hadoop\hdfs\server\namenode\TestEditLog.java,1775,453,54,28,33,568
 hadoop-trunk\hadoop-trunk\hadoop-yarn-project\hadoop-yarn\hadoop-yarn-server\hadoop-yarn-server-resourcemanager\src\test\java\org\apache\hadoop\yarn\server\resourcemanager\TestWorkPreservingRMRestart.java,1776,327,65,50,11,453
 hadoop-trunk\hadoop-trunk\hadoop-yarn-project\hadoop-yarn\hadoop-yarn-server\hadoop-yarn-server-nodemanager\src\main\java\org\apache\hadoop\yarn\server\nodemanager\containermanager\launcher\ContainerLaunch.java,1776,260,38,25,8,331
 hadoop-trunk\hadoop-trunk\hadoop-hdfs-project\hadoop-hdfs\src\test\java\org\apache\hadoop\hdfs\server\blockmanagement\TestBlockManager.java,1781,299,67,19,29,414
 hadoop-trunk\hadoop-trunk\hadoop-tools\hadoop-rumen\src\main\java\org\apache\hadoop\tools\rumen\HadoopLogsAnalyzer.java,1783,226,30,19,1,276
 hadoop-trunk\hadoop-trunk\hadoop-hdfs-project\hadoop-hdfs\src\test\java\org\apache\hadoop\hdfs\TestDecommission.java,1793,364,35,58,12,469
 hadoop-trunk\hadoop-trunk\hadoop-yarn-project\hadoop-yarn\hadoop-yarn-server\hadoop-yarn-server-timelineservice-hbase-tests\src\test\java\org\apache\hadoop\yarn\server\timelineservice\storage\TestHBaseTimelineStorageEntities.java,1797,239,39,31,0,309
 pulsar-master\pulsar-master\pulsar-broker\src\test\java\org\apache\pulsar\broker\service\PersistentTopicE2ETest.java,1804,291,27,177,0,495
 pulsar-master\pulsar-master\tests\integration\src\test\java\org\apache\pulsar\tests\integration\functions\PulsarFunctionsTest.java,1816,437,31,222,0,690
 pulsar-master\pulsar-master\pulsar-broker\src\test\java\org\apache\pulsar\broker\service\ServerCnxTest.java,1823,482,15,284,0,781
 hadoop-trunk\hadoop-trunk\hadoop-hdfs-project\hadoop-hdfs\src\main\java\org\apache\hadoop\hdfs\DFSUtil.java,1824,400,49,37,5,491
 hadoop-trunk\hadoop-trunk\hadoop-common-project\hadoop-common\src\main\java\org\apache\hadoop\fs\viewfs\ViewFileSystem.java,1844,328,37,12,5,382
 zookeeper-master\zookeeper-master\zookeeper-server\src\main\java\org\apache\zookeeper\server\DataTree.java,1846,0,126,83,0,209
 hadoop-trunk\hadoop-trunk\hadoop-yarn-project\hadoop-yarn\hadoop-yarn-server\hadoop-yarn-server-nodemanager\src\main\java\org\apache\hadoop\yarn\server\nodemanager\containermanager\ContainerManagerImpl.java,1847,250,59,62,17,388
 hadoop-trunk\hadoop-trunk\hadoop-hdfs-project\hadoop-hdfs-rbf\src\test\java\org\apache\hadoop\hdfs\server\federation\router\TestRouterRpc.java,1860,163,7,13,12,195
 hadoop-trunk\hadoop-trunk\hadoop-yarn-project\hadoop-yarn\hadoop-yarn-server\hadoop-yarn-server-resourcemanager\src\test\java\org\apache\hadoop\yarn\server\resourcemanager\rmapp\attempt\TestRMAppAttemptTransitions.java,1865,359,63,30,6,458
 hadoop-trunk\hadoop-trunk\hadoop-common-project\hadoop-common\src\main\java\org\apache\hadoop\ipc\Client.java,1874,466,63,38,39,606
 hadoop-trunk\hadoop-trunk\hadoop-yarn-project\hadoop-yarn\hadoop-yarn-server\hadoop-yarn-server-nodemanager\src\test\java\org\apache\hadoop\yarn\server\nodemanager\TestNodeStatusUpdater.java,1880,467,70,50,31,618
 hadoop-trunk\hadoop-trunk\hadoop-hdfs-project\hadoop-hdfs\src\test\java\org\apache\hadoop\hdfs\server\namenode\TestReencryption.java,1882,235,27,2,15,279
 kafka-trunk\kafka-trunk\connect\runtime\src\main\java\org\apache\kafka\connect\runtime\distributed\DistributedHerder.java,1887,0,57,424,15,496
 kafka-trunk\kafka-trunk\clients\src\generated\java\org\apache\kafka\common\message\MetadataResponseData.java,1926,0,0,228,23,251
 hadoop-trunk\hadoop-trunk\hadoop-mapreduce-project\hadoop-mapreduce-client\hadoop-mapreduce-client-app\src\test\java\org\apache\hadoop\mapreduce\v2\app\job\impl\TestTaskAttempt.java,1936,237,53,19,17,326
 hadoop-trunk\hadoop-trunk\hadoop-common-project\hadoop-common\src\test\java\org\apache\hadoop\fs\contract\ContractTestUtils.java,1939,288,9,4,3,304
 pulsar-master\pulsar-master\pulsar-broker\src\main\java\org\apache\pulsar\broker\admin\v2\Namespaces.java,1941,1564,140,575,0,2279
 pulsar-master\pulsar-master\pulsar-broker\src\test\java\org\apache\pulsar\broker\admin\v1\V1_AdminApiTest.java,1952,573,48,341,0,962
 hadoop-trunk\hadoop-trunk\hadoop-hdfs-project\hadoop-hdfs-httpfs\src\test\java\org\apache\hadoop\fs\http\client\BaseTestHttpFSWith.java,1954,185,91,29,22,327
 hadoop-trunk\hadoop-trunk\hadoop-common-project\hadoop-common\src\main\java\org\apache\hadoop\io\compress\bzip2\CBZip2OutputStream.java,1957,443,137,23,1,604
 hadoop-trunk\hadoop-trunk\hadoop-hdfs-project\hadoop-hdfs-client\src\main\java\org\apache\hadoop\hdfs\DFSInputStream.java,1966,314,70,21,8,413
 hadoop-trunk\hadoop-trunk\hadoop-hdfs-project\hadoop-hdfs\src\main\java\org\apache\hadoop\hdfs\DFSConfigKeys.java,1972,1613,1,477,1,2092
 hadoop-trunk\hadoop-trunk\hadoop-hdfs-project\hadoop-hdfs\src\main\java\org\apache\hadoop\hdfs\server\namenode\FSDirectory.java,1976,479,47,27,4,557
 kafka-trunk\kafka-trunk\clients\src\generated\java\org\apache\kafka\common\message\UpdateMetadataRequestData.java,1995,0,0,240,31,271
 kafka-trunk\kafka-trunk\connect\runtime\src\test\java\org\apache\kafka\connect\runtime\WorkerSinkTaskTest.java,2003,0,37,286,13,336
 hadoop-trunk\hadoop-trunk\hadoop-mapreduce-project\hadoop-mapreduce-client\hadoop-mapreduce-client-core\src\main\java\org\apache\hadoop\mapred\MapTask.java,2016,543,95,29,36,703
 pulsar-master\pulsar-master\pulsar-client-tools-test\src\test\java\org\apache\pulsar\admin\cli\PulsarAdminToolTest.java,2020,965,35,757,0,1757
 hadoop-trunk\hadoop-trunk\hadoop-mapreduce-project\hadoop-mapreduce-client\hadoop-mapreduce-client-app\src\test\java\org\apache\hadoop\mapreduce\v2\app\TestRecovery.java,2052,276,75,25,5,381
 kafka-trunk\kafka-trunk\clients\src\generated\java\org\apache\kafka\common\message\FetchResponseData.java,2070,0,0,213,26,239
 rocketmq-develop\rocketmq-develop\store\src\main\java\org\apache\rocketmq\store\DefaultMessageStore.java,2087,596,69,304,31,1000
 kafka-trunk\kafka-trunk\streams\src\main\java\org\apache\kafka\streams\processor\internals\InternalTopologyBuilder.java,2088,0,6,322,17,345
 hadoop-trunk\hadoop-trunk\hadoop-hdfs-project\hadoop-hdfs-rbf\src\main\java\org\apache\hadoop\hdfs\server\federation\router\RouterClientProtocol.java,2104,345,39,12,5,401
 rocketmq-develop\rocketmq-develop\client\src\main\java\org\apache\rocketmq\client\impl\MQClientAPIImpl.java,2133,742,27,490,9,1268
 hadoop-trunk\hadoop-trunk\hadoop-common-project\hadoop-common\src\main\java\org\apache\hadoop\security\UserGroupInformation.java,2168,334,41,15,8,398
 hadoop-trunk\hadoop-trunk\hadoop-hdfs-project\hadoop-hdfs-client\src\main\java\org\apache\hadoop\hdfs\ViewDistributedFileSystem.java,2194,328,33,5,1,367
 hadoop-trunk\hadoop-trunk\hadoop-hdfs-project\hadoop-hdfs-nfs\src\main\java\org\apache\hadoop\hdfs\nfs\nfs3\RpcProgramNfs3.java,2196,258,65,13,9,345
 kafka-trunk\kafka-trunk\streams\src\test\java\org\apache\kafka\streams\processor\internals\StreamsPartitionAssignorTest.java,2228,0,43,532,4,579
 hadoop-trunk\hadoop-trunk\hadoop-common-project\hadoop-common\src\main\java\org\apache\hadoop\io\file\tfile\TFile.java,2231,424,39,14,2,479
 hadoop-trunk\hadoop-trunk\hadoop-yarn-project\hadoop-yarn\hadoop-yarn-server\hadoop-yarn-server-nodemanager\src\main\java\org\apache\hadoop\yarn\server\nodemanager\containermanager\container\ContainerImpl.java,2272,330,64,30,34,458
 pulsar-master\pulsar-master\pulsar-broker\src\test\java\org\apache\pulsar\client\api\v1\V1_ProducerConsumerTest.java,2280,409,89,228,0,726
 hadoop-trunk\hadoop-trunk\hadoop-hdfs-project\hadoop-hdfs\src\test\java\org\apache\hadoop\hdfs\TestEncryptionZones.java,2283,244,85,17,42,388
 pulsar-master\pulsar-master\pulsar-broker\src\test\java\org\apache\pulsar\broker\admin\AdminApi2Test.java,2323,707,42,433,0,1182
 hadoop-trunk\hadoop-trunk\hadoop-yarn-project\hadoop-yarn\hadoop-yarn-client\src\test\java\org\apache\hadoop\yarn\client\cli\TestYarnCLI.java,2330,557,70,207,95,929
 hadoop-trunk\hadoop-trunk\hadoop-yarn-project\hadoop-yarn\hadoop-yarn-server\hadoop-yarn-server-resourcemanager\src\main\java\org\apache\hadoop\yarn\server\resourcemanager\scheduler\capacity\AbstractLeafQueue.java,2387,441,40,87,13,581
 hadoop-trunk\hadoop-trunk\hadoop-hdfs-project\hadoop-hdfs\src\test\java\org\apache\hadoop\hdfs\server\namenode\TestFsck.java,2393,303,71,4,47,425
 hadoop-trunk\hadoop-trunk\hadoop-mapreduce-project\hadoop-mapreduce-client\hadoop-mapreduce-client-app\src\main\java\org\apache\hadoop\mapreduce\v2\app\job\impl\TaskAttemptImpl.java,2397,434,44,51,15,544
 kafka-trunk\kafka-trunk\clients\src\test\java\org\apache\kafka\common\security\authenticator\SaslAuthenticatorTest.java,2428,0,49,646,14,709
 hadoop-trunk\hadoop-trunk\hadoop-hdfs-project\hadoop-hdfs\src\main\java\org\apache\hadoop\hdfs\server\namenode\NameNodeRpcServer.java,2459,602,56,54,2,714
 hadoop-trunk\hadoop-trunk\hadoop-yarn-project\hadoop-yarn\hadoop-yarn-server\hadoop-yarn-server-nodemanager\src\test\java\org\apache\hadoop\yarn\server\nodemanager\containermanager\linux\runtime\TestDockerContainerRuntime.java,2459,199,63,47,9,318
 kafka-trunk\kafka-trunk\raft\src\main\java\org\apache\kafka\raft\KafkaRaftClient.java,2465,0,23,355,0,378
 hadoop-trunk\hadoop-trunk\hadoop-hdfs-project\hadoop-hdfs\src\test\java\org\apache\hadoop\hdfs\server\namenode\snapshot\TestRenameWithSnapshots.java,2475,574,137,16,25,752
 pulsar-master\pulsar-master\pulsar-client-admin\src\main\java\org\apache\pulsar\client\admin\internal\NamespacesImpl.java,2507,1299,4,449,0,1752
 hadoop-trunk\hadoop-trunk\hadoop-hdfs-project\hadoop-hdfs\src\main\java\org\apache\hadoop\hdfs\tools\DFSAdmin.java,2527,667,32,40,3,742
 pulsar-master\pulsar-master\pulsar-broker-common\src\main\java\org\apache\pulsar\broker\ServiceConfiguration.java,2671,1006,1,452,0,1459
 kafka-trunk\kafka-trunk\streams\src\test\java\org\apache\kafka\streams\processor\internals\StreamTaskTest.java,2697,0,28,303,10,341
 pulsar-master\pulsar-master\pulsar-broker\src\main\java\org\apache\pulsar\broker\admin\impl\NamespacesBase.java,2706,923,181,656,0,1760
 kafka-trunk\kafka-trunk\raft\src\test\java\org\apache\kafka\raft\KafkaRaftClientTest.java,2717,0,10,409,0,419
 hadoop-trunk\hadoop-trunk\hadoop-yarn-project\hadoop-yarn\hadoop-yarn-server\hadoop-yarn-server-resourcemanager\src\main\java\org\apache\hadoop\yarn\server\resourcemanager\webapp\RMWebServices.java,2718,328,63,60,16,467
 pulsar-master\pulsar-master\pulsar-client-tools\src\main\java\org\apache\pulsar\admin\cli\CmdTopics.java,2737,816,134,541,0,1491
 kafka-trunk\kafka-trunk\connect\runtime\src\test\java\org\apache\kafka\connect\runtime\distributed\DistributedHerderTest.java,2746,0,140,426,17,583
 hadoop-trunk\hadoop-trunk\hadoop-yarn-project\hadoop-yarn\hadoop-yarn-server\hadoop-yarn-server-resourcemanager\src\test\java\org\apache\hadoop\yarn\server\resourcemanager\scheduler\capacity\TestCapacityScheduler.java,2769,620,153,121,61,955
 pulsar-master\pulsar-master\pulsar-broker\src\main\java\org\apache\pulsar\broker\service\ServerCnx.java,2807,976,61,682,0,1719
 hadoop-trunk\hadoop-trunk\hadoop-common-project\hadoop-common\src\main\java\org\apache\hadoop\fs\FileContext.java,2815,388,17,12,21,438
 pulsar-master\pulsar-master\pulsar-broker\src\main\java\org\apache\pulsar\broker\service\BrokerService.java,2850,1092,57,683,0,1832
 kafka-trunk\kafka-trunk\clients\src\test\java\org\apache\kafka\clients\consumer\KafkaConsumerTest.java,2860,0,124,522,22,668
 hadoop-trunk\hadoop-trunk\hadoop-yarn-project\hadoop-yarn\hadoop-yarn-server\hadoop-yarn-server-resourcemanager\src\main\java\org\apache\hadoop\yarn\server\resourcemanager\scheduler\capacity\CapacitySchedulerConfiguration.java,2876,822,78,62,8,970
 hadoop-trunk\hadoop-trunk\hadoop-yarn-project\hadoop-yarn\hadoop-yarn-server\hadoop-yarn-server-resourcemanager\src\test\java\org\apache\hadoop\yarn\server\resourcemanager\TestRMRestart.java,2887,403,54,41,34,532
 pulsar-master\pulsar-master\pulsar-client-admin\src\main\java\org\apache\pulsar\client\admin\internal\TopicsImpl.java,2889,1435,5,484,0,1924
 pulsar-master\pulsar-master\pulsar-broker\src\test\java\org\apache\pulsar\broker\admin\TopicPoliciesTest.java,2921,1094,194,662,0,1950
 zookeeper-master\zookeeper-master\zookeeper-server\src\main\java\org\apache\zookeeper\ZooKeeper.java,2951,0,111,210,2,323
 kafka-trunk\kafka-trunk\streams\src\test\java\org\apache\kafka\streams\kstream\internals\KStreamImplTest.java,2976,0,48,497,176,721
 kafka-trunk\kafka-trunk\streams\src\test\java\org\apache\kafka\streams\processor\internals\StreamThreadTest.java,3003,0,155,491,48,694
 hadoop-trunk\hadoop-trunk\hadoop-tools\hadoop-azure\src\main\java\org\apache\hadoop\fs\azure\AzureNativeFileSystemStore.java,3007,446,44,124,13,627
 pulsar-master\pulsar-master\managed-ledger\src\main\java\org\apache\bookkeeper\mledger\impl\ManagedCursorImpl.java,3016,1002,88,553,0,1643
 hadoop-trunk\hadoop-trunk\hadoop-yarn-project\hadoop-yarn\hadoop-yarn-common\src\main\java\org\apache\hadoop\yarn\webapp\hamlet2\HamletSpec.java,3055,438,390,4,0,832
 hadoop-trunk\hadoop-trunk\hadoop-yarn-project\hadoop-yarn\hadoop-yarn-server\hadoop-yarn-server-resourcemanager\src\test\java\org\apache\hadoop\yarn\server\resourcemanager\TestResourceTrackerService.java,3056,415,217,43,33,708
 hadoop-trunk\hadoop-trunk\hadoop-yarn-project\hadoop-yarn\hadoop-yarn-server\hadoop-yarn-server-nodemanager\src\test\java\org\apache\hadoop\yarn\server\nodemanager\containermanager\localizer\TestResourceLocalizationService.java,3077,277,96,57,25,455
 kafka-trunk\kafka-trunk\clients\src\test\java\org\apache\kafka\common\requests\RequestResponseTest.java,3077,0,16,632,14,662
 kafka-trunk\kafka-trunk\clients\src\test\java\org\apache\kafka\clients\producer\internals\SenderTest.java,3133,0,20,549,17,586
 pulsar-master\pulsar-master\pulsar-broker\src\test\java\org\apache\pulsar\broker\admin\AdminApiTest.java,3181,987,96,609,0,1692
 hadoop-trunk\hadoop-trunk\hadoop-hdfs-project\hadoop-hdfs-client\src\main\java\org\apache\hadoop\hdfs\protocolPB\PBHelperClient.java,3278,571,167,52,0,790
 pulsar-master\pulsar-master\managed-ledger\src\test\java\org\apache\bookkeeper\mledger\impl\ManagedLedgerTest.java,3398,871,91,379,0,1341
 hadoop-trunk\hadoop-trunk\hadoop-yarn-project\hadoop-yarn\hadoop-yarn-server\hadoop-yarn-server-resourcemanager\src\test\java\org\apache\hadoop\yarn\server\resourcemanager\scheduler\capacity\TestNodeLabelContainerAllocation.java,3401,907,156,53,1,1117
 kafka-trunk\kafka-trunk\streams\src\test\java\org\apache\kafka\streams\processor\internals\TaskManagerTest.java,3402,0,43,601,6,650
 kafka-trunk\kafka-trunk\clients\src\test\java\org\apache\kafka\clients\producer\internals\TransactionManagerTest.java,3494,0,16,655,14,685
 hadoop-trunk\hadoop-trunk\hadoop-mapreduce-project\hadoop-mapreduce-client\hadoop-mapreduce-client-app\src\test\java\org\apache\hadoop\mapreduce\v2\app\rm\TestRMContainerAllocator.java,3572,625,223,32,18,898
 hadoop-trunk\hadoop-trunk\hadoop-yarn-project\hadoop-yarn\hadoop-yarn-server\hadoop-yarn-server-timelineservice\src\main\java\org\apache\hadoop\yarn\server\timelineservice\reader\TimelineReaderWebServices.java,3602,691,54,7,3,755
 kafka-trunk\kafka-trunk\clients\src\test\java\org\apache\kafka\clients\consumer\internals\ConsumerCoordinatorTest.java,3624,0,115,633,24,772
 hadoop-trunk\hadoop-trunk\hadoop-common-project\hadoop-common\src\main\java\org\apache\hadoop\io\SequenceFile.java,3627,1529,167,41,24,1761
 pulsar-master\pulsar-master\managed-ledger\src\test\java\org\apache\bookkeeper\mledger\impl\ManagedCursorTest.java,3652,895,87,343,0,1325
 hadoop-trunk\hadoop-trunk\hadoop-common-project\hadoop-common\src\main\java\org\apache\hadoop\ipc\Server.java,3886,1035,202,43,0,1280
 kafka-trunk\kafka-trunk\clients\src\main\java\org\apache\kafka\clients\admin\KafkaAdminClient.java,4209,0,75,922,13,1010
 pulsar-master\pulsar-master\pulsar-broker\src\test\java\org\apache\pulsar\client\api\SimpleProducerConsumerTest.java,4289,992,176,653,0,1821
 pulsar-master\pulsar-master\pulsar-broker\src\main\java\org\apache\pulsar\broker\admin\impl\PersistentTopicsBase.java,4783,1817,284,1330,0,3431
 hadoop-trunk\hadoop-trunk\hadoop-yarn-project\hadoop-yarn\hadoop-yarn-api\src\main\java\org\apache\hadoop\yarn\conf\YarnConfiguration.java,4877,1120,7,53,10,1190
 kafka-trunk\kafka-trunk\clients\src\test\java\org\apache\kafka\clients\consumer\internals\FetcherTest.java,4991,0,98,860,86,1044
 hadoop-trunk\hadoop-trunk\hadoop-yarn-project\hadoop-yarn\hadoop-yarn-server\hadoop-yarn-server-resourcemanager\src\test\java\org\apache\hadoop\yarn\server\resourcemanager\scheduler\capacity\TestLeafQueue.java,5302,2278,395,112,20,2805
 hadoop-trunk\hadoop-trunk\hadoop-hdfs-project\hadoop-hdfs\src\main\java\org\apache\hadoop\hdfs\server\blockmanagement\BlockManager.java,5349,1085,171,48,14,1318
 hadoop-trunk\hadoop-trunk\hadoop-hdfs-project\hadoop-hdfs\src\main\java\org\apache\hadoop\hdfs\server\namenode\FSEditLogOp.java,5479,1287,71,54,4,1416
,,,,,,
