Class_Location,Class_Length,CheckStyle_Amount,PMD_Amount,SCAX_Amount,SpotBugs_Amount,Total_Amount
 pulsar-master\pulsar-master\tiered-storage\jcloud\src\main\java\org\apache\bookkeeper\mledger\offload\jcloud\impl\BlockAwareSegmentInputStreamImpl.java,0,58,1,23,0,82
pulsar-master\pulsar-master\pulsar-io\core\src\main\java\org\apache\pulsar\io\core\Sink.java,0,3,0,3,0,6
 pulsar-master\pulsar-master\pulsar-broker-common\src\test\java\org\apache\pulsar\bookie\rackawareness\BookieRackAffinityMappingTest.java,0,50,12,35,0,97
 pulsar-master\pulsar-master\pulsar-broker\src\main\java\org\apache\pulsar\broker\stats\NamespaceStats.java,100,54,0,11,0,65
 pulsar-master\pulsar-master\pulsar-client-api\src\main\java\org\apache\pulsar\client\api\Messages.java,0,1,0,1,0,2
 pulsar-master\pulsar-master\tests\integration\src\test\java\org\apache\pulsar\tests\integration\proxy\TestProxyWithWebSocket.java,82,29,5,6,0,40
 pulsar-master\pulsar-master\pulsar-client-admin-api\src\main\java\org\apache\pulsar\common\policies\data\FunctionInstanceStats.java,0,2,0,1,0,3
 pulsar-master\pulsar-master\pulsar-io\elastic-search\src\main\java\org\apache\pulsar\io\elasticsearch\client\opensearch\package-info.java,0,1,0,1,0,2
 pulsar-master\pulsar-master\pulsar-broker\src\main\java\org\apache\pulsar\broker\service\schema\ProtobufNativeSchemaCompatibilityCheck.java,45,22,1,12,0,35
 pulsar-master\pulsar-master\pulsar-broker\src\test\java\org\apache\pulsar\functions\worker\PulsarFunctionE2ESecurityTest.java,752,254,41,166,0,461
 pulsar-master\pulsar-master\pulsar-broker\src\main\java\org\apache\pulsar\broker\transaction\buffer\matadata\package-info.java,0,1,0,1,0,2
 pulsar-master\pulsar-master\pulsar-io\elastic-search\src\test\java\org\apache\pulsar\io\elasticsearch\ElasticSearchClientTests.java,303,90,1,44,0,135
 pulsar-master\pulsar-master\pulsar-transaction\coordinator\src\main\java\org\apache\pulsar\transaction\coordinator\impl\InMemTransactionMetadataStore.java,0,30,1,12,0,43
 pulsar-master\pulsar-master\pulsar-broker\src\test\java\org\apache\pulsar\broker\transaction\coordinator\TransactionMetaStoreAssignmentTest.java,100,21,1,7,0,29
 pulsar-master\pulsar-master\pulsar-functions\instance\src\main\java\org\apache\pulsar\functions\instance\state\StateManager.java,0,1,0,1,0,2
 pulsar-master\pulsar-master\pulsar-io\hbase\src\main\java\org\apache\pulsar\io\hbase\sink\HbaseGenericRecordSink.java,49,8,0,4,0,12
 pulsar-master\pulsar-master\pulsar-common\src\main\java\org\apache\pulsar\common\policies\data\PersistentOfflineTopicStats.java,81,56,0,5,0,61
 pulsar-master\pulsar-master\pulsar-broker\src\test\java\org\apache\pulsar\broker\admin\AdminApiOffloadTest.java,298,85,4,49,0,138
 pulsar-master\pulsar-master\pulsar-functions\instance\src\main\java\org\apache\pulsar\functions\instance\stats\ComponentStatsManager.java,136,70,0,18,0,88
 pulsar-master\pulsar-master\tests\integration\src\test\java\org\apache\pulsar\tests\integration\functions\utils\UploadDownloadCommandGenerator.java,47,31,0,7,0,38
 pulsar-master\pulsar-master\pulsar-sql\presto-pulsar\src\main\java\org\apache\pulsar\sql\presto\decoder\protobufnative\PulsarProtobufNativeRowDecoder.java,42,21,0,12,0,33
 pulsar-master\pulsar-master\pulsar-io\solr\src\test\java\org\apache\pulsar\io\solr\SolrServerUtil.java,63,18,1,6,0,25
 pulsar-master\pulsar-master\pulsar-broker\src\main\java\org\apache\pulsar\broker\service\schema\validator\package-info.java,0,0,0,1,0,1
 pulsar-master\pulsar-master\pulsar-client\src\test\java\org\apache\pulsar\client\impl\ConnectionTimeoutTest.java,28,10,1,6,0,17
 pulsar-master\pulsar-master\managed-ledger\src\main\java\org\apache\bookkeeper\mledger\ManagedLedgerFactoryMXBean.java,0,8,0,1,0,9
 pulsar-master\pulsar-master\pulsar-broker\src\test\java\org\apache\pulsar\client\impl\BrokerClientIntegrationTest.java,945,212,42,151,0,405
 pulsar-master\pulsar-master\pulsar-io\kafka\src\main\java\org\apache\pulsar\io\kafka\KafkaAbstractSink.java,0,37,0,22,0,59
 pulsar-master\pulsar-master\pulsar-broker\src\test\java\org\apache\pulsar\broker\auth\InvalidBrokerConfigForAuthorizationTest.java,29,5,1,5,0,11
 pulsar-master\pulsar-master\pulsar-io\dynamodb\src\main\java\org\apache\pulsar\io\dynamodb\StreamsRecord.java,44,23,1,5,0,29
 pulsar-master\pulsar-master\tests\integration\src\test\java\org\apache\pulsar\tests\integration\backwardscompatibility\PulsarStandaloneTestSuite2_4.java,6,3,1,2,0,6
 pulsar-master\pulsar-master\pulsar-broker\src\test\java\org\apache\pulsar\broker\service\NonPersistentTopicE2ETest.java,199,35,0,22,0,57
 pulsar-master\pulsar-master\pulsar-functions\java-examples\src\main\java\org\apache\pulsar\functions\api\examples\UserMetricFunction.java,0,3,0,1,0,4
 pulsar-master\pulsar-master\pulsar-io\kafka\src\test\java\org\apache\pulsar\io\kafka\KafkaBytesSourceTest.java,109,46,4,29,0,79
 pulsar-master\pulsar-master\pulsar-functions\api-java\src\main\java\org\apache\pulsar\functions\api\utils\JavaSerDe.java,34,6,1,1,0,8
 pulsar-master\pulsar-master\pulsar-websocket\src\main\java\org\apache\pulsar\websocket\data\EndOfTopicResponse.java,5,2,0,1,0,3
 pulsar-master\pulsar-master\pulsar-common\src\main\java\org\apache\pulsar\common\policies\data\package-info.java,0,2,0,1,0,3
 pulsar-master\pulsar-master\pulsar-functions\worker\src\test\java\org\apache\pulsar\functions\worker\executor\MockClockTest.java,18,6,0,1,0,7
 pulsar-master\pulsar-master\pulsar-io\flume\src\main\java\org\apache\pulsar\io\flume\node\package-info.java,0,1,0,1,0,2
 pulsar-master\pulsar-master\pulsar-functions\instance\src\main\java\org\apache\pulsar\functions\source\TopicSchema.java,211,122,3,43,0,168
 pulsar-master\pulsar-master\tests\integration\src\test\java\org\apache\pulsar\tests\integration\messaging\NonPersistentTopicMessagingTest.java,43,24,0,9,0,33
 pulsar-master\pulsar-master\tests\integration\src\test\java\org\apache\pulsar\tests\integration\cli\ClusterMetadataTearDownTest.java,163,41,2,20,0,63
 pulsar-master\pulsar-master\pulsar-client\src\test\java\org\apache\pulsar\client\impl\schema\generic\GenericAvroRecordTest.java,21,4,0,3,0,7
 pulsar-master\pulsar-master\pulsar-functions\worker\src\main\java\org\apache\pulsar\functions\worker\rest\FunctionApiResource.java,31,16,0,4,0,20
 pulsar-master\pulsar-master\pulsar-client\src\main\java\org\apache\pulsar\client\util\TimedCompletableFuture.java,13,5,1,1,0,7
 pulsar-master\pulsar-master\pulsar-functions\worker\src\test\java\org\apache\pulsar\functions\worker\FunctionMetaDataManagerTest.java,385,60,0,45,0,105
 pulsar-master\pulsar-master\pulsar-client-api\src\main\java\org\apache\pulsar\client\api\AuthenticationFactory.java,0,19,4,11,0,34
 pulsar-master\pulsar-master\pulsar-io\hdfs2\src\test\java\org\apache\pulsar\io\hdfs2\sink\HdfsSinkConfigTests.java,124,49,1,3,0,53
 pulsar-master\pulsar-master\pulsar-client-admin-api\src\main\java\org\apache\pulsar\common\policies\data\impl\BookieAffinityGroupDataImpl.java,0,22,0,8,0,30
 pulsar-master\pulsar-master\pulsar-client-api\src\main\java\org\apache\pulsar\common\classification\package-info.java,0,1,0,1,0,2
 pulsar-master\pulsar-master\pulsar-proxy\src\test\java\org\apache\pulsar\proxy\server\ProxyAuthenticatedProducerConsumerTest.java,163,48,7,27,0,82
 pulsar-master\pulsar-master\pulsar-common\src\test\java\org\apache\pulsar\common\util\collections\GrowablePriorityLongPairQueueTest.java,345,151,5,22,0,178
 pulsar-master\pulsar-master\pulsar-io\file\src\main\java\org\apache\pulsar\io\file\utils\package-info.java,0,1,0,1,0,2
 pulsar-master\pulsar-master\pulsar-client\src\main\java\org\apache\pulsar\client\impl\KeyBasedBatcherBuilder.java,10,1,0,1,0,2
 pulsar-master\pulsar-master\pulsar-functions\worker\src\test\java\org\apache\pulsar\functions\worker\executor\MockExecutorControllerTest.java,71,17,0,1,0,18
 pulsar-master\pulsar-master\pulsar-broker\src\test\java\org\apache\pulsar\client\api\SimpleProducerConsumerTest.java,4289,992,176,653,0,1821
 pulsar-master\pulsar-master\pulsar-functions\instance\src\main\java\org\apache\pulsar\functions\instance\stats\package-info.java,0,0,0,1,0,1
 pulsar-master\pulsar-master\pulsar-proxy\src\test\java\org\apache\pulsar\proxy\server\ProxyConnectionTest.java,15,5,0,5,0,10
 pulsar-master\pulsar-master\pulsar-broker\src\main\java\org\apache\pulsar\broker\transaction\pendingack\impl\MLPendingAckStore.java,368,153,8,86,0,247
 pulsar-master\pulsar-master\pulsar-broker\src\test\java\org\apache\pulsar\websocket\proxy\ProxyPublishConsumeTlsTest.java,102,22,3,13,0,38
 pulsar-master\pulsar-master\pulsar-broker-common\src\main\java\org\apache\pulsar\broker\authentication\AuthenticationDataSource.java,0,11,2,8,0,21
 pulsar-master\pulsar-master\pulsar-common\src\main\java\org\apache\pulsar\common\util\KeyStoreHolder.java,35,16,0,4,0,20
 pulsar-master\pulsar-master\pulsar-common\src\main\java\org\apache\pulsar\common\policies\data\FunctionInstanceStatsDataBaseImpl.java,27,8,0,4,0,12
 pulsar-master\pulsar-master\pulsar-io\flume\src\main\java\org\apache\pulsar\io\flume\source\AbstractSinkOfFlume.java,9,3,0,1,0,4
 pulsar-master\pulsar-master\pulsar-client\src\test\java\org\apache\pulsar\client\impl\PartitionedProducerImplTest.java,208,75,3,47,0,125
 pulsar-master\pulsar-master\pulsar-broker\src\main\java\org\apache\pulsar\broker\service\ConnectionController.java,0,37,0,17,0,54
 pulsar-master\pulsar-master\pulsar-io\core\src\main\java\org\apache\pulsar\io\core\BatchPushSource.java,80,16,0,4,0,20
 pulsar-master\pulsar-master\pulsar-common\src\test\java\org\apache\pulsar\common\policies\impl\MinAvailablePolicyTest.java,11,4,0,1,0,5
 pulsar-master\pulsar-master\pulsar-broker\src\test\java\org\apache\pulsar\client\impl\TransactionClientConnectTest.java,166,71,9,43,0,123
 pulsar-master\pulsar-master\pulsar-common\src\test\java\org\apache\pulsar\common\policies\data\BacklogQuotaTest.java,47,7,0,3,0,10
 pulsar-master\pulsar-master\pulsar-broker\src\main\java\org\apache\pulsar\broker\loadbalance\impl\ThresholdShedder.java,123,53,1,42,0,96
 pulsar-master\pulsar-master\tiered-storage\jcloud\src\main\java\org\apache\bookkeeper\mledger\offload\jcloud\JCloudLedgerOffloaderFactory.java,23,14,0,10,0,24
 pulsar-master\pulsar-master\pulsar-broker\src\main\java\org\apache\pulsar\broker\service\plugin\EntryFilter.java,0,2,0,2,0,4
 pulsar-master\pulsar-master\pulsar-io\twitter\src\main\java\org\apache\pulsar\io\twitter\data\TweetData.java,105,74,0,1,0,75
 pulsar-master\pulsar-master\pulsar-io\dynamodb\src\main\java\org\apache\pulsar\io\dynamodb\StreamsRecordProcessor.java,77,24,2,14,0,40
 pulsar-master\pulsar-master\pulsar-broker\src\main\java\org\apache\pulsar\broker\service\schema\exceptions\InvalidSchemaDataException.java,13,5,0,1,0,6
 pulsar-master\pulsar-master\pulsar-websocket\src\main\java\org\apache\pulsar\websocket\service\package-info.java,0,0,0,1,0,1
 pulsar-master\pulsar-master\testmocks\src\main\java\org\apache\zookeeper\MockZooKeeperSession.java,218,105,3,30,0,138
 pulsar-master\pulsar-master\pulsar-broker\src\test\java\org\apache\pulsar\schema\SchemaTest.java,1098,245,47,157,0,449
 pulsar-master\pulsar-master\bouncy-castle\bc\src\main\java\org\apache\pulsar\bcloader\BouncyCastleLoader.java,16,3,0,1,0,4
 pulsar-master\pulsar-master\pulsar-client-api\src\main\java\org\apache\pulsar\client\api\package-info.java,0,1,0,1,0,2
 pulsar-master\pulsar-master\pulsar-common\src\main\java\org\apache\pulsar\common\schema\LongSchemaVersion.java,45,11,0,1,0,12
 pulsar-master\pulsar-master\pulsar-functions\instance\src\main\java\org\apache\pulsar\functions\instance\state\PulsarMetadataStateStoreImpl.java,114,47,4,2,0,53
 pulsar-master\pulsar-master\pulsar-client-admin-api\src\main\java\org\apache\pulsar\common\stats\package-info.java,0,2,0,1,0,3
 pulsar-master\pulsar-master\pulsar-io\batch-data-generator\src\main\java\org\apache\pulsar\io\batchdatagenerator\Person.java,82,41,2,2,0,45
 pulsar-master\pulsar-master\pulsar-client\src\test\java\org\apache\pulsar\client\impl\TopicMetadataImplTest.java,10,3,0,1,0,4
 pulsar-master\pulsar-master\pulsar-functions\worker\src\main\java\org\apache\pulsar\functions\worker\MetricsGenerator.java,18,8,0,3,0,11
 pulsar-master\pulsar-master\pulsar-broker\src\test\java\org\apache\pulsar\broker\auth\MockAuthenticationProvider.java,41,14,4,4,0,22
 pulsar-master\pulsar-master\pulsar-client-tools\src\main\java\org\apache\pulsar\admin\cli\utils\SchemaExtractor.java,16,7,1,3,0,11
 pulsar-master\pulsar-master\pulsar-io\batch-data-generator\src\main\java\org\apache\pulsar\io\batchdatagenerator\BatchDataGeneratorPushSource.java,50,18,1,4,0,23
 pulsar-master\pulsar-master\pulsar-broker\src\test\java\org\apache\pulsar\functions\worker\PulsarFunctionLocalRunTest.java,1041,368,31,180,0,579
 pulsar-master\pulsar-master\pulsar-metadata\src\main\java\org\apache\pulsar\metadata\api\MetadataStore.java,0,17,0,17,0,34
 pulsar-master\pulsar-master\pulsar-metadata\src\test\java\org\apache\pulsar\metadata\bookkeeper\EndToEndTest.java,95,18,1,3,0,22
 pulsar-master\pulsar-master\pulsar-broker\src\main\java\org\apache\pulsar\broker\service\nonpersistent\NonPersistentTopic.java,0,339,23,204,0,566
 pulsar-master\pulsar-master\tests\integration\src\test\java\org\apache\pulsar\tests\integration\io\sinks\ElasticSearch8SinkTester.java,16,5,0,2,0,7
 pulsar-master\pulsar-master\pulsar-broker-common\src\test\java\org\apache\pulsar\broker\validator\MultipleListenerValidatorTest.java,86,27,7,15,0,49
 pulsar-master\pulsar-master\pulsar-io\hbase\src\test\java\org\apache\pulsar\io\hbase\sink\HbaseGenericRecordSinkTest.java,122,32,2,10,0,44
 pulsar-master\pulsar-master\pulsar-functions\secrets\src\test\java\org\apache\pulsar\functions\secretsprovider\ClearTextSecretsProviderTest.java,11,3,0,2,0,5
 pulsar-master\pulsar-master\pulsar-client-admin-api\src\main\java\org\apache\pulsar\common\policies\data\SubscriptionAuthMode.java,0,0,0,1,0,1
 pulsar-master\pulsar-master\pulsar-proxy\src\main\java\org\apache\pulsar\proxy\extensions\ProxyExtension.java,0,9,0,9,0,18
 pulsar-master\pulsar-master\pulsar-common\src\main\java\org\apache\pulsar\common\allocator\PulsarByteBufAllocator.java,63,21,3,13,0,37
 pulsar-master\pulsar-master\pulsar-transaction\common\src\main\java\org\apache\pulsar\transaction\impl\common\package-info.java,0,2,0,1,0,3
 pulsar-master\pulsar-master\pulsar-broker\src\test\java\org\apache\pulsar\client\impl\MessagePublishThrottlingTest.java,484,150,25,99,0,274
 pulsar-master\pulsar-master\pulsar-client\src\test\java\org\apache\pulsar\client\api\MessagePayloadTest.java,74,18,0,6,0,24
 pulsar-master\pulsar-master\pulsar-functions\api-java\src\main\java\org\apache\pulsar\functions\api\package-info.java,0,2,0,2,0,4
 pulsar-master\pulsar-master\pulsar-client-admin-api\src\main\java\org\apache\pulsar\common\policies\impl\MinAvailablePolicy.java,48,22,0,6,0,28
 pulsar-master\pulsar-master\pulsar-io\kinesis\src\main\java\org\apache\pulsar\io\kinesis\KinesisRecord.java,57,24,1,3,0,28
 pulsar-master\pulsar-master\pulsar-io\hdfs3\src\test\java\org\apache\pulsar\io\hdfs3\sink\AbstractHdfsSinkTest.java,0,56,2,7,0,65
 pulsar-master\pulsar-master\pulsar-broker\src\main\java\org\apache\pulsar\package-info.java,0,0,0,1,0,1
 pulsar-master\pulsar-master\pulsar-functions\runtime\src\main\java\org\apache\pulsar\functions\runtime\thread\ThreadRuntimeFactoryConfig.java,30,11,0,3,0,14
 pulsar-master\pulsar-master\pulsar-common\src\main\java\org\apache\pulsar\common\lookup\package-info.java,0,2,0,1,0,3
 pulsar-master\pulsar-master\pulsar-client-api\src\main\java\org\apache\pulsar\client\api\Reader.java,0,45,0,41,0,86
 pulsar-master\pulsar-master\pulsar-broker\src\test\java\org\apache\pulsar\broker\service\persistent\PersistentTopicTest.java,217,58,1,44,0,103
 pulsar-master\pulsar-master\pulsar-client-admin-api\src\main\java\org\apache\pulsar\common\partition\PartitionedTopicMetadata.java,30,16,0,3,0,19
 pulsar-master\pulsar-master\pulsar-client-api\src\main\java\org\apache\pulsar\client\api\transaction\TransactionBuilder.java,0,1,0,2,0,3
 pulsar-master\pulsar-master\pulsar-broker\src\main\java\org\apache\pulsar\broker\resourcegroup\ResourceUsageTransportManager.java,0,12,5,3,0,20
 pulsar-master\pulsar-master\pulsar-client\src\test\java\org\apache\pulsar\client\impl\ClientCnxRequestTimeoutQueueTest.java,77,15,0,6,0,21
 pulsar-master\pulsar-master\pulsar-client-tools\src\main\java\org\apache\pulsar\admin\cli\CmdResourceQuotas.java,0,35,0,22,0,57
 pulsar-master\pulsar-master\pulsar-broker\src\test\java\org\apache\pulsar\broker\admin\TopicPoliciesTest.java,2921,1094,194,662,0,1950
 pulsar-master\pulsar-master\pulsar-functions\instance\src\main\java\org\apache\pulsar\functions\windowing\DefaultEvictionContext.java,63,30,0,3,0,33
 pulsar-master\pulsar-master\pulsar-broker\src\main\java\org\apache\pulsar\broker\admin\impl\TenantsBase.java,305,112,23,65,0,200
 pulsar-master\pulsar-master\pulsar-broker-common\src\main\java\org\apache\pulsar\bookie\rackawareness\package-info.java,0,1,0,1,0,2
 pulsar-master\pulsar-master\pulsar-sql\presto-pulsar\src\main\java\org\apache\pulsar\sql\presto\PulsarConnectorFactory.java,43,11,0,4,0,15
 pulsar-master\pulsar-master\pulsar-client-admin-api\src\main\java\org\apache\pulsar\common\functions\UpdateOptions.java,0,2,0,1,0,3
 pulsar-master\pulsar-master\pulsar-functions\utils\src\main\java\org\apache\pulsar\functions\utils\functioncache\package-info.java,0,0,0,1,0,1
 pulsar-master\pulsar-master\pulsar-common\src\main\java\org\apache\pulsar\common\protocol\schema\DeleteSchemaResponse.java,4,1,0,1,0,2
 pulsar-master\pulsar-master\pulsar-io\dynamodb\src\main\java\org\apache\pulsar\io\dynamodb\StreamsRecordProcessorFactory.java,16,9,0,5,0,14
 pulsar-master\pulsar-master\pulsar-transaction\coordinator\src\main\java\org\apache\pulsar\transaction\coordinator\TransactionLogReplayCallback.java,0,2,0,2,0,4
 pulsar-master\pulsar-master\pulsar-client-tools\src\main\java\org\apache\pulsar\client\cli\NoSplitter.java,15,3,0,2,0,5
 pulsar-master\pulsar-master\pulsar-io\flume\src\main\java\org\apache\pulsar\io\flume\FlumeConfig.java,39,11,0,3,0,14
 pulsar-master\pulsar-master\pulsar-metadata\src\main\java\org\apache\pulsar\metadata\impl\EtcdSessionWatcher.java,122,37,1,17,0,55
 pulsar-master\pulsar-master\tiered-storage\jcloud\src\main\java\org\apache\bookkeeper\mledger\offload\jcloud\impl\OffloadIndexEntryImpl.java,0,21,1,4,0,26
 pulsar-master\pulsar-master\pulsar-io\influxdb\src\main\java\org\apache\pulsar\io\influxdb\v1\InfluxDBSinkConfig.java,89,25,0,8,0,33
 pulsar-master\pulsar-master\pulsar-common\src\main\java\org\apache\pulsar\common\policies\data\AutoFailoverPolicyDataImpl.java,55,24,0,8,0,32
 pulsar-master\pulsar-master\pulsar-common\src\main\java\org\apache\pulsar\common\policies\data\ResourceQuotaMixIn.java,5,1,0,1,0,2
 pulsar-master\pulsar-master\pulsar-io\redis\src\main\java\org\apache\pulsar\io\redis\RedisSession.java,99,33,2,12,0,47
 pulsar-master\pulsar-master\tiered-storage\jcloud\src\main\java\org\apache\bookkeeper\mledger\offload\jcloud\impl\BufferedOffloadStream.java,106,46,2,10,0,58
 pulsar-master\pulsar-master\pulsar-broker\src\test\java\org\apache\pulsar\broker\web\RestExceptionTest.java,32,13,0,10,0,23
 pulsar-master\pulsar-master\pulsar-broker\src\main\java\org\apache\pulsar\broker\service\persistent\PersistentReplicator.java,0,236,17,127,0,380
 pulsar-master\pulsar-master\pulsar-common\src\main\java\org\apache\pulsar\common\io\ConfigFieldDefinition.java,18,0,0,1,0,1
 pulsar-master\pulsar-master\pulsar-client-admin-api\src\main\java\org\apache\pulsar\common\policies\data\RawBookieInfo.java,4,1,0,1,0,2
 pulsar-master\pulsar-master\pulsar-broker\src\test\java\org\apache\pulsar\client\impl\ConsumerAckResponseTest.java,58,16,0,10,0,26
 pulsar-master\pulsar-master\buildtools\src\main\java\org\apache\pulsar\tests\AnnotationListener.java,43,21,0,8,0,29
 pulsar-master\pulsar-master\pulsar-client\src\main\java\org\apache\pulsar\client\impl\schema\generic\ProtobufNativeRecordBuilderImpl.java,47,18,0,2,0,20
 pulsar-master\pulsar-master\pulsar-client\src\main\java\org\apache\pulsar\client\impl\auth\AuthenticationDataNull.java,4,0,0,1,0,1
 pulsar-master\pulsar-master\pulsar-broker\src\main\java\org\apache\pulsar\broker\resourcegroup\ResourceQuotaCalculator.java,0,13,0,12,0,25
 pulsar-master\pulsar-master\pulsar-client-api\src\main\java\org\apache\pulsar\client\api\KeyStoreParams.java,6,3,0,1,0,4
 pulsar-master\pulsar-master\pulsar-functions\worker\src\test\java\org\apache\pulsar\functions\worker\MembershipManagerTest.java,360,91,8,73,0,172
 pulsar-master\pulsar-master\pulsar-proxy\src\main\java\org\apache\pulsar\proxy\extensions\ExtensionsDefinitions.java,0,2,0,2,0,4
 pulsar-master\pulsar-master\pulsar-client-admin-api\src\main\java\org\apache\pulsar\common\policies\package-info.java,0,2,0,1,0,3
 pulsar-master\pulsar-master\pulsar-broker\src\test\java\org\apache\pulsar\broker\admin\BrokerAdminClientTlsAuthTest.java,109,26,1,12,0,39
 pulsar-master\pulsar-master\pulsar-io\common\src\test\java\org\apache\pulsar\io\common\IOConfigUtilsTest.java,372,96,9,24,0,129
 pulsar-master\pulsar-master\pulsar-broker\src\test\java\org\apache\pulsar\broker\service\MaxMessageSizeTest.java,204,74,5,19,0,98
 pulsar-master\pulsar-master\tests\integration\src\test\java\org\apache\pulsar\tests\integration\io\sinks\PulsarSinksTest.java,71,15,0,3,0,18
 pulsar-master\pulsar-master\pulsar-io\hdfs3\src\main\java\org\apache\pulsar\io\hdfs3\sink\package-info.java,0,1,0,1,0,2
 pulsar-master\pulsar-master\pulsar-functions\runtime\src\main\java\org\apache\pulsar\functions\auth\ClearTextFunctionTokenAuthProvider.java,46,24,0,14,0,38
 pulsar-master\pulsar-master\pulsar-client\src\main\java\org\apache\pulsar\client\impl\schema\generic\GenericProtobufNativeSchema.java,44,20,0,6,0,26
 pulsar-master\pulsar-master\tests\integration\src\test\java\org\apache\pulsar\tests\integration\messaging\NonDurableConsumerMessagingTest.java,38,10,2,6,0,18
 pulsar-master\pulsar-master\tiered-storage\jcloud\src\main\java\org\apache\bookkeeper\mledger\offload\jcloud\provider\TieredStorageConfiguration.java,309,134,1,38,0,173
 pulsar-master\pulsar-master\pulsar-metadata\src\main\java\org\apache\pulsar\metadata\api\coordination\LeaderElectionState.java,0,0,0,1,0,1
 pulsar-master\pulsar-master\pulsar-io\kinesis\src\main\java\org\apache\pulsar\io\kinesis\BaseKinesisConfig.java,47,10,0,5,0,15
 pulsar-master\pulsar-master\pulsar-functions\secrets\src\test\java\org\apache\pulsar\functions\secretsprovider\EnvironmentBasedSecretsProviderTest.java,25,10,0,6,0,16
 pulsar-master\pulsar-master\pulsar-client-api\src\main\java\org\apache\pulsar\client\api\MessagePayloadProcessor.java,0,14,0,10,0,24
 pulsar-master\pulsar-master\pulsar-broker\src\main\java\org\apache\pulsar\broker\transaction\buffer\TransactionEntry.java,0,1,0,1,0,2
 pulsar-master\pulsar-master\pulsar-sql\presto-pulsar\src\main\java\org\apache\pulsar\sql\presto\decoder\avro\package-info.java,0,2,0,1,0,3
 pulsar-master\pulsar-master\pulsar-common\src\main\java\org\apache\pulsar\common\protocol\schema\LongSchemaVersionResponse.java,4,2,0,1,0,3
 pulsar-master\pulsar-master\pulsar-broker\src\test\java\org\apache\pulsar\broker\stats\PrometheusMetricsTest.java,0,282,16,200,0,498
 pulsar-master\pulsar-master\pulsar-client\src\main\java\org\apache\pulsar\client\impl\auth\AuthenticationDataBasic.java,35,13,1,3,0,17
 pulsar-master\pulsar-master\pulsar-common\src\main\java\org\apache\pulsar\common\compression\CompressionCodecProvider.java,59,21,0,11,0,32
 pulsar-master\pulsar-master\pulsar-client\src\main\java\org\apache\pulsar\client\impl\auth\oauth2\AuthenticationFactoryOAuth2.java,0,17,1,10,0,28
 pulsar-master\pulsar-master\pulsar-common\src\main\java\org\apache\pulsar\common\protocol\schema\GetAllVersionsSchemaResponse.java,4,1,0,1,0,2
 pulsar-master\pulsar-master\pulsar-broker\src\test\java\org\apache\pulsar\broker\service\PrecisTopicPublishRateThrottleTest.java,156,57,6,30,0,93
 pulsar-master\pulsar-master\pulsar-common\src\main\java\org\apache\pulsar\common\util\RestException.java,41,13,0,3,0,16
 pulsar-master\pulsar-master\pulsar-functions\instance\src\main\java\org\apache\pulsar\functions\windowing\triggers\CountTriggerPolicy.java,0,24,0,5,0,29
 pulsar-master\pulsar-master\pulsar-broker\src\test\java\org\apache\pulsar\broker\namespace\OwnerShipCacheForCurrentServerTest.java,58,22,0,12,0,34
 pulsar-master\pulsar-master\pulsar-functions\instance\src\main\java\org\apache\pulsar\functions\source\PulsarSourceConsumerConfig.java,0,7,0,1,0,8
 pulsar-master\pulsar-master\pulsar-broker\src\test\java\org\apache\pulsar\client\impl\ConsumerDedupPermitsUpdateTest.java,88,27,0,5,0,32
 pulsar-master\pulsar-master\pulsar-broker\src\main\java\org\apache\pulsar\broker\loadbalance\ResourceUnit.java,0,4,0,2,0,6
 pulsar-master\pulsar-master\pulsar-client\src\main\java\org\apache\pulsar\client\impl\ProducerStatsRecorder.java,0,5,0,1,0,6
 pulsar-master\pulsar-master\tests\integration\src\test\java\org\apache\pulsar\tests\integration\containers\S3Container.java,29,10,0,1,0,11
 pulsar-master\pulsar-master\pulsar-broker-common\src\main\java\org\apache\pulsar\bookie\rackawareness\BookieRackAffinityMapping.java,0,60,5,41,0,106
 pulsar-master\pulsar-master\pulsar-client-api\src\main\java\org\apache\pulsar\client\api\AutoClusterFailoverBuilder.java,0,22,0,11,0,33
 pulsar-master\pulsar-master\pulsar-proxy\src\test\java\org\apache\pulsar\proxy\server\ProxyPrometheusMetricsTest.java,133,26,3,15,0,44
 pulsar-master\pulsar-master\pulsar-client\src\main\java\org\apache\pulsar\client\impl\transaction\TransactionCoordinatorClientImpl.java,232,82,2,38,0,122
 pulsar-master\pulsar-master\pulsar-broker\src\main\java\org\apache\pulsar\common\naming\NamespaceBundles.java,170,75,4,15,0,94
 pulsar-master\pulsar-master\pulsar-broker\src\test\java\org\apache\pulsar\broker\admin\TopicAutoCreationTest.java,56,10,0,6,0,16
 pulsar-master\pulsar-master\pulsar-proxy\src\main\java\org\apache\pulsar\proxy\stats\package-info.java,0,1,0,1,0,2
 pulsar-master\pulsar-master\pulsar-broker\src\test\java\org\apache\pulsar\websocket\proxy\SimpleConsumerMessageHandler.java,0,1,0,1,0,2
 pulsar-master\pulsar-master\tests\integration\src\test\java\org\apache\pulsar\tests\integration\suites\PulsarCliTestSuite.java,17,3,0,1,0,4
 pulsar-master\pulsar-master\pulsar-testclient\src\main\java\org\apache\pulsar\proxy\socket\client\SimpleTestProducerSocket.java,66,45,1,10,0,56
 pulsar-master\pulsar-master\pulsar-client\src\main\java\org\apache\pulsar\client\impl\schema\BytesSchema.java,45,10,1,1,0,12
 pulsar-master\pulsar-master\pulsar-io\core\src\main\java\org\apache\pulsar\io\core\annotations\FieldDoc.java,0,0,0,1,0,1
 pulsar-master\pulsar-master\pulsar-io\flume\src\test\java\org\apache\pulsar\io\flume\sink\StringSinkTests.java,89,24,2,1,0,27
 pulsar-master\pulsar-master\managed-ledger\src\test\java\org\apache\bookkeeper\mledger\impl\EntryCacheTest.java,214,76,0,12,0,88
 pulsar-master\pulsar-master\pulsar-io\redis\src\main\java\org\apache\pulsar\io\redis\sink\RedisSinkConfig.java,42,18,0,8,0,26
 pulsar-master\pulsar-master\tests\integration\src\test\java\org\apache\pulsar\tests\integration\topologies\PulsarGeoCluster.java,57,15,2,4,0,21
 pulsar-master\pulsar-master\pulsar-functions\utils\src\test\java\org\apache\pulsar\functions\utils\FunctionMetaDataUtilsTest.java,68,38,0,28,0,66
 pulsar-master\pulsar-master\managed-ledger\src\test\java\org\apache\bookkeeper\mledger\impl\ManagedCursorConcurrencyTest.java,391,71,7,25,0,103
 pulsar-master\pulsar-master\pulsar-functions\java-examples\src\main\java\org\apache\pulsar\functions\api\examples\AvroSchemaTestFunction.java,0,6,1,3,0,10
 pulsar-master\pulsar-master\pulsar-broker-common\src\main\java\org\apache\pulsar\broker\web\plugin\servlet\AdditionalServletWithClassLoader.java,39,12,0,6,0,18
 pulsar-master\pulsar-master\pulsar-broker\src\test\java\org\apache\pulsar\PulsarTransactionCoordinatorMetadataSetupTest.java,35,4,1,4,0,9
 pulsar-master\pulsar-master\managed-ledger\src\test\java\org\apache\bookkeeper\mledger\util\TestStatsBuckets.java,91,37,2,1,0,40
 pulsar-master\pulsar-master\pulsar-client-api\src\main\java\org\apache\pulsar\common\schema\SchemaInfoWithVersion.java,12,5,0,2,0,7
 pulsar-master\pulsar-master\pulsar-common\src\main\java\org\apache\pulsar\common\util\CompletableFutureCancellationHandler.java,80,23,2,14,0,39
 pulsar-master\pulsar-master\pulsar-broker\src\test\java\org\apache\pulsar\broker\intercept\BrokerInterceptorUtilsTest.java,90,21,0,19,0,40
 pulsar-master\pulsar-master\tests\integration\src\test\java\org\apache\pulsar\tests\integration\python\PythonSchemaTest.java,87,21,0,9,0,30
 pulsar-master\pulsar-master\pulsar-io\twitter\src\test\java\org\apache\pulsar\io\twitter\TwitterFireHoseConfigTests.java,79,32,0,1,0,33
 pulsar-master\pulsar-master\pulsar-client-tools\src\main\java\org\apache\pulsar\client\cli\CmdProduce.java,452,147,15,58,0,220
 pulsar-master\pulsar-master\pulsar-io\influxdb\src\main\java\org\apache\pulsar\io\influxdb\BatchSink.java,0,13,0,2,0,15
 pulsar-master\pulsar-master\pulsar-websocket\src\main\java\org\apache\pulsar\websocket\data\ProducerAcks.java,7,4,0,1,0,5
 pulsar-master\pulsar-master\pulsar-broker\src\test\java\org\apache\pulsar\broker\service\TransactionMarkerDeleteTest.java,113,22,0,16,0,38
 pulsar-master\pulsar-master\tiered-storage\file-system\src\main\java\org\apache\bookkeeper\mledger\offload\filesystem\FileSystemLedgerOffloaderFactory.java,14,11,0,7,0,18
 pulsar-master\pulsar-master\pulsar-client-1x-base\pulsar-client-1x\src\main\java\org\apache\pulsar\client\impl\v1\ReaderV1Impl.java,59,18,0,3,0,21
 pulsar-master\pulsar-master\pulsar-broker\src\main\java\org\apache\pulsar\broker\loadbalance\impl\PulsarLoadReportImpl.java,58,16,1,8,0,25
 pulsar-master\pulsar-master\pulsar-io\hdfs2\src\main\java\org\apache\pulsar\io\hdfs2\sink\package-info.java,0,1,0,1,0,2
 pulsar-master\pulsar-master\pulsar-sql\presto-pulsar\src\main\java\org\apache\pulsar\sql\presto\PulsarRowDecoderFactory.java,0,8,0,5,0,13
 pulsar-master\pulsar-master\pulsar-functions\worker\src\main\java\org\apache\pulsar\functions\worker\rest\api\v2\package-info.java,0,0,0,1,0,1
 pulsar-master\pulsar-master\pulsar-broker\src\main\java\org\apache\pulsar\broker\service\nonpersistent\NonPersistentDispatcherSingleActiveConsumer.java,0,26,0,12,0,38
 pulsar-master\pulsar-master\managed-ledger\src\test\java\org\apache\bookkeeper\mledger\impl\ManagedLedgerSingleBookieTest.java,45,10,0,4,0,14
 pulsar-master\pulsar-master\tests\integration\src\test\java\org\apache\pulsar\tests\integration\io\sources\debezium\DebeziumPostgreSqlSourceTester.java,120,50,3,25,0,78
 pulsar-master\pulsar-master\pulsar-client-admin\src\main\java\org\apache\pulsar\client\admin\internal\http\package-info.java,0,1,0,1,0,2
 pulsar-master\pulsar-master\managed-ledger\src\test\java\org\apache\bookkeeper\mledger\impl\ManagedLedgerFactoryChangeLedgerPathTest.java,84,20,0,9,0,29
 pulsar-master\pulsar-master\pulsar-client-admin\src\main\java\org\apache\pulsar\client\admin\internal\SourcesImpl.java,0,271,0,108,0,379
 pulsar-master\pulsar-master\managed-ledger\src\main\java\org\apache\bookkeeper\mledger\impl\LedgerMetadataUtils.java,0,41,0,21,0,62
 pulsar-master\pulsar-master\pulsar-common\src\main\java\org\apache\pulsar\common\policies\data\PolicyName.java,0,28,0,1,0,29
 pulsar-master\pulsar-master\tests\docker-images\java-test-functions\src\main\java\org\apache\pulsar\tests\integration\io\TestStateSource.java,28,10,1,2,0,13
 pulsar-master\pulsar-master\pulsar-client-1x-base\pulsar-client-1x\src\main\java\org\apache\pulsar\client\api\ClientConfiguration.java,356,74,0,45,0,119
 pulsar-master\pulsar-master\pulsar-io\kafka-connect-adaptor\src\main\java\org\apache\pulsar\io\kafka\connect\package-info.java,0,1,0,1,0,2
 pulsar-master\pulsar-master\pulsar-client-1x-base\pulsar-client-1x\src\main\java\org\apache\pulsar\client\api\MessageListener.java,0,5,0,5,0,10
 pulsar-master\pulsar-master\pulsar-io\elastic-search\src\main\java\org\apache\pulsar\io\elasticsearch\RandomExponentialRetry.java,59,34,1,6,0,41
 pulsar-master\pulsar-master\pulsar-client\src\test\java\org\apache\pulsar\client\impl\PulsarServiceNameResolverTest.java,96,24,1,8,0,33
 pulsar-master\pulsar-master\pulsar-proxy\src\test\java\org\apache\pulsar\proxy\server\ProxyLookupThrottlingTest.java,75,25,6,12,0,43
 pulsar-master\pulsar-master\tests\integration\src\test\java\org\apache\pulsar\tests\integration\schema\Schemas.java,0,55,1,6,0,62
 pulsar-master\pulsar-master\pulsar-client-tools-test\src\test\java\org\apache\pulsar\client\cli\PulsarClientToolWsTest.java,111,31,2,18,0,51
 pulsar-master\pulsar-master\pulsar-functions\instance\src\main\java\org\apache\pulsar\functions\windowing\triggers\TimeTriggerPolicy.java,0,29,3,9,0,41
 pulsar-master\pulsar-master\buildtools\src\main\java\org\apache\pulsar\tests\EnumValuesDataProvider.java,22,8,0,5,0,13
 pulsar-master\pulsar-master\pulsar-proxy\src\test\java\org\apache\pulsar\proxy\server\ProxyKeyStoreTlsTestWithoutAuth.java,140,65,10,25,0,100
 pulsar-master\pulsar-master\managed-ledger\src\test\java\org\apache\bookkeeper\mledger\impl\MetaStoreImplTest.java,214,65,3,30,0,98
 pulsar-master\pulsar-master\pulsar-client\src\main\java\org\apache\pulsar\client\impl\ConsumerId.java,39,18,0,3,0,21
 pulsar-master\pulsar-master\pulsar-client\src\main\java\org\apache\pulsar\client\impl\schema\GenericObjectWrapper.java,0,19,1,5,0,25
 pulsar-master\pulsar-master\pulsar-client\src\test\java\org\apache\pulsar\client\tutorial\SampleConsumerWithSchema.java,24,8,1,4,0,13
 pulsar-master\pulsar-master\pulsar-client\src\main\java\org\apache\pulsar\client\impl\schema\LocalDateTimeSchema.java,57,14,1,3,0,18
 pulsar-master\pulsar-master\pulsar-broker\src\test\java\org\apache\pulsar\compaction\CompactionRetentionTest.java,230,34,8,19,0,61
 pulsar-master\pulsar-master\pulsar-broker\src\test\java\org\apache\pulsar\broker\loadbalance\BrokerVersionFilterTest.java,50,3,0,2,0,5
 pulsar-master\pulsar-master\pulsar-testclient\src\main\java\org\apache\pulsar\testclient\utils\FixedColumnLengthTableMaker.java,133,22,0,12,0,34
 pulsar-master\pulsar-master\pulsar-broker\src\test\java\org\apache\pulsar\broker\namespace\NamespaceServiceTest.java,580,164,20,129,0,313
 pulsar-master\pulsar-master\pulsar-broker\src\main\java\org\apache\pulsar\broker\systopic\SystemTopicClient.java,0,8,0,1,0,9
 pulsar-master\pulsar-master\pulsar-broker\src\test\java\org\apache\pulsar\broker\service\EntryBatchIndexesAcksTest.java,29,10,0,3,0,13
 pulsar-master\pulsar-master\pulsar-client-1x-base\pulsar-client-1x\src\main\java\org\apache\pulsar\client\impl\v1\ConsumerV1Impl.java,148,79,0,8,0,87
 pulsar-master\pulsar-master\pulsar-broker-auth-sasl\src\test\java\org\apache\pulsar\broker\authentication\SaslAuthenticateTest.java,233,31,6,15,0,52
 pulsar-master\pulsar-master\managed-ledger\src\test\java\org\apache\bookkeeper\test\ZooKeeperUtil.java,125,46,4,14,0,64
 pulsar-master\pulsar-master\pulsar-common\src\test\java\org\apache\pulsar\common\protocol\MarkersTest.java,115,48,0,17,0,65
 pulsar-master\pulsar-master\pulsar-websocket\src\main\java\org\apache\pulsar\websocket\data\ProducerMessage.java,41,27,0,2,0,29
 pulsar-master\pulsar-master\pulsar-common\src\test\java\org\apache\pulsar\AddMissingPatchVersionTest.java,23,12,1,9,0,22
 pulsar-master\pulsar-master\pulsar-broker-common\src\main\java\org\apache\pulsar\broker\authorization\AuthorizationProvider.java,0,131,10,105,0,246
 pulsar-master\pulsar-master\pulsar-io\netty\src\main\java\org\apache\pulsar\io\netty\tcp\NettyTCPChannelInitializer.java,16,6,0,1,0,7
 pulsar-master\pulsar-master\pulsar-broker\src\main\java\org\apache\pulsar\broker\admin\impl\NamespacesBase.java,2706,923,181,656,0,1760
 pulsar-master\pulsar-master\pulsar-broker\src\main\java\org\apache\pulsar\broker\admin\impl\TransactionsBase.java,492,177,8,134,0,319
 pulsar-master\pulsar-master\pulsar-client\src\main\java\org\apache\pulsar\client\impl\schema\util\package-info.java,0,0,0,1,0,1
 pulsar-master\pulsar-master\pulsar-client\src\main\java\org\apache\pulsar\client\impl\auth\AuthenticationTls.java,0,48,4,12,0,64
 pulsar-master\pulsar-master\pulsar-io\kinesis\src\main\java\org\apache\pulsar\io\kinesis\fbs\CompressionType.java,0,9,0,1,0,10
 pulsar-master\pulsar-master\pulsar-proxy\src\main\java\org\apache\pulsar\proxy\server\ServiceChannelInitializer.java,137,39,0,22,0,61
 pulsar-master\pulsar-master\pulsar-broker\src\test\java\org\apache\pulsar\broker\transaction\coordinator\TransactionCoordinatorClientTest.java,72,23,4,21,0,48
 pulsar-master\pulsar-master\pulsar-broker\src\main\java\org\apache\pulsar\broker\tools\GenerateDocsCommand.java,0,9,0,2,0,11
 pulsar-master\pulsar-master\pulsar-functions\instance\src\test\java\org\apache\pulsar\functions\source\TopicSchemaTest.java,26,6,1,5,0,12
 pulsar-master\pulsar-master\pulsar-broker-common\src\main\java\org\apache\pulsar\broker\authentication\AuthenticationDataCommand.java,94,45,4,3,0,52
 pulsar-master\pulsar-master\pulsar-broker\src\main\java\org\apache\pulsar\client\impl\RawBatchConverter.java,117,44,1,35,0,80
 pulsar-master\pulsar-master\pulsar-client\src\test\java\org\apache\pulsar\client\impl\BinaryProtoLookupServiceTest.java,87,40,4,17,0,61
 pulsar-master\pulsar-master\pulsar-broker\src\test\java\org\apache\pulsar\broker\resourcegroup\ResourceGroupConfigListenerTest.java,252,121,5,34,0,160
 pulsar-master\pulsar-master\pulsar-functions\instance\src\main\java\org\apache\pulsar\functions\windowing\evictors\TimeEvictionPolicy.java,0,24,2,8,0,34
 pulsar-master\pulsar-master\pulsar-broker-common\src\main\java\org\apache\pulsar\broker\web\plugin\servlet\AdditionalServletMetadata.java,13,0,0,1,0,1
 pulsar-master\pulsar-master\pulsar-io\flume\src\test\java\org\apache\pulsar\io\flume\node\TestPollingZooKeeperConfigurationProvider.java,64,8,1,2,0,11
 pulsar-master\pulsar-master\pulsar-broker\src\test\java\org\apache\pulsar\broker\service\persistent\ReplicatedSubscriptionSnapshotCacheTest.java,82,32,0,13,0,45
 pulsar-master\pulsar-master\managed-ledger\src\test\java\org\apache\bookkeeper\mledger\impl\ManagedLedgerBkTest.java,494,106,8,60,0,174
 pulsar-master\pulsar-master\pulsar-broker\src\main\java\org\apache\pulsar\broker\web\ProcessHandlerFilter.java,33,13,0,5,0,18
 pulsar-master\pulsar-master\pulsar-broker\src\test\java\org\apache\pulsar\broker\admin\AdminApiSchemaValidationEnforced.java,155,44,1,33,0,78
 pulsar-master\pulsar-master\pulsar-functions\worker\src\main\java\org\apache\pulsar\functions\worker\rest\WorkerReadinessResource.java,36,13,0,3,0,16
 pulsar-master\pulsar-master\pulsar-metadata\src\main\java\org\apache\pulsar\metadata\bookkeeper\LongHierarchicalLedgerManager.java,0,41,1,14,0,56
 pulsar-master\pulsar-master\managed-ledger\src\test\java\org\apache\bookkeeper\mledger\impl\ManagedCursorContainerTest.java,663,369,29,111,0,509
 pulsar-master\pulsar-master\pulsar-common\src\main\java\org\apache\pulsar\common\policies\path\package-info.java,0,2,0,1,0,3
 pulsar-master\pulsar-master\pulsar-broker\src\main\java\org\apache\pulsar\broker\BrokerData.java,18,8,0,6,0,14
 pulsar-master\pulsar-master\tests\integration\src\test\java\org\apache\pulsar\tests\integration\containers\StandaloneContainer.java,50,16,0,3,0,19
 pulsar-master\pulsar-master\pulsar-io\kinesis\src\test\java\org\apache\pulsar\io\kinesis\KinesisSinkConfigTests.java,62,11,0,6,0,17
 pulsar-master\pulsar-master\pulsar-common\src\main\java\org\apache\pulsar\common\stats\package-info.java,0,2,0,1,0,3
 pulsar-master\pulsar-master\pulsar-proxy\src\test\java\org\apache\pulsar\proxy\server\AuthedAdminProxyHandlerTest.java,141,39,6,26,0,71
 pulsar-master\pulsar-master\pulsar-common\src\main\java\org\apache\pulsar\common\util\netty\ChannelFutures.java,0,6,1,5,0,12
 pulsar-master\pulsar-master\pulsar-broker\src\main\java\org\apache\pulsar\broker\loadbalance\LoadData.java,45,11,0,4,0,15
 pulsar-master\pulsar-master\tests\integration\src\test\java\org\apache\pulsar\tests\integration\suites\PulsarSQLTestSuite.java,74,20,0,5,0,25
 pulsar-master\pulsar-master\pulsar-broker\src\test\java\org\apache\pulsar\io\PulsarFunctionTlsTest.java,224,98,8,44,0,150
 pulsar-master\pulsar-master\pulsar-functions\instance\src\test\java\org\apache\pulsar\functions\windowing\WindowFunctionExecutorTest.java,186,89,1,31,0,121
 pulsar-master\pulsar-master\pulsar-broker-common\src\main\java\org\apache\pulsar\broker\BaseGenerateDocumentation.java,93,24,2,8,0,34
 pulsar-master\pulsar-master\pulsar-functions\worker\src\main\java\org\apache\pulsar\functions\worker\service\api\Component.java,0,46,0,23,0,69
 pulsar-master\pulsar-master\pulsar-client\src\test\java\org\apache\pulsar\client\api\MultiplierRedeliveryBackoffTest.java,49,18,0,1,0,19
 pulsar-master\pulsar-master\pulsar-io\file\src\main\java\org\apache\pulsar\io\file\ProcessedFileThread.java,39,14,0,5,0,19
 pulsar-master\pulsar-master\pulsar-broker\src\test\java\org\apache\pulsar\broker\service\AdvertisedAddressTest.java,49,30,1,9,0,40
 pulsar-master\pulsar-master\pulsar-broker\src\test\java\org\apache\pulsar\broker\lookup\http\v2\TopicLookupTest.java,44,18,0,5,0,23
 pulsar-master\pulsar-master\pulsar-broker\src\main\java\org\apache\pulsar\broker\admin\v2\ResourceQuotas.java,73,42,14,11,0,67
 pulsar-master\pulsar-master\pulsar-broker\src\test\java\org\apache\pulsar\client\api\PulsarMultiListenersWithInternalListenerNameTest.java,145,49,1,25,0,75
 pulsar-master\pulsar-master\pulsar-metadata\src\main\java\org\apache\pulsar\metadata\api\MetadataStoreFactory.java,18,7,0,4,0,11
 pulsar-master\pulsar-master\testmocks\src\main\java\org\apache\bookkeeper\client\PulsarMockLedgerHandle.java,221,89,6,31,2,128
 pulsar-master\pulsar-master\pulsar-broker-common\src\main\java\org\apache\pulsar\zookeeper\package-info.java,0,1,0,1,0,2
 pulsar-master\pulsar-master\pulsar-broker\src\test\java\org\apache\pulsar\common\naming\SpecifiedPositionsBundleSplitAlgorithmTest.java,61,25,2,11,0,38
 pulsar-master\pulsar-master\pulsar-io\hdfs2\src\main\java\org\apache\pulsar\io\hdfs2\HdfsResources.java,25,14,0,2,0,16
 pulsar-master\pulsar-master\pulsar-client-api\src\main\java\org\apache\pulsar\client\api\ConsumerInterceptor.java,0,11,1,11,0,23
 pulsar-master\pulsar-master\pulsar-common\src\main\java\org\apache\pulsar\common\allocator\package-info.java,0,2,0,1,0,3
 pulsar-master\pulsar-master\pulsar-broker\src\main\java\org\apache\pulsar\broker\service\AbstractBaseDispatcher.java,271,113,2,50,0,165
 pulsar-master\pulsar-master\pulsar-common\src\main\java\org\apache\pulsar\common\policies\impl\NamespaceIsolationPolicyImpl.java,137,52,0,15,0,67
 pulsar-master\pulsar-master\tests\integration\src\test\java\org\apache\pulsar\tests\integration\containers\CassandraContainer.java,0,9,1,2,0,12
 pulsar-master\pulsar-master\pulsar-functions\instance\src\main\java\org\apache\pulsar\functions\sink\PulsarSinkConfig.java,11,8,0,1,0,9
 pulsar-master\pulsar-master\pulsar-testclient\src\main\java\org\apache\pulsar\testclient\PerformanceConsumer.java,600,269,19,118,0,406
 pulsar-master\pulsar-master\pulsar-client\src\main\java\org\apache\pulsar\client\impl\schema\generic\VersionedGenericRecord.java,23,8,0,1,0,9
 pulsar-master\pulsar-master\pulsar-proxy\src\main\java\org\apache\pulsar\proxy\extensions\ProxyExtensionMetadata.java,0,0,0,1,0,1
 pulsar-master\pulsar-master\pulsar-common\src\main\java\org\apache\pulsar\common\api\raw\RawMessageIdImpl.java,20,7,0,1,0,8
 pulsar-master\pulsar-master\pulsar-broker\src\main\java\org\apache\pulsar\client\api\package-info.java,0,0,0,1,0,1
 pulsar-master\pulsar-master\pulsar-transaction\coordinator\src\main\java\org\apache\pulsar\transaction\coordinator\TransactionMetadataStoreProvider.java,0,8,0,9,0,17
 pulsar-master\pulsar-master\pulsar-client-admin-api\src\main\java\org\apache\pulsar\policies\data\loadbalancer\LoadManagerReport.java,0,19,0,2,0,21
 pulsar-master\pulsar-master\pulsar-client\src\main\java\org\apache\pulsar\client\impl\schema\generic\GenericProtobufNativeWriter.java,7,4,0,3,0,7
 pulsar-master\pulsar-master\pulsar-broker\src\test\java\org\apache\pulsar\broker\service\persistent\PersistentDispatcherFailoverConsumerStreamingDispatcherTest.java,9,5,0,3,0,8
 pulsar-master\pulsar-master\pulsar-broker\src\test\java\org\apache\pulsar\client\impl\SequenceIdWithErrorTest.java,49,14,1,12,0,27
 pulsar-master\pulsar-master\pulsar-functions\java-examples\src\main\java\org\apache\pulsar\functions\api\examples\window\UserMetricWindowFunction.java,0,5,0,3,0,8
 pulsar-master\pulsar-master\pulsar-broker\src\test\java\org\apache\pulsar\broker\service\PeerReplicatorTest.java,202,49,3,35,0,87
 pulsar-master\pulsar-master\pulsar-io\jdbc\core\src\main\java\org\apache\pulsar\io\jdbc\JdbcSinkConfig.java,66,17,0,4,0,21
 pulsar-master\pulsar-master\pulsar-client\src\test\java\org\apache\pulsar\client\impl\ClientBuilderImplTest.java,60,17,2,8,0,27
 pulsar-master\pulsar-master\pulsar-io\rabbitmq\src\main\java\org\apache\pulsar\io\rabbitmq\RabbitMQSource.java,67,34,4,15,0,53
 pulsar-master\pulsar-master\pulsar-client-1x-base\pulsar-client-1x\src\main\java\org\apache\pulsar\client\api\package-info.java,0,1,0,1,0,2
 pulsar-master\pulsar-master\pulsar-transaction\coordinator\src\test\java\org\apache\pulsar\transaction\coordinator\TxnStatusTest.java,88,8,0,4,0,12
 pulsar-master\pulsar-master\pulsar-client-admin-api\src\main\java\org\apache\pulsar\packages\management\core\common\PackageMetadata.java,8,10,0,1,0,11
 pulsar-master\pulsar-master\pulsar-broker\src\test\java\org\apache\pulsar\broker\service\GracefulExecutorServicesShutdownTest.java,134,26,0,19,0,45
 pulsar-master\pulsar-master\pulsar-common\src\main\java\org\apache\pulsar\common\protocol\Markers.java,232,96,0,42,0,138
 pulsar-master\pulsar-master\tests\integration\src\test\java\org\apache\pulsar\tests\integration\offload\TestBaseOffload.java,262,79,0,40,0,119
 pulsar-master\pulsar-master\managed-ledger\src\test\java\org\apache\bookkeeper\mledger\offload\OffloadersCacheTest.java,25,8,0,7,0,15
 pulsar-master\pulsar-master\pulsar-io\elastic-search\src\test\java\org\apache\pulsar\io\elasticsearch\ElasticSearchSinkTests.java,0,88,0,30,0,118
 pulsar-master\pulsar-master\pulsar-broker\src\test\java\org\apache\pulsar\client\api\ConsumerRedeliveryTest.java,257,52,0,21,0,73
 pulsar-master\pulsar-master\pulsar-client-admin-api\src\main\java\org\apache\pulsar\client\admin\Functions.java,0,107,0,63,0,170
 pulsar-master\pulsar-master\pulsar-broker\src\main\java\org\apache\pulsar\broker\lookup\package-info.java,0,0,0,1,0,1
 pulsar-master\pulsar-master\pulsar-client-api\src\main\java\org\apache\pulsar\client\api\BatchReceivePolicy.java,105,49,1,15,0,65
 pulsar-master\pulsar-master\pulsar-broker\src\main\java\org\apache\pulsar\broker\transaction\pendingack\TransactionPendingAckStoreProvider.java,0,5,0,5,0,10
 pulsar-master\pulsar-master\pulsar-client\src\main\java\org\apache\pulsar\client\impl\MessagePayloadUtils.java,11,2,1,1,0,4
 pulsar-master\pulsar-master\pulsar-common\src\main\java\org\apache\pulsar\common\util\keystoretls\NettySSLContextAutoRefreshBuilder.java,114,69,3,14,0,86
 pulsar-master\pulsar-master\pulsar-broker\src\main\java\org\apache\pulsar\broker\lookup\RedirectData.java,12,6,0,1,0,7
 pulsar-master\pulsar-master\pulsar-io\flume\src\test\java\org\apache\pulsar\io\flume\node\TestStaticZooKeeperConfigurationProvider.java,22,4,0,1,0,5
 pulsar-master\pulsar-master\pulsar-client-auth-sasl\src\main\java\org\apache\pulsar\client\impl\auth\PulsarSaslClient.java,111,34,5,21,0,60
 pulsar-master\pulsar-master\pulsar-client-admin-api\src\main\java\org\apache\pulsar\client\admin\BrokerStats.java,0,20,0,9,0,29
 pulsar-master\pulsar-master\pulsar-broker\src\main\java\org\apache\pulsar\broker\loadbalance\LoadReportUpdaterTask.java,18,7,0,3,0,10
 pulsar-master\pulsar-master\tests\integration\src\test\java\org\apache\pulsar\tests\integration\io\sources\SourceTester.java,149,73,8,14,0,95
 pulsar-master\pulsar-master\tiered-storage\file-system\src\test\java\org\apache\bookkeeper\mledger\offload\filesystem\impl\FileSystemManagedLedgerOffloaderTest.java,95,42,1,15,0,58
 pulsar-master\pulsar-master\pulsar-broker-common\src\main\java\org\apache\pulsar\common\configuration\PropertyContext.java,0,0,0,1,0,1
 pulsar-master\pulsar-master\pulsar-broker\src\main\java\org\apache\pulsar\broker\stats\prometheus\PrometheusMetricsGenerator.java,0,69,2,42,0,113
 pulsar-master\pulsar-master\pulsar-broker\src\main\java\org\apache\pulsar\broker\service\ConsistentHashingStickyKeyConsumerSelector.java,107,20,0,9,0,29
 pulsar-master\pulsar-master\pulsar-client-1x-base\pulsar-client-1x\src\main\java\org\apache\pulsar\client\impl\v1\PulsarClientV1Impl.java,133,50,3,19,0,72
 pulsar-master\pulsar-master\pulsar-broker\src\main\java\org\apache\pulsar\broker\admin\v1\Brokers.java,3,1,0,2,0,3
 pulsar-master\pulsar-master\pulsar-broker\src\main\java\org\apache\pulsar\broker\transaction\pendingack\impl\package-info.java,0,1,0,1,0,2
 pulsar-master\pulsar-master\pulsar-functions\instance\src\main\java\org\apache\pulsar\functions\instance\state\DefaultStateStore.java,0,1,0,2,0,3
 pulsar-master\pulsar-master\pulsar-functions\instance\src\main\java\org\apache\pulsar\functions\windowing\TriggerHandler.java,0,2,0,3,0,5
 pulsar-master\pulsar-master\pulsar-broker\src\main\java\org\apache\pulsar\broker\systopic\TopicPoliciesSystemTopicClient.java,168,44,6,16,0,66
 pulsar-master\pulsar-master\pulsar-functions\java-examples\src\main\java\org\apache\pulsar\functions\api\examples\TypedMessageBuilderPublish.java,0,7,0,5,0,12
 pulsar-master\pulsar-master\pulsar-metadata\src\main\java\org\apache\pulsar\metadata\impl\batching\AbstractBatchedMetadataStore.java,124,32,1,9,0,42
 pulsar-master\pulsar-master\pulsar-broker\src\main\java\org\apache\pulsar\broker\service\InMemoryRedeliveryTracker.java,51,22,0,9,0,31
 pulsar-master\pulsar-master\pulsar-common\src\main\java\org\apache\pulsar\common\tls\PublicSuffixList.java,0,19,0,6,0,25
 pulsar-master\pulsar-master\pulsar-metadata\src\test\java\org\apache\pulsar\metadata\bookkeeper\PulsarLayoutManagerTest.java,85,12,4,3,0,19
 pulsar-master\pulsar-master\pulsar-client\src\main\java\org\apache\pulsar\client\impl\schema\util\SchemaUtil.java,67,25,2,13,0,40
 pulsar-master\pulsar-master\pulsar-client-tools\src\main\java\org\apache\pulsar\admin\cli\CmdTopicPolicies.java,1694,656,75,423,0,1154
 pulsar-master\pulsar-master\tests\integration\src\test\java\org\apache\pulsar\tests\integration\functions\utils\CommandGenerator.java,336,92,5,28,0,125
 pulsar-master\pulsar-master\tiered-storage\jcloud\src\main\java\org\apache\bookkeeper\mledger\offload\jcloud\OffloadIndexBlockV2.java,0,10,0,3,0,13
 pulsar-master\pulsar-master\pulsar-client\src\main\java\org\apache\pulsar\client\impl\TableViewBuilderImpl.java,48,17,0,2,0,19
 pulsar-master\pulsar-master\pulsar-io\common\src\main\java\org\apache\pulsar\io\common\package-info.java,0,1,0,1,0,2
 pulsar-master\pulsar-master\pulsar-proxy\src\main\java\org\apache\pulsar\proxy\stats\TopicStats.java,26,15,1,1,0,17
 pulsar-master\pulsar-master\tests\integration\src\test\java\org\apache\pulsar\tests\integration\backwardscompatibility\ClientTest2_2.java,12,9,1,4,0,14
 pulsar-master\pulsar-master\pulsar-broker\src\main\java\org\apache\pulsar\broker\admin\v2\WorkerStats.java,39,12,1,3,0,16
 pulsar-master\pulsar-master\pulsar-broker\src\main\java\org\apache\pulsar\broker\service\Subscription.java,0,46,0,9,0,55
 pulsar-master\pulsar-master\pulsar-io\hdfs2\src\main\java\org\apache\pulsar\io\hdfs2\Compression.java,0,5,0,1,0,6
 pulsar-master\pulsar-master\pulsar-client\src\main\java\org\apache\pulsar\client\impl\ProducerBuilderImpl.java,317,134,6,39,0,179
 pulsar-master\pulsar-master\pulsar-client\src\test\java\org\apache\pulsar\client\impl\TypedMessageBuilderImplTest.java,188,79,2,60,0,141
 pulsar-master\pulsar-master\pulsar-metadata\src\main\java\org\apache\pulsar\metadata\api\MetadataStoreException.java,169,51,0,5,0,56
 pulsar-master\pulsar-master\pulsar-broker\src\main\java\org\apache\pulsar\broker\rest\RestMessagePublishContext.java,0,24,1,8,0,33
 pulsar-master\pulsar-master\pulsar-client-admin\src\main\java\org\apache\pulsar\client\admin\internal\FunctionsImpl.java,776,456,3,183,0,642
 pulsar-master\pulsar-master\tiered-storage\file-system\src\main\java\org\apache\bookkeeper\mledger\offload\filesystem\impl\FileSystemManagedLedgerOffloader.java,327,138,6,44,0,188
 pulsar-master\pulsar-master\pulsar-common\src\main\java\io\airlift\compress\zstd\ZStdRawDecompressor.java,4,0,0,1,0,1
 pulsar-master\pulsar-master\tiered-storage\jcloud\src\main\java\org\apache\bookkeeper\mledger\offload\jcloud\impl\OffloadIndexBlockV2BuilderImpl.java,0,50,2,18,0,70
 pulsar-master\pulsar-master\pulsar-client\src\main\java\org\apache\pulsar\client\impl\ProducerBase.java,151,68,1,10,0,79
 pulsar-master\pulsar-master\pulsar-broker\src\test\java\org\apache\pulsar\broker\service\ReplicatorTopicPoliciesTest.java,719,257,2,175,0,434
 pulsar-master\pulsar-master\pulsar-io\elastic-search\src\main\java\org\apache\pulsar\io\elasticsearch\ElasticSearchConnectionException.java,14,7,0,1,0,8
 pulsar-master\pulsar-master\pulsar-testclient\src\main\java\org\apache\pulsar\testclient\DefaultMessageFormatter.java,89,13,2,2,0,17
 pulsar-master\pulsar-master\pulsar-client\src\main\java\org\apache\pulsar\client\impl\schema\generic\package-info.java,0,0,0,1,0,1
 pulsar-master\pulsar-master\pulsar-broker-common\src\main\java\org\apache\pulsar\broker\resources\TenantResources.java,143,76,2,33,0,111
 pulsar-master\pulsar-master\tests\integration\src\test\java\org\apache\pulsar\tests\integration\functions\java\PulsarWorkerRebalanceDrainTest.java,347,101,15,68,0,184
 pulsar-master\pulsar-master\pulsar-common\src\test\java\org\apache\pulsar\common\util\FileModifiedTimeUpdaterTest.java,86,43,1,11,0,55
 pulsar-master\pulsar-master\pulsar-transaction\coordinator\src\main\java\org\apache\pulsar\transaction\coordinator\util\TransactionUtil.java,28,6,1,6,0,13
 pulsar-master\pulsar-master\pulsar-common\src\main\java\org\apache\pulsar\common\util\collections\TripleLongPriorityQueue.java,204,33,1,7,0,41
 pulsar-master\pulsar-master\testmocks\src\main\java\org\apache\bookkeeper\client\BookKeeperTestClient.java,24,9,1,3,0,13
 pulsar-master\pulsar-master\pulsar-package-management\core\src\main\java\org\apache\pulsar\packages\management\core\PackagesStorageConfiguration.java,0,1,0,2,0,3
 pulsar-master\pulsar-master\pulsar-functions\utils\src\test\java\org\apache\pulsar\functions\utils\ActionsTest.java,179,41,1,17,0,59
 pulsar-master\pulsar-master\pulsar-broker\src\test\java\org\apache\pulsar\broker\namespace\NamespaceCreateBundlesTest.java,49,13,0,6,0,19
 pulsar-master\pulsar-master\pulsar-client-admin-api\src\main\java\org\apache\pulsar\common\protocol\schema\package-info.java,0,2,0,1,0,3
 pulsar-master\pulsar-master\pulsar-client\src\main\java\org\apache\pulsar\client\impl\LookupService.java,0,15,0,9,0,24
 pulsar-master\pulsar-master\pulsar-websocket\src\test\java\org\apache\pulsar\websocket\ProducerHandlerTest.java,50,16,0,10,0,26
 pulsar-master\pulsar-master\pulsar-broker\src\test\java\org\apache\pulsar\broker\admin\AdminApiDelayedDelivery.java,149,46,2,25,0,73
 pulsar-master\pulsar-master\pulsar-client-tools-test\src\test\java\org\apache\pulsar\admin\cli\PulsarAdminToolTest.java,2020,965,35,757,0,1757
 pulsar-master\pulsar-master\pulsar-common\src\main\java\org\apache\pulsar\client\impl\schema\SchemaUtils.java,0,85,0,43,0,128
 pulsar-master\pulsar-master\pulsar-broker\src\test\java\org\apache\pulsar\broker\service\schema\BaseAvroSchemaCompatibilityTest.java,0,131,0,69,0,200
 pulsar-master\pulsar-master\pulsar-functions\instance\src\test\java\org\apache\pulsar\functions\instance\FunctionResultRouterTest.java,93,30,2,9,0,41
 pulsar-master\pulsar-master\managed-ledger\src\main\java\org\apache\bookkeeper\mledger\util\package-info.java,0,1,0,1,0,2
 pulsar-master\pulsar-master\pulsar-client\src\main\java\org\apache\pulsar\client\impl\TableViewConfigurationData.java,0,5,1,2,0,8
 pulsar-master\pulsar-master\pulsar-broker\src\test\java\org\apache\pulsar\broker\service\PersistentMessageFinderTest.java,404,137,2,77,0,216
 pulsar-master\pulsar-master\pulsar-broker\src\main\java\org\apache\pulsar\broker\transaction\buffer\TransactionBufferProvider.java,0,2,0,2,0,4
 pulsar-master\pulsar-master\pulsar-broker\src\main\java\org\apache\pulsar\broker\web\package-info.java,0,0,0,1,0,1
 pulsar-master\pulsar-master\pulsar-common\src\main\java\org\apache\pulsar\common\protocol\schema\SchemaHash.java,32,17,1,3,0,21
 pulsar-master\pulsar-master\pulsar-broker-common\src\main\java\org\apache\pulsar\broker\web\plugin\servlet\package-info.java,0,2,0,1,0,3
 pulsar-master\pulsar-master\pulsar-proxy\src\test\java\org\apache\pulsar\proxy\extensions\ProxyExtensionsTest.java,110,34,9,6,0,49
 pulsar-master\pulsar-master\pulsar-broker-common\src\main\java\org\apache\pulsar\broker\authentication\utils\package-info.java,0,1,0,1,0,2
 pulsar-master\pulsar-master\pulsar-common\src\test\java\org\apache\pulsar\common\policies\data\PolicyHierarchyValueTest.java,22,5,0,1,0,6
 pulsar-master\pulsar-master\pulsar-broker\src\test\java\org\apache\pulsar\client\api\ExposeMessageRedeliveryCountTest.java,0,22,1,8,0,31
 pulsar-master\pulsar-master\pulsar-io\influxdb\src\main\java\org\apache\pulsar\io\influxdb\v2\InfluxDBSink.java,0,28,1,14,0,43
 pulsar-master\pulsar-master\pulsar-broker\src\main\java\org\apache\pulsar\broker\admin\v2\PersistentTopics.java,0,2451,373,943,0,3767
 pulsar-master\pulsar-master\pulsar-common\src\main\java\org\apache\pulsar\common\util\RateLimiter.java,235,76,2,34,0,112
 pulsar-master\pulsar-master\pulsar-metadata\src\test\java\org\apache\pulsar\metadata\LockManagerTest.java,251,76,2,56,0,134
 pulsar-master\pulsar-master\pulsar-broker\src\main\java\org\apache\pulsar\broker\transaction\buffer\impl\TransactionBufferHandlerImpl.java,310,123,6,50,0,179
 pulsar-master\pulsar-master\pulsar-io\kafka-connect-adaptor\src\test\java\org\apache\pulsar\io\kafka\connect\KafkaConnectSourceTest.java,103,22,4,10,0,36
 pulsar-master\pulsar-master\pulsar-client\src\main\java\org\apache\pulsar\client\impl\ProducerImpl.java,0,691,48,361,0,1100
 pulsar-master\pulsar-master\pulsar-broker\src\main\java\org\apache\pulsar\broker\stats\prometheus\AggregatedNamespaceStats.java,134,78,0,19,0,97
 pulsar-master\pulsar-master\pulsar-config-validation\src\test\java\org\apache\pulsar\config\validation\ConfigValidationTest.java,113,43,4,13,0,60
 pulsar-master\pulsar-master\pulsar-functions\instance\src\main\java\org\apache\pulsar\functions\source\SingleConsumerPulsarSourceConfig.java,11,6,0,3,0,9
 pulsar-master\pulsar-master\pulsar-common\src\main\java\org\apache\pulsar\common\util\RelativeTimeUtil.java,51,9,1,2,0,12
 pulsar-master\pulsar-master\pulsar-io\elastic-search\src\test\java\org\apache\pulsar\io\elasticsearch\ElasticSearchBWCTests.java,29,5,0,4,0,9
 pulsar-master\pulsar-master\buildtools\src\main\java\org\apache\pulsar\tests\MockitoCleanupListener.java,15,14,0,10,0,24
 pulsar-master\pulsar-master\pulsar-broker\src\test\java\org\apache\pulsar\client\api\AuthenticationTlsHostnameVerificationTest.java,208,77,12,41,0,130
 pulsar-master\pulsar-master\tiered-storage\jcloud\src\test\java\org\apache\bookkeeper\mledger\offload\jcloud\provider\JCloudBlobStoreProviderTests.java,80,46,2,14,0,62
 pulsar-master\pulsar-master\pulsar-proxy\src\test\java\org\apache\pulsar\proxy\server\ProxyKeyStoreTlsTestWithAuth.java,152,66,11,23,0,100
 pulsar-master\pulsar-master\pulsar-broker-auth-sasl\src\main\java\org\apache\pulsar\broker\authentication\package-info.java,0,0,0,1,0,1
 pulsar-master\pulsar-master\pulsar-broker\src\test\java\org\apache\pulsar\client\impl\MultiTopicsReaderTest.java,612,142,24,64,0,230
 pulsar-master\pulsar-master\pulsar-client-api\src\main\java\org\apache\pulsar\client\api\transaction\package-info.java,0,2,0,1,0,3
 pulsar-master\pulsar-master\pulsar-io\elastic-search\src\main\java\org\apache\pulsar\io\elasticsearch\client\RestClient.java,150,58,2,26,0,86
 pulsar-master\pulsar-master\pulsar-broker\src\test\java\org\apache\pulsar\client\impl\RawMessageSerDeserTest.java,31,16,0,8,0,24
 pulsar-master\pulsar-master\pulsar-broker\src\main\java\org\apache\pulsar\broker\service\schema\validator\SchemaRegistryServiceWithSchemaDataValidator.java,110,54,1,22,0,77
 pulsar-master\pulsar-master\pulsar-client-admin\src\test\java\org\apache\pulsar\client\admin\internal\SinksImplTest.java,177,31,0,24,0,55
 pulsar-master\pulsar-master\pulsar-broker-common\src\main\java\org\apache\pulsar\broker\authorization\AuthorizationService.java,560,336,11,154,0,501
 pulsar-master\pulsar-master\pulsar-client-tools\src\main\java\org\apache\pulsar\admin\cli\CmdResourceGroups.java,120,23,0,10,0,33
 pulsar-master\pulsar-master\pulsar-broker\src\test\java\org\apache\pulsar\compaction\CompactorTest.java,197,37,0,20,0,57
 pulsar-master\pulsar-master\pulsar-client\src\main\java\org\apache\pulsar\client\impl\AbstractBatchMessageContainer.java,84,52,5,16,0,73
 pulsar-master\pulsar-master\pulsar-metadata\src\test\java\org\apache\pulsar\metadata\BacklogQuotaCompatibilityTest.java,0,57,7,38,0,102
 pulsar-master\pulsar-master\pulsar-common\src\test\java\org\apache\pulsar\common\naming\MetadataTests.java,59,31,0,2,0,33
 pulsar-master\pulsar-master\pulsar-package-management\core\src\main\java\org\apache\pulsar\packages\management\core\PackagesStorage.java,0,6,0,1,0,7
 pulsar-master\pulsar-master\pulsar-client\src\test\java\org\apache\pulsar\client\tutorial\JsonPojo.java,19,12,1,1,0,14
 pulsar-master\pulsar-master\pulsar-functions\utils\src\main\java\org\apache\pulsar\functions\utils\FunctionInstanceId.java,30,10,0,4,0,14
 pulsar-master\pulsar-master\tests\integration\src\test\java\org\apache\pulsar\tests\integration\schema\SchemaTest.java,0,32,1,10,0,43
 pulsar-master\pulsar-master\pulsar-common\src\main\java\org\apache\pulsar\common\protocol\schema\SchemaData.java,39,8,0,1,0,9
 pulsar-master\pulsar-master\pulsar-broker\src\main\java\org\apache\pulsar\broker\web\RestException.java,57,19,0,3,0,22
 pulsar-master\pulsar-master\pulsar-broker\src\main\java\org\apache\pulsar\broker\loadbalance\LoadSheddingStrategy.java,0,3,0,4,0,7
 pulsar-master\pulsar-master\pulsar-broker\src\main\java\org\apache\pulsar\broker\service\EntryWrapper.java,44,17,1,2,0,20
 pulsar-master\pulsar-master\pulsar-client\src\main\java\org\apache\pulsar\client\impl\schema\LongSchema.java,84,30,1,3,0,34
 pulsar-master\pulsar-master\pulsar-client-admin-api\src\main\java\org\apache\pulsar\common\policies\data\OffloadPolicies.java,0,80,0,23,0,103
 pulsar-master\pulsar-master\pulsar-functions\worker\src\main\java\org\apache\pulsar\functions\worker\service\WorkerServiceWithClassLoader.java,77,26,0,4,0,30
 pulsar-master\pulsar-master\pulsar-broker\src\test\java\org\apache\pulsar\client\impl\NegativeAcksTest.java,215,189,2,11,0,202
 pulsar-master\pulsar-master\pulsar-client-1x-base\pulsar-client-1x\src\main\java\org\apache\pulsar\client\impl\v1\package-info.java,0,1,0,1,0,2
 pulsar-master\pulsar-master\pulsar-package-management\core\src\test\java\org\apache\pulsar\packages\management\core\impl\PackagesManagementImplTest.java,158,27,0,22,0,49
 pulsar-master\pulsar-master\pulsar-client\src\test\java\org\apache\pulsar\client\api\MessageIdTest.java,18,8,0,1,0,9
 pulsar-master\pulsar-master\tiered-storage\jcloud\src\main\java\org\apache\bookkeeper\mledger\offload\jcloud\DataBlockHeader.java,0,5,0,2,0,7
 pulsar-master\pulsar-master\pulsar-broker\src\main\java\org\apache\pulsar\broker\namespace\ServiceUnitUtils.java,0,19,3,7,0,29
 pulsar-master\pulsar-master\managed-ledger\src\main\java\org\apache\bookkeeper\mledger\util\SafeRun.java,32,7,2,2,0,11
 pulsar-master\pulsar-master\pulsar-functions\api-java\src\main\java\org\apache\pulsar\functions\api\Context.java,0,13,0,11,0,24
 pulsar-master\pulsar-master\pulsar-broker-auth-sasl\src\test\java\org\apache\pulsar\broker\authentication\MiniKdc.java,278,54,7,14,0,75
 pulsar-master\pulsar-master\pulsar-functions\worker\src\test\java\org\apache\pulsar\functions\worker\rest\api\v3\SourceApiV3ResourceTest.java,1473,363,14,203,0,580
 pulsar-master\pulsar-master\managed-ledger\src\test\java\org\apache\bookkeeper\mledger\impl\ManagedCursorTest.java,3652,895,87,343,0,1325
 pulsar-master\pulsar-master\tests\integration\src\test\java\org\apache\pulsar\tests\integration\cli\tenant\TenantTest.java,88,36,0,29,0,65
 pulsar-master\pulsar-master\pulsar-io\flume\src\main\java\org\apache\pulsar\io\flume\source\SinkOfFlume.java,0,14,3,6,0,23
 pulsar-master\pulsar-master\pulsar-functions\utils\src\main\java\org\apache\pulsar\functions\utils\CryptoUtils.java,0,41,2,25,0,68
 pulsar-master\pulsar-master\pulsar-client\src\main\java\org\apache\pulsar\client\impl\PatternMultiTopicsConsumerImpl.java,177,77,7,37,0,121
 pulsar-master\pulsar-master\pulsar-testclient\src\main\java\org\apache\pulsar\proxy\socket\client\PerformanceClient.java,413,183,26,80,0,289
 pulsar-master\pulsar-master\pulsar-client-admin-api\src\main\java\org\apache\pulsar\common\functions\Resources.java,29,12,0,4,0,16
 pulsar-master\pulsar-master\pulsar-client-tools-test\src\test\java\org\apache\pulsar\admin\cli\CmdFunctionsTest.java,843,170,13,70,0,253
 pulsar-master\pulsar-master\pulsar-broker\src\main\java\org\apache\pulsar\broker\stats\prometheus\metrics\PrometheusTextFormatUtil.java,139,79,1,36,0,116
 pulsar-master\pulsar-master\pulsar-package-management\filesystem-storage\src\main\java\org\apache\pulsar\packages\management\storage\filesystem\FileSystemPackagesStorage.java,107,26,0,7,0,33
 pulsar-master\pulsar-master\pulsar-io\hdfs2\src\test\java\org\apache\pulsar\io\hdfs2\sink\text\HdfsStringSinkTests.java,0,28,1,1,0,30
 pulsar-master\pulsar-master\pulsar-broker-common\src\main\java\org\apache\pulsar\broker\web\plugin\servlet\AdditionalServlets.java,88,33,2,22,0,57
 pulsar-master\pulsar-master\pulsar-broker\src\main\java\org\apache\pulsar\broker\admin\v3\Sinks.java,3,0,0,1,0,1
 pulsar-master\pulsar-master\pulsar-broker\src\test\java\org\apache\pulsar\broker\service\ReplicatorTlsTest.java,33,8,0,4,0,12
 pulsar-master\pulsar-master\pulsar-proxy\src\main\java\org\apache\pulsar\proxy\util\package-info.java,0,1,0,1,0,2
 pulsar-master\pulsar-master\pulsar-client-tools\src\main\java\org\apache\pulsar\admin\cli\CmdGenerateDocument.java,96,21,3,13,0,37
 pulsar-master\pulsar-master\pulsar-broker-common\src\main\java\org\apache\pulsar\broker\authentication\package-info.java,0,1,0,1,0,2
 pulsar-master\pulsar-master\pulsar-io\netty\src\main\java\org\apache\pulsar\io\netty\server\package-info.java,0,1,0,1,0,2
 pulsar-master\pulsar-master\pulsar-client-admin-api\src\main\java\org\apache\pulsar\common\policies\data\ExceptionInformation.java,5,4,0,1,0,5
 pulsar-master\pulsar-master\pulsar-functions\runtime\src\main\java\org\apache\pulsar\functions\auth\FunctionAuthUtils.java,0,5,1,3,0,9
 pulsar-master\pulsar-master\pulsar-broker\src\main\java\org\apache\pulsar\utils\CmdGenerateDocumentation.java,23,6,0,3,0,9
 pulsar-master\pulsar-master\pulsar-websocket\src\main\java\org\apache\pulsar\websocket\admin\v1\package-info.java,0,0,0,1,0,1
 pulsar-master\pulsar-master\tests\integration\src\test\java\org\apache\pulsar\tests\integration\containers\PulsarContainer.java,0,98,4,19,0,121
 pulsar-master\pulsar-master\pulsar-functions\instance\src\main\java\org\apache\pulsar\functions\source\PulsarRecord.java,89,22,0,2,0,24
 pulsar-master\pulsar-master\pulsar-io\twitter\src\main\java\org\apache\pulsar\io\twitter\data\TwitterRecord.java,38,15,1,2,0,18
 pulsar-master\pulsar-master\pulsar-common\src\test\java\org\apache\pulsar\common\nar\NarUnpackerTest.java,121,28,2,7,0,37
 pulsar-master\pulsar-master\pulsar-client-admin-api\src\main\java\org\apache\pulsar\common\functions\package-info.java,0,2,0,1,0,3
 pulsar-master\pulsar-master\pulsar-common\src\main\java\org\apache\pulsar\common\intercept\AppendIndexMetadataInterceptor.java,31,15,0,3,0,18
 pulsar-master\pulsar-master\pulsar-common\src\main\java\org\apache\pulsar\client\admin\internal\data\AuthPoliciesImpl.java,0,33,1,13,0,47
 pulsar-master\pulsar-master\pulsar-client\src\test\java\org\apache\pulsar\client\impl\conf\ConfigurationDataUtilsTest.java,194,57,3,21,0,81
 pulsar-master\pulsar-master\pulsar-io\elastic-search\src\main\java\org\apache\pulsar\io\elasticsearch\ElasticSearchSslConfig.java,69,9,0,1,0,10
 pulsar-master\pulsar-master\pulsar-broker\src\main\java\org\apache\pulsar\broker\service\schema\AlwaysSchemaValidator.java,0,3,1,1,0,5
 pulsar-master\pulsar-master\tests\integration\src\test\java\org\apache\pulsar\tests\integration\functions\python\PulsarFunctionsPythonThreadTest.java,7,2,0,1,0,3
 pulsar-master\pulsar-master\pulsar-common\src\main\java\org\apache\pulsar\common\functions\FunctionDefinition.java,20,0,0,1,0,1
 pulsar-master\pulsar-master\pulsar-functions\worker\src\test\java\org\apache\pulsar\functions\worker\FunctionAssignmentTailerTest.java,364,108,2,79,0,189
 pulsar-master\pulsar-master\pulsar-metadata\src\main\java\org\apache\pulsar\metadata\impl\PulsarZooKeeperClient.java,0,417,7,149,0,573
 pulsar-master\pulsar-master\managed-ledger\src\main\java\org\apache\bookkeeper\mledger\Position.java,0,3,0,2,0,5
 pulsar-master\pulsar-master\pulsar-broker\src\test\java\org\apache\pulsar\broker\service\schema\validator\SchemaDataValidatorTest.java,106,44,0,7,0,51
 pulsar-master\pulsar-master\pulsar-client\src\test\java\org\apache\pulsar\client\impl\AcknowledgementsGroupingTrackerTest.java,385,137,3,41,0,181
 pulsar-master\pulsar-master\pulsar-io\data-generator\src\main\java\org\apache\pulsar\io\datagenerator\DataGeneratorSource.java,23,8,1,3,0,12
 pulsar-master\pulsar-master\pulsar-common\src\main\java\org\apache\pulsar\common\policies\data\stats\PublisherStatsImpl.java,130,43,1,7,0,51
 pulsar-master\pulsar-master\pulsar-sql\presto-pulsar\src\main\java\org\apache\pulsar\sql\presto\PulsarRecordSetProvider.java,29,19,0,8,0,27
 pulsar-master\pulsar-master\pulsar-functions\instance\src\main\java\org\apache\pulsar\functions\instance\JavaInstance.java,151,41,2,9,0,52
 pulsar-master\pulsar-master\pulsar-broker\src\test\java\org\apache\pulsar\broker\service\schema\AvroSchemaCompatibilityCheckTest.java,9,4,0,2,0,6
 pulsar-master\pulsar-master\pulsar-broker\src\main\java\org\apache\pulsar\broker\transaction\timeout\TransactionTimeoutTrackerImpl.java,0,43,1,13,0,57
 pulsar-master\pulsar-master\pulsar-io\hdfs2\src\main\java\org\apache\pulsar\io\hdfs2\sink\HdfsAbstractSink.java,0,29,0,10,0,39
 pulsar-master\pulsar-master\pulsar-broker\src\test\java\org\apache\pulsar\broker\service\utils\ClientChannelHelper.java,114,39,2,6,0,47
 pulsar-master\pulsar-master\pulsar-io\kinesis\src\main\java\org\apache\pulsar\io\kinesis\KinesisRecordProcessorFactory.java,16,10,0,4,0,14
 pulsar-master\pulsar-master\pulsar-client\src\main\java\org\apache\pulsar\client\impl\auth\oauth2\ClientCredentialsFlow.java,0,35,2,18,0,55
 pulsar-master\pulsar-master\pulsar-functions\secrets\src\main\java\org\apache\pulsar\functions\secretsproviderconfigurator\SecretsProviderConfigurator.java,0,27,2,12,0,41
 pulsar-master\pulsar-master\pulsar-common\src\main\java\org\apache\pulsar\common\api\raw\ReferenceCountedMessageMetadata.java,45,15,1,4,0,20
 pulsar-master\pulsar-master\pulsar-io\kafka\src\main\java\org\apache\pulsar\io\kafka\KafkaSourceConfig.java,127,47,0,21,0,68
 pulsar-master\pulsar-master\pulsar-functions\instance\src\main\java\org\apache\pulsar\functions\source\SingleConsumerPulsarSource.java,67,32,7,10,0,49
 pulsar-master\pulsar-master\pulsar-common\src\test\java\org\apache\pulsar\common\util\netty\ChannelFuturesTest.java,78,30,5,10,0,45
 pulsar-master\pulsar-master\pulsar-client\src\test\java\org\apache\pulsar\client\impl\BatchMessageIdImplTest.java,108,14,0,6,0,20
 pulsar-master\pulsar-master\pulsar-websocket\src\main\java\org\apache\pulsar\websocket\WebSocketReaderServlet.java,24,11,0,4,0,15
 pulsar-master\pulsar-master\pulsar-client-admin-api\src\main\java\org\apache\pulsar\common\policies\data\FunctionStatus.java,53,37,0,1,0,38
 pulsar-master\pulsar-master\pulsar-io\hdfs2\src\main\java\org\apache\pulsar\io\hdfs2\sink\text\HdfsStringSink.java,0,3,0,2,0,5
 pulsar-master\pulsar-master\buildtools\src\main\java\org\apache\pulsar\tests\ThreadDumpUtil.java,132,31,3,18,0,52
 pulsar-master\pulsar-master\pulsar-io\flume\src\main\java\org\apache\pulsar\io\flume\sink\package-info.java,0,1,0,1,0,2
 pulsar-master\pulsar-master\pulsar-proxy\src\main\java\org\apache\pulsar\proxy\server\BrokerProxyValidator.java,142,48,0,22,0,70
 pulsar-master\pulsar-master\pulsar-client\src\test\java\org\apache\pulsar\client\impl\ConsumerImplTest.java,183,54,5,20,0,79
 pulsar-master\pulsar-master\pulsar-io\kafka-connect-adaptor\src\main\java\org\apache\pulsar\io\kafka\connect\KafkaConnectSink.java,269,68,3,28,0,99
 pulsar-master\pulsar-master\pulsar-client-admin-api\src\main\java\org\apache\pulsar\packages\management\core\common\PackageType.java,0,11,0,3,0,14
 pulsar-master\pulsar-master\pulsar-broker\src\test\java\org\apache\pulsar\compaction\CompactionTest.java,1600,311,136,189,0,636
 pulsar-master\pulsar-master\pulsar-transaction\coordinator\src\main\java\org\apache\pulsar\transaction\coordinator\package-info.java,0,2,0,1,0,3
 pulsar-master\pulsar-master\pulsar-broker\src\test\java\org\apache\pulsar\socks5\auth\PasswordAuth.java,0,1,0,1,0,2
 pulsar-master\pulsar-master\pulsar-io\core\src\main\java\org\apache\pulsar\io\core\KeyValue.java,0,22,0,1,0,23
 pulsar-master\pulsar-master\pulsar-io\hbase\src\main\java\org\apache\pulsar\io\hbase\sink\HbaseSinkConfig.java,54,17,0,6,0,23
 pulsar-master\pulsar-master\pulsar-client\src\main\java\org\apache\pulsar\client\impl\AutoClusterFailover.java,328,144,8,58,0,210
 pulsar-master\pulsar-master\pulsar-client\src\test\java\org\apache\pulsar\client\impl\schema\SupportVersioningAvroSchemaTest.java,36,17,0,10,0,27
 pulsar-master\pulsar-master\pulsar-metadata\src\main\java\org\apache\pulsar\metadata\bookkeeper\package-info.java,0,0,0,1,0,1
 pulsar-master\pulsar-master\pulsar-sql\presto-pulsar\src\main\java\org\apache\pulsar\sql\presto\PulsarConnectorMetricsTracker.java,327,174,20,51,0,245
 pulsar-master\pulsar-master\pulsar-common\src\main\java\org\apache\pulsar\common\partition\package-info.java,0,2,0,1,0,3
 pulsar-master\pulsar-master\pulsar-client-admin-api\src\main\java\org\apache\pulsar\common\protocol\schema\PostSchemaPayload.java,6,3,0,1,0,4
 pulsar-master\pulsar-master\pulsar-io\aws\src\main\java\org\apache\pulsar\io\aws\STSAssumeRoleProviderPlugin.java,35,12,1,6,0,19
 pulsar-master\pulsar-master\pulsar-broker\src\main\java\org\apache\pulsar\broker\package-info.java,0,0,0,1,0,1
 pulsar-master\pulsar-master\pulsar-broker\src\test\java\org\apache\pulsar\common\naming\NamespaceBundlesTest.java,268,96,11,56,0,163
 pulsar-master\pulsar-master\pulsar-io\kafka-connect-adaptor\src\main\java\org\apache\pulsar\io\kafka\connect\PulsarOffsetBackingStore.java,182,35,3,12,0,50
 pulsar-master\pulsar-master\pulsar-broker\src\test\java\org\apache\pulsar\broker\service\BatchMessageWithBatchIndexLevelTest.java,157,34,1,16,0,51
 pulsar-master\pulsar-master\pulsar-broker\src\main\java\org\apache\pulsar\broker\service\TransactionBufferSnapshotService.java,0,4,0,6,0,10
 pulsar-master\pulsar-master\pulsar-broker\src\test\java\org\apache\pulsar\broker\intercept\InterceptFilterOutTest.java,163,42,1,29,0,72
 pulsar-master\pulsar-master\pulsar-metadata\src\test\java\org\apache\pulsar\metadata\MetadataStoreBatchingTest.java,135,45,1,21,0,67
 pulsar-master\pulsar-master\tiered-storage\jcloud\src\main\java\org\apache\bookkeeper\mledger\offload\jcloud\provider\BlobStoreLocation.java,33,22,0,5,0,27
 pulsar-master\pulsar-master\pulsar-client-api\src\main\java\org\apache\pulsar\client\api\ServiceUrlProvider.java,0,4,0,5,0,9
 pulsar-master\pulsar-master\pulsar-io\twitter\src\main\java\org\apache\pulsar\io\twitter\endpoint\SampleStatusesEndpoint.java,15,4,0,2,0,6
 pulsar-master\pulsar-master\pulsar-io\cassandra\src\main\java\org\apache\pulsar\io\cassandra\CassandraStringSink.java,0,5,0,3,0,8
 pulsar-master\pulsar-master\pulsar-broker\src\main\java\org\apache\pulsar\broker\namespace\LookupOptions.java,28,4,0,2,0,6
 pulsar-master\pulsar-master\pulsar-client-admin-api\src\main\java\org\apache\pulsar\common\policies\data\BrokerAssignment.java,0,3,0,1,0,4
 pulsar-master\pulsar-master\pulsar-broker-common\src\main\java\org\apache\pulsar\broker\authentication\AuthenticationDataHttp.java,68,21,0,2,0,23
 pulsar-master\pulsar-master\pulsar-io\influxdb\src\test\java\org\apache\pulsar\io\influxdb\v1\InfluxDBSinkConfigTest.java,115,11,1,4,0,16
 pulsar-master\pulsar-master\tests\bc_2_0_1\src\test\java\org\apache\pulsar\tests\integration\SmokeTest.java,50,6,0,1,0,7
 pulsar-master\pulsar-master\pulsar-broker\src\test\java\org\apache\pulsar\broker\transaction\TransactionTestBase.java,257,99,3,42,0,144
 pulsar-master\pulsar-master\pulsar-broker\src\test\java\org\apache\pulsar\broker\admin\AdminApi2Test.java,2323,707,42,433,0,1182
 pulsar-master\pulsar-master\pulsar-common\src\main\java\org\apache\pulsar\common\util\collections\ConcurrentOpenLongPairRangeSet.java,341,119,9,57,0,185
 pulsar-master\pulsar-master\pulsar-common\src\test\java\org\apache\pulsar\common\util\FieldParserTest.java,68,21,0,1,0,22
 pulsar-master\pulsar-master\pulsar-functions\java-examples\src\main\java\org\apache\pulsar\functions\api\examples\serde\CustomObject.java,4,1,0,1,0,2
 pulsar-master\pulsar-master\pulsar-broker\src\main\java\org\apache\pulsar\broker\namespace\NamespaceService.java,1301,514,34,285,0,833
 pulsar-master\pulsar-master\pulsar-broker\src\main\java\org\apache\pulsar\broker\lookup\LookupResult.java,63,45,0,10,0,55
 pulsar-master\pulsar-master\tiered-storage\jcloud\src\test\java\org\apache\bookkeeper\mledger\offload\jcloud\BlobStoreBackedInputStreamTest.java,243,116,3,28,0,147
 pulsar-master\pulsar-master\pulsar-broker\src\main\java\org\apache\pulsar\broker\service\schema\ProtobufSchemaCompatibilityCheck.java,8,3,0,3,0,6
 pulsar-master\pulsar-master\pulsar-broker\src\main\java\org\apache\pulsar\compaction\CompactedTopicContext.java,11,10,0,2,0,12
 pulsar-master\pulsar-master\pulsar-zookeeper-utils\src\main\java\org\apache\pulsar\zookeeper\package-info.java,0,0,0,1,0,1
 pulsar-master\pulsar-master\pulsar-functions\api-java\src\main\java\org\apache\pulsar\functions\api\StateStore.java,0,0,0,1,0,1
 pulsar-master\pulsar-master\pulsar-io\netty\src\main\java\org\apache\pulsar\io\netty\tcp\package-info.java,0,1,0,1,0,2
 pulsar-master\pulsar-master\pulsar-client\src\main\java\org\apache\pulsar\client\impl\schema\ByteBufferSchema.java,70,13,1,1,0,15
 pulsar-master\pulsar-master\pulsar-broker\src\main\java\org\apache\pulsar\broker\stats\prometheus\TopicStats.java,0,368,1,200,0,569
 pulsar-master\pulsar-master\pulsar-proxy\src\test\java\org\apache\pulsar\proxy\server\ProxyTest.java,264,68,2,35,0,105
 pulsar-master\pulsar-master\pulsar-client\src\main\java\org\apache\pulsar\client\impl\auth\AuthenticationToken.java,0,29,1,11,0,41
 pulsar-master\pulsar-master\pulsar-broker\src\main\java\org\apache\pulsar\broker\service\schema\SchemaStorageFactory.java,0,1,0,1,0,2
 pulsar-master\pulsar-master\pulsar-client\src\main\java\org\apache\pulsar\client\impl\schema\generic\MultiVersionSchemaInfoProvider.java,65,27,1,9,0,37
 pulsar-master\pulsar-master\pulsar-common\src\main\java\org\apache\pulsar\common\naming\ServiceUnitId.java,0,2,0,3,0,5
 pulsar-master\pulsar-master\pulsar-client-admin-api\src\main\java\org\apache\pulsar\common\policies\data\NonPersistentSubscriptionStats.java,0,2,0,2,0,4
 pulsar-master\pulsar-master\tests\integration\src\test\java\org\apache\pulsar\tests\integration\io\PulsarIOTestBase.java,34,16,0,6,0,22
 pulsar-master\pulsar-master\pulsar-client-1x-base\pulsar-client-1x\src\main\java\org\apache\pulsar\client\api\ReaderConfiguration.java,144,33,0,15,0,48
 pulsar-master\pulsar-master\pulsar-client-1x-base\pulsar-client-1x\src\main\java\org\apache\pulsar\client\impl\MessageBuilderImpl.java,85,27,0,2,0,29
 pulsar-master\pulsar-master\pulsar-proxy\src\main\java\org\apache\pulsar\proxy\server\WebServer.java,213,79,5,23,0,107
 pulsar-master\pulsar-master\pulsar-client-admin-api\src\main\java\org\apache\pulsar\policies\data\loadbalancer\ServiceLookupData.java,0,4,0,1,0,5
 pulsar-master\pulsar-master\pulsar-broker-common\src\main\java\org\apache\pulsar\broker\ShutdownService.java,0,1,0,1,0,2
 pulsar-master\pulsar-master\pulsar-client-admin\src\main\java\org\apache\pulsar\client\admin\internal\ProxyStatsImpl.java,30,10,2,4,0,16
 pulsar-master\pulsar-master\pulsar-broker\src\test\java\org\apache\pulsar\broker\transaction\buffer\TransactionBufferClientTest.java,236,69,3,45,0,117
 pulsar-master\pulsar-master\pulsar-package-management\core\src\main\java\org\apache\pulsar\packages\management\core\common\package-info.java,0,1,0,1,0,2
 pulsar-master\pulsar-master\pulsar-common\src\test\java\org\apache\pulsar\common\util\collections\ConcurrentLongHashMapTest.java,543,102,6,24,0,132
 pulsar-master\pulsar-master\pulsar-websocket\src\main\java\org\apache\pulsar\websocket\ConsumerHandler.java,420,141,18,80,0,239
 pulsar-master\pulsar-master\pulsar-broker\src\test\java\org\apache\pulsar\client\api\TlsSniTest.java,0,7,0,7,0,14
 pulsar-master\pulsar-master\testmocks\src\main\java\org\apache\bookkeeper\client\package-info.java,0,0,0,1,0,1
 pulsar-master\pulsar-master\pulsar-broker\src\main\java\org\apache\pulsar\broker\stats\metrics\ManagedLedgerMetrics.java,145,40,0,27,0,67
 pulsar-master\pulsar-master\pulsar-broker-common\src\main\java\org\apache\pulsar\broker\resources\NamespaceResources.java,239,206,2,68,0,276
 pulsar-master\pulsar-master\pulsar-client-api\src\main\java\org\apache\pulsar\client\internal\PulsarClientImplementationBinding.java,0,79,1,28,0,108
 pulsar-master\pulsar-master\pulsar-client-admin-api\src\main\java\org\apache\pulsar\common\policies\data\impl\DispatchRateImpl.java,0,37,0,9,0,46
 pulsar-master\pulsar-master\tests\integration\src\test\java\org\apache\pulsar\tests\integration\backwardscompatibility\ClientTest2_3.java,12,8,1,4,0,13
 pulsar-master\pulsar-master\pulsar-client\src\test\java\org\apache\pulsar\client\impl\MessageTest.java,62,12,0,8,0,20
 pulsar-master\pulsar-master\pulsar-client\src\main\java\org\apache\pulsar\client\impl\auth\AuthenticationKeyStoreTls.java,0,29,2,11,0,42
 pulsar-master\pulsar-master\tests\pulsar-client-admin-shade-test\src\test\java\org\apache\pulsar\tests\integration\PulsarContainer.java,32,15,0,4,0,19
 pulsar-master\pulsar-master\pulsar-client-admin-api\src\main\java\org\apache\pulsar\common\policies\data\FunctionInstanceStatsData.java,0,4,0,2,0,6
 pulsar-master\pulsar-master\pulsar-functions\api-java\src\main\java\org\apache\pulsar\functions\api\KVRecord.java,0,5,0,1,0,6
 pulsar-master\pulsar-master\pulsar-broker-common\src\main\java\org\apache\pulsar\broker\resources\TopicResources.java,84,43,1,11,0,55
 pulsar-master\pulsar-master\pulsar-client\src\main\java\org\apache\pulsar\client\impl\HttpClient.java,192,67,9,42,0,118
 pulsar-master\pulsar-master\pulsar-broker\src\test\java\org\apache\pulsar\broker\namespace\OwnershipCacheTest.java,347,75,8,43,0,126
 pulsar-master\pulsar-master\pulsar-functions\worker\src\main\java\org\apache\pulsar\functions\worker\WorkerUtils.java,0,146,0,81,0,227
 pulsar-master\pulsar-master\pulsar-broker\src\main\java\org\apache\pulsar\broker\transaction\buffer\impl\TransactionBufferDisable.java,72,34,0,7,0,41
 pulsar-master\pulsar-master\pulsar-functions\runtime-all\src\main\java\org\apache\pulsar\functions\instance\package-info.java,0,0,0,1,0,1
 pulsar-master\pulsar-master\pulsar-testclient\src\main\java\org\apache\pulsar\testclient\PerformanceReader.java,321,147,12,60,0,219
 pulsar-master\pulsar-master\pulsar-functions\runtime\src\main\java\org\apache\pulsar\functions\auth\FunctionAuthData.java,14,3,0,3,0,6
 pulsar-master\pulsar-master\pulsar-broker\src\main\java\org\apache\pulsar\broker\service\persistent\PersistentMessageExpiryMonitor.java,160,77,3,34,0,114
 pulsar-master\pulsar-master\pulsar-functions\java-examples\src\main\java\org\apache\pulsar\functions\api\examples\serde\package-info.java,0,0,0,1,0,1
 pulsar-master\pulsar-master\pulsar-io\jdbc\sqlite\src\main\java\org\apache\pulsar\io\jdbc\package-info.java,0,1,0,1,0,2
 pulsar-master\pulsar-master\pulsar-broker-common\src\main\java\org\apache\pulsar\broker\resources\ResourceGroupResources.java,55,40,0,8,0,48
 pulsar-master\pulsar-master\pulsar-client\src\test\java\org\apache\pulsar\client\impl\schema\generic\GenericAvroSchemaTest.java,47,18,0,11,0,29
 pulsar-master\pulsar-master\pulsar-client\src\main\java\org\apache\pulsar\client\impl\conf\ReaderConfigurationData.java,0,30,1,4,0,35
 pulsar-master\pulsar-master\pulsar-functions\worker\src\test\java\org\apache\pulsar\functions\worker\scheduler\RoundRobinSchedulerTest.java,46,10,1,6,0,17
 pulsar-master\pulsar-master\pulsar-io\elastic-search\src\main\java\org\apache\pulsar\io\elasticsearch\IndexNameFormatter.java,57,22,0,11,0,33
 pulsar-master\pulsar-master\pulsar-broker\src\test\java\org\apache\pulsar\schema\Schemas.java,49,22,0,1,0,23
 pulsar-master\pulsar-master\pulsar-client-admin\src\main\java\org\apache\pulsar\client\admin\internal\PulsarAdminBuilderImpl.java,154,85,3,20,0,108
 pulsar-master\pulsar-master\pulsar-client-admin-api\src\main\java\org\apache\pulsar\common\policies\data\PersistentTopicInternalStats.java,8,5,0,1,0,6
 pulsar-master\pulsar-master\pulsar-client-tools\src\main\java\org\apache\pulsar\client\cli\CmdConsume.java,443,148,10,60,0,218
 pulsar-master\pulsar-master\pulsar-functions\runtime\src\main\java\org\apache\pulsar\functions\runtime\process\ProcessRuntimeFactoryConfig.java,21,10,0,3,0,13
 pulsar-master\pulsar-master\managed-ledger\src\main\java\org\apache\bookkeeper\mledger\impl\OffloadSegmentInfoImpl.java,35,35,3,3,0,41
 pulsar-master\pulsar-master\pulsar-io\hdfs2\src\main\java\org\apache\pulsar\io\hdfs2\sink\seq\HdfsAbstractSequenceFileSink.java,0,17,4,4,0,25
 pulsar-master\pulsar-master\pulsar-broker\src\test\java\org\apache\pulsar\broker\protocol\SimpleProtocolHandlerSharedThreadPoolTest.java,6,2,0,2,0,4
 pulsar-master\pulsar-master\pulsar-io\flume\src\test\java\org\apache\pulsar\io\flume\node\TestPropertiesFileConfigurationProvider.java,70,10,3,4,0,17
 pulsar-master\pulsar-master\pulsar-broker\src\main\java\org\apache\pulsar\PulsarClusterMetadataTeardown.java,154,52,2,31,0,85
 pulsar-master\pulsar-master\pulsar-client\src\test\java\org\apache\pulsar\client\impl\schema\KeyValueSchemaInfoTest.java,180,40,0,28,0,68
 pulsar-master\pulsar-master\pulsar-client\src\main\java\org\apache\pulsar\client\impl\ReaderInterceptorUtil.java,56,29,1,10,0,40
 pulsar-master\pulsar-master\managed-ledger\src\main\java\org\apache\bookkeeper\mledger\impl\package-info.java,0,1,0,1,0,2
 pulsar-master\pulsar-master\pulsar-broker\src\test\java\org\apache\pulsar\client\api\ConsumerCleanupTest.java,37,11,0,4,0,15
 pulsar-master\pulsar-master\pulsar-client\src\test\java\org\apache\pulsar\client\tutorial\SampleCryptoProducer.java,56,23,1,12,0,36
 pulsar-master\pulsar-master\pulsar-client-api\src\main\java\org\apache\pulsar\client\api\PulsarClient.java,0,50,0,46,0,96
 pulsar-master\pulsar-master\pulsar-client\src\test\java\org\apache\pulsar\client\impl\schema\FloatSchemaTest.java,0,10,0,1,0,11
 pulsar-master\pulsar-master\pulsar-io\kafka\src\main\java\org\apache\pulsar\io\kafka\KafkaAbstractSource.java,216,83,3,41,0,127
 pulsar-master\pulsar-master\pulsar-proxy\src\main\java\org\apache\pulsar\proxy\extensions\ProxyExtensionDefinition.java,19,0,0,1,0,1
 pulsar-master\pulsar-master\pulsar-io\elastic-search\src\test\java\org\apache\pulsar\io\elasticsearch\ElasticSearchClientSslTests.java,132,54,0,39,0,93
 pulsar-master\pulsar-master\pulsar-broker\src\main\java\org\apache\pulsar\broker\loadbalance\impl\SimpleLoadManagerImpl.java,0,544,51,371,0,966
 pulsar-master\pulsar-master\pulsar-client-tools\src\main\java\org\apache\pulsar\admin\cli\utils\package-info.java,0,0,0,1,0,1
 pulsar-master\pulsar-master\pulsar-common\src\main\java\org\apache\pulsar\client\impl\schema\KeyValueSchemaInfo.java,0,64,2,27,0,93
 pulsar-master\pulsar-master\pulsar-functions\runtime\src\main\java\org\apache\pulsar\functions\runtime\RuntimeCustomizer.java,0,3,0,2,0,5
 pulsar-master\pulsar-master\pulsar-broker\src\test\java\org\apache\pulsar\PulsarBrokerStarterTest.java,349,115,12,89,0,216
 pulsar-master\pulsar-master\buildtools\src\test\java\org\apache\pulsar\tests\FastThreadLocalStateCleanerTest.java,98,31,1,8,0,40
 pulsar-master\pulsar-master\tests\pulsar-client-all-shade-test\src\test\java\org\apache\pulsar\tests\integration\PulsarContainer.java,32,15,0,4,0,19
 pulsar-master\pulsar-master\pulsar-broker\src\test\java\org\apache\pulsar\client\impl\ZeroQueueSizeTest.java,492,83,12,52,0,147
 pulsar-master\pulsar-master\tests\pulsar-client-shade-test\src\test\java\org\apache\pulsar\tests\integration\PulsarContainer.java,32,15,0,4,0,19
 pulsar-master\pulsar-master\pulsar-client\src\test\java\org\apache\pulsar\client\impl\schema\InstantSchemaTest.java,57,6,0,3,0,9
 pulsar-master\pulsar-master\pulsar-broker\src\main\java\org\apache\pulsar\broker\loadbalance\impl\PulsarServiceUnit.java,50,16,1,1,0,18
 pulsar-master\pulsar-master\pulsar-broker\src\main\java\org\apache\pulsar\broker\transaction\pendingack\impl\MLPendingAckStoreProvider.java,87,50,3,38,0,91
 pulsar-master\pulsar-master\pulsar-broker\src\main\java\org\apache\pulsar\broker\loadbalance\PlacementStrategy.java,0,2,0,2,0,4
 pulsar-master\pulsar-master\pulsar-broker\src\test\java\org\apache\pulsar\broker\service\TopicOwnerTest.java,284,103,3,61,0,167
 pulsar-master\pulsar-master\pulsar-functions\worker\src\main\java\org\apache\pulsar\functions\worker\rest\ConfigurationResource.java,18,2,0,1,0,3
 pulsar-master\pulsar-master\pulsar-common\src\main\java\org\apache\pulsar\common\util\netty\package-info.java,0,3,0,2,0,5
 pulsar-master\pulsar-master\pulsar-common\src\main\java\org\apache\pulsar\common\functions\JsonIgnorePropertiesMixIn.java,4,0,1,1,0,2
 pulsar-master\pulsar-master\pulsar-broker\src\main\java\org\apache\pulsar\broker\service\nonpersistent\NonPersistentDispatcher.java,0,14,0,3,0,17
 pulsar-master\pulsar-master\pulsar-common\src\main\java\org\apache\pulsar\client\impl\schema\package-info.java,0,0,0,1,0,1
 pulsar-master\pulsar-master\pulsar-broker\src\main\java\org\apache\pulsar\broker\storage\package-info.java,0,2,0,1,0,3
 pulsar-master\pulsar-master\pulsar-io\kinesis\src\main\java\org\apache\pulsar\io\kinesis\fbs\KeyValue.java,0,63,13,16,0,92
 pulsar-master\pulsar-master\pulsar-common\src\test\java\org\apache\pulsar\common\util\collections\FieldParserTest.java,81,10,3,2,0,15
 pulsar-master\pulsar-master\pulsar-client\src\main\java\org\apache\pulsar\client\impl\ControlledClusterFailover.java,213,81,3,32,0,116
 pulsar-master\pulsar-master\buildtools\src\test\java\org\apache\pulsar\tests\ThreadDumpUtilTest.java,14,1,0,1,0,2
 pulsar-master\pulsar-master\pulsar-client\src\main\java\org\apache\pulsar\client\impl\schema\TimeSchema.java,53,10,1,1,0,12
 pulsar-master\pulsar-master\tests\bc_2_0_0\src\test\java\org\apache\pulsar\tests\integration\PulsarContainer.java,28,12,0,3,0,15
 pulsar-master\pulsar-master\pulsar-transaction\common\src\main\java\org\apache\pulsar\transaction\common\exception\TransactionConflictException.java,9,3,0,2,0,5
 pulsar-master\pulsar-master\pulsar-functions\java-examples\src\main\java\org\apache\pulsar\functions\api\examples\ConfigBasedAppendFunction.java,0,4,0,2,0,6
 pulsar-master\pulsar-master\pulsar-functions\instance\src\test\java\org\apache\pulsar\functions\instance\state\PulsarMetadataStateStoreImplTest.java,70,33,0,10,0,43
 pulsar-master\pulsar-master\tiered-storage\file-system\src\test\java\org\apache\bookkeeper\mledger\offload\filesystem\FileStoreTestBase.java,33,19,1,5,0,25
 pulsar-master\pulsar-master\pulsar-client\src\main\java\org\apache\pulsar\client\impl\TopicMessageImpl.java,196,48,0,3,0,51
 pulsar-master\pulsar-master\pulsar-client-api\src\main\java\org\apache\pulsar\client\api\ConsumerBuilder.java,0,165,1,136,0,302
 pulsar-master\pulsar-master\pulsar-io\mongo\src\test\java\org\apache\pulsar\io\mongodb\MongoConfigTest.java,59,10,0,4,0,14
 pulsar-master\pulsar-master\pulsar-broker\src\main\java\org\apache\pulsar\broker\service\schema\SchemaCompatibilityCheck.java,0,18,0,10,0,28
 pulsar-master\pulsar-master\pulsar-common\src\main\java\org\apache\pulsar\common\naming\package-info.java,0,2,0,1,0,3
 pulsar-master\pulsar-master\pulsar-client-tools\src\main\java\org\apache\pulsar\admin\cli\CmdPersistentTopics.java,664,196,38,131,0,365
 pulsar-master\pulsar-master\pulsar-broker\src\test\java\org\apache\pulsar\broker\service\persistent\PersistentSubscriptionTest.java,270,119,7,59,0,185
 pulsar-master\pulsar-master\tests\integration\src\test\java\org\apache\pulsar\tests\integration\io\sources\debezium\DebeziumMongoDbSourceTester.java,94,50,2,19,0,71
 pulsar-master\pulsar-master\pulsar-functions\utils\src\test\java\org\apache\pulsar\functions\utils\WindowConfigUtilsTest.java,257,34,0,28,0,62
 pulsar-master\pulsar-master\pulsar-broker\src\main\java\org\apache\pulsar\broker\service\schema\JsonSchemaCompatibilityCheck.java,86,28,3,14,0,45
 pulsar-master\pulsar-master\pulsar-io\hdfs3\src\test\java\org\apache\pulsar\io\hdfs3\sink\text\HdfsStringSinkTests.java,0,29,1,1,0,31
 pulsar-master\pulsar-master\pulsar-common\src\main\java\org\apache\pulsar\common\topics\TopicList.java,41,21,0,8,0,29
 pulsar-master\pulsar-master\pulsar-common\src\main\java\org\apache\pulsar\common\events\EventsTopicNames.java,35,13,2,7,0,22
 pulsar-master\pulsar-master\pulsar-broker\src\test\java\org\apache\pulsar\broker\admin\AdminApiHealthCheckTest.java,123,23,0,13,0,36
 pulsar-master\pulsar-master\pulsar-broker\src\main\java\org\apache\pulsar\broker\stats\AllocatorStatsGenerator.java,81,9,1,3,0,13
 pulsar-master\pulsar-master\pulsar-broker\src\test\java\org\apache\pulsar\client\api\BytesKeyTest.java,49,7,0,2,0,9
 pulsar-master\pulsar-master\pulsar-broker\src\main\java\org\apache\pulsar\broker\service\nonpersistent\NonPersistentDispatcherMultipleConsumers.java,0,72,1,30,0,103
 pulsar-master\pulsar-master\pulsar-client\src\main\java\org\apache\pulsar\client\impl\schema\reader\ProtobufNativeReader.java,0,3,0,2,0,5
 pulsar-master\pulsar-master\pulsar-sql\presto-pulsar\src\test\java\org\apache\pulsar\sql\presto\decoder\protobufnative\TestMsg.java,0,1275,712,235,0,2222
 pulsar-master\pulsar-master\pulsar-functions\instance\src\main\java\org\apache\pulsar\functions\source\PulsarSource.java,152,53,0,25,0,78
 pulsar-master\pulsar-master\pulsar-functions\instance\src\main\java\org\apache\pulsar\functions\instance\stats\SinkStatsManager.java,348,101,5,27,0,133
 pulsar-master\pulsar-master\pulsar-functions\secrets\src\main\java\org\apache\pulsar\functions\secretsproviderconfigurator\NameAndConfigBasedSecretsProviderConfigurator.java,41,28,0,12,0,40
 pulsar-master\pulsar-master\pulsar-broker\src\test\java\org\apache\pulsar\utils\StatsOutputStreamTest.java,123,17,0,2,0,19
 pulsar-master\pulsar-master\pulsar-metadata\src\main\java\org\apache\pulsar\metadata\bookkeeper\PulsarLedgerIdGenerator.java,256,63,8,37,0,108
 pulsar-master\pulsar-master\pulsar-client-tools\src\test\java\org\apache\pulsar\admin\cli\TestCmdSources.java,0,119,2,24,0,145
 pulsar-master\pulsar-master\tests\integration\src\test\java\org\apache\pulsar\tests\integration\io\sources\BatchSourceTest.java,0,51,4,19,0,74
 pulsar-master\pulsar-master\pulsar-client\src\main\java\org\apache\pulsar\client\impl\conf\ConsumerConfigurationData.java,0,70,1,11,0,82
 pulsar-master\pulsar-master\pulsar-client-admin-api\src\main\java\org\apache\pulsar\client\admin\Packages.java,0,10,0,9,0,19
 pulsar-master\pulsar-master\pulsar-io\solr\src\test\java\org\apache\pulsar\io\solr\SolrSinkConfigTest.java,132,13,1,5,0,19
 pulsar-master\pulsar-master\pulsar-broker\src\main\java\org\apache\pulsar\broker\service\persistent\ReplicatedSubscriptionsController.java,0,86,6,50,0,142
 pulsar-master\pulsar-master\pulsar-broker\src\main\java\org\apache\pulsar\broker\service\schema\exceptions\SchemaException.java,27,14,0,1,0,15
 pulsar-master\pulsar-master\pulsar-client\src\main\java\org\apache\pulsar\client\impl\UnAckedTopicMessageTracker.java,30,10,0,4,0,14
 pulsar-master\pulsar-master\pulsar-broker\src\main\java\org\apache\pulsar\broker\delayed\DelayedDeliveryTracker.java,0,9,0,7,0,16
 pulsar-master\pulsar-master\pulsar-client-1x-base\pulsar-client-1x\src\main\java\org\apache\pulsar\client\api\PulsarClient.java,0,39,0,39,0,78
 pulsar-master\pulsar-master\pulsar-broker\src\test\java\org\apache\pulsar\broker\service\PublishRateLimiterDisableTest.java,10,3,0,3,0,6
 pulsar-master\pulsar-master\pulsar-broker\src\main\java\org\apache\pulsar\broker\loadbalance\LoadReport.java,0,5,0,3,0,8
 pulsar-master\pulsar-master\pulsar-common\src\main\java\org\apache\pulsar\common\protocol\package-info.java,0,2,0,1,0,3
 pulsar-master\pulsar-master\pulsar-broker-common\src\main\java\org\apache\pulsar\broker\resources\BookieResources.java,24,13,1,3,0,17
 pulsar-master\pulsar-master\pulsar-client-admin-api\src\main\java\org\apache\pulsar\client\admin\Source.java,0,0,0,1,0,1
 pulsar-master\pulsar-master\pulsar-proxy\src\test\java\org\apache\pulsar\proxy\server\ProxyEnableHAProxyProtocolTest.java,77,19,1,15,0,35
 pulsar-master\pulsar-master\pulsar-client\src\main\java\org\apache\pulsar\client\impl\schema\generic\AbstractMultiVersionGenericReader.java,16,11,0,7,0,18
 pulsar-master\pulsar-master\pulsar-proxy\src\test\java\org\apache\pulsar\proxy\extensions\MockProxyExtension.java,0,6,0,2,0,8
 pulsar-master\pulsar-master\pulsar-broker\src\main\java\org\apache\pulsar\broker\loadbalance\BundleSplitStrategy.java,0,2,0,3,0,5
 pulsar-master\pulsar-master\pulsar-broker\src\main\java\org\apache\pulsar\broker\transaction\buffer\TransactionMeta.java,0,9,0,6,0,15
 pulsar-master\pulsar-master\pulsar-common\src\main\java\org\apache\pulsar\common\intercept\AppendBrokerTimestampMetadataInterceptor.java,16,7,0,3,0,10
 pulsar-master\pulsar-master\pulsar-broker\src\main\java\org\apache\pulsar\broker\web\NoSwaggerDocumentation.java,0,0,0,1,0,1
 pulsar-master\pulsar-master\pulsar-broker-common\src\test\java\org\apache\pulsar\bookie\rackawareness\IsolatedBookieEnsemblePlacementPolicyTest.java,0,215,7,159,0,381
 pulsar-master\pulsar-master\pulsar-common\src\main\java\org\apache\pulsar\common\policies\data\ClusterDataImpl.java,0,135,5,31,0,171
 pulsar-master\pulsar-master\tests\integration\src\test\java\org\apache\pulsar\tests\integration\presto\TestPrestoQueryTieredStorage.java,182,57,4,22,0,83
 pulsar-master\pulsar-master\pulsar-sql\presto-pulsar\src\main\java\org\apache\pulsar\sql\presto\PulsarRecordSet.java,39,18,0,4,0,22
 pulsar-master\pulsar-master\pulsar-io\data-generator\src\main\java\org\apache\pulsar\io\datagenerator\DataGeneratorSourceConfig.java,23,5,0,3,0,8
 pulsar-master\pulsar-master\pulsar-metadata\src\main\java\org\apache\pulsar\metadata\bookkeeper\BKCluster.java,274,64,6,21,0,91
 pulsar-master\pulsar-master\pulsar-functions\worker\src\main\java\org\apache\pulsar\functions\worker\scheduler\RoundRobinScheduler.java,106,25,0,16,0,41
 pulsar-master\pulsar-master\pulsar-sql\presto-pulsar\src\main\java\org\apache\pulsar\sql\presto\PulsarColumnMetadata.java,193,93,1,15,0,109
 pulsar-master\pulsar-master\pulsar-broker\src\main\java\org\apache\pulsar\broker\admin\v1\Namespaces.java,1193,1087,36,419,0,1542
 pulsar-master\pulsar-master\pulsar-client-api\src\main\java\org\apache\pulsar\client\api\ControlledClusterFailoverBuilder.java,0,9,0,5,0,14
 pulsar-master\pulsar-master\tiered-storage\jcloud\src\main\java\org\apache\bookkeeper\mledger\offload\jcloud\impl\package-info.java,0,1,0,1,0,2
 pulsar-master\pulsar-master\pulsar-broker-common\src\main\java\org\apache\pulsar\broker\ServiceConfigurationUtils.java,110,47,2,18,0,67
 pulsar-master\pulsar-master\pulsar-client-admin-api\src\main\java\org\apache\pulsar\common\policies\data\SchemaAutoUpdateCompatibilityStrategy.java,0,7,0,8,0,15
 pulsar-master\pulsar-master\pulsar-io\hdfs3\src\test\java\org\apache\pulsar\io\hdfs3\sink\HdfsSinkConfigTests.java,121,49,1,3,0,53
 pulsar-master\pulsar-master\pulsar-io\hdfs2\src\main\java\org\apache\pulsar\io\hdfs2\sink\HdfsSinkConfig.java,78,21,2,15,0,38
 pulsar-master\pulsar-master\pulsar-client-admin-api\src\main\java\org\apache\pulsar\common\policies\data\BookiesClusterInfo.java,0,4,0,1,0,5
 pulsar-master\pulsar-master\pulsar-broker\src\main\java\org\apache\pulsar\utils\CmdUtility.java,58,8,1,4,0,13
 pulsar-master\pulsar-master\pulsar-client-admin-api\src\main\java\org\apache\pulsar\common\policies\data\TransactionCoordinatorInternalStats.java,6,1,0,1,0,2
 pulsar-master\pulsar-master\pulsar-client-admin-api\src\main\java\org\apache\pulsar\client\admin\Sink.java,0,0,0,1,0,1
 pulsar-master\pulsar-master\pulsar-client\src\main\java\org\apache\pulsar\client\impl\PulsarChannelInitializer.java,0,46,2,26,0,74
 pulsar-master\pulsar-master\pulsar-broker\src\main\java\org\apache\pulsar\PulsarInitialNamespaceSetup.java,84,21,1,10,0,32
 pulsar-master\pulsar-master\pulsar-broker\src\main\java\org\apache\pulsar\broker\service\schema\AvroSchemaCompatibilityCheck.java,9,2,0,2,0,4
 pulsar-master\pulsar-master\pulsar-metadata\src\main\java\org\apache\pulsar\metadata\impl\batching\OpPut.java,23,9,0,1,0,10
 pulsar-master\pulsar-master\pulsar-broker\src\test\java\org\apache\pulsar\broker\SLAMonitoringTest.java,201,50,3,28,0,81
 pulsar-master\pulsar-master\pulsar-common\src\main\java\org\apache\pulsar\common\policies\data\stats\NonPersistentSubscriptionStatsImpl.java,0,9,0,4,0,13
 pulsar-master\pulsar-master\pulsar-io\flume\src\main\java\org\apache\pulsar\io\flume\sink\StringSink.java,8,2,0,1,0,3
 pulsar-master\pulsar-master\pulsar-proxy\src\main\java\org\apache\pulsar\proxy\stats\RestException.java,25,13,0,4,0,17
 pulsar-master\pulsar-master\pulsar-io\hdfs3\src\main\java\org\apache\pulsar\io\hdfs3\sink\HdfsSyncThread.java,48,14,0,2,0,16
 pulsar-master\pulsar-master\pulsar-broker\src\test\java\org\apache\pulsar\broker\BrokerAdditionalServletTest.java,152,45,6,25,0,76
 pulsar-master\pulsar-master\pulsar-client\src\main\java\org\apache\pulsar\client\impl\ChunkMessageIdImpl.java,50,17,1,4,0,22
 pulsar-master\pulsar-master\pulsar-broker\src\test\java\org\apache\pulsar\broker\auth\MockedPulsarServiceBaseTest.java,427,177,9,61,0,247
 pulsar-master\pulsar-master\pulsar-common\src\main\java\org\apache\pulsar\common\protocol\OptionalProxyProtocolDecoder.java,18,8,0,5,0,13
 pulsar-master\pulsar-master\tests\integration\src\test\java\org\apache\pulsar\tests\integration\presto\TestBasicPresto.java,315,139,9,51,0,199
 pulsar-master\pulsar-master\pulsar-client-admin-api\src\main\java\org\apache\pulsar\client\admin\utils\package-info.java,0,2,0,2,0,4
 pulsar-master\pulsar-master\pulsar-broker\src\test\java\org\apache\pulsar\broker\zookeeper\MultiBrokerMetadataConsistencyTest.java,49,13,0,6,0,19
 pulsar-master\pulsar-master\pulsar-common\src\main\java\org\apache\pulsar\common\util\keystoretls\package-info.java,0,2,0,2,0,4
 pulsar-master\pulsar-master\tests\integration\src\test\java\org\apache\pulsar\tests\integration\containers\CSContainer.java,15,3,0,1,0,4
 pulsar-master\pulsar-master\pulsar-functions\api-java\src\main\java\org\apache\pulsar\functions\api\state\package-info.java,0,1,0,1,0,2
 pulsar-master\pulsar-master\pulsar-common\src\test\java\org\apache\pulsar\common\policies\impl\NamespaceIsolationPoliciesTest.java,152,34,1,27,0,62
 pulsar-master\pulsar-master\pulsar-client\src\test\java\org\apache\pulsar\client\impl\PatternMultiTopicsConsumerImplTest.java,72,10,0,4,0,14
 pulsar-master\pulsar-master\pulsar-io\hdfs2\src\main\java\org\apache\pulsar\io\hdfs2\package-info.java,0,1,0,1,0,2
 pulsar-master\pulsar-master\pulsar-functions\worker\src\main\java\org\apache\pulsar\functions\worker\dlog\DLInputStream.java,106,17,0,3,0,20
 pulsar-master\pulsar-master\pulsar-functions\worker\src\main\java\org\apache\pulsar\functions\worker\MembershipManager.java,192,48,5,32,0,85
 pulsar-master\pulsar-master\pulsar-broker\src\test\java\org\apache\pulsar\client\api\MemoryLimitTest.java,139,35,5,8,0,48
 pulsar-master\pulsar-master\tests\integration\src\test\java\org\apache\pulsar\tests\integration\containers\DebeziumPostgreSqlContainer.java,32,9,0,2,0,11
 pulsar-master\pulsar-master\pulsar-client-admin-api\src\main\java\org\apache\pulsar\common\stats\Metrics.java,69,31,1,5,0,37
 pulsar-master\pulsar-master\pulsar-client\src\test\java\org\apache\pulsar\client\impl\schema\generic\GenericAvroReaderTest.java,74,25,0,9,0,34
 pulsar-master\pulsar-master\pulsar-io\file\src\main\java\org\apache\pulsar\io\file\FileListingThread.java,158,43,2,22,0,67
 pulsar-master\pulsar-master\pulsar-broker\src\main\java\org\apache\pulsar\broker\loadbalance\impl\BrokerVersionFilter.java,127,36,6,30,0,72
 pulsar-master\pulsar-master\pulsar-functions\instance\src\test\java\org\apache\pulsar\functions\source\PulsarSourceTest.java,305,121,1,82,0,204
 pulsar-master\pulsar-master\pulsar-client\src\test\java\org\apache\pulsar\client\impl\schema\KeyValueSchemaTest.java,365,121,0,99,0,220
 pulsar-master\pulsar-master\pulsar-client-api\src\main\java\org\apache\pulsar\client\api\TopicMetadata.java,0,0,0,1,0,1
 pulsar-master\pulsar-master\tests\integration\src\test\java\org\apache\pulsar\tests\integration\containers\ProxyContainer.java,18,11,0,4,0,15
 pulsar-master\pulsar-master\pulsar-client\src\main\java\org\apache\pulsar\client\impl\schema\ByteSchema.java,64,16,1,3,0,20
 pulsar-master\pulsar-master\pulsar-broker\src\main\java\org\apache\pulsar\broker\service\schema\SchemaRegistryService.java,0,11,0,8,0,19
 pulsar-master\pulsar-master\pulsar-broker\src\test\java\org\apache\pulsar\broker\service\PersistentTopicE2ETest.java,1804,291,27,177,0,495
 pulsar-master\pulsar-master\pulsar-metadata\src\test\java\org\apache\pulsar\metadata\MetadataStoreTest.java,397,88,1,48,0,137
 pulsar-master\pulsar-master\tests\integration\src\test\java\org\apache\pulsar\tests\integration\topologies\FunctionRuntimeType.java,0,2,0,1,0,3
 pulsar-master\pulsar-master\pulsar-functions\runtime\src\test\java\org\apache\pulsar\functions\runtime\thread\ThreadRuntimeFactoryTest.java,101,48,0,18,0,66
 pulsar-master\pulsar-master\pulsar-functions\instance\src\main\java\org\apache\pulsar\functions\windowing\evictors\package-info.java,0,0,0,1,0,1
 pulsar-master\pulsar-master\tiered-storage\jcloud\src\main\java\org\apache\bookkeeper\mledger\offload\jcloud\OffloadIndexEntry.java,0,5,0,2,0,7
 pulsar-master\pulsar-master\pulsar-common\src\main\java\org\apache\pulsar\common\util\SimpleTextOutputStream.java,109,49,0,2,0,51
 pulsar-master\pulsar-master\pulsar-client-api\src\main\java\org\apache\pulsar\client\api\BatchMessageContainer.java,0,2,0,2,0,4
 pulsar-master\pulsar-master\pulsar-client-admin-api\src\main\java\org\apache\pulsar\common\policies\data\AutoFailoverPolicyType.java,0,6,0,4,0,10
 pulsar-master\pulsar-master\pulsar-common\src\main\java\org\apache\pulsar\common\util\ObjectMapperFactory.java,107,37,1,37,0,75
 pulsar-master\pulsar-master\managed-ledger\src\main\java\org\apache\bookkeeper\mledger\ManagedLedgerConfig.java,634,233,0,55,0,288
 pulsar-master\pulsar-master\pulsar-websocket\src\main\java\org\apache\pulsar\websocket\admin\v1\WebSocketProxyStatsV1.java,32,22,2,9,0,33
 pulsar-master\pulsar-master\pulsar-client\src\main\java\org\apache\pulsar\client\impl\ReaderBuilderImpl.java,210,82,4,24,0,110
 pulsar-master\pulsar-master\pulsar-broker\src\test\java\org\apache\pulsar\io\AbstractPulsarE2ETest.java,222,109,8,50,0,167
 pulsar-master\pulsar-master\pulsar-broker\src\main\java\org\apache\pulsar\broker\lookup\v2\package-info.java,0,0,0,1,0,1
 pulsar-master\pulsar-master\pulsar-client\src\test\java\org\apache\pulsar\client\impl\ChunkMessageIdImplTest.java,64,14,0,2,0,16
 pulsar-master\pulsar-master\pulsar-functions\java-examples\src\main\java\org\apache\pulsar\functions\api\examples\package-info.java,0,0,0,1,0,1
 pulsar-master\pulsar-master\pulsar-broker\src\test\java\org\apache\pulsar\broker\admin\AdminApiSchemaTest.java,343,108,7,42,0,157
 pulsar-master\pulsar-master\pulsar-functions\instance\src\main\java\org\apache\pulsar\functions\windowing\triggers\package-info.java,0,0,0,1,0,1
 pulsar-master\pulsar-master\pulsar-io\mongo\src\test\java\org\apache\pulsar\io\mongodb\MongoSinkTest.java,146,30,2,4,0,36
 pulsar-master\pulsar-master\pulsar-broker-common\src\main\java\org\apache\pulsar\zookeeper\ZkIsolatedBookieEnsemblePlacementPolicy.java,4,2,0,4,0,6
 pulsar-master\pulsar-master\pulsar-broker\src\main\java\org\apache\pulsar\broker\service\GracefulExecutorServicesTerminationHandler.java,0,31,2,19,0,52
 pulsar-master\pulsar-master\pulsar-client\src\test\java\org\apache\pulsar\client\impl\schema\AvroSchemaTest.java,390,130,12,47,0,189
 pulsar-master\pulsar-master\pulsar-io\cassandra\src\main\java\org\apache\pulsar\io\cassandra\CassandraAbstractSink.java,0,22,1,5,0,28
 pulsar-master\pulsar-master\pulsar-client\src\main\java\org\apache\pulsar\client\impl\conf\ProducerConfigurationData.java,0,97,2,20,0,119
 pulsar-master\pulsar-master\pulsar-broker\src\test\java\org\apache\pulsar\client\processor\MessagePayloadProcessorTest.java,169,44,0,21,0,65
 pulsar-master\pulsar-master\tests\integration\src\test\java\org\apache\pulsar\tests\integration\cli\CLITest.java,472,48,6,27,0,81
 pulsar-master\pulsar-master\pulsar-sql\presto-pulsar\src\test\java\org\apache\pulsar\sql\presto\TestCacheSizeAllocator.java,122,33,4,20,0,57
 pulsar-master\pulsar-master\pulsar-client\src\main\java\org\apache\pulsar\client\impl\ServiceNameResolver.java,0,1,0,1,0,2
 pulsar-master\pulsar-master\pulsar-client-admin-api\src\main\java\org\apache\pulsar\common\policies\data\NamespaceOwnershipStatus.java,26,17,0,3,0,20
 pulsar-master\pulsar-master\pulsar-broker\src\main\java\org\apache\pulsar\broker\service\Replicator.java,0,9,0,1,0,10
 pulsar-master\pulsar-master\pulsar-broker\src\main\java\org\apache\pulsar\broker\systopic\SystemTopicClientBase.java,88,25,1,2,0,28
 pulsar-master\pulsar-master\pulsar-client-admin-api\src\main\java\org\apache\pulsar\common\policies\data\SubscriptionStats.java,0,39,0,9,0,48
 pulsar-master\pulsar-master\pulsar-broker\src\main\java\org\apache\pulsar\broker\service\PublishRateLimiterDisable.java,47,12,0,2,0,14
 pulsar-master\pulsar-master\pulsar-io\debezium\core\src\test\java\org\apache\pulsar\io\debezium\PulsarDatabaseHistoryTest.java,193,55,3,25,0,83
 pulsar-master\pulsar-master\tests\docker-images\java-test-functions\src\main\java\org\apache\pulsar\tests\integration\io\TestGenericObjectSink.java,71,22,23,18,0,63
 pulsar-master\pulsar-master\pulsar-broker\src\main\java\org\apache\pulsar\broker\lookup\v1\TopicLookup.java,36,39,0,17,0,56
 pulsar-master\pulsar-master\pulsar-io\elastic-search\src\test\java\org\apache\pulsar\io\elasticsearch\v8\ElasticSearch8ClientTests.java,7,1,0,1,0,2
 pulsar-master\pulsar-master\pulsar-common\src\main\java\org\apache\pulsar\common\policies\data\PersistentTopicStats.java,0,0,0,1,0,1
 pulsar-master\pulsar-master\pulsar-broker\src\main\java\org\apache\pulsar\broker\admin\impl\ClustersBase.java,966,262,54,129,0,445
 pulsar-master\pulsar-master\pulsar-io\twitter\src\main\java\org\apache\pulsar\io\twitter\TwitterFireHoseConfig.java,131,39,1,17,0,57
 pulsar-master\pulsar-master\pulsar-broker\src\test\java\org\apache\pulsar\client\api\ClientDeduplicationFailureTest.java,0,127,11,38,0,176
 pulsar-master\pulsar-master\pulsar-io\influxdb\src\test\java\org\apache\pulsar\io\influxdb\v1\InfluxDBGenericRecordSinkTest.java,105,27,5,4,0,36
 pulsar-master\pulsar-master\pulsar-client\src\main\java\org\apache\pulsar\client\impl\MultiTopicsConsumerImpl.java,1425,436,23,244,0,703
 pulsar-master\pulsar-master\pulsar-client\src\test\java\org\apache\pulsar\client\impl\schema\DoubleSchemaTest.java,42,14,0,1,0,15
 pulsar-master\pulsar-master\pulsar-broker\src\main\java\org\apache\pulsar\broker\service\schema\exceptions\IncompatibleSchemaException.java,17,5,0,1,0,6
 pulsar-master\pulsar-master\pulsar-common\src\test\java\org\apache\pulsar\common\util\ReflectionsTest.java,168,30,6,10,0,46
 pulsar-master\pulsar-master\tests\integration\src\test\java\org\apache\pulsar\tests\integration\backwardscompatibility\SmokeTest2_4.java,18,13,1,4,0,18
 pulsar-master\pulsar-master\pulsar-broker\src\main\java\org\apache\pulsar\broker\stats\prometheus\metrics\PrometheusMetricsProvider.java,93,40,0,16,0,56
 pulsar-master\pulsar-master\pulsar-common\src\main\java\org\apache\pulsar\common\util\SslContextAutoRefreshBuilder.java,69,14,2,6,0,22
 pulsar-master\pulsar-master\pulsar-broker\src\test\java\org\apache\pulsar\broker\service\persistent\SimpleProducerConsumerTestStreamingDispatcherTest.java,9,4,0,2,0,6
 pulsar-master\pulsar-master\managed-ledger\src\test\java\org\apache\bookkeeper\mledger\impl\ManagedLedgerTest.java,3398,871,91,379,0,1341
 pulsar-master\pulsar-master\pulsar-broker\src\main\java\org\apache\pulsar\broker\protocol\ProtocolHandler.java,0,15,0,15,0,30
 pulsar-master\pulsar-master\pulsar-client-admin-api\src\main\java\org\apache\pulsar\common\io\BatchSourceConfig.java,10,6,0,3,0,9
 pulsar-master\pulsar-master\pulsar-common\src\main\java\org\apache\pulsar\common\tls\package-info.java,0,0,0,1,0,1
 pulsar-master\pulsar-master\pulsar-client-admin-api\src\main\java\org\apache\pulsar\common\policies\data\SinkStatus.java,60,35,0,1,0,36
 pulsar-master\pulsar-master\pulsar-client-admin-api\src\main\java\org\apache\pulsar\common\policies\data\AutoFailoverPolicyData.java,0,8,0,2,0,10
 pulsar-master\pulsar-master\pulsar-io\netty\src\main\java\org\apache\pulsar\io\netty\server\NettyServer.java,150,56,0,10,0,66
 pulsar-master\pulsar-master\pulsar-broker-common\src\main\java\org\apache\pulsar\broker\authentication\AuthenticationProviderTls.java,73,17,0,13,0,30
 pulsar-master\pulsar-master\pulsar-broker\src\main\java\org\apache\pulsar\broker\tools\package-info.java,0,2,0,1,0,3
 pulsar-master\pulsar-master\pulsar-client\src\main\java\org\apache\pulsar\client\impl\schema\FieldSchemaBuilderImpl.java,0,34,0,12,0,46
 pulsar-master\pulsar-master\pulsar-broker\src\main\java\org\apache\pulsar\broker\protocol\ProtocolHandlers.java,116,37,4,21,0,62
 pulsar-master\pulsar-master\tests\integration\src\test\java\org\apache\pulsar\tests\integration\functions\PulsarStateTest.java,436,90,2,36,0,128
 pulsar-master\pulsar-master\pulsar-io\influxdb\src\test\java\org\apache\pulsar\io\influxdb\InfluxDBGenericRecordSinkTest.java,42,6,3,2,0,11
 pulsar-master\pulsar-master\pulsar-client-api\src\main\java\org\apache\pulsar\client\api\CompressionType.java,0,0,0,1,0,1
 pulsar-master\pulsar-master\pulsar-io\jdbc\sqlite\src\test\java\org\apache\pulsar\io\jdbc\JdbcUtilsTest.java,83,31,2,6,0,39
 pulsar-master\pulsar-master\pulsar-client\src\test\java\org\apache\pulsar\client\impl\RoundRobinPartitionMessageRouterImplTest.java,121,42,1,13,0,56
 pulsar-master\pulsar-master\pulsar-client\src\test\java\org\apache\pulsar\client\impl\AutoClusterFailoverTest.java,254,70,18,57,0,145
 pulsar-master\pulsar-master\pulsar-client-api\src\main\java\org\apache\pulsar\common\classification\InterfaceStability.java,24,9,2,1,0,12
 pulsar-master\pulsar-master\pulsar-broker\src\test\java\org\apache\pulsar\broker\service\ReplicatorRemoveClusterTest.java,74,23,0,10,0,33
 pulsar-master\pulsar-master\pulsar-io\flume\src\main\java\org\apache\pulsar\io\flume\node\AbstractZooKeeperConfigurationProvider.java,41,15,0,2,0,17
 pulsar-master\pulsar-master\pulsar-io\influxdb\src\main\java\org\apache\pulsar\io\influxdb\v2\InfluxDBClientBuilder.java,0,1,0,1,0,2
 pulsar-master\pulsar-master\pulsar-testclient\src\main\java\org\apache\pulsar\testclient\BrokerMonitor.java,439,162,2,83,0,247
 pulsar-master\pulsar-master\pulsar-client-api\src\main\java\org\apache\pulsar\client\api\TypedMessageBuilder.java,0,31,0,21,0,52
 pulsar-master\pulsar-master\pulsar-config-validation\src\main\java\org\apache\pulsar\config\validation\ConfigValidationUtils.java,155,37,1,19,0,57
 pulsar-master\pulsar-master\pulsar-broker\src\main\java\org\apache\pulsar\broker\stats\prometheus\ManagedLedgerStats.java,28,23,0,4,0,27
 pulsar-master\pulsar-master\pulsar-client\src\main\java\org\apache\pulsar\client\impl\schema\generic\GenericAvroSchema.java,42,12,2,5,0,19
 pulsar-master\pulsar-master\pulsar-io\redis\src\main\java\org\apache\pulsar\io\redis\sink\package-info.java,0,1,0,1,0,2
 pulsar-master\pulsar-master\pulsar-package-management\core\src\main\java\org\apache\pulsar\packages\management\core\impl\DefaultPackagesStorageConfiguration.java,20,10,0,2,0,12
 pulsar-master\pulsar-master\managed-ledger\src\main\java\org\apache\bookkeeper\mledger\package-info.java,0,1,0,1,0,2
 pulsar-master\pulsar-master\pulsar-client\src\test\java\org\apache\pulsar\client\tutorial\ContinuousProducer.java,22,7,1,4,0,12
 pulsar-master\pulsar-master\pulsar-broker\src\main\java\org\apache\pulsar\compaction\CompactionRecord.java,105,56,0,4,0,60
 pulsar-master\pulsar-master\pulsar-broker\src\test\java\org\apache\pulsar\client\api\ProducerQueueSizeTest.java,60,12,0,2,0,14
 pulsar-master\pulsar-master\pulsar-metadata\src\main\java\org\apache\pulsar\metadata\api\MetadataCache.java,0,16,0,15,0,31
 pulsar-master\pulsar-master\pulsar-broker\src\main\java\org\apache\pulsar\broker\intercept\package-info.java,0,2,0,1,0,3
 pulsar-master\pulsar-master\pulsar-client-admin-api\src\main\java\org\apache\pulsar\common\functions\WorkerInfo.java,28,12,0,3,0,15
 pulsar-master\pulsar-master\pulsar-package-management\bookkeeper-storage\src\test\java\org\apache\pulsar\packages\management\storage\bookkeeper\bookkeeper\test\ZooKeeperUtil.java,94,36,1,10,0,47
 pulsar-master\pulsar-master\pulsar-functions\worker\src\main\java\org\apache\pulsar\functions\worker\rest\api\v3\FunctionsApiV3Resource.java,342,177,3,89,0,269
 pulsar-master\pulsar-master\pulsar-proxy\src\test\java\org\apache\pulsar\proxy\server\ProxyTlsTestWithAuth.java,62,25,5,11,0,41
 pulsar-master\pulsar-master\pulsar-broker\src\main\java\org\apache\pulsar\broker\namespace\NamespaceBundleOwnershipListener.java,0,1,0,2,0,3
 pulsar-master\pulsar-master\tests\bc_2_0_0\src\test\java\org\apache\pulsar\tests\integration\SmokeTest.java,50,6,0,1,0,7
 pulsar-master\pulsar-master\pulsar-broker\src\test\java\org\apache\pulsar\functions\worker\PulsarFunctionTlsTest.java,205,69,3,28,0,100
 pulsar-master\pulsar-master\pulsar-proxy\src\main\java\org\apache\pulsar\proxy\server\TargetAddressDeniedException.java,0,2,0,1,0,3
 pulsar-master\pulsar-master\pulsar-functions\instance\src\main\java\org\apache\pulsar\functions\windowing\WaterMarkEventGenerator.java,114,41,2,11,0,54
 pulsar-master\pulsar-master\pulsar-common\src\test\java\org\apache\pulsar\common\policies\data\NamespaceOwnershipStatusTest.java,32,11,5,8,0,24
 pulsar-master\pulsar-master\pulsar-client-api\src\main\java\org\apache\pulsar\client\api\schema\FieldSchemaBuilder.java,0,2,0,1,0,3
 pulsar-master\pulsar-master\pulsar-metadata\src\main\java\org\apache\pulsar\metadata\api\MetadataStoreConfig.java,45,1,0,2,0,3
 pulsar-master\pulsar-master\pulsar-common\src\main\java\org\apache\pulsar\common\protocol\schema\SchemaStorage.java,0,8,0,1,0,9
 pulsar-master\pulsar-master\pulsar-io\influxdb\src\test\java\org\apache\pulsar\io\influxdb\v2\InfluxDBSinkConfigTest.java,74,13,0,2,0,15
 pulsar-master\pulsar-master\buildtools\src\main\java\org\apache\pulsar\tests\ThreadLeakDetectorListener.java,84,31,3,13,0,47
 pulsar-master\pulsar-master\pulsar-broker\src\main\java\org\apache\pulsar\broker\admin\v2\Brokers.java,3,1,0,2,0,3
 pulsar-master\pulsar-master\pulsar-broker\src\main\java\org\apache\pulsar\broker\service\PulsarChannelInitializer.java,143,44,2,23,0,69
 pulsar-master\pulsar-master\pulsar-io\hdfs3\src\main\java\org\apache\pulsar\io\hdfs3\sink\text\package-info.java,0,1,0,1,0,2
 pulsar-master\pulsar-master\pulsar-transaction\coordinator\src\main\java\org\apache\pulsar\transaction\coordinator\TransactionCoordinatorID.java,13,2,0,1,0,3
 pulsar-master\pulsar-master\pulsar-io\netty\src\main\java\org\apache\pulsar\io\netty\package-info.java,0,1,0,1,0,2
 pulsar-master\pulsar-master\pulsar-broker\src\main\java\org\apache\pulsar\broker\intercept\BrokerInterceptorUtils.java,124,37,2,25,0,64
 pulsar-master\pulsar-master\pulsar-sql\presto-pulsar\src\main\java\org\apache\pulsar\sql\presto\PulsarConnectorConfig.java,429,262,0,40,0,302
 pulsar-master\pulsar-master\pulsar-package-management\core\src\test\java\org\apache\pulsar\packages\management\core\MockedPackagesStorage.java,82,22,3,5,0,30
 pulsar-master\pulsar-master\pulsar-proxy\src\main\java\org\apache\pulsar\proxy\extensions\ProxyExtensions.java,107,35,4,21,0,60
 pulsar-master\pulsar-master\pulsar-broker\src\test\java\org\apache\pulsar\broker\service\MessageIdSerializationTest.java,27,4,0,1,0,5
 pulsar-master\pulsar-master\pulsar-client\src\main\java\org\apache\pulsar\client\impl\ConsumerInterceptors.java,157,68,8,46,0,122
 pulsar-master\pulsar-master\pulsar-client-admin-api\src\main\java\org\apache\pulsar\common\policies\data\AutoSubscriptionCreationOverride.java,0,5,0,3,0,8
 pulsar-master\pulsar-master\pulsar-client-admin\src\main\java\org\apache\pulsar\client\admin\internal\TopicPoliciesImpl.java,1380,708,0,217,0,925
 pulsar-master\pulsar-master\pulsar-broker\src\test\java\org\apache\pulsar\client\processor\CustomBatchFormat.java,41,9,1,1,0,11
 pulsar-master\pulsar-master\pulsar-io\influxdb\src\main\java\org\apache\pulsar\io\influxdb\v2\InfluxDBSinkConfig.java,0,25,0,9,0,34
 pulsar-master\pulsar-master\pulsar-sql\presto-pulsar\src\test\java\org\apache\pulsar\sql\presto\TestPulsarSplitManager.java,424,155,22,117,0,294
 pulsar-master\pulsar-master\pulsar-broker\src\main\java\org\apache\pulsar\broker\loadbalance\LeaderElectionService.java,34,19,0,3,0,22
 pulsar-master\pulsar-master\pulsar-broker\src\main\java\org\apache\pulsar\broker\admin\v2\Worker.java,161,72,3,22,0,97
 pulsar-master\pulsar-master\pulsar-zookeeper-utils\src\main\java\org\apache\pulsar\stats\package-info.java,0,0,0,1,0,1
 pulsar-master\pulsar-master\pulsar-sql\presto-pulsar\src\main\java\org\apache\pulsar\sql\presto\decoder\primitive\package-info.java,0,3,0,2,0,5
 pulsar-master\pulsar-master\pulsar-functions\worker\src\test\java\org\apache\pulsar\functions\worker\LeaderServiceTest.java,210,40,5,19,0,64
 pulsar-master\pulsar-master\pulsar-broker\src\main\java\org\apache\pulsar\broker\resourcegroup\ResourceGroupConfigListener.java,114,38,6,18,0,62
 pulsar-master\pulsar-master\pulsar-broker\src\test\java\org\apache\pulsar\broker\service\schema\ProtobufSchemaCompatibilityCheckTest.java,8,3,0,2,0,5
 pulsar-master\pulsar-master\pulsar-zookeeper-utils\src\test\java\org\apache\pulsar\zookeeper\LocalBookkeeperEnsembleTest.java,47,8,3,6,0,17
 pulsar-master\pulsar-master\pulsar-broker\src\test\java\org\apache\pulsar\websocket\proxy\MockUnauthenticationProvider.java,15,4,0,2,0,6
 pulsar-master\pulsar-master\pulsar-client\src\main\java\org\apache\pulsar\client\impl\ConsumerBase.java,1033,373,22,142,0,537
 pulsar-master\pulsar-master\pulsar-broker\src\main\java\org\apache\pulsar\broker\BundleData.java,84,26,1,5,0,32
 pulsar-master\pulsar-master\managed-ledger\src\main\java\org\apache\bookkeeper\mledger\ManagedLedgerException.java,165,73,0,16,0,89
 pulsar-master\pulsar-master\managed-ledger\src\main\java\org\apache\bookkeeper\mledger\offload\OffloaderDefinition.java,19,0,0,1,0,1
 pulsar-master\pulsar-master\pulsar-broker\src\main\java\org\apache\pulsar\broker\admin\impl\SinksBase.java,531,320,47,213,0,580
 pulsar-master\pulsar-master\pulsar-client\src\main\java\org\apache\pulsar\client\impl\HttpLookupService.java,157,57,3,29,0,89
 pulsar-master\pulsar-master\pulsar-broker\src\main\java\org\apache\pulsar\broker\transaction\exception\pendingack\TransactionPendingAckException.java,28,11,0,3,0,14
 pulsar-master\pulsar-master\pulsar-client\src\main\java\org\apache\pulsar\client\impl\NonPersistentAcknowledgmentGroupingTracker.java,46,17,1,5,0,23
 pulsar-master\pulsar-master\pulsar-client\src\test\java\org\apache\pulsar\client\impl\schema\generic\GenericJsonRecordTest.java,87,40,0,10,0,50
 pulsar-master\pulsar-master\pulsar-io\twitter\src\main\java\org\apache\pulsar\io\twitter\data\package-info.java,0,1,0,1,0,2
 pulsar-master\pulsar-master\pulsar-client\src\main\java\org\apache\pulsar\client\impl\TransactionMetaStoreHandler.java,0,209,6,105,0,320
 pulsar-master\pulsar-master\pulsar-io\elastic-search\src\test\java\org\apache\pulsar\io\elasticsearch\opensearch\OpenSearchSinkTests.java,7,1,0,1,0,2
 pulsar-master\pulsar-master\pulsar-metadata\src\main\java\org\apache\pulsar\metadata\bookkeeper\PulsarLedgerManager.java,369,130,5,71,0,206
 pulsar-master\pulsar-master\pulsar-client\src\main\java\org\apache\pulsar\client\impl\schema\generic\GenericJsonSchema.java,32,11,2,3,0,16
 pulsar-master\pulsar-master\pulsar-io\elastic-search\src\main\java\org\apache\pulsar\io\elasticsearch\ElasticSearchSink.java,243,60,6,26,0,92
 pulsar-master\pulsar-master\pulsar-client\src\main\java\org\apache\pulsar\client\impl\BackoffBuilder.java,40,30,0,3,0,33
 pulsar-master\pulsar-master\pulsar-broker\src\test\java\org\apache\pulsar\client\api\TopicReaderTest.java,1558,326,21,176,0,523
 pulsar-master\pulsar-master\pulsar-io\kafka-connect-adaptor\src\main\java\org\apache\pulsar\io\kafka\connect\schema\PulsarSchemaToKafkaSchema.java,69,29,1,15,0,45
 pulsar-master\pulsar-master\tests\integration\src\test\java\org\apache\pulsar\tests\integration\containers\DebeziumMySQLContainer.java,34,9,0,2,0,11
 pulsar-master\pulsar-master\tests\integration\src\test\java\org\apache\pulsar\tests\integration\topologies\PulsarStandaloneTestBase.java,86,28,4,13,0,45
 pulsar-master\pulsar-master\pulsar-broker-common\src\main\java\org\apache\pulsar\broker\ClassLoaderSwitcher.java,14,7,0,3,0,10
 pulsar-master\pulsar-master\pulsar-client-tools-test\src\test\java\org\apache\pulsar\client\cli\DocumentTest.java,38,9,0,5,0,14
 pulsar-master\pulsar-master\pulsar-broker\src\main\java\org\apache\pulsar\broker\intercept\BrokerInterceptor.java,0,40,9,13,0,62
 pulsar-master\pulsar-master\pulsar-client-1x-base\pulsar-client-1x\src\main\java\org\apache\pulsar\client\api\Consumer.java,0,49,0,49,0,98
 pulsar-master\pulsar-master\pulsar-client\src\main\java\org\apache\pulsar\client\impl\schema\reader\JacksonJsonReader.java,36,16,0,2,0,18
 pulsar-master\pulsar-master\pulsar-broker\src\test\java\org\apache\pulsar\broker\service\SystemTopicBasedTopicPoliciesServiceTest.java,0,133,4,81,0,218
 pulsar-master\pulsar-master\pulsar-functions\worker\src\main\java\org\apache\pulsar\functions\worker\dlog\package-info.java,0,0,0,1,0,1
 pulsar-master\pulsar-master\pulsar-proxy\src\main\java\org\apache\pulsar\proxy\server\ProxyClientCnx.java,34,29,0,8,0,37
 pulsar-master\pulsar-master\pulsar-common\src\test\java\org\apache\pulsar\common\policies\data\AutoTopicCreationOverrideTest.java,60,12,0,8,0,20
 pulsar-master\pulsar-master\pulsar-broker-common\src\test\java\org\apache\pulsar\broker\authorization\MultiRolesTokenAuthorizationProviderTest.java,70,15,2,11,0,28
 pulsar-master\pulsar-master\pulsar-io\jdbc\core\src\main\java\org\apache\pulsar\io\jdbc\package-info.java,0,1,0,1,0,2
 pulsar-master\pulsar-master\pulsar-broker\src\main\java\org\apache\pulsar\broker\transaction\buffer\impl\TransactionEntryImpl.java,111,41,0,1,0,42
 pulsar-master\pulsar-master\pulsar-metadata\src\main\java\org\apache\pulsar\metadata\coordination\impl\package-info.java,0,0,0,1,0,1
 pulsar-master\pulsar-master\pulsar-broker\src\test\java\org\apache\pulsar\broker\loadbalance\SimpleLoadManagerImplTest.java,398,185,5,52,0,242
 pulsar-master\pulsar-master\pulsar-functions\runtime\src\main\java\org\apache\pulsar\functions\worker\package-info.java,0,1,0,1,0,2
 pulsar-master\pulsar-master\pulsar-broker\src\main\java\org\apache\pulsar\broker\service\AbstractTopic.java,0,444,22,228,0,694
 pulsar-master\pulsar-master\pulsar-broker\src\test\java\org\apache\pulsar\socks5\handler\IdleHandler.java,13,4,0,2,0,6
 pulsar-master\pulsar-master\pulsar-broker\src\test\java\org\apache\pulsar\broker\stats\prometheus\AggregatedNamespaceStatsTest.java,135,89,0,7,0,96
 pulsar-master\pulsar-master\pulsar-client\src\main\java\org\apache\pulsar\client\impl\schema\reader\AvroReader.java,78,35,0,10,0,45
 pulsar-master\pulsar-master\managed-ledger\src\main\java\org\apache\bookkeeper\mledger\ManagedLedgerInfo.java,62,48,0,1,0,49
 pulsar-master\pulsar-master\pulsar-broker\src\test\java\org\apache\pulsar\io\PulsarSinkE2ETest.java,453,144,2,100,0,246
 pulsar-master\pulsar-master\pulsar-broker\src\test\java\org\apache\pulsar\broker\service\BrokerBookieIsolationTest.java,770,203,15,163,0,381
 pulsar-master\pulsar-master\pulsar-client\src\main\java\org\apache\pulsar\client\impl\schema\generic\GenericJsonWriter.java,18,5,0,2,0,7
 pulsar-master\pulsar-master\pulsar-sql\presto-pulsar\src\test\java\org\apache\pulsar\sql\presto\TestNoStrictCacheSizeAllocator.java,22,18,0,7,0,25
 pulsar-master\pulsar-master\pulsar-client\src\main\java\org\apache\pulsar\client\impl\MessageIdImpl.java,225,92,3,24,0,119
 pulsar-master\pulsar-master\pulsar-functions\runtime\src\main\java\org\apache\pulsar\functions\runtime\RuntimeUtils.java,453,171,7,95,0,273
 pulsar-master\pulsar-master\pulsar-broker\src\main\java\org\apache\pulsar\broker\rest\TopicsBase.java,671,236,10,179,0,425
 pulsar-master\pulsar-master\pulsar-io\elastic-search\src\test\java\org\apache\pulsar\io\elasticsearch\ElasticSearchConfigTests.java,240,53,0,15,0,68
 pulsar-master\pulsar-master\pulsar-client-api\src\main\java\org\apache\pulsar\client\api\schema\KeyValueSchema.java,0,0,0,1,0,1
 pulsar-master\pulsar-master\pulsar-functions\worker\src\test\java\org\apache\pulsar\functions\worker\rest\api\v2\FunctionApiV2ResourceTest.java,1402,334,11,172,0,517
 pulsar-master\pulsar-master\pulsar-functions\worker\src\main\java\org\apache\pulsar\functions\worker\service\api\Functions.java,0,39,0,13,0,52
 pulsar-master\pulsar-master\pulsar-common\src\main\java\org\apache\pulsar\common\util\collections\ConcurrentLongHashMap.java,582,208,24,32,0,264
 pulsar-master\pulsar-master\pulsar-io\docs\src\main\java\org\apache\pulsar\io\docs\package-info.java,0,1,0,1,0,2
 pulsar-master\pulsar-master\pulsar-client-api\src\main\java\org\apache\pulsar\client\api\ProxyProtocol.java,0,2,0,3,0,5
 pulsar-master\pulsar-master\pulsar-broker\src\test\java\org\apache\pulsar\common\naming\NamespaceBundleSplitAlgorithmTest.java,17,11,0,12,0,23
 pulsar-master\pulsar-master\pulsar-client-admin-api\src\main\java\org\apache\pulsar\common\policies\data\impl\AutoSubscriptionCreationOverrideImpl.java,23,12,0,4,0,16
 pulsar-master\pulsar-master\pulsar-client-admin-api\src\main\java\org\apache\pulsar\common\policies\data\DispatchRate.java,0,12,0,3,0,15
 pulsar-master\pulsar-master\pulsar-broker\src\main\java\org\apache\pulsar\broker\service\GracefulExecutorServicesShutdown.java,77,25,1,13,0,39
 pulsar-master\pulsar-master\tiered-storage\jcloud\src\test\java\org\apache\bookkeeper\mledger\offload\jcloud\provider\TieredStorageConfigurationTests.java,182,62,8,23,0,93
 pulsar-master\pulsar-master\pulsar-client\src\main\java\org\apache\pulsar\client\impl\schema\TimestampSchema.java,53,10,1,1,0,12
 pulsar-master\pulsar-master\pulsar-broker-common\src\main\java\org\apache\pulsar\broker\web\JsonMapperProvider.java,9,4,0,1,0,5
 pulsar-master\pulsar-master\pulsar-functions\utils\src\main\java\org\apache\pulsar\functions\utils\Actions.java,110,25,5,5,0,35
 pulsar-master\pulsar-master\pulsar-functions\java-examples\src\main\java\org\apache\pulsar\functions\api\examples\pojo\Users.java,21,5,0,1,0,6
 pulsar-master\pulsar-master\pulsar-metadata\src\main\java\org\apache\pulsar\metadata\api\coordination\CoordinationService.java,0,8,0,4,0,12
 pulsar-master\pulsar-master\pulsar-sql\presto-pulsar\src\main\java\org\apache\pulsar\sql\presto\util\NoStrictCacheSizeAllocator.java,58,10,0,1,0,11
 pulsar-master\pulsar-master\tests\integration\src\test\java\org\apache\pulsar\tests\integration\io\sinks\OpenSearchSinkTester.java,42,14,1,6,0,21
 pulsar-master\pulsar-master\tests\integration\src\test\java\org\apache\pulsar\tests\integration\io\sinks\HdfsSinkTester.java,35,16,0,4,0,20
 pulsar-master\pulsar-master\pulsar-functions\utils\src\main\java\org\apache\pulsar\functions\utils\ValidatorUtils.java,214,84,8,60,0,152
 pulsar-master\pulsar-master\pulsar-common\src\test\java\org\apache\pulsar\common\policies\data\AutoFailoverPolicyTypeTest.java,9,3,1,2,0,6
 pulsar-master\pulsar-master\pulsar-client-api\src\main\java\org\apache\pulsar\client\api\PulsarClientException.java,1109,166,2,68,0,236
 pulsar-master\pulsar-master\pulsar-io\elastic-search\src\test\java\org\apache\pulsar\io\elasticsearch\IndexNameFormatterTest.java,24,6,0,1,0,7
 pulsar-master\pulsar-master\pulsar-broker\src\main\java\org\apache\pulsar\broker\protocol\ProtocolHandlerWithClassLoader.java,0,13,0,9,0,22
 pulsar-master\pulsar-master\pulsar-broker\src\test\java\org\apache\pulsar\socks5\handler\PasswordAuthRequestHandler.java,20,9,0,5,0,14
 pulsar-master\pulsar-master\pulsar-client-admin-api\src\main\java\org\apache\pulsar\common\protocol\schema\IsCompatibilityResponse.java,6,4,0,1,0,5
 pulsar-master\pulsar-master\pulsar-broker\src\main\java\org\apache\pulsar\broker\admin\v3\Packages.java,194,81,3,27,0,111
 pulsar-master\pulsar-master\pulsar-io\kafka-connect-adaptor\src\main\java\org\apache\pulsar\io\kafka\connect\schema\KafkaSchemaWrappedSchema.java,0,9,2,2,0,13
 pulsar-master\pulsar-master\pulsar-broker-common\src\test\java\org\apache\pulsar\broker\web\plugin\servlet\AdditionalServletWithClassLoaderTest.java,16,2,0,2,0,4
 pulsar-master\pulsar-master\pulsar-broker\src\test\java\org\apache\pulsar\client\impl\PulsarMultiHostClientTest.java,125,23,1,12,0,36
 pulsar-master\pulsar-master\pulsar-functions\runtime\src\main\java\org\apache\pulsar\functions\worker\ConnectorsManager.java,45,31,2,6,0,39
 pulsar-master\pulsar-master\pulsar-functions\instance\src\test\java\org\apache\pulsar\functions\instance\JavaInstanceTest.java,205,42,1,23,0,66
 pulsar-master\pulsar-master\tests\integration\src\test\java\org\apache\pulsar\tests\integration\backwardscompatibility\ClientTest2_5.java,12,8,1,4,0,13
 pulsar-master\pulsar-master\tests\integration\src\test\java\org\apache\pulsar\tests\integration\io\sources\PulsarSourcePropertyTest.java,0,18,1,8,0,27
 pulsar-master\pulsar-master\pulsar-metadata\src\main\java\org\apache\pulsar\metadata\api\coordination\package-info.java,0,0,0,1,0,1
 pulsar-master\pulsar-master\pulsar-common\src\main\java\org\apache\pulsar\common\util\Hash.java,0,1,0,1,0,2
 pulsar-master\pulsar-master\pulsar-broker\src\test\java\org\apache\pulsar\broker\web\plugin\servlet\AdditionalServletWithPulsarServiceTest.java,35,11,0,11,0,22
 pulsar-master\pulsar-master\pulsar-broker\src\test\java\org\apache\pulsar\broker\service\ExclusiveProducerTest.java,297,67,6,24,0,97
 pulsar-master\pulsar-master\pulsar-io\data-generator\src\main\java\org\apache\pulsar\io\datagenerator\Person.java,66,48,2,9,0,59
 pulsar-master\pulsar-master\managed-ledger\src\test\java\org\apache\bookkeeper\mledger\impl\ManagedLedgerTerminationTest.java,129,16,4,3,0,23
 pulsar-master\pulsar-master\tiered-storage\jcloud\src\test\java\org\apache\bookkeeper\mledger\offload\jcloud\provider\AbstractJCloudBlobStoreFactoryTest.java,77,63,1,13,0,77
 pulsar-master\pulsar-master\pulsar-client-tools\src\main\java\org\apache\pulsar\admin\cli\CmdNonPersistentTopics.java,120,31,0,20,0,51
 pulsar-master\pulsar-master\pulsar-broker-common\src\main\java\org\apache\pulsar\broker\authorization\MultiRolesTokenAuthorizationProvider.java,222,124,1,59,0,184
 pulsar-master\pulsar-master\pulsar-broker-common\src\main\java\org\apache\pulsar\broker\web\WebExecutorThreadPool.java,19,8,0,1,0,9
 pulsar-master\pulsar-master\pulsar-functions\utils\src\main\java\org\apache\pulsar\functions\utils\functioncache\FunctionCacheEntry.java,83,35,1,11,0,47
 pulsar-master\pulsar-master\pulsar-broker\src\test\java\org\apache\pulsar\broker\admin\CreateSubscriptionTest.java,307,83,2,59,0,144
 pulsar-master\pulsar-master\tests\pulsar-client-all-shade-test\src\test\java\org\apache\pulsar\tests\integration\SimpleProducerConsumerTest.java,534,180,11,112,0,303
 pulsar-master\pulsar-master\pulsar-broker\src\main\java\org\apache\pulsar\broker\service\persistent\MessageDeduplication.java,455,153,14,75,0,242
 pulsar-master\pulsar-master\tests\integration\src\test\java\org\apache\pulsar\tests\integration\docker\ContainerExecException.java,13,11,0,3,0,14
 pulsar-master\pulsar-master\pulsar-broker\src\main\java\org\apache\pulsar\broker\namespace\OwnedBundle.java,140,44,3,23,0,70
 pulsar-master\pulsar-master\pulsar-broker\src\test\java\org\apache\pulsar\websocket\proxy\ProxyConfigurationTest.java,40,16,0,6,0,22
 pulsar-master\pulsar-master\pulsar-common\src\main\java\org\apache\pulsar\common\intercept\BrokerEntryMetadataUtils.java,54,20,3,11,0,34
 pulsar-master\pulsar-master\pulsar-io\kafka-connect-adaptor\src\main\java\org\apache\pulsar\io\kafka\connect\schema\KafkaConnectData.java,125,28,6,18,0,52
 pulsar-master\pulsar-master\pulsar-broker\src\main\java\org\apache\pulsar\broker\protocol\ProtocolHandlerUtils.java,0,35,2,22,0,59
 pulsar-master\pulsar-master\pulsar-functions\instance\src\main\java\org\apache\pulsar\functions\windowing\TimestampExtractor.java,0,1,0,1,0,2
 pulsar-master\pulsar-master\pulsar-common\src\main\java\org\apache\pulsar\common\util\keystoretls\NetSslContextBuilder.java,62,38,1,5,0,44
 pulsar-master\pulsar-master\managed-ledger\src\test\java\org\apache\bookkeeper\mledger\util\PositionAckSetUtilTest.java,81,25,0,7,0,32
 pulsar-master\pulsar-master\pulsar-functions\java-examples\src\main\java\org\apache\pulsar\functions\api\examples\window\UserConfigWindowFunction.java,0,6,0,4,0,10
 pulsar-master\pulsar-master\pulsar-common\src\test\java\org\apache\pulsar\common\policies\data\PartitionedTopicStatsTest.java,31,5,1,4,0,10
 pulsar-master\pulsar-master\pulsar-broker\src\main\java\org\apache\pulsar\broker\admin\v1\Properties.java,3,1,0,2,0,3
 pulsar-master\pulsar-master\pulsar-io\flume\src\test\java\org\apache\pulsar\io\flume\node\TestApplication.java,159,24,0,5,0,29
 pulsar-master\pulsar-master\pulsar-functions\api-java\src\test\java\org\apache\pulsar\functions\api\utils\JavaSerDeTest.java,23,6,0,2,0,8
 pulsar-master\pulsar-master\pulsar-sql\presto-pulsar\src\main\java\org\apache\pulsar\sql\presto\decoder\avro\PulsarAvroColumnDecoder.java,313,74,0,30,0,104
 pulsar-master\pulsar-master\pulsar-functions\runtime\src\main\java\org\apache\pulsar\functions\runtime\JavaInstanceStarter.java,329,150,17,67,0,234
 pulsar-master\pulsar-master\pulsar-functions\runtime\src\main\java\org\apache\pulsar\functions\runtime\process\package-info.java,0,1,0,1,0,2
 pulsar-master\pulsar-master\pulsar-sql\presto-pulsar\src\main\java\org\apache\pulsar\sql\presto\decoder\primitive\PulsarPrimitiveRowDecoder.java,49,23,1,17,0,41
 pulsar-master\pulsar-master\pulsar-metadata\src\main\java\org\apache\pulsar\metadata\api\Notification.java,0,0,0,1,0,1
 pulsar-master\pulsar-master\pulsar-io\data-generator\src\main\java\org\apache\pulsar\io\datagenerator\package-info.java,0,1,0,1,0,2
 pulsar-master\pulsar-master\pulsar-client-admin-api\src\main\java\org\apache\pulsar\client\admin\Clusters.java,0,69,2,40,0,111
 pulsar-master\pulsar-master\pulsar-transaction\coordinator\src\main\java\org\apache\pulsar\transaction\coordinator\TransactionSubscription.java,33,8,0,2,0,10
 pulsar-master\pulsar-master\pulsar-broker\src\main\java\org\apache\pulsar\broker\loadbalance\LoadManager.java,0,22,0,10,0,32
 pulsar-master\pulsar-master\pulsar-proxy\src\main\java\org\apache\pulsar\proxy\server\DirectProxyHandler.java,359,146,5,73,0,224
 pulsar-master\pulsar-master\pulsar-broker\src\main\java\org\apache\pulsar\broker\TimeAverageBrokerData.java,77,16,0,9,0,25
 pulsar-master\pulsar-master\pulsar-io\file\src\test\java\org\apache\pulsar\io\file\AbstractFileTests.java,92,51,0,12,0,63
 pulsar-master\pulsar-master\pulsar-metadata\src\main\java\org\apache\pulsar\metadata\bookkeeper\AbstractHierarchicalLedgerManager.java,188,47,2,16,0,65
 pulsar-master\pulsar-master\pulsar-common\src\test\java\org\apache\pulsar\common\policies\data\ReplicatorStatsTest.java,36,16,1,1,0,18
 pulsar-master\pulsar-master\pulsar-common\src\test\java\org\apache\pulsar\common\policies\data\NonPersistentPartitionedTopicStatsTest.java,31,9,0,13,0,22
 pulsar-master\pulsar-master\pulsar-functions\utils\src\main\java\org\apache\pulsar\functions\utils\io\package-info.java,0,0,0,1,0,1
 pulsar-master\pulsar-master\pulsar-common\src\main\java\org\apache\pulsar\common\api\raw\RawMessage.java,0,10,0,10,0,20
 pulsar-master\pulsar-master\pulsar-io\batch-discovery-triggerers\src\main\java\org\apache\pulsar\io\batchdiscovery\ImmediateTriggerer.java,18,6,2,2,0,10
 pulsar-master\pulsar-master\pulsar-functions\worker\src\main\java\org\apache\pulsar\functions\worker\FunctionRuntimeManager.java,936,335,15,209,0,559
 pulsar-master\pulsar-master\pulsar-broker\src\main\java\org\apache\pulsar\broker\loadbalance\impl\LinuxBrokerHostUsageImpl.java,250,86,4,34,0,124
 pulsar-master\pulsar-master\pulsar-io\aerospike\src\main\java\org\apache\pulsar\io\aerospike\package-info.java,0,1,0,1,0,2
 pulsar-master\pulsar-master\pulsar-client-tools\src\main\java\org\apache\pulsar\admin\cli\CmdProxyStats.java,41,13,0,5,0,18
 pulsar-master\pulsar-master\pulsar-broker\src\test\java\org\apache\pulsar\broker\protocol\ProtocolHandlerUtilsTest.java,101,19,2,18,0,39
 pulsar-master\pulsar-master\tests\integration\src\test\java\org\apache\pulsar\tests\integration\messaging\PersistentTopicMessagingTest.java,44,24,0,9,0,33
 pulsar-master\pulsar-master\pulsar-client\src\main\java\org\apache\pulsar\client\impl\BatchMessageContainerBase.java,0,5,0,6,0,11
 pulsar-master\pulsar-master\pulsar-io\hdfs3\src\main\java\org\apache\pulsar\io\hdfs3\sink\text\HdfsStringSink.java,0,3,0,2,0,5
 pulsar-master\pulsar-master\pulsar-broker\src\main\java\org\apache\pulsar\broker\ManagedLedgerClientFactory.java,128,57,2,37,0,96
 pulsar-master\pulsar-master\pulsar-io\nsq\src\main\java\org\apache\pulsar\io\nsq\NSQSource.java,0,17,2,6,0,25
 pulsar-master\pulsar-master\pulsar-functions\instance\src\main\java\org\apache\pulsar\functions\source\RecordWithEncryptionContext.java,0,0,0,1,0,1
 pulsar-master\pulsar-master\pulsar-broker-common\src\main\java\org\apache\pulsar\broker\authentication\AuthenticationDataHttps.java,24,7,1,2,0,10
 pulsar-master\pulsar-master\pulsar-io\nsq\src\main\java\org\apache\pulsar\io\nsq\package-info.java,0,1,0,1,0,2
 pulsar-master\pulsar-master\tests\integration\src\test\java\org\apache\pulsar\tests\integration\containers\BKContainer.java,11,5,0,2,0,7
 pulsar-master\pulsar-master\pulsar-client-api\src\main\java\org\apache\pulsar\client\api\ProducerBuilder.java,0,122,2,119,0,243
 pulsar-master\pulsar-master\pulsar-io\kafka\src\test\java\org\apache\pulsar\io\kafka\sink\KafkaAbstractSinkTest.java,204,53,9,16,0,78
 pulsar-master\pulsar-master\tests\integration\src\test\java\org\apache\pulsar\tests\integration\presto\TestPulsarSQLBase.java,255,88,9,38,0,135
 pulsar-master\pulsar-master\pulsar-io\jdbc\core\src\main\java\org\apache\pulsar\io\jdbc\JdbcUtils.java,0,89,2,20,0,111
 pulsar-master\pulsar-master\pulsar-broker\src\main\java\org\apache\pulsar\broker\admin\v3\Sources.java,3,0,0,1,0,1
 pulsar-master\pulsar-master\pulsar-io\mongo\src\main\java\org\apache\pulsar\io\mongodb\MongoSource.java,115,24,5,7,0,36
 pulsar-master\pulsar-master\managed-ledger\src\test\java\org\apache\bookkeeper\test\MockedBookKeeperTestCase.java,109,34,3,6,0,43
 pulsar-master\pulsar-master\pulsar-broker\src\test\java\org\apache\pulsar\broker\auth\SameThreadOrderedSafeExecutor.java,32,10,0,1,0,11
 pulsar-master\pulsar-master\pulsar-broker\src\main\java\org\apache\pulsar\broker\intercept\ManagedLedgerInterceptorImpl.java,156,66,3,36,0,105
 pulsar-master\pulsar-master\pulsar-client-tools\src\test\java\org\apache\pulsar\admin\cli\TestRunMain.java,20,3,0,2,0,5
 pulsar-master\pulsar-master\pulsar-common\src\main\java\org\apache\pulsar\common\protocol\schema\package-info.java,0,2,0,1,0,3
 pulsar-master\pulsar-master\pulsar-client\src\main\java\org\apache\pulsar\client\impl\PersistentAcknowledgmentsGroupingTracker.java,647,220,13,135,0,368
 pulsar-master\pulsar-master\pulsar-client-admin-api\src\main\java\org\apache\pulsar\common\policies\data\impl\DelayedDeliveryPoliciesImpl.java,0,17,0,3,0,20
 pulsar-master\pulsar-master\pulsar-transaction\coordinator\src\main\java\org\apache\pulsar\transaction\coordinator\impl\TxnMetaImpl.java,0,23,1,8,0,32
 pulsar-master\pulsar-master\pulsar-client-tools\src\main\java\org\apache\pulsar\admin\cli\CmdTenants.java,128,22,0,9,0,31
 pulsar-master\pulsar-master\pulsar-broker\src\test\java\org\apache\pulsar\PulsarClusterMetadataTeardownTest.java,35,3,1,3,0,7
 pulsar-master\pulsar-master\tests\integration\src\test\java\org\apache\pulsar\tests\integration\standalone\SmokeTest.java,9,5,0,2,0,7
 pulsar-master\pulsar-master\pulsar-broker\src\main\java\org\apache\pulsar\broker\stats\ClusterReplicationMetrics.java,61,41,0,8,0,49
 pulsar-master\pulsar-master\pulsar-io\mongo\src\main\java\org\apache\pulsar\io\mongodb\MongoConfig.java,69,23,4,9,0,36
 pulsar-master\pulsar-master\tiered-storage\jcloud\src\main\java\org\apache\bookkeeper\mledger\offload\jcloud\package-info.java,0,1,0,1,0,2
 pulsar-master\pulsar-master\pulsar-metadata\src\test\java\org\apache\pulsar\metadata\bookkeeper\PulsarRegistrationManagerTest.java,195,78,1,24,0,103
 pulsar-master\pulsar-master\pulsar-client\src\main\java\org\apache\pulsar\client\impl\schema\generic\AvroRecordBuilderImpl.java,0,19,0,7,0,26
 pulsar-master\pulsar-master\pulsar-client\src\main\java\org\apache\pulsar\client\impl\auth\oauth2\protocol\ClientCredentialsExchanger.java,0,1,0,2,0,3
 pulsar-master\pulsar-master\pulsar-client-admin-api\src\main\java\org\apache\pulsar\common\policies\data\TransactionPendingAckStats.java,6,1,0,1,0,2
 pulsar-master\pulsar-master\managed-ledger\src\main\java\org\apache\bookkeeper\mledger\util\PositionAckSetUtil.java,71,24,1,15,0,40
 pulsar-master\pulsar-master\pulsar-client-admin-api\src\main\java\org\apache\pulsar\client\admin\GetStatsOptions.java,17,0,0,1,0,1
 pulsar-master\pulsar-master\pulsar-broker\src\test\java\org\apache\pulsar\client\api\SimpleProducerConsumerStatTest.java,402,110,3,39,0,152
 pulsar-master\pulsar-master\pulsar-broker\src\test\java\org\apache\pulsar\broker\service\schema\SchemaServiceTest.java,0,95,2,34,0,131
 pulsar-master\pulsar-master\pulsar-common\src\test\java\org\apache\pulsar\common\allocator\PulsarByteBufAllocatorDefaultTest.java,33,8,0,4,0,12
 pulsar-master\pulsar-master\pulsar-client\src\main\java\org\apache\pulsar\client\impl\schema\reader\ProtobufReader.java,0,13,0,3,0,16
 pulsar-master\pulsar-master\pulsar-io\kinesis\src\main\java\org\apache\pulsar\io\kinesis\package-info.java,0,1,0,1,0,2
 pulsar-master\pulsar-master\pulsar-sql\presto-pulsar\src\main\java\org\apache\pulsar\sql\presto\PulsarConnectorModule.java,53,20,0,6,0,26
 pulsar-master\pulsar-master\pulsar-client-api\src\main\java\org\apache\pulsar\client\api\KeySharedMode.java,0,1,0,2,0,3
 pulsar-master\pulsar-master\pulsar-io\elastic-search\src\test\java\org\apache\pulsar\io\elasticsearch\v7\ElasticSearch7ClientTests.java,7,1,0,1,0,2
 pulsar-master\pulsar-master\pulsar-broker\src\main\java\org\apache\pulsar\broker\service\persistent\package-info.java,0,0,0,1,0,1
 pulsar-master\pulsar-master\pulsar-io\canal\src\main\java\org\apache\pulsar\io\canal\MessageUtils.java,128,12,2,9,0,23
 pulsar-master\pulsar-master\pulsar-io\elastic-search\src\test\java\org\apache\pulsar\io\elasticsearch\opensearch\OpenSearchClientSslTests.java,112,32,0,15,0,47
 pulsar-master\pulsar-master\pulsar-client-api\src\main\java\org\apache\pulsar\client\api\SubscriptionType.java,0,8,0,8,0,16
 pulsar-master\pulsar-master\pulsar-testclient\src\main\java\org\apache\pulsar\testclient\PositiveNumberParameterValidator.java,10,4,0,2,0,6
 pulsar-master\pulsar-master\pulsar-client-admin-api\src\main\java\org\apache\pulsar\common\policies\data\TransactionPendingAckInternalStats.java,6,1,0,1,0,2
 pulsar-master\pulsar-master\pulsar-client-1x-base\pulsar-client-1x\src\main\java\org\apache\pulsar\client\api\MessageBuilder.java,0,20,0,8,0,28
 pulsar-master\pulsar-master\pulsar-broker\src\main\java\org\apache\pulsar\broker\loadbalance\LoadSheddingTask.java,18,7,0,2,0,9
 pulsar-master\pulsar-master\pulsar-common\src\main\java\org\apache\pulsar\common\util\collections\BitSetRecyclable.java,0,219,100,11,0,330
 pulsar-master\pulsar-master\pulsar-broker\src\test\java\org\apache\pulsar\broker\service\BrokerServiceTest.java,1318,295,35,193,0,523
 pulsar-master\pulsar-master\pulsar-testclient\src\main\java\org\apache\pulsar\testclient\LoadSimulationController.java,671,169,10,111,0,290
 pulsar-master\pulsar-master\pulsar-broker-common\src\main\java\org\apache\pulsar\broker\validator\package-info.java,0,1,0,1,0,2
 pulsar-master\pulsar-master\pulsar-broker\src\main\java\org\apache\pulsar\broker\stats\prometheus\AggregatedSubscriptionStats.java,41,39,0,2,0,41
 pulsar-master\pulsar-master\tiered-storage\jcloud\src\main\java\org\apache\bookkeeper\mledger\offload\jcloud\impl\DataBlockUtils.java,71,29,3,8,0,40
 pulsar-master\pulsar-master\pulsar-functions\worker\src\main\java\org\apache\pulsar\functions\worker\service\WorkerServiceDefinition.java,17,0,0,1,0,1
 pulsar-master\pulsar-master\pulsar-io\flume\src\main\java\org\apache\pulsar\io\flume\node\PropertiesFileConfigurationProvider.java,52,14,2,33,0,49
 pulsar-master\pulsar-master\pulsar-client-api\src\main\java\org\apache\pulsar\client\api\schema\SchemaWriter.java,0,1,0,1,0,2
 pulsar-master\pulsar-master\pulsar-client\src\test\java\org\apache\pulsar\client\api\ConsumerConfigurationTest.java,39,8,2,2,0,12
 pulsar-master\pulsar-master\pulsar-client-api\src\main\java\org\apache\pulsar\client\internal\ReflectionUtils.java,0,13,3,6,0,22
 pulsar-master\pulsar-master\pulsar-client-auth-sasl\src\main\java\org\apache\pulsar\client\impl\auth\AuthenticationSasl.java,0,66,13,38,0,117
 pulsar-master\pulsar-master\pulsar-client-admin\src\main\java\org\apache\pulsar\client\admin\internal\BaseResource.java,250,90,7,43,0,140
 pulsar-master\pulsar-master\pulsar-functions\java-examples\src\main\java\org\apache\pulsar\functions\api\examples\ConsistentlyFailingFunction.java,0,4,1,2,0,7
 pulsar-master\pulsar-master\pulsar-broker\src\test\java\org\apache\pulsar\broker\admin\AdminResourceTest.java,114,16,0,11,0,27
 pulsar-master\pulsar-master\pulsar-client\src\main\java\org\apache\pulsar\client\impl\auth\oauth2\KeyFile.java,32,12,0,1,0,13
 pulsar-master\pulsar-master\pulsar-client-admin-api\src\main\java\org\apache\pulsar\client\admin\Transactions.java,0,37,0,40,0,77
 pulsar-master\pulsar-master\pulsar-functions\runtime\src\main\java\org\apache\pulsar\functions\runtime\kubernetes\package-info.java,0,1,0,1,0,2
 pulsar-master\pulsar-master\pulsar-broker\src\main\java\org\apache\pulsar\broker\stats\prometheus\package-info.java,0,0,0,1,0,1
 pulsar-master\pulsar-master\pulsar-io\netty\src\main\java\org\apache\pulsar\io\netty\tcp\NettyTCPServerHandler.java,29,17,0,4,0,21
 pulsar-master\pulsar-master\pulsar-functions\instance\src\main\java\org\apache\pulsar\functions\windowing\WindowUtils.java,6,6,1,2,0,9
 pulsar-master\pulsar-master\pulsar-io\debezium\core\src\main\java\org\apache\pulsar\io\debezium\package-info.java,0,1,0,1,0,2
 pulsar-master\pulsar-master\pulsar-broker\src\main\java\org\apache\pulsar\broker\service\persistent\PersistentDispatcherMultipleConsumers.java,0,330,19,188,0,537
 pulsar-master\pulsar-master\pulsar-broker\src\test\java\org\apache\pulsar\broker\transaction\buffer\TransactionBufferHandlerImplTest.java,30,11,0,5,0,16
 pulsar-master\pulsar-master\pulsar-io\netty\src\main\java\org\apache\pulsar\io\netty\NettySourceConfig.java,41,14,2,6,0,22
 pulsar-master\pulsar-master\pulsar-broker\src\main\java\org\apache\pulsar\broker\lookup\v2\TopicLookup.java,35,32,0,12,0,44
 pulsar-master\pulsar-master\pulsar-functions\utils\src\main\java\org\apache\pulsar\functions\utils\functions\package-info.java,0,0,0,1,0,1
 pulsar-master\pulsar-master\pulsar-functions\instance\src\main\java\org\apache\pulsar\functions\windowing\TriggerPolicy.java,0,2,0,3,0,5
 pulsar-master\pulsar-master\tests\docker-images\java-test-functions\src\main\java\org\apache\pulsar\tests\integration\io\TestStateSink.java,25,9,1,2,0,12
 pulsar-master\pulsar-master\pulsar-io\kinesis\src\main\java\org\apache\pulsar\io\kinesis\fbs\EncryptionCtx.java,0,146,16,41,0,203
 pulsar-master\pulsar-master\pulsar-client-auth-sasl\src\main\java\org\apache\pulsar\client\impl\auth\SaslAuthenticationDataProvider.java,42,14,0,6,0,20
 pulsar-master\pulsar-master\pulsar-client-api\src\main\java\org\apache\pulsar\client\api\ProducerInterceptor.java,0,12,1,12,0,25
 pulsar-master\pulsar-master\pulsar-common\src\main\java\org\apache\pulsar\common\util\collections\GrowablePriorityLongPairQueue.java,346,84,1,11,0,96
 pulsar-master\pulsar-master\pulsar-broker\src\test\java\org\apache\pulsar\schema\PartitionedTopicSchemaTest.java,73,21,0,14,0,35
 pulsar-master\pulsar-master\pulsar-broker\src\main\java\org\apache\pulsar\broker\resourcegroup\ResourceUsagePublisher.java,0,4,0,2,0,6
 pulsar-master\pulsar-master\pulsar-package-management\core\src\test\java\org\apache\pulsar\packages\management\core\common\PackageNameTest.java,96,17,0,10,0,27
 pulsar-master\pulsar-master\pulsar-client\src\main\java\org\apache\pulsar\client\impl\Backoff.java,97,64,0,14,0,78
 pulsar-master\pulsar-master\pulsar-functions\runtime\src\main\java\org\apache\pulsar\functions\package-info.java,0,2,0,1,0,3
 pulsar-master\pulsar-master\pulsar-functions\runtime\src\main\java\org\apache\pulsar\functions\runtime\RuntimeFactory.java,0,11,1,6,0,18
 pulsar-master\pulsar-master\pulsar-proxy\src\test\java\org\apache\pulsar\proxy\server\ProxyConnectionThrottlingTest.java,68,21,4,11,0,36
 pulsar-master\pulsar-master\pulsar-client\src\main\java\org\apache\pulsar\client\impl\MessagePayloadImpl.java,43,9,1,4,0,14
 pulsar-master\pulsar-master\pulsar-common\src\main\java\org\apache\pulsar\common\protocol\schema\LatestVersion.java,0,1,0,1,0,2
 pulsar-master\pulsar-master\pulsar-broker\src\main\java\org\apache\pulsar\broker\admin\v3\Sink.java,3,1,0,1,0,2
 pulsar-master\pulsar-master\pulsar-functions\instance\src\main\java\org\apache\pulsar\functions\instance\stats\FunctionStatsManager.java,443,199,2,45,0,246
 pulsar-master\pulsar-master\pulsar-broker-common\src\main\java\org\apache\pulsar\broker\authentication\AuthenticationProviderList.java,214,47,5,20,0,72
 pulsar-master\pulsar-master\pulsar-broker\src\main\java\org\apache\pulsar\broker\service\SystemTopicBaseTxnBufferSnapshotService.java,52,29,0,19,0,48
 pulsar-master\pulsar-master\pulsar-io\kinesis\src\test\java\org\apache\pulsar\io\kinesis\KinesisSinkTest.java,125,20,3,10,0,33
 pulsar-master\pulsar-master\pulsar-io\kafka-connect-adaptor\src\main\java\org\apache\pulsar\io\kafka\connect\AbstractKafkaConnectSource.java,239,81,6,32,0,119
 pulsar-master\pulsar-master\pulsar-functions\worker\src\main\java\org\apache\pulsar\functions\worker\rest\Resources.java,0,3,0,1,0,4
 pulsar-master\pulsar-master\pulsar-client\src\test\java\org\apache\pulsar\client\impl\schema\LocalTimeSchemaTest.java,63,27,0,1,0,28
 pulsar-master\pulsar-master\pulsar-client-api\src\main\java\org\apache\pulsar\common\api\package-info.java,0,1,0,1,0,2
 pulsar-master\pulsar-master\pulsar-io\debezium\postgres\src\main\java\org\apache\pulsar\io\debezium\postgres\package-info.java,0,1,0,1,0,2
 pulsar-master\pulsar-master\pulsar-client\src\test\java\org\apache\pulsar\client\api\SchemaDefinitionBuilderTest.java,74,10,0,2,0,12
 pulsar-master\pulsar-master\pulsar-client-admin\src\main\java\org\apache\pulsar\client\admin\internal\ResourceQuotasImpl.java,0,54,0,17,0,71
 pulsar-master\pulsar-master\pulsar-broker\src\main\java\org\apache\pulsar\PulsarTransactionCoordinatorMetadataSetup.java,81,25,1,15,0,41
 pulsar-master\pulsar-master\pulsar-functions\worker\src\main\java\org\apache\pulsar\functions\worker\rest\api\v3\SinkApiV3Resource.java,3,1,0,1,0,2
 pulsar-master\pulsar-master\pulsar-common\src\main\java\org\apache\pulsar\common\protocol\PulsarHandler.java,101,42,4,16,0,62
 pulsar-master\pulsar-master\pulsar-io\elastic-search\src\test\java\org\apache\pulsar\io\elasticsearch\client\RestClientFactoryTest.java,20,10,1,9,0,20
 pulsar-master\pulsar-master\pulsar-io\redis\src\test\java\org\apache\pulsar\io\redis\EmbeddedRedisUtils.java,0,9,0,1,0,10
 pulsar-master\pulsar-master\pulsar-common\src\test\java\org\apache\pulsar\common\util\collections\ConcurrentBitSetRecyclableTest.java,37,14,0,9,0,23
 pulsar-master\pulsar-master\pulsar-proxy\src\test\java\org\apache\pulsar\proxy\server\FunctionWorkerRoutingTest.java,39,10,0,9,0,19
 pulsar-master\pulsar-master\pulsar-common\src\main\java\org\apache\pulsar\common\tls\SubjectName.java,0,5,0,1,0,6
 pulsar-master\pulsar-master\managed-ledger\src\main\java\org\apache\bookkeeper\mledger\ManagedCursorMXBean.java,0,0,0,1,0,1
 pulsar-master\pulsar-master\pulsar-broker\src\test\java\org\apache\pulsar\client\api\DispatcherBlockConsumerTest.java,991,258,11,188,0,457
 pulsar-master\pulsar-master\pulsar-package-management\bookkeeper-storage\src\test\java\org\apache\pulsar\packages\management\storage\bookkeeper\DLOutputStreamTest.java,102,22,0,10,0,32
 pulsar-master\pulsar-master\pulsar-broker\src\test\java\org\apache\pulsar\broker\web\plugin\servlet\MockAdditionalServletWithClassLoader.java,27,6,0,2,0,8
 pulsar-master\pulsar-master\pulsar-client\src\test\java\org\apache\pulsar\client\impl\schema\DateSchemaTest.java,62,26,0,1,0,27
 pulsar-master\pulsar-master\pulsar-broker\src\main\java\org\apache\pulsar\broker\web\PulsarWebResource.java,1039,422,25,230,0,677
 pulsar-master\pulsar-master\tests\pulsar-client-all-shade-test\src\test\java\org\apache\pulsar\tests\integration\SmokeTest.java,59,10,0,4,0,14
 pulsar-master\pulsar-master\pulsar-sql\presto-pulsar\src\test\java\org\apache\pulsar\sql\presto\decoder\protobufnative\ProtobufNativeDecoderTestUtil.java,166,41,2,21,0,64
 pulsar-master\pulsar-master\pulsar-client-tools\src\test\java\org\apache\pulsar\admin\cli\TestCmdNamespaceIsolationPolicy.java,24,8,0,8,0,16
 pulsar-master\pulsar-master\pulsar-sql\presto-pulsar\src\main\java\org\apache\pulsar\sql\presto\PulsarFieldValueProviders.java,38,8,1,3,0,12
 pulsar-master\pulsar-master\pulsar-io\influxdb\src\test\java\org\apache\pulsar\io\influxdb\v2\InfluxDBSinkTest.java,143,46,0,15,0,61
 pulsar-master\pulsar-master\pulsar-broker\src\main\java\org\apache\pulsar\broker\resourcegroup\ResourceGroup.java,638,259,7,126,0,392
 pulsar-master\pulsar-master\pulsar-metadata\src\main\java\org\apache\pulsar\metadata\bookkeeper\PulsarLedgerUnderreplicationManager.java,913,268,11,172,0,451
 pulsar-master\pulsar-master\pulsar-client\src\main\java\org\apache\pulsar\client\util\Secret.java,0,0,0,1,0,1
 pulsar-master\pulsar-master\pulsar-client-auth-athenz\src\main\java\org\apache\pulsar\client\impl\auth\AuthenticationAthenz.java,0,57,4,29,0,90
 pulsar-master\pulsar-master\pulsar-transaction\coordinator\src\main\java\org\apache\pulsar\transaction\coordinator\impl\MLTransactionLogImpl.java,237,100,1,37,0,138
 pulsar-master\pulsar-master\pulsar-common\src\main\java\org\apache\pulsar\common\policies\data\stats\NonPersistentPartitionedTopicStatsImpl.java,0,11,0,4,0,15
 pulsar-master\pulsar-master\tests\pulsar-client-shade-test\src\test\java\org\apache\pulsar\tests\integration\SmokeTest.java,50,6,0,1,0,7
 pulsar-master\pulsar-master\pulsar-common\src\main\java\org\apache\pulsar\common\intercept\package-info.java,0,2,0,1,0,3
 pulsar-master\pulsar-master\pulsar-broker\src\main\java\org\apache\pulsar\broker\stats\prometheus\metrics\PrometheusStatsLogger.java,46,27,0,7,0,34
 pulsar-master\pulsar-master\pulsar-broker\src\test\java\org\apache\pulsar\broker\admin\NamespacesTest.java,1645,566,50,381,0,997
 pulsar-master\pulsar-master\pulsar-functions\java-examples\src\main\java\org\apache\pulsar\functions\api\examples\ByteBufferSerDe.java,0,5,0,1,0,6
 pulsar-master\pulsar-master\pulsar-broker\src\test\java\org\apache\pulsar\broker\service\MessageTTLTest.java,68,21,0,15,0,36
 pulsar-master\pulsar-master\pulsar-common\src\test\java\org\apache\pulsar\common\policies\data\ClusterDataTest.java,88,4,0,4,0,8
 pulsar-master\pulsar-master\managed-ledger\src\main\java\org\apache\bookkeeper\mledger\impl\EntryCache.java,0,10,0,10,0,20
 pulsar-master\pulsar-master\pulsar-functions\worker\src\main\java\org\apache\pulsar\functions\worker\rest\api\v2\WorkerStatsApiV2Resource.java,61,24,0,7,0,31
 pulsar-master\pulsar-master\pulsar-client-admin-api\src\main\java\org\apache\pulsar\client\admin\Topics.java,0,628,1,436,0,1065
 pulsar-master\pulsar-master\pulsar-client\src\test\java\org\apache\pulsar\client\impl\OpSendMsgQueueTest.java,55,7,0,3,0,10
 pulsar-master\pulsar-master\pulsar-common\src\test\java\org\apache\pulsar\common\protocol\ByteBufPairTest.java,55,9,0,1,0,10
 pulsar-master\pulsar-master\pulsar-client\src\test\java\org\apache\pulsar\client\impl\ClientInitializationTest.java,18,2,0,2,0,4
 pulsar-master\pulsar-master\pulsar-client\src\main\java\org\apache\pulsar\client\impl\schema\NativeAvroBytesSchema.java,66,32,3,8,0,43
 pulsar-master\pulsar-master\pulsar-client\src\test\java\org\apache\pulsar\client\impl\ProducerStatsRecorderImplTest.java,43,12,0,5,0,17
 pulsar-master\pulsar-master\pulsar-broker\src\test\java\org\apache\pulsar\broker\protocol\SimpleProtocolHandlerSeparateThreadPoolTest.java,6,2,0,2,0,4
 pulsar-master\pulsar-master\pulsar-io\canal\src\main\java\org\apache\pulsar\io\canal\CanalByteSource.java,15,5,0,2,0,7
 pulsar-master\pulsar-master\tests\integration\src\test\java\org\apache\pulsar\tests\integration\io\sinks\KinesisSinkTester.java,87,16,0,8,0,24
 pulsar-master\pulsar-master\pulsar-broker\src\test\java\org\apache\pulsar\client\impl\PatternTopicsConsumerImplTest.java,719,222,27,143,0,392
 pulsar-master\pulsar-master\pulsar-broker\src\test\java\org\apache\pulsar\client\api\SubscriptionMessageDispatchThrottlingTest.java,786,209,7,125,0,341
 pulsar-master\pulsar-master\pulsar-functions\worker\src\test\java\org\apache\pulsar\functions\worker\rest\api\FunctionsImplTest.java,307,113,15,61,0,189
 pulsar-master\pulsar-master\pulsar-metadata\src\main\java\org\apache\pulsar\metadata\impl\batching\OpGetChildren.java,16,5,0,2,0,7
 pulsar-master\pulsar-master\pulsar-common\src\main\java\org\apache\pulsar\common\util\FieldParser.java,0,59,1,24,0,84
 pulsar-master\pulsar-master\pulsar-io\kinesis\src\main\java\org\apache\pulsar\io\kinesis\KinesisSink.java,225,115,7,66,0,188
 pulsar-master\pulsar-master\buildtools\src\main\java\org\apache\pulsar\tests\FastThreadLocalCleanupListener.java,36,15,1,9,0,25
 pulsar-master\pulsar-master\pulsar-client-admin-api\src\main\java\org\apache\pulsar\client\admin\TopicPolicies.java,0,302,0,168,0,470
 pulsar-master\pulsar-master\structured-event-log\src\main\java\org\apache\pulsar\structuredeventlog\slf4j\Slf4jEvent.java,0,47,0,5,0,52
 pulsar-master\pulsar-master\pulsar-common\src\main\java\org\apache\pulsar\common\util\TrustManagerProxy.java,84,44,3,15,0,62
 pulsar-master\pulsar-master\pulsar-broker\src\test\java\org\apache\pulsar\schema\compatibility\SchemaTypeCompatibilityCheckTest.java,324,72,0,55,0,127
 pulsar-master\pulsar-master\pulsar-io\jdbc\sqlite\src\main\java\org\apache\pulsar\io\jdbc\SqliteJdbcAutoSchemaSink.java,4,1,0,2,0,3
 pulsar-master\pulsar-master\pulsar-common\src\main\java\org\apache\pulsar\common\protocol\schema\GetSchemaResponse.java,8,5,0,1,0,6
 pulsar-master\pulsar-master\buildtools\src\main\java\org\apache\pulsar\tests\ThreadLocalStateCleaner.java,0,37,6,16,0,59
 pulsar-master\pulsar-master\pulsar-broker\src\main\java\org\apache\pulsar\broker\service\persistent\SubscribeRateLimiter.java,237,90,1,34,0,125
 pulsar-master\pulsar-master\pulsar-functions\instance\src\main\java\org\apache\pulsar\functions\windowing\EvictionPolicy.java,0,7,0,8,0,15
 pulsar-master\pulsar-master\pulsar-client\src\main\java\org\apache\pulsar\client\impl\schema\ProtobufNativeSchema.java,0,43,1,20,0,64
 pulsar-master\pulsar-master\pulsar-io\jdbc\core\src\main\java\org\apache\pulsar\io\jdbc\JdbcDriverType.java,0,33,0,3,0,36
 pulsar-master\pulsar-master\pulsar-common\src\test\java\org\apache\pulsar\common\policies\data\RetentionPolicesTest.java,13,4,0,3,0,7
 pulsar-master\pulsar-master\pulsar-broker\src\test\java\org\apache\pulsar\client\impl\UnAcknowledgedMessagesTimeoutTest.java,550,136,27,59,0,222
 pulsar-master\pulsar-master\pulsar-broker\src\main\java\org\apache\pulsar\broker\BookKeeperClientFactory.java,0,8,0,6,0,14
 pulsar-master\pulsar-master\pulsar-client\src\main\java\org\apache\pulsar\client\impl\auth\package-info.java,0,1,0,1,0,2
 pulsar-master\pulsar-master\pulsar-client\src\main\java\org\apache\pulsar\client\impl\ConsumerBuilderImpl.java,472,219,6,89,0,314
 pulsar-master\pulsar-master\pulsar-broker\src\test\java\org\apache\pulsar\utils\CmdTest.java,40,9,2,4,0,15
 pulsar-master\pulsar-master\pulsar-broker-common\src\main\java\org\apache\pulsar\broker\web\DisableDebugHttpMethodFilter.java,44,15,2,7,0,24
 pulsar-master\pulsar-master\pulsar-broker\src\test\java\org\apache\pulsar\broker\BrokerTestUtil.java,22,10,1,5,0,16
 pulsar-master\pulsar-master\tests\integration\src\test\java\org\apache\pulsar\tests\integration\io\PulsarIOTestRunner.java,59,35,0,7,0,42
 pulsar-master\pulsar-master\pulsar-common\src\main\java\org\apache\pulsar\common\events\package-info.java,0,1,0,1,0,2
 pulsar-master\pulsar-master\pulsar-common\src\main\java\org\apache\pulsar\policies\data\loadbalancer\ResourceUnitRanking.java,284,165,10,65,0,240
 pulsar-master\pulsar-master\pulsar-functions\worker\src\main\java\org\apache\pulsar\functions\worker\dlog\DLOutputStream.java,45,18,0,1,0,19
 pulsar-master\pulsar-master\pulsar-io\core\src\main\java\org\apache\pulsar\io\core\BatchSourceTriggerer.java,0,13,0,13,0,26
 pulsar-master\pulsar-master\pulsar-broker\src\main\java\org\apache\pulsar\broker\service\plugin\EntryFilterDefinitions.java,4,1,0,1,0,2
 pulsar-master\pulsar-master\pulsar-testclient\src\main\java\org\apache\pulsar\testclient\utils\PaddingDecimalFormat.java,48,26,0,6,0,32
 pulsar-master\pulsar-master\pulsar-broker\src\main\java\org\apache\pulsar\broker\loadbalance\impl\WRRPlacementStrategy.java,55,27,2,24,0,53
 pulsar-master\pulsar-master\pulsar-functions\secrets\src\main\java\org\apache\pulsar\functions\secretsprovider\EnvironmentBasedSecretsProvider.java,13,4,0,2,0,6
 pulsar-master\pulsar-master\pulsar-io\netty\src\main\java\package-info.java,0,0,0,1,0,1
 pulsar-master\pulsar-master\pulsar-broker\src\test\java\org\apache\pulsar\client\api\ProxyProtocolTest.java,75,22,2,15,0,39
 pulsar-master\pulsar-master\pulsar-broker\src\test\java\org\apache\pulsar\broker\service\KeyValueTest.java,52,11,0,9,0,20
 pulsar-master\pulsar-master\pulsar-client\src\test\java\org\apache\pulsar\client\impl\schema\TimeSchemaTest.java,57,24,0,1,0,25
 pulsar-master\pulsar-master\managed-ledger\src\main\java\org\apache\bookkeeper\mledger\ManagedLedgerMXBean.java,0,14,0,3,0,17
 pulsar-master\pulsar-master\pulsar-broker\src\test\java\org\apache\pulsar\functions\worker\FileServer.java,71,25,0,4,0,29
 pulsar-master\pulsar-master\managed-ledger\src\main\java\org\apache\bookkeeper\mledger\ManagedLedger.java,0,82,0,70,0,152
 pulsar-master\pulsar-master\pulsar-client-auth-sasl\src\main\java\org\apache\pulsar\client\impl\auth\package-info.java,0,1,0,1,0,2
 pulsar-master\pulsar-master\buildtools\src\test\java\org\apache\pulsar\tests\AnnotationListenerTest.java,10,3,0,2,0,5
 pulsar-master\pulsar-master\pulsar-io\hbase\src\main\java\org\apache\pulsar\io\hbase\sink\HbaseAbstractSink.java,150,45,4,17,0,66
 pulsar-master\pulsar-master\pulsar-broker\src\main\java\org\apache\pulsar\broker\transaction\recover\TransactionRecoverTrackerImpl.java,96,35,0,19,0,54
 pulsar-master\pulsar-master\pulsar-functions\instance\src\test\java\org\apache\pulsar\functions\instance\JavaInstanceRunnableTest.java,114,33,3,15,0,51
 pulsar-master\pulsar-master\pulsar-metadata\src\test\java\org\apache\pulsar\metadata\TestZKServer.java,160,40,4,6,0,50
 pulsar-master\pulsar-master\pulsar-io\hdfs3\src\test\java\org\apache\pulsar\io\hdfs3\sink\seq\HdfsSequentialSinkTests.java,0,35,1,2,0,38
 pulsar-master\pulsar-master\pulsar-functions\java-examples\src\main\java\org\apache\pulsar\functions\api\examples\UserPublishFunction.java,0,4,0,2,0,6
 pulsar-master\pulsar-master\pulsar-broker\src\test\java\org\apache\pulsar\broker\service\CurrentLedgerRolloverIfFullTest.java,110,34,2,24,0,60
 pulsar-master\pulsar-master\pulsar-broker\src\test\java\org\apache\pulsar\stats\client\PulsarBrokerStatsClientTest.java,93,31,4,21,0,56
 pulsar-master\pulsar-master\tests\docker-images\java-test-functions\src\main\java\org\apache\pulsar\tests\integration\functions\ExceptionFunction.java,0,6,0,1,0,7
 pulsar-master\pulsar-master\managed-ledger\src\test\java\org\apache\bookkeeper\mledger\util\CallbackMutexTest.java,100,39,5,3,0,47
 pulsar-master\pulsar-master\tiered-storage\jcloud\src\test\java\org\apache\bookkeeper\mledger\offload\jcloud\impl\DataBlockHeaderV2Test.java,56,14,5,10,0,29
 pulsar-master\pulsar-master\managed-ledger\src\main\java\org\apache\bookkeeper\mledger\intercept\ManagedLedgerInterceptor.java,0,7,0,5,0,12
 pulsar-master\pulsar-master\pulsar-client-admin-api\src\main\java\org\apache\pulsar\common\policies\data\TransactionBufferStats.java,12,3,0,1,0,4
 pulsar-master\pulsar-master\pulsar-client\src\test\java\org\apache\pulsar\client\api\KeySharedPolicyTest.java,40,9,2,3,0,14
 pulsar-master\pulsar-master\pulsar-broker\src\main\java\org\apache\pulsar\broker\transaction\buffer\matadata\AbortTxnMetadata.java,7,8,0,1,0,9
 pulsar-master\pulsar-master\pulsar-client\src\test\java\org\apache\pulsar\client\impl\BackoffTest.java,159,98,1,5,0,104
 pulsar-master\pulsar-master\tiered-storage\jcloud\src\test\java\org\apache\bookkeeper\mledger\offload\jcloud\impl\DataBlockHeaderTest.java,51,13,5,8,0,26
 pulsar-master\pulsar-master\pulsar-client-api\src\main\java\org\apache\pulsar\client\api\ConsumerStats.java,0,4,0,3,0,7
 pulsar-master\pulsar-master\pulsar-proxy\src\main\java\org\apache\pulsar\proxy\server\LookupProxyHandler.java,411,139,5,82,0,226
 pulsar-master\pulsar-master\pulsar-transaction\coordinator\src\main\java\org\apache\pulsar\transaction\coordinator\impl\MLTransactionSequenceIdGenerator.java,77,30,1,14,0,45
 pulsar-master\pulsar-master\pulsar-client\src\main\java\org\apache\pulsar\client\impl\BatchMessageAcker.java,74,29,1,2,0,32
 pulsar-master\pulsar-master\pulsar-broker\src\test\java\org\apache\pulsar\broker\service\TransactionMetadataStoreServiceTest.java,340,137,22,89,0,248
 pulsar-master\pulsar-master\pulsar-proxy\src\test\java\org\apache\pulsar\proxy\server\ProxyServiceStarterTest.java,126,40,4,20,0,64
 pulsar-master\pulsar-master\tests\integration\src\test\java\org\apache\pulsar\tests\integration\containers\HdfsContainer.java,30,14,0,2,0,16
 pulsar-master\pulsar-master\pulsar-broker\src\main\java\org\apache\pulsar\broker\transaction\exception\pendingack\package-info.java,0,1,0,1,0,2
 pulsar-master\pulsar-master\pulsar-client\src\main\java\org\apache\pulsar\client\impl\schema\generic\MultiVersionGenericProtobufNativeReader.java,0,23,2,9,0,34
 pulsar-master\pulsar-master\pulsar-functions\runtime\src\test\java\org\apache\pulsar\functions\runtime\kubernetes\KubernetesRuntimeTest.java,1113,582,13,293,0,888
 pulsar-master\pulsar-master\pulsar-broker\src\test\java\org\apache\pulsar\broker\loadbalance\ModularLoadManagerStrategyTest.java,38,13,0,6,0,19
 pulsar-master\pulsar-master\pulsar-client\src\main\java\org\apache\pulsar\client\impl\ConnectionPool.java,0,113,4,56,0,173
 pulsar-master\pulsar-master\pulsar-broker\src\test\java\org\apache\pulsar\io\PulsarFunctionAdminTest.java,148,69,7,24,0,100
 pulsar-master\pulsar-master\pulsar-broker\src\main\java\org\apache\pulsar\broker\service\PulsarStats.java,215,78,9,29,0,116
 pulsar-master\pulsar-master\pulsar-broker-auth-athenz\src\test\java\org\apache\pulsar\broker\authentication\AuthenticationProviderAthenzTest.java,120,32,7,20,0,59
 pulsar-master\pulsar-master\pulsar-client-admin-api\src\main\java\org\apache\pulsar\client\admin\Bookies.java,0,27,0,10,0,37
 pulsar-master\pulsar-master\pulsar-client\src\main\java\org\apache\pulsar\client\impl\schema\ProtobufNativeSchemaUtils.java,119,49,3,38,0,90
 pulsar-master\pulsar-master\pulsar-functions\runtime\src\main\java\org\apache\pulsar\functions\runtime\thread\package-info.java,0,1,0,1,0,2
 pulsar-master\pulsar-master\pulsar-proxy\src\test\java\org\apache\pulsar\proxy\server\InvalidProxyConfigForAuthorizationTest.java,20,3,0,4,0,7
 pulsar-master\pulsar-master\tests\integration\src\test\java\org\apache\pulsar\tests\integration\containers\ChaosContainer.java,0,38,1,7,0,46
 pulsar-master\pulsar-master\tests\integration\src\test\java\org\apache\pulsar\tests\integration\functions\java\PulsarFunctionsJavaThreadTest.java,7,2,0,1,0,3
 pulsar-master\pulsar-master\pulsar-client-admin-api\src\main\java\org\apache\pulsar\common\policies\data\TransactionCoordinatorStatus.java,12,3,0,1,0,4
 pulsar-master\pulsar-master\pulsar-client\src\main\java\org\apache\pulsar\client\impl\customroute\package-info.java,0,2,0,1,0,3
 pulsar-master\pulsar-master\pulsar-broker\src\test\java\org\apache\pulsar\broker\service\MessagePublishBufferThrottleTest.java,120,26,3,12,0,41
 pulsar-master\pulsar-master\pulsar-io\dynamodb\src\main\java\org\apache\pulsar\io\dynamodb\package-info.java,0,1,0,1,0,2
 pulsar-master\pulsar-master\pulsar-client-admin-api\src\main\java\org\apache\pulsar\common\policies\data\TransactionLogStats.java,9,2,0,1,0,3
 pulsar-master\pulsar-master\managed-ledger\src\main\java\org\apache\bookkeeper\mledger\impl\EntryCacheEvictionPolicy.java,0,1,0,2,0,3
 pulsar-master\pulsar-master\pulsar-broker\src\test\java\org\apache\pulsar\client\impl\ClientWithSocks5ProxyTest.java,142,22,1,4,0,27
 pulsar-master\pulsar-master\pulsar-broker\src\main\java\org\apache\pulsar\broker\loadbalance\impl\ModularLoadManagerWrapper.java,103,27,2,6,0,35
 pulsar-master\pulsar-master\pulsar-client-api\src\main\java\org\apache\pulsar\client\api\EncodedAuthenticationParameterSupport.java,0,2,0,3,0,5
 pulsar-master\pulsar-master\pulsar-common\src\main\java\org\apache\pulsar\common\policies\data\BrokerNamespaceIsolationDataImpl.java,0,34,0,8,0,42
 pulsar-master\pulsar-master\pulsar-broker-common\src\main\java\org\apache\pulsar\broker\authorization\package-info.java,0,1,0,1,0,2
 pulsar-master\pulsar-master\pulsar-broker\src\main\java\org\apache\pulsar\broker\stats\BrokerOperabilityMetrics.java,127,72,0,21,0,93
 pulsar-master\pulsar-master\pulsar-functions\secrets\src\main\java\org\apache\pulsar\functions\secretsproviderconfigurator\DefaultSecretsProviderConfigurator.java,39,20,1,11,0,32
 pulsar-master\pulsar-master\pulsar-sql\presto-pulsar\src\main\java\org\apache\pulsar\sql\presto\PulsarTableHandle.java,91,23,0,1,0,24
 pulsar-master\pulsar-master\pulsar-common\src\test\java\org\apache\pulsar\common\naming\NamespaceNameTest.java,166,10,20,9,0,39
 pulsar-master\pulsar-master\pulsar-broker\src\main\java\org\apache\pulsar\broker\admin\impl\FunctionsBase.java,705,342,67,221,0,630
 pulsar-master\pulsar-master\pulsar-client\src\main\java\org\apache\pulsar\client\impl\schema\generic\GenericProtobufNativeRecord.java,34,14,0,1,0,15
 pulsar-master\pulsar-master\pulsar-client\src\test\java\org\apache\pulsar\common\schema\KeyValueTest.java,76,46,6,15,0,67
 pulsar-master\pulsar-master\managed-ledger\src\test\java\org\apache\bookkeeper\test\BookKeeperClusterTestCase.java,459,134,5,43,0,182
 pulsar-master\pulsar-master\pulsar-package-management\bookkeeper-storage\src\test\java\org\apache\pulsar\packages\management\storage\bookkeeper\bookkeeper\test\MockedBookKeeperTestCase.java,95,37,1,7,0,45
 pulsar-master\pulsar-master\pulsar-sql\presto-pulsar\src\main\java\org\apache\pulsar\sql\presto\PulsarHandleResolver.java,53,17,0,9,0,26
 pulsar-master\pulsar-master\pulsar-io\elastic-search\src\test\java\org\apache\pulsar\io\elasticsearch\RandomExponentialRetryTests.java,68,58,1,5,0,64
 pulsar-master\pulsar-master\pulsar-io\canal\src\main\java\org\apache\pulsar\io\canal\CanalStringSource.java,0,11,0,4,0,15
 pulsar-master\pulsar-master\pulsar-broker\src\test\java\org\apache\pulsar\websocket\proxy\SimpleConsumerSocket.java,98,52,3,6,0,61
 pulsar-master\pulsar-master\pulsar-common\src\main\java\org\apache\pulsar\common\tls\PublicSuffixMatcher.java,0,28,0,13,0,41
 pulsar-master\pulsar-master\pulsar-common\src\main\java\org\apache\pulsar\common\events\ActionType.java,0,4,0,1,0,5
 pulsar-master\pulsar-master\pulsar-client-tools\src\test\java\org\apache\pulsar\admin\cli\TestCmdTopics.java,112,35,7,12,0,54
 pulsar-master\pulsar-master\pulsar-broker\src\main\java\org\apache\pulsar\broker\service\streamingdispatch\package-info.java,0,0,0,1,0,1
 pulsar-master\pulsar-master\pulsar-common\src\main\java\org\apache\pulsar\common\util\Runnables.java,0,12,1,5,0,18
 pulsar-master\pulsar-master\pulsar-common\src\test\java\org\apache\pulsar\common\policies\data\PersistentOfflineTopicStatsTest.java,27,6,1,2,0,9
 pulsar-master\pulsar-master\pulsar-broker\src\test\java\org\apache\pulsar\client\api\PulsarMultiListenersWithoutInternalListenerNameTest.java,7,1,0,1,0,2
 pulsar-master\pulsar-master\pulsar-metadata\src\main\java\org\apache\pulsar\metadata\api\NotificationType.java,0,4,0,1,0,5
 pulsar-master\pulsar-master\pulsar-common\src\main\java\org\apache\pulsar\client\api\url\PulsarURLStreamHandlerFactory.java,26,6,0,3,0,9
 pulsar-master\pulsar-master\pulsar-broker\src\test\java\org\apache\pulsar\client\impl\TopicDoesNotExistsTest.java,54,17,2,13,0,32
 pulsar-master\pulsar-master\pulsar-metadata\src\main\java\org\apache\pulsar\metadata\api\package-info.java,0,0,0,1,0,1
 pulsar-master\pulsar-master\pulsar-client-api\src\main\java\org\apache\pulsar\client\api\ReaderListener.java,0,4,0,4,0,8
 pulsar-master\pulsar-master\pulsar-functions\runtime\src\main\java\org\apache\pulsar\functions\worker\WorkerConfig.java,0,236,1,81,0,318
 pulsar-master\pulsar-master\pulsar-common\src\main\java\org\apache\pulsar\common\schema\package-info.java,0,2,0,1,0,3
 pulsar-master\pulsar-master\structured-event-log\src\main\java\org\apache\pulsar\structuredeventlog\EventResources.java,0,1,0,1,0,2
 pulsar-master\pulsar-master\pulsar-client-admin-api\src\main\java\org\apache\pulsar\common\policies\data\BundlesData.java,0,6,0,1,0,7
 pulsar-master\pulsar-master\tiered-storage\jcloud\src\test\java\org\apache\bookkeeper\mledger\offload\jcloud\impl\BlobStoreManagedLedgerOffloaderStreamingTest.java,397,140,17,82,0,239
 pulsar-master\pulsar-master\tests\integration\src\test\java\org\apache\pulsar\tests\integration\cli\HealthCheckTest.java,77,19,2,7,0,28
 pulsar-master\pulsar-master\pulsar-metadata\src\main\java\org\apache\pulsar\metadata\api\extended\CreateOption.java,0,2,0,3,0,5
 pulsar-master\pulsar-master\pulsar-functions\api-java\src\main\java\org\apache\pulsar\functions\api\Function.java,0,13,2,6,0,21
 pulsar-master\pulsar-master\pulsar-broker\src\test\java\org\apache\pulsar\client\api\NonDurableSubscriptionTest.java,260,69,13,36,0,118
 pulsar-master\pulsar-master\pulsar-metadata\src\test\java\org\apache\pulsar\metadata\BaseMetadataStoreTest.java,103,39,1,11,0,51
 pulsar-master\pulsar-master\managed-ledger\src\main\java\org\apache\bookkeeper\mledger\impl\MetaStore.java,0,19,0,14,0,33
 pulsar-master\pulsar-master\tests\integration\src\test\java\org\apache\pulsar\tests\integration\functions\PulsarFunctionsTestBase.java,124,50,0,12,0,62
 pulsar-master\pulsar-master\tests\integration\src\test\java\org\apache\pulsar\tests\integration\io\sinks\ElasticSearchSinkTester.java,112,28,0,11,0,39
 pulsar-master\pulsar-master\pulsar-functions\worker\src\test\java\org\apache\pulsar\functions\worker\WorkerUtilsTest.java,60,9,2,8,0,19
 pulsar-master\pulsar-master\pulsar-client-api\src\main\java\org\apache\pulsar\client\api\SizeUnit.java,0,16,0,2,0,18
 pulsar-master\pulsar-master\pulsar-broker\src\test\java\org\apache\pulsar\client\impl\TopicsConsumerImplTest.java,1172,292,55,166,0,513
 pulsar-master\pulsar-master\pulsar-client\src\main\java\org\apache\pulsar\client\impl\schema\writer\ProtobufNativeWriter.java,0,2,1,2,0,5
 pulsar-master\pulsar-master\pulsar-broker\src\test\java\org\apache\pulsar\functions\worker\PulsarFunctionTestTemporaryDirectory.java,46,24,1,12,0,37
 pulsar-master\pulsar-master\pulsar-functions\worker\src\test\java\org\apache\pulsar\functions\worker\ClusterServiceCoordinatorTest.java,58,16,1,4,0,21
 pulsar-master\pulsar-master\pulsar-client\src\test\java\org\apache\pulsar\client\impl\schema\generic\MultiVersionSchemaInfoProviderTest.java,27,7,0,4,0,11
 pulsar-master\pulsar-master\pulsar-functions\worker\src\main\java\org\apache\pulsar\functions\worker\service\WorkerServiceLoader.java,133,28,2,15,0,45
 pulsar-master\pulsar-master\pulsar-io\debezium\core\src\main\java\org\apache\pulsar\io\debezium\DebeziumSource.java,74,38,0,21,0,59
 pulsar-master\pulsar-master\pulsar-metadata\src\main\java\org\apache\pulsar\metadata\api\extended\MetadataStoreExtended.java,0,12,0,12,0,24
 pulsar-master\pulsar-master\pulsar-functions\instance\src\main\java\org\apache\pulsar\functions\instance\go\GoInstanceConfig.java,47,38,0,2,0,40
 pulsar-master\pulsar-master\pulsar-common\src\main\java\org\apache\pulsar\client\api\url\DataURLStreamHandler.java,94,16,0,7,0,23
 pulsar-master\pulsar-master\pulsar-common\src\main\java\org\apache\pulsar\common\policies\data\TopicOperation.java,0,25,0,1,0,26
 pulsar-master\pulsar-master\pulsar-sql\presto-pulsar\src\main\java\org\apache\pulsar\sql\presto\decoder\json\package-info.java,0,2,0,1,0,3
 pulsar-master\pulsar-master\pulsar-broker\src\main\java\org\apache\pulsar\broker\rest\package-info.java,0,0,0,1,0,1
 pulsar-master\pulsar-master\pulsar-broker\src\main\java\org\apache\pulsar\broker\intercept\BrokerInterceptorWithClassLoader.java,124,75,0,22,0,97
 pulsar-master\pulsar-master\pulsar-broker\src\test\java\org\apache\pulsar\client\api\SimpleSchemaTest.java,1184,344,69,202,0,615
 pulsar-master\pulsar-master\pulsar-client-admin-api\src\main\java\org\apache\pulsar\policies\data\loadbalancer\NamespaceBundleStats.java,0,55,0,11,0,66
 pulsar-master\pulsar-master\pulsar-io\netty\src\main\java\org\apache\pulsar\io\netty\udp\NettyUDPServerHandler.java,28,18,0,5,0,23
 pulsar-master\pulsar-master\pulsar-proxy\src\test\java\org\apache\pulsar\proxy\server\ProxyWithJwtAuthorizationTest.java,329,82,9,45,0,136
 pulsar-master\pulsar-master\pulsar-broker\src\test\java\org\apache\pulsar\broker\cache\BundlesQuotasTest.java,58,26,0,8,0,34
 pulsar-master\pulsar-master\pulsar-broker\src\main\java\org\apache\pulsar\broker\TimeAverageMessageData.java,158,53,1,9,0,63
 pulsar-master\pulsar-master\pulsar-functions\instance\src\main\java\org\apache\pulsar\functions\windowing\EvictionContext.java,0,0,0,1,0,1
 pulsar-master\pulsar-master\pulsar-websocket\src\main\java\org\apache\pulsar\websocket\service\ProxyServer.java,115,46,5,17,0,68
 pulsar-master\pulsar-master\pulsar-websocket\src\main\java\org\apache\pulsar\websocket\WebSocketConsumerServlet.java,24,11,0,4,0,15
 pulsar-master\pulsar-master\pulsar-broker\src\main\java\org\apache\pulsar\broker\loadbalance\BrokerFilter.java,0,7,0,8,0,15
 pulsar-master\pulsar-master\pulsar-broker\src\main\java\org\apache\pulsar\utils\StatsOutputStream.java,0,44,1,1,0,46
 pulsar-master\pulsar-master\pulsar-client-admin-api\src\main\java\org\apache\pulsar\common\policies\data\NonPersistentReplicatorStats.java,0,2,0,2,0,4
 pulsar-master\pulsar-master\pulsar-broker\src\main\java\org\apache\pulsar\compaction\CompactedTopicImpl.java,0,115,4,69,0,188
 pulsar-master\pulsar-master\pulsar-broker\src\test\java\org\apache\pulsar\broker\service\OpportunisticStripingTest.java,60,12,0,7,0,19
 pulsar-master\pulsar-master\pulsar-client\src\main\java\org\apache\pulsar\client\impl\ResetCursorData.java,52,27,0,3,0,30
 pulsar-master\pulsar-master\pulsar-client\src\test\java\org\apache\pulsar\client\avro\generated\NasaMission.java,0,174,0,55,0,229
 pulsar-master\pulsar-master\pulsar-functions\api-java\src\main\java\org\apache\pulsar\functions\api\StateStoreContext.java,0,0,0,1,0,1
 pulsar-master\pulsar-master\pulsar-client-api\src\main\java\org\apache\pulsar\client\api\ConsumerCryptoFailureAction.java,0,5,0,6,0,11
 pulsar-master\pulsar-master\pulsar-common\src\main\java\org\apache\pulsar\common\protocol\schema\SchemaVersion.java,0,5,0,1,0,6
 pulsar-master\pulsar-master\pulsar-client-admin-api\src\main\java\org\apache\pulsar\client\admin\NonPersistentTopics.java,0,48,0,44,0,92
 pulsar-master\pulsar-master\pulsar-client\src\test\java\org\apache\pulsar\client\impl\auth\MockAuthentication.java,29,7,2,2,0,11
 pulsar-master\pulsar-master\pulsar-functions\instance\src\test\java\org\apache\pulsar\functions\windowing\WaterMarkEventGeneratorTest.java,94,43,0,4,0,47
 pulsar-master\pulsar-master\pulsar-common\src\test\java\org\apache\pulsar\common\util\collections\ConcurrentOpenHashSetTest.java,381,70,7,8,0,85
 pulsar-master\pulsar-master\structured-event-log\src\main\java\org\apache\pulsar\structuredeventlog\EventGroup.java,0,1,1,1,0,3
 pulsar-master\pulsar-master\pulsar-io\kinesis\src\test\java\org\apache\pulsar\io\kinesis\KinesisSinkAuthTest.java,119,29,1,17,0,47
 pulsar-master\pulsar-master\pulsar-client\src\main\java\org\apache\pulsar\client\impl\auth\oauth2\protocol\MetadataResolver.java,0,1,0,1,0,2
 pulsar-master\pulsar-master\pulsar-common\src\main\java\org\apache\pulsar\common\events\PulsarEvent.java,11,3,1,1,0,5
 pulsar-master\pulsar-master\pulsar-proxy\src\test\java\org\apache\pulsar\proxy\server\ProxyWithoutServiceDiscoveryTest.java,155,45,6,25,0,76
 pulsar-master\pulsar-master\pulsar-broker\src\test\java\org\apache\pulsar\client\api\AuthenticatedProducerConsumerTest.java,352,100,11,60,0,171
 pulsar-master\pulsar-master\managed-ledger\src\main\java\org\apache\bookkeeper\mledger\proto\PendingBookieOpsStats.java,11,16,0,1,0,17
 pulsar-master\pulsar-master\tests\integration\src\test\java\org\apache\pulsar\tests\integration\auth\token\PulsarTokenAuthenticationBaseSuite.java,341,64,8,34,0,106
 pulsar-master\pulsar-master\pulsar-broker\src\main\java\org\apache\pulsar\PulsarClusterMetadataSetup.java,330,117,2,71,0,190
 pulsar-master\pulsar-master\pulsar-metadata\src\main\java\org\apache\pulsar\metadata\bookkeeper\PulsarLayoutManager.java,0,12,0,5,0,17
 pulsar-master\pulsar-master\pulsar-sql\presto-pulsar\src\main\java\org\apache\pulsar\sql\presto\PulsarRecordCursor.java,788,273,16,145,0,434
 pulsar-master\pulsar-master\pulsar-io\aerospike\src\main\java\org\apache\pulsar\io\aerospike\AerospikeSinkConfig.java,28,18,0,3,0,21
 pulsar-master\pulsar-master\pulsar-io\kafka-connect-adaptor\src\test\java\org\apache\pulsar\io\kafka\connect\SchemaedFileStreamSinkTask.java,52,5,0,3,0,8
 pulsar-master\pulsar-master\pulsar-functions\java-examples\src\main\java\org\apache\pulsar\functions\api\examples\window\ContextWindowFunction.java,0,5,0,3,0,8
 pulsar-master\pulsar-master\pulsar-io\core\src\main\java\org\apache\pulsar\io\core\annotations\package-info.java,0,1,0,1,0,2
 pulsar-master\pulsar-master\tests\integration\src\test\java\org\apache\pulsar\tests\integration\functions\python\PulsarFunctionsPythonProcessTest.java,7,4,0,2,0,6
 pulsar-master\pulsar-master\structured-event-log\src\main\java\org\apache\pulsar\structuredeventlog\EventResourcesImpl.java,61,22,0,2,0,24
 pulsar-master\pulsar-master\pulsar-functions\worker\src\main\java\org\apache\pulsar\functions\worker\rest\api\WorkerImpl.java,297,94,11,74,0,179
 pulsar-master\pulsar-master\pulsar-broker\src\test\java\org\apache\pulsar\broker\admin\MaxUnackedMessagesTest.java,293,88,5,44,0,137
 pulsar-master\pulsar-master\pulsar-websocket\src\main\java\org\apache\pulsar\websocket\stats\package-info.java,0,0,0,1,0,1
 pulsar-master\pulsar-master\pulsar-client\src\main\java\org\apache\pulsar\client\impl\PulsarServiceNameResolver.java,77,20,5,8,0,33
 pulsar-master\pulsar-master\pulsar-client\src\main\java\org\apache\pulsar\client\impl\transaction\package-info.java,0,2,0,1,0,3
 pulsar-master\pulsar-master\pulsar-client-1x-base\pulsar-client-1x\src\main\java\org\apache\pulsar\client\api\Producer.java,0,28,0,29,0,57
 pulsar-master\pulsar-master\pulsar-io\elastic-search\src\test\java\org\apache\pulsar\io\elasticsearch\testcontainers\ElasticToxiproxiContainer.java,48,22,1,3,0,26
 pulsar-master\pulsar-master\managed-ledger\src\main\java\org\apache\bookkeeper\mledger\ManagedLedgerFactoryConfig.java,59,19,0,9,0,28
 pulsar-master\pulsar-master\pulsar-broker\src\main\java\org\apache\pulsar\broker\service\plugin\package-info.java,0,0,0,1,0,1
 pulsar-master\pulsar-master\pulsar-broker\src\main\java\org\apache\pulsar\utils\PulsarKeyException.java,16,7,0,1,0,8
 pulsar-master\pulsar-master\pulsar-client\src\main\java\org\apache\pulsar\client\impl\schema\StructSchema.java,73,27,1,15,0,43
 pulsar-master\pulsar-master\pulsar-common\src\test\java\org\apache\pulsar\common\compression\CompressionCodecLZ4JNI.java,44,22,2,11,0,35
 pulsar-master\pulsar-master\pulsar-common\src\main\java\org\apache\pulsar\common\protocol\schema\PostSchemaResponse.java,4,1,0,1,0,2
 pulsar-master\pulsar-master\pulsar-broker\src\main\java\org\apache\pulsar\broker\admin\impl\PersistentTopicsBase.java,4783,1817,284,1330,0,3431
 pulsar-master\pulsar-master\pulsar-client\src\test\java\org\apache\pulsar\client\impl\schema\TimestampSchemaTest.java,59,24,0,1,0,25
 pulsar-master\pulsar-master\pulsar-io\jdbc\clickhouse\src\main\java\org\apache\pulsar\io\jdbc\package-info.java,0,1,0,1,0,2
 pulsar-master\pulsar-master\pulsar-client-admin-api\src\main\java\org\apache\pulsar\common\policies\data\TopicType.java,0,8,0,1,0,9
 pulsar-master\pulsar-master\pulsar-common\src\test\java\org\apache\pulsar\common\policies\data\AutoFailoverPolicyDataTest.java,34,2,0,1,0,3
 pulsar-master\pulsar-master\pulsar-broker\src\main\java\org\apache\pulsar\broker\service\StickyKeyConsumerSelector.java,0,4,0,3,0,7
 pulsar-master\pulsar-master\pulsar-broker\src\test\java\org\apache\pulsar\broker\PulsarServiceTest.java,110,30,0,15,0,45
 pulsar-master\pulsar-master\pulsar-client-admin-api\src\main\java\org\apache\pulsar\common\policies\data\CompactionStats.java,0,4,0,1,0,5
 pulsar-master\pulsar-master\pulsar-common\src\test\java\org\apache\pulsar\common\policies\impl\NamespaceIsolationPolicyImplTest.java,178,53,3,26,0,82
 pulsar-master\pulsar-master\pulsar-client-api\src\main\java\org\apache\pulsar\common\api\AuthData.java,0,17,0,4,0,21
 pulsar-master\pulsar-master\pulsar-client\src\main\java\org\apache\pulsar\client\impl\auth\oauth2\protocol\package-info.java,0,0,0,1,0,1
 pulsar-master\pulsar-master\pulsar-io\netty\src\main\java\org\apache\pulsar\io\netty\http\package-info.java,0,1,0,1,0,2
 pulsar-master\pulsar-master\pulsar-broker\src\test\java\org\apache\pulsar\broker\service\HashRangeExclusiveStickyKeyConsumerSelectorTest.java,217,93,2,27,0,122
 pulsar-master\pulsar-master\pulsar-broker\src\main\java\org\apache\pulsar\client\api\RawReader.java,0,18,1,11,0,30
 pulsar-master\pulsar-master\pulsar-client-admin-api\src\main\java\org\apache\pulsar\client\admin\Lookup.java,0,5,0,4,0,9
 pulsar-master\pulsar-master\pulsar-broker\src\test\java\org\apache\pulsar\broker\transaction\buffer\TransactionLowWaterMarkTest.java,221,52,13,36,0,101
 pulsar-master\pulsar-master\pulsar-broker\src\test\java\org\apache\pulsar\broker\service\ReplicatorRateLimiterTest.java,376,129,15,66,0,210
 pulsar-master\pulsar-master\pulsar-client\src\main\java\org\apache\pulsar\client\impl\schema\writer\package-info.java,0,0,0,1,0,1
 pulsar-master\pulsar-master\pulsar-functions\runtime\src\main\java\org\apache\pulsar\functions\runtime\kubernetes\KubernetesManifestCustomizer.java,0,8,0,5,0,13
 pulsar-master\pulsar-master\pulsar-client\src\test\java\org\apache\pulsar\client\impl\schema\BytesSchemaTest.java,28,5,0,2,0,7
 pulsar-master\pulsar-master\pulsar-broker\src\test\java\org\apache\pulsar\broker\service\nonpersistent\NonPersistentStickyKeyDispatcherMultipleConsumersTest.java,129,42,9,22,0,73
 pulsar-master\pulsar-master\pulsar-client-api\src\main\java\org\apache\pulsar\client\api\EncryptionKeyInfo.java,32,21,0,2,0,23
 pulsar-master\pulsar-master\pulsar-broker\src\main\java\org\apache\pulsar\broker\admin\impl\BrokerStatsBase.java,125,47,9,25,0,81
 pulsar-master\pulsar-master\pulsar-client\src\main\java\org\apache\pulsar\client\impl\conf\package-info.java,0,0,0,1,0,1
 pulsar-master\pulsar-master\pulsar-io\elastic-search\src\main\java\org\apache\pulsar\io\elasticsearch\client\opensearch\RandomExponentialBackoffPolicy.java,45,25,0,6,0,31
 pulsar-master\pulsar-master\pulsar-sql\presto-pulsar\src\test\java\org\apache\pulsar\sql\presto\decoder\DecoderTestUtil.java,86,64,2,13,0,79
 pulsar-master\pulsar-master\pulsar-client\src\test\java\org\apache\pulsar\client\examples\TransactionExample.java,63,8,4,3,0,15
 pulsar-master\pulsar-master\pulsar-broker\src\test\java\org\apache\pulsar\broker\service\ReplicatorTest.java,1349,372,111,228,0,711
 pulsar-master\pulsar-master\pulsar-broker\src\main\java\org\apache\pulsar\broker\service\Producer.java,699,309,5,87,0,401
 pulsar-master\pulsar-master\pulsar-functions\instance\src\main\java\org\apache\pulsar\functions\source\MultiConsumerPulsarSource.java,77,30,2,13,0,45
 pulsar-master\pulsar-master\pulsar-client\src\main\java\org\apache\pulsar\client\impl\auth\oauth2\protocol\ClientCredentialsExchangeRequest.java,15,5,0,2,0,7
 pulsar-master\pulsar-master\pulsar-common\src\main\java\org\apache\pulsar\common\sasl\SaslConstants.java,95,42,2,14,0,58
 pulsar-master\pulsar-master\pulsar-broker\src\test\java\org\apache\pulsar\client\impl\MessageParserTest.java,122,33,0,11,0,44
 pulsar-master\pulsar-master\pulsar-broker\src\test\java\org\apache\pulsar\broker\service\ResendRequestTest.java,690,126,79,56,0,261
 pulsar-master\pulsar-master\pulsar-broker\src\main\java\org\apache\pulsar\broker\namespace\OwnershipCache.java,275,86,7,50,0,143
 pulsar-master\pulsar-master\pulsar-broker\src\main\java\org\apache\pulsar\broker\stats\prometheus\NamespaceStatsAggregator.java,406,208,1,139,0,348
 pulsar-master\pulsar-master\pulsar-metadata\src\main\java\org\apache\pulsar\metadata\impl\LocalMemoryMetadataStore.java,179,63,5,32,0,100
 pulsar-master\pulsar-master\pulsar-config-validation\src\main\java\org\apache\pulsar\config\validation\Validator.java,15,7,3,2,0,12
 pulsar-master\pulsar-master\pulsar-broker\src\test\java\org\apache\pulsar\compaction\CompactedTopicTest.java,768,189,2,117,0,308
 pulsar-master\pulsar-master\pulsar-sql\presto-pulsar\src\test\java\org\apache\pulsar\sql\presto\TestPulsarConnector.java,635,335,5,151,0,491
 pulsar-master\pulsar-master\pulsar-broker\src\test\java\org\apache\pulsar\broker\web\ExceptionHandlerTest.java,28,7,0,6,0,13
 pulsar-master\pulsar-master\pulsar-common\src\test\java\org\apache\pulsar\common\util\collections\ConcurrentLongPairSetTest.java,464,134,8,11,0,153
 pulsar-master\pulsar-master\pulsar-client-admin\src\main\java\org\apache\pulsar\client\admin\internal\package-info.java,0,1,0,1,0,2
 pulsar-master\pulsar-master\pulsar-broker\src\test\java\org\apache\pulsar\broker\service\persistent\PersistentFailoverStreamingDispatcherE2ETest.java,10,3,0,2,0,5
 pulsar-master\pulsar-master\pulsar-broker\src\test\java\org\apache\pulsar\schema\compatibility\SchemaTypeCompatibilityCheckOnTopicLevelTest.java,285,97,0,84,0,181
 pulsar-master\pulsar-master\pulsar-broker\src\main\java\org\apache\pulsar\broker\loadbalance\impl\LoadManagerShared.java,505,132,6,100,0,238
 pulsar-master\pulsar-master\tiered-storage\jcloud\src\main\java\org\apache\bookkeeper\mledger\offload\jcloud\OffloadIndexBlockBuilder.java,0,11,0,5,0,16
 pulsar-master\pulsar-master\pulsar-broker\src\test\java\org\apache\pulsar\broker\admin\AdminApiSchemaAutoUpdateTest.java,243,127,1,55,0,183
 pulsar-master\pulsar-master\pulsar-broker\src\test\java\org\apache\pulsar\client\impl\PulsarTestClient.java,169,69,5,41,0,115
 pulsar-master\pulsar-master\pulsar-functions\java-examples\src\main\java\org\apache\pulsar\functions\api\examples\WindowDurationFunction.java,0,3,0,2,0,5
 pulsar-master\pulsar-master\pulsar-functions\java-examples\src\main\java\org\apache\pulsar\functions\api\examples\RawFileKeyReader.java,40,17,0,5,0,22
 pulsar-master\pulsar-master\pulsar-broker\src\main\java\org\apache\pulsar\broker\TransactionMetadataStoreService.java,497,204,7,131,0,342
 pulsar-master\pulsar-master\pulsar-common\src\main\java\org\apache\pulsar\common\policies\data\stats\package-info.java,0,0,0,1,0,1
 pulsar-master\pulsar-master\pulsar-broker\src\test\java\org\apache\pulsar\functions\worker\PulsarWorkerAssignmentTest.java,291,111,12,56,0,179
 pulsar-master\pulsar-master\pulsar-functions\utils\src\test\java\org\apache\pulsar\functions\utils\FunctionCommonTest.java,69,16,2,6,0,24
 pulsar-master\pulsar-master\pulsar-client\src\main\java\org\apache\pulsar\client\impl\UnAckedMessageRedeliveryTracker.java,203,51,4,23,0,78
 pulsar-master\pulsar-master\pulsar-client-api\src\main\java\org\apache\pulsar\client\api\SchemaSerializationException.java,26,4,0,3,0,7
 pulsar-master\pulsar-master\pulsar-broker\src\test\java\org\apache\pulsar\broker\transaction\TransactionConsumeTest.java,249,76,3,39,0,118
 pulsar-master\pulsar-master\pulsar-io\elastic-search\src\test\java\org\apache\pulsar\io\elasticsearch\opensearch\OpenSearchClientTests.java,7,1,0,1,0,2
 pulsar-master\pulsar-master\pulsar-common\src\main\java\org\apache\pulsar\policies\data\loadbalancer\AdvertisedListener.java,38,8,0,2,0,10
 pulsar-master\pulsar-master\pulsar-broker\src\test\java\org\apache\pulsar\PulsarInitialNamespaceSetupTest.java,35,4,1,4,0,9
 pulsar-master\pulsar-master\pulsar-io\kafka\src\main\java\org\apache\pulsar\io\kafka\KafkaSinkConfig.java,105,41,0,20,0,61
 pulsar-master\pulsar-master\pulsar-broker-common\src\main\java\org\apache\pulsar\common\configuration\VipStatus.java,28,9,1,4,0,14
 pulsar-master\pulsar-master\pulsar-broker\src\main\java\org\apache\pulsar\broker\service\schema\SchemaRegistry.java,0,44,0,15,0,59
 pulsar-master\pulsar-master\pulsar-proxy\src\test\java\org\apache\pulsar\proxy\server\SuperUserAuthedAdminProxyHandlerTest.java,141,37,5,25,0,67
 pulsar-master\pulsar-master\pulsar-client-api\src\main\java\org\apache\pulsar\client\api\transaction\TxnID.java,40,6,0,1,0,7
 pulsar-master\pulsar-master\pulsar-client-tools\src\main\java\org\apache\pulsar\admin\cli\utils\CmdUtils.java,33,13,6,10,0,29
 pulsar-master\pulsar-master\pulsar-broker\src\main\java\org\apache\pulsar\broker\loadbalance\NoopLoadManager.java,114,24,0,9,0,33
 pulsar-master\pulsar-master\pulsar-broker\src\test\java\org\apache\pulsar\broker\service\persistent\MessageDuplicationTest.java,371,143,4,74,0,221
 pulsar-master\pulsar-master\pulsar-io\rabbitmq\src\test\java\org\apache\pulsar\io\rabbitmq\RabbitMQBrokerManager.java,39,12,1,3,0,16
 pulsar-master\pulsar-master\pulsar-client\src\main\java\org\apache\pulsar\client\impl\schema\IntSchema.java,81,26,1,3,0,30
 pulsar-master\pulsar-master\pulsar-broker-auth-sasl\src\main\java\org\apache\pulsar\broker\authentication\SaslAuthenticationState.java,44,16,0,5,0,21
 pulsar-master\pulsar-master\pulsar-client-tools\src\main\java\org\apache\pulsar\admin\cli\CmdBrokers.java,169,31,0,21,0,52
 pulsar-master\pulsar-master\pulsar-broker\src\test\java\org\apache\pulsar\broker\service\BrokerServiceAutoTopicCreationTest.java,381,136,5,96,0,237
 pulsar-master\pulsar-master\pulsar-common\src\main\java\org\apache\pulsar\common\policies\data\FunctionStatsImpl.java,107,33,0,17,0,50
 pulsar-master\pulsar-master\pulsar-common\src\test\java\org\apache\pulsar\common\compression\CompressionCodecZstdJNI.java,47,16,0,10,0,26
 pulsar-master\pulsar-master\managed-ledger\src\main\java\org\apache\bookkeeper\mledger\ManagedCursor.java,0,85,0,65,0,150
 pulsar-master\pulsar-master\pulsar-common\src\test\java\org\apache\pulsar\common\util\collections\GrowableArrayBlockingQueueTest.java,246,56,3,1,0,60
 pulsar-master\pulsar-master\tiered-storage\file-system\src\main\java\org\apache\bookkeeper\mledger\offload\filesystem\impl\FileStoreBackedReadHandleImpl.java,142,39,3,17,0,59
 pulsar-master\pulsar-master\pulsar-common\src\main\java-templates\org\apache\pulsar\PulsarVersion.java,80,30,3,10,0,43
 pulsar-master\pulsar-master\pulsar-broker\src\test\java\org\apache\pulsar\client\impl\KeyStoreTlsProducerConsumerTestWithAuthTest.java,225,75,16,26,0,117
 pulsar-master\pulsar-master\pulsar-broker-common\src\test\java\org\apache\pulsar\broker\authentication\AuthenticationProviderTokenTest.java,853,189,6,140,0,335
 pulsar-master\pulsar-master\pulsar-metadata\src\main\java\org\apache\pulsar\metadata\cache\impl\MetadataCacheImpl.java,0,89,8,39,0,136
 pulsar-master\pulsar-master\pulsar-client-1x-base\pulsar-client-1x\src\main\java\org\apache\pulsar\client\impl\package-info.java,0,1,0,1,0,2
 pulsar-master\pulsar-master\pulsar-broker\src\main\java\org\apache\pulsar\client\impl\RawMessageImpl.java,62,22,1,4,0,27
 pulsar-master\pulsar-master\pulsar-client-api\src\main\java\org\apache\pulsar\client\api\transaction\Transaction.java,0,0,0,1,0,1
 pulsar-master\pulsar-master\pulsar-broker\src\main\java\org\apache\pulsar\broker\transaction\exception\TransactionException.java,58,22,0,8,0,30
 pulsar-master\pulsar-master\pulsar-proxy\src\test\java\org\apache\pulsar\proxy\server\ProxyWithAuthorizationTest.java,431,147,31,70,0,248
 pulsar-master\pulsar-master\pulsar-functions\instance\src\main\java\org\apache\pulsar\functions\instance\state\StateStoreContextImpl.java,3,0,0,1,0,1
 pulsar-master\pulsar-master\pulsar-broker\src\test\java\org\apache\pulsar\broker\auth\AuthenticationServiceTest.java,93,37,8,19,0,64
 pulsar-master\pulsar-master\pulsar-io\netty\src\test\java\org\apache\pulsar\io\netty\tcp\NettyTCPChannelInitializerTest.java,16,7,2,2,0,11
 pulsar-master\pulsar-master\pulsar-client-admin-api\src\main\java\org\apache\pulsar\common\policies\impl\package-info.java,0,2,0,1,0,3
 pulsar-master\pulsar-master\bouncy-castle\bcfips\src\main\java\org\apache\pulsar\bcloader\BouncyCastleFipsLoader.java,16,5,1,2,0,8
 pulsar-master\pulsar-master\pulsar-broker\src\main\java\org\apache\pulsar\broker\service\nonpersistent\NonPersistentStickyKeyDispatcherMultipleConsumers.java,130,50,1,30,0,81
 pulsar-master\pulsar-master\pulsar-broker\src\main\java\org\apache\pulsar\broker\loadbalance\BrokerHostUsage.java,0,0,0,1,0,1
 pulsar-master\pulsar-master\pulsar-functions\java-examples\src\main\java\org\apache\pulsar\functions\api\examples\pojo\package-info.java,0,0,0,1,0,1
 pulsar-master\pulsar-master\pulsar-common\src\main\java\org\apache\pulsar\common\util\ThreadDumpUtil.java,132,31,3,18,0,52
 pulsar-master\pulsar-master\pulsar-io\dynamodb\src\main\java\org\apache\pulsar\io\dynamodb\DynamoDBSourceConfig.java,184,63,0,33,0,96
 pulsar-master\pulsar-master\pulsar-common\src\main\java\org\apache\pulsar\common\stats\JvmMetrics.java,131,34,3,16,0,53
 pulsar-master\pulsar-master\pulsar-common\src\main\java\org\apache\pulsar\common\policies\package-info.java,0,2,0,1,0,3
 pulsar-master\pulsar-master\managed-ledger\src\test\java\org\apache\bookkeeper\mledger\impl\ManagedCursorIndividualDeletedMessagesTest.java,87,67,1,11,0,79
 pulsar-master\pulsar-master\pulsar-proxy\src\test\java\org\apache\pulsar\proxy\server\ProxyAdditionalServletTest.java,145,33,5,22,0,60
 pulsar-master\pulsar-master\tests\integration\src\test\java\org\apache\pulsar\tests\integration\auth\token\TokenAuthWithPublicPrivateKeys.java,68,36,0,25,0,61
 pulsar-master\pulsar-master\pulsar-broker\src\main\java\org\apache\pulsar\broker\service\schema\NeverSchemaValidator.java,0,7,2,3,0,12
 pulsar-master\pulsar-master\buildtools\src\main\java\org\apache\pulsar\tests\RetryAnalyzer.java,40,13,1,6,0,20
 pulsar-master\pulsar-master\tests\integration\src\test\java\org\apache\pulsar\tests\integration\cli\SchemaUpdateStrategyTest.java,454,185,12,101,0,298
 pulsar-master\pulsar-master\pulsar-broker\src\test\java\org\apache\pulsar\broker\systopic\PartitionedSystemTopicTest.java,94,22,1,11,0,34
 pulsar-master\pulsar-master\pulsar-io\hdfs2\src\main\java\org\apache\pulsar\io\hdfs2\AbstractHdfsConnector.java,200,50,1,27,0,78
 pulsar-master\pulsar-master\pulsar-broker\src\test\java\org\apache\pulsar\client\api\TokenAuthenticatedProducerConsumerTest.java,118,32,0,13,0,45
 pulsar-master\pulsar-master\pulsar-common\src\main\java\org\apache\pulsar\common\util\keystoretls\KeyStoreSSLContext.java,0,176,5,47,0,228
 pulsar-master\pulsar-master\pulsar-broker\src\main\java\org\apache\pulsar\common\naming\RangeEquallyDivideBundleSplitAlgorithm.java,10,6,0,5,0,11
 pulsar-master\pulsar-master\managed-ledger\src\test\java\org\apache\bookkeeper\mledger\impl\OffloadPrefixReadTest.java,387,122,4,45,0,171
 pulsar-master\pulsar-master\pulsar-client\src\main\java\org\apache\pulsar\client\impl\PulsarClientImplementationBindingImpl.java,0,133,0,33,0,166
 pulsar-master\pulsar-master\managed-ledger\src\main\java\org\apache\bookkeeper\mledger\OffloadedLedgerMetadata.java,0,8,0,1,0,9
 pulsar-master\pulsar-master\pulsar-client-api\src\main\java\org\apache\pulsar\client\api\MessageRoutingMode.java,0,8,0,9,0,17
 pulsar-master\pulsar-master\pulsar-io\batch-data-generator\src\main\java\org\apache\pulsar\io\batchdatagenerator\BatchDataGeneratorSource.java,45,18,3,2,0,23
 pulsar-master\pulsar-master\pulsar-common\src\main\java\org\apache\pulsar\client\api\url\package-info.java,0,2,0,1,0,3
 pulsar-master\pulsar-master\pulsar-broker\src\main\java\org\apache\pulsar\broker\stats\MetricsGenerator.java,50,10,0,3,0,13
 pulsar-master\pulsar-master\pulsar-io\rabbitmq\src\test\java\org\apache\pulsar\io\rabbitmq\source\RabbitMQSourceConfigTest.java,139,8,0,1,0,9
 pulsar-master\pulsar-master\pulsar-broker-common\src\main\java\org\apache\pulsar\broker\resources\BaseResources.java,159,84,16,27,0,127
 pulsar-master\pulsar-master\pulsar-functions\worker\src\main\java\org\apache\pulsar\functions\worker\rest\api\ComponentImpl.java,1640,550,119,450,0,1119
 pulsar-master\pulsar-master\managed-ledger\src\main\java\org\apache\bookkeeper\mledger\impl\OpAddEntry.java,0,135,16,47,0,198
 pulsar-master\pulsar-master\managed-ledger\src\test\java\org\apache\bookkeeper\mledger\impl\PositionImplRecyclableTest.java,12,2,0,1,0,3
 pulsar-master\pulsar-master\tiered-storage\jcloud\src\test\java\org\apache\bookkeeper\mledger\offload\jcloud\provider\TransientBlobStoreFactoryTests.java,32,16,1,6,0,23
 pulsar-master\pulsar-master\managed-ledger\src\main\java\org\apache\bookkeeper\mledger\AsyncCallbacks.java,0,42,0,5,0,47
 pulsar-master\pulsar-master\pulsar-client\src\main\java\org\apache\pulsar\client\util\RetryMessageUtil.java,14,13,0,3,0,16
 pulsar-master\pulsar-master\pulsar-metadata\src\main\java\org\apache\pulsar\metadata\api\coordination\LeaderElection.java,0,10,0,9,0,19
 pulsar-master\pulsar-master\pulsar-broker\src\test\java\org\apache\pulsar\client\impl\LookupRetryTest.java,266,89,4,36,0,129
 pulsar-master\pulsar-master\pulsar-io\aerospike\src\main\java\org\apache\pulsar\io\aerospike\AerospikeAbstractSink.java,0,38,0,12,0,50
 pulsar-master\pulsar-master\pulsar-broker\src\test\java\org\apache\pulsar\broker\transaction\coordinator\TransactionMetaStoreTestBase.java,101,29,1,9,0,39
 pulsar-master\pulsar-master\pulsar-client\src\test\java\org\apache\pulsar\client\impl\schema\generic\GenericSchemaImplTest.java,160,35,1,21,0,57
 pulsar-master\pulsar-master\pulsar-broker\src\main\java\org\apache\pulsar\broker\loadbalance\package-info.java,0,0,0,1,0,1
 pulsar-master\pulsar-master\pulsar-functions\instance\src\main\java\org\apache\pulsar\functions\instance\state\BKStateStoreImpl.java,157,57,4,13,0,74
 pulsar-master\pulsar-master\pulsar-client\src\main\java\org\apache\pulsar\client\impl\auth\AuthenticationDataKeyStoreTls.java,28,9,0,3,0,12
 pulsar-master\pulsar-master\pulsar-common\src\test\java\org\apache\pulsar\common\policies\data\OffloadPoliciesTest.java,282,123,4,90,0,217
 pulsar-master\pulsar-master\tests\integration\src\test\java\org\apache\pulsar\tests\integration\io\sinks\ElasticSearch7SinkTester.java,14,5,0,2,0,7
 pulsar-master\pulsar-master\pulsar-broker\src\main\java\org\apache\pulsar\broker\transaction\recover\package-info.java,0,1,0,1,0,2
 pulsar-master\pulsar-master\pulsar-io\core\src\main\java\org\apache\pulsar\io\core\Source.java,0,1,0,2,0,3
 pulsar-master\pulsar-master\pulsar-io\core\src\main\java\org\apache\pulsar\io\core\BatchSource.java,0,17,0,16,0,33
 pulsar-master\pulsar-master\pulsar-client-admin-api\src\main\java\org\apache\pulsar\common\naming\TopicVersion.java,0,2,0,1,0,3
 pulsar-master\pulsar-master\pulsar-io\kinesis\src\main\java\org\apache\pulsar\io\kinesis\KinesisRecordProcessor.java,88,27,3,7,0,37
 pulsar-master\pulsar-master\tests\integration\src\test\java\org\apache\pulsar\tests\integration\functions\go\PulsarFunctionsGoThreadTest.java,7,1,0,1,0,2
 pulsar-master\pulsar-master\pulsar-broker\src\test\java\org\apache\pulsar\client\api\ConsumerAckListTest.java,80,24,0,4,0,28
 pulsar-master\pulsar-master\pulsar-broker\src\main\java\org\apache\pulsar\broker\stats\prometheus\AggregatedTransactionCoordinatorStats.java,27,16,0,1,0,17
 pulsar-master\pulsar-master\pulsar-client\src\test\java\org\apache\pulsar\client\impl\schema\generic\GenericProtobufNativeReaderTest.java,53,29,1,19,0,49
 pulsar-master\pulsar-master\pulsar-client-admin-api\src\main\java\org\apache\pulsar\common\policies\data\FunctionStats.java,0,9,0,1,0,10
 pulsar-master\pulsar-master\pulsar-client-admin-api\src\main\java\org\apache\pulsar\common\policies\data\ManagedLedgerInternalStats.java,79,61,0,7,0,68
 pulsar-master\pulsar-master\pulsar-broker\src\main\java\org\apache\pulsar\broker\cache\BundlesQuotas.java,65,45,4,13,0,62
 pulsar-master\pulsar-master\pulsar-metadata\src\main\java\org\apache\pulsar\metadata\cache\impl\JSONMetadataSerdeSimpleType.java,19,12,0,2,0,14
 pulsar-master\pulsar-master\pulsar-broker\src\test\java\org\apache\pulsar\client\impl\ConsumeBaseExceptionTest.java,52,9,0,6,0,15
 pulsar-master\pulsar-master\pulsar-io\flume\src\test\java\org\apache\pulsar\io\flume\node\TestAbstractZooKeeperConfigurationProvider.java,93,20,0,5,0,25
 pulsar-master\pulsar-master\pulsar-broker\src\main\java\org\apache\pulsar\broker\transaction\pendingack\PendingAckHandle.java,0,28,0,26,0,54
 pulsar-master\pulsar-master\pulsar-broker\src\main\java\org\apache\pulsar\broker\intercept\BrokerInterceptorDefinition.java,18,0,0,1,0,1
 pulsar-master\pulsar-master\pulsar-sql\presto-pulsar\src\main\java\org\apache\pulsar\sql\presto\decoder\avro\PulsarAvroRowDecoder.java,37,16,0,9,0,25
 pulsar-master\pulsar-master\pulsar-functions\runtime\src\main\java\org\apache\pulsar\functions\auth\KubernetesFunctionAuthProvider.java,0,9,2,5,0,16
 pulsar-master\pulsar-master\pulsar-client\src\main\java\org\apache\pulsar\client\impl\MemoryLimitController.java,60,18,0,2,0,20
 pulsar-master\pulsar-master\pulsar-broker\src\main\java\org\apache\pulsar\broker\transaction\pendingack\impl\InMemoryPendingAckStoreProvider.java,13,7,0,5,0,12
 pulsar-master\pulsar-master\pulsar-broker\src\test\java\org\apache\pulsar\broker\web\ProcessHandlerFilterTest.java,51,30,0,27,0,57
 pulsar-master\pulsar-master\pulsar-io\hdfs2\src\main\java\org\apache\pulsar\io\hdfs2\sink\seq\HdfsTextSink.java,0,6,0,2,0,8
 pulsar-master\pulsar-master\pulsar-metadata\src\main\java\org\apache\pulsar\metadata\impl\ZKSessionWatcher.java,0,38,2,17,0,57
 pulsar-master\pulsar-master\pulsar-functions\worker\src\main\java\org\apache\pulsar\functions\worker\rest\api\FunctionsImpl.java,758,264,38,240,0,542
 pulsar-master\pulsar-master\pulsar-functions\instance\src\main\java\org\apache\pulsar\functions\source\MultiConsumerPulsarSourceConfig.java,10,5,0,3,0,8
 pulsar-master\pulsar-master\pulsar-broker-auth-sasl\src\main\java\org\apache\pulsar\broker\authentication\SaslRoleToken.java,196,42,0,16,0,58
 pulsar-master\pulsar-master\pulsar-broker\src\main\java\org\apache\pulsar\broker\lookup\TopicLookupBase.java,348,145,15,101,0,261
 pulsar-master\pulsar-master\pulsar-broker\src\main\java\org\apache\pulsar\broker\service\persistent\ReplicatedSubscriptionsSnapshotBuilder.java,101,42,0,17,0,59
 pulsar-master\pulsar-master\pulsar-functions\utils\src\main\java\org\apache\pulsar\functions\utils\FunctionConfigUtils.java,957,244,29,216,0,489
 pulsar-master\pulsar-master\pulsar-package-management\core\src\main\java\org\apache\pulsar\packages\management\core\impl\package-info.java,0,1,0,1,0,2
 pulsar-master\pulsar-master\managed-ledger\src\main\java\org\apache\bookkeeper\mledger\OffloadedLedgerMetadataConsumer.java,0,0,0,1,0,1
 pulsar-master\pulsar-master\pulsar-client-admin-api\src\main\java\org\apache\pulsar\common\policies\data\RetentionPolicies.java,52,23,0,7,0,30
 pulsar-master\pulsar-master\pulsar-broker-common\src\main\java\org\apache\pulsar\broker\authentication\AuthenticationProvider.java,0,44,0,34,0,78
 pulsar-master\pulsar-master\pulsar-config-validation\src\main\java\org\apache\pulsar\config\validation\ConfigValidationAnnotations.java,123,40,0,11,0,51
 pulsar-master\pulsar-master\pulsar-broker\src\main\java\org\apache\pulsar\broker\loadbalance\ModularLoadManagerStrategy.java,0,2,1,3,0,6
 pulsar-master\pulsar-master\pulsar-functions\instance\src\main\java\org\apache\pulsar\functions\sink\PulsarSinkDisable.java,21,6,0,2,0,8
 pulsar-master\pulsar-master\pulsar-functions\worker\src\main\java\org\apache\pulsar\functions\worker\rest\package-info.java,0,0,0,1,0,1
 pulsar-master\pulsar-master\pulsar-client\src\main\java\org\apache\pulsar\client\impl\MessageImpl.java,708,363,7,90,0,460
 pulsar-master\pulsar-master\pulsar-broker\src\main\java\org\apache\pulsar\broker\service\schema\package-info.java,0,0,0,1,0,1
 pulsar-master\pulsar-master\pulsar-common\src\main\java\org\apache\pulsar\common\util\SecurityUtility.java,520,255,11,136,0,402
 pulsar-master\pulsar-master\pulsar-broker\src\test\java\org\apache\pulsar\broker\namespace\NamespaceUnloadingTest.java,41,10,0,6,0,16
 pulsar-master\pulsar-master\pulsar-broker\src\main\java\org\apache\pulsar\broker\service\persistent\MessageRedeliveryController.java,88,44,0,11,0,55
 pulsar-master\pulsar-master\pulsar-client-api\src\main\java\org\apache\pulsar\client\api\AuthenticationDataProvider.java,0,13,2,11,0,26
 pulsar-master\pulsar-master\pulsar-broker\src\main\java\org\apache\pulsar\broker\admin\v2\Bookies.java,141,54,6,34,0,94
 pulsar-master\pulsar-master\pulsar-common\src\main\java\org\apache\pulsar\common\policies\data\stats\SubscriptionStatsImpl.java,158,49,0,13,0,62
 pulsar-master\pulsar-master\pulsar-broker\src\test\java\org\apache\pulsar\client\api\TlsProducerConsumerTest.java,215,66,7,42,0,115
 pulsar-master\pulsar-master\pulsar-broker\src\main\java\org\apache\pulsar\broker\loadbalance\impl\package-info.java,0,0,0,1,0,1
 pulsar-master\pulsar-master\pulsar-broker\src\test\java\org\apache\pulsar\client\impl\ConsumerUnsubscribeTest.java,32,6,0,2,0,8
 pulsar-master\pulsar-master\pulsar-client\src\main\java\org\apache\pulsar\client\impl\TopicMessageIdImpl.java,59,20,0,3,0,23
 pulsar-master\pulsar-master\pulsar-package-management\bookkeeper-storage\src\main\java\org\apache\pulsar\packages\management\storage\bookkeeper\BookKeeperPackagesStorage.java,149,45,0,24,0,69
 pulsar-master\pulsar-master\pulsar-broker\src\test\java\org\apache\pulsar\client\api\InterceptorsTest.java,821,266,26,100,0,392
 pulsar-master\pulsar-master\pulsar-metadata\src\main\java\org\apache\pulsar\metadata\api\MetadataSerde.java,0,0,0,1,0,1
 pulsar-master\pulsar-master\pulsar-common\src\test\java\org\apache\pulsar\common\naming\TopicNameTest.java,264,42,18,37,0,97
 pulsar-master\pulsar-master\pulsar-broker\src\test\java\org\apache\pulsar\broker\service\persistent\MessageRedeliveryControllerTest.java,176,103,2,20,0,125
 pulsar-master\pulsar-master\pulsar-common\src\main\java\org\apache\pulsar\common\stats\JvmGCMetricsLogger.java,0,3,0,4,0,7
 pulsar-master\pulsar-master\pulsar-broker\src\main\java\org\apache\pulsar\broker\admin\v2\NonPersistentTopics.java,479,233,31,110,0,374
 pulsar-master\pulsar-master\pulsar-metadata\src\main\java\org\apache\pulsar\metadata\bookkeeper\HierarchicalLedgerUtils.java,0,10,0,4,0,14
 pulsar-master\pulsar-master\pulsar-broker-common\src\main\java\org\apache\pulsar\broker\resources\ClusterResources.java,123,95,0,27,0,122
 pulsar-master\pulsar-master\pulsar-testclient\src\test\java\org\apache\pulsar\testclient\Oauth2PerformanceTransactionTest.java,167,50,5,30,0,85
 pulsar-master\pulsar-master\pulsar-io\elastic-search\src\main\java\org\apache\pulsar\io\elasticsearch\package-info.java,0,1,0,1,0,2
 pulsar-master\pulsar-master\pulsar-functions\localrun\src\main\java\org\apache\pulsar\functions\LocalRunner.java,645,280,9,140,0,429
 pulsar-master\pulsar-master\pulsar-client-admin-api\src\main\java\org\apache\pulsar\common\policies\data\impl\BrokerStatusImpl.java,0,23,0,2,0,25
 pulsar-master\pulsar-master\pulsar-broker\src\test\java\org\apache\pulsar\client\processor\CustomBatchProducer.java,40,11,0,5,0,16
 pulsar-master\pulsar-master\pulsar-broker\src\test\java\org\apache\pulsar\broker\service\EnableProxyProtocolTest.java,67,14,1,13,0,28
 pulsar-master\pulsar-master\pulsar-broker\src\test\java\org\apache\pulsar\broker\web\MaxRequestSizeFilterTest.java,73,43,2,35,0,80
 pulsar-master\pulsar-master\pulsar-client\src\main\java\org\apache\pulsar\client\impl\MultiTopicsReaderImpl.java,172,58,1,22,0,81
 pulsar-master\pulsar-master\pulsar-sql\presto-pulsar\src\test\java\org\apache\pulsar\sql\presto\decoder\primitive\PrimitiveDecoderTestUtil.java,28,14,5,2,0,21
 pulsar-master\pulsar-master\pulsar-broker\src\test\java\org\apache\pulsar\broker\protocol\MockProtocolHandler.java,0,6,0,2,0,8
 pulsar-master\pulsar-master\pulsar-broker\src\main\java\org\apache\pulsar\broker\systopic\TransactionBufferSystemTopicClient.java,0,61,0,33,0,94
 pulsar-master\pulsar-master\pulsar-io\hdfs2\src\main\java\org\apache\pulsar\io\hdfs2\sink\text\HdfsAbstractTextFileSink.java,0,11,1,4,0,16
 pulsar-master\pulsar-master\tiered-storage\jcloud\src\main\java\org\apache\bookkeeper\mledger\offload\jcloud\impl\BlobStoreBackedInputStreamImpl.java,118,44,1,9,0,54
 pulsar-master\pulsar-master\pulsar-client-api\src\main\java\org\apache\pulsar\client\api\TableViewBuilder.java,0,6,0,6,0,12
 pulsar-master\pulsar-master\pulsar-functions\runtime\src\test\java\org\apache\pulsar\functions\auth\ClearTextFunctionTokenAuthProviderTest.java,36,12,0,11,0,23
 pulsar-master\pulsar-master\pulsar-client\src\main\java\org\apache\pulsar\client\impl\schema\SchemaDefinitionImpl.java,100,33,0,5,0,38
 pulsar-master\pulsar-master\pulsar-broker\src\main\java\org\apache\pulsar\broker\protocol\ProtocolHandlerDefinition.java,19,0,0,1,0,1
 pulsar-master\pulsar-master\pulsar-common\src\main\java\org\apache\pulsar\common\tls\TlsHostnameVerifier.java,266,38,9,24,0,71
 pulsar-master\pulsar-master\pulsar-common\src\main\java\org\apache\pulsar\common\policies\data\NamespaceOperation.java,0,13,0,1,0,14
 pulsar-master\pulsar-master\pulsar-broker-common\src\main\java\org\apache\pulsar\broker\authentication\AuthenticationProviderToken.java,343,127,3,58,0,188
 pulsar-master\pulsar-master\structured-event-log\src\main\java\org\apache\pulsar\structuredeventlog\package-info.java,0,0,0,1,0,1
 pulsar-master\pulsar-master\pulsar-common\src\main\java\org\apache\pulsar\common\util\ClassLoaderUtils.java,60,19,3,7,0,29
 pulsar-master\pulsar-master\pulsar-broker\src\test\java\org\apache\pulsar\broker\transaction\buffer\TransactionStablePositionTest.java,185,47,8,27,0,82
 pulsar-master\pulsar-master\pulsar-transaction\coordinator\src\main\java\org\apache\pulsar\transaction\coordinator\exceptions\CoordinatorException.java,95,44,0,12,0,56
 pulsar-master\pulsar-master\pulsar-broker\src\test\java\org\apache\pulsar\broker\admin\AdminApiTlsAuthTest.java,436,113,13,57,0,183
 pulsar-master\pulsar-master\pulsar-broker\src\test\java\org\apache\pulsar\client\api\TlsHostVerification.java,38,8,2,7,0,17
 pulsar-master\pulsar-master\pulsar-broker\src\test\java\org\apache\pulsar\client\impl\CompactedOutBatchMessageTest.java,59,22,0,11,0,33
 pulsar-master\pulsar-master\pulsar-broker\src\test\java\org\apache\pulsar\broker\resourcegroup\ResourceUsageTransportManagerTest.java,88,28,0,14,0,42
 pulsar-master\pulsar-master\pulsar-client-admin\src\main\java\org\apache\pulsar\client\admin\internal\TransactionsImpl.java,300,152,0,68,0,220
 pulsar-master\pulsar-master\pulsar-functions\instance\src\main\java\org\apache\pulsar\functions\windowing\WindowImpl.java,78,32,0,5,0,37
 pulsar-master\pulsar-master\pulsar-functions\java-examples\src\main\java\org\apache\pulsar\functions\api\examples\CustomDerivedObject.java,0,5,0,1,0,6
 pulsar-master\pulsar-master\pulsar-io\flume\src\main\java\org\apache\pulsar\io\flume\node\SimpleMaterializedConfiguration.java,50,19,0,3,0,22
 pulsar-master\pulsar-master\pulsar-common\src\main\java\io\airlift\compress\zstd\package-info.java,0,2,0,1,0,3
 pulsar-master\pulsar-master\pulsar-broker-common\src\main\java\org\apache\pulsar\zookeeper\ZkBookieRackAffinityMapping.java,4,1,0,2,0,3
 pulsar-master\pulsar-master\tests\pulsar-client-admin-shade-test\src\test\java\org\apache\pulsar\tests\integration\SmokeTest.java,59,9,0,4,0,13
 pulsar-master\pulsar-master\pulsar-broker\src\main\java\org\apache\pulsar\common\naming\NamespaceBundleSplitAlgorithm.java,0,13,0,5,0,18
 pulsar-master\pulsar-master\pulsar-io\docs\src\main\java\org\apache\pulsar\io\docs\ConnectorDocGenerator.java,132,26,3,12,0,41
 pulsar-master\pulsar-master\tests\integration\src\test\java\org\apache\pulsar\tests\integration\io\sources\debezium\PulsarDebeziumOracleSourceTest.java,66,22,1,12,0,35
 pulsar-master\pulsar-master\pulsar-common\src\main\java\org\apache\pulsar\policies\data\loadbalancer\LocalBrokerData.java,487,226,0,33,0,259
 pulsar-master\pulsar-master\pulsar-broker\src\test\java\org\apache\pulsar\client\impl\KeyStoreTlsProducerConsumerTestWithoutAuthTest.java,212,79,15,29,0,123
 pulsar-master\pulsar-master\pulsar-common\src\main\java\org\apache\pulsar\common\intercept\ManagedLedgerPayloadProcessor.java,0,5,0,6,0,11
 pulsar-master\pulsar-master\pulsar-common\src\test\java\org\apache\pulsar\common\lookup\data\LookupDataTest.java,84,30,1,17,0,48
 pulsar-master\pulsar-master\tests\integration\src\test\java\org\apache\pulsar\tests\integration\messaging\GeoReplicationTest.java,71,24,0,12,0,36
 pulsar-master\pulsar-master\pulsar-client-tools\src\main\java\org\apache\pulsar\admin\cli\CmdNamespaces.java,0,713,155,450,0,1318
 pulsar-master\pulsar-master\tests\integration\src\test\java\org\apache\pulsar\tests\integration\messaging\MessagingBase.java,128,49,3,19,0,71
 pulsar-master\pulsar-master\pulsar-metadata\src\main\java\org\apache\pulsar\metadata\impl\package-info.java,0,0,0,1,0,1
 pulsar-master\pulsar-master\pulsar-client\src\test\java\org\apache\pulsar\client\tutorial\SampleAsyncProducer.java,37,9,1,5,0,15
 pulsar-master\pulsar-master\pulsar-metadata\src\main\java\org\apache\pulsar\metadata\cache\impl\package-info.java,0,0,0,1,0,1
 pulsar-master\pulsar-master\pulsar-broker\src\test\java\org\apache\pulsar\broker\service\persistent\ReplicatedSubscriptionsSnapshotBuilderTest.java,172,48,1,15,0,64
 pulsar-master\pulsar-master\pulsar-broker\src\test\java\org\apache\pulsar\client\impl\PerMessageUnAcknowledgedRedeliveryTest.java,462,99,47,30,0,176
 pulsar-master\pulsar-master\tests\integration\src\test\java\org\apache\pulsar\tests\integration\io\sinks\KafkaSinkTester.java,82,20,1,8,0,29
 pulsar-master\pulsar-master\pulsar-broker\src\test\java\org\apache\pulsar\client\api\AuthorizationProducerConsumerTest.java,925,394,24,212,0,630
 pulsar-master\pulsar-master\pulsar-metadata\src\main\java\org\apache\pulsar\metadata\coordination\impl\CoordinationServiceImpl.java,81,25,1,7,0,33
 pulsar-master\pulsar-master\pulsar-io\file\src\test\java\org\apache\pulsar\io\file\TestFileGenerator.java,59,45,2,5,0,52
 pulsar-master\pulsar-master\pulsar-client-api\src\main\java\org\apache\pulsar\client\api\SubscriptionInitialPosition.java,0,8,0,5,0,13
 pulsar-master\pulsar-master\pulsar-io\solr\src\test\java\org\apache\pulsar\io\solr\SolrGenericRecordSinkTest.java,69,15,3,2,0,20
 pulsar-master\pulsar-master\pulsar-proxy\src\test\java\org\apache\pulsar\proxy\server\ProxyAuthenticationTest.java,206,73,3,20,0,96
 pulsar-master\pulsar-master\pulsar-functions\runtime\src\test\java\org\apache\pulsar\functions\runtime\process\ProcessRuntimeTest.java,365,150,3,72,0,225
 pulsar-master\pulsar-master\pulsar-broker\src\main\java\org\apache\pulsar\broker\web\ResponseHandlerFilter.java,87,33,2,16,0,51
 pulsar-master\pulsar-master\pulsar-common\src\test\java\org\apache\pulsar\common\policies\data\PersistentTopicStatsTest.java,208,33,0,4,0,37
 pulsar-master\pulsar-master\pulsar-client\src\main\java\org\apache\pulsar\client\impl\transaction\TransactionBuilderImpl.java,46,19,0,6,0,25
 pulsar-master\pulsar-master\pulsar-broker\src\main\java\org\apache\pulsar\broker\web\PreInterceptFilter.java,46,18,2,7,0,27
 pulsar-master\pulsar-master\pulsar-common\src\main\java\org\apache\pulsar\common\util\collections\ConcurrentLongLongPairHashMap.java,635,236,4,31,0,271
 pulsar-master\pulsar-master\pulsar-broker\src\main\java\org\apache\pulsar\broker\admin\v3\package-info.java,0,0,0,1,0,1
 pulsar-master\pulsar-master\pulsar-metadata\src\main\java\org\apache\pulsar\metadata\coordination\impl\ResourceLockImpl.java,280,70,13,34,0,117
 pulsar-master\pulsar-master\pulsar-io\elastic-search\src\test\java\org\apache\pulsar\io\elasticsearch\v7\ElasticSearch7ClientSslTests.java,7,2,0,1,0,3
 pulsar-master\pulsar-master\pulsar-client-tools\src\main\java\org\apache\pulsar\admin\cli\CmdFunctions.java,1235,500,11,225,0,736
 pulsar-master\pulsar-master\pulsar-proxy\src\test\java\org\apache\pulsar\proxy\extensions\SimpleProxyExtensionTestBase.java,138,41,4,22,0,67
 pulsar-master\pulsar-master\pulsar-io\debezium\mysql\src\main\java\org\apache\pulsar\io\debezium\mysql\DebeziumMysqlSource.java,9,6,0,4,0,10
 pulsar-master\pulsar-master\pulsar-functions\instance\src\main\java\org\apache\pulsar\functions\instance\package-info.java,0,1,0,1,0,2
 pulsar-master\pulsar-master\pulsar-broker-common\src\main\java\org\apache\pulsar\broker\resources\DynamicConfigurationResources.java,0,33,0,10,0,43
 pulsar-master\pulsar-master\tiered-storage\jcloud\src\test\java\org\apache\bookkeeper\mledger\offload\jcloud\impl\OffloadIndexV2Test.java,290,120,17,51,0,188
 pulsar-master\pulsar-master\pulsar-broker\src\main\java\org\apache\pulsar\broker\service\persistent\PersistentStickyKeyDispatcherMultipleConsumers.java,420,142,4,100,0,246
 pulsar-master\pulsar-master\pulsar-broker\src\main\java\org\apache\pulsar\broker\transaction\pendingack\package-info.java,0,1,0,1,0,2
 pulsar-master\pulsar-master\tiered-storage\jcloud\src\test\java\org\apache\bookkeeper\mledger\offload\jcloud\impl\BufferedOffloadStreamTest.java,153,31,10,10,0,51
 pulsar-master\pulsar-master\pulsar-client-api\src\main\java\org\apache\pulsar\client\api\interceptor\ProducerInterceptor.java,0,11,1,11,0,23
 pulsar-master\pulsar-master\pulsar-common\src\main\java\org\apache\pulsar\common\nar\NarClassLoaderBuilder.java,43,28,0,5,0,33
 pulsar-master\pulsar-master\pulsar-common\src\main\java\org\apache\pulsar\common\compression\CompressionCodecZLib.java,99,24,0,8,0,32
 pulsar-master\pulsar-master\tests\integration\src\test\java\org\apache\pulsar\tests\integration\admin\AdminTest.java,37,8,0,4,0,12
 pulsar-master\pulsar-master\pulsar-client\src\main\java\org\apache\pulsar\client\impl\auth\AuthenticationDisabled.java,0,12,5,5,0,22
 pulsar-master\pulsar-master\pulsar-io\elastic-search\src\main\java\org\apache\pulsar\io\elasticsearch\client\opensearch\OpenSearchHighLevelRestClient.java,225,90,5,43,0,138
 pulsar-master\pulsar-master\pulsar-broker\src\main\java\org\apache\pulsar\broker\service\AbstractReplicator.java,229,120,6,47,0,173
 pulsar-master\pulsar-master\pulsar-functions\instance\src\main\java\org\apache\pulsar\functions\instance\stats\SourceStatsManager.java,348,105,5,29,0,139
 pulsar-master\pulsar-master\pulsar-io\netty\src\main\java\org\apache\pulsar\io\netty\http\NettyHttpChannelInitializer.java,20,12,0,4,0,16
 pulsar-master\pulsar-master\pulsar-broker-common\src\test\java\org\apache\pulsar\broker\web\plugin\servlet\AdditionalServletUtilsTest.java,89,20,0,17,0,37
 pulsar-master\pulsar-master\pulsar-broker\src\test\java\org\apache\pulsar\client\api\MockBrokerService.java,353,152,9,32,0,193
 pulsar-master\pulsar-master\pulsar-broker\src\main\java\org\apache\pulsar\broker\tools\BrokerTool.java,25,7,1,2,0,10
 pulsar-master\pulsar-master\pulsar-client-admin\src\main\java\org\apache\pulsar\client\admin\internal\SchemasImpl.java,374,161,0,61,0,222
 pulsar-master\pulsar-master\managed-ledger\src\main\java\org\apache\bookkeeper\mledger\intercept\package-info.java,0,1,0,1,0,2
 pulsar-master\pulsar-master\pulsar-functions\worker\src\main\java\org\apache\pulsar\functions\worker\rest\api\FunctionsMetricsResource.java,58,12,1,4,0,17
 pulsar-master\pulsar-master\pulsar-broker\src\test\java\org\apache\pulsar\broker\loadbalance\impl\OverloadShedderTest.java,169,59,0,9,0,68
 pulsar-master\pulsar-master\pulsar-common\src\main\java\org\apache\pulsar\common\policies\data\stats\ConsumerStatsImpl.java,134,46,1,6,0,53
 pulsar-master\pulsar-master\pulsar-client-api\src\main\java\org\apache\pulsar\client\api\schema\GenericObject.java,0,1,0,2,0,3
 pulsar-master\pulsar-master\pulsar-websocket\src\main\java\org\apache\pulsar\websocket\service\WebSocketServiceStarter.java,78,28,1,20,0,49
 pulsar-master\pulsar-master\pulsar-functions\utils\src\main\java\org\apache\pulsar\functions\utils\io\ConnectorUtils.java,140,40,5,25,0,70
 pulsar-master\pulsar-master\pulsar-websocket\src\main\java\org\apache\pulsar\websocket\WebSocketHttpServletRequestWrapper.java,26,11,1,5,0,17
 pulsar-master\pulsar-master\pulsar-common\src\main\java\org\apache\pulsar\common\protocol\schema\ProtobufNativeSchemaData.java,16,1,0,2,0,3
 pulsar-master\pulsar-master\pulsar-client-admin-api\src\main\java\org\apache\pulsar\common\policies\data\TopicHashPositions.java,6,3,0,1,0,4
 pulsar-master\pulsar-master\pulsar-broker\src\main\java\org\apache\pulsar\broker\resourcegroup\ResourceUsageConsumer.java,0,3,0,2,0,5
 pulsar-master\pulsar-master\pulsar-client-tools-test\src\test\java\org\apache\pulsar\admin\cli\utils\NameValueParameterSplitterTest.java,28,5,1,2,0,8
 pulsar-master\pulsar-master\pulsar-client-admin-api\src\main\java\org\apache\pulsar\client\admin\utils\DefaultImplementation.java,21,17,0,8,0,25
 pulsar-master\pulsar-master\pulsar-broker\src\main\java\org\apache\pulsar\broker\BookKeeperClientFactoryImpl.java,185,78,0,62,0,140
 pulsar-master\pulsar-master\pulsar-common\src\test\java\org\apache\pulsar\common\io\BatchSourceConfigParseTest.java,0,19,2,9,0,30
 pulsar-master\pulsar-master\managed-ledger\src\main\java\org\apache\bookkeeper\mledger\util\RangeCache.java,0,40,5,14,0,59
 pulsar-master\pulsar-master\pulsar-client-admin-api\src\main\java\org\apache\pulsar\common\policies\data\BacklogQuota.java,0,16,0,9,0,25
 pulsar-master\pulsar-master\pulsar-testclient\src\main\java\org\apache\pulsar\testclient\utils\package-info.java,0,0,0,1,0,1
 pulsar-master\pulsar-master\pulsar-io\flume\src\test\java\org\apache\pulsar\io\flume\AbstractFlumeTests.java,4,1,1,1,0,3
 pulsar-master\pulsar-master\pulsar-functions\instance\src\main\java\org\apache\pulsar\functions\instance\state\BKStateStoreProviderImpl.java,150,54,2,28,0,84
 pulsar-master\pulsar-master\pulsar-client-api\src\main\java\org\apache\pulsar\client\api\TableView.java,0,7,0,8,0,15
 pulsar-master\pulsar-master\pulsar-client-admin-api\src\main\java\org\apache\pulsar\common\functions\FunctionConfig.java,97,56,0,12,0,68
 pulsar-master\pulsar-master\pulsar-functions\utils\src\main\java\org\apache\pulsar\functions\utils\ResourceConfigUtils.java,33,10,1,5,0,16
 pulsar-master\pulsar-master\pulsar-broker\src\main\java\org\apache\pulsar\broker\service\schema\SchemaRegistryServiceImpl.java,481,172,11,101,0,284
 pulsar-master\pulsar-master\pulsar-functions\instance\src\main\java\org\apache\pulsar\functions\source\batch\package-info.java,0,0,0,1,0,1
 pulsar-master\pulsar-master\tests\integration\src\test\java\org\apache\pulsar\tests\integration\docker\ContainerExecResult.java,22,9,0,1,0,10
 pulsar-master\pulsar-master\pulsar-broker\src\main\java\org\apache\pulsar\broker\service\schema\DefaultSchemaRegistryService.java,82,59,1,18,0,78
 pulsar-master\pulsar-master\pulsar-broker\src\main\java\org\apache\pulsar\broker\service\StreamingStats.java,62,13,1,4,0,18
 pulsar-master\pulsar-master\pulsar-broker\src\main\java\org\apache\pulsar\broker\loadbalance\BrokerFilterException.java,14,7,0,1,0,8
 pulsar-master\pulsar-master\pulsar-client-admin\src\main\java\org\apache\pulsar\client\admin\internal\OffloadProcessStatusImpl.java,32,12,0,2,0,14
 pulsar-master\pulsar-master\pulsar-functions\instance\src\test\java\org\apache\pulsar\functions\windowing\WindowManagerTest.java,789,569,1,73,0,643
 pulsar-master\pulsar-master\pulsar-io\file\src\main\java\org\apache\pulsar\io\file\utils\ZipFiles.java,47,11,4,4,0,19
 pulsar-master\pulsar-master\pulsar-broker\src\test\java\org\apache\pulsar\client\impl\BatchMessageIndexAckDisableTest.java,115,23,0,3,0,26
 pulsar-master\pulsar-master\pulsar-broker-auth-sasl\src\main\java\org\apache\pulsar\broker\authentication\SaslAuthenticationDataSource.java,19,6,0,1,0,7
 pulsar-master\pulsar-master\pulsar-common\src\main\java\org\apache\pulsar\common\compression\package-info.java,0,2,0,1,0,3
 pulsar-master\pulsar-master\pulsar-broker-auth-sasl\src\main\java\org\apache\pulsar\broker\authentication\PulsarSaslServer.java,144,41,4,21,0,66
 pulsar-master\pulsar-master\pulsar-common\src\main\java\org\apache\pulsar\common\api\raw\MessageParser.java,141,60,4,29,0,93
 pulsar-master\pulsar-master\pulsar-proxy\src\test\java\org\apache\pulsar\proxy\extensions\ProxyExtensionUtilsTest.java,102,19,2,18,0,39
 pulsar-master\pulsar-master\pulsar-client-api\src\main\java\org\apache\pulsar\client\api\HashingScheme.java,0,2,0,3,0,5
 pulsar-master\pulsar-master\pulsar-broker-common\src\main\java\org\apache\pulsar\common\configuration\package-info.java,0,1,0,1,0,2
 pulsar-master\pulsar-master\pulsar-client-admin-api\src\main\java\org\apache\pulsar\packages\management\core\common\package-info.java,0,1,0,1,0,2
 pulsar-master\pulsar-master\pulsar-broker\src\main\java\org\apache\pulsar\broker\service\AbstractDispatcherSingleActiveConsumer.java,252,104,3,38,0,145
 pulsar-master\pulsar-master\pulsar-broker\src\test\java\org\apache\pulsar\client\processor\DefaultProcessorWithRefCnt.java,13,12,0,6,0,18
 pulsar-master\pulsar-master\managed-ledger\src\test\java\org\apache\bookkeeper\mledger\impl\ManagedLedgerErrorsTest.java,489,84,25,42,0,151
 pulsar-master\pulsar-master\pulsar-broker\src\test\java\org\apache\pulsar\broker\admin\TopicPoliciesDisableTest.java,268,73,2,39,0,114
 pulsar-master\pulsar-master\pulsar-broker\src\main\java\org\apache\pulsar\broker\admin\v3\Source.java,3,1,0,1,0,2
 pulsar-master\pulsar-master\pulsar-client-admin-api\src\main\java\org\apache\pulsar\common\conf\InternalConfigurationData.java,70,31,1,4,0,36
 pulsar-master\pulsar-master\pulsar-broker\src\test\java\org\apache\pulsar\broker\service\schema\JsonSchemaCompatibilityCheckTest.java,93,37,2,13,0,52
 pulsar-master\pulsar-master\managed-ledger\src\main\java\org\apache\bookkeeper\mledger\impl\NonDurableCursorImpl.java,114,52,3,29,0,84
 pulsar-master\pulsar-master\tests\integration\src\test\java\org\apache\pulsar\tests\integration\io\sources\debezium\DebeziumMySqlSourceTester.java,96,38,2,16,0,56
 pulsar-master\pulsar-master\pulsar-broker\src\main\java\org\apache\pulsar\broker\admin\v2\ResourceGroups.java,0,30,3,11,0,44
 pulsar-master\pulsar-master\managed-ledger\src\main\java\org\apache\bookkeeper\mledger\impl\OpFindNewest.java,0,63,6,14,0,83
 pulsar-master\pulsar-master\pulsar-client-admin-api\src\main\java\org\apache\pulsar\client\admin\PulsarAdmin.java,0,3,0,2,0,5
 pulsar-master\pulsar-master\pulsar-client-admin\src\main\java\org\apache\pulsar\client\admin\internal\ComponentResource.java,36,14,2,8,0,24
 pulsar-master\pulsar-master\pulsar-proxy\src\main\java\org\apache\pulsar\proxy\stats\ConnectionStats.java,20,18,0,4,0,22
 pulsar-master\pulsar-master\pulsar-common\src\main\java\org\apache\pulsar\client\impl\schema\SchemaInfoImpl.java,46,6,0,3,0,9
 pulsar-master\pulsar-master\pulsar-broker\src\main\java\org\apache\pulsar\broker\admin\v1\PersistentTopics.java,871,764,16,291,0,1071
 pulsar-master\pulsar-master\bouncy-castle\bcfips-include-test\src\test\java\org\apache\pulsar\client\TlsProducerConsumerBase.java,80,39,6,14,0,59
 pulsar-master\pulsar-master\pulsar-functions\utils\src\main\java\org\apache\pulsar\functions\utils\FunctionMetaDataUtils.java,60,26,1,15,0,42
 pulsar-master\pulsar-master\pulsar-common\src\main\java\org\apache\pulsar\common\util\collections\ConcurrentSortedLongPairSet.java,160,61,0,17,0,78
 pulsar-master\pulsar-master\pulsar-sql\presto-pulsar\src\test\java\org\apache\pulsar\sql\presto\decoder\avro\AvroDecoderTestUtil.java,162,46,3,24,0,73
 pulsar-master\pulsar-master\pulsar-metadata\src\test\java\org\apache\pulsar\metadata\bookkeeper\PulsarMetadataDriverBaseStaticTest.java,98,13,0,3,0,16
 pulsar-master\pulsar-master\managed-ledger\src\main\java\org\apache\bookkeeper\mledger\offload\OffloaderUtils.java,125,38,5,27,0,70
 pulsar-master\pulsar-master\pulsar-client\src\test\java\org\apache\pulsar\client\impl\schema\generic\AbstractGenericSchemaTest.java,62,23,0,15,0,38
 pulsar-master\pulsar-master\pulsar-client\src\main\java\org\apache\pulsar\client\impl\schema\generic\GenericJsonRecord.java,111,26,0,5,0,31
 pulsar-master\pulsar-master\pulsar-broker\src\main\java\org\apache\pulsar\broker\service\persistent\PersistentStreamingDispatcherMultipleConsumers.java,0,45,3,37,0,85
 pulsar-master\pulsar-master\pulsar-broker\src\test\java\org\apache\pulsar\broker\MockedBookKeeperClientFactory.java,44,26,1,8,0,35
 pulsar-master\pulsar-master\pulsar-transaction\coordinator\src\main\java\org\apache\pulsar\transaction\coordinator\TransactionMetadataStore.java,0,7,0,8,0,15
 pulsar-master\pulsar-master\pulsar-common\src\main\java\org\apache\pulsar\common\util\Codec.java,22,8,3,3,0,14
 pulsar-master\pulsar-master\pulsar-broker\src\main\java\org\apache\pulsar\broker\admin\v1\package-info.java,0,0,0,1,0,1
 pulsar-master\pulsar-master\pulsar-common\src\test\java\org\apache\pulsar\common\compression\CommandsTest.java,60,14,0,5,0,19
 pulsar-master\pulsar-master\pulsar-broker\src\test\java\org\apache\pulsar\client\impl\ConsumerConfigurationTest.java,46,19,0,13,0,32
 pulsar-master\pulsar-master\pulsar-functions\instance\src\main\java\org\apache\pulsar\functions\windowing\WindowFunctionExecutor.java,0,107,4,60,0,171
 pulsar-master\pulsar-master\pulsar-broker\src\main\java\org\apache\pulsar\broker\stats\metrics\ManagedCursorMetrics.java,56,15,0,11,0,26
 pulsar-master\pulsar-master\pulsar-broker\src\test\java\org\apache\pulsar\broker\service\DistributedIdGeneratorTest.java,88,20,2,9,0,31
 pulsar-master\pulsar-master\pulsar-io\flume\src\test\java\org\apache\pulsar\io\flume\node\TestEnvVarResolverProperties.java,0,16,1,6,0,23
 pulsar-master\pulsar-master\pulsar-broker\src\test\java\org\apache\pulsar\broker\service\StandaloneTest.java,32,8,2,5,0,15
 pulsar-master\pulsar-master\pulsar-client\src\test\java\org\apache\pulsar\client\api\MessageRouterTest.java,25,6,0,1,0,7
 pulsar-master\pulsar-master\tests\integration\src\test\java\org\apache\pulsar\tests\integration\backwardscompatibility\ClientTest2_4.java,12,8,1,4,0,13
 pulsar-master\pulsar-master\pulsar-broker\src\main\java\org\apache\pulsar\broker\stats\MBeanStatsGenerator.java,84,8,2,2,0,12
 pulsar-master\pulsar-master\pulsar-common\src\test\java\org\apache\pulsar\common\compression\Crc32cChecksumTest.java,124,26,1,13,0,40
 pulsar-master\pulsar-master\pulsar-io\kafka-connect-adaptor\src\test\java\org\apache\pulsar\io\kafka\connect\MockGenericObjectWrapper.java,0,5,1,1,0,7
 pulsar-master\pulsar-master\pulsar-functions\runtime\src\main\java\org\apache\pulsar\functions\runtime\thread\ThreadRuntime.java,264,99,4,36,0,139
 pulsar-master\pulsar-master\pulsar-client\src\main\java\org\apache\pulsar\client\impl\conf\ConfigurationDataUtils.java,0,17,0,6,0,23
 pulsar-master\pulsar-master\pulsar-broker\src\test\java\org\apache\pulsar\broker\loadbalance\MultiBrokerLeaderElectionTest.java,120,31,2,19,0,52
 pulsar-master\pulsar-master\pulsar-broker\src\test\java\org\apache\pulsar\broker\admin\TopicMessageTTLTest.java,204,82,3,34,0,119
 pulsar-master\pulsar-master\pulsar-transaction\coordinator\src\main\java\org\apache\pulsar\transaction\coordinator\impl\TransactionMetadataStoreStats.java,35,13,0,3,0,16
 pulsar-master\pulsar-master\pulsar-testclient\src\main\java\org\apache\pulsar\testclient\PerformanceTransaction.java,667,322,46,166,0,534
 pulsar-master\pulsar-master\pulsar-common\src\main\java\org\apache\pulsar\common\naming\Constants.java,7,4,1,1,0,6
 pulsar-master\pulsar-master\pulsar-client\src\main\java\org\apache\pulsar\client\impl\schema\SchemaInfoUtil.java,40,10,0,2,0,12
 pulsar-master\pulsar-master\pulsar-sql\presto-pulsar\src\main\java\org\apache\pulsar\sql\presto\decoder\protobufnative\package-info.java,0,2,0,1,0,3
 pulsar-master\pulsar-master\pulsar-io\file\src\test\java\org\apache\pulsar\io\file\FileSourceConfigTests.java,93,43,3,6,0,52
 pulsar-master\pulsar-master\pulsar-common\src\test\java\org\apache\pulsar\common\policies\data\ConsumerStatsTest.java,43,9,0,1,0,10
 pulsar-master\pulsar-master\pulsar-io\influxdb\src\main\java\org\apache\pulsar\io\influxdb\v1\InfluxDBBuilderImpl.java,32,6,4,5,0,15
 pulsar-master\pulsar-master\pulsar-broker\src\test\java\org\apache\pulsar\broker\namespace\OwnerShipForCurrentServerTestBase.java,209,76,3,35,0,114
 pulsar-master\pulsar-master\pulsar-broker\src\test\java\org\apache\pulsar\broker\stats\BookieClientsStatsGeneratorTest.java,51,10,0,2,0,12
 pulsar-master\pulsar-master\pulsar-io\elastic-search\src\test\java\org\apache\pulsar\io\elasticsearch\ElasticSearchTestBase.java,32,14,1,6,0,21
 pulsar-master\pulsar-master\pulsar-common\src\main\java\org\apache\pulsar\common\intercept\InterceptException.java,10,5,0,1,0,6
 pulsar-master\pulsar-master\pulsar-broker\src\main\java\org\apache\pulsar\broker\web\ExceptionHandler.java,25,8,0,5,0,13
 pulsar-master\pulsar-master\pulsar-client-admin-api\src\main\java\org\apache\pulsar\common\functions\AuthenticationConfig.java,9,6,0,1,0,7
 pulsar-master\pulsar-master\pulsar-client-admin-api\src\main\java\org\apache\pulsar\packages\management\core\exceptions\PackagesManagementException.java,0,19,0,9,0,28
 pulsar-master\pulsar-master\pulsar-client-api\src\main\java\org\apache\pulsar\client\api\Range.java,59,24,0,2,0,26
 pulsar-master\pulsar-master\pulsar-broker-common\src\main\java\org\apache\pulsar\broker\stats\prometheus\PrometheusRawMetricsProvider.java,0,0,0,1,0,1
 pulsar-master\pulsar-master\pulsar-client-admin-api\src\main\java\org\apache\pulsar\common\policies\data\impl\package-info.java,0,1,0,1,0,2
 pulsar-master\pulsar-master\pulsar-broker\src\main\java\org\apache\pulsar\broker\service\plugin\EntryFilterMetaData.java,12,0,0,1,0,1
 pulsar-master\pulsar-master\pulsar-broker-common\src\main\java\org\apache\pulsar\broker\web\plugin\servlet\AdditionalServlet.java,0,0,0,1,0,1
 pulsar-master\pulsar-master\pulsar-common\src\main\java\org\apache\pulsar\common\compression\AirliftUtils.java,14,1,0,1,0,2
 pulsar-master\pulsar-master\pulsar-package-management\core\src\test\java\org\apache\pulsar\packages\management\core\common\PackageMetadataSerdeTest.java,31,6,2,5,0,13
 pulsar-master\pulsar-master\pulsar-client\src\main\java\org\apache\pulsar\client\impl\schema\generic\MultiVersionGenericAvroReader.java,32,14,2,10,0,26
 pulsar-master\pulsar-master\pulsar-proxy\src\test\java\org\apache\pulsar\proxy\server\ProxyTlsTest.java,83,27,3,15,0,45
 pulsar-master\pulsar-master\tests\integration\src\test\java\org\apache\pulsar\tests\integration\compaction\TestCompaction.java,332,92,1,45,0,138
 pulsar-master\pulsar-master\pulsar-io\influxdb\src\main\java\org\apache\pulsar\io\influxdb\v2\package-info.java,0,1,0,1,0,2
 pulsar-master\pulsar-master\pulsar-client\src\test\java\org\apache\pulsar\client\impl\schema\AutoConsumeSchemaTest.java,15,3,0,2,0,5
 pulsar-master\pulsar-master\pulsar-client\src\test\java\org\apache\pulsar\client\impl\schema\LocalDateSchemaTest.java,63,26,0,1,0,27
 pulsar-master\pulsar-master\pulsar-client-api\src\main\java\org\apache\pulsar\client\api\ConsumerEventListener.java,0,2,0,3,0,5
 pulsar-master\pulsar-master\pulsar-broker\src\test\java\org\apache\pulsar\client\processor\CustomBatchPayloadProcessor.java,30,10,0,6,0,16
 pulsar-master\pulsar-master\pulsar-client-admin-api\src\main\java\org\apache\pulsar\common\functions\CryptoConfig.java,10,5,0,1,0,6
 pulsar-master\pulsar-master\tests\integration\src\test\java\org\apache\pulsar\tests\integration\containers\RabbitMQContainer.java,25,10,0,1,0,11
 pulsar-master\pulsar-master\tests\integration\src\test\java\org\apache\pulsar\tests\integration\topologies\PulsarCluster.java,653,213,23,95,0,331
 pulsar-master\pulsar-master\pulsar-client-api\src\main\java\org\apache\pulsar\client\api\MessagePayloadContext.java,0,12,0,13,0,25
 pulsar-master\pulsar-master\pulsar-client-tools\src\main\java\org\apache\pulsar\admin\cli\CmdSources.java,681,259,2,109,0,370
 pulsar-master\pulsar-master\pulsar-client-admin-api\src\main\java\org\apache\pulsar\client\admin\OffloadProcessStatus.java,0,10,0,5,0,15
 pulsar-master\pulsar-master\pulsar-proxy\src\main\java\org\apache\pulsar\proxy\server\ProxyConfiguration.java,783,259,2,96,0,357
 pulsar-master\pulsar-master\pulsar-io\flume\src\main\java\org\apache\pulsar\io\flume\package-info.java,0,1,0,1,0,2
 pulsar-master\pulsar-master\pulsar-client\src\main\java\org\apache\pulsar\client\impl\SendCallback.java,0,1,0,2,0,3
 pulsar-master\pulsar-master\pulsar-client-admin-api\src\main\java\org\apache\pulsar\policies\data\loadbalancer\ResourceUsage.java,37,17,0,2,0,19
 pulsar-master\pulsar-master\pulsar-transaction\coordinator\src\main\java\org\apache\pulsar\transaction\coordinator\impl\MLTransactionMetadataStoreProvider.java,22,22,2,15,0,39
 pulsar-master\pulsar-master\pulsar-websocket\src\main\java\org\apache\pulsar\websocket\package-info.java,0,0,0,1,0,1
 pulsar-master\pulsar-master\tests\integration\src\test\java\org\apache\pulsar\tests\integration\messaging\TopicMessagingBase.java,402,59,2,30,0,91
 pulsar-master\pulsar-master\pulsar-client-api\src\main\java\org\apache\pulsar\client\api\Message.java,0,25,0,25,0,50
 pulsar-master\pulsar-master\pulsar-websocket\src\test\java\org\apache\pulsar\websocket\PingPongHandlerTest.java,87,30,5,9,0,44
 pulsar-master\pulsar-master\pulsar-client-admin-api\src\main\java\org\apache\pulsar\common\policies\data\SourceStatus.java,61,36,0,2,0,38
 pulsar-master\pulsar-master\pulsar-common\src\test\java\org\apache\pulsar\common\policies\data\EnsemblePlacementPolicyConfigTest.java,29,7,1,4,0,12
 pulsar-master\pulsar-master\pulsar-broker\src\main\java\org\apache\pulsar\broker\service\schema\BookkeeperSchemaStorageFactory.java,8,2,0,1,0,3
 pulsar-master\pulsar-master\pulsar-broker\src\main\java\org\apache\pulsar\broker\service\PulsarCommandSenderImpl.java,316,189,2,64,0,255
 pulsar-master\pulsar-master\pulsar-broker\src\test\java\org\apache\pulsar\client\api\PartitionedProducerConsumerTest.java,997,299,37,158,0,494
 pulsar-master\pulsar-master\pulsar-broker-common\src\main\java\org\apache\pulsar\broker\stats\prometheus\package-info.java,0,0,0,1,0,1
 pulsar-master\pulsar-master\pulsar-client-admin-api\src\main\java\org\apache\pulsar\common\io\SinkConfig.java,53,32,0,5,0,37
 pulsar-master\pulsar-master\pulsar-transaction\common\src\main\java\org\apache\pulsar\transaction\common\exception\package-info.java,0,2,0,1,0,3
 pulsar-master\pulsar-master\pulsar-testclient\src\test\java\org\apache\pulsar\testclient\PerformanceTransactionTest.java,189,52,2,32,0,86
 pulsar-master\pulsar-master\pulsar-client-api\src\main\java\org\apache\pulsar\client\api\ClientBuilder.java,0,74,1,70,0,145
 pulsar-master\pulsar-master\pulsar-functions\worker\src\main\java\org\apache\pulsar\functions\worker\FunctionsStatsGenerator.java,53,19,2,14,0,35
 pulsar-master\pulsar-master\pulsar-functions\worker\src\main\java\org\apache\pulsar\functions\worker\LeaderService.java,0,64,2,22,0,88
 pulsar-master\pulsar-master\pulsar-broker\src\main\java\org\apache\pulsar\broker\transaction\exception\coordinator\TransactionCoordinatorException.java,30,13,0,4,0,17
 pulsar-master\pulsar-master\pulsar-client\src\main\java\org\apache\pulsar\client\util\RetryUtil.java,39,19,2,8,0,29
 pulsar-master\pulsar-master\pulsar-functions\instance\src\test\java\org\apache\pulsar\functions\instance\InstanceUtilsTest.java,56,15,0,13,0,28
 pulsar-master\pulsar-master\pulsar-broker\src\test\java\org\apache\pulsar\broker\BrokerMessageDeduplicationTest.java,42,6,1,5,0,12
 pulsar-master\pulsar-master\pulsar-sql\presto-pulsar\src\main\java\org\apache\pulsar\sql\presto\PulsarSplit.java,193,97,1,5,0,103
 pulsar-master\pulsar-master\pulsar-client\src\main\java\org\apache\pulsar\client\impl\schema\writer\JsonWriter.java,18,6,0,1,0,7
 pulsar-master\pulsar-master\pulsar-broker\src\main\java\org\apache\pulsar\broker\service\TopicPoliciesService.java,0,59,0,29,0,88
 pulsar-master\pulsar-master\pulsar-functions\java-examples\src\main\java\org\apache\pulsar\functions\api\examples\IntegerAdditionFunction.java,0,4,0,1,0,5
 pulsar-master\pulsar-master\pulsar-broker\src\test\java\org\apache\pulsar\broker\service\PublishRateLimiterTest.java,124,65,7,27,0,99
 pulsar-master\pulsar-master\pulsar-client\src\main\java\org\apache\pulsar\client\impl\schema\generic\GenericAvroReader.java,86,35,3,9,0,47
 pulsar-master\pulsar-master\pulsar-broker\src\test\java\org\apache\pulsar\broker\service\BrokerBkEnsemblesTests.java,307,66,13,46,0,125
 pulsar-master\pulsar-master\tests\integration\src\test\java\org\apache\pulsar\tests\integration\cli\PulsarVersionTest.java,44,11,0,7,0,18
 pulsar-master\pulsar-master\pulsar-functions\worker\src\main\java\org\apache\pulsar\functions\worker\rest\api\package-info.java,0,0,0,1,0,1
 pulsar-master\pulsar-master\tests\integration\src\test\java\org\apache\pulsar\tests\integration\backwardscompatibility\SmokeTest2_5.java,18,13,1,4,0,18
 pulsar-master\pulsar-master\tests\integration\src\test\java\org\apache\pulsar\tests\integration\functions\python\PulsarFunctionsPythonTest.java,43,9,0,2,0,11
 pulsar-master\pulsar-master\pulsar-client-api\src\main\java\org\apache\pulsar\client\api\schema\GenericSchema.java,0,6,0,4,0,10
 pulsar-master\pulsar-master\pulsar-functions\worker\src\main\java\org\apache\pulsar\functions\worker\SchedulerManager.java,854,232,9,125,0,366
 pulsar-master\pulsar-master\pulsar-broker\src\test\java\org\apache\pulsar\client\api\KeySharedSubscriptionTest.java,0,367,58,143,0,568
 pulsar-master\pulsar-master\pulsar-common\src\main\java\org\apache\pulsar\common\api\raw\RawMessageId.java,0,0,0,1,0,1
 pulsar-master\pulsar-master\pulsar-common\src\main\java\org\apache\pulsar\policies\data\loadbalancer\LoadReportDeserializer.java,15,8,2,5,0,15
 pulsar-master\pulsar-master\pulsar-functions\instance\src\main\java\org\apache\pulsar\functions\source\PushPulsarSource.java,51,13,0,5,0,18
 pulsar-master\pulsar-master\pulsar-broker\src\main\java\org\apache\pulsar\broker\loadbalance\impl\SimpleResourceUnit.java,53,20,0,3,0,23
 pulsar-master\pulsar-master\pulsar-io\mongo\src\test\java\org\apache\pulsar\io\mongodb\TestHelper.java,0,7,0,1,0,8
 pulsar-master\pulsar-master\pulsar-broker\src\main\java\org\apache\pulsar\broker\loadbalance\impl\SimpleLoadCalculatorImpl.java,22,10,0,8,0,18
 pulsar-master\pulsar-master\pulsar-broker\src\main\java\org\apache\pulsar\broker\service\schema\validator\StructSchemaDataValidator.java,0,14,1,9,0,24
 pulsar-master\pulsar-master\pulsar-broker\src\test\java\org\apache\pulsar\client\impl\TransactionEndToEndTest.java,982,205,46,122,0,373
 pulsar-master\pulsar-master\pulsar-client\src\test\java\org\apache\pulsar\client\impl\HashTest.java,30,11,1,1,0,13
 pulsar-master\pulsar-master\pulsar-broker\src\main\java\org\apache\pulsar\broker\service\SystemTopicBasedTopicPoliciesService.java,526,175,9,99,0,283
 pulsar-master\pulsar-master\pulsar-client\src\main\java\org\apache\pulsar\client\util\ExecutorProvider.java,94,38,3,9,0,50
 pulsar-master\pulsar-master\pulsar-broker\src\test\java\org\apache\pulsar\broker\TimeAverageBrokerDataTest.java,109,43,1,9,0,53
 pulsar-master\pulsar-master\pulsar-broker\src\test\java\org\apache\pulsar\broker\loadbalance\impl\ThresholdShedderTest.java,183,68,0,16,0,84
 pulsar-master\pulsar-master\pulsar-broker\src\test\java\org\apache\pulsar\broker\service\streamingdispatch\StreamingEntryReaderTests.java,377,146,2,63,0,211
 pulsar-master\pulsar-master\pulsar-client-admin-api\src\main\java\org\apache\pulsar\common\policies\data\NamespaceIsolationData.java,0,13,0,3,0,16
 pulsar-master\pulsar-master\pulsar-broker-common\src\test\java\org\apache\pulsar\broker\resources\NamespaceResourcesTest.java,10,8,1,5,0,14
 pulsar-master\pulsar-master\pulsar-sql\presto-pulsar\src\main\java\org\apache\pulsar\sql\presto\PulsarInternalColumn.java,83,49,0,20,0,69
 pulsar-master\pulsar-master\pulsar-common\src\main\java\org\apache\pulsar\common\util\collections\ConcurrentOpenHashMap.java,0,197,18,21,0,236
 pulsar-master\pulsar-master\pulsar-io\elastic-search\src\main\java\org\apache\pulsar\io\elasticsearch\client\elastic\ElasticBulkProcessor.java,306,110,5,40,0,155
 pulsar-master\pulsar-master\pulsar-client\src\test\java\org\apache\pulsar\client\impl\schema\generic\GenericProtobufNativeSchemaTest.java,38,17,1,8,0,26
 pulsar-master\pulsar-master\managed-ledger\src\main\java\org\apache\bookkeeper\mledger\offload\OffloadUtils.java,0,41,0,23,0,64
 pulsar-master\pulsar-master\pulsar-client\src\test\java\org\apache\pulsar\client\impl\MultiTopicsConsumerImplTest.java,181,58,3,40,0,101
 pulsar-master\pulsar-master\pulsar-functions\utils\src\test\java\org\apache\pulsar\functions\utils\FunctionInstanceIdTest.java,35,8,4,6,0,18
 pulsar-master\pulsar-master\pulsar-client\src\main\java\org\apache\pulsar\client\impl\transaction\TransactionImpl.java,0,83,5,32,0,120
 pulsar-master\pulsar-master\pulsar-common\src\main\java\org\apache\pulsar\common\tls\NoopHostnameVerifier.java,16,4,0,2,0,6
 pulsar-master\pulsar-master\pulsar-broker\src\main\java\org\apache\pulsar\common\naming\PartitionedManagedLedgerInfo.java,9,3,0,1,0,4
 pulsar-master\pulsar-master\pulsar-broker\src\test\java\org\apache\pulsar\io\PulsarSourceE2ETest.java,171,58,3,40,0,101
 pulsar-master\pulsar-master\pulsar-websocket\src\main\java\org\apache\pulsar\websocket\admin\WebSocketProxyStatsBase.java,82,16,1,9,0,26
 pulsar-master\pulsar-master\pulsar-broker\src\main\java\org\apache\pulsar\broker\transaction\buffer\impl\package-info.java,0,1,0,1,0,2
 pulsar-master\pulsar-master\pulsar-functions\api-java\src\main\java\org\apache\pulsar\functions\api\SerDe.java,0,3,0,1,0,4
 pulsar-master\pulsar-master\pulsar-client-admin-api\src\main\java\org\apache\pulsar\common\policies\data\BookiesRackConfiguration.java,0,13,0,3,0,16
 pulsar-master\pulsar-master\pulsar-functions\instance\src\main\java\org\apache\pulsar\functions\windowing\Event.java,0,0,0,1,0,1
 pulsar-master\pulsar-master\pulsar-client\src\main\java\org\apache\pulsar\client\impl\schema\reader\MultiVersionAvroReader.java,30,17,2,10,0,29
 pulsar-master\pulsar-master\pulsar-sql\presto-pulsar\src\main\java\org\apache\pulsar\sql\presto\PulsarTransactionHandle.java,0,1,0,1,0,2
 pulsar-master\pulsar-master\tests\integration\src\test\java\org\apache\pulsar\tests\integration\offload\TestFileSystemOffload.java,31,17,0,8,0,25
 pulsar-master\pulsar-master\pulsar-functions\java-examples\src\main\java\org\apache\pulsar\functions\api\examples\MergeTopicFunction.java,0,8,3,6,0,17
 pulsar-master\pulsar-master\pulsar-client\src\main\java\org\apache\pulsar\client\impl\MessagePayloadFactoryImpl.java,13,4,0,1,0,5
 pulsar-master\pulsar-master\pulsar-io\kafka\src\main\java\org\apache\pulsar\io\kafka\AvroSchemaCache.java,0,11,1,4,0,16
 pulsar-master\pulsar-master\pulsar-common\src\main\java\org\apache\pulsar\common\util\DateFormatter.java,41,8,1,2,0,11
 pulsar-master\pulsar-master\pulsar-functions\worker\src\main\java\org\apache\pulsar\functions\worker\FunctionMetaDataTopicTailer.java,0,39,4,13,0,56
 pulsar-master\pulsar-master\pulsar-io\rabbitmq\src\test\java\org\apache\pulsar\io\rabbitmq\sink\RabbitMQSinkConfigTest.java,104,7,0,1,0,8
 pulsar-master\pulsar-master\tiered-storage\file-system\src\main\java\org\apache\bookkeeper\mledger\offload\filesystem\package-info.java,0,0,0,1,0,1
 pulsar-master\pulsar-master\pulsar-common\src\main\java\org\apache\pulsar\common\util\collections\LongPairRangeSet.java,0,102,2,23,0,127
 pulsar-master\pulsar-master\pulsar-websocket\src\main\java\org\apache\pulsar\websocket\data\ConsumerMessage.java,13,16,0,1,0,17
 pulsar-master\pulsar-master\tiered-storage\jcloud\src\test\java\org\apache\bookkeeper\mledger\offload\jcloud\BlobStoreTestBase.java,56,26,1,14,0,41
 pulsar-master\pulsar-master\pulsar-broker\src\main\java\org\apache\pulsar\broker\service\plugin\EntryFilterWithClassLoader.java,25,12,0,2,0,14
 pulsar-master\pulsar-master\pulsar-client-admin-api\src\main\java\org\apache\pulsar\client\admin\Tenants.java,0,14,0,9,0,23
 pulsar-master\pulsar-master\pulsar-broker\src\main\java\org\apache\pulsar\broker\service\schema\validator\PrimitiveSchemaDataValidator.java,0,9,1,6,0,16
 pulsar-master\pulsar-master\pulsar-client-auth-athenz\src\test\java\org\apache\pulsar\client\impl\auth\AuthenticationAthenzTest.java,180,45,7,28,0,80
 pulsar-master\pulsar-master\pulsar-package-management\bookkeeper-storage\src\main\java\org\apache\pulsar\packages\management\storage\bookkeeper\DLOutputStream.java,0,23,1,9,0,33
 pulsar-master\pulsar-master\pulsar-broker\src\main\java\org\apache\pulsar\broker\service\nonpersistent\NonPersistentSubscription.java,472,137,4,58,0,199
 pulsar-master\pulsar-master\pulsar-io\influxdb\src\main\java\org\apache\pulsar\io\influxdb\InfluxDBGenericRecordSink.java,33,12,3,5,0,20
 pulsar-master\pulsar-master\pulsar-client\src\main\java\org\apache\pulsar\client\impl\schema\KeyValueSchemaImpl.java,0,110,7,43,0,160
 pulsar-master\pulsar-master\pulsar-client-admin-api\src\main\java\org\apache\pulsar\common\policies\impl\AutoFailoverPolicyFactory.java,14,6,1,3,0,10
 pulsar-master\pulsar-master\tests\integration\src\test\java\org\apache\pulsar\tests\integration\cli\PackagesCliTest.java,109,28,1,15,0,44
 pulsar-master\pulsar-master\pulsar-broker\src\test\java\org\apache\pulsar\broker\systopic\NamespaceEventsSystemTopicServiceTest.java,112,39,3,27,0,69
 pulsar-master\pulsar-master\pulsar-io\elastic-search\src\main\java\org\apache\pulsar\io\elasticsearch\client\BulkProcessor.java,0,21,0,3,0,24
 pulsar-master\pulsar-master\pulsar-functions\worker\src\main\java\org\apache\pulsar\functions\worker\ErrorNotifierShutdownServiceImpl.java,25,8,0,2,0,10
 pulsar-master\pulsar-master\pulsar-client\src\main\java\org\apache\pulsar\client\impl\BatchMessageAckerDisabled.java,0,5,1,2,0,8
 pulsar-master\pulsar-master\pulsar-client-api\src\main\java\org\apache\pulsar\client\api\RegexSubscriptionMode.java,0,0,0,1,0,1
 pulsar-master\pulsar-master\pulsar-io\hdfs2\src\test\java\org\apache\pulsar\io\hdfs2\sink\seq\HdfsSequentialSinkTests.java,0,35,1,2,0,38
 pulsar-master\pulsar-master\pulsar-broker\src\test\java\org\apache\pulsar\broker\service\HashRangeAutoSplitStickyKeyConsumerSelectorTest.java,50,25,0,13,0,38
 pulsar-master\pulsar-master\pulsar-client\src\main\java\org\apache\pulsar\client\impl\auth\oauth2\FlowBase.java,46,15,2,7,0,24
 pulsar-master\pulsar-master\pulsar-client-tools\src\main\java\org\apache\pulsar\client\cli\CmdGenerateDocumentation.java,55,11,3,6,0,20
 pulsar-master\pulsar-master\pulsar-client\src\test\java\org\apache\pulsar\client\impl\schema\PrimitiveSchemaTest.java,126,106,3,55,0,164
 pulsar-master\pulsar-master\pulsar-broker\src\test\java\org\apache\pulsar\broker\auth\MockAuthentication.java,55,23,4,4,0,31
 pulsar-master\pulsar-master\managed-ledger\src\test\java\org\apache\bookkeeper\mledger\impl\ManagedCursorListAckTest.java,42,8,0,2,0,10
 pulsar-master\pulsar-master\pulsar-functions\java-examples\src\main\java\org\apache\pulsar\functions\api\examples\window\LoggingWindowFunction.java,0,4,1,2,0,7
 pulsar-master\pulsar-master\pulsar-client\src\test\java\org\apache\pulsar\client\impl\schema\SchemaTestUtils.java,0,86,0,28,0,114
 pulsar-master\pulsar-master\managed-ledger\src\test\java\org\apache\bookkeeper\mledger\impl\ManagedCursorPropertiesTest.java,132,17,0,8,0,25
 pulsar-master\pulsar-master\pulsar-io\hbase\src\test\java\org\apache\pulsar\io\hbase\sink\HbaseSinkConfigTest.java,120,12,0,3,0,15
 pulsar-master\pulsar-master\pulsar-metadata\src\main\java\org\apache\pulsar\metadata\impl\AbstractMetadataStore.java,0,108,4,40,0,152
 pulsar-master\pulsar-master\pulsar-broker\src\test\java\org\apache\pulsar\compaction\CompactorMXBeanImplTest.java,43,6,0,2,0,8
 pulsar-master\pulsar-master\tests\integration\src\test\java\org\apache\pulsar\tests\integration\presto\Stock.java,61,42,2,1,0,45
 pulsar-master\pulsar-master\pulsar-broker\src\main\java\org\apache\pulsar\broker\admin\impl\SourcesBase.java,479,249,47,142,0,438
 pulsar-master\pulsar-master\pulsar-client\src\main\java\org\apache\pulsar\client\impl\MessagePayloadContextImpl.java,120,35,3,13,0,51
 pulsar-master\pulsar-master\pulsar-broker\src\test\java\org\apache\pulsar\broker\auth\MockAuthorizationProvider.java,246,216,3,59,0,278
 pulsar-master\pulsar-master\pulsar-client-admin-api\src\main\java\org\apache\pulsar\common\policies\data\TopicStats.java,0,23,0,1,0,24
 pulsar-master\pulsar-master\pulsar-io\file\src\test\java\org\apache\pulsar\io\file\FileConsumerThreadTests.java,111,32,0,13,0,45
 pulsar-master\pulsar-master\pulsar-io\file\src\main\java\org\apache\pulsar\io\file\package-info.java,0,1,0,1,0,2
 pulsar-master\pulsar-master\pulsar-functions\java-examples\src\main\java\org\apache\pulsar\functions\api\examples\CustomDerivedToBaseFunction.java,0,6,0,3,0,9
 pulsar-master\pulsar-master\pulsar-client-admin-api\src\main\java\org\apache\pulsar\client\admin\PulsarAdminException.java,228,99,43,20,0,162
 pulsar-master\pulsar-master\pulsar-functions\instance\src\main\java\org\apache\pulsar\functions\sink\PulsarSink.java,405,138,4,65,0,207
 pulsar-master\pulsar-master\pulsar-broker\src\test\java\org\apache\pulsar\websocket\proxy\ProxyPublishConsumeTest.java,993,227,8,132,0,367
 pulsar-master\pulsar-master\pulsar-broker\src\main\java\org\apache\pulsar\broker\service\schema\exceptions\package-info.java,0,0,0,1,0,1
 pulsar-master\pulsar-master\pulsar-broker\src\main\java\org\apache\pulsar\broker\service\Consumer.java,941,386,17,169,0,572
 pulsar-master\pulsar-master\pulsar-io\hdfs3\src\main\java\org\apache\pulsar\io\hdfs3\sink\seq\HdfsTextSink.java,0,6,0,2,0,8
 pulsar-master\pulsar-master\pulsar-client\src\test\java\org\apache\pulsar\client\impl\schema\DefaultSchemasTest.java,53,13,0,6,0,19
 pulsar-master\pulsar-master\pulsar-io\debezium\mysql\src\main\java\org\apache\pulsar\io\debezium\mysql\package-info.java,0,1,0,1,0,2
 pulsar-master\pulsar-master\pulsar-common\src\main\java\org\apache\pulsar\common\naming\NamedEntity.java,15,6,0,2,0,8
 pulsar-master\pulsar-master\buildtools\src\main\java\org\apache\pulsar\tests\BetweenTestClassesListenerAdapter.java,0,10,0,6,0,16
 pulsar-master\pulsar-master\tests\integration\src\test\java\org\apache\pulsar\tests\integration\cli\FunctionsCLITest.java,62,11,0,5,0,16
 pulsar-master\pulsar-master\pulsar-broker\src\test\java\org\apache\pulsar\broker\service\BrokerServiceThrottlingTest.java,260,57,6,32,0,95
 pulsar-master\pulsar-master\pulsar-functions\utils\src\main\java\org\apache\pulsar\functions\utils\SourceConfigUtils.java,489,147,28,103,0,278
 pulsar-master\pulsar-master\pulsar-io\elastic-search\src\main\java\org\apache\pulsar\io\elasticsearch\client\elastic\package-info.java,0,1,0,1,0,2
 pulsar-master\pulsar-master\pulsar-broker\src\main\java\org\apache\pulsar\PulsarStandaloneStarter.java,117,22,6,10,0,38
 pulsar-master\pulsar-master\pulsar-broker\src\test\java\org\apache\pulsar\broker\admin\TopicsAuthTest.java,134,59,5,22,0,86
 pulsar-master\pulsar-master\pulsar-broker\src\test\java\org\apache\pulsar\client\impl\MessageChunkingTest.java,448,132,12,60,0,204
 pulsar-master\pulsar-master\pulsar-metadata\src\test\java\org\apache\pulsar\metadata\LeaderElectionTest.java,247,66,9,40,0,115
 pulsar-master\pulsar-master\pulsar-metadata\src\main\java\org\apache\pulsar\metadata\bookkeeper\BookieServiceInfoSerde.java,39,12,1,6,0,19
 pulsar-master\pulsar-master\pulsar-client\src\main\java\org\apache\pulsar\client\impl\PulsarClientImpl.java,1044,445,29,201,0,675
 pulsar-master\pulsar-master\pulsar-client-admin-api\src\main\java\org\apache\pulsar\client\admin\ProxyStats.java,0,2,0,1,0,3
 pulsar-master\pulsar-master\pulsar-broker\src\main\java\org\apache\pulsar\broker\service\persistent\CompactorSubscription.java,77,40,0,24,0,64
 pulsar-master\pulsar-master\pulsar-client-api\src\main\java\org\apache\pulsar\client\internal\package-info.java,0,2,0,2,0,4
 pulsar-master\pulsar-master\pulsar-io\elastic-search\src\test\java\org\apache\pulsar\io\elasticsearch\v8\ElasticSearch8ClientSslTests.java,7,2,0,1,0,3
 pulsar-master\pulsar-master\pulsar-config-validation\src\test\java\org\apache\pulsar\config\validation\ValidatorImplsTest.java,119,49,0,34,0,83
 pulsar-master\pulsar-master\pulsar-common\src\main\java\org\apache\pulsar\common\nar\package-info.java,0,2,0,1,0,3
 pulsar-master\pulsar-master\pulsar-io\influxdb\src\main\java\org\apache\pulsar\io\influxdb\package-info.java,0,1,0,1,0,2
 pulsar-master\pulsar-master\pulsar-client-api\src\main\java\org\apache\pulsar\client\api\schema\SchemaInfoProvider.java,0,0,0,1,0,1
 pulsar-master\pulsar-master\pulsar-broker\src\main\java\org\apache\pulsar\broker\admin\impl\ResourceQuotasBase.java,100,38,7,27,0,72
 pulsar-master\pulsar-master\pulsar-client-admin\src\main\java\org\apache\pulsar\client\admin\internal\ClustersImpl.java,376,227,0,87,0,314
 pulsar-master\pulsar-master\pulsar-client\src\main\java\org\apache\pulsar\client\impl\ReaderImpl.java,195,70,3,31,0,104
 pulsar-master\pulsar-master\pulsar-client\src\test\java\org\apache\pulsar\client\impl\ReaderImplTest.java,46,10,0,5,0,15
 pulsar-master\pulsar-master\pulsar-broker\src\main\java\org\apache\pulsar\broker\loadbalance\ResourceDescription.java,11,6,0,3,0,9
 pulsar-master\pulsar-master\pulsar-broker\src\main\java\org\apache\pulsar\broker\admin\v3\Functions.java,3,1,0,2,0,3
 pulsar-master\pulsar-master\pulsar-websocket\src\main\java\org\apache\pulsar\websocket\WebSocketService.java,265,114,0,36,0,150
 pulsar-master\pulsar-master\pulsar-functions\secrets\src\main\java\org\apache\pulsar\functions\package-info.java,0,0,0,1,0,1
 pulsar-master\pulsar-master\pulsar-io\flume\src\test\java\org\apache\pulsar\io\flume\source\StringSourceTests.java,67,16,2,1,0,19
 pulsar-master\pulsar-master\pulsar-broker\src\test\java\org\apache\pulsar\broker\admin\IncrementPartitionsTest.java,122,44,3,25,0,72
 pulsar-master\pulsar-master\pulsar-common\src\main\java\org\apache\pulsar\common\util\BCLoader.java,0,1,0,1,0,2
 pulsar-master\pulsar-master\pulsar-io\kafka-connect-adaptor\src\test\java\org\apache\pulsar\io\kafka\connect\ErrFileStreamSourceTask.java,9,2,0,1,0,3
 pulsar-master\pulsar-master\pulsar-client\src\main\java\org\apache\pulsar\client\util\MathUtils.java,30,7,0,2,0,9
 pulsar-master\pulsar-master\pulsar-io\elastic-search\src\test\java\org\apache\pulsar\io\elasticsearch\v8\ElasticSearch8SinkTests.java,7,1,0,1,0,2
 pulsar-master\pulsar-master\pulsar-broker\src\test\java\org\apache\pulsar\broker\admin\v3\AdminApiTransactionTest.java,403,140,1,94,0,235
 pulsar-master\pulsar-master\pulsar-broker\src\main\java\org\apache\pulsar\broker\service\persistent\ReplicatedSubscriptionSnapshotCache.java,60,25,1,12,0,38
 pulsar-master\pulsar-master\pulsar-client-auth-athenz\src\main\java\org\apache\pulsar\client\impl\auth\package-info.java,0,1,0,1,0,2
 pulsar-master\pulsar-master\pulsar-proxy\src\main\java\org\apache\pulsar\proxy\stats\ProxyStats.java,73,37,0,19,0,56
 pulsar-master\pulsar-master\pulsar-client-tools\src\main\java\org\apache\pulsar\admin\cli\CliCommand.java,184,49,3,15,0,67
 pulsar-master\pulsar-master\pulsar-functions\utils\src\test\java\org\apache\pulsar\functions\utils\ExceptionsTest.java,74,14,0,6,0,20
 pulsar-master\pulsar-master\pulsar-client-admin-api\src\main\java\org\apache\pulsar\common\policies\data\WorkerFunctionInstanceStats.java,8,3,0,1,0,4
 pulsar-master\pulsar-master\pulsar-io\kinesis\src\test\java\org\apache\pulsar\io\kinesis\KinesisSourceConfigTests.java,151,47,0,18,0,65
 pulsar-master\pulsar-master\pulsar-metadata\src\main\java\org\apache\pulsar\metadata\bookkeeper\PulsarMetadataClientDriver.java,41,17,0,8,0,25
 pulsar-master\pulsar-master\pulsar-broker\src\test\java\org\apache\pulsar\broker\service\schema\KeyValueSchemaCompatibilityCheckTest.java,451,247,0,212,0,459
 pulsar-master\pulsar-master\pulsar-client\src\test\java\org\apache\pulsar\client\impl\schema\LongSchemaTest.java,68,30,0,1,0,31
 pulsar-master\pulsar-master\pulsar-client\src\main\java\org\apache\pulsar\client\impl\DefaultBatcherBuilder.java,10,1,0,1,0,2
 pulsar-master\pulsar-master\pulsar-sql\presto-pulsar\src\main\java\org\apache\pulsar\sql\presto\decoder\json\PulsarJsonRowDecoderFactory.java,122,37,2,22,0,61
 pulsar-master\pulsar-master\pulsar-broker-common\src\main\java\org\apache\pulsar\broker\stats\prometheus\PrometheusMetricsGeneratorUtils.java,0,15,1,7,0,23
 pulsar-master\pulsar-master\pulsar-io\core\src\test\java\org\apache\pulsar\io\core\SourceTest.java,30,6,1,2,0,9
 pulsar-master\pulsar-master\pulsar-io\elastic-search\src\test\java\org\apache\pulsar\io\elasticsearch\ElasticSearchExtractTests.java,236,58,7,48,0,113
 pulsar-master\pulsar-master\pulsar-common\src\test\java\org\apache\pulsar\common\policies\data\ResourceQuotaTest.java,58,22,0,1,0,23
 pulsar-master\pulsar-master\pulsar-client-admin-api\src\main\java\org\apache\pulsar\common\policies\data\PublisherStats.java,0,12,0,1,0,13
 pulsar-master\pulsar-master\pulsar-client\src\test\java\org\apache\pulsar\client\impl\BatchMessageAckerTest.java,54,14,2,2,0,18
 pulsar-master\pulsar-master\pulsar-proxy\src\test\java\org\apache\pulsar\proxy\server\UnauthedAdminProxyHandlerTest.java,95,25,3,12,0,40
 pulsar-master\pulsar-master\tests\docker-images\java-test-functions\src\main\java\org\apache\pulsar\tests\integration\functions\GenericObjectFunction.java,0,8,2,6,0,16
 pulsar-master\pulsar-master\pulsar-common\src\test\java\org\apache\pulsar\common\util\collections\ConcurrentOpenHashMapTest.java,557,97,7,16,0,120
 pulsar-master\pulsar-master\pulsar-client\src\test\java\org\apache\pulsar\client\tutorial\SampleConsumerListener.java,19,5,1,3,0,9
 pulsar-master\pulsar-master\pulsar-client-api\src\main\java\org\apache\pulsar\client\api\BatcherBuilder.java,0,6,0,7,0,13
 pulsar-master\pulsar-master\pulsar-io\debezium\oracle\src\main\java\org\apache\pulsar\io\debezium\oracle\package-info.java,0,1,0,1,0,2
 pulsar-master\pulsar-master\pulsar-client\src\test\java\org\apache\pulsar\client\impl\ControlledClusterFailoverTest.java,97,18,0,16,0,34
 pulsar-master\pulsar-master\pulsar-io\core\src\main\java\org\apache\pulsar\io\core\SinkContext.java,0,8,0,9,0,17
 pulsar-master\pulsar-master\pulsar-client-api\src\main\java\org\apache\pulsar\common\classification\InterfaceAudience.java,28,9,2,1,0,12
 pulsar-master\pulsar-master\managed-ledger\src\main\java\org\apache\bookkeeper\mledger\impl\ManagedLedgerOfflineBacklog.java,414,155,4,112,0,271
 pulsar-master\pulsar-master\pulsar-broker\src\main\java\org\apache\pulsar\broker\stats\prometheus\PulsarPrometheusMetricsServlet.java,29,23,0,7,0,30
 pulsar-master\pulsar-master\pulsar-io\kinesis\src\main\java\org\apache\pulsar\io\kinesis\Backoff.java,72,47,0,8,0,55
 pulsar-master\pulsar-master\pulsar-common\src\main\java\org\apache\pulsar\common\policies\data\stats\PartitionedTopicStatsImpl.java,28,11,0,2,0,13
 pulsar-master\pulsar-master\managed-ledger\src\test\java\org\apache\bookkeeper\mledger\impl\ManagedLedgerMBeanTest.java,113,28,2,8,0,38
 pulsar-master\pulsar-master\pulsar-broker\src\main\java\org\apache\pulsar\broker\service\streamingdispatch\PendingReadEntryRequest.java,47,25,0,5,0,30
 pulsar-master\pulsar-master\pulsar-functions\utils\src\main\java\org\apache\pulsar\functions\utils\FunctionCommon.java,478,184,13,84,0,281
 pulsar-master\pulsar-master\managed-ledger\src\main\java\org\apache\bookkeeper\mledger\impl\EntryCacheManager.java,260,113,7,37,0,157
 pulsar-master\pulsar-master\pulsar-common\src\main\java\org\apache\pulsar\common\policies\data\NamespaceIsolationDataImpl.java,92,41,1,12,0,54
 pulsar-master\pulsar-master\pulsar-functions\instance\src\main\java\org\apache\pulsar\functions\windowing\WaterMarkEvent.java,17,5,0,1,0,6
 pulsar-master\pulsar-master\pulsar-testclient\src\test\java\org\apache\pulsar\testclient\PerformanceProducerTest.java,154,34,2,16,0,52
 pulsar-master\pulsar-master\pulsar-io\influxdb\src\main\java\org\apache\pulsar\io\influxdb\v2\InfluxDBClientBuilderImpl.java,23,3,1,2,0,6
 pulsar-master\pulsar-master\pulsar-broker\src\main\java\org\apache\pulsar\broker\loadbalance\ServiceUnit.java,10,7,0,4,0,11
 pulsar-master\pulsar-master\pulsar-broker\src\test\java\org\apache\pulsar\client\api\TenantTest.java,40,11,1,6,0,18
 pulsar-master\pulsar-master\pulsar-client\src\main\java\org\apache\pulsar\client\impl\schema\reader\JsonReader.java,36,15,0,1,0,16
 pulsar-master\pulsar-master\pulsar-common\src\test\java\org\apache\pulsar\common\util\collections\DefaultRangeSetTest.java,38,14,2,2,0,18
 pulsar-master\pulsar-master\pulsar-io\dynamodb\src\main\java\org\apache\pulsar\io\dynamodb\DynamoDBSource.java,85,33,6,24,0,63
 pulsar-master\pulsar-master\pulsar-common\src\main\java\org\apache\pulsar\common\naming\NamespaceName.java,187,56,7,14,0,77
 pulsar-master\pulsar-master\buildtools\src\test\java\org\apache\pulsar\tests\TestRetrySupportBeforeMethodRetryTest.java,43,13,0,5,0,18
 pulsar-master\pulsar-master\pulsar-broker\src\main\java\org\apache\pulsar\broker\resourcegroup\ResourceGroupService.java,779,314,7,160,0,481
 pulsar-master\pulsar-master\tests\integration\src\test\java\org\apache\pulsar\tests\integration\cli\topicpolicies\SchemaCompatibilityStrategyTest.java,61,19,0,15,0,34
 pulsar-master\pulsar-master\pulsar-common\src\main\java\org\apache\pulsar\common\util\CmdGenerateDocs.java,137,30,7,13,0,50
 pulsar-master\pulsar-master\pulsar-io\hdfs2\src\main\java\org\apache\pulsar\io\hdfs2\sink\HdfsSyncThread.java,48,14,0,2,0,16
 pulsar-master\pulsar-master\pulsar-websocket\src\main\java\org\apache\pulsar\websocket\WebSocketError.java,0,17,1,1,0,19
 pulsar-master\pulsar-master\tiered-storage\jcloud\src\main\java\org\apache\bookkeeper\mledger\offload\jcloud\provider\package-info.java,0,1,0,1,0,2
 pulsar-master\pulsar-master\pulsar-io\jdbc\sqlite\src\test\java\org\apache\pulsar\io\jdbc\SqliteJdbcSinkTest.java,349,83,17,33,0,133
 pulsar-master\pulsar-master\pulsar-broker-common\src\main\java\org\apache\pulsar\broker\resources\LocalPoliciesResources.java,71,58,1,18,0,77
 pulsar-master\pulsar-master\tests\integration\src\test\java\org\apache\pulsar\tests\integration\containers\DebeziumMongoDbContainer.java,30,9,0,2,0,11
 pulsar-master\pulsar-master\pulsar-client\src\test\java\org\apache\pulsar\client\impl\schema\StringSchemaTest.java,103,7,0,1,0,8
 pulsar-master\pulsar-master\pulsar-broker\src\test\java\org\apache\pulsar\broker\service\plugin\FilterEntryTest.java,163,33,3,19,0,55
 pulsar-master\pulsar-master\pulsar-common\src\main\java\org\apache\pulsar\common\compression\CompressionCodecNone.java,15,6,0,2,0,8
 pulsar-master\pulsar-master\pulsar-websocket\src\main\java\org\apache\pulsar\websocket\admin\package-info.java,0,0,0,1,0,1
 pulsar-master\pulsar-master\pulsar-client-api\src\main\java\org\apache\pulsar\client\internal\DefaultImplementation.java,24,6,2,5,0,13
 pulsar-master\pulsar-master\managed-ledger\src\test\java\org\apache\bookkeeper\mledger\util\MockClock.java,0,10,0,1,0,11
 pulsar-master\pulsar-master\pulsar-client-admin\src\main\java\org\apache\pulsar\client\admin\internal\NonPersistentTopicsImpl.java,186,83,0,30,0,113
 pulsar-master\pulsar-master\pulsar-broker\src\test\java\org\apache\pulsar\broker\loadbalance\AdvertisedListenersTest.java,75,17,1,8,0,26
 pulsar-master\pulsar-master\pulsar-broker-common\src\test\java\org\apache\pulsar\broker\web\plugin\servlet\MockAdditionalServlet.java,23,4,2,1,0,7
 pulsar-master\pulsar-master\pulsar-broker\src\test\java\org\apache\pulsar\broker\BookKeeperClientFactoryImplTest.java,235,56,0,42,0,98
 pulsar-master\pulsar-master\pulsar-functions\worker\src\test\java\org\apache\pulsar\functions\worker\executor\MockExecutorController.java,163,52,0,16,0,68
 pulsar-master\pulsar-master\managed-ledger\src\main\java\org\apache\bookkeeper\mledger\impl\PositionImpl.java,0,60,2,3,0,65
 pulsar-master\pulsar-master\pulsar-client\src\main\java\org\apache\pulsar\client\impl\schema\generic\GenericAvroRecord.java,48,16,0,2,0,18
 pulsar-master\pulsar-master\pulsar-common\src\main\java\org\apache\pulsar\common\protocol\schema\StoredSchema.java,39,14,0,1,0,15
 pulsar-master\pulsar-master\managed-ledger\src\main\java\org\apache\bookkeeper\mledger\impl\EntryCacheDefaultEvictionPolicy.java,61,20,2,14,0,36
 pulsar-master\pulsar-master\pulsar-functions\runtime\src\test\java\org\apache\pulsar\functions\runtime\kubernetes\BasicKubernetesManifestCustomizerTest.java,60,23,4,14,0,41
 pulsar-master\pulsar-master\tiered-storage\jcloud\src\main\java\org\apache\bookkeeper\mledger\offload\jcloud\impl\OffloadIndexBlockImpl.java,0,72,4,27,0,103
 pulsar-master\pulsar-master\pulsar-functions\worker\src\main\java\org\apache\pulsar\functions\worker\rest\api\v2\WorkerApiV2Resource.java,179,83,3,23,0,109
 pulsar-master\pulsar-master\pulsar-functions\worker\src\main\java\org\apache\pulsar\functions\worker\rest\RestUtils.java,0,7,0,2,0,9
 pulsar-master\pulsar-master\managed-ledger\src\main\java\org\apache\bookkeeper\mledger\util\CallbackMutex.java,44,16,0,4,0,20
 pulsar-master\pulsar-master\pulsar-common\src\main\java\org\apache\pulsar\common\policies\data\TopicPolicies.java,133,81,0,2,0,83
 pulsar-master\pulsar-master\tests\integration\src\test\java\org\apache\pulsar\tests\integration\functions\go\PulsarFunctionsGoProcessTest.java,8,2,0,1,0,3
 pulsar-master\pulsar-master\tests\integration\src\test\java\org\apache\pulsar\tests\integration\backwardscompatibility\PulsarStandaloneTestSuite2_2.java,6,3,1,2,0,6
 pulsar-master\pulsar-master\pulsar-broker\src\main\java\org\apache\pulsar\broker\service\schema\validator\ProtobufNativeSchemaDataValidator.java,27,9,1,7,0,17
 pulsar-master\pulsar-master\pulsar-client\src\main\java\org\apache\pulsar\client\impl\schema\AbstractSchema.java,62,17,2,12,0,31
 pulsar-master\pulsar-master\pulsar-broker\src\main\java\org\apache\pulsar\broker\transaction\buffer\package-info.java,0,1,0,1,0,2
 pulsar-master\pulsar-master\pulsar-functions\runtime\src\main\java\org\apache\pulsar\functions\runtime\kubernetes\KubernetesRuntimeFactoryConfig.java,145,88,0,35,0,123
 pulsar-master\pulsar-master\pulsar-package-management\core\src\main\java\org\apache\pulsar\packages\management\core\PackagesManagement.java,0,12,0,8,0,20
 pulsar-master\pulsar-master\pulsar-testclient\src\main\java\org\apache\pulsar\testclient\PerformanceProducer.java,813,353,39,155,0,547
 pulsar-master\pulsar-master\pulsar-broker\src\main\java\org\apache\pulsar\broker\stats\prometheus\metrics\DataSketchesOpStatsLogger.java,163,45,4,6,0,55
 pulsar-master\pulsar-master\pulsar-sql\presto-pulsar\src\main\java\org\apache\pulsar\sql\presto\PulsarConnectorUtils.java,71,28,1,11,0,40
 pulsar-master\pulsar-master\pulsar-transaction\coordinator\src\test\java\org\apache\pulsar\transaction\coordinator\TransactionMetadataStoreProviderTest.java,213,52,2,37,0,91
 pulsar-master\pulsar-master\pulsar-io\hdfs2\src\main\java\org\apache\pulsar\io\hdfs2\AbstractHdfsConfig.java,47,7,2,6,0,15
 pulsar-master\pulsar-master\pulsar-broker\src\main\java\org\apache\pulsar\broker\stats\metrics\AbstractMetrics.java,214,74,7,28,0,109
 pulsar-master\pulsar-master\pulsar-io\elastic-search\src\main\java\org\apache\pulsar\io\elasticsearch\client\elastic\ElasticSearchJavaRestClient.java,150,52,5,21,0,78
 pulsar-master\pulsar-master\pulsar-client-tools\src\main\java\org\apache\pulsar\admin\cli\CmdSchemas.java,133,40,3,23,0,66
 pulsar-master\pulsar-master\managed-ledger\src\test\java\org\apache\bookkeeper\mledger\impl\NonDurableCursorTest.java,710,125,7,44,0,176
 pulsar-master\pulsar-master\pulsar-io\elastic-search\src\test\java\org\apache\pulsar\io\elasticsearch\ElasticSearchSinkRawDataTests.java,0,41,1,5,0,47
 pulsar-master\pulsar-master\managed-ledger\src\main\java\org\apache\bookkeeper\mledger\ManagedLedgerFactory.java,0,25,0,19,0,44
 pulsar-master\pulsar-master\pulsar-functions\instance\src\main\java\org\apache\pulsar\functions\sink\package-info.java,0,0,0,1,0,1
 pulsar-master\pulsar-master\pulsar-common\src\test\java\org\apache\pulsar\common\util\FutureUtilTest.java,101,20,2,14,0,36
 pulsar-master\pulsar-master\tiered-storage\jcloud\src\main\java\org\apache\bookkeeper\mledger\offload\jcloud\BlockAwareSegmentInputStream.java,42,2,0,2,0,4
 pulsar-master\pulsar-master\pulsar-broker\src\main\java\org\apache\pulsar\broker\resourcegroup\ResourceQuotaCalculatorImpl.java,103,40,0,27,0,67
 pulsar-master\pulsar-master\pulsar-broker\src\main\java\org\apache\pulsar\broker\stats\package-info.java,0,0,0,1,0,1
 pulsar-master\pulsar-master\pulsar-client-admin-api\src\main\java\org\apache\pulsar\common\policies\data\impl\BacklogQuotaImpl.java,100,54,0,4,0,58
 pulsar-master\pulsar-master\pulsar-io\kafka\src\main\java\org\apache\pulsar\io\kafka\ByteBufferSchemaWrapper.java,0,15,3,3,0,21
 pulsar-master\pulsar-master\pulsar-io\jdbc\postgres\src\main\java\org\apache\pulsar\io\jdbc\PostgresJdbcAutoSchemaSink.java,4,1,0,2,0,3
 pulsar-master\pulsar-master\managed-ledger\src\main\java\org\apache\bookkeeper\mledger\offload\package-info.java,0,1,0,1,0,2
 pulsar-master\pulsar-master\pulsar-testclient\src\main\java\org\apache\pulsar\testclient\package-info.java,0,0,0,1,0,1
 pulsar-master\pulsar-master\pulsar-io\solr\src\main\java\org\apache\pulsar\io\solr\SolrGenericRecordSink.java,14,3,0,2,0,5
 pulsar-master\pulsar-master\buildtools\src\test\java\org\apache\pulsar\tests\RetryAnalyzerTest.java,37,9,0,1,0,10
 pulsar-master\pulsar-master\pulsar-common\src\main\java\org\apache\pulsar\common\util\NettyClientSslContextRefresher.java,63,38,1,12,0,51
 pulsar-master\pulsar-master\buildtools\src\main\java\org\apache\pulsar\tests\FailFastNotifier.java,0,23,2,12,0,37
 pulsar-master\pulsar-master\pulsar-functions\instance\src\main\java\org\apache\pulsar\functions\instance\state\StateStoreProvider.java,0,9,2,4,0,15
 pulsar-master\pulsar-master\pulsar-client-api\src\main\java\org\apache\pulsar\client\api\ProducerCryptoFailureAction.java,0,0,0,1,0,1
 pulsar-master\pulsar-master\tiered-storage\jcloud\src\main\java\org\apache\bookkeeper\mledger\offload\jcloud\impl\BlobStoreManagedLedgerOffloader.java,619,201,30,111,0,342
 pulsar-master\pulsar-master\pulsar-transaction\coordinator\src\main\java\org\apache\pulsar\transaction\coordinator\TxnMeta.java,0,4,0,5,0,9
 pulsar-master\pulsar-master\pulsar-broker\src\test\java\org\apache\pulsar\socks5\handler\InitialRequestHandler.java,26,10,1,5,0,16
 pulsar-master\pulsar-master\pulsar-client-1x-base\pulsar-client-1x\src\main\java\org\apache\pulsar\client\api\ReaderListener.java,0,4,0,4,0,8
 pulsar-master\pulsar-master\pulsar-io\mongo\src\main\java\org\apache\pulsar\io\mongodb\MongoSink.java,160,44,2,13,0,59
 pulsar-master\pulsar-master\pulsar-broker\src\main\java\org\apache\pulsar\broker\transaction\exception\buffer\TransactionBufferException.java,67,21,0,7,0,28
 pulsar-master\pulsar-master\pulsar-client-admin-api\src\main\java\org\apache\pulsar\common\policies\data\InactiveTopicPolicies.java,6,3,0,1,0,4
 pulsar-master\pulsar-master\pulsar-client\src\test\java\org\apache\pulsar\client\impl\MemoryLimitControllerTest.java,133,24,0,1,0,25
 pulsar-master\pulsar-master\pulsar-functions\utils\src\main\java\org\apache\pulsar\functions\utils\functioncache\FunctionClassLoaders.java,23,10,1,2,0,13
 pulsar-master\pulsar-master\pulsar-broker\src\test\java\org\apache\pulsar\broker\service\plugin\EntryFilter2Test.java,25,9,1,4,0,14
 pulsar-master\pulsar-master\pulsar-broker\src\main\java\org\apache\pulsar\broker\service\persistent\PersistentMessageFinder.java,0,46,1,20,0,67
 pulsar-master\pulsar-master\pulsar-broker\src\test\java\org\apache\pulsar\broker\service\BkEnsemblesTestBase.java,81,26,2,7,0,35
 pulsar-master\pulsar-master\pulsar-common\src\test\java\org\apache\pulsar\common\policies\data\PoliciesDataTest.java,72,18,0,15,0,33
 pulsar-master\pulsar-master\pulsar-common\src\main\java\org\apache\pulsar\common\policies\data\TenantOperation.java,0,3,0,1,0,4
 pulsar-master\pulsar-master\pulsar-common\src\main\java\io\airlift\compress\zstd\ZStdRawCompressor.java,9,8,1,2,0,11
 pulsar-master\pulsar-master\pulsar-client-api\src\main\java\org\apache\pulsar\client\api\RedeliveryBackoff.java,0,5,0,5,0,10
 pulsar-master\pulsar-master\pulsar-broker\src\test\java\org\apache\pulsar\broker\lookup\http\HttpTopicLookupv2Test.java,187,43,8,27,0,78
 pulsar-master\pulsar-master\pulsar-broker\src\test\java\org\apache\pulsar\broker\service\PersistentTopicConcurrentTest.java,304,51,14,27,0,92
 pulsar-master\pulsar-master\pulsar-client-admin-api\src\main\java\org\apache\pulsar\common\policies\data\NonPersistentPublisherStats.java,0,3,0,2,0,5
 pulsar-master\pulsar-master\pulsar-package-management\core\src\main\java\org\apache\pulsar\packages\management\core\common\PackageName.java,128,50,2,15,0,67
 pulsar-master\pulsar-master\pulsar-sql\presto-pulsar\src\main\java\org\apache\pulsar\sql\presto\decoder\json\PulsarJsonRowDecoder.java,46,23,1,13,0,37
 pulsar-master\pulsar-master\pulsar-functions\instance\src\main\java\org\apache\pulsar\functions\instance\InstanceConfig.java,36,21,0,4,0,25
 pulsar-master\pulsar-master\pulsar-broker\src\main\java\org\apache\pulsar\broker\PulsarService.java,0,522,30,272,0,824
 pulsar-master\pulsar-master\pulsar-common\src\main\java\org\apache\pulsar\common\util\FutureUtil.java,171,61,1,36,0,98
 pulsar-master\pulsar-master\pulsar-package-management\bookkeeper-storage\src\test\java\org\apache\pulsar\packages\management\storage\bookkeeper\bookkeeper\test\BookKeeperClusterTestCase.java,438,118,5,40,0,163
 pulsar-master\pulsar-master\pulsar-testclient\src\test\java\org\apache\pulsar\testclient\TestDefaultMessageFormatter.java,47,11,1,3,0,15
 pulsar-master\pulsar-master\pulsar-broker\src\test\java\org\apache\pulsar\io\PulsarFunctionE2ETest.java,1089,334,5,238,0,577
 pulsar-master\pulsar-master\pulsar-io\rabbitmq\src\main\java\org\apache\pulsar\io\rabbitmq\package-info.java,0,1,0,1,0,2
 pulsar-master\pulsar-master\pulsar-broker\src\test\java\org\apache\pulsar\client\impl\ProducerMemoryLimitTest.java,64,13,0,5,0,18
 pulsar-master\pulsar-master\pulsar-functions\worker\src\test\java\org\apache\pulsar\functions\worker\rest\api\PulsarFunctionTestTemporaryDirectory.java,46,24,1,12,0,37
 pulsar-master\pulsar-master\pulsar-io\nsq\src\main\java\org\apache\pulsar\io\nsq\NSQSourceConfig.java,69,21,0,5,0,26
 pulsar-master\pulsar-master\pulsar-common\src\test\java\org\apache\pulsar\common\policies\data\PublisherStatsTest.java,99,16,0,3,0,19
 pulsar-master\pulsar-master\pulsar-broker\src\test\java\org\apache\pulsar\broker\service\ServerCnxTest.java,1823,482,15,284,0,781
 pulsar-master\pulsar-master\pulsar-client\src\test\java\org\apache\pulsar\client\api\RangeTest.java,42,17,0,1,0,18
 pulsar-master\pulsar-master\pulsar-io\elastic-search\src\main\java\org\apache\pulsar\io\elasticsearch\ElasticSearchClient.java,308,90,5,28,0,123
 pulsar-master\pulsar-master\pulsar-broker\src\test\java\org\apache\pulsar\broker\transaction\pendingack\PendingAckMetadataTest.java,57,19,3,14,0,36
 pulsar-master\pulsar-master\pulsar-common\src\test\java\org\apache\pulsar\common\stats\JvmDefaultGCMetricsLoggerTest.java,12,4,0,3,0,7
 pulsar-master\pulsar-master\pulsar-broker\src\test\java\org\apache\pulsar\websocket\proxy\SimpleProducerSocket.java,70,42,2,5,0,49
 pulsar-master\pulsar-master\pulsar-common\src\main\java\org\apache\pulsar\common\compression\CompressionCodecSnappy.java,79,17,0,10,0,27
 pulsar-master\pulsar-master\pulsar-io\canal\src\main\java\org\apache\pulsar\io\canal\CanalSourceConfig.java,58,19,0,6,0,25
 pulsar-master\pulsar-master\pulsar-client\src\test\java\org\apache\pulsar\client\impl\schema\SupportVersioningKeyValueSchemaTest.java,135,40,0,28,0,68
 pulsar-master\pulsar-master\pulsar-functions\worker\src\main\java\org\apache\pulsar\functions\worker\service\api\Sinks.java,0,37,0,10,0,47
 pulsar-master\pulsar-master\pulsar-broker\src\main\java\org\apache\pulsar\common\naming\package-info.java,0,0,0,1,0,1
 pulsar-master\pulsar-master\pulsar-broker\src\main\java\org\apache\pulsar\broker\admin\v1\BrokerStats.java,18,15,0,9,0,24
 pulsar-master\pulsar-master\pulsar-broker\src\test\java\org\apache\pulsar\broker\service\BacklogQuotaManagerConfigurationTest.java,55,22,1,8,0,31
 pulsar-master\pulsar-master\pulsar-broker-common\src\main\java\org\apache\pulsar\broker\cache\package-info.java,0,1,0,1,0,2
 pulsar-master\pulsar-master\pulsar-broker\src\test\java\org\apache\pulsar\PulsarVersionStarterTest.java,35,3,1,3,0,7
 pulsar-master\pulsar-master\pulsar-client\src\test\java\org\apache\pulsar\client\impl\BatchMessageAckerDisabledTest.java,23,6,0,2,0,8
 pulsar-master\pulsar-master\pulsar-broker\src\test\java\org\apache\pulsar\client\api\ProducerCreationTest.java,162,47,4,30,0,81
 pulsar-master\pulsar-master\pulsar-broker-common\src\main\java\org\apache\pulsar\broker\authentication\AuthenticationService.java,134,45,2,28,0,75
 pulsar-master\pulsar-master\pulsar-functions\worker\src\main\java\org\apache\pulsar\functions\worker\FunctionRuntimeInfo.java,10,3,0,1,0,4
 pulsar-master\pulsar-master\pulsar-broker\src\main\java\org\apache\pulsar\broker\service\HashRangeExclusiveStickyKeyConsumerSelector.java,115,40,0,26,0,66
 pulsar-master\pulsar-master\pulsar-functions\runtime\src\main\java\org\apache\pulsar\functions\auth\package-info.java,0,1,0,1,0,2
 pulsar-master\pulsar-master\pulsar-transaction\coordinator\src\test\java\org\apache\pulsar\transaction\coordinator\test\MockedBookKeeperTestCase.java,95,39,1,6,0,46
 pulsar-master\pulsar-master\pulsar-io\elastic-search\src\test\java\org\apache\pulsar\io\elasticsearch\data\Profile.java,5,5,0,1,0,6
 pulsar-master\pulsar-master\tests\bc_2_0_1\src\test\java\org\apache\pulsar\tests\integration\PulsarContainer.java,28,12,0,3,0,15
 pulsar-master\pulsar-master\pulsar-broker\src\main\java\org\apache\pulsar\broker\loadbalance\impl\ModularLoadManagerImpl.java,1088,278,18,198,0,494
 pulsar-master\pulsar-master\pulsar-client-admin\src\main\java\org\apache\pulsar\client\admin\internal\PackagesImpl.java,177,89,0,34,0,123
 pulsar-master\pulsar-master\pulsar-proxy\src\main\java\org\apache\pulsar\proxy\extensions\package-info.java,0,1,0,1,0,2
 pulsar-master\pulsar-master\pulsar-broker\src\test\java\org\apache\pulsar\broker\service\BrokerServiceBundlesCacheInvalidationTest.java,40,7,1,1,0,9
 pulsar-master\pulsar-master\pulsar-broker\src\main\java\org\apache\pulsar\broker\service\persistent\PersistentStreamingDispatcherSingleActiveConsumer.java,0,46,2,30,0,78
 pulsar-master\pulsar-master\pulsar-broker\src\test\java\org\apache\pulsar\broker\stats\ManagedCursorMetricsTest.java,117,24,0,16,0,40
 pulsar-master\pulsar-master\pulsar-proxy\src\test\java\org\apache\pulsar\proxy\extensions\SimpleProxyExtensionSharedThreadPoolTest.java,6,2,0,2,0,4
 pulsar-master\pulsar-master\pulsar-broker\src\main\java\org\apache\pulsar\broker\transaction\buffer\TransactionCursor.java,0,7,0,3,0,10
 pulsar-master\pulsar-master\pulsar-broker\src\test\java\org\apache\pulsar\client\impl\AdminApiKeyStoreTlsAuthTest.java,175,71,11,27,0,109
 pulsar-master\pulsar-master\pulsar-functions\worker\src\main\java\org\apache\pulsar\functions\worker\service\package-info.java,0,1,0,1,0,2
 pulsar-master\pulsar-master\pulsar-client-admin-api\src\main\java\org\apache\pulsar\client\admin\Properties.java,0,7,0,6,0,13
 pulsar-master\pulsar-master\pulsar-broker\src\test\java\org\apache\pulsar\broker\transaction\buffer\TransactionBufferCloseTest.java,72,31,0,11,0,42
 pulsar-master\pulsar-master\pulsar-websocket\src\main\java\org\apache\pulsar\websocket\service\WebSocketProxyConfiguration.java,157,82,1,28,0,111
 pulsar-master\pulsar-master\pulsar-functions\instance\src\main\java\org\apache\pulsar\functions\instance\stats\FunctionCollectorRegistryImpl.java,17,7,0,3,0,10
 pulsar-master\pulsar-master\pulsar-broker-common\src\main\java\org\apache\pulsar\common\configuration\PulsarConfiguration.java,0,3,0,1,0,4
 pulsar-master\pulsar-master\pulsar-broker\src\test\java\org\apache\pulsar\websocket\proxy\v1\V1_ProxyAuthenticationTest.java,173,46,6,20,0,72
 pulsar-master\pulsar-master\pulsar-functions\java-examples\src\main\java\org\apache\pulsar\functions\api\examples\CustomBaseToDerivedFunction.java,0,8,0,4,0,12
 pulsar-master\pulsar-master\pulsar-functions\worker\src\test\java\org\apache\pulsar\functions\worker\FunctionRuntimeManagerTest.java,1154,313,10,280,0,603
 pulsar-master\pulsar-master\pulsar-broker\src\test\java\org\apache\pulsar\broker\transaction\buffer\InMemTransactionBufferReaderTest.java,110,33,0,11,0,44
 pulsar-master\pulsar-master\pulsar-functions\java-examples\src\main\java\org\apache\pulsar\functions\api\examples\CustomDerivedSerde.java,0,5,0,1,0,6
 pulsar-master\pulsar-master\managed-ledger\src\main\java\org\apache\bookkeeper\mledger\util\AbstractCASReferenceCounted.java,82,26,1,10,0,37
 pulsar-master\pulsar-master\pulsar-common\src\test\java\org\apache\pulsar\common\util\CmdGenerateDocsTest.java,81,8,4,2,0,14
 pulsar-master\pulsar-master\pulsar-client-tools\src\main\java\org\apache\pulsar\admin\cli\CmdSinks.java,745,292,2,117,0,411
 pulsar-master\pulsar-master\pulsar-broker\src\main\java\org\apache\pulsar\broker\transaction\pendingack\impl\MLPendingAckReplyCallBack.java,83,35,3,25,0,63
 pulsar-master\pulsar-master\pulsar-broker\src\main\java\org\apache\pulsar\broker\stats\prometheus\metrics\Summary.java,0,34,0,11,0,45
 pulsar-master\pulsar-master\pulsar-broker\src\main\java\org\apache\pulsar\broker\service\Dispatcher.java,0,35,0,5,0,40
 pulsar-master\pulsar-master\pulsar-common\src\main\java\org\apache\pulsar\common\policies\impl\package-info.java,0,2,0,1,0,3
 pulsar-master\pulsar-master\pulsar-broker-common\src\main\java\org\apache\pulsar\broker\authentication\AuthenticationState.java,0,22,0,14,0,36
 pulsar-master\pulsar-master\managed-ledger\src\main\java\org\apache\bookkeeper\mledger\proto\package-info.java,0,1,0,1,0,2
 pulsar-master\pulsar-master\pulsar-functions\secrets\src\main\java\org\apache\pulsar\functions\secretsprovider\SecretsProvider.java,0,8,1,3,0,12
 pulsar-master\pulsar-master\pulsar-broker\src\test\java\org\apache\pulsar\broker\service\schema\ProtobufNativeSchemaCompatibilityCheckTest.java,22,11,0,6,0,17
 pulsar-master\pulsar-master\pulsar-broker\src\main\java\org\apache\pulsar\PulsarStandalone.java,361,184,4,33,0,221
 pulsar-master\pulsar-master\pulsar-client-admin-api\src\main\java\org\apache\pulsar\common\policies\data\impl\BookiesClusterInfoImpl.java,0,12,0,3,0,15
 pulsar-master\pulsar-master\pulsar-functions\java-examples\src\main\java\org\apache\pulsar\functions\api\examples\CommaWindowFunction.java,0,3,0,2,0,5
 pulsar-master\pulsar-master\pulsar-common\src\main\java\org\apache\pulsar\common\lookup\GetTopicsResult.java,7,4,0,1,0,5
 pulsar-master\pulsar-master\pulsar-client-api\src\main\java\org\apache\pulsar\client\api\schema\SchemaBuilder.java,0,1,0,2,0,3
 pulsar-master\pulsar-master\pulsar-websocket\src\main\java\org\apache\pulsar\websocket\ReaderHandler.java,274,83,15,46,0,144
 pulsar-master\pulsar-master\pulsar-client\src\main\java\org\apache\pulsar\client\impl\PartitionsChangedListener.java,0,2,0,1,0,3
 pulsar-master\pulsar-master\pulsar-client-admin-api\src\main\java\org\apache\pulsar\common\policies\data\TenantInfo.java,0,7,0,2,0,9
 pulsar-master\pulsar-master\pulsar-functions\worker\src\main\java\org\apache\pulsar\functions\worker\rest\api\v3\SourcesApiV3Resource.java,245,126,1,56,0,183
 pulsar-master\pulsar-master\pulsar-sql\presto-pulsar\src\test\java\org\apache\pulsar\sql\presto\decoder\AbstractDecoderTester.java,85,81,0,17,0,98
 pulsar-master\pulsar-master\tests\integration\src\test\java\org\apache\pulsar\tests\integration\containers\DebeziumMsSqlContainer.java,47,18,0,9,0,27
 pulsar-master\pulsar-master\pulsar-functions\utils\src\test\java\org\apache\pulsar\functions\utils\SourceConfigUtilsTest.java,346,86,7,50,0,143
 pulsar-master\pulsar-master\pulsar-broker\src\main\java\org\apache\pulsar\broker\admin\impl\OffloaderObjectsScannerUtils.java,110,33,1,17,0,51
 pulsar-master\pulsar-master\structured-event-log\src\main\java\org\apache\pulsar\structuredeventlog\slf4j\Slf4jStructuredEventLog.java,21,7,0,2,0,9
 pulsar-master\pulsar-master\pulsar-functions\runtime-all\src\test\java\org\apache\pulsar\functions\instance\JavaInstanceDepsTest.java,38,13,2,8,0,23
 pulsar-master\pulsar-master\pulsar-client\src\test\java\org\apache\pulsar\client\impl\schema\LocalDateTimeSchemaTest.java,57,11,0,5,0,16
 pulsar-master\pulsar-master\pulsar-metadata\src\main\java\org\apache\pulsar\metadata\bookkeeper\LegacyHierarchicalLedgerRangeIterator.java,0,45,0,23,0,68
 pulsar-master\pulsar-master\pulsar-io\kinesis\src\main\java\org\apache\pulsar\io\kinesis\AwsCredentialProviderPlugin.java,0,2,0,3,0,5
 pulsar-master\pulsar-master\pulsar-client\src\main\java\org\apache\pulsar\client\impl\schema\generic\JsonRecordBuilderImpl.java,81,14,0,2,0,16
 pulsar-master\pulsar-master\pulsar-broker\src\test\java\org\apache\pulsar\broker\service\persistent\DelayedDeliveryTest.java,488,115,8,42,0,165
 pulsar-master\pulsar-master\pulsar-common\src\main\java\org\apache\pulsar\common\policies\data\EnsemblePlacementPolicyConfig.java,68,32,0,12,0,44
 pulsar-master\pulsar-master\tests\integration\src\test\java\org\apache\pulsar\tests\integration\functions\java\PulsarFunctionsJavaProcessTest.java,8,3,0,1,0,4
 pulsar-master\pulsar-master\pulsar-testclient\src\main\java\org\apache\pulsar\testclient\LoadSimulationClient.java,320,88,6,30,0,124
 pulsar-master\pulsar-master\pulsar-functions\worker\src\main\java\org\apache\pulsar\functions\worker\Worker.java,96,27,2,11,0,40
 pulsar-master\pulsar-master\managed-ledger\src\main\java\org\apache\bookkeeper\mledger\impl\ManagedCursorContainer.java,311,69,3,20,0,92
 pulsar-master\pulsar-master\pulsar-common\src\main\java\org\apache\pulsar\common\util\SafeCollectionUtils.java,12,8,2,2,0,12
 pulsar-master\pulsar-master\pulsar-broker\src\main\java\org\apache\pulsar\broker\delayed\DelayedDeliveryTrackerLoader.java,19,7,0,5,0,12
 pulsar-master\pulsar-master\pulsar-client\src\main\java\org\apache\pulsar\client\impl\ProducerInterceptors.java,94,38,5,22,0,65
 pulsar-master\pulsar-master\pulsar-metadata\src\test\java\org\apache\pulsar\metadata\bookkeeper\PulsarLedgerIdGeneratorTest.java,115,19,2,13,0,34
 pulsar-master\pulsar-master\pulsar-broker\src\test\java\org\apache\pulsar\broker\stats\ManagedLedgerMetricsTest.java,69,16,0,11,0,27
 pulsar-master\pulsar-master\pulsar-io\kafka\src\main\java\org\apache\pulsar\io\kafka\package-info.java,0,1,0,1,0,2
 pulsar-master\pulsar-master\pulsar-broker\src\main\java\org\apache\pulsar\broker\service\nonpersistent\NonPersistentReplicator.java,218,61,4,27,0,92
 pulsar-master\pulsar-master\pulsar-broker\src\test\java\org\apache\pulsar\broker\admin\TopicsTest.java,0,431,7,250,0,688
 pulsar-master\pulsar-master\pulsar-broker-common\src\main\java\org\apache\pulsar\broker\web\JettyRequestLogFactory.java,38,13,1,13,0,27
 pulsar-master\pulsar-master\pulsar-functions\api-java\src\main\java\org\apache\pulsar\functions\api\WindowContext.java,0,6,0,5,0,11
 pulsar-master\pulsar-master\pulsar-io\hdfs2\src\main\java\org\apache\pulsar\io\hdfs2\sink\seq\HdfsSequentialTextSink.java,0,14,0,8,0,22
 pulsar-master\pulsar-master\pulsar-io\batch-data-generator\src\main\java\org\apache\pulsar\io\batchdatagenerator\BatchDataGeneratorPrintSink.java,19,4,3,1,0,8
 pulsar-master\pulsar-master\pulsar-broker\src\test\java\org\apache\pulsar\broker\intercept\MangedLedgerInterceptorImplTest.java,236,90,7,47,0,144
 pulsar-master\pulsar-master\pulsar-websocket\src\main\java\org\apache\pulsar\websocket\ProducerHandler.java,272,93,10,55,0,158
 pulsar-master\pulsar-master\pulsar-proxy\src\test\java\org\apache\pulsar\proxy\util\CmdTest.java,32,6,2,3,0,11
 pulsar-master\pulsar-master\pulsar-common\src\test\java\org\apache\pulsar\common\net\ServiceURITest.java,289,73,7,20,0,100
 pulsar-master\pulsar-master\tests\integration\src\test\java\org\apache\pulsar\tests\integration\functions\java\PulsarFunctionsJavaTest.java,158,33,2,13,0,48
 pulsar-master\pulsar-master\pulsar-broker\src\test\java\org\apache\pulsar\broker\service\schema\PartitionedTopicsSchemaTest.java,72,10,1,7,0,18
 pulsar-master\pulsar-master\pulsar-client\src\test\java\org\apache\pulsar\client\impl\schema\ProtobufNativeSchemaTest.java,80,41,3,29,0,73
 pulsar-master\pulsar-master\pulsar-broker\src\test\java\org\apache\pulsar\broker\stats\ConsumerStatsTest.java,177,34,0,21,0,55
 pulsar-master\pulsar-master\pulsar-broker\src\test\java\org\apache\pulsar\utils\auth\tokens\TokensCliUtilsTest.java,54,4,1,2,0,7
 pulsar-master\pulsar-master\pulsar-broker\src\test\java\org\apache\pulsar\functions\worker\PulsarFunctionMetadataStoreTest.java,16,7,0,5,0,12
 pulsar-master\pulsar-master\pulsar-broker-common\src\main\java\org\apache\pulsar\broker\resources\PulsarResources.java,69,41,4,16,0,61
 pulsar-master\pulsar-master\pulsar-functions\instance\src\main\java\org\apache\pulsar\functions\instance\LogAppender.java,100,36,0,5,0,41
 pulsar-master\pulsar-master\pulsar-client-admin-api\src\main\java\org\apache\pulsar\common\policies\data\AuthPolicies.java,0,12,0,5,0,17
 pulsar-master\pulsar-master\pulsar-broker\src\main\java\org\apache\pulsar\broker\stats\metrics\ManagedLedgerCacheMetrics.java,65,10,0,7,0,17
 pulsar-master\pulsar-master\pulsar-broker\src\main\java\org\apache\pulsar\broker\service\TopicPolicyListener.java,0,1,0,1,0,2
 pulsar-master\pulsar-master\testmocks\src\main\java\org\apache\zookeeper\MockZooKeeper.java,1103,261,18,117,1,397
 pulsar-master\pulsar-master\pulsar-broker\src\test\java\org\apache\pulsar\client\impl\KeyStoreTlsTest.java,94,52,11,15,0,78
 pulsar-master\pulsar-master\pulsar-io\kinesis\src\main\java\org\apache\pulsar\io\kinesis\KinesisSinkConfig.java,112,32,0,22,0,54
 pulsar-master\pulsar-master\pulsar-common\src\main\java\org\apache\pulsar\common\compression\CompressionCodecLZ4.java,73,20,0,13,0,33
 pulsar-master\pulsar-master\pulsar-functions\instance\src\main\java\org\apache\pulsar\functions\instance\go\package-info.java,0,0,0,1,0,1
 pulsar-master\pulsar-master\pulsar-broker-common\src\main\java\org\apache\pulsar\broker\PulsarServerException.java,26,11,0,1,0,12
 pulsar-master\pulsar-master\pulsar-io\aws\src\main\java\org\apache\pulsar\io\aws\AbstractAwsConnector.java,97,30,2,16,0,48
 pulsar-master\pulsar-master\pulsar-broker\src\test\java\org\apache\pulsar\broker\service\PersistentDispatcherFailoverConsumerTest.java,592,182,7,93,0,282
 pulsar-master\pulsar-master\pulsar-transaction\coordinator\src\main\java\org\apache\pulsar\transaction\coordinator\TransactionRecoverTracker.java,0,2,0,4,0,6
 pulsar-master\pulsar-master\pulsar-io\flume\src\test\java\org\apache\pulsar\io\flume\node\TestPollingPropertiesFileConfigurationProvider.java,65,19,0,6,0,25
 pulsar-master\pulsar-master\pulsar-common\src\main\java\org\apache\pulsar\common\stats\MetricsMixIn.java,5,2,1,1,0,4
 pulsar-master\pulsar-master\pulsar-io\canal\src\main\java\org\apache\pulsar\io\canal\CanalAbstractSource.java,139,39,4,14,0,57
 pulsar-master\pulsar-master\pulsar-common\src\main\java\org\apache\pulsar\common\policies\data\FunctionInstanceStatsImpl.java,7,4,0,2,0,6
 pulsar-master\pulsar-master\pulsar-functions\worker\src\test\java\org\apache\pulsar\functions\worker\FunctionActionerTest.java,220,62,1,60,0,123
 pulsar-master\pulsar-master\pulsar-broker\src\test\java\org\apache\pulsar\client\api\RetryTopicTest.java,424,95,15,71,0,181
 pulsar-master\pulsar-master\pulsar-websocket\src\main\java\org\apache\pulsar\websocket\stats\StatsBuckets.java,91,32,0,3,0,35
 pulsar-master\pulsar-master\pulsar-broker\src\test\java\org\apache\pulsar\client\api\BrokerServiceLookupTest.java,832,197,28,139,0,364
 pulsar-master\pulsar-master\tests\integration\src\test\java\org\apache\pulsar\tests\integration\proxy\TestProxy.java,84,25,1,13,0,39
 pulsar-master\pulsar-master\pulsar-io\cassandra\src\main\java\org\apache\pulsar\io\cassandra\package-info.java,0,1,0,1,0,2
 pulsar-master\pulsar-master\tiered-storage\file-system\src\main\java\org\apache\bookkeeper\mledger\offload\filesystem\impl\package-info.java,0,0,0,1,0,1
 pulsar-master\pulsar-master\pulsar-common\src\main\java\org\apache\pulsar\common\topics\package-info.java,0,0,0,1,0,1
 pulsar-master\pulsar-master\pulsar-functions\worker\src\main\java\org\apache\pulsar\functions\worker\service\api\Workers.java,0,13,0,3,0,16
 pulsar-master\pulsar-master\pulsar-client\src\main\java\org\apache\pulsar\client\impl\schema\AvroBaseStructSchema.java,19,12,0,3,0,15
 pulsar-master\pulsar-master\pulsar-functions\instance\src\main\java\org\apache\pulsar\functions\instance\stats\FunctionCollectorRegistry.java,19,5,0,5,0,10
 pulsar-master\pulsar-master\pulsar-proxy\src\test\java\org\apache\pulsar\proxy\server\ProxyIsAHttpProxyTest.java,377,79,1,51,0,131
 pulsar-master\pulsar-master\pulsar-client\src\test\java\org\apache\pulsar\client\impl\schema\IntSchemaTest.java,58,24,0,1,0,25
 pulsar-master\pulsar-master\pulsar-client-admin\src\test\java\org\apache\pulsar\client\admin\internal\PulsarAdminBuilderImplTest.java,13,6,0,3,0,9
 pulsar-master\pulsar-master\pulsar-client-admin-api\src\main\java\org\apache\pulsar\common\policies\data\ErrorData.java,11,6,1,1,0,8
 pulsar-master\pulsar-master\pulsar-functions\worker\src\main\java\org\apache\pulsar\functions\worker\scheduler\package-info.java,0,0,0,1,0,1
 pulsar-master\pulsar-master\pulsar-broker\src\main\java\org\apache\pulsar\broker\service\BrokerService.java,2850,1092,57,683,0,1832
 pulsar-master\pulsar-master\pulsar-broker\src\test\java\org\apache\pulsar\broker\intercept\MockBrokerInterceptor.java,33,9,0,3,0,12
 pulsar-master\pulsar-master\pulsar-client\src\test\java\org\apache\pulsar\client\impl\auth\oauth2\MockClock.java,69,18,0,1,0,19
 pulsar-master\pulsar-master\pulsar-client-api\src\main\java\org\apache\pulsar\client\api\MessageCrypto.java,0,22,2,16,0,40
 pulsar-master\pulsar-master\pulsar-functions\instance\src\main\java\org\apache\pulsar\functions\windowing\WindowContextImpl.java,114,42,0,2,0,44
 pulsar-master\pulsar-master\pulsar-io\hdfs3\src\main\java\org\apache\pulsar\io\hdfs3\HdfsResources.java,25,14,0,2,0,16
 pulsar-master\pulsar-master\pulsar-io\file\src\main\java\org\apache\pulsar\io\file\FileRecord.java,37,24,1,3,0,28
 pulsar-master\pulsar-master\pulsar-functions\instance\src\test\java\org\apache\pulsar\functions\instance\ContextImplTest.java,276,61,23,32,0,116
 pulsar-master\pulsar-master\pulsar-sql\presto-pulsar\src\test\java\org\apache\pulsar\sql\presto\TestPulsarMetadata.java,341,99,8,71,0,178
 pulsar-master\pulsar-master\pulsar-broker\src\test\java\org\apache\pulsar\broker\ConfigHelper.java,61,35,2,19,0,56
 pulsar-master\pulsar-master\pulsar-broker\src\main\java\org\apache\pulsar\broker\loadbalance\impl\UniformLoadShedder.java,134,59,0,52,0,111
 pulsar-master\pulsar-master\structured-event-log\src\main\java\org\apache\pulsar\structuredeventlog\Event.java,0,13,0,12,0,25
 pulsar-master\pulsar-master\pulsar-client\src\main\java\org\apache\pulsar\client\impl\AcknowledgmentsGroupingTracker.java,0,7,0,3,0,10
 pulsar-master\pulsar-master\pulsar-client\src\test\java\org\apache\pulsar\client\impl\DefaultCryptoKeyReaderTest.java,95,28,4,27,0,59
 pulsar-master\pulsar-master\pulsar-client-api\src\main\java\org\apache\pulsar\common\schema\SchemaInfo.java,0,29,2,1,0,32
 pulsar-master\pulsar-master\pulsar-common\src\main\java\org\apache\pulsar\common\policies\data\PolicyHierarchyValue.java,50,24,6,4,0,34
 pulsar-master\pulsar-master\pulsar-common\src\main\java\org\apache\pulsar\common\util\collections\ConcurrentLongPairSet.java,648,204,11,24,0,239
 pulsar-master\pulsar-master\pulsar-broker\src\test\java\org\apache\pulsar\client\api\MessageDispatchThrottlingTest.java,1157,317,15,184,0,516
 pulsar-master\pulsar-master\pulsar-common\src\main\java\org\apache\pulsar\common\protocol\schema\EmptyVersion.java,0,1,0,1,0,2
 pulsar-master\pulsar-master\pulsar-broker\src\main\java\org\apache\pulsar\broker\service\persistent\PersistentSubscription.java,1095,400,16,212,0,628
 pulsar-master\pulsar-master\tests\integration\src\test\java\org\apache\pulsar\tests\integration\functions\java\PulsarWorkerRebalanceDrainThreadTest.java,7,3,0,2,0,5
 pulsar-master\pulsar-master\pulsar-io\elastic-search\src\test\java\org\apache\pulsar\io\elasticsearch\data\UserProfile.java,7,8,0,1,0,9
 pulsar-master\pulsar-master\pulsar-client-admin-api\src\main\java\org\apache\pulsar\client\admin\utils\ReflectionUtils.java,65,15,3,6,0,24
 pulsar-master\pulsar-master\pulsar-metadata\src\main\java\org\apache\pulsar\metadata\api\extended\package-info.java,0,0,0,1,0,1
 pulsar-master\pulsar-master\pulsar-transaction\coordinator\src\main\java\org\apache\pulsar\transaction\coordinator\util\package-info.java,0,2,0,1,0,3
 pulsar-master\pulsar-master\pulsar-functions\worker\src\main\java\org\apache\pulsar\functions\worker\ClusterServiceCoordinator.java,57,34,2,9,0,45
 pulsar-master\pulsar-master\pulsar-broker\src\test\java\org\apache\pulsar\broker\service\plugin\EntryFilterTest.java,24,5,1,2,0,8
 pulsar-master\pulsar-master\pulsar-client\src\main\java\org\apache\pulsar\client\impl\ProducerResponse.java,8,4,0,1,0,5
 pulsar-master\pulsar-master\pulsar-io\redis\src\test\java\org\apache\pulsar\io\redis\sink\RedisSinkConfigTest.java,116,12,1,4,0,17
 pulsar-master\pulsar-master\managed-ledger\src\main\java\org\apache\bookkeeper\mledger\util\Errors.java,0,4,0,1,0,5
 pulsar-master\pulsar-master\pulsar-io\redis\src\main\java\org\apache\pulsar\io\redis\RedisAbstractConfig.java,82,21,0,5,0,26
 pulsar-master\pulsar-master\pulsar-broker\src\test\java\org\apache\pulsar\client\api\TokenOauth2AuthenticatedProducerConsumerTest.java,184,58,4,28,0,90
 pulsar-master\pulsar-master\pulsar-common\src\main\java\org\apache\pulsar\common\util\NumberFormat.java,42,8,2,2,0,12
 pulsar-master\pulsar-master\pulsar-broker\src\main\java\org\apache\pulsar\broker\loadbalance\ModularLoadManager.java,0,14,0,9,0,23
 pulsar-master\pulsar-master\pulsar-client\src\main\java\org\apache\pulsar\client\impl\TableViewImpl.java,231,51,4,12,0,67
 pulsar-master\pulsar-master\pulsar-broker-common\src\main\java\org\apache\pulsar\common\configuration\BindAddress.java,18,1,0,2,0,3
 pulsar-master\pulsar-master\managed-ledger\src\main\java\org\apache\bookkeeper\mledger\offload\OffloadersCache.java,38,9,0,6,0,15
 pulsar-master\pulsar-master\pulsar-broker\src\test\java\org\apache\pulsar\broker\loadbalance\impl\LoadManagerSharedTest.java,65,19,0,15,0,34
 pulsar-master\pulsar-master\pulsar-broker\src\test\java\org\apache\pulsar\broker\admin\v3\PackagesApiTest.java,118,28,1,19,0,48
 pulsar-master\pulsar-master\pulsar-broker\src\test\java\org\apache\pulsar\broker\service\ReplicatorSubscriptionTest.java,571,150,3,105,0,258
 pulsar-master\pulsar-master\tests\pulsar-client-admin-shade-test\src\test\java\org\apache\pulsar\tests\integration\SimpleProducerConsumerTest.java,535,180,10,112,0,302
 pulsar-master\pulsar-master\pulsar-broker\src\main\java\org\apache\pulsar\broker\rest\Topics.java,117,91,4,48,0,143
 pulsar-master\pulsar-master\tests\bc_2_6_0\src\test\java\org\apache\pulsar\tests\integration\PulsarContainer.java,28,12,0,3,0,15
 pulsar-master\pulsar-master\pulsar-sql\presto-pulsar\src\main\java\org\apache\pulsar\sql\presto\util\NullCacheSizeAllocator.java,18,3,0,1,0,4
 pulsar-master\pulsar-master\pulsar-broker\src\main\java\org\apache\pulsar\compaction\CompactorTool.java,111,37,6,29,0,72
 pulsar-master\pulsar-master\pulsar-io\influxdb\src\main\java\org\apache\pulsar\io\influxdb\v1\InfluxDBGenericRecordSink.java,55,8,0,6,0,14
 pulsar-master\pulsar-master\pulsar-client\src\main\java\org\apache\pulsar\client\impl\Hash.java,0,1,0,1,0,2
 pulsar-master\pulsar-master\pulsar-broker\src\main\java\org\apache\pulsar\broker\transaction\pendingack\impl\InMemoryPendingAckStore.java,35,22,0,6,0,28
 pulsar-master\pulsar-master\pulsar-functions\worker\src\main\java\org\apache\pulsar\functions\worker\ErrorNotifier.java,0,5,0,1,0,6
 pulsar-master\pulsar-master\pulsar-client\src\main\java\org\apache\pulsar\client\impl\auth\oauth2\AuthenticationDataOAuth2.java,0,7,0,2,0,9
 pulsar-master\pulsar-master\pulsar-broker\src\main\java\org\apache\pulsar\broker\loadbalance\impl\OverloadShedder.java,98,40,2,33,0,75
 pulsar-master\pulsar-master\pulsar-common\src\main\java\org\apache\pulsar\common\policies\data\HierarchyTopicPolicies.java,57,53,0,5,0,58
 pulsar-master\pulsar-master\pulsar-io\netty\src\test\java\org\apache\pulsar\io\netty\NettySourceConfigTest.java,53,16,1,4,0,21
 pulsar-master\pulsar-master\pulsar-broker\src\test\java\org\apache\pulsar\broker\admin\AdminTest.java,837,220,32,142,0,394
 pulsar-master\pulsar-master\pulsar-io\core\src\test\java\org\apache\pulsar\io\core\BatchPushSourceTest.java,31,11,6,2,0,19
 pulsar-master\pulsar-master\pulsar-common\src\test\java\org\apache\pulsar\common\util\RunnablesTest.java,10,2,0,1,0,3
 pulsar-master\pulsar-master\pulsar-metadata\src\test\java\org\apache\pulsar\metadata\impl\LocalMemoryMetadataStoreTest.java,57,6,0,3,0,9
 pulsar-master\pulsar-master\pulsar-functions\localrun\src\main\java\org\apache\pulsar\functions\package-info.java,0,0,0,1,0,1
 pulsar-master\pulsar-master\pulsar-common\src\test\java\org\apache\pulsar\common\util\collections\BitSetRecyclableRecyclableTest.java,26,9,0,1,0,10
 pulsar-master\pulsar-master\pulsar-functions\instance\src\main\java\org\apache\pulsar\functions\package-info.java,0,0,0,1,0,1
 pulsar-master\pulsar-master\pulsar-io\kafka\src\main\java\org\apache\pulsar\io\kafka\KafkaBytesSink.java,0,8,0,4,0,12
 pulsar-master\pulsar-master\pulsar-broker\src\test\java\org\apache\pulsar\websocket\proxy\MockAuthenticationProvider.java,27,6,1,2,0,9
 pulsar-master\pulsar-master\pulsar-broker\src\main\java\org\apache\pulsar\broker\service\AbstractDispatcherMultipleConsumers.java,210,72,4,39,0,115
 pulsar-master\pulsar-master\pulsar-io\flume\src\main\java\org\apache\pulsar\io\flume\node\EnvVarResolverProperties.java,30,6,0,5,0,11
 pulsar-master\pulsar-master\pulsar-broker\src\main\java\org\apache\pulsar\broker\loadbalance\impl\DeviationShedder.java,117,24,2,21,0,47
 pulsar-master\pulsar-master\pulsar-websocket\src\main\java\org\apache\pulsar\websocket\data\package-info.java,0,0,0,1,0,1
 pulsar-master\pulsar-master\pulsar-broker\src\test\java\org\apache\pulsar\broker\service\persistent\PersistentSubscriptionMessageDispatchStreamingDispatcherThrottlingTest.java,0,4,0,2,0,6
 pulsar-master\pulsar-master\pulsar-common\src\main\java\org\apache\pulsar\policies\data\loadbalancer\LoadReport.java,442,232,2,17,0,251
 pulsar-master\pulsar-master\pulsar-io\elastic-search\src\test\java\org\apache\pulsar\io\elasticsearch\v8\ElasticSearch8SinkRawDataTests.java,0,2,0,2,0,4
 pulsar-master\pulsar-master\pulsar-functions\runtime\src\main\java\org\apache\pulsar\functions\runtime\kubernetes\KubernetesRuntimeFactory.java,488,179,8,90,0,277
 pulsar-master\pulsar-master\pulsar-broker\src\main\java\org\apache\pulsar\broker\stats\prometheus\AggregatedProducerStats.java,12,8,0,1,0,9
 pulsar-master\pulsar-master\pulsar-broker\src\main\java\org\apache\pulsar\broker\transaction\exception\buffer\package-info.java,0,1,0,1,0,2
 pulsar-master\pulsar-master\pulsar-common\src\main\java\org\apache\pulsar\common\protocol\Commands.java,1769,951,11,271,0,1233
 pulsar-master\pulsar-master\pulsar-broker\src\test\java\org\apache\pulsar\broker\resourcegroup\RGUsageMTAggrWaitForAllMsgsTest.java,908,337,47,183,0,567
 pulsar-master\pulsar-master\pulsar-io\core\src\main\java\org\apache\pulsar\io\core\package-info.java,0,1,0,1,0,2
 pulsar-master\pulsar-master\pulsar-io\twitter\src\main\java\org\apache\pulsar\io\twitter\TwitterFireHose.java,115,24,1,12,0,37
 pulsar-master\pulsar-master\pulsar-broker\src\main\java\org\apache\pulsar\broker\service\package-info.java,0,0,0,1,0,1
 pulsar-master\pulsar-master\pulsar-metadata\src\main\java\org\apache\pulsar\metadata\bookkeeper\AbstractMetadataDriver.java,97,31,0,8,0,39
 pulsar-master\pulsar-master\pulsar-client-tools\src\main\java\org\apache\pulsar\admin\cli\CmdBookies.java,108,27,1,17,0,45
 pulsar-master\pulsar-master\pulsar-functions\instance\src\test\java\org\apache\pulsar\functions\instance\state\BKStateStoreImplTest.java,94,26,4,3,0,33
 pulsar-master\pulsar-master\pulsar-transaction\coordinator\src\main\java\org\apache\pulsar\transaction\coordinator\TransactionTimeoutTracker.java,0,1,0,2,0,3
 pulsar-master\pulsar-master\pulsar-broker\src\main\java\org\apache\pulsar\broker\delayed\DelayedDeliveryTrackerFactory.java,0,5,0,6,0,11
 pulsar-master\pulsar-master\pulsar-common\src\main\java\org\apache\pulsar\common\util\Reflections.java,302,63,6,29,0,98
 pulsar-master\pulsar-master\pulsar-io\netty\src\test\java\org\apache\pulsar\io\netty\udp\NettyUDPChannelInitializerTest.java,16,5,0,2,0,7
 pulsar-master\pulsar-master\pulsar-broker\src\test\java\org\apache\pulsar\broker\admin\AdminApiMultiBrokersTest.java,79,30,3,13,0,46
 pulsar-master\pulsar-master\pulsar-client-tools\src\test\java\org\apache\pulsar\client\cli\TestCmdConsume.java,27,11,1,6,0,18
 pulsar-master\pulsar-master\pulsar-functions\java-examples\src\main\java\org\apache\pulsar\functions\api\examples\VoidFunction.java,0,3,0,1,0,4
 pulsar-master\pulsar-master\pulsar-functions\runtime\src\main\java\org\apache\pulsar\functions\runtime\Runtime.java,0,14,1,3,0,18
 pulsar-master\pulsar-master\pulsar-broker\src\test\java\org\apache\pulsar\client\api\MockBrokerServiceHooks.java,0,15,0,5,0,20
 pulsar-master\pulsar-master\pulsar-io\rabbitmq\src\main\java\org\apache\pulsar\io\rabbitmq\RabbitMQAbstractConfig.java,101,26,0,6,0,32
 pulsar-master\pulsar-master\pulsar-common\src\main\java\org\apache\pulsar\common\tls\DomainType.java,0,3,0,1,0,4
 pulsar-master\pulsar-master\pulsar-broker\src\main\java\org\apache\pulsar\broker\service\SubscriptionOption.java,27,19,0,2,0,21
 pulsar-master\pulsar-master\tests\integration\src\test\java\org\apache\pulsar\tests\integration\topologies\PulsarClusterSpec.java,118,23,0,2,0,25
 pulsar-master\pulsar-master\pulsar-broker\src\main\java\org\apache\pulsar\broker\admin\v2\Functions.java,279,160,3,79,0,242
 pulsar-master\pulsar-master\pulsar-broker\src\test\java\org\apache\pulsar\broker\zookeeper\ZooKeeperSessionExpireRecoveryTest.java,41,10,2,8,0,20
 pulsar-master\pulsar-master\pulsar-io\debezium\core\src\main\java\org\apache\pulsar\io\debezium\PulsarDatabaseHistory.java,0,49,4,34,0,87
 pulsar-master\pulsar-master\pulsar-broker\src\main\java\org\apache\pulsar\broker\stats\ReplicationMetrics.java,61,26,1,4,0,31
 pulsar-master\pulsar-master\tests\docker-images\java-test-functions\src\main\java\org\apache\pulsar\tests\integration\io\GenericRecordSource.java,48,13,3,4,0,20
 pulsar-master\pulsar-master\pulsar-common\src\main\java\org\apache\pulsar\policies\data\loadbalancer\NamespaceUsage.java,177,102,0,5,0,107
 pulsar-master\pulsar-master\pulsar-functions\worker\src\main\java\org\apache\pulsar\functions\worker\service\api\Sources.java,0,37,0,10,0,47
 pulsar-master\pulsar-master\pulsar-broker\src\main\java\org\apache\pulsar\broker\loadbalance\LoadCalculator.java,0,2,0,1,0,3
 pulsar-master\pulsar-master\pulsar-client-api\src\main\java\org\apache\pulsar\client\api\transaction\TransactionCoordinatorClientException.java,105,38,2,12,0,52
 pulsar-master\pulsar-master\pulsar-common\src\main\java\org\apache\pulsar\common\nar\NarUnpacker.java,131,25,4,16,0,45
 pulsar-master\pulsar-master\pulsar-broker\src\main\java\org\apache\pulsar\broker\service\streamingdispatch\StreamingDispatcher.java,0,3,0,2,0,5
 pulsar-master\pulsar-master\pulsar-broker\src\test\java\org\apache\pulsar\broker\admin\v1\V1_AdminApi2Test.java,750,226,9,137,0,372
 pulsar-master\pulsar-master\pulsar-client-api\src\main\java\org\apache\pulsar\client\api\schema\SchemaDefinition.java,0,7,0,6,0,13
 pulsar-master\pulsar-master\pulsar-broker\src\main\java\org\apache\pulsar\broker\loadbalance\LeaderBroker.java,4,2,0,2,0,4
 pulsar-master\pulsar-master\pulsar-proxy\src\main\java\org\apache\pulsar\proxy\server\ProxyConnectionPool.java,28,11,0,5,0,16
 pulsar-master\pulsar-master\pulsar-broker\src\test\java\org\apache\pulsar\broker\service\BrokerTestBase.java,61,22,0,10,0,32
 pulsar-master\pulsar-master\pulsar-functions\instance\src\main\java\org\apache\pulsar\functions\instance\InstanceUtils.java,167,84,1,45,0,130
 pulsar-master\pulsar-master\pulsar-common\src\test\java\org\apache\pulsar\common\util\ObjectMapperFactoryTest.java,28,2,0,1,0,3
 pulsar-master\pulsar-master\pulsar-broker\src\main\java\org\apache\pulsar\broker\stats\prometheus\TransactionAggregator.java,293,171,1,90,0,262
 pulsar-master\pulsar-master\pulsar-client-api\src\main\java\org\apache\pulsar\client\api\transaction\TransactionBufferClient.java,0,5,0,3,0,8
 pulsar-master\pulsar-master\pulsar-functions\java-examples\src\main\java\org\apache\pulsar\functions\api\examples\CustomObjectFunction.java,0,5,0,2,0,7
 pulsar-master\pulsar-master\pulsar-io\jdbc\mariadb\src\main\java\org\apache\pulsar\io\jdbc\package-info.java,0,1,0,1,0,2
 pulsar-master\pulsar-master\tests\integration\src\test\java\org\apache\pulsar\tests\integration\upgrade\PulsarZKDowngradeTest.java,72,12,2,5,0,19
 pulsar-master\pulsar-master\pulsar-client\src\main\java\org\apache\pulsar\client\impl\schema\AvroSchema.java,114,56,5,23,0,84
 pulsar-master\pulsar-master\pulsar-broker\src\main\java\org\apache\pulsar\broker\transaction\buffer\TransactionBufferReader.java,0,4,0,5,0,9
 pulsar-master\pulsar-master\pulsar-client-admin-api\src\main\java\org\apache\pulsar\common\functions\ConsumerConfig.java,18,11,0,1,0,12
 pulsar-master\pulsar-master\managed-ledger\src\main\java\org\apache\bookkeeper\mledger\LedgerOffloader.java,0,72,0,34,0,106
 pulsar-master\pulsar-master\pulsar-broker\src\main\java\org\apache\pulsar\PulsarStandaloneBuilder.java,0,36,2,9,0,47
 pulsar-master\pulsar-master\pulsar-client-tools\src\test\java\org\apache\pulsar\client\cli\TestCmdProduce.java,46,22,0,17,0,39
 pulsar-master\pulsar-master\pulsar-common\src\main\java\org\apache\pulsar\common\stats\JvmG1GCMetricsLogger.java,63,23,10,9,0,42
 pulsar-master\pulsar-master\pulsar-client-admin-api\src\main\java\org\apache\pulsar\common\policies\data\PersistencePolicies.java,53,27,0,3,0,30
 pulsar-master\pulsar-master\managed-ledger\src\test\java\org\apache\bookkeeper\mledger\impl\EntryCacheManagerTest.java,344,108,0,26,0,134
 pulsar-master\pulsar-master\pulsar-websocket\src\main\java\org\apache\pulsar\websocket\AbstractWebSocketHandler.java,212,87,18,47,0,152
 pulsar-master\pulsar-master\pulsar-broker\src\test\java\org\apache\pulsar\io\PulsarBatchSourceE2ETest.java,166,57,5,42,0,104
 pulsar-master\pulsar-master\pulsar-client\src\main\java\org\apache\pulsar\client\impl\schema\RecordSchemaBuilderImpl.java,98,30,0,5,0,35
 pulsar-master\pulsar-master\pulsar-common\src\main\java\org\apache\pulsar\common\policies\data\OffloadPoliciesImpl.java,0,278,3,105,0,386
 pulsar-master\pulsar-master\pulsar-client\src\main\java\org\apache\pulsar\client\util\ConsumerName.java,6,4,1,2,0,7
 pulsar-master\pulsar-master\tiered-storage\jcloud\src\main\java\org\apache\bookkeeper\mledger\offload\jcloud\OffloadIndexBlock.java,0,17,0,5,0,22
 pulsar-master\pulsar-master\pulsar-client-tools\src\test\java\org\apache\pulsar\admin\cli\TestCmdPackages.java,145,58,1,20,0,79
 pulsar-master\pulsar-master\tiered-storage\jcloud\src\test\java\org\apache\bookkeeper\mledger\offload\jcloud\impl\BlockAwareSegmentInputStreamTest.java,484,194,2,40,0,236
 pulsar-master\pulsar-master\pulsar-testclient\src\main\java\org\apache\pulsar\testclient\ManagedLedgerWriter.java,373,174,28,62,0,264
 pulsar-master\pulsar-master\pulsar-broker\src\main\java\org\apache\pulsar\broker\resourcegroup\ResourceGroupPublishLimiter.java,0,63,8,15,0,86
 pulsar-master\pulsar-master\pulsar-sql\presto-pulsar\src\test\java\org\apache\pulsar\sql\presto\decoder\protobufnative\TestProtobufNativeDecoder.java,230,95,0,65,0,160
 pulsar-master\pulsar-master\pulsar-broker\src\main\java\org\apache\pulsar\PulsarVersionStarter.java,34,9,1,4,0,14
 pulsar-master\pulsar-master\pulsar-io\flume\src\main\java\org\apache\pulsar\io\flume\sink\SourceOfFlume.java,74,18,1,4,0,23
 pulsar-master\pulsar-master\pulsar-io\debezium\core\src\main\java\org\apache\pulsar\io\debezium\SerDeUtils.java,40,17,2,7,0,26
 pulsar-master\pulsar-master\pulsar-client-api\src\main\java\org\apache\pulsar\client\api\MessagePayload.java,0,2,0,3,0,5
 pulsar-master\pulsar-master\pulsar-client\src\main\java\org\apache\pulsar\client\impl\schema\LocalTimeSchema.java,53,10,1,1,0,12
 pulsar-master\pulsar-master\pulsar-metadata\src\main\java\org\apache\pulsar\metadata\impl\MetadataStoreFactoryImpl.java,60,33,1,22,0,56
 pulsar-master\pulsar-master\pulsar-client\src\test\java\org\apache\pulsar\client\util\MathUtilsTest.java,17,13,0,3,0,16
 pulsar-master\pulsar-master\pulsar-metadata\src\test\java\org\apache\pulsar\metadata\CounterTest.java,60,12,2,7,0,21
 pulsar-master\pulsar-master\pulsar-client-admin-api\src\main\java\org\apache\pulsar\common\policies\data\TransactionInBufferStats.java,9,2,0,1,0,3
 pulsar-master\pulsar-master\pulsar-functions\java-examples\src\main\java\org\apache\pulsar\functions\api\examples\AddWindowFunction.java,0,4,0,3,0,7
 pulsar-master\pulsar-master\pulsar-client-tools\src\main\java\org\apache\pulsar\admin\cli\CmdFunctionWorker.java,87,9,1,8,0,18
 pulsar-master\pulsar-master\bouncy-castle\bc\src\main\java\org\apache\pulsar\bcloader\package-info.java,0,1,0,1,0,2
 pulsar-master\pulsar-master\pulsar-client-admin-api\src\main\java\org\apache\pulsar\common\policies\data\ResourceQuota.java,58,11,0,1,0,12
 pulsar-master\pulsar-master\pulsar-client\src\main\java\org\apache\pulsar\client\impl\customroute\PartialRoundRobinMessageRouterImpl.java,53,22,1,14,0,37
 pulsar-master\pulsar-master\pulsar-metadata\src\main\java\org\apache\pulsar\metadata\api\GetResult.java,12,0,0,1,0,1
 pulsar-master\pulsar-master\pulsar-broker\src\main\java\org\apache\pulsar\broker\transaction\pendingack\exceptions\package-info.java,0,1,0,1,0,2
 pulsar-master\pulsar-master\pulsar-io\kafka\src\main\java\org\apache\pulsar\io\kafka\KafkaBytesSource.java,183,67,0,44,0,111
 pulsar-master\pulsar-master\pulsar-functions\worker\src\test\java\org\apache\pulsar\functions\worker\SchedulerManagerTest.java,1082,322,44,241,0,607
 pulsar-master\pulsar-master\pulsar-io\hdfs3\src\main\java\org\apache\pulsar\io\hdfs3\AbstractHdfsConfig.java,47,7,2,6,0,15
 pulsar-master\pulsar-master\pulsar-broker-common\src\main\java\org\apache\pulsar\broker\authorization\PulsarAuthorizationProvider.java,551,260,7,149,0,416
 pulsar-master\pulsar-master\pulsar-sql\presto-pulsar\src\test\java\org\apache\pulsar\sql\presto\TestPulsarConnectorConfig.java,80,25,6,21,0,52
 pulsar-master\pulsar-master\pulsar-sql\presto-pulsar\src\main\java\org\apache\pulsar\sql\presto\PulsarConnectorCache.java,157,65,8,37,0,110
 pulsar-master\pulsar-master\pulsar-broker\src\test\java\org\apache\pulsar\broker\service\BacklogQuotaManagerTest.java,1235,319,27,169,0,515
 pulsar-master\pulsar-master\tests\integration\src\test\java\org\apache\pulsar\tests\integration\docker\ContainerExecResultBytes.java,8,3,0,1,0,4
 pulsar-master\pulsar-master\pulsar-broker\src\test\java\org\apache\pulsar\broker\admin\AdminApiSubscriptionTest.java,76,17,0,14,0,31
 pulsar-master\pulsar-master\pulsar-client-tools\src\main\java\org\apache\pulsar\admin\cli\PulsarAdminTool.java,332,100,8,42,0,150
 pulsar-master\pulsar-master\pulsar-config-validation\src\main\java\org\apache\pulsar\config\validation\package-info.java,0,1,0,1,0,2
 pulsar-master\pulsar-master\pulsar-client-admin-api\src\main\java\org\apache\pulsar\common\policies\data\impl\BundlesDataImpl.java,0,15,0,1,0,16
 pulsar-master\pulsar-master\pulsar-client-api\src\main\java\org\apache\pulsar\common\schema\SchemaType.java,0,35,0,2,0,37
 pulsar-master\pulsar-master\pulsar-broker\src\test\java\org\apache\pulsar\client\api\MultiTopicsConsumerTest.java,149,40,4,21,0,65
 pulsar-master\pulsar-master\pulsar-functions\worker\src\test\java\org\apache\pulsar\functions\worker\dlog\DLOutputStreamTest.java,46,1,0,1,0,2
 pulsar-master\pulsar-master\pulsar-functions\instance\src\main\java\org\apache\pulsar\functions\windowing\evictors\WatermarkCountEvictionPolicy.java,0,28,2,6,0,36
 pulsar-master\pulsar-master\managed-ledger\src\test\java\org\apache\bookkeeper\mledger\impl\OffloadPrefixTest.java,1063,391,17,159,0,567
 pulsar-master\pulsar-master\pulsar-broker-common\src\main\java\org\apache\pulsar\broker\cache\ConfigurationCacheService.java,3,1,0,2,0,3
 pulsar-master\pulsar-master\pulsar-io\netty\src\main\java\org\apache\pulsar\io\netty\udp\package-info.java,0,1,0,1,0,2
 pulsar-master\pulsar-master\pulsar-client\src\test\java\org\apache\pulsar\client\impl\schema\JSONSchemaTest.java,398,101,38,48,0,187
 pulsar-master\pulsar-master\pulsar-functions\instance\src\main\java\org\apache\pulsar\functions\source\package-info.java,0,0,0,1,0,1
 pulsar-master\pulsar-master\pulsar-broker\src\main\java\org\apache\pulsar\broker\protocol\ProtocolHandlerDefinitions.java,0,2,0,2,0,4
 pulsar-master\pulsar-master\pulsar-io\rabbitmq\src\main\java\org\apache\pulsar\io\rabbitmq\RabbitMQSinkConfig.java,39,12,0,5,0,17
 pulsar-master\pulsar-master\pulsar-proxy\src\main\java\org\apache\pulsar\proxy\server\package-info.java,0,1,0,1,0,2
 pulsar-master\pulsar-master\pulsar-functions\worker\src\main\java\org\apache\pulsar\functions\worker\rest\api\SourcesImpl.java,743,251,40,229,0,520
 pulsar-master\pulsar-master\pulsar-broker\src\test\java\org\apache\pulsar\broker\service\PersistentFailoverE2ETest.java,472,95,31,53,0,179
 pulsar-master\pulsar-master\pulsar-client\src\main\java\org\apache\pulsar\client\impl\auth\oauth2\AuthenticationOAuth2.java,0,42,0,13,0,55
 pulsar-master\pulsar-master\pulsar-common\src\main\java\org\apache\pulsar\common\util\keystoretls\JettySslContextFactoryWithAutoRefresh.java,0,20,2,5,0,27
 pulsar-master\pulsar-master\managed-ledger\src\main\java\org\apache\bookkeeper\mledger\impl\NullLedgerOffloader.java,44,18,1,4,0,23
 pulsar-master\pulsar-master\pulsar-websocket\src\main\java\org\apache\pulsar\websocket\admin\v2\WebSocketProxyStatsV2.java,30,22,2,9,0,33
 pulsar-master\pulsar-master\pulsar-functions\java-examples\src\main\java\org\apache\pulsar\functions\api\examples\HostAppenderFunction.java,0,3,0,1,0,4
 pulsar-master\pulsar-master\pulsar-io\batch-discovery-triggerers\src\main\java\org\apache\pulsar\io\batchdiscovery\package-info.java,0,1,0,1,0,2
 pulsar-master\pulsar-master\pulsar-client-api\src\main\java\org\apache\pulsar\client\api\schema\package-info.java,0,1,0,1,0,2
 pulsar-master\pulsar-master\pulsar-common\src\test\java\org\apache\pulsar\common\topics\TopicListTest.java,79,22,0,12,0,34
 pulsar-master\pulsar-master\pulsar-broker\src\test\java\org\apache\pulsar\common\naming\RangeEquallyDivideBundleSplitAlgorithmTest.java,17,9,0,5,0,14
 pulsar-master\pulsar-master\pulsar-client-api\src\main\java\org\apache\pulsar\client\api\ReaderInterceptor.java,0,4,1,5,0,10
 pulsar-master\pulsar-master\pulsar-io\elastic-search\src\test\java\org\apache\pulsar\io\elasticsearch\v7\ElasticSearch7SinkTests.java,7,1,0,1,0,2
 pulsar-master\pulsar-master\pulsar-zookeeper-utils\src\test\java\org\apache\pulsar\zookeeper\ZookeeperServerTest.java,64,24,1,3,0,28
 pulsar-master\pulsar-master\pulsar-common\src\main\java\org\apache\pulsar\policies\data\loadbalancer\JvmUsage.java,26,12,0,4,0,16
 pulsar-master\pulsar-master\pulsar-websocket\src\main\java\org\apache\pulsar\websocket\data\ProducerMessages.java,15,5,0,1,0,6
 pulsar-master\pulsar-master\pulsar-client\src\test\java\org\apache\pulsar\client\impl\schema\ProtobufNativeSchemaUtilsTest.java,18,7,2,5,0,14
 pulsar-master\pulsar-master\pulsar-client\src\test\java\org\apache\pulsar\client\impl\schema\SchemaInfoTest.java,302,20,0,9,0,29
 pulsar-master\pulsar-master\tiered-storage\jcloud\src\main\java\org\apache\bookkeeper\mledger\offload\jcloud\impl\BlobStoreBackedReadHandleImplV2.java,254,91,3,33,0,127
 pulsar-master\pulsar-master\pulsar-proxy\src\test\java\org\apache\pulsar\proxy\server\ProxyStatsTest.java,152,34,5,28,0,67
 pulsar-master\pulsar-master\pulsar-package-management\core\src\test\java\org\apache\pulsar\packages\management\core\MockedPackagesStorageProvider.java,7,2,0,1,0,3
 pulsar-master\pulsar-master\pulsar-client-admin-api\src\main\java\org\apache\pulsar\common\policies\data\ClusterData.java,0,38,4,2,0,44
 pulsar-master\pulsar-master\managed-ledger\src\main\java\org\apache\bookkeeper\mledger\WaitingEntryCallBack.java,0,2,0,3,0,5
 pulsar-master\pulsar-master\pulsar-functions\java-examples\src\main\java\org\apache\pulsar\functions\api\examples\CustomBaseObject.java,0,1,0,1,0,2
 pulsar-master\pulsar-master\pulsar-broker\src\test\java\org\apache\pulsar\client\impl\BatchMessageIdImplSerializationTest.java,27,7,0,1,0,8
 pulsar-master\pulsar-master\pulsar-functions\java-examples\src\main\java\org\apache\pulsar\functions\api\examples\PublishFunction.java,0,5,0,3,0,8
 pulsar-master\pulsar-master\pulsar-io\hdfs2\src\test\java\org\apache\pulsar\io\hdfs2\sink\seq\HdfsTextSinkTests.java,0,36,1,1,0,38
 pulsar-master\pulsar-master\pulsar-client\src\main\java\org\apache\pulsar\client\impl\schema\FloatSchema.java,81,26,1,3,0,30
 pulsar-master\pulsar-master\pulsar-broker\src\main\java\org\apache\pulsar\broker\admin\AdminResource.java,783,332,50,185,0,567
 pulsar-master\pulsar-master\pulsar-broker\src\main\java\org\apache\pulsar\broker\service\schema\validator\SchemaDataValidator.java,0,6,0,8,0,14
 pulsar-master\pulsar-master\pulsar-broker\src\test\java\org\apache\pulsar\broker\resourcegroup\ResourceGroupServiceTest.java,231,104,4,63,0,171
 pulsar-master\pulsar-master\pulsar-transaction\coordinator\src\test\java\org\apache\pulsar\transaction\coordinator\MLTransactionMetadataStoreTest.java,441,193,22,153,0,368
 pulsar-master\pulsar-master\pulsar-io\kinesis\src\main\java\org\apache\pulsar\io\kinesis\json\package-info.java,0,1,0,1,0,2
 pulsar-master\pulsar-master\pulsar-testclient\src\main\java\org\apache\pulsar\proxy\socket\client\package-info.java,0,0,0,1,0,1
 pulsar-master\pulsar-master\pulsar-testclient\src\test\java\org\apache\pulsar\proxy\socket\client\PerformanceClientTest.java,49,16,1,12,0,29
 pulsar-master\pulsar-master\pulsar-transaction\coordinator\src\main\java\org\apache\pulsar\transaction\coordinator\TransactionTimeoutTrackerFactory.java,0,2,0,2,0,4
 pulsar-master\pulsar-master\pulsar-common\src\main\java\org\apache\pulsar\common\tls\InetAddressUtils.java,86,26,1,13,0,40
 pulsar-master\pulsar-master\pulsar-io\kafka-connect-adaptor\src\main\java\org\apache\pulsar\io\kafka\connect\PulsarKafkaConnectSinkConfig.java,61,24,0,11,0,35
 pulsar-master\pulsar-master\pulsar-broker\src\test\java\org\apache\pulsar\broker\stats\DimensionStatsTest.java,20,18,0,2,0,20
 pulsar-master\pulsar-master\pulsar-common\src\test\java\org\apache\pulsar\common\util\collections\ConcurrentOpenLongPairRangeSetTest.java,427,401,27,84,0,512
 pulsar-master\pulsar-master\pulsar-metadata\src\main\java\org\apache\pulsar\metadata\impl\batching\OpGet.java,16,5,0,2,0,7
 pulsar-master\pulsar-master\pulsar-client-api\src\main\java\org\apache\pulsar\client\api\schema\Field.java,13,0,0,1,0,1
 pulsar-master\pulsar-master\pulsar-broker\src\test\java\org\apache\pulsar\broker\loadbalance\LoadReportNetworkLimitTest.java,39,13,0,4,0,17
 pulsar-master\pulsar-master\pulsar-functions\instance\src\main\java\org\apache\pulsar\functions\instance\state\InstanceStateManager.java,49,10,1,2,0,13
 pulsar-master\pulsar-master\pulsar-common\src\main\java\org\apache\pulsar\common\lookup\data\LookupData.java,64,36,1,7,0,44
 pulsar-master\pulsar-master\pulsar-broker\src\main\java\org\apache\pulsar\broker\loadbalance\impl\SimpleResourceAllocationPolicies.java,75,50,0,20,0,70
 pulsar-master\pulsar-master\pulsar-sql\presto-pulsar\src\test\java\org\apache\pulsar\sql\presto\TestPulsarRecordCursor.java,439,159,48,121,0,328
 pulsar-master\pulsar-master\pulsar-functions\api-java\src\main\java\org\apache\pulsar\functions\api\BaseContext.java,0,13,0,11,0,24
 pulsar-master\pulsar-master\pulsar-client-api\src\main\java\org\apache\pulsar\common\schema\KeyValue.java,0,35,0,3,0,38
 pulsar-master\pulsar-master\managed-ledger\src\test\java\org\apache\bookkeeper\mledger\util\RangeCacheTest.java,240,72,3,8,0,83
 pulsar-master\pulsar-master\pulsar-websocket\src\main\java\org\apache\pulsar\websocket\data\ProducerAck.java,33,26,0,2,0,28
 pulsar-master\pulsar-master\tests\integration\src\test\java\org\apache\pulsar\tests\integration\io\sources\PulsarIOSourceRunner.java,250,79,5,34,0,118
 pulsar-master\pulsar-master\pulsar-client\src\main\java\org\apache\pulsar\client\util\MessageIdUtils.java,22,8,2,1,0,11
 pulsar-master\pulsar-master\pulsar-client\src\main\java\org\apache\pulsar\client\impl\schema\AbstractStructSchema.java,148,62,2,11,0,75
 pulsar-master\pulsar-master\pulsar-io\kinesis\src\main\java\org\apache\pulsar\io\kinesis\AwsDefaultProviderChainPlugin.java,0,2,0,3,0,5
 pulsar-master\pulsar-master\pulsar-broker\src\main\java\org\apache\pulsar\broker\admin\v1\SchemasResource.java,0,150,1,51,0,202
 pulsar-master\pulsar-master\pulsar-client-api\src\main\java\org\apache\pulsar\client\api\SubscriptionMode.java,0,4,0,3,0,7
 pulsar-master\pulsar-master\pulsar-transaction\coordinator\src\main\java\org\apache\pulsar\transaction\coordinator\impl\InMemTransactionMetadataStoreProvider.java,13,13,0,9,0,22
 pulsar-master\pulsar-master\pulsar-broker\src\test\java\org\apache\pulsar\socks5\handler\CommandRequestHandler.java,81,36,0,15,0,51
 pulsar-master\pulsar-master\pulsar-config-validation\src\main\java\org\apache\pulsar\config\validation\ValidatorImpls.java,368,140,7,45,0,192
 pulsar-master\pulsar-master\pulsar-common\src\main\java\org\apache\pulsar\common\intercept\BrokerEntryMetadataInterceptor.java,0,7,0,3,0,10
 pulsar-master\pulsar-master\pulsar-client-admin-api\src\main\java\org\apache\pulsar\common\io\ConnectorDefinition.java,49,6,0,7,0,13
 pulsar-master\pulsar-master\pulsar-broker\src\main\java\org\apache\pulsar\broker\storage\ManagedLedgerStorage.java,0,8,0,5,0,13
 pulsar-master\pulsar-master\pulsar-broker\src\main\java\org\apache\pulsar\client\impl\RawReaderImpl.java,185,53,2,12,0,67
 pulsar-master\pulsar-master\pulsar-broker\src\test\java\org\apache\pulsar\broker\service\BusyWaitServiceTest.java,51,6,0,1,0,7
 pulsar-master\pulsar-master\pulsar-broker-common\src\main\java\org\apache\pulsar\broker\web\plugin\servlet\AdditionalServletUtils.java,124,35,2,23,0,60
 pulsar-master\pulsar-master\pulsar-io\file\src\main\java\org\apache\pulsar\io\file\FileSourceConfig.java,138,27,1,21,0,49
 pulsar-master\pulsar-master\pulsar-common\src\main\java\org\apache\pulsar\common\nar\FileUtils.java,0,43,5,31,0,79
 pulsar-master\pulsar-master\pulsar-websocket\src\test\java\org\apache\pulsar\websocket\service\WebSocketProxyConfigurationTest.java,23,9,0,7,0,16
 pulsar-master\pulsar-master\pulsar-broker-common\src\main\java\org\apache\pulsar\common\configuration\Category.java,0,0,0,1,0,1
 pulsar-master\pulsar-master\pulsar-broker\src\test\java\org\apache\pulsar\broker\loadbalance\LoadBalancerTest.java,716,310,17,138,0,465
 pulsar-master\pulsar-master\pulsar-common\src\main\java\org\apache\pulsar\common\net\package-info.java,0,2,0,1,0,3
 pulsar-master\pulsar-master\pulsar-client\src\main\java\org\apache\pulsar\client\impl\auth\oauth2\protocol\TokenClient.java,103,28,0,10,0,38
 pulsar-master\pulsar-master\pulsar-common\src\main\java\org\apache\pulsar\common\functions\UpdateOptionsImpl.java,7,2,0,2,0,4
 pulsar-master\pulsar-master\pulsar-common\src\main\java\org\apache\pulsar\common\policies\data\stats\NonPersistentPublisherStatsImpl.java,16,7,0,4,0,11
 pulsar-master\pulsar-master\pulsar-client\src\main\java\org\apache\pulsar\client\impl\TopicMetadataImpl.java,0,3,0,1,0,4
 pulsar-master\pulsar-master\pulsar-io\hbase\src\main\java\org\apache\pulsar\io\hbase\sink\package-info.java,0,1,0,1,0,2
 pulsar-master\pulsar-master\tiered-storage\jcloud\src\main\java\org\apache\bookkeeper\mledger\offload\jcloud\impl\OffloadIndexBlockV2Impl.java,0,79,4,33,0,116
 pulsar-master\pulsar-master\pulsar-broker\src\test\java\org\apache\pulsar\client\impl\PartialPartitionedProducerTest.java,215,52,4,20,0,76
 pulsar-master\pulsar-master\pulsar-common\src\test\java\org\apache\pulsar\common\policies\data\OldPolicies.java,31,21,1,4,0,26
 pulsar-master\pulsar-master\buildtools\src\main\java\org\apache\pulsar\tests\FastThreadLocalStateCleaner.java,0,31,0,16,0,47
 pulsar-master\pulsar-master\pulsar-broker-common\src\main\java\org\apache\pulsar\broker\web\plugin\servlet\AdditionalServletDefinitions.java,5,2,0,2,0,4
 pulsar-master\pulsar-master\pulsar-metadata\src\test\java\org\apache\pulsar\metadata\MetadataStoreExtendedTest.java,34,9,0,7,0,16
 pulsar-master\pulsar-master\pulsar-broker\src\test\java\org\apache\pulsar\broker\transaction\TransactionProduceTest.java,310,61,7,38,0,106
 pulsar-master\pulsar-master\pulsar-sql\presto-pulsar\src\main\java\org\apache\pulsar\sql\presto\PulsarPlugin.java,7,1,0,1,0,2
 pulsar-master\pulsar-master\pulsar-broker\src\main\java\org\apache\pulsar\broker\transaction\buffer\TransactionBuffer.java,0,23,0,22,0,45
 pulsar-master\pulsar-master\pulsar-websocket\src\test\java\org\apache\pulsar\websocket\WebSocketHttpServletRequestWrapperTest.java,59,24,0,19,0,43
 pulsar-master\pulsar-master\pulsar-broker\src\main\java\org\apache\pulsar\broker\service\EntryBatchSizes.java,37,18,1,2,0,21
 pulsar-master\pulsar-master\pulsar-broker\src\main\java\org\apache\pulsar\broker\stats\prometheus\metrics\DataSketchesSummaryLogger.java,93,29,3,3,0,35
 pulsar-master\pulsar-master\pulsar-client\src\main\java\org\apache\pulsar\client\impl\TypedMessageBuilderImpl.java,264,75,1,17,0,93
 pulsar-master\pulsar-master\pulsar-common\src\main\java\org\apache\pulsar\common\policies\data\LocalPolicies.java,24,14,0,1,0,15
 pulsar-master\pulsar-master\pulsar-functions\instance\src\main\java\org\apache\pulsar\functions\windowing\WindowManager.java,256,54,1,17,0,72
 pulsar-master\pulsar-master\pulsar-package-management\bookkeeper-storage\src\main\java\org\apache\pulsar\packages\management\storage\bookkeeper\BookKeeperPackagesStorageConfiguration.java,57,19,0,4,0,23
 pulsar-master\pulsar-master\pulsar-client-admin-api\src\main\java\org\apache\pulsar\client\admin\ResourceGroups.java,0,23,0,16,0,39
 pulsar-master\pulsar-master\pulsar-broker-common\src\main\java\org\apache\pulsar\broker\ServiceConfiguration.java,2671,1006,1,452,0,1459
 pulsar-master\pulsar-master\pulsar-sql\presto-pulsar\src\test\java\org\apache\pulsar\sql\presto\TestReadChunkedMessages.java,160,37,3,19,0,59
 pulsar-master\pulsar-master\pulsar-functions\worker\src\main\java\org\apache\pulsar\functions\worker\rest\api\v3\package-info.java,0,0,0,1,0,1
 pulsar-master\pulsar-master\pulsar-functions\api-java\src\main\java\org\apache\pulsar\functions\api\state\CounterStateStore.java,0,1,0,1,0,2
 pulsar-master\pulsar-master\tests\integration\src\test\java\org\apache\pulsar\tests\integration\io\sinks\JdbcPostgresSinkTester.java,97,22,4,4,0,30
 pulsar-master\pulsar-master\pulsar-broker\src\test\java\org\apache\pulsar\broker\service\persistent\ReplicatedSubscriptionConfigTest.java,107,8,1,5,0,14
 pulsar-master\pulsar-master\pulsar-functions\instance\src\main\java\org\apache\pulsar\functions\instance\JavaExecutionResult.java,12,7,0,3,0,10
 pulsar-master\pulsar-master\tiered-storage\jcloud\src\main\java\org\apache\bookkeeper\mledger\offload\jcloud\provider\JCloudBlobStoreProvider.java,0,97,5,64,0,166
 pulsar-master\pulsar-master\structured-event-log\src\main\java\org\apache\pulsar\structuredeventlog\slf4j\package-info.java,0,0,0,1,0,1
 pulsar-master\pulsar-master\pulsar-common\src\main\java\org\apache\pulsar\common\policies\data\FunctionInstanceStatsDataImpl.java,0,7,0,4,0,11
 pulsar-master\pulsar-master\pulsar-transaction\coordinator\src\main\java\org\apache\pulsar\transaction\coordinator\impl\MLTransactionMetadataStore.java,0,163,4,111,0,278
 pulsar-master\pulsar-master\pulsar-broker\src\main\java\org\apache\pulsar\utils\auth\tokens\package-info.java,0,0,0,1,0,1
 pulsar-master\pulsar-master\pulsar-functions\worker\src\test\java\org\apache\pulsar\functions\worker\rest\api\v3\FunctionApiV3ResourceTest.java,1557,376,15,181,0,572
 pulsar-master\pulsar-master\pulsar-websocket\src\test\java\org\apache\pulsar\websocket\service\WebSocketServiceStarterTest.java,35,3,1,3,0,7
 pulsar-master\pulsar-master\pulsar-client-admin-api\src\main\java\org\apache\pulsar\common\policies\data\Policies.java,175,164,1,46,0,211
 pulsar-master\pulsar-master\pulsar-functions\java-examples\src\main\java\org\apache\pulsar\functions\api\examples\CustomBaseToBaseFunction.java,0,5,0,2,0,7
 pulsar-master\pulsar-master\pulsar-broker\src\test\java\org\apache\pulsar\broker\admin\AdminApiGetLastMessageIdTest.java,202,52,10,20,0,82
 pulsar-master\pulsar-master\pulsar-client-api\src\main\java\org\apache\pulsar\client\api\ProducerStats.java,0,8,0,9,0,17
 pulsar-master\pulsar-master\pulsar-client\src\main\java\org\apache\pulsar\client\impl\UnAckedMessageTracker.java,232,72,5,21,0,98
 pulsar-master\pulsar-master\pulsar-io\flume\src\main\java\org\apache\pulsar\io\flume\node\StaticZooKeeperConfigurationProvider.java,29,8,0,3,0,11
 pulsar-master\pulsar-master\pulsar-client\src\main\java\org\apache\pulsar\client\impl\auth\oauth2\Flow.java,0,1,0,2,0,3
 pulsar-master\pulsar-master\pulsar-common\src\main\java\org\apache\pulsar\common\naming\Metadata.java,25,7,2,2,0,11
 pulsar-master\pulsar-master\pulsar-client\src\test\java\org\apache\pulsar\client\impl\conf\DefaultCryptoKeyReaderConfigurationDataTest.java,48,11,0,10,0,21
 pulsar-master\pulsar-master\pulsar-broker\src\test\java\org\apache\pulsar\client\impl\MessageRedeliveryTest.java,330,75,9,33,0,117
 pulsar-master\pulsar-master\pulsar-broker\src\test\java\org\apache\pulsar\broker\admin\MockServletContext.java,240,89,16,11,0,116
 pulsar-master\pulsar-master\pulsar-common\src\main\java\org\apache\pulsar\common\policies\data\PolicyOperation.java,0,2,0,1,0,3
 pulsar-master\pulsar-master\pulsar-broker\src\main\java\org\apache\pulsar\broker\service\RedeliveryTracker.java,0,8,0,1,0,9
 pulsar-master\pulsar-master\pulsar-io\flume\src\test\java\org\apache\pulsar\io\flume\node\TestAbstractConfigurationProvider.java,332,60,1,12,0,73
 pulsar-master\pulsar-master\pulsar-io\elastic-search\src\test\java\org\apache\pulsar\io\elasticsearch\opensearch\OpenSearchSinkRawDataTests.java,0,1,0,1,0,2
 pulsar-master\pulsar-master\pulsar-broker\src\main\java\org\apache\pulsar\broker\lookup\NamespaceData.java,12,6,0,1,0,7
 pulsar-master\pulsar-master\pulsar-common\src\main\java\org\apache\pulsar\common\stats\Rate.java,67,35,0,3,0,38
 pulsar-master\pulsar-master\pulsar-io\netty\src\test\java\org\apache\pulsar\io\netty\http\NettyHttpChannelInitializerTest.java,16,4,0,2,0,6
 pulsar-master\pulsar-master\pulsar-functions\worker\src\main\java\org\apache\pulsar\functions\worker\FunctionActioner.java,612,191,15,120,0,326
 pulsar-master\pulsar-master\pulsar-client\src\main\java\org\apache\pulsar\client\impl\MultiplierRedeliveryBackoff.java,69,45,0,9,0,54
 pulsar-master\pulsar-master\pulsar-io\kinesis\src\test\java\org\apache\pulsar\io\kinesis\UtilsTest.java,0,126,8,79,0,213
 pulsar-master\pulsar-master\pulsar-broker\src\main\java\org\apache\pulsar\broker\protocol\ProtocolHandlerMetadata.java,0,0,0,1,0,1
 pulsar-master\pulsar-master\pulsar-common\src\main\java\org\apache\pulsar\common\compression\CompressionCodec.java,0,3,0,4,0,7
 pulsar-master\pulsar-master\tests\integration\src\test\java\org\apache\pulsar\tests\integration\functions\PulsarFunctionsTest.java,1816,437,31,222,0,690
 pulsar-master\pulsar-master\pulsar-broker\src\main\java\org\apache\pulsar\broker\transaction\buffer\impl\InMemTransactionBuffer.java,0,68,1,22,0,91
 pulsar-master\pulsar-master\managed-ledger\src\main\java\org\apache\bookkeeper\mledger\impl\MetaStoreImpl.java,362,124,2,63,0,189
 pulsar-master\pulsar-master\pulsar-client\src\test\java\org\apache\pulsar\client\impl\ProducerBuilderImplTest.java,328,86,1,42,0,129
 pulsar-master\pulsar-master\pulsar-broker\src\test\java\org\apache\pulsar\broker\service\persistent\PersistentStreamingDispatcherBlockConsumerTest.java,10,4,0,2,0,6
 pulsar-master\pulsar-master\pulsar-functions\instance\src\main\java\org\apache\pulsar\functions\instance\SinkRecord.java,104,23,0,7,0,30
 pulsar-master\pulsar-master\pulsar-broker\src\main\java\org\apache\pulsar\broker\service\BrokerServiceException.java,231,86,1,24,0,111
 pulsar-master\pulsar-master\pulsar-broker\src\main\java\org\apache\pulsar\broker\transaction\buffer\impl\InMemTransactionBufferReader.java,63,21,0,7,0,28
 pulsar-master\pulsar-master\pulsar-io\mongo\src\main\java\org\apache\pulsar\io\mongodb\package-info.java,0,1,0,1,0,2
 pulsar-master\pulsar-master\pulsar-io\hdfs3\src\main\java\org\apache\pulsar\io\hdfs3\AbstractHdfsConnector.java,200,51,1,27,0,79
 pulsar-master\pulsar-master\pulsar-broker\src\main\java\org\apache\pulsar\common\naming\NamespaceBundleFactory.java,357,163,10,70,0,243
 pulsar-master\pulsar-master\pulsar-functions\instance\src\main\java\org\apache\pulsar\functions\windowing\evictors\WatermarkTimeEvictionPolicy.java,63,11,0,4,0,15
 pulsar-master\pulsar-master\pulsar-client\src\main\java\org\apache\pulsar\client\impl\HandlerState.java,65,31,3,11,0,45
 pulsar-master\pulsar-master\pulsar-functions\java-examples\src\main\java\org\apache\pulsar\functions\api\examples\CustomDerivedToDerivedFunction.java,0,8,0,4,0,12
 pulsar-master\pulsar-master\pulsar-broker-common\src\main\java\org\apache\pulsar\broker\web\AuthenticationFilter.java,88,36,2,20,0,58
 pulsar-master\pulsar-master\pulsar-io\file\src\main\java\org\apache\pulsar\io\file\FileConsumerThread.java,72,22,0,3,0,25
 pulsar-master\pulsar-master\pulsar-broker\src\test\java\org\apache\pulsar\client\impl\ProducerSemaphoreTest.java,168,43,1,34,0,78
 pulsar-master\pulsar-master\managed-ledger\src\main\java\org\apache\bookkeeper\mledger\impl\EntryImpl.java,148,31,0,4,0,35
 pulsar-master\pulsar-master\pulsar-broker\src\main\java\org\apache\pulsar\broker\admin\v2\Clusters.java,3,0,0,1,0,1
 pulsar-master\pulsar-master\pulsar-io\aws\src\main\java\org\apache\pulsar\io\aws\AwsDefaultProviderChainPlugin.java,22,5,2,3,0,10
 pulsar-master\pulsar-master\pulsar-broker\src\main\java\org\apache\pulsar\broker\service\EntryBatchIndexesAcks.java,57,25,1,6,0,32
 pulsar-master\pulsar-master\pulsar-broker\src\main\java\org\apache\pulsar\broker\transaction\buffer\impl\InMemTransactionBufferProvider.java,8,4,0,3,0,7
 pulsar-master\pulsar-master\pulsar-broker\src\main\java\org\apache\pulsar\broker\service\plugin\EntryFilterProvider.java,120,37,4,26,0,67
 pulsar-master\pulsar-master\pulsar-client-messagecrypto-bc\src\main\java\org\apache\pulsar\client\impl\crypto\MessageCryptoBc.java,0,128,12,68,0,208
 pulsar-master\pulsar-master\pulsar-client\src\main\java\org\apache\pulsar\client\impl\schema\InstantSchema.java,56,10,1,1,0,12
 pulsar-master\pulsar-master\pulsar-broker\src\main\java\org\apache\pulsar\broker\admin\impl\ResourceGroupsBase.java,149,49,15,32,0,96
 pulsar-master\pulsar-master\pulsar-metadata\src\main\java\org\apache\pulsar\metadata\api\CacheGetResult.java,12,2,0,2,0,4
 pulsar-master\pulsar-master\pulsar-broker\src\main\java\org\apache\pulsar\common\naming\SpecifiedPositionsBundleSplitAlgorithm.java,28,10,2,7,0,19
 pulsar-master\pulsar-master\pulsar-broker\src\main\java\org\apache\pulsar\compaction\CompactorMXBeanImpl.java,47,41,0,10,0,51
 pulsar-master\pulsar-master\tests\integration\src\test\java\org\apache\pulsar\tests\integration\semantics\SemanticsTest.java,242,53,1,25,0,79
 pulsar-master\pulsar-master\pulsar-client\src\test\java\org\apache\pulsar\client\impl\UnAckedMessageTrackerTest.java,42,5,0,3,0,8
 pulsar-master\pulsar-master\pulsar-client\src\test\java\org\apache\pulsar\client\impl\auth\AuthenticationTokenTest.java,185,22,0,9,0,31
 pulsar-master\pulsar-master\pulsar-broker\src\test\java\org\apache\pulsar\broker\service\ManagedLedgerCompressionTest.java,72,17,0,10,0,27
 pulsar-master\pulsar-master\pulsar-functions\java-examples\src\main\java\org\apache\pulsar\functions\api\examples\ExclamationFunction.java,0,3,0,1,0,4
 pulsar-master\pulsar-master\pulsar-broker\src\main\java\org\apache\pulsar\broker\loadbalance\LoadResourceQuotaUpdaterTask.java,18,8,0,3,0,11
 pulsar-master\pulsar-master\pulsar-sql\presto-pulsar\src\main\java\org\apache\pulsar\sql\presto\PulsarConnectorId.java,32,8,0,1,0,9
 pulsar-master\pulsar-master\pulsar-broker\src\test\java\org\apache\pulsar\broker\web\plugin\servlet\AdditionalServletWithClassLoaderTest.java,77,19,0,14,0,33
 pulsar-master\pulsar-master\pulsar-client-api\src\main\java\org\apache\pulsar\client\api\Authentication.java,0,19,0,13,0,32
 pulsar-master\pulsar-master\pulsar-common\src\test\java\org\apache\pulsar\common\policies\data\LocalPolicesTest.java,133,40,4,21,0,65
 pulsar-master\pulsar-master\pulsar-broker\src\test\java\org\apache\pulsar\common\naming\ServiceConfigurationTest.java,194,66,5,36,0,107
 pulsar-master\pulsar-master\pulsar-broker\src\test\java\org\apache\pulsar\broker\EndToEndMetadataTest.java,42,6,0,2,0,8
 pulsar-master\pulsar-master\tests\integration\src\test\java\org\apache\pulsar\tests\integration\containers\ZKContainer.java,0,17,2,2,0,21
 pulsar-master\pulsar-master\tests\integration\src\test\java\org\apache\pulsar\tests\integration\offload\TestUniversalConfigurations.java,55,21,0,9,0,30
 pulsar-master\pulsar-master\pulsar-client-api\src\main\java\org\apache\pulsar\client\api\ProducerAccessMode.java,0,1,0,2,0,3
 pulsar-master\pulsar-master\pulsar-broker\src\main\java\org\apache\pulsar\broker\service\schema\KeyValueSchemaCompatibilityCheck.java,69,31,0,18,0,49
 pulsar-master\pulsar-master\pulsar-broker\src\test\java\org\apache\pulsar\broker\zookeeper\ClusterMetadataSetupTest.java,432,84,1,38,0,123
 pulsar-master\pulsar-master\pulsar-metadata\src\main\java\org\apache\pulsar\metadata\api\extended\SessionEvent.java,0,3,0,3,0,6
 pulsar-master\pulsar-master\pulsar-functions\instance\src\main\java\org\apache\pulsar\functions\source\SerDeSchema.java,26,7,2,1,0,10
 pulsar-master\pulsar-master\pulsar-client-tools\src\test\java\org\apache\pulsar\admin\cli\TestCmdFunctionWorker.java,24,6,1,1,0,8
 pulsar-master\pulsar-master\pulsar-functions\api-java\src\main\java\org\apache\pulsar\functions\api\utils\package-info.java,0,1,0,1,0,2
 pulsar-master\pulsar-master\pulsar-common\src\main\java\org\apache\pulsar\common\util\FileModifiedTimeUpdater.java,35,13,0,4,0,17
 pulsar-master\pulsar-master\pulsar-functions\java-examples\src\main\java\org\apache\pulsar\functions\api\examples\CustomBaseSerde.java,0,5,0,1,0,6
 pulsar-master\pulsar-master\pulsar-broker\src\main\java\org\apache\pulsar\broker\lookup\v1\package-info.java,0,0,0,1,0,1
 pulsar-master\pulsar-master\pulsar-broker\src\test\java\org\apache\pulsar\broker\service\persistent\ChecksumTest.java,64,7,0,5,0,12
 pulsar-master\pulsar-master\pulsar-broker\src\main\java\org\apache\pulsar\broker\resourcegroup\package-info.java,0,1,0,1,0,2
 pulsar-master\pulsar-master\pulsar-client\src\main\java\org\apache\pulsar\client\impl\schema\BooleanSchema.java,56,13,1,2,0,16
 pulsar-master\pulsar-master\tests\integration\src\test\java\org\apache\pulsar\tests\integration\io\sinks\CassandraSinkTester.java,98,21,5,5,0,31
 pulsar-master\pulsar-master\pulsar-broker\src\test\java\org\apache\pulsar\broker\transaction\TopicTransactionBufferRecoverTest.java,482,125,19,86,0,230
 pulsar-master\pulsar-master\managed-ledger\src\main\java\org\apache\bookkeeper\mledger\impl\ManagedLedgerFactoryImpl.java,908,357,15,157,0,529
 pulsar-master\pulsar-master\pulsar-functions\worker\src\main\java\org\apache\pulsar\functions\worker\rest\api\v3\SourceApiV3Resource.java,3,1,0,1,0,2
 pulsar-master\pulsar-master\pulsar-broker\src\test\java\org\apache\pulsar\broker\transaction\pendingack\PendingAckPersistentTest.java,289,57,16,40,0,113
 pulsar-master\pulsar-master\pulsar-client-admin-api\src\main\java\org\apache\pulsar\common\policies\data\BrokerInfo.java,0,4,0,1,0,5
 pulsar-master\pulsar-master\pulsar-sql\presto-pulsar\src\main\java\org\apache\pulsar\sql\presto\PulsarDispatchingRowDecoderFactory.java,44,31,1,14,0,46
 pulsar-master\pulsar-master\tests\integration\src\test\java\org\apache\pulsar\tests\integration\backwardscompatibility\PulsarStandaloneTestSuite2_3.java,6,4,1,2,0,7
 pulsar-master\pulsar-master\pulsar-common\src\test\java\org\apache\pulsar\common\compression\CompressorCodecBackwardCompatTest.java,50,17,0,7,0,24
 pulsar-master\pulsar-master\pulsar-functions\utils\src\test\java\org\apache\pulsar\functions\utils\SinkConfigUtilsTest.java,433,125,11,79,0,215
 pulsar-master\pulsar-master\pulsar-io\file\src\test\java\org\apache\pulsar\io\file\ProcessedFileThreadTests.java,278,82,2,34,0,118
 pulsar-master\pulsar-master\pulsar-io\core\src\main\java\org\apache\pulsar\io\core\annotations\IOType.java,0,0,0,1,0,1
 pulsar-master\pulsar-master\pulsar-functions\instance\src\test\java\org\apache\pulsar\functions\sink\PulsarSinkTest.java,540,94,10,65,0,169
 pulsar-master\pulsar-master\pulsar-broker\src\main\java\org\apache\pulsar\common\naming\BundleSplitOption.java,6,3,0,1,0,4
 pulsar-master\pulsar-master\pulsar-sql\presto-pulsar\src\main\java\org\apache\pulsar\sql\presto\PulsarConnector.java,65,34,0,9,0,43
 pulsar-master\pulsar-master\pulsar-client\src\test\java\org\apache\pulsar\client\impl\ClientCnxTest.java,110,15,4,10,0,29
 pulsar-master\pulsar-master\pulsar-io\core\src\main\java\org\apache\pulsar\io\core\PushSource.java,47,9,0,4,0,13
 pulsar-master\pulsar-master\pulsar-broker\src\test\java\org\apache\pulsar\websocket\proxy\ProxyAuthenticationTest.java,172,44,5,20,0,69
 pulsar-master\pulsar-master\pulsar-common\src\main\java\org\apache\pulsar\common\util\netty\NettyFutureUtil.java,59,6,1,4,0,11
 pulsar-master\pulsar-master\pulsar-metadata\src\test\java\org\apache\pulsar\metadata\MetadataCacheTest.java,527,164,2,85,0,251
 pulsar-master\pulsar-master\pulsar-common\src\main\java\org\apache\pulsar\common\util\DefaultSslContextBuilder.java,39,30,2,11,0,43
 pulsar-master\pulsar-master\pulsar-broker\src\test\java\org\apache\pulsar\client\api\DeadLetterTopicTest.java,748,181,19,123,0,323
 pulsar-master\pulsar-master\pulsar-broker\src\test\java\org\apache\pulsar\client\impl\ReaderTest.java,554,111,23,64,0,198
 pulsar-master\pulsar-master\pulsar-websocket\src\test\java\org\apache\pulsar\websocket\LookupProtocolTest.java,69,21,4,10,0,35
 pulsar-master\pulsar-master\pulsar-broker\src\main\java\org\apache\pulsar\client\impl\package-info.java,0,0,0,1,0,1
 pulsar-master\pulsar-master\pulsar-metadata\src\main\java\org\apache\pulsar\metadata\impl\RocksdbMetadataStore.java,508,103,13,44,0,160
 pulsar-master\pulsar-master\pulsar-client-admin-api\src\main\java\org\apache\pulsar\client\admin\Schemas.java,0,35,0,21,0,56
 pulsar-master\pulsar-master\pulsar-broker\src\test\java\org\apache\pulsar\broker\service\persistent\TopicDuplicationTest.java,467,173,5,101,0,279
 pulsar-master\pulsar-master\pulsar-client\src\main\java\org\apache\pulsar\client\impl\ProducerStatsDisabled.java,116,22,0,1,0,23
 pulsar-master\pulsar-master\pulsar-client\src\test\java\org\apache\pulsar\client\impl\ClientTestFixtures.java,0,29,1,17,0,47
 pulsar-master\pulsar-master\pulsar-client-admin-api\src\main\java\org\apache\pulsar\common\policies\data\NonPersistentPartitionedTopicStats.java,0,4,0,2,0,6
 pulsar-master\pulsar-master\managed-ledger\src\test\java\org\apache\bookkeeper\mledger\impl\PositionTest.java,56,20,4,2,0,26
 pulsar-master\pulsar-master\tests\integration\src\test\java\org\apache\pulsar\tests\integration\auth\token\TokenAuthWithSymmetricKeys.java,55,20,0,11,0,31
 pulsar-master\pulsar-master\pulsar-broker\src\main\java\org\apache\pulsar\compaction\CompactedTopic.java,0,6,0,2,0,8
 pulsar-master\pulsar-master\pulsar-client-admin\src\main\java\org\apache\pulsar\client\admin\internal\http\AsyncHttpConnector.java,273,80,2,41,0,123
 pulsar-master\pulsar-master\pulsar-functions\instance\src\test\java\org\apache\pulsar\functions\instance\state\InstanceStateManagerTest.java,86,8,2,1,0,11
 pulsar-master\pulsar-master\pulsar-client\src\test\java\org\apache\pulsar\client\impl\SinglePartitionMessageRouterImplTest.java,31,14,0,6,0,20
 pulsar-master\pulsar-master\managed-ledger\src\test\java\org\apache\bookkeeper\mledger\impl\ManagedLedgerFactoryTest.java,45,11,1,3,0,15
 pulsar-master\pulsar-master\pulsar-client-admin-api\src\main\java\org\apache\pulsar\common\policies\data\PartitionedTopicStats.java,0,4,0,1,0,5
 pulsar-master\pulsar-master\pulsar-io\hdfs2\src\main\java\org\apache\pulsar\io\hdfs2\sink\seq\package-info.java,0,1,0,1,0,2
 pulsar-master\pulsar-master\pulsar-io\flume\src\main\java\org\apache\pulsar\io\flume\FlumeConnector.java,87,20,1,12,0,33
 pulsar-master\pulsar-master\pulsar-broker\src\test\java\org\apache\pulsar\client\impl\TableViewTest.java,186,49,12,21,0,82
 pulsar-master\pulsar-master\pulsar-functions\worker\src\test\java\org\apache\pulsar\functions\worker\rest\api\v3\SinkApiV3ResourceTest.java,1601,401,15,238,0,654
 pulsar-master\pulsar-master\pulsar-functions\instance\src\main\java\org\apache\pulsar\functions\windowing\EventImpl.java,32,13,0,1,0,14
 pulsar-master\pulsar-master\pulsar-client\src\main\java\org\apache\pulsar\client\impl\package-info.java,0,1,0,1,0,2
 pulsar-master\pulsar-master\pulsar-functions\instance\src\main\java\org\apache\pulsar\functions\instance\InstanceCache.java,32,6,1,2,0,9
 pulsar-master\pulsar-master\pulsar-broker\src\test\java\org\apache\pulsar\broker\namespace\NamespaceOwnershipListenerTests.java,136,25,2,13,0,40
 pulsar-master\pulsar-master\pulsar-broker\src\test\java\org\apache\pulsar\broker\service\RackAwareTest.java,270,50,12,28,0,90
 pulsar-master\pulsar-master\pulsar-websocket\src\main\java\org\apache\pulsar\websocket\stats\ProxyStats.java,132,45,0,18,0,63
 pulsar-master\pulsar-master\pulsar-proxy\src\test\java\org\apache\pulsar\proxy\server\ProxyParserTest.java,204,51,0,28,0,79
 pulsar-master\pulsar-master\pulsar-io\redis\src\main\java\org\apache\pulsar\io\redis\package-info.java,0,1,0,1,0,2
 pulsar-master\pulsar-master\pulsar-functions\runtime\src\main\java\org\apache\pulsar\functions\runtime\RuntimeSpawner.java,114,50,6,20,0,76
 pulsar-master\pulsar-master\pulsar-io\batch-discovery-triggerers\src\main\java\org\apache\pulsar\io\batchdiscovery\CronTriggerer.java,0,15,0,7,0,22
 pulsar-master\pulsar-master\pulsar-client-admin-api\src\main\java\org\apache\pulsar\common\policies\AutoFailoverPolicy.java,21,6,0,4,0,10
 pulsar-master\pulsar-master\pulsar-broker\src\main\java\org\apache\pulsar\broker\service\PulsarCommandSender.java,0,46,0,19,0,65
 pulsar-master\pulsar-master\pulsar-functions\java-examples\src\main\java\org\apache\pulsar\functions\api\examples\InstanceIdAppenderFunction.java,0,3,0,1,0,4
 pulsar-master\pulsar-master\pulsar-broker-auth-sasl\src\test\java\org\apache\pulsar\broker\authentication\SaslServerTokenSignerTest.java,84,14,9,8,0,31
 pulsar-master\pulsar-master\pulsar-sql\presto-pulsar\src\main\java\org\apache\pulsar\sql\presto\PulsarTopicDescription.java,41,18,0,2,0,20
 pulsar-master\pulsar-master\pulsar-client-tools-test\src\test\java\org\apache\pulsar\client\cli\PulsarClientToolTest.java,233,64,16,36,0,116
 pulsar-master\pulsar-master\pulsar-client-admin\src\main\java\org\apache\pulsar\client\admin\internal\TenantsImpl.java,0,64,0,15,0,79
 pulsar-master\pulsar-master\bouncy-castle\bcfips-include-test\src\test\java\org\apache\pulsar\client\TlsProducerConsumerTest.java,104,33,3,20,0,56
 pulsar-master\pulsar-master\pulsar-broker\src\test\java\org\apache\pulsar\broker\admin\v3\PackagesApiNotEnabledTest.java,62,11,0,3,0,14
 pulsar-master\pulsar-master\pulsar-proxy\src\test\java\org\apache\pulsar\proxy\server\ProxyForwardAuthDataTest.java,108,20,1,16,0,37
 pulsar-master\pulsar-master\pulsar-common\src\main\java\org\apache\pulsar\common\naming\TopicName.java,364,102,2,36,0,140
 pulsar-master\pulsar-master\pulsar-client-admin-api\src\main\java\org\apache\pulsar\common\functions\FunctionState.java,8,5,0,1,0,6
 pulsar-master\pulsar-master\pulsar-common\src\test\java\org\apache\pulsar\common\policies\data\PersistencePoliciesTest.java,11,1,0,1,0,2
 pulsar-master\pulsar-master\pulsar-client-api\src\main\java\org\apache\pulsar\common\schema\package-info.java,0,2,0,2,0,4
 pulsar-master\pulsar-master\pulsar-metadata\src\main\java\org\apache\pulsar\metadata\bookkeeper\CombinedLedgerRangeIterator.java,0,10,0,3,0,13
 pulsar-master\pulsar-master\pulsar-io\hdfs3\src\main\java\org\apache\pulsar\io\hdfs3\package-info.java,0,1,0,1,0,2
 pulsar-master\pulsar-master\pulsar-metadata\src\main\java\org\apache\pulsar\metadata\bookkeeper\PulsarLedgerAuditorManager.java,0,16,0,6,0,22
 pulsar-master\pulsar-master\pulsar-broker\src\test\java\org\apache\pulsar\client\impl\RetryUtilTest.java,51,15,0,4,0,19
 pulsar-master\pulsar-master\pulsar-io\kafka-connect-adaptor\src\main\java\org\apache\pulsar\io\kafka\connect\PulsarKafkaSinkTaskContext.java,201,71,4,23,0,98
 pulsar-master\pulsar-master\pulsar-broker\src\main\java\org\apache\pulsar\broker\transaction\buffer\impl\TopicTransactionBufferProvider.java,8,3,0,2,0,5
 pulsar-master\pulsar-master\pulsar-client-messagecrypto-bc\src\main\java\org\apache\pulsar\client\impl\crypto\package-info.java,0,1,0,1,0,2
 pulsar-master\pulsar-master\pulsar-io\hdfs2\src\main\java\org\apache\pulsar\io\hdfs2\SecurityUtil.java,62,12,1,10,0,23
 pulsar-master\pulsar-master\pulsar-common\src\test\java\org\apache\pulsar\common\util\CompletableFutureCancellationHandlerTest.java,29,4,0,3,0,7
 pulsar-master\pulsar-master\pulsar-common\src\test\java\org\apache\pulsar\common\api\raw\RawMessageImplTest.java,25,18,0,10,0,28
 pulsar-master\pulsar-master\pulsar-functions\instance\src\main\java\org\apache\pulsar\functions\instance\stats\PrometheusTextFormat.java,54,14,2,8,0,24
 pulsar-master\pulsar-master\pulsar-functions\secrets\src\main\java\org\apache\pulsar\functions\secretsprovider\package-info.java,0,0,0,1,0,1
 pulsar-master\pulsar-master\pulsar-broker\src\test\java\org\apache\pulsar\broker\service\ConsumedLedgersTrimTest.java,136,35,12,21,0,68
 pulsar-master\pulsar-master\pulsar-common\src\main\java\org\apache\pulsar\common\protocol\schema\BytesSchemaVersion.java,0,32,1,9,0,42
 pulsar-master\pulsar-master\pulsar-client\src\test\java\org\apache\pulsar\client\impl\schema\ShortSchemaTest.java,54,16,0,1,0,17
 pulsar-master\pulsar-master\pulsar-broker\src\test\java\org\apache\pulsar\client\api\NonPersistentTopicTest.java,1004,250,10,141,0,401
 pulsar-master\pulsar-master\pulsar-broker\src\main\java\org\apache\pulsar\broker\stats\prometheus\AggregatedConsumerStats.java,19,16,0,1,0,17
 pulsar-master\pulsar-master\pulsar-websocket\src\test\java\org\apache\pulsar\websocket\WebSocketProxyConfigurationTest.java,56,16,1,10,0,27
 pulsar-master\pulsar-master\pulsar-client\src\test\java\org\apache\pulsar\client\api\ConsumerIdTest.java,48,18,0,11,0,29
 pulsar-master\pulsar-master\pulsar-websocket\src\main\java\org\apache\pulsar\websocket\admin\v2\package-info.java,0,0,0,1,0,1
 pulsar-master\pulsar-master\pulsar-broker\src\test\java\org\apache\pulsar\client\api\SimpleTypedProducerConsumerTest.java,623,123,29,46,0,198
 pulsar-master\pulsar-master\pulsar-metadata\src\main\java\org\apache\pulsar\metadata\api\coordination\ResourceLock.java,0,3,0,2,0,5
 pulsar-master\pulsar-master\pulsar-io\kafka-connect-adaptor\src\test\java\org\apache\pulsar\io\kafka\connect\KafkaConnectSourceErrTest.java,97,20,4,11,0,35
 pulsar-master\pulsar-master\pulsar-metadata\src\main\java\org\apache\pulsar\metadata\impl\FaultInjectionMetadataStore.java,164,74,0,16,0,90
 pulsar-master\pulsar-master\pulsar-broker\src\main\java\org\apache\pulsar\broker\service\TransportCnx.java,0,23,0,1,0,24
 pulsar-master\pulsar-master\pulsar-broker\src\test\java\org\apache\pulsar\broker\protocol\SimpleProtocolHandlerTestsBase.java,129,31,4,14,0,49
 pulsar-master\pulsar-master\pulsar-websocket\src\main\java\org\apache\pulsar\websocket\stats\JvmMetrics.java,92,24,11,10,0,45
 pulsar-master\pulsar-master\pulsar-broker\src\test\java\org\apache\pulsar\broker\loadbalance\LeaderElectionServiceTest.java,109,34,1,18,0,53
 pulsar-master\pulsar-master\pulsar-package-management\core\src\main\java\org\apache\pulsar\packages\management\core\impl\PackagesManagementImpl.java,224,66,0,35,0,101
 pulsar-master\pulsar-master\pulsar-io\debezium\mongodb\src\main\java\org\apache\pulsar\io\debezium\mongodb\package-info.java,0,1,0,1,0,2
 pulsar-master\pulsar-master\pulsar-common\src\test\java\org\apache\pulsar\common\util\netty\SslContextTest.java,96,26,0,14,0,40
 pulsar-master\pulsar-master\pulsar-functions\utils\src\main\java\org\apache\pulsar\functions\utils\functions\Functions.java,5,4,0,1,0,5
 pulsar-master\pulsar-master\tests\integration\src\test\java\org\apache\pulsar\tests\integration\cli\AdminMultiHostTest.java,58,24,0,8,0,32
 pulsar-master\pulsar-master\pulsar-proxy\src\main\java\org\apache\pulsar\proxy\server\BrokerDiscoveryProvider.java,121,52,3,27,0,82
 pulsar-master\pulsar-master\pulsar-functions\worker\src\main\java\org\apache\pulsar\functions\worker\FunctionAssignmentTailer.java,139,44,4,14,0,62
 pulsar-master\pulsar-master\pulsar-functions\secrets\src\test\java\org\apache\pulsar\functions\secretsproviderconfigurator\KubernetesSecretsProviderConfiguratorTest.java,37,6,2,5,0,13
 pulsar-master\pulsar-master\pulsar-client-api\src\main\java\org\apache\pulsar\client\api\CryptoKeyReader.java,0,4,0,5,0,9
 pulsar-master\pulsar-master\pulsar-client-admin-api\src\main\java\org\apache\pulsar\common\policies\data\PublishRate.java,44,17,0,5,0,22
 pulsar-master\pulsar-master\pulsar-broker\src\test\java\org\apache\pulsar\broker\loadbalance\impl\BundleSplitterTaskTest.java,61,13,0,7,0,20
 pulsar-master\pulsar-master\pulsar-client\src\test\java\org\apache\pulsar\client\impl\auth\oauth2\AuthenticationOAuth2Test.java,101,24,0,8,0,32
 pulsar-master\pulsar-master\pulsar-functions\utils\src\main\java\org\apache\pulsar\functions\utils\SinkConfigUtils.java,603,149,19,127,0,295
 pulsar-master\pulsar-master\pulsar-broker-common\src\test\java\org\apache\pulsar\common\configuration\PulsarConfigurationLoaderTest.java,257,105,19,35,0,159
 pulsar-master\pulsar-master\pulsar-functions\utils\src\main\java\org\apache\pulsar\functions\utils\io\Connector.java,8,5,0,1,0,6
 pulsar-master\pulsar-master\pulsar-common\src\test\java\org\apache\pulsar\common\util\keystoretls\JettySslContextFactoryWithAutoRefreshTest.java,142,39,3,28,0,70
 pulsar-master\pulsar-master\pulsar-io\aws\src\main\java\org\apache\pulsar\io\aws\AwsCredentialProviderPlugin.java,0,10,0,8,0,18
 pulsar-master\pulsar-master\pulsar-broker-common\src\main\java\org\apache\pulsar\broker\web\plugin\servlet\AdditionalServletDefinition.java,17,0,0,1,0,1
 pulsar-master\pulsar-master\pulsar-proxy\src\main\java\org\apache\pulsar\proxy\extensions\ProxyExtensionWithClassLoader.java,0,16,0,10,0,26
 pulsar-master\pulsar-master\pulsar-client\src\main\java\org\apache\pulsar\client\impl\schema\ByteBufSchema.java,46,10,1,1,0,12
 pulsar-master\pulsar-master\pulsar-broker\src\test\java\org\apache\pulsar\client\impl\BatchMessageIndexAckTest.java,295,45,3,11,0,59
 pulsar-master\pulsar-master\pulsar-broker-common\src\main\java\org\apache\pulsar\common\configuration\PulsarConfigurationLoader.java,174,57,7,32,0,96
 pulsar-master\pulsar-master\pulsar-broker-common\src\main\java\org\apache\pulsar\common\configuration\FieldContext.java,0,1,0,1,0,2
 pulsar-master\pulsar-master\pulsar-client\src\main\java\org\apache\pulsar\client\impl\schema\AutoConsumeSchema.java,326,103,7,38,0,148
 pulsar-master\pulsar-master\pulsar-io\hdfs3\src\main\java\org\apache\pulsar\io\hdfs3\sink\seq\HdfsSequentialTextSink.java,0,14,0,8,0,22
 pulsar-master\pulsar-master\tests\integration\src\test\java\org\apache\pulsar\tests\integration\io\sinks\SinkTester.java,97,59,2,4,0,65
 pulsar-master\pulsar-master\pulsar-broker\src\test\java\org\apache\pulsar\broker\delayed\InMemoryDeliveryTrackerTest.java,140,52,0,8,0,60
 pulsar-master\pulsar-master\pulsar-broker\src\test\java\org\apache\pulsar\compaction\CompactorToolTest.java,43,3,2,3,0,8
 pulsar-master\pulsar-master\pulsar-functions\runtime\src\main\java\org\apache\pulsar\functions\runtime\thread\ThreadRuntimeFactory.java,174,121,3,40,0,164
 pulsar-master\pulsar-master\pulsar-client\src\main\java\org\apache\pulsar\client\impl\ConsumerStatsDisabled.java,126,21,1,1,0,23
 pulsar-master\pulsar-master\testmocks\src\main\java\org\apache\bookkeeper\client\PulsarMockBookKeeper.java,384,160,15,43,2,220
 pulsar-master\pulsar-master\pulsar-client-api\src\main\java\org\apache\pulsar\client\api\MessageId.java,0,11,0,9,0,20
 pulsar-master\pulsar-master\pulsar-broker\src\main\java\org\apache\pulsar\broker\intercept\BrokerInterceptorDefinitions.java,5,2,0,2,0,4
 pulsar-master\pulsar-master\pulsar-io\kafka\src\main\java\org\apache\pulsar\io\kafka\BytesWithKafkaSchema.java,5,3,0,2,0,5
 pulsar-master\pulsar-master\pulsar-broker\src\test\java\org\apache\pulsar\broker\service\nonpersistent\NonPersistentTopicTest.java,64,14,0,11,0,25
 pulsar-master\pulsar-master\managed-ledger\src\main\java\org\apache\bookkeeper\mledger\offload\Offloaders.java,27,11,1,7,0,19
 pulsar-master\pulsar-master\pulsar-io\kinesis\src\main\java\org\apache\pulsar\io\kinesis\STSAssumeRoleProviderPlugin.java,0,2,0,3,0,5
 pulsar-master\pulsar-master\pulsar-io\debezium\mssql\src\main\java\org\apache\pulsar\io\debezium\mssql\package-info.java,0,1,0,1,0,2
 pulsar-master\pulsar-master\pulsar-broker\src\main\java\org\apache\pulsar\broker\admin\v1\Functions.java,0,2,0,2,0,4
 pulsar-master\pulsar-master\pulsar-io\kafka-connect-adaptor\src\main\java\org\apache\pulsar\io\kafka\connect\PulsarIOSourceTaskContext.java,0,7,0,2,0,9
 pulsar-master\pulsar-master\pulsar-functions\runtime\src\main\java\org\apache\pulsar\functions\runtime\process\ProcessRuntimeFactory.java,200,108,1,28,0,137
 pulsar-master\pulsar-master\pulsar-common\src\main\java\org\apache\pulsar\common\protocol\CommandUtils.java,0,10,0,4,0,14
 pulsar-master\pulsar-master\pulsar-broker\src\main\java\org\apache\pulsar\broker\web\plugin\servlet\package-info.java,0,2,0,1,0,3
 pulsar-master\pulsar-master\pulsar-client\src\test\java\org\apache\pulsar\client\tutorial\ContinuousAsyncProducer.java,14,7,1,4,0,12
 pulsar-master\pulsar-master\pulsar-common\src\main\java\org\apache\pulsar\common\protocol\ByteBufPair.java,0,37,0,11,0,48
 pulsar-master\pulsar-master\pulsar-io\kafka-connect-adaptor\src\test\java\org\apache\pulsar\io\kafka\connect\PulsarOffsetBackingStoreTest.java,93,13,3,3,0,19
 pulsar-master\pulsar-master\pulsar-broker\src\test\java\org\apache\pulsar\socks5\Socks5Server.java,47,22,0,8,0,30
 pulsar-master\pulsar-master\buildtools\src\main\java\org\apache\pulsar\tests\MockitoThreadLocalStateCleaner.java,0,23,3,19,0,45
 pulsar-master\pulsar-master\pulsar-broker\src\main\java\org\apache\pulsar\broker\loadbalance\impl\BundleSplitterTask.java,75,19,2,17,0,38
 pulsar-master\pulsar-master\pulsar-client-admin-api\src\main\java\org\apache\pulsar\common\policies\data\impl\BrokerInfoImpl.java,0,9,0,1,0,10
 pulsar-master\pulsar-master\pulsar-common\src\main\java\org\apache\pulsar\common\policies\data\PoliciesUtil.java,46,11,1,3,0,15
 pulsar-master\pulsar-master\pulsar-common\src\main\java\org\apache\pulsar\common\util\collections\LongPairSet.java,0,15,2,5,0,22
 pulsar-master\pulsar-master\pulsar-broker\src\main\java\org\apache\pulsar\broker\admin\v2\Tenants.java,3,0,0,1,0,1
 pulsar-master\pulsar-master\pulsar-io\netty\src\main\java\org\apache\pulsar\io\netty\udp\NettyUDPChannelInitializer.java,15,6,0,1,0,7
 pulsar-master\pulsar-master\pulsar-io\batch-data-generator\src\test\java\org\apache\pulsar\io\batchdatagenerator\BatchDataGeneratorExec.java,38,6,1,3,0,10
 pulsar-master\pulsar-master\pulsar-functions\instance\src\main\java\org\apache\pulsar\functions\instance\JavaInstanceRunnable.java,0,186,8,125,0,319
 pulsar-master\pulsar-master\pulsar-functions\instance\src\main\java\org\apache\pulsar\functions\source\PulsarSourceConfig.java,15,11,1,2,0,14
 pulsar-master\pulsar-master\pulsar-functions\utils\src\main\java\org\apache\pulsar\functions\utils\functioncache\FunctionCacheManagerImpl.java,128,26,2,6,0,34
 pulsar-master\pulsar-master\pulsar-broker\src\test\java\org\apache\pulsar\client\impl\DynamicReceiverQueueSizeTest.java,90,35,0,10,0,45
 pulsar-master\pulsar-master\pulsar-broker\src\test\java\org\apache\pulsar\broker\service\NullValueTest.java,225,31,0,10,0,41
 pulsar-master\pulsar-master\pulsar-client-admin-api\src\main\java\org\apache\pulsar\common\policies\data\AutoTopicCreationOverride.java,0,8,0,2,0,10
 pulsar-master\pulsar-master\pulsar-client\src\main\java\org\apache\pulsar\client\impl\SinglePartitionMessageRouterImpl.java,23,11,0,4,0,15
 pulsar-master\pulsar-master\pulsar-client\src\test\java\org\apache\pulsar\client\tutorial\SampleProducer.java,14,7,1,4,0,12
 pulsar-master\pulsar-master\pulsar-io\jdbc\sqlite\src\test\java\org\apache\pulsar\io\jdbc\SqliteUtils.java,0,17,1,2,0,20
 pulsar-master\pulsar-master\pulsar-broker\src\main\java\org\apache\pulsar\client\api\RawMessage.java,0,8,0,5,0,13
 pulsar-master\pulsar-master\pulsar-client-admin-api\src\main\java\org\apache\pulsar\common\functions\ProducerConfig.java,8,5,0,1,0,6
 pulsar-master\pulsar-master\pulsar-client-admin\src\main\java\org\apache\pulsar\client\admin\internal\BookiesImpl.java,106,46,0,16,0,62
 pulsar-master\pulsar-master\pulsar-common\src\main\java\org\apache\pulsar\common\protocol\PulsarDecoder.java,590,176,1,56,0,233
 pulsar-master\pulsar-master\pulsar-functions\runtime\src\main\java\org\apache\pulsar\functions\auth\KubernetesSecretsTokenAuthProvider.java,360,97,5,53,0,155
 pulsar-master\pulsar-master\pulsar-broker\src\main\java\org\apache\pulsar\broker\service\DistributedIdGenerator.java,30,18,0,8,0,26
 pulsar-master\pulsar-master\pulsar-io\kafka-connect-adaptor\src\main\java\org\apache\pulsar\io\kafka\connect\schema\package-info.java,0,1,0,1,0,2
 pulsar-master\pulsar-master\tiered-storage\jcloud\src\test\java\org\apache\bookkeeper\mledger\offload\jcloud\impl\BlobStoreManagedLedgerOffloaderTest.java,474,154,26,100,0,280
 pulsar-master\pulsar-master\pulsar-broker\src\test\java\org\apache\pulsar\broker\protocol\ProtocolHandlerWithClassLoaderTest.java,110,24,1,20,0,45
 pulsar-master\pulsar-master\pulsar-broker\src\main\java\org\apache\pulsar\broker\service\persistent\DispatchRateLimiter.java,430,129,4,71,0,204
 pulsar-master\pulsar-master\pulsar-testclient\src\test\java\org\apache\pulsar\testclient\GenerateDocumentionTest.java,14,4,0,1,0,5
 pulsar-master\pulsar-master\pulsar-client-api\src\main\java\org\apache\pulsar\client\api\schema\SchemaReader.java,0,2,1,2,0,5
 pulsar-master\pulsar-master\pulsar-functions\java-examples\src\main\java\org\apache\pulsar\functions\api\examples\WordCountFunction.java,0,4,0,2,0,6
 pulsar-master\pulsar-master\tests\integration\src\test\java\org\apache\pulsar\tests\integration\functions\go\PulsarFunctionsGoTest.java,13,3,0,2,0,5
 pulsar-master\pulsar-master\managed-ledger\src\main\java\org\apache\bookkeeper\mledger\impl\EntryCacheImpl.java,324,103,7,58,0,168
 pulsar-master\pulsar-master\pulsar-client\src\main\java\org\apache\pulsar\client\impl\ZeroQueueConsumerImpl.java,161,58,6,24,0,88
 pulsar-master\pulsar-master\pulsar-functions\worker\src\main\java\org\apache\pulsar\functions\worker\rest\api\v3\SinksApiV3Resource.java,230,113,1,46,0,160
 pulsar-master\pulsar-master\pulsar-package-management\filesystem-storage\src\main\java\org\apache\pulsar\packages\management\storage\filesystem\FileSystemPackagesStorageProvider.java,7,3,0,2,0,5
 pulsar-master\pulsar-master\pulsar-client-admin-api\src\main\java\org\apache\pulsar\client\admin\Sources.java,0,78,0,46,0,124
 pulsar-master\pulsar-master\pulsar-functions\instance\src\main\java\org\apache\pulsar\functions\instance\ContextImpl.java,0,194,1,67,0,262
 pulsar-master\pulsar-master\managed-ledger\src\test\java\org\apache\bookkeeper\mledger\impl\ManagedLedgerInfoMetadataTest.java,90,22,2,17,0,41
 pulsar-master\pulsar-master\pulsar-broker\src\main\java\org\apache\pulsar\broker\stats\metrics\package-info.java,0,0,0,1,0,1
 pulsar-master\pulsar-master\pulsar-common\src\main\java\org\apache\pulsar\common\policies\data\SinkStatusUtil.java,8,4,1,2,0,7
 pulsar-master\pulsar-master\pulsar-broker\src\test\java\org\apache\pulsar\client\api\ClientDeduplicationTest.java,255,72,0,41,0,113
 pulsar-master\pulsar-master\pulsar-broker\src\test\java\org\apache\pulsar\client\api\v1\V1_ProducerConsumerTest.java,2280,409,89,228,0,726
 pulsar-master\pulsar-master\pulsar-sql\presto-pulsar\src\test\java\org\apache\pulsar\sql\presto\decoder\primitive\TestPrimitiveDecoder.java,181,84,0,79,0,163
 pulsar-master\pulsar-master\pulsar-broker-common\src\main\java\org\apache\pulsar\common\configuration\PropertiesContext.java,0,0,0,1,0,1
 pulsar-master\pulsar-master\pulsar-websocket\src\test\java\org\apache\pulsar\websocket\admin\WebSocketWebResourceTest.java,195,42,1,22,0,65
 pulsar-master\pulsar-master\pulsar-client\src\main\java\org\apache\pulsar\client\impl\Murmur3Hash32.java,21,9,1,2,0,12
 pulsar-master\pulsar-master\pulsar-broker\src\main\java\org\apache\pulsar\broker\admin\v2\Namespaces.java,1941,1564,140,575,0,2279
 pulsar-master\pulsar-master\pulsar-client-tools\src\main\java\org\apache\pulsar\admin\cli\utils\IOUtils.java,34,6,5,4,0,15
 pulsar-master\pulsar-master\pulsar-io\netty\src\main\java\org\apache\pulsar\io\netty\NettySource.java,49,18,2,6,0,26
 pulsar-master\pulsar-master\pulsar-client\src\main\java\org\apache\pulsar\client\impl\schema\reader\AbstractMultiVersionAvroBaseReader.java,10,9,0,3,0,12
 pulsar-master\pulsar-master\pulsar-sql\presto-pulsar\src\main\java\org\apache\pulsar\sql\presto\decoder\avro\PulsarAvroRowDecoderFactory.java,122,42,2,24,0,68
 pulsar-master\pulsar-master\pulsar-functions\instance\src\main\java\org\apache\pulsar\functions\instance\state\package-info.java,0,0,0,1,0,1
 pulsar-master\pulsar-master\pulsar-broker\src\test\java\org\apache\pulsar\client\impl\RawReaderTest.java,346,81,2,35,0,118
 pulsar-master\pulsar-master\tests\integration\src\test\java\org\apache\pulsar\tests\integration\suites\PulsarTestSuite.java,38,14,1,4,0,19
 pulsar-master\pulsar-master\pulsar-io\redis\src\test\java\org\apache\pulsar\io\redis\sink\RedisSinkTest.java,64,12,3,1,0,16
 pulsar-master\pulsar-master\pulsar-broker\src\test\java\org\apache\pulsar\client\api\TlsProducerConsumerBase.java,80,38,6,14,0,58
 pulsar-master\pulsar-master\pulsar-broker\src\main\java\org\apache\pulsar\broker\delayed\InMemoryDelayedDeliveryTrackerFactory.java,27,12,0,7,0,19
 pulsar-master\pulsar-master\pulsar-broker\src\test\java\org\apache\pulsar\websocket\proxy\ProxyAuthorizationTest.java,86,25,2,21,0,48
 pulsar-master\pulsar-master\pulsar-proxy\src\main\java\org\apache\pulsar\proxy\server\ProxyConnection.java,482,168,4,83,0,255
 pulsar-master\pulsar-master\pulsar-client-admin\src\main\java\org\apache\pulsar\client\admin\internal\ResourceGroupsImpl.java,89,43,0,13,0,56
 pulsar-master\pulsar-master\pulsar-broker\src\main\java\org\apache\pulsar\broker\transaction\buffer\impl\TopicTransactionBufferRecoverCallBack.java,0,1,0,2,0,3
 pulsar-master\pulsar-master\pulsar-broker\src\main\java\org\apache\pulsar\broker\stats\prometheus\metrics\ObserverGauge.java,0,27,2,6,0,35
 pulsar-master\pulsar-master\pulsar-client\src\test\java\org\apache\pulsar\client\util\ObjectCacheTest.java,34,6,0,2,0,8
 pulsar-master\pulsar-master\pulsar-client-admin-api\src\main\java\org\apache\pulsar\common\policies\data\TransactionMetadata.java,21,7,0,2,0,9
 pulsar-master\pulsar-master\pulsar-functions\utils\src\main\java\org\apache\pulsar\functions\utils\functioncache\FunctionCacheManager.java,0,6,0,4,0,10
 pulsar-master\pulsar-master\pulsar-common\src\test\java\org\apache\pulsar\common\util\RateLimiterTest.java,198,39,3,14,0,56
 pulsar-master\pulsar-master\pulsar-broker\src\main\java\org\apache\pulsar\broker\stats\prometheus\metrics\package-info.java,0,0,0,1,0,1
 pulsar-master\pulsar-master\pulsar-common\src\main\java\org\apache\pulsar\common\policies\data\FailureDomainImpl.java,0,11,0,2,0,13
 pulsar-master\pulsar-master\pulsar-functions\worker\src\main\java\org\apache\pulsar\functions\worker\PulsarWorkerService.java,588,163,20,92,0,275
 pulsar-master\pulsar-master\pulsar-broker\src\test\java\org\apache\pulsar\broker\service\TopicPoliciesServiceDisableTest.java,32,7,0,4,0,11
 pulsar-master\pulsar-master\pulsar-io\hdfs3\src\main\java\org\apache\pulsar\io\hdfs3\SecurityUtil.java,62,12,1,10,0,23
 pulsar-master\pulsar-master\pulsar-broker\src\test\java\org\apache\pulsar\broker\service\schema\BookkeeperSchemaStorageTest.java,37,11,0,11,0,22
 pulsar-master\pulsar-master\pulsar-broker\src\main\java\org\apache\pulsar\broker\admin\v2\SchemasResource.java,0,143,1,51,0,195
 pulsar-master\pulsar-master\pulsar-broker\src\test\java\org\apache\pulsar\broker\EmbeddedPulsarCluster.java,93,25,5,7,0,37
 pulsar-master\pulsar-master\pulsar-broker\src\main\java\org\apache\pulsar\broker\resourcegroup\ResourceUsageTopicTransportManager.java,215,65,3,35,0,103
 pulsar-master\pulsar-master\pulsar-metadata\src\main\java\org\apache\pulsar\metadata\bookkeeper\LongHierarchicalLedgerRangeIterator.java,0,43,0,15,0,58
 pulsar-master\pulsar-master\pulsar-sql\presto-pulsar\src\test\java\org\apache\pulsar\sql\presto\decoder\json\JsonDecoderTestUtil.java,160,42,3,23,0,68
 pulsar-master\pulsar-master\pulsar-client-admin-api\src\main\java\org\apache\pulsar\common\policies\data\FunctionInstanceStatsDataBase.java,0,5,0,1,0,6
 pulsar-master\pulsar-master\pulsar-broker\src\test\java\org\apache\pulsar\client\impl\TopicFromMessageTest.java,90,22,0,14,0,36
 pulsar-master\pulsar-master\pulsar-functions\utils\src\main\java\org\apache\pulsar\functions\utils\functions\FunctionUtils.java,82,25,4,14,0,43
 pulsar-master\pulsar-master\pulsar-functions\instance\src\main\java\org\apache\pulsar\functions\windowing\triggers\WatermarkCountTriggerPolicy.java,0,27,1,5,0,33
 pulsar-master\pulsar-master\pulsar-client\src\main\java\org\apache\pulsar\client\impl\UnAckedTopicMessageRedeliveryTracker.java,44,16,1,10,0,27
 pulsar-master\pulsar-master\pulsar-common\src\test\java\org\apache\pulsar\common\protocol\PulsarDecoderTest.java,26,8,0,2,0,10
 pulsar-master\pulsar-master\pulsar-metadata\src\main\java\org\apache\pulsar\metadata\cache\impl\JSONMetadataSerdeTypeRef.java,19,12,0,2,0,14
 pulsar-master\pulsar-master\pulsar-client\src\main\java\org\apache\pulsar\client\impl\schema\generic\MultiVersionGenericJsonReader.java,36,15,2,9,0,26
 pulsar-master\pulsar-master\pulsar-broker\src\test\java\org\apache\pulsar\client\impl\ProducerCloseTest.java,112,32,0,13,0,45
 pulsar-master\pulsar-master\pulsar-broker\src\test\java\org\apache\pulsar\broker\loadbalance\ModularLoadManagerImplTest.java,0,155,18,99,0,272
 pulsar-master\pulsar-master\pulsar-client\src\test\java\org\apache\pulsar\client\impl\auth\MockEncodedAuthenticationParameterSupport.java,0,9,3,3,0,15
 pulsar-master\pulsar-master\pulsar-broker\src\test\java\org\apache\pulsar\broker\loadbalance\LoadBalancerTestingUtils.java,17,9,1,8,0,18
 pulsar-master\pulsar-master\pulsar-functions\instance\src\main\java\org\apache\pulsar\functions\source\batch\BatchSourceExecutor.java,0,58,6,26,0,90
 pulsar-master\pulsar-master\pulsar-functions\java-examples\src\main\java\org\apache\pulsar\functions\api\examples\window\WordCountWindowFunction.java,0,5,0,3,0,8
 pulsar-master\pulsar-master\pulsar-broker\src\test\java\org\apache\pulsar\broker\auth\AuthLogsTest.java,0,17,13,16,0,46
 pulsar-master\pulsar-master\managed-ledger\src\main\java\org\apache\bookkeeper\mledger\LedgerOffloaderFactory.java,0,4,0,4,0,8
 pulsar-master\pulsar-master\tests\integration\src\test\java\org\apache\pulsar\tests\integration\suites\PulsarTieredStorageTestSuite.java,37,5,0,3,0,8
 pulsar-master\pulsar-master\pulsar-broker\src\main\java\org\apache\pulsar\broker\admin\v1\ResourceQuotas.java,45,40,0,13,0,53
 pulsar-master\pulsar-master\pulsar-zookeeper-utils\src\main\java\org\apache\pulsar\zookeeper\LocalBookkeeperEnsemble.java,518,221,7,48,0,276
 pulsar-master\pulsar-master\pulsar-broker\src\main\java\org\apache\pulsar\broker\loadbalance\impl\ResourceAvailabilityRanker.java,0,26,1,16,0,43
 pulsar-master\pulsar-master\tiered-storage\jcloud\src\main\java\org\apache\bookkeeper\mledger\offload\jcloud\impl\BlobStoreBackedReadHandleImpl.java,221,78,6,42,0,126
 pulsar-master\pulsar-master\pulsar-broker\src\main\java\org\apache\pulsar\broker\systopic\package-info.java,0,0,0,1,0,1
 pulsar-master\pulsar-master\pulsar-client-admin-api\src\main\java\org\apache\pulsar\common\policies\data\OffloadedReadPriority.java,0,12,0,4,0,16
 pulsar-master\pulsar-master\pulsar-functions\instance\src\main\java\org\apache\pulsar\functions\windowing\Window.java,0,7,0,8,0,15
 pulsar-master\pulsar-master\tests\integration\src\test\java\org\apache\pulsar\tests\integration\transaction\TransactionTestBase.java,67,24,2,9,0,35
 pulsar-master\pulsar-master\pulsar-functions\runtime\src\test\java\org\apache\pulsar\functions\auth\KubernetesSecretsTokenAuthProviderTest.java,153,64,0,55,0,119
 pulsar-master\pulsar-master\pulsar-client-tools\src\main\java\org\apache\pulsar\admin\cli\CmdBrokerStats.java,111,15,0,9,0,24
 pulsar-master\pulsar-master\tiered-storage\jcloud\src\main\java\org\apache\bookkeeper\mledger\offload\jcloud\OffloadIndexBlockV2Builder.java,0,13,0,7,0,20
 pulsar-master\pulsar-master\pulsar-client-api\src\main\java\org\apache\pulsar\client\api\transaction\TransactionBufferClientException.java,63,16,0,5,0,21
 pulsar-master\pulsar-master\tests\integration\src\test\java\org\apache\pulsar\tests\integration\containers\BrokerContainer.java,17,7,0,3,0,10
 pulsar-master\pulsar-master\pulsar-client\src\main\java\org\apache\pulsar\client\impl\AuthenticationUtil.java,83,19,3,12,0,34
 pulsar-master\pulsar-master\pulsar-testclient\src\main\java\org\apache\pulsar\testclient\CmdGenerateDocumentation.java,92,23,3,16,0,42
 pulsar-master\pulsar-master\pulsar-io\kinesis\src\main\java\org\apache\pulsar\io\kinesis\fbs\Message.java,0,112,14,32,0,158
 pulsar-master\pulsar-master\pulsar-functions\runtime-all\src\main\java\org\apache\pulsar\functions\instance\JavaInstanceMain.java,104,35,6,22,0,63
 pulsar-master\pulsar-master\pulsar-common\src\main\java\org\apache\pulsar\common\net\ServiceURI.java,216,42,7,16,0,65
 pulsar-master\pulsar-master\pulsar-sql\presto-pulsar\src\main\java\org\apache\pulsar\sql\presto\package-info.java,0,2,0,1,0,3
 pulsar-master\pulsar-master\pulsar-package-management\core\src\main\java\org\apache\pulsar\packages\management\core\package-info.java,0,4,0,4,0,8
 pulsar-master\pulsar-master\pulsar-broker-common\src\test\java\org\apache\pulsar\broker\authentication\AuthenticationProviderListTest.java,189,74,8,34,0,116
 pulsar-master\pulsar-master\pulsar-client-admin-api\src\main\java\org\apache\pulsar\common\policies\data\ResourceGroup.java,7,4,0,1,0,5
 pulsar-master\pulsar-master\pulsar-proxy\src\main\java\org\apache\pulsar\proxy\server\ProxyService.java,380,158,4,61,0,223
 pulsar-master\pulsar-master\pulsar-broker\src\test\java\org\apache\pulsar\broker\stats\SubscriptionStatsTest.java,98,13,0,9,0,22
 pulsar-master\pulsar-master\pulsar-package-management\filesystem-storage\src\main\java\org\apache\pulsar\packages\management\storage\filesystem\package-info.java,0,1,0,1,0,2
 pulsar-master\pulsar-master\pulsar-io\debezium\oracle\src\main\java\org\apache\pulsar\io\debezium\oracle\DebeziumOracleSource.java,9,6,0,4,0,10
 pulsar-master\pulsar-master\pulsar-broker\src\test\java\org\apache\pulsar\broker\service\PartitionKeyTest.java,48,12,0,8,0,20
 pulsar-master\pulsar-master\pulsar-broker-common\src\main\java\org\apache\pulsar\broker\resources\LoadManagerReportResources.java,7,5,0,3,0,8
 pulsar-master\pulsar-master\pulsar-common\src\main\java\org\apache\pulsar\common\util\keystoretls\SSLContextValidatorEngine.java,135,34,3,18,0,55
 pulsar-master\pulsar-master\managed-ledger\src\main\java\org\apache\bookkeeper\mledger\impl\ReadOnlyCursorImpl.java,44,20,1,8,0,29
 pulsar-master\pulsar-master\pulsar-io\kafka\src\main\java\org\apache\pulsar\io\kafka\KafkaStringSource.java,13,5,1,4,0,10
 pulsar-master\pulsar-master\pulsar-common\src\main\java\org\apache\pulsar\common\sasl\package-info.java,0,2,0,1,0,3
 pulsar-master\pulsar-master\pulsar-metadata\src\main\java\org\apache\pulsar\metadata\coordination\impl\LeaderElectionImpl.java,0,69,11,41,0,121
 pulsar-master\pulsar-master\pulsar-broker\src\main\java\org\apache\pulsar\broker\service\SendMessageInfo.java,25,8,1,3,0,12
 pulsar-master\pulsar-master\pulsar-broker\src\main\java\org\apache\pulsar\broker\service\schema\BookkeeperSchemaStorage.java,657,206,7,115,0,328
 pulsar-master\pulsar-master\pulsar-common\src\main\java\org\apache\pulsar\client\admin\internal\data\package-info.java,0,1,0,1,0,2
 pulsar-master\pulsar-master\pulsar-broker\src\test\java\org\apache\pulsar\broker\service\PersistentQueueE2ETest.java,455,86,19,54,0,159
 pulsar-master\pulsar-master\buildtools\src\main\java\org\apache\pulsar\tests\package-info.java,0,1,0,1,0,2
 pulsar-master\pulsar-master\pulsar-client-admin-api\src\main\java\org\apache\pulsar\client\admin\PulsarAdminBuilder.java,0,45,1,26,0,72
 pulsar-master\pulsar-master\pulsar-broker\src\test\java\org\apache\pulsar\broker\service\SubscriptionSeekTest.java,725,148,1,89,0,238
 pulsar-master\pulsar-master\pulsar-broker\src\main\java\org\apache\pulsar\compaction\package-info.java,0,0,0,1,0,1
 pulsar-master\pulsar-master\buildtools\src\test\java\org\apache\pulsar\tests\TestRetrySupportRetryTest.java,43,12,0,5,0,17
 pulsar-master\pulsar-master\pulsar-io\kinesis\src\main\java\org\apache\pulsar\io\kinesis\Utils.java,219,69,7,44,0,120
 pulsar-master\pulsar-master\pulsar-io\mongo\src\test\java\org\apache\pulsar\io\mongodb\MongoSourceTest.java,0,16,3,2,0,21
 pulsar-master\pulsar-master\pulsar-functions\java-examples\src\main\java\org\apache\pulsar\functions\api\examples\LoggingFunction.java,0,3,0,1,0,4
 pulsar-master\pulsar-master\pulsar-client-api\src\main\java\org\apache\pulsar\client\api\interceptor\ProducerInterceptorWrapper.java,35,22,0,5,0,27
 pulsar-master\pulsar-master\pulsar-common\src\main\java\org\apache\pulsar\common\util\NettyServerSslContextBuilder.java,50,43,2,13,0,58
 pulsar-master\pulsar-master\pulsar-common\src\main\java\org\apache\pulsar\common\util\collections\GrowableArrayBlockingQueue.java,402,79,4,8,0,91
 pulsar-master\pulsar-master\pulsar-io\flume\src\main\java\org\apache\pulsar\io\flume\node\MaterializedConfiguration.java,0,6,0,1,0,7
 pulsar-master\pulsar-master\pulsar-functions\java-examples\src\main\java\org\apache\pulsar\functions\api\examples\window\package-info.java,0,0,0,1,0,1
 pulsar-master\pulsar-master\pulsar-zookeeper-utils\src\main\java\org\apache\pulsar\stats\CacheMetricsCollector.java,7,3,0,2,0,5
 pulsar-master\pulsar-master\pulsar-common\src\main\java\org\apache\pulsar\common\api\raw\RawMessageImpl.java,187,35,2,14,0,51
 pulsar-master\pulsar-master\pulsar-client-tools\src\main\java\org\apache\pulsar\admin\cli\CmdClusters.java,375,112,3,54,0,169
 pulsar-master\pulsar-master\pulsar-proxy\src\main\java\org\apache\pulsar\proxy\server\ProxyServiceStarter.java,285,80,6,51,0,137
 pulsar-master\pulsar-master\structured-event-log\src\test\java\org\apache\pulsar\structuredeventlog\slf4j\StructuredEventLogTest.java,0,64,2,18,0,84
 pulsar-master\pulsar-master\pulsar-client\src\main\java\org\apache\pulsar\client\impl\auth\oauth2\package-info.java,0,0,0,1,0,1
 pulsar-master\pulsar-master\pulsar-functions\worker\src\main\java\org\apache\pulsar\functions\worker\rest\api\SinksImpl.java,743,247,40,224,0,511
 pulsar-master\pulsar-master\pulsar-client-admin-api\src\main\java\org\apache\pulsar\common\naming\TopicDomain.java,0,11,1,2,3,17
 pulsar-master\pulsar-master\pulsar-broker\src\main\java\org\apache\pulsar\broker\transaction\pendingack\impl\PendingAckHandleImpl.java,889,313,13,209,0,535
 pulsar-master\pulsar-master\pulsar-broker\src\main\java\org\apache\pulsar\broker\delayed\package-info.java,0,0,0,1,0,1
 pulsar-master\pulsar-master\pulsar-common\src\main\java\org\apache\pulsar\common\policies\data\stats\NonPersistentTopicStatsImpl.java,180,83,0,49,0,132
 pulsar-master\pulsar-master\pulsar-metadata\src\main\java\org\apache\pulsar\metadata\bookkeeper\PulsarRegistrationManager.java,302,98,9,60,0,167
 pulsar-master\pulsar-master\pulsar-client\src\main\java\org\apache\pulsar\client\util\package-info.java,0,1,0,1,0,2
 pulsar-master\pulsar-master\pulsar-broker\src\main\java\org\apache\pulsar\broker\admin\impl\BrokersBase.java,0,196,43,96,0,335
 pulsar-master\pulsar-master\pulsar-client-admin-api\src\main\java\org\apache\pulsar\common\io\SourceConfig.java,39,21,0,4,0,25
 pulsar-master\pulsar-master\pulsar-broker\src\test\java\org\apache\pulsar\functions\worker\PulsarFunctionPublishTest.java,487,174,12,88,0,274
 pulsar-master\pulsar-master\pulsar-client-admin\src\main\java\org\apache\pulsar\client\admin\internal\http\AsyncHttpConnectorProvider.java,27,22,0,5,0,27
 pulsar-master\pulsar-master\tiered-storage\jcloud\src\test\java\org\apache\bookkeeper\mledger\offload\jcloud\impl\OffloadIndexTest.java,209,86,10,28,0,124
 pulsar-master\pulsar-master\pulsar-io\jdbc\postgres\src\main\java\org\apache\pulsar\io\jdbc\package-info.java,0,1,0,1,0,2
 pulsar-master\pulsar-master\pulsar-broker\src\main\java\org\apache\pulsar\broker\namespace\NamespaceEphemeralData.java,36,31,0,4,0,35
 pulsar-master\pulsar-master\pulsar-io\twitter\src\main\java\org\apache\pulsar\io\twitter\package-info.java,0,1,0,1,0,2
 pulsar-master\pulsar-master\pulsar-broker\src\test\java\org\apache\pulsar\broker\web\PulsarWebResourceTest.java,0,10,0,5,0,15
 pulsar-master\pulsar-master\pulsar-sql\presto-pulsar\src\main\java\org\apache\pulsar\sql\presto\PulsarMetadata.java,345,148,14,77,0,239
 pulsar-master\pulsar-master\pulsar-functions\worker\src\main\java\org\apache\pulsar\functions\worker\FunctionWorkerStarter.java,58,8,2,3,0,13
 pulsar-master\pulsar-master\pulsar-package-management\filesystem-storage\src\test\java\org\apache\pulsar\packages\management\storage\filesystem\FileSystemPackagesStorageTest.java,142,35,0,13,0,48
 pulsar-master\pulsar-master\pulsar-broker\src\test\java\org\apache\pulsar\client\api\ProducerConsumerBase.java,40,21,0,9,0,30
 pulsar-master\pulsar-master\pulsar-broker-common\src\main\java\org\apache\pulsar\broker\authentication\metrics\package-info.java,0,1,0,1,0,2
 pulsar-master\pulsar-master\pulsar-broker\src\main\java\org\apache\pulsar\broker\stats\prometheus\metrics\LongAdderCounter.java,33,9,2,2,0,13
 pulsar-master\pulsar-master\pulsar-client\src\main\java\org\apache\pulsar\client\impl\schema\SchemaDefinitionBuilderImpl.java,125,47,2,15,0,64
 pulsar-master\pulsar-master\pulsar-broker-common\src\main\java\org\apache\pulsar\broker\authentication\AuthenticationProviderBasic.java,116,30,3,18,0,51
 pulsar-master\pulsar-master\pulsar-broker\src\test\java\org\apache\pulsar\broker\admin\v1\V1_AdminApiTest.java,1952,573,48,341,0,962
 pulsar-master\pulsar-master\pulsar-functions\worker\src\test\java\org\apache\pulsar\functions\worker\dlog\DLInputStreamTest.java,65,4,0,2,0,6
 pulsar-master\pulsar-master\pulsar-io\core\src\main\java\org\apache\pulsar\io\core\SourceContext.java,0,6,0,7,0,13
 pulsar-master\pulsar-master\pulsar-common\src\main\java\org\apache\pulsar\common\policies\data\TenantInfoImpl.java,53,16,1,4,0,21
 pulsar-master\pulsar-master\pulsar-io\flume\src\main\java\org\apache\pulsar\io\flume\node\PollingZooKeeperConfigurationProvider.java,95,19,1,4,0,24
 pulsar-master\pulsar-master\pulsar-functions\instance\src\main\java\org\apache\pulsar\functions\windowing\evictors\CountEvictionPolicy.java,0,20,0,2,0,22
 pulsar-master\pulsar-master\pulsar-sql\presto-pulsar\src\test\java\org\apache\pulsar\sql\presto\decoder\json\TestJsonDecoder.java,232,80,5,58,0,143
 pulsar-master\pulsar-master\pulsar-functions\java-examples\src\main\java\org\apache\pulsar\functions\api\examples\ContextFunction.java,0,6,0,4,0,10
 pulsar-master\pulsar-master\pulsar-websocket\src\main\java\org\apache\pulsar\websocket\stats\ProxyTopicStat.java,52,31,2,5,0,38
 pulsar-master\pulsar-master\pulsar-client\src\main\java\org\apache\pulsar\client\impl\schema\writer\AvroWriter.java,37,12,0,3,0,15
 pulsar-master\pulsar-master\pulsar-functions\runtime\src\main\java\org\apache\pulsar\functions\runtime\process\ProcessRuntime.java,0,88,10,43,0,141
 pulsar-master\pulsar-master\pulsar-broker\src\main\java\org\apache\pulsar\utils\auth\tokens\TokensCliUtils.java,302,77,8,36,0,121
 pulsar-master\pulsar-master\pulsar-sql\presto-pulsar\src\main\java\org\apache\pulsar\sql\presto\util\package-info.java,0,0,0,1,0,1
 pulsar-master\pulsar-master\tests\integration\src\test\java\org\apache\pulsar\tests\integration\cli\FileSystemPackagesCliTest.java,96,25,0,16,0,41
 pulsar-master\pulsar-master\pulsar-common\src\main\java\org\apache\pulsar\common\api\raw\package-info.java,0,2,0,1,0,3
 pulsar-master\pulsar-master\pulsar-client\src\test\java\org\apache\pulsar\client\impl\PulsarClientImplTest.java,186,45,4,27,0,76
 pulsar-master\pulsar-master\pulsar-broker\src\test\java\org\apache\pulsar\client\impl\SchemaDeleteTest.java,81,17,0,10,0,27
 pulsar-master\pulsar-master\pulsar-broker\src\test\java\org\apache\pulsar\broker\service\PrecisPublishLimiterTest.java,33,19,0,4,0,23
 pulsar-master\pulsar-master\pulsar-functions\worker\src\main\java\org\apache\pulsar\functions\worker\service\WorkerServiceMetadata.java,0,0,0,1,0,1
 pulsar-master\pulsar-master\pulsar-client-admin-api\src\main\java\org\apache\pulsar\common\policies\data\impl\AutoTopicCreationOverrideImpl.java,0,37,0,15,0,52
 pulsar-master\pulsar-master\pulsar-broker\src\main\java\org\apache\pulsar\broker\transaction\timeout\TransactionTimeoutTrackerFactoryImpl.java,21,17,0,7,0,24
 pulsar-master\pulsar-master\pulsar-client\src\main\java\org\apache\pulsar\client\impl\ProducerStatsRecorderImpl.java,313,118,29,25,0,172
 pulsar-master\pulsar-master\pulsar-client-admin\src\main\java\org\apache\pulsar\client\admin\internal\BrokerStatsImpl.java,167,49,0,15,0,64
 pulsar-master\pulsar-master\pulsar-functions\instance\src\main\java\org\apache\pulsar\functions\instance\FunctionResultRouter.java,39,15,0,6,0,21
 pulsar-master\pulsar-master\pulsar-broker\src\test\java\org\apache\pulsar\broker\service\InactiveTopicDeleteTest.java,562,185,19,123,0,327
 pulsar-master\pulsar-master\pulsar-client\src\test\java\org\apache\pulsar\client\impl\schema\ProtobufSchemaTest.java,0,73,3,40,0,116
 pulsar-master\pulsar-master\pulsar-broker\src\main\java\org\apache\pulsar\broker\tools\LoadReportCommand.java,0,16,0,5,0,21
 pulsar-master\pulsar-master\pulsar-client\src\test\java\org\apache\pulsar\client\tutorial\SampleCryptoConsumer.java,60,22,1,11,0,34
 pulsar-master\pulsar-master\pulsar-broker-auth-sasl\src\test\java\org\apache\pulsar\broker\authentication\ProxySaslAuthenticationTest.java,235,59,4,15,0,78
 pulsar-master\pulsar-master\pulsar-broker\src\main\java\org\apache\pulsar\broker\intercept\BrokerInterceptorMetadata.java,13,0,0,1,0,1
 pulsar-master\pulsar-master\pulsar-broker\src\test\java\org\apache\pulsar\broker\auth\AuthorizationTest.java,0,111,5,101,0,217
 pulsar-master\pulsar-master\pulsar-io\jdbc\clickhouse\src\main\java\org\apache\pulsar\io\jdbc\ClickHouseJdbcAutoSchemaSink.java,4,1,0,2,0,3
 pulsar-master\pulsar-master\pulsar-broker\src\test\java\org\apache\pulsar\broker\service\persistent\PersistentTopicStreamingDispatcherTest.java,9,5,0,2,0,7
 pulsar-master\pulsar-master\pulsar-broker\src\test\java\org\apache\pulsar\broker\web\WebServiceTest.java,361,101,20,54,0,175
 pulsar-master\pulsar-master\pulsar-broker\src\test\java\org\apache\pulsar\broker\intercept\BrokerInterceptorWithClassLoaderTest.java,138,92,0,54,0,146
 pulsar-master\pulsar-master\pulsar-broker\src\main\java\org\apache\pulsar\broker\admin\v1\Clusters.java,3,1,0,2,0,3
 pulsar-master\pulsar-master\tests\integration\src\test\java\org\apache\pulsar\tests\integration\messaging\ReaderMessagingTest.java,107,20,0,13,0,33
 pulsar-master\pulsar-master\pulsar-client-admin-api\src\main\java\org\apache\pulsar\common\policies\data\BrokerNamespaceIsolationData.java,0,11,0,2,0,13
 pulsar-master\pulsar-master\pulsar-broker\src\test\java\org\apache\pulsar\broker\service\ReplicatorGlobalNSTest.java,93,34,0,21,0,55
 pulsar-master\pulsar-master\pulsar-client-admin-api\src\main\java\org\apache\pulsar\common\policies\data\BookieAffinityGroupData.java,0,8,0,3,0,11
 pulsar-master\pulsar-master\pulsar-client-admin-api\src\main\java\org\apache\pulsar\client\admin\Namespaces.java,0,592,0,419,0,1011
 pulsar-master\pulsar-master\pulsar-websocket\src\test\java\org\apache\pulsar\websocket\AbstractWebSocketHandlerTest.java,0,119,4,70,0,193
 pulsar-master\pulsar-master\pulsar-broker\src\main\java\org\apache\pulsar\broker\transaction\timeout\package-info.java,0,1,0,1,0,2
 pulsar-master\pulsar-master\pulsar-sql\presto-pulsar\src\main\java\org\apache\pulsar\sql\presto\util\CacheSizeAllocator.java,0,0,0,1,0,1
 pulsar-master\pulsar-master\pulsar-client\src\test\java\org\apache\pulsar\client\impl\BuildersTest.java,90,37,1,20,0,58
 pulsar-master\pulsar-master\tests\integration\src\test\java\org\apache\pulsar\tests\integration\io\sources\debezium\DebeziumMsSqlSourceTester.java,127,40,4,14,0,58
 pulsar-master\pulsar-master\pulsar-functions\secrets\src\main\java\org\apache\pulsar\functions\secretsproviderconfigurator\package-info.java,0,0,0,1,0,1
 pulsar-master\pulsar-master\pulsar-client-api\src\main\java\org\apache\pulsar\common\schema\KeyValueEncodingType.java,0,0,0,1,0,1
 pulsar-master\pulsar-master\pulsar-client-admin\src\main\java\org\apache\pulsar\client\admin\internal\JacksonConfigurator.java,29,7,0,4,0,11
 pulsar-master\pulsar-master\pulsar-io\flume\src\main\java\org\apache\pulsar\io\flume\node\ConfigurationProvider.java,0,1,0,1,0,2
 pulsar-master\pulsar-master\pulsar-broker-common\src\main\java\org\apache\pulsar\broker\resources\MetadataStoreCacheLoader.java,105,37,1,18,0,56
 pulsar-master\pulsar-master\pulsar-client-api\src\main\java\org\apache\pulsar\client\api\schema\SchemaDefinitionBuilder.java,0,8,0,8,0,16
 pulsar-master\pulsar-master\pulsar-transaction\coordinator\src\main\java\org\apache\pulsar\transaction\coordinator\exceptions\package-info.java,0,2,0,1,0,3
 pulsar-master\pulsar-master\pulsar-broker\src\test\java\org\apache\pulsar\broker\service\PersistentTopicTest.java,0,608,54,419,0,1081
 pulsar-master\pulsar-master\pulsar-broker\src\main\java\org\apache\pulsar\broker\stats\DimensionStats.java,123,68,2,11,0,81
 pulsar-master\pulsar-master\pulsar-io\elastic-search\src\main\java\org\apache\pulsar\io\elasticsearch\client\RestClientFactory.java,74,24,8,18,0,50
 pulsar-master\pulsar-master\pulsar-client-admin-api\src\main\java\org\apache\pulsar\client\admin\Sinks.java,0,78,0,46,0,124
 pulsar-master\pulsar-master\pulsar-functions\worker\src\main\java\org\apache\pulsar\functions\worker\rest\WorkerServer.java,161,68,4,35,0,107
 pulsar-master\pulsar-master\pulsar-client\src\main\java\org\apache\pulsar\client\impl\auth\oauth2\protocol\TokenResult.java,16,4,0,1,0,5
 pulsar-master\pulsar-master\tests\integration\src\test\java\org\apache\pulsar\tests\integration\topologies\PulsarTestBase.java,157,42,0,14,0,56
 pulsar-master\pulsar-master\tests\integration\src\test\java\org\apache\pulsar\tests\integration\io\sources\AvroKafkaSourceTest.java,433,158,23,55,0,236
 pulsar-master\pulsar-master\pulsar-client\src\test\java\org\apache\pulsar\client\impl\schema\SchemaBuilderTest.java,479,170,5,93,0,268
 pulsar-master\pulsar-master\pulsar-io\influxdb\src\main\java\org\apache\pulsar\io\influxdb\v1\InfluxDBAbstractSink.java,0,16,3,4,0,23
 pulsar-master\pulsar-master\pulsar-io\debezium\mssql\src\main\java\org\apache\pulsar\io\debezium\mssql\DebeziumMsSqlSource.java,9,6,0,4,0,10
 pulsar-master\pulsar-master\pulsar-broker-common\src\main\java\org\apache\pulsar\broker\authentication\metrics\AuthenticationMetrics.java,32,12,1,3,0,16
 pulsar-master\pulsar-master\pulsar-metadata\src\test\java\org\apache\pulsar\metadata\MetadataBenchmark.java,120,38,9,10,0,57
 pulsar-master\pulsar-master\pulsar-functions\java-examples\src\main\java\org\apache\pulsar\functions\api\examples\CursorManagementFunction.java,0,5,0,2,0,7
 pulsar-master\pulsar-master\pulsar-broker\src\test\java\org\apache\pulsar\client\api\PartitionCreationTest.java,116,61,2,27,0,90
 pulsar-master\pulsar-master\pulsar-package-management\bookkeeper-storage\src\main\java\org\apache\pulsar\packages\management\storage\bookkeeper\package-info.java,0,1,0,1,0,2
 pulsar-master\pulsar-master\pulsar-client\src\main\java\org\apache\pulsar\client\impl\JavaStringHash.java,21,7,1,1,0,9
 pulsar-master\pulsar-master\pulsar-io\kafka-connect-adaptor\src\main\java\org\apache\pulsar\io\kafka\connect\PulsarKafkaSinkContext.java,13,3,0,1,0,4
 pulsar-master\pulsar-master\pulsar-client\src\main\java\org\apache\pulsar\client\impl\transaction\TransactionBufferHandler.java,0,6,0,5,0,11
 pulsar-master\pulsar-master\pulsar-client\src\main\java\org\apache\pulsar\client\impl\MultiMessageIdImpl.java,80,16,0,7,0,23
 pulsar-master\pulsar-master\pulsar-common\src\main\java\org\apache\pulsar\common\nar\NarClassLoader.java,160,57,3,47,0,107
 pulsar-master\pulsar-master\pulsar-client-admin\src\main\java\org\apache\pulsar\client\admin\internal\TopicsImpl.java,2889,1435,5,484,0,1924
 pulsar-master\pulsar-master\tests\integration\src\test\java\org\apache\pulsar\tests\integration\io\RabbitMQSinkTester.java,69,21,4,6,0,31
 pulsar-master\pulsar-master\structured-event-log\src\main\java\org\apache\pulsar\structuredeventlog\StructuredEventLog.java,0,11,0,8,0,19
 pulsar-master\pulsar-master\managed-ledger\src\main\java\org\apache\bookkeeper\mledger\impl\ManagedCursorMXBeanImpl.java,93,27,0,2,0,29
 pulsar-master\pulsar-master\pulsar-functions\proto\src\test\java\org\apache\pulsar\functions\proto\FunctionDetailsTest.java,13,2,0,2,0,4
 pulsar-master\pulsar-master\tiered-storage\jcloud\src\main\java\org\apache\bookkeeper\mledger\offload\jcloud\impl\DataBlockHeaderImpl.java,0,34,1,10,0,45
 pulsar-master\pulsar-master\pulsar-package-management\core\src\main\java\org\apache\pulsar\packages\management\core\common\PackageMetadataUtil.java,18,8,1,5,0,14
 pulsar-master\pulsar-master\pulsar-io\rabbitmq\src\test\java\org\apache\pulsar\io\rabbitmq\sink\RabbitMQSinkTest.java,75,14,4,4,0,22
 pulsar-master\pulsar-master\pulsar-broker\src\test\java\org\apache\pulsar\broker\admin\v3\AsyncResponseTest.java,22,7,0,2,0,9
 pulsar-master\pulsar-master\pulsar-broker\src\test\java\org\apache\pulsar\broker\protocol\ProtocolHandlersTest.java,123,35,9,6,0,50
 pulsar-master\pulsar-master\pulsar-client\src\test\java\org\apache\pulsar\client\impl\BatchMessageContainerImplTest.java,35,10,0,10,0,20
 pulsar-master\pulsar-master\tests\integration\src\test\java\org\apache\pulsar\tests\integration\backwardscompatibility\PulsarStandaloneTestSuite2_5.java,6,3,1,2,0,6
 pulsar-master\pulsar-master\buildtools\src\test\java\org\apache\pulsar\tests\ThreadLocalStateCleanerTest.java,75,31,0,7,0,38
 pulsar-master\pulsar-master\pulsar-broker\src\main\java\org\apache\pulsar\broker\admin\impl\package-info.java,0,0,0,1,0,1
 pulsar-master\pulsar-master\pulsar-client\src\main\java\org\apache\pulsar\client\impl\RoundRobinPartitionMessageRouterImpl.java,54,37,1,10,0,48
 pulsar-master\pulsar-master\tests\integration\src\test\java\org\apache\pulsar\tests\integration\suites\PulsarStandaloneTestSuite.java,35,8,0,2,0,10
 pulsar-master\pulsar-master\pulsar-package-management\bookkeeper-storage\src\test\java\org\apache\pulsar\packages\management\storage\bookkeeper\bookkeeper\test\PortManager.java,90,23,2,8,0,33
 pulsar-master\pulsar-master\pulsar-functions\instance\src\main\java\org\apache\pulsar\functions\instance\state\PulsarMetadataStateStoreProviderImpl.java,41,22,0,8,0,30
 pulsar-master\pulsar-master\pulsar-broker-auth-sasl\src\main\java\org\apache\pulsar\broker\authentication\AuthenticationProviderSasl.java,228,66,7,49,0,122
 pulsar-master\pulsar-master\pulsar-io\file\src\main\java\org\apache\pulsar\io\file\FileSource.java,35,15,0,7,0,22
 pulsar-master\pulsar-master\pulsar-broker\src\main\java\org\apache\pulsar\broker\loadbalance\impl\LeastLongTermMessageRate.java,100,25,4,23,0,52
 pulsar-master\pulsar-master\pulsar-functions\worker\src\main\java\org\apache\pulsar\functions\worker\WorkerStatsManager.java,312,163,9,33,0,205
 pulsar-master\pulsar-master\pulsar-common\src\test\java\org\apache\pulsar\common\policies\data\NamespaceIsolationDataTest.java,84,3,1,1,0,5
 pulsar-master\pulsar-master\pulsar-broker\src\test\java\org\apache\pulsar\client\api\ProducerCleanupTest.java,28,7,0,4,0,11
 pulsar-master\pulsar-master\pulsar-broker\src\test\java\org\apache\pulsar\broker\admin\AdminTopicApiTest.java,61,19,0,10,0,29
 pulsar-master\pulsar-master\managed-ledger\src\test\java\org\apache\bookkeeper\mledger\SimpleBookKeeperTest.java,35,11,1,4,0,16
 pulsar-master\pulsar-master\pulsar-sql\presto-pulsar\src\main\java\org\apache\pulsar\sql\presto\decoder\protobufnative\PulsarProtobufNativeRowDecoderFactory.java,117,33,1,19,0,53
 pulsar-master\pulsar-master\pulsar-common\src\main\java\org\apache\pulsar\common\events\TopicPoliciesEvent.java,9,5,0,1,0,6
 pulsar-master\pulsar-master\pulsar-metadata\src\test\java\org\apache\pulsar\metadata\ZKSessionTest.java,141,45,0,15,0,60
 pulsar-master\pulsar-master\pulsar-websocket\src\main\java\org\apache\pulsar\websocket\data\ConsumerCommand.java,6,6,0,1,0,7
 pulsar-master\pulsar-master\pulsar-common\src\main\java\org\apache\pulsar\common\policies\impl\NamespaceIsolationPolicies.java,142,37,0,14,0,51
 pulsar-master\pulsar-master\pulsar-io\kafka-connect-adaptor\src\main\java\org\apache\pulsar\io\kafka\connect\PulsarKafkaWorkerConfig.java,34,8,0,4,0,12
 pulsar-master\pulsar-master\tests\integration\src\test\java\org\apache\pulsar\tests\integration\io\RabbitMQSourceTester.java,61,15,3,7,0,25
 pulsar-master\pulsar-master\pulsar-client-api\src\main\java\org\apache\pulsar\client\api\transaction\TransactionCoordinatorClient.java,0,10,0,6,0,16
 pulsar-master\pulsar-master\tests\pulsar-client-shade-test\src\test\java\org\apache\pulsar\tests\integration\SimpleProducerConsumerTest.java,532,180,10,112,0,302
 pulsar-master\pulsar-master\pulsar-client\src\main\java\org\apache\pulsar\client\impl\schema\DateSchema.java,53,10,1,1,0,12
 pulsar-master\pulsar-master\pulsar-functions\worker\src\test\java\org\apache\pulsar\functions\worker\executor\MockClock.java,38,11,0,1,0,12
 pulsar-master\pulsar-master\pulsar-broker-common\src\main\java\org\apache\pulsar\broker\validator\MultipleListenerValidator.java,0,27,3,24,0,54
 pulsar-master\pulsar-master\pulsar-broker\src\main\java\org\apache\pulsar\broker\cache\package-info.java,0,0,0,1,0,1
 pulsar-master\pulsar-master\pulsar-broker\src\test\java\org\apache\pulsar\client\impl\PatternTopicsConsumerImplAuthTest.java,415,206,11,73,0,290
 pulsar-master\pulsar-master\pulsar-broker\src\test\java\org\apache\pulsar\socks5\config\Socks5Config.java,8,3,0,1,0,4
 pulsar-master\pulsar-master\managed-ledger\src\main\java\org\apache\bookkeeper\mledger\Entry.java,0,3,0,2,0,5
 pulsar-master\pulsar-master\testmocks\src\main\java\org\apache\zookeeper\package-info.java,0,0,0,1,0,1
 pulsar-master\pulsar-master\pulsar-broker\src\test\java\org\apache\pulsar\broker\transaction\buffer\TransactionEntryImplTest.java,20,5,0,1,0,6
 pulsar-master\pulsar-master\pulsar-client-api\src\main\java\org\apache\pulsar\client\api\ReaderBuilder.java,0,43,1,38,0,82
 pulsar-master\pulsar-master\pulsar-client-tools\src\main\java\org\apache\pulsar\admin\cli\CmdPackages.java,0,41,0,22,0,63
 pulsar-master\pulsar-master\pulsar-io\elastic-search\src\main\java\org\apache\pulsar\io\elasticsearch\ElasticSearchConfig.java,303,103,4,51,0,158
 pulsar-master\pulsar-master\pulsar-broker-common\src\main\java\org\apache\pulsar\broker\authentication\utils\AuthTokenUtils.java,86,29,2,10,0,41
 pulsar-master\pulsar-master\pulsar-client\src\main\java\org\apache\pulsar\client\impl\schema\ShortSchema.java,78,21,1,3,0,25
 pulsar-master\pulsar-master\tests\bc_2_6_0\src\test\java\org\apache\pulsar\tests\integration\SmokeTest.java,50,6,0,1,0,7
 pulsar-master\pulsar-master\pulsar-io\kinesis\src\main\java\org\apache\pulsar\io\kinesis\KinesisSource.java,89,31,6,19,0,56
 pulsar-master\pulsar-master\pulsar-client\src\main\java\org\apache\pulsar\client\impl\schema\writer\JacksonJsonWriter.java,18,6,0,1,0,7
 pulsar-master\pulsar-master\pulsar-client-tools\src\main\java\org\apache\pulsar\admin\cli\CmdTransactions.java,164,58,1,37,0,96
 pulsar-master\pulsar-master\pulsar-broker\src\main\java\org\apache\pulsar\broker\service\PublishRateLimiterImpl.java,93,37,6,6,0,49
 pulsar-master\pulsar-master\pulsar-common\src\main\java\org\apache\pulsar\common\util\package-info.java,0,2,0,1,0,3
 pulsar-master\pulsar-master\pulsar-broker\src\main\java\org\apache\pulsar\broker\loadbalance\impl\PulsarResourceDescription.java,87,22,1,7,0,30
 pulsar-master\pulsar-master\pulsar-io\file\src\test\java\org\apache\pulsar\io\file\FileListingThreadTests.java,251,74,0,16,0,90
 pulsar-master\pulsar-master\pulsar-broker\src\main\java\org\apache\pulsar\common\naming\TopicCountEquallyDivideBundleSplitAlgorithm.java,23,8,1,7,0,16
 pulsar-master\pulsar-master\pulsar-io\kinesis\src\main\java\org\apache\pulsar\io\kinesis\KinesisSourceConfig.java,149,50,0,24,0,74
 pulsar-master\pulsar-master\pulsar-broker\src\main\java\org\apache\pulsar\compaction\Compactor.java,0,35,0,6,0,41
 pulsar-master\pulsar-master\managed-ledger\src\test\java\org\apache\bookkeeper\mledger\impl\OffloadLedgerDeleteTest.java,360,107,3,46,0,156
 pulsar-master\pulsar-master\pulsar-client\src\main\java\org\apache\pulsar\client\impl\conf\ClientConfigurationData.java,0,102,1,26,0,129
 pulsar-master\pulsar-master\pulsar-metadata\src\main\java\org\apache\pulsar\metadata\impl\batching\package-info.java,0,0,0,1,0,1
 pulsar-master\pulsar-master\managed-ledger\src\main\java\org\apache\bookkeeper\mledger\impl\PositionImplRecyclable.java,27,12,1,4,0,17
 pulsar-master\pulsar-master\pulsar-functions\runtime\src\test\java\org\apache\pulsar\functions\config\TestWorkerConfig.java,89,24,1,13,0,38
 pulsar-master\pulsar-master\pulsar-client\src\test\java\org\apache\pulsar\client\impl\auth\oauth2\protocol\TokenClientTest.java,65,24,0,20,0,44
 pulsar-master\pulsar-master\pulsar-client-admin\src\main\java\org\apache\pulsar\client\admin\internal\WebTargets.java,0,7,2,3,0,12
 pulsar-master\pulsar-master\pulsar-client\src\test\java\org\apache\pulsar\client\impl\schema\BooleanSchemaTest.java,54,6,6,3,0,15
 pulsar-master\pulsar-master\pulsar-client-1x-base\pulsar-client-1x\src\main\java\org\apache\pulsar\client\api\ProducerConfiguration.java,437,117,2,60,0,179
 pulsar-master\pulsar-master\pulsar-io\hdfs3\src\test\java\org\apache\pulsar\io\hdfs3\sink\seq\HdfsTextSinkTests.java,0,36,1,1,0,38
 pulsar-master\pulsar-master\pulsar-package-management\bookkeeper-storage\src\test\java\org\apache\pulsar\packages\management\storage\bookkeeper\DLInputStreamTest.java,99,17,1,7,0,25
 pulsar-master\pulsar-master\pulsar-broker-common\src\main\java\org\apache\pulsar\broker\authentication\OneStageAuthenticationState.java,41,17,0,3,0,20
 pulsar-master\pulsar-master\pulsar-common\src\test\java\org\apache\pulsar\common\util\collections\TripleLongPriorityQueueTest.java,112,37,5,1,0,43
 pulsar-master\pulsar-master\pulsar-proxy\src\main\java\org\apache\pulsar\proxy\server\AdminProxyHandler.java,0,71,2,32,0,105
 pulsar-master\pulsar-master\pulsar-client\src\main\java\org\apache\pulsar\client\impl\BinaryProtoLookupService.java,323,140,5,65,0,210
 pulsar-master\pulsar-master\pulsar-broker\src\test\java\org\apache\pulsar\PulsarClusterMetadataSetupTest.java,35,4,1,4,0,9
 pulsar-master\pulsar-master\pulsar-broker\src\main\java\org\apache\pulsar\broker\web\RequestWrapper.java,45,11,1,4,0,16
 pulsar-master\pulsar-master\pulsar-io\kafka\src\test\java\org\apache\pulsar\io\kafka\source\KafkaAbstractSourceTest.java,95,22,1,8,0,31
 pulsar-master\pulsar-master\pulsar-io\flume\src\main\java\org\apache\pulsar\io\flume\node\Application.java,196,48,13,20,0,81
 pulsar-master\pulsar-master\pulsar-functions\runtime\src\main\java\org\apache\pulsar\functions\runtime\package-info.java,0,2,0,1,0,3
 pulsar-master\pulsar-master\pulsar-broker\src\test\java\org\apache\pulsar\client\impl\MessageChecksumTest.java,196,56,3,41,0,100
 pulsar-master\pulsar-master\pulsar-broker\src\main\java\org\apache\pulsar\broker\web\WebService.java,242,72,6,32,0,110
 pulsar-master\pulsar-master\pulsar-client-admin-api\src\main\java\org\apache\pulsar\common\stats\AllocatorStats.java,62,66,0,1,0,67
 pulsar-master\pulsar-master\pulsar-common\src\main\java\org\apache\pulsar\client\api\url\URL.java,39,17,0,5,0,22
 pulsar-master\pulsar-master\pulsar-client-admin-api\src\main\java\org\apache\pulsar\common\policies\data\InactiveTopicDeleteMode.java,0,1,0,2,0,3
 pulsar-master\pulsar-master\managed-ledger\src\main\java\org\apache\bookkeeper\mledger\ReadOnlyCursor.java,0,8,0,9,0,17
 pulsar-master\pulsar-master\pulsar-functions\api-java\src\main\java\org\apache\pulsar\functions\api\Record.java,0,6,2,2,0,10
 pulsar-master\pulsar-master\pulsar-broker\src\test\java\org\apache\pulsar\client\api\ConsumerBatchReceiveTest.java,571,281,9,72,0,362
 pulsar-master\pulsar-master\pulsar-client\src\main\java\org\apache\pulsar\client\impl\schema\generic\GenericJsonReader.java,58,39,0,4,0,43
 pulsar-master\pulsar-master\pulsar-broker\src\main\java\org\apache\pulsar\broker\loadbalance\impl\PulsarServiceRequest.java,93,70,0,1,0,71
 pulsar-master\pulsar-master\pulsar-broker\src\main\java\org\apache\pulsar\broker\service\BacklogQuotaManager.java,220,78,10,55,0,143
 pulsar-master\pulsar-master\pulsar-common\src\main\java\org\apache\pulsar\policies\data\loadbalancer\BrokerUsage.java,44,20,0,6,0,26
 pulsar-master\pulsar-master\pulsar-common\src\test\java\org\apache\pulsar\common\compression\CompressionCodecSnappyJNI.java,35,12,1,7,0,20
 pulsar-master\pulsar-master\pulsar-broker-common\src\main\java\org\apache\pulsar\broker\validator\BindAddressValidator.java,64,18,1,12,0,31
 pulsar-master\pulsar-master\pulsar-client-tools\src\main\java\org\apache\pulsar\admin\cli\CmdNamespaceIsolationPolicy.java,222,62,0,42,0,104
 pulsar-master\pulsar-master\pulsar-io\kafka\src\test\java\org\apache\pulsar\io\kafka\ByteBufferSchemaWrapperTest.java,49,15,0,1,0,16
 pulsar-master\pulsar-master\pulsar-broker\src\main\java\org\apache\pulsar\broker\transaction\pendingack\impl\PendingAckHandleDisabled.java,67,35,1,12,0,48
 pulsar-master\pulsar-master\pulsar-client-auth-athenz\src\main\java\org\apache\pulsar\client\impl\auth\AuthenticationDataAthenz.java,38,13,0,1,0,14
 pulsar-master\pulsar-master\pulsar-broker\src\test\java\org\apache\pulsar\broker\service\ConsistentHashingStickyKeyConsumerSelectorTest.java,139,111,2,14,0,127
 pulsar-master\pulsar-master\managed-ledger\src\main\java\org\apache\bookkeeper\mledger\util\StatsBuckets.java,101,31,0,3,0,34
 pulsar-master\pulsar-master\pulsar-client-admin-api\src\main\java\org\apache\pulsar\common\policies\data\ReplicatorStats.java,0,15,0,4,0,19
 pulsar-master\pulsar-master\pulsar-broker\src\main\java\org\apache\pulsar\broker\service\plugin\FilterContext.java,12,6,0,2,0,8
 pulsar-master\pulsar-master\pulsar-broker\src\test\java\org\apache\pulsar\broker\service\schema\validator\SchemaRegistryServiceWithSchemaDataValidatorTest.java,118,26,0,15,0,41
 pulsar-master\pulsar-master\pulsar-io\hbase\src\test\java\org\apache\pulsar\io\hbase\TableUtils.java,19,12,2,8,0,22
 pulsar-master\pulsar-master\pulsar-client-tools\src\main\java\org\apache\pulsar\admin\cli\CmdBase.java,84,18,1,4,0,23
 pulsar-master\pulsar-master\pulsar-functions\java-examples\src\main\java\org\apache\pulsar\functions\api\examples\UserExceptionFunction.java,0,3,0,1,0,4
 pulsar-master\pulsar-master\pulsar-common\src\main\java\org\apache\pulsar\common\sasl\JAASCredentialsContainer.java,67,29,0,8,0,37
 pulsar-master\pulsar-master\pulsar-io\data-generator\src\main\java\org\apache\pulsar\io\datagenerator\DataGeneratorPrintSink.java,19,5,3,2,0,10
 pulsar-master\pulsar-master\pulsar-proxy\src\main\java\org\apache\pulsar\proxy\util\CmdGenerateDocumentation.java,17,6,0,3,0,9
 pulsar-master\pulsar-master\pulsar-io\flume\src\main\java\org\apache\pulsar\io\flume\source\package-info.java,0,1,0,1,0,2
 pulsar-master\pulsar-master\pulsar-common\src\test\java\org\apache\pulsar\common\util\RelativeTimeUtilTest.java,37,27,2,11,0,40
 pulsar-master\pulsar-master\tests\integration\src\test\java\org\apache\pulsar\tests\integration\backwardscompatibility\SmokeTest2_2.java,13,9,1,3,0,13
 pulsar-master\pulsar-master\tests\integration\src\test\java\org\apache\pulsar\tests\integration\io\PulsarGenericObjectSinkTest.java,0,81,4,38,0,123
 pulsar-master\pulsar-master\pulsar-functions\runtime\src\test\java\org\apache\pulsar\functions\worker\WorkerApiV2ResourceConfigTest.java,89,54,3,29,0,86
 pulsar-master\pulsar-master\pulsar-client\src\main\java\org\apache\pulsar\client\impl\ConsumerStatsRecorderImpl.java,292,86,10,20,0,116
 pulsar-master\pulsar-master\pulsar-functions\instance\src\main\java\org\apache\pulsar\functions\windowing\package-info.java,0,0,0,1,0,1
 pulsar-master\pulsar-master\pulsar-client\src\main\java\org\apache\pulsar\client\impl\schema\AutoProduceBytesSchema.java,85,27,4,5,0,36
 pulsar-master\pulsar-master\pulsar-io\file\src\test\java\org\apache\pulsar\io\file\utils\GZipFilesTests.java,39,17,0,5,0,22
 pulsar-master\pulsar-master\pulsar-broker\src\test\java\org\apache\pulsar\broker\resourcegroup\ResourceGroupRateLimiterTest.java,117,39,8,12,0,59
 pulsar-master\pulsar-master\tiered-storage\jcloud\src\test\java\org\apache\bookkeeper\mledger\offload\jcloud\impl\DataBlockUtilsTest.java,40,10,0,7,0,17
 pulsar-master\pulsar-master\pulsar-functions\instance\src\main\java\org\apache\pulsar\functions\instance\AuthenticationConfig.java,9,6,0,1,0,7
 pulsar-master\pulsar-master\pulsar-io\rabbitmq\src\main\java\org\apache\pulsar\io\rabbitmq\RabbitMQSourceConfig.java,46,18,0,10,0,28
 pulsar-master\pulsar-master\pulsar-broker\src\test\java\org\apache\pulsar\broker\admin\AdminApiTest.java,3181,987,96,609,0,1692
 pulsar-master\pulsar-master\pulsar-io\hdfs3\src\main\java\org\apache\pulsar\io\hdfs3\sink\seq\HdfsAbstractSequenceFileSink.java,0,17,4,4,0,25
 pulsar-master\pulsar-master\pulsar-functions\worker\src\main\java\org\apache\pulsar\functions\worker\ErrorNotifierImpl.java,34,9,3,1,0,13
 pulsar-master\pulsar-master\pulsar-broker\src\main\java\org\apache\pulsar\broker\service\PrecisPublishLimiter.java,137,57,6,20,0,83
 pulsar-master\pulsar-master\pulsar-sql\presto-distribution\src\main\java\org\openjdk\jol\info\package-info.java,0,1,0,1,0,2
 pulsar-master\pulsar-master\pulsar-io\hdfs2\src\test\java\org\apache\pulsar\io\hdfs2\sink\AbstractHdfsSinkTest.java,0,56,2,7,0,65
 pulsar-master\pulsar-master\pulsar-broker\src\test\java\org\apache\pulsar\broker\service\BrokerEntryMetadataE2ETest.java,356,64,5,38,0,107
 pulsar-master\pulsar-master\pulsar-functions\instance\src\main\java\org\apache\pulsar\functions\windowing\triggers\WatermarkTimeTriggerPolicy.java,0,37,1,11,0,49
 pulsar-master\pulsar-master\pulsar-client-admin-api\src\main\java\org\apache\pulsar\common\policies\data\SchemaCompatibilityStrategy.java,0,8,0,5,0,13
 pulsar-master\pulsar-master\pulsar-client\src\main\java\org\apache\pulsar\client\util\SecretsSerializer.java,15,2,0,2,0,4
 pulsar-master\pulsar-master\pulsar-package-management\core\src\main\java\org\apache\pulsar\packages\management\core\PackagesStorageProvider.java,0,3,0,3,0,6
 pulsar-master\pulsar-master\tests\integration\src\test\java\org\apache\pulsar\tests\integration\presto\StockProtoMessage.java,0,254,109,45,0,408
 pulsar-master\pulsar-master\pulsar-broker\src\main\java\org\apache\pulsar\broker\transaction\buffer\impl\TransactionBufferClientImpl.java,57,40,1,15,0,56
 pulsar-master\pulsar-master\pulsar-client\src\main\java\org\apache\pulsar\client\impl\DefaultCryptoKeyReader.java,79,23,1,10,0,34
 pulsar-master\pulsar-master\pulsar-broker\src\main\java\org\apache\pulsar\broker\systopic\NamespaceEventsSystemTopicFactory.java,39,28,2,13,0,43
 pulsar-master\pulsar-master\pulsar-functions\java-examples\src\main\java\org\apache\pulsar\functions\api\examples\window\UserExceptionWindowFunction.java,0,5,0,3,0,8
 pulsar-master\pulsar-master\pulsar-broker\src\test\java\org\apache\pulsar\broker\admin\ResourceGroupsTest.java,140,34,11,11,0,56
 pulsar-master\pulsar-master\pulsar-broker\src\test\java\org\apache\pulsar\client\impl\MessageIdTest.java,134,32,0,21,0,53
 pulsar-master\pulsar-master\pulsar-client\src\main\java\org\apache\pulsar\client\impl\PartitionedProducerImpl.java,448,125,7,76,0,208
 pulsar-master\pulsar-master\pulsar-proxy\src\test\java\org\apache\pulsar\proxy\server\ProxyWithAuthorizationNegTest.java,196,70,13,39,0,122
 pulsar-master\pulsar-master\pulsar-client-tools-test\src\test\java\org\apache\pulsar\admin\cli\utils\IOUtilsTest.java,114,18,3,4,0,25
 pulsar-master\pulsar-master\pulsar-broker\src\test\java\org\apache\pulsar\broker\auth\PortForwarder.java,155,43,1,14,0,58
 pulsar-master\pulsar-master\pulsar-common\src\main\java\org\apache\pulsar\common\policies\data\SourceStatusUtil.java,8,4,1,2,0,7
 pulsar-master\pulsar-master\pulsar-client-admin-api\src\main\java\org\apache\pulsar\packages\management\core\exceptions\package-info.java,0,1,0,1,0,2
 pulsar-master\pulsar-master\pulsar-common\src\test\java\org\apache\pulsar\common\policies\impl\AutoFailoverPolicyFactoryTest.java,29,3,1,2,0,6
 pulsar-master\pulsar-master\managed-ledger\src\main\java\org\apache\bookkeeper\mledger\impl\ManagedCursorImpl.java,3016,1002,88,553,0,1643
 pulsar-master\pulsar-master\pulsar-functions\java-examples\src\main\java\org\apache\pulsar\functions\api\examples\AutoSchemaFunction.java,0,3,0,1,0,4
 pulsar-master\pulsar-master\pulsar-sql\presto-distribution\src\main\java\org\openjdk\jol\info\ClassLayout.java,26,12,2,2,0,16
 pulsar-master\pulsar-master\pulsar-io\dynamodb\src\test\java\org\apache\pulsar\io\dynamodb\DynamoDBSourceConfigTests.java,111,51,0,17,0,68
 pulsar-master\pulsar-master\pulsar-client-api\src\main\java\org\apache\pulsar\client\api\MessagePayloadFactory.java,0,2,0,2,0,4
 pulsar-master\pulsar-master\tests\integration\src\test\java\org\apache\pulsar\tests\integration\io\sources\KafkaSourceTester.java,103,23,1,8,0,32
 pulsar-master\pulsar-master\pulsar-io\elastic-search\src\test\java\org\apache\pulsar\io\elasticsearch\JsonConverterTests.java,106,70,3,31,0,104
 pulsar-master\pulsar-master\pulsar-broker\src\main\java\org\apache\pulsar\broker\transaction\exception\package-info.java,0,1,0,1,0,2
 pulsar-master\pulsar-master\pulsar-metadata\src\main\java\org\apache\pulsar\metadata\bookkeeper\PulsarLedgerManagerFactory.java,107,37,2,17,0,56
 pulsar-master\pulsar-master\pulsar-broker\src\test\java\org\apache\pulsar\broker\resourcegroup\ResourceQuotaCalculatorImplTest.java,87,31,0,14,0,45
 pulsar-master\pulsar-master\pulsar-functions\instance\src\main\java\org\apache\pulsar\functions\windowing\WindowLifecycleListener.java,0,3,0,4,0,7
 pulsar-master\pulsar-master\pulsar-io\file\src\test\java\org\apache\pulsar\io\file\utils\ZipFilesTests.java,39,16,0,5,0,21
 pulsar-master\pulsar-master\pulsar-broker\src\test\java\org\apache\pulsar\socks5\auth\DefaultPasswordAuthImpl.java,12,7,0,2,0,9
 pulsar-master\pulsar-master\pulsar-websocket\src\main\java\org\apache\pulsar\websocket\WebSocketProducerServlet.java,23,11,0,4,0,15
 pulsar-master\pulsar-master\pulsar-sql\presto-pulsar\src\main\java\org\apache\pulsar\sql\presto\PulsarRowDecoder.java,0,2,0,2,0,4
 pulsar-master\pulsar-master\pulsar-io\hdfs3\src\main\java\org\apache\pulsar\io\hdfs3\sink\HdfsSinkConfig.java,62,16,1,12,0,29
 pulsar-master\pulsar-master\pulsar-broker-common\src\main\java\org\apache\pulsar\broker\package-info.java,0,1,0,1,0,2
 pulsar-master\pulsar-master\pulsar-sql\presto-pulsar\src\test\java\org\apache\pulsar\sql\presto\decoder\avro\TestAvroDecoder.java,238,83,4,63,0,150
 pulsar-master\pulsar-master\pulsar-common\src\main\java\org\apache\pulsar\common\util\collections\ConcurrentBitSet.java,142,20,0,2,0,22
 pulsar-master\pulsar-master\pulsar-io\jdbc\core\src\main\java\org\apache\pulsar\io\jdbc\JdbcAbstractSink.java,195,42,4,16,0,62
 pulsar-master\pulsar-master\pulsar-io\hdfs3\src\main\java\org\apache\pulsar\io\hdfs3\sink\text\HdfsAbstractTextFileSink.java,0,11,1,4,0,16
 pulsar-master\pulsar-master\pulsar-client-api\src\main\java\org\apache\pulsar\client\api\schema\GenericRecordBuilder.java,0,0,0,1,0,1
 pulsar-master\pulsar-master\pulsar-io\aerospike\src\main\java\org\apache\pulsar\io\aerospike\AerospikeStringSink.java,0,5,0,3,0,8
 pulsar-master\pulsar-master\pulsar-broker\src\test\java\org\apache\pulsar\functions\worker\PulsarFunctionTestUtils.java,77,20,3,11,0,34
 pulsar-master\pulsar-master\pulsar-broker\src\test\java\org\apache\pulsar\broker\intercept\BrokerInterceptorTest.java,181,66,4,22,0,92
 pulsar-master\pulsar-master\pulsar-functions\instance\src\test\java\org\apache\pulsar\functions\source\batch\BatchSourceExecutorTest.java,370,141,13,43,0,197
 pulsar-master\pulsar-master\pulsar-functions\utils\src\main\java\org\apache\pulsar\functions\utils\WindowConfigUtils.java,79,23,1,16,0,40
 pulsar-master\pulsar-master\pulsar-client\src\main\java\org\apache\pulsar\client\impl\MessagesImpl.java,59,20,1,4,0,25
 pulsar-master\pulsar-master\pulsar-io\kinesis\src\main\java\org\apache\pulsar\io\kinesis\json\JsonConverter.java,171,53,2,22,0,77
 pulsar-master\pulsar-master\pulsar-common\src\main\java\org\apache\pulsar\common\functions\package-info.java,0,2,0,1,0,3
 pulsar-master\pulsar-master\pulsar-io\hdfs2\src\main\java\org\apache\pulsar\io\hdfs2\sink\text\package-info.java,0,1,0,1,0,2
 pulsar-master\pulsar-master\pulsar-client-admin-api\src\main\java\org\apache\pulsar\common\policies\data\impl\BookieInfoImpl.java,0,23,0,5,0,28
 pulsar-master\pulsar-master\tests\integration\src\test\java\org\apache\pulsar\tests\integration\io\sources\debezium\PulsarDebeziumSourcesTest.java,223,72,2,50,0,124
 pulsar-master\pulsar-master\pulsar-functions\worker\src\main\java\org\apache\pulsar\functions\worker\FunctionsManager.java,21,13,0,3,0,16
 pulsar-master\pulsar-master\pulsar-metadata\src\test\java\org\apache\pulsar\metadata\bookkeeper\LedgerManagerIteratorTest.java,415,110,3,49,0,162
 pulsar-master\pulsar-master\pulsar-common\src\main\java\org\apache\pulsar\policies\data\loadbalancer\package-info.java,0,2,0,1,0,3
 pulsar-master\pulsar-master\pulsar-broker\src\test\java\org\apache\pulsar\broker\resourcegroup\ResourceGroupUsageAggregationTest.java,223,93,5,37,0,135
 pulsar-master\pulsar-master\pulsar-common\src\main\java\org\apache\pulsar\common\compression\CompressionCodecZstd.java,73,19,0,11,0,30
 pulsar-master\pulsar-master\pulsar-client\src\main\java\org\apache\pulsar\client\util\TypeCheckUtil.java,12,5,0,2,0,7
 pulsar-master\pulsar-master\pulsar-client\src\main\java\org\apache\pulsar\client\impl\auth\oauth2\protocol\TokenExchangeException.java,13,7,0,2,0,9
 pulsar-master\pulsar-master\pulsar-io\rabbitmq\src\test\java\org\apache\pulsar\io\rabbitmq\source\RabbitMQSourceTest.java,43,8,1,2,0,11
 pulsar-master\pulsar-master\pulsar-io\influxdb\src\main\java\org\apache\pulsar\io\influxdb\v1\InfluxDBBuilder.java,0,1,0,1,0,2
 pulsar-master\pulsar-master\pulsar-common\src\main\java\org\apache\pulsar\common\policies\data\stats\ReplicatorStatsImpl.java,52,19,0,5,0,24
 pulsar-master\pulsar-master\pulsar-transaction\coordinator\src\main\java\org\apache\pulsar\transaction\coordinator\TransactionLog.java,0,6,0,4,0,10
 pulsar-master\pulsar-master\pulsar-client\src\main\java\org\apache\pulsar\client\impl\auth\AuthenticationDataTls.java,120,57,5,23,0,85
 pulsar-master\pulsar-master\pulsar-package-management\bookkeeper-storage\src\test\java\org\apache\pulsar\packages\management\storage\bookkeeper\BookKeeperPackagesStorageTest.java,210,57,0,32,0,89
 pulsar-master\pulsar-master\pulsar-broker\src\main\java\org\apache\pulsar\broker\service\persistent\SystemTopic.java,56,13,0,4,0,17
 pulsar-master\pulsar-master\pulsar-functions\worker\src\main\java\org\apache\pulsar\functions\worker\FunctionMetaDataManager.java,444,149,3,83,0,235
 pulsar-master\pulsar-master\pulsar-io\hbase\src\main\java\org\apache\pulsar\io\hbase\package-info.java,0,1,0,1,0,2
 pulsar-master\pulsar-master\pulsar-client\src\main\java\org\apache\pulsar\client\impl\DefaultCryptoKeyReaderBuilder.java,53,33,1,9,0,43
 pulsar-master\pulsar-master\pulsar-metadata\src\main\java\org\apache\pulsar\metadata\impl\batching\OpDelete.java,17,5,0,1,0,6
 pulsar-master\pulsar-master\pulsar-package-management\bookkeeper-storage\src\main\java\org\apache\pulsar\packages\management\storage\bookkeeper\BookKeeperPackagesStorageProvider.java,7,3,0,2,0,5
 pulsar-master\pulsar-master\pulsar-client-admin-api\src\main\java\org\apache\pulsar\common\policies\data\package-info.java,0,2,0,1,0,3
 pulsar-master\pulsar-master\pulsar-sql\presto-pulsar\src\main\java\org\apache\pulsar\sql\presto\PulsarColumnHandle.java,216,68,0,12,0,80
 pulsar-master\pulsar-master\pulsar-broker\src\main\java\org\apache\pulsar\broker\transaction\exception\coordinator\package-info.java,0,1,0,1,0,2
 pulsar-master\pulsar-master\pulsar-metadata\src\main\java\org\apache\pulsar\metadata\api\MetadataStoreLifecycle.java,0,3,0,4,0,7
 pulsar-master\pulsar-master\pulsar-client-admin\src\main\java\org\apache\pulsar\client\admin\internal\LookupImpl.java,119,43,0,15,0,58
 pulsar-master\pulsar-master\pulsar-sql\presto-pulsar\src\main\java\org\apache\pulsar\sql\presto\PulsarTableLayoutHandle.java,46,16,0,3,0,19
 pulsar-master\pulsar-master\pulsar-functions\utils\src\main\java\org\apache\pulsar\functions\utils\package-info.java,0,0,0,1,0,1
 pulsar-master\pulsar-master\pulsar-client\src\main\java\org\apache\pulsar\client\impl\ConsumerStatsRecorder.java,0,8,0,1,0,9
 pulsar-master\pulsar-master\pulsar-broker\src\test\java\org\apache\pulsar\broker\transaction\pendingack\PendingAckInMemoryDeleteTest.java,232,60,7,48,0,115
 pulsar-master\pulsar-master\pulsar-metadata\src\main\java\org\apache\pulsar\metadata\bookkeeper\PulsarMetadataBookieDriver.java,31,13,0,7,0,20
 pulsar-master\pulsar-master\pulsar-broker\src\main\java\org\apache\pulsar\broker\protocol\package-info.java,0,2,0,1,0,3
 pulsar-master\pulsar-master\pulsar-client\src\main\java\org\apache\pulsar\client\impl\BatchMessageIdImpl.java,131,55,2,9,0,66
 pulsar-master\pulsar-master\pulsar-broker\src\main\java\org\apache\pulsar\broker\service\schema\AvroSchemaBasedCompatibilityCheck.java,60,25,2,18,0,45
 pulsar-master\pulsar-master\pulsar-io\batch-data-generator\src\main\java\org\apache\pulsar\io\batchdatagenerator\package-info.java,0,1,0,1,0,2
 pulsar-master\pulsar-master\pulsar-client-admin-api\src\main\java\org\apache\pulsar\common\conf\package-info.java,0,2,0,1,0,3
 pulsar-master\pulsar-master\pulsar-broker\src\test\java\org\apache\pulsar\broker\loadbalance\AntiAffinityNamespaceGroupTest.java,486,120,5,86,0,211
 pulsar-master\pulsar-master\pulsar-io\canal\src\main\java\org\apache\pulsar\io\canal\package-info.java,0,1,0,1,0,2
 pulsar-master\pulsar-master\pulsar-broker\src\main\java\org\apache\pulsar\broker\transaction\buffer\matadata\TransactionBufferSnapshot.java,7,4,0,1,0,5
 pulsar-master\pulsar-master\tests\integration\src\test\java\org\apache\pulsar\tests\integration\topologies\PulsarGeoClusterTestBase.java,66,17,0,5,0,22
 pulsar-master\pulsar-master\pulsar-client\src\main\java\org\apache\pulsar\client\impl\schema\JSONSchema.java,62,30,1,15,0,46
 pulsar-master\pulsar-master\pulsar-client\src\main\java\org\apache\pulsar\client\impl\auth\oauth2\protocol\Metadata.java,23,7,0,1,0,8
 pulsar-master\pulsar-master\pulsar-io\jdbc\core\src\main\java\org\apache\pulsar\io\jdbc\BaseJdbcAutoSchemaSink.java,0,19,0,8,0,27
 pulsar-master\pulsar-master\pulsar-client\src\test\java\org\apache\pulsar\client\tutorial\SampleAsyncProducerWithSchema.java,38,8,1,4,0,13
 pulsar-master\pulsar-master\pulsar-functions\worker\src\test\java\org\apache\pulsar\functions\worker\FunctionWorkerStarterTest.java,32,3,1,3,0,7
 pulsar-master\pulsar-master\pulsar-client\src\main\java\org\apache\pulsar\client\impl\NegativeAcksTracker.java,0,35,2,18,0,55
 pulsar-master\pulsar-master\pulsar-broker\src\main\java\org\apache\pulsar\broker\loadbalance\impl\GenericBrokerHostUsageImpl.java,79,28,0,10,0,38
 pulsar-master\pulsar-master\pulsar-client-admin-api\src\main\java\org\apache\pulsar\common\policies\data\BookieInfo.java,0,6,0,1,0,7
 pulsar-master\pulsar-master\pulsar-client-tools-test\src\test\java\org\apache\pulsar\admin\cli\DeprecatedCommanderTest.java,50,16,1,5,0,22
 pulsar-master\pulsar-master\tests\integration\src\test\java\org\apache\pulsar\tests\integration\io\sinks\PulsarIOSinkRunner.java,407,109,9,49,0,167
 pulsar-master\pulsar-master\pulsar-client-admin\src\main\java\org\apache\pulsar\client\admin\package-info.java,0,1,0,1,0,2
 pulsar-master\pulsar-master\pulsar-websocket\src\main\java\org\apache\pulsar\websocket\PingPongHandler.java,23,8,2,3,0,13
 pulsar-master\pulsar-master\pulsar-io\hdfs3\src\main\java\org\apache\pulsar\io\hdfs3\sink\seq\package-info.java,0,1,0,1,0,2
 pulsar-master\pulsar-master\pulsar-broker\src\main\java\org\apache\pulsar\broker\admin\v3\Transactions.java,205,199,10,90,0,299
 pulsar-master\pulsar-master\pulsar-broker\src\test\java\org\apache\pulsar\client\impl\ConnectionPoolTest.java,104,30,5,19,0,54
 pulsar-master\pulsar-master\pulsar-broker\src\main\java\org\apache\pulsar\compaction\TwoPhaseCompactor.java,363,121,8,55,0,184
 pulsar-master\pulsar-master\pulsar-client\src\main\java\org\apache\pulsar\client\impl\schema\writer\ProtobufWriter.java,0,3,0,2,0,5
 pulsar-master\pulsar-master\pulsar-broker\src\test\java\org\apache\pulsar\client\api\ClientErrorsTest.java,743,181,12,118,0,311
 pulsar-master\pulsar-master\pulsar-common\src\main\java\org\apache\pulsar\common\util\collections\package-info.java,0,2,0,1,0,3
 pulsar-master\pulsar-master\pulsar-broker\src\main\java\org\apache\pulsar\broker\admin\v1\NonPersistentTopics.java,248,144,11,71,0,226
 pulsar-master\pulsar-master\tests\integration\src\test\java\org\apache\pulsar\tests\integration\offload\TestS3Offload.java,57,21,0,9,0,30
 pulsar-master\pulsar-master\pulsar-broker-common\src\main\java\org\apache\pulsar\bookie\rackawareness\IsolatedBookieEnsemblePlacementPolicy.java,258,103,4,73,0,180
 pulsar-master\pulsar-master\pulsar-broker\src\test\java\org\apache\pulsar\broker\stats\TransactionMetricsTest.java,365,119,1,75,0,195
 pulsar-master\pulsar-master\pulsar-broker\src\main\java\org\apache\pulsar\broker\stats\prometheus\AggregatedReplicationStats.java,28,10,0,3,0,13
 pulsar-master\pulsar-master\pulsar-functions\secrets\src\main\java\org\apache\pulsar\functions\secretsprovider\ClearTextSecretsProvider.java,16,3,0,1,0,4
 pulsar-master\pulsar-master\pulsar-io\kafka-connect-adaptor\src\test\java\org\apache\pulsar\io\kafka\connect\SchemaedFileStreamSinkConnector.java,16,4,0,2,0,6
 pulsar-master\pulsar-master\tests\integration\src\test\java\org\apache\pulsar\tests\integration\io\sources\GenericRecordSourceTest.java,204,60,5,21,0,86
 pulsar-master\pulsar-master\tests\integration\src\test\java\org\apache\pulsar\tests\integration\topologies\ClientTestBase.java,50,19,0,7,0,26
 pulsar-master\pulsar-master\pulsar-functions\java-examples\src\main\java\org\apache\pulsar\functions\api\examples\serde\CustomObjectSerde.java,15,5,0,1,0,6
 pulsar-master\pulsar-master\pulsar-broker-common\src\main\java\org\apache\pulsar\broker\resources\package-info.java,0,1,0,1,0,2
 pulsar-master\pulsar-master\pulsar-broker\src\main\java\org\apache\pulsar\broker\transaction\pendingack\PendingAckReplyCallBack.java,0,3,0,3,0,6
 pulsar-master\pulsar-master\pulsar-client\src\main\java\org\apache\pulsar\client\impl\auth\oauth2\protocol\DefaultMetadataResolver.java,80,23,0,5,0,28
 pulsar-master\pulsar-master\pulsar-client-admin-api\src\main\java\org\apache\pulsar\common\policies\data\AuthAction.java,0,0,0,1,0,1
 pulsar-master\pulsar-master\pulsar-client\src\test\java\org\apache\pulsar\client\tutorial\SampleConsumer.java,28,8,1,3,0,12
 pulsar-master\pulsar-master\pulsar-client-admin-api\src\main\java\org\apache\pulsar\common\policies\data\ValidateResult.java,18,10,1,1,0,12
 pulsar-master\pulsar-master\pulsar-metadata\src\main\java\org\apache\pulsar\metadata\bookkeeper\PulsarRegistrationClient.java,112,36,5,11,0,52
 pulsar-master\pulsar-master\pulsar-client\src\main\java\org\apache\pulsar\client\impl\schema\reader\AbstractMultiVersionReader.java,94,52,6,15,0,73
 pulsar-master\pulsar-master\pulsar-common\src\main\java\org\apache\pulsar\common\util\collections\ConcurrentOpenHashSet.java,551,170,24,16,0,210
 pulsar-master\pulsar-master\pulsar-broker-common\src\main\java\org\apache\pulsar\broker\stats\prometheus\PrometheusMetricsServlet.java,81,38,1,13,0,52
 pulsar-master\pulsar-master\pulsar-broker\src\test\java\org\apache\pulsar\client\impl\TopicPublishThrottlingInitTest.java,87,23,1,15,0,39
 pulsar-master\pulsar-master\pulsar-client-admin-api\src\main\java\org\apache\pulsar\common\partition\package-info.java,0,2,0,1,0,3
 pulsar-master\pulsar-master\pulsar-broker\src\main\java\org\apache\pulsar\broker\stats\BookieClientStatsGenerator.java,43,18,0,10,0,28
 pulsar-master\pulsar-master\managed-ledger\src\main\java\org\apache\bookkeeper\mledger\impl\ManagedLedgerFactoryMBeanImpl.java,83,38,0,3,0,41
 pulsar-master\pulsar-master\pulsar-client-api\src\main\java\org\apache\pulsar\client\api\DeadLetterPolicy.java,26,3,0,4,0,7
 pulsar-master\pulsar-master\pulsar-broker\src\main\java\org\apache\pulsar\broker\transaction\buffer\impl\TopicTransactionBuffer.java,0,258,25,147,0,430
 pulsar-master\pulsar-master\pulsar-common\src\test\java\org\apache\pulsar\common\allocator\PulsarByteBufAllocatorOomThrowExceptionTest.java,34,9,0,7,0,16
 pulsar-master\pulsar-master\pulsar-client\src\main\java\org\apache\pulsar\client\impl\auth\oauth2\protocol\TokenError.java,11,3,0,1,0,4
 pulsar-master\pulsar-master\pulsar-io\twitter\src\main\java\org\apache\pulsar\io\twitter\endpoint\package-info.java,0,1,0,1,0,2
 pulsar-master\pulsar-master\pulsar-common\src\main\java\org\apache\pulsar\common\policies\data\stats\TopicStatsImpl.java,238,65,0,18,0,83
 pulsar-master\pulsar-master\pulsar-websocket\src\main\java\org\apache\pulsar\websocket\admin\WebSocketWebResource.java,125,36,2,17,0,55
 pulsar-master\pulsar-master\tests\integration\src\test\java\org\apache\pulsar\tests\integration\topologies\PulsarClusterTestBase.java,112,36,2,9,0,47
 pulsar-master\pulsar-master\pulsar-broker\src\test\java\org\apache\pulsar\broker\intercept\CounterBrokerInterceptor.java,216,124,2,10,0,136
 pulsar-master\pulsar-master\pulsar-io\rabbitmq\src\main\java\org\apache\pulsar\io\rabbitmq\RabbitMQSink.java,60,20,2,10,0,32
 pulsar-master\pulsar-master\pulsar-functions\api-java\src\main\java\org\apache\pulsar\functions\api\state\ByteBufferStateStore.java,0,5,0,4,0,9
 pulsar-master\pulsar-master\pulsar-metadata\src\test\java\org\apache\pulsar\metadata\bookkeeper\LedgerUnderreplicationManagerTest.java,651,158,15,50,0,223
 pulsar-master\pulsar-master\tests\docker-images\java-test-functions\src\main\java\org\apache\pulsar\tests\integration\functions\RemoveAvroFieldFunction.java,0,38,4,31,0,73
 pulsar-master\pulsar-master\pulsar-broker\src\test\java\org\apache\pulsar\common\naming\TopicCountEquallyDivideBundleSplitAlgorithmTest.java,61,22,1,19,0,42
 pulsar-master\pulsar-master\pulsar-functions\worker\src\main\java\org\apache\pulsar\functions\worker\rest\api\v2\FunctionsApiV2Resource.java,282,163,3,81,0,247
 pulsar-master\pulsar-master\pulsar-broker-common\src\test\java\org\apache\pulsar\broker\validator\BindAddressValidatorTest.java,105,37,1,22,0,60
 pulsar-master\pulsar-master\pulsar-broker\src\main\java\org\apache\pulsar\broker\admin\impl\PackagesBase.java,169,105,7,48,0,160
 pulsar-master\pulsar-master\pulsar-client-admin\src\main\java\org\apache\pulsar\client\admin\internal\WorkerImpl.java,168,67,0,29,0,96
 pulsar-master\pulsar-master\pulsar-common\src\main\java\org\apache\pulsar\common\events\EventType.java,0,0,0,1,0,1
 pulsar-master\pulsar-master\pulsar-functions\java-examples\src\main\java\org\apache\pulsar\functions\api\examples\JavaNativeExclamationFunction.java,0,2,0,1,0,3
 pulsar-master\pulsar-master\pulsar-broker\src\test\java\org\apache\pulsar\broker\admin\BookiesApiTest.java,146,13,6,6,0,25
 pulsar-master\pulsar-master\pulsar-broker\src\test\java\org\apache\pulsar\broker\admin\PersistentTopicsTest.java,1144,516,15,352,0,883
 pulsar-master\pulsar-master\tests\integration\src\test\java\org\apache\pulsar\tests\integration\containers\DebeziumOracleDbContainer.java,38,13,0,5,0,18
 pulsar-master\pulsar-master\pulsar-websocket\src\main\java\org\apache\pulsar\websocket\WebSocketPingPongServlet.java,22,11,0,3,0,14
 pulsar-master\pulsar-master\pulsar-client\src\main\java\org\apache\pulsar\client\impl\schema\generic\AbstractGenericSchema.java,0,10,0,4,0,14
 pulsar-master\pulsar-master\tests\integration\src\test\java\org\apache\pulsar\tests\integration\utils\DockerUtils.java,368,146,9,73,0,228
 pulsar-master\pulsar-master\pulsar-common\src\main\java\org\apache\pulsar\common\sasl\KerberosName.java,395,69,3,20,0,92
 pulsar-master\pulsar-master\tests\integration\src\test\java\org\apache\pulsar\tests\integration\containers\WorkerContainer.java,28,5,0,1,0,6
 pulsar-master\pulsar-master\pulsar-broker\src\test\java\org\apache\pulsar\broker\admin\AdminApiMaxUnackedMessages.java,173,71,0,35,0,106
 pulsar-master\pulsar-master\pulsar-client-1x-base\pulsar-client-1x\src\main\java\org\apache\pulsar\client\impl\v1\ProducerV1Impl.java,63,32,0,1,0,33
 pulsar-master\pulsar-master\pulsar-sql\presto-pulsar\src\main\java\org\apache\pulsar\sql\presto\decoder\protobufnative\PulsarProtobufNativeColumnDecoder.java,333,88,1,39,0,128
 pulsar-master\pulsar-master\tests\integration\src\test\java\org\apache\pulsar\tests\integration\io\sources\debezium\PulsarIODebeziumSourceRunner.java,89,44,0,13,0,57
 pulsar-master\pulsar-master\pulsar-proxy\src\test\java\org\apache\pulsar\proxy\server\ProxyRolesEnforcementTest.java,202,45,2,19,0,66
 pulsar-master\pulsar-master\pulsar-broker\src\main\java\org\apache\pulsar\broker\web\MaxRequestSizeFilter.java,42,12,2,3,0,17
 pulsar-master\pulsar-master\pulsar-functions\worker\src\main\java\org\apache\pulsar\functions\worker\scheduler\IScheduler.java,0,3,0,4,0,7
 pulsar-master\pulsar-master\pulsar-broker\src\main\java\org\apache\pulsar\common\naming\NamespaceBundle.java,0,63,5,22,0,90
 pulsar-master\pulsar-master\managed-ledger\src\main\java\org\apache\bookkeeper\mledger\impl\ManagedLedgerImpl.java,0,1309,68,671,0,2048
 pulsar-master\pulsar-master\pulsar-broker\src\main\java\org\apache\pulsar\broker\service\plugin\EntryFilterDefinition.java,18,0,0,1,0,1
 pulsar-master\pulsar-master\pulsar-client-admin-api\src\main\java\org\apache\pulsar\common\functions\WindowConfig.java,23,10,0,1,0,11
 pulsar-master\pulsar-master\pulsar-broker\src\test\java\org\apache\pulsar\client\api\v1\V1_ProducerConsumerBase.java,27,19,1,7,0,27
 pulsar-master\pulsar-master\pulsar-broker\src\main\java\org\apache\pulsar\broker\loadbalance\BrokerFilterBadVersionException.java,14,8,0,1,0,9
 pulsar-master\pulsar-master\pulsar-broker\src\main\java\org\apache\pulsar\broker\transaction\buffer\impl\TopicTransactionBufferState.java,56,27,3,6,0,36
 pulsar-master\pulsar-master\pulsar-io\hbase\src\main\java\org\apache\pulsar\io\hbase\HbaseAbstractConfig.java,39,13,0,7,0,20
 pulsar-master\pulsar-master\pulsar-functions\java-examples\src\main\java\org\apache\pulsar\functions\api\examples\InitializableFunction.java,26,7,0,1,0,8
 pulsar-master\pulsar-master\pulsar-proxy\src\test\java\org\apache\pulsar\proxy\extensions\ProxyExtensionWithClassLoaderTest.java,96,21,1,17,0,39
 pulsar-master\pulsar-master\pulsar-metadata\src\test\java\org\apache\pulsar\metadata\bookkeeper\PulsarLedgerAuditorManagerTest.java,82,17,3,7,0,27
 pulsar-master\pulsar-master\managed-ledger\src\main\java\org\apache\bookkeeper\mledger\impl\ManagedLedgerMBeanImpl.java,295,124,0,11,0,135
 pulsar-master\pulsar-master\pulsar-io\solr\src\main\java\org\apache\pulsar\io\solr\SolrSinkConfig.java,63,21,0,9,0,30
 pulsar-master\pulsar-master\pulsar-broker-auth-athenz\src\main\java\org\apache\pulsar\broker\authentication\AuthenticationProviderAthenz.java,118,36,1,23,0,60
 pulsar-master\pulsar-master\pulsar-broker\src\main\java\org\apache\pulsar\broker\service\persistent\PersistentTopic.java,0,1045,66,665,0,1776
 pulsar-master\pulsar-master\pulsar-functions\runtime\src\test\java\org\apache\pulsar\functions\runtime\kubernetes\KubernetesRuntimeFactoryTest.java,448,296,20,121,0,437
 pulsar-master\pulsar-master\pulsar-broker\src\main\java\org\apache\pulsar\broker\service\persistent\PersistentDispatcherSingleActiveConsumer.java,0,192,7,116,0,315
 pulsar-master\pulsar-master\pulsar-broker\src\test\java\org\apache\pulsar\broker\transaction\recover\TransactionRecoverTrackerTest.java,79,32,5,20,0,57
 pulsar-master\pulsar-master\pulsar-client\src\main\java\org\apache\pulsar\client\impl\ConsumerImpl.java,0,808,50,470,0,1328
 pulsar-master\pulsar-master\pulsar-client\src\main\java\org\apache\pulsar\client\impl\BatchMessageContainerImpl.java,0,43,4,29,0,76
 pulsar-master\pulsar-master\pulsar-broker-common\src\main\java\org\apache\pulsar\broker\web\RateLimitingFilter.java,34,12,2,2,0,16
 pulsar-master\pulsar-master\pulsar-functions\java-examples\src\main\java\org\apache\pulsar\functions\api\examples\pojo\AvroTestObject.java,7,2,0,1,0,3
 pulsar-master\pulsar-master\pulsar-broker\src\test\java\org\apache\pulsar\utils\SimpleTextOutputStreamTest.java,90,21,0,2,0,23
 pulsar-master\pulsar-master\pulsar-broker\src\test\java\org\apache\pulsar\broker\service\ReplicatorTestBase.java,381,150,4,30,0,184
 pulsar-master\pulsar-master\pulsar-client-api\src\main\java\org\apache\pulsar\client\api\schema\GenericRecord.java,0,0,0,1,0,1
 pulsar-master\pulsar-master\testmocks\src\main\java\org\apache\bookkeeper\client\PulsarMockReadHandle.java,0,28,1,10,0,39
 pulsar-master\pulsar-master\pulsar-common\src\main\java\org\apache\pulsar\common\sasl\TGTRefreshThread.java,242,71,12,49,0,132
 pulsar-master\pulsar-master\pulsar-broker\src\test\java\org\apache\pulsar\broker\service\BrokerDispatchRateLimiterTest.java,32,13,0,10,0,23
 pulsar-master\pulsar-master\tiered-storage\jcloud\src\test\java\org\apache\bookkeeper\mledger\offload\jcloud\impl\BlobStoreManagedLedgerOffloaderBase.java,121,62,0,24,0,86
 pulsar-master\pulsar-master\pulsar-metadata\src\test\java\org\apache\pulsar\metadata\impl\RocksdbMetadataStoreTest.java,100,21,3,15,0,39
 pulsar-master\pulsar-master\pulsar-sql\presto-pulsar\src\main\java\org\apache\pulsar\sql\presto\PulsarSqlSchemaInfoProvider.java,75,33,2,14,0,49
 pulsar-master\pulsar-master\pulsar-broker\src\main\java\org\apache\pulsar\broker\service\streamingdispatch\StreamingEntryReader.java,0,109,5,69,0,183
 pulsar-master\pulsar-master\pulsar-client-tools\src\main\java\org\apache\pulsar\admin\cli\CmdTopics.java,2737,816,134,541,0,1491
 pulsar-master\pulsar-master\pulsar-metadata\src\test\java\org\apache\pulsar\metadata\bookkeeper\PulsarRegistrationClientTest.java,145,44,3,20,0,67
 pulsar-master\pulsar-master\pulsar-client-api\src\main\java\org\apache\pulsar\client\api\KeySharedPolicy.java,112,40,0,11,0,51
 pulsar-master\pulsar-master\pulsar-broker\src\test\java\org\apache\pulsar\client\impl\TransactionEndToEndWithoutBatchIndexAckTest.java,17,5,0,3,0,8
 pulsar-master\pulsar-master\pulsar-broker\src\main\java\org\apache\pulsar\broker\admin\impl\SchemasResourceBase.java,253,108,6,60,0,174
 pulsar-master\pulsar-master\pulsar-metadata\src\main\java\org\apache\pulsar\metadata\impl\ZKMetadataStore.java,0,130,8,79,0,217
 pulsar-master\pulsar-master\pulsar-client-api\src\main\java\org\apache\pulsar\client\api\MessageListener.java,0,5,0,5,0,10
 pulsar-master\pulsar-master\pulsar-sql\presto-pulsar\src\main\java\org\apache\pulsar\sql\presto\decoder\primitive\PulsarPrimitiveRowDecoderFactory.java,65,26,0,14,0,40
 pulsar-master\pulsar-master\pulsar-client\src\main\java\org\apache\pulsar\client\impl\MessageRouterBase.java,17,3,1,1,0,5
 pulsar-master\pulsar-master\pulsar-broker\src\main\java\org\apache\pulsar\broker\transaction\pendingack\impl\PendingAckHandleState.java,53,26,2,5,0,33
 pulsar-master\pulsar-master\pulsar-testclient\src\main\java\org\apache\pulsar\testclient\PerfClientUtils.java,28,12,4,5,0,21
 pulsar-master\pulsar-master\pulsar-proxy\src\test\java\org\apache\pulsar\proxy\server\AdminProxyHandlerTest.java,104,29,3,17,0,49
 pulsar-master\pulsar-master\pulsar-broker\src\main\java\org\apache\pulsar\broker\stats\prometheus\metrics\SimpleGauge.java,13,6,0,1,0,7
 pulsar-master\pulsar-master\pulsar-io\solr\src\main\java\org\apache\pulsar\io\solr\SolrAbstractSink.java,89,23,2,8,0,33
 pulsar-master\pulsar-master\pulsar-metadata\src\main\java\org\apache\pulsar\metadata\coordination\impl\LockManagerImpl.java,0,35,2,11,0,48
 pulsar-master\pulsar-master\pulsar-broker\src\main\java\org\apache\pulsar\broker\loadbalance\LoadRanker.java,0,1,0,1,0,2
 pulsar-master\pulsar-master\pulsar-io\flume\src\main\java\org\apache\pulsar\io\flume\source\StringSource.java,8,2,0,1,0,3
 pulsar-master\pulsar-master\pulsar-functions\java-examples\src\main\java\org\apache\pulsar\functions\api\examples\AsyncContextFunction.java,0,8,0,5,0,13
 pulsar-master\pulsar-master\pulsar-client-admin-api\src\main\java\org\apache\pulsar\client\admin\Brokers.java,0,38,0,22,0,60
 pulsar-master\pulsar-master\pulsar-broker\src\test\java\org\apache\pulsar\io\SinkForTest.java,21,5,2,2,0,9
 pulsar-master\pulsar-master\pulsar-broker\src\test\java\org\apache\pulsar\broker\admin\AdminApiDynamicConfigurationsTest.java,39,13,4,5,0,22
 pulsar-master\pulsar-master\pulsar-client\src\main\java\org\apache\pulsar\client\impl\BatchMessageKeyBasedContainer.java,0,52,4,30,0,86
 pulsar-master\pulsar-master\pulsar-common\src\test\java\org\apache\pulsar\common\util\collections\ConcurrentLongLongPairHashMapTest.java,386,155,15,19,0,189
 pulsar-master\pulsar-master\pulsar-client\src\test\java\org\apache\pulsar\client\impl\auth\AuthenticationTlsTest.java,63,13,0,6,0,19
 pulsar-master\pulsar-master\pulsar-functions\runtime\src\main\java\org\apache\pulsar\functions\runtime\kubernetes\BasicKubernetesManifestCustomizer.java,196,67,0,35,0,102
 pulsar-master\pulsar-master\pulsar-client-tools\src\main\java\org\apache\pulsar\client\cli\package-info.java,0,0,0,1,0,1
 pulsar-master\pulsar-master\pulsar-functions\runtime\src\main\java\org\apache\pulsar\functions\auth\FunctionAuthProvider.java,0,16,0,14,0,30
 pulsar-master\pulsar-master\pulsar-client-admin-api\src\main\java\org\apache\pulsar\client\admin\ResourceQuotas.java,0,21,0,14,0,35
 pulsar-master\pulsar-master\pulsar-broker-auth-sasl\src\main\java\org\apache\pulsar\broker\authentication\SaslRoleTokenSigner.java,79,12,0,6,0,18
 pulsar-master\pulsar-master\pulsar-broker\src\main\java\org\apache\pulsar\broker\admin\v2\BrokerStats.java,33,17,0,9,0,26
 pulsar-master\pulsar-master\pulsar-io\elastic-search\src\main\java\org\apache\pulsar\io\elasticsearch\JsonConverter.java,183,58,2,25,0,85
 pulsar-master\pulsar-master\pulsar-client\src\test\java\org\apache\pulsar\client\impl\schema\generic\GenericSchemaTest.java,160,35,0,21,0,56
 pulsar-master\pulsar-master\pulsar-client-admin\src\main\java\org\apache\pulsar\client\admin\internal\NamespacesImpl.java,2507,1299,4,449,0,1752
 pulsar-master\pulsar-master\pulsar-broker\src\test\java\org\apache\pulsar\broker\service\BrokerServiceAutoSubscriptionCreationTest.java,121,35,2,29,0,66
 pulsar-master\pulsar-master\pulsar-broker\src\test\java\org\apache\pulsar\broker\service\persistent\PersistentStickyKeyDispatcherMultipleConsumersTest.java,377,113,7,62,0,182
 pulsar-master\pulsar-master\pulsar-io\common\src\main\java\org\apache\pulsar\io\common\IOConfigUtils.java,38,19,3,8,0,30
 pulsar-master\pulsar-master\pulsar-functions\worker\src\main\java\org\apache\pulsar\functions\worker\service\api\FunctionsV2.java,0,19,0,1,0,20
 pulsar-master\pulsar-master\pulsar-broker\src\main\java\org\apache\pulsar\broker\intercept\BrokerInterceptors.java,196,78,2,22,0,102
 pulsar-master\pulsar-master\tests\integration\src\test\java\org\apache\pulsar\tests\integration\containers\PrestoWorkerContainer.java,44,15,0,6,0,21
 pulsar-master\pulsar-master\pulsar-client-tools\src\main\java\org\apache\pulsar\admin\cli\package-info.java,0,0,0,1,0,1
 pulsar-master\pulsar-master\managed-ledger\src\main\java\org\apache\bookkeeper\mledger\impl\ReadOnlyManagedLedgerImpl.java,124,53,0,38,0,91
 pulsar-master\pulsar-master\pulsar-io\elastic-search\src\main\java\org\apache\pulsar\io\elasticsearch\client\package-info.java,0,1,0,1,0,2
 pulsar-master\pulsar-master\pulsar-websocket\src\test\java\org\apache\pulsar\websocket\ReaderHandlerTest.java,167,30,4,20,0,54
 pulsar-master\pulsar-master\pulsar-broker-common\src\main\java\org\apache\pulsar\broker\resources\BrokerResources.java,11,5,0,1,0,6
 pulsar-master\pulsar-master\pulsar-client-tools\src\main\java\org\apache\pulsar\admin\cli\CmdUsageFormatter.java,62,25,0,6,0,31
 pulsar-master\pulsar-master\pulsar-client-admin-api\src\main\java\org\apache\pulsar\common\policies\data\NonPersistentTopicStats.java,0,5,0,2,0,7
 pulsar-master\pulsar-master\pulsar-client-admin-api\src\main\java\org\apache\pulsar\common\policies\data\PartitionedTopicInternalStats.java,24,11,0,1,0,12
 pulsar-master\pulsar-master\pulsar-broker\src\test\java\org\apache\pulsar\client\api\MutualAuthenticationTest.java,195,53,2,18,0,73
 pulsar-master\pulsar-master\pulsar-functions\java-examples\src\main\java\org\apache\pulsar\functions\api\examples\pojo\Tick.java,18,16,1,1,0,18
 pulsar-master\pulsar-master\pulsar-broker\src\test\java\org\apache\pulsar\schema\compatibility\SchemaCompatibilityCheckTest.java,497,107,1,62,0,170
 pulsar-master\pulsar-master\pulsar-broker-common\src\main\java\org\apache\pulsar\broker\web\package-info.java,0,1,0,1,0,2
 pulsar-master\pulsar-master\managed-ledger\src\main\java\org\apache\bookkeeper\mledger\impl\OpReadEntry.java,0,56,6,26,0,88
 pulsar-master\pulsar-master\pulsar-package-management\bookkeeper-storage\src\main\java\org\apache\pulsar\packages\management\storage\bookkeeper\DLInputStream.java,0,20,1,7,0,28
 pulsar-master\pulsar-master\pulsar-broker\src\main\java\org\apache\pulsar\broker\namespace\package-info.java,0,0,0,1,0,1
 pulsar-master\pulsar-master\pulsar-io\netty\src\main\java\org\apache\pulsar\io\netty\http\NettyHttpServerHandler.java,91,35,0,14,0,49
 pulsar-master\pulsar-master\pulsar-proxy\src\test\java\org\apache\pulsar\proxy\server\BrokerProxyValidatorTest.java,88,38,8,16,0,62
 pulsar-master\pulsar-master\pulsar-broker\src\test\java\org\apache\pulsar\broker\transaction\buffer\TransactionBufferTest.java,233,49,2,13,0,64
 pulsar-master\pulsar-master\tests\integration\src\test\java\org\apache\pulsar\tests\integration\backwardscompatibility\SmokeTest2_3.java,13,9,1,3,0,13
 pulsar-master\pulsar-master\pulsar-common\src\main\java\org\apache\pulsar\common\policies\data\FunctionStatusUtil.java,6,4,1,2,0,7
 pulsar-master\pulsar-master\managed-ledger\src\test\java\org\apache\bookkeeper\mledger\impl\ReadOnlyCursorTest.java,193,33,6,16,0,55
 pulsar-master\pulsar-master\pulsar-broker-auth-athenz\src\main\java\org\apache\pulsar\broker\authentication\package-info.java,0,0,0,1,0,1
 pulsar-master\pulsar-master\pulsar-client-admin-api\src\main\java\org\apache\pulsar\common\policies\data\FailureDomain.java,0,5,0,2,0,7
 pulsar-master\pulsar-master\pulsar-client-admin-api\src\main\java\org\apache\pulsar\common\policies\data\DelayedDeliveryPolicies.java,0,6,0,1,0,7
 pulsar-master\pulsar-master\pulsar-io\jdbc\mariadb\src\main\java\org\apache\pulsar\io\jdbc\MariadbJdbcAutoSchemaSink.java,4,1,0,2,0,3
 pulsar-master\pulsar-master\pulsar-broker\src\main\java\org\apache\pulsar\broker\web\PulsarServerConnector.java,41,14,0,3,0,17
 pulsar-master\pulsar-master\pulsar-broker\src\test\java\org\apache\pulsar\broker\service\persistent\PersistentTopicStreamingDispatcherE2ETest.java,9,4,0,2,0,6
 pulsar-master\pulsar-master\pulsar-broker\src\main\java\org\apache\pulsar\utils\package-info.java,0,0,0,1,0,1
 pulsar-master\pulsar-master\pulsar-io\kinesis\src\main\java\org\apache\pulsar\io\kinesis\json\JsonRecord.java,17,15,0,1,0,16
 pulsar-master\pulsar-master\pulsar-io\core\src\main\java\org\apache\pulsar\io\core\annotations\Connector.java,0,0,0,1,0,1
 pulsar-master\pulsar-master\pulsar-client\src\main\java\org\apache\pulsar\client\util\ObjectCache.java,31,21,0,4,0,25
 pulsar-master\pulsar-master\pulsar-client-1x-base\pulsar-client-1x\src\main\java\org\apache\pulsar\client\api\ConsumerConfiguration.java,377,96,0,52,0,148
 pulsar-master\pulsar-master\pulsar-common\src\test\java\org\apache\pulsar\common\compression\CompressorCodecTest.java,158,67,0,23,0,90
 pulsar-master\pulsar-master\pulsar-common\src\main\java\org\apache\pulsar\common\lookup\data\package-info.java,0,2,0,1,0,3
 pulsar-master\pulsar-master\pulsar-functions\worker\src\test\java\org\apache\pulsar\functions\worker\FunctionMetaDataTopicTailerTest.java,58,14,2,5,0,21
 pulsar-master\pulsar-master\pulsar-client\src\main\java\org\apache\pulsar\client\impl\schema\generic\GenericAvroWriter.java,26,10,0,4,0,14
 pulsar-master\pulsar-master\pulsar-client-api\src\main\java\org\apache\pulsar\client\api\Producer.java,0,27,0,24,0,51
 pulsar-master\pulsar-master\pulsar-metadata\src\main\java\org\apache\pulsar\metadata\api\Stat.java,33,6,0,1,0,7
 pulsar-master\pulsar-master\pulsar-broker\src\main\java\org\apache\pulsar\broker\service\HashRangeAutoSplitStickyKeyConsumerSelector.java,108,26,0,13,0,39
 pulsar-master\pulsar-master\pulsar-client\src\main\java\org\apache\pulsar\client\impl\schema\generic\GenericSchemaImpl.java,0,15,0,9,0,24
 pulsar-master\pulsar-master\pulsar-proxy\src\main\java\org\apache\pulsar\proxy\server\ParserProxyHandler.java,157,55,3,23,0,81
 pulsar-master\pulsar-master\pulsar-broker\src\test\java\org\apache\pulsar\common\naming\NamespaceBundleTest.java,178,71,9,34,0,114
 pulsar-master\pulsar-master\pulsar-io\kafka-connect-adaptor\src\main\java\org\apache\pulsar\io\kafka\connect\KafkaConnectSource.java,0,29,0,15,0,44
 pulsar-master\pulsar-master\pulsar-client-admin-api\src\main\java\org\apache\pulsar\client\admin\LongRunningProcessStatus.java,33,17,0,1,0,18
 pulsar-master\pulsar-master\pulsar-config-validation\src\main\java\org\apache\pulsar\config\validation\ConfigValidation.java,107,31,2,11,0,44
 pulsar-master\pulsar-master\pulsar-broker\src\main\java\org\apache\pulsar\broker\admin\package-info.java,0,0,0,1,0,1
 pulsar-master\pulsar-master\pulsar-metadata\src\main\java\org\apache\pulsar\metadata\bookkeeper\LegacyHierarchicalLedgerManager.java,0,8,0,6,0,14
 pulsar-master\pulsar-master\pulsar-broker\src\test\java\org\apache\pulsar\websocket\proxy\ProxyPublishConsumeWithoutZKTest.java,88,21,1,10,0,32
 pulsar-master\pulsar-master\pulsar-client-api\src\main\java\org\apache\pulsar\client\api\schema\RecordSchemaBuilder.java,0,1,0,1,0,2
 pulsar-master\pulsar-master\pulsar-io\debezium\mongodb\src\main\java\org\apache\pulsar\io\debezium\mongodb\DebeziumMongoDbSource.java,9,6,0,4,0,10
 pulsar-master\pulsar-master\pulsar-broker\src\test\java\org\apache\pulsar\broker\service\BatchMessageTest.java,0,351,15,190,0,556
 pulsar-master\pulsar-master\buildtools\src\test\java\org\apache\pulsar\tests\DefaultTestRetriesTest.java,27,7,3,1,0,11
 pulsar-master\pulsar-master\pulsar-client\src\test\java\org\apache\pulsar\client\impl\TopicMessageIdImplTest.java,33,8,0,7,0,15
 pulsar-master\pulsar-master\pulsar-common\src\main\java\org\apache\pulsar\common\io\package-info.java,0,2,0,1,0,3
 pulsar-master\pulsar-master\pulsar-broker\src\main\java\org\apache\pulsar\broker\service\RedeliveryTrackerDisabled.java,42,11,1,2,0,14
 pulsar-master\pulsar-master\pulsar-broker\src\test\java\org\apache\pulsar\client\impl\DispatchAccordingPermitsTests.java,67,12,0,7,0,19
 pulsar-master\pulsar-master\pulsar-functions\secrets\src\main\java\org\apache\pulsar\functions\secretsproviderconfigurator\KubernetesSecretsProviderConfigurator.java,100,45,1,27,0,73
 pulsar-master\pulsar-master\pulsar-functions\api-java\src\main\java\org\apache\pulsar\functions\api\WindowFunction.java,0,6,0,3,0,9
 pulsar-master\pulsar-master\pulsar-client\src\main\java\org\apache\pulsar\client\impl\schema\reader\package-info.java,0,1,0,1,0,2
 pulsar-master\pulsar-master\pulsar-broker\src\test\java\org\apache\pulsar\broker\service\TopicTerminationTest.java,339,65,11,30,0,106
 pulsar-master\pulsar-master\pulsar-io\core\src\test\java\org\apache\pulsar\io\core\SinkTest.java,31,6,2,2,0,10
 pulsar-master\pulsar-master\tests\integration\src\test\java\org\apache\pulsar\tests\integration\io\sources\debezium\DebeziumOracleDbSourceTester.java,217,44,6,16,0,66
 pulsar-master\pulsar-master\pulsar-broker-common\src\main\java\org\apache\pulsar\broker\MetadataSessionExpiredPolicy.java,0,3,0,2,0,5
 pulsar-master\pulsar-master\pulsar-functions\java-examples\src\main\java\org\apache\pulsar\functions\api\examples\window\PublishWindowFunction.java,0,5,0,3,0,8
 pulsar-master\pulsar-master\tiered-storage\jcloud\src\test\java\org\apache\bookkeeper\mledger\offload\jcloud\impl\MockManagedLedger.java,331,164,29,39,0,232
 pulsar-master\pulsar-master\tests\integration\src\test\java\org\apache\pulsar\tests\integration\containers\package-info.java,0,2,0,1,0,3
 pulsar-master\pulsar-master\pulsar-io\aws\src\main\java\org\apache\pulsar\io\aws\package-info.java,0,1,0,1,0,2
 pulsar-master\pulsar-master\pulsar-common\src\main\java\org\apache\pulsar\common\util\KeyManagerProxy.java,107,55,3,19,0,77
 pulsar-master\pulsar-master\pulsar-client-admin\src\main\java\org\apache\pulsar\client\admin\internal\PulsarAdminImpl.java,420,129,7,39,0,175
 pulsar-master\pulsar-master\pulsar-client-api\src\main\java\org\apache\pulsar\common\api\EncryptionContext.java,23,9,0,1,0,10
 pulsar-master\pulsar-master\pulsar-common\src\test\java\org\apache\pulsar\common\util\collections\ConcurrentSortedLongPairSetTest.java,213,80,3,6,0,89
 pulsar-master\pulsar-master\tests\integration\src\test\java\org\apache\pulsar\tests\integration\functions\java\PulsarWorkerRebalanceDrainProcessTest.java,7,3,0,2,0,5
 pulsar-master\pulsar-master\pulsar-client-api\src\main\java\org\apache\pulsar\client\api\MessageRouter.java,0,2,0,3,0,5
 pulsar-master\pulsar-master\pulsar-client\src\main\java\org\apache\pulsar\client\impl\schema\StringSchema.java,97,29,1,3,0,33
 pulsar-master\pulsar-master\pulsar-common\src\main\java\org\apache\pulsar\common\policies\NamespaceIsolationPolicy.java,0,18,0,10,0,28
 pulsar-master\pulsar-master\pulsar-functions\worker\src\main\java\org\apache\pulsar\functions\worker\service\api\package-info.java,0,1,0,1,0,2
 pulsar-master\pulsar-master\pulsar-broker\src\main\java\org\apache\pulsar\broker\service\schema\validator\StringSchemaDataValidator.java,0,9,1,5,0,15
 pulsar-master\pulsar-master\pulsar-functions\api-java\src\main\java\org\apache\pulsar\functions\api\utils\IdentityFunction.java,0,2,0,1,0,3
 pulsar-master\pulsar-master\pulsar-broker\src\test\java\org\apache\pulsar\broker\transaction\TransactionTest.java,854,228,64,163,0,455
 pulsar-master\pulsar-master\pulsar-broker\src\main\java\org\apache\pulsar\broker\service\nonpersistent\package-info.java,0,0,0,1,0,1
 pulsar-master\pulsar-master\pulsar-common\src\main\java\org\apache\pulsar\common\stats\JvmDefaultGCMetricsLogger.java,106,31,12,10,0,53
 pulsar-master\pulsar-master\pulsar-client\src\test\java\org\apache\pulsar\client\api\AuthenticationTest.java,73,16,0,12,0,28
 pulsar-master\pulsar-master\pulsar-broker\src\main\java\org\apache\pulsar\PulsarBrokerStarter.java,299,78,8,55,0,141
 pulsar-master\pulsar-master\pulsar-client-api\src\main\java\org\apache\pulsar\client\api\Consumer.java,0,113,0,114,0,227
 pulsar-master\pulsar-master\pulsar-common\src\main\java\org\apache\pulsar\common\util\netty\EventLoopUtil.java,82,29,3,14,0,46
 pulsar-master\pulsar-master\pulsar-io\debezium\postgres\src\main\java\org\apache\pulsar\io\debezium\postgres\DebeziumPostgresSource.java,9,6,0,4,0,10
 pulsar-master\pulsar-master\pulsar-client\src\test\java\org\apache\pulsar\client\impl\ProducerImplTest.java,24,4,0,3,0,7
 pulsar-master\pulsar-master\pulsar-client\src\main\java\org\apache\pulsar\client\impl\ClientBuilderImpl.java,316,135,3,30,0,168
 pulsar-master\pulsar-master\pulsar-client-admin-api\src\main\java\org\apache\pulsar\common\policies\data\SubscribeRate.java,40,21,1,6,0,28
 pulsar-master\pulsar-master\tests\integration\src\test\java\org\apache\pulsar\tests\integration\transaction\TransactionTest.java,123,24,1,19,0,44
 pulsar-master\pulsar-master\pulsar-io\flume\src\main\java\org\apache\pulsar\io\flume\node\AbstractConfigurationProvider.java,489,106,4,63,0,173
 pulsar-master\pulsar-master\pulsar-client-tools\src\main\java\org\apache\pulsar\client\cli\PulsarClientTool.java,184,76,1,31,0,108
 pulsar-master\pulsar-master\pulsar-metadata\src\main\java\org\apache\pulsar\metadata\impl\EtcdMetadataStore.java,363,100,10,54,0,164
 pulsar-master\pulsar-master\pulsar-client-admin\src\main\java\org\apache\pulsar\client\admin\internal\BrokersImpl.java,301,111,0,43,0,154
 pulsar-master\pulsar-master\pulsar-broker\src\test\java\org\apache\pulsar\client\api\ServiceUrlProviderTest.java,138,31,4,16,0,51
 pulsar-master\pulsar-master\pulsar-client-admin\src\main\java\org\apache\pulsar\client\admin\internal\SinksImpl.java,0,282,0,112,0,394
 pulsar-master\pulsar-master\pulsar-client-admin-api\src\main\java\org\apache\pulsar\common\policies\data\BrokerStatus.java,0,8,0,1,0,9
 pulsar-master\pulsar-master\pulsar-broker\src\test\java\org\apache\pulsar\broker\tools\BrokerToolTest.java,36,4,1,3,0,8
 pulsar-master\pulsar-master\tiered-storage\jcloud\src\main\java\org\apache\bookkeeper\mledger\offload\jcloud\impl\StreamingDataBlockHeaderImpl.java,0,43,1,13,0,57
 pulsar-master\pulsar-master\pulsar-sql\presto-pulsar\src\main\java\org\apache\pulsar\sql\presto\PulsarSplitManager.java,390,160,5,94,0,259
 pulsar-master\pulsar-master\pulsar-client-admin-api\src\main\java\org\apache\pulsar\common\policies\data\TransactionCoordinatorStats.java,12,3,0,1,0,4
 pulsar-master\pulsar-master\pulsar-testclient\src\main\java\org\apache\pulsar\testclient\IMessageFormatter.java,0,2,0,1,0,3
 pulsar-master\pulsar-master\tests\integration\src\test\java\org\apache\pulsar\tests\integration\messaging\DelayMessagingTest.java,68,17,1,11,0,29
 pulsar-master\pulsar-master\pulsar-client-tools\src\test\java\org\apache\pulsar\admin\cli\TestCmdSinks.java,685,112,4,19,0,135
 pulsar-master\pulsar-master\pulsar-client\src\main\java\org\apache\pulsar\client\impl\UnackMessageIdWrapper.java,70,23,2,7,0,32
 pulsar-master\pulsar-master\pulsar-client\src\main\java\org\apache\pulsar\client\impl\schema\generic\GenericProtobufNativeReader.java,55,27,0,8,0,35
 pulsar-master\pulsar-master\pulsar-functions\runtime\src\main\java\org\apache\pulsar\functions\runtime\kubernetes\KubernetesRuntime.java,1137,317,19,152,0,488
 pulsar-master\pulsar-master\pulsar-client\src\main\java\org\apache\pulsar\client\impl\auth\AuthenticationBasic.java,0,12,0,4,0,16
 pulsar-master\pulsar-master\pulsar-io\cassandra\src\main\java\org\apache\pulsar\io\cassandra\CassandraSinkConfig.java,41,12,0,3,0,15
 pulsar-master\pulsar-master\pulsar-broker\src\main\java\org\apache\pulsar\broker\service\ServerCnx.java,2807,976,61,682,0,1719
 pulsar-master\pulsar-master\pulsar-functions\utils\src\main\java\org\apache\pulsar\functions\utils\ComponentTypeUtils.java,15,4,1,2,0,7
 pulsar-master\pulsar-master\pulsar-io\hdfs3\src\main\java\org\apache\pulsar\io\hdfs3\sink\HdfsAbstractSink.java,0,29,0,11,0,40
 pulsar-master\pulsar-master\pulsar-functions\worker\src\main\java\org\apache\pulsar\functions\worker\package-info.java,0,0,0,1,0,1
 pulsar-master\pulsar-master\pulsar-io\nsq\src\test\java\org\apache\pulsar\io\nsq\NSQConfigTests.java,76,27,0,1,0,28
 pulsar-master\pulsar-master\pulsar-functions\worker\src\main\java\org\apache\pulsar\functions\worker\rest\api\FunctionsImplV2.java,212,160,3,67,0,230
 pulsar-master\pulsar-master\pulsar-common\src\main\java\org\apache\pulsar\common\functions\Utils.java,58,19,1,2,0,22
 pulsar-master\pulsar-master\tiered-storage\jcloud\src\main\java\org\apache\bookkeeper\mledger\offload\jcloud\BackedInputStream.java,5,2,0,1,0,3
 pulsar-master\pulsar-master\pulsar-client\src\main\java\org\apache\pulsar\client\impl\schema\DoubleSchema.java,86,30,1,3,0,34
 pulsar-master\pulsar-master\tests\integration\src\test\java\org\apache\pulsar\tests\integration\schema\JodaTimeTest.java,95,33,0,8,0,41
 pulsar-master\pulsar-master\pulsar-client-admin-api\src\main\java\org\apache\pulsar\policies\data\loadbalancer\package-info.java,0,2,0,1,0,3
 pulsar-master\pulsar-master\pulsar-metadata\src\main\java\org\apache\pulsar\metadata\api\coordination\LockManager.java,0,12,0,9,0,21
 pulsar-master\pulsar-master\pulsar-client\src\main\java\org\apache\pulsar\client\impl\schema\LocalDateSchema.java,53,10,1,1,0,12
 pulsar-master\pulsar-master\pulsar-proxy\src\test\java\org\apache\pulsar\proxy\server\ProxyServiceTlsStarterTest.java,125,49,7,23,0,79
 pulsar-master\pulsar-master\pulsar-client-admin-api\src\main\java\org\apache\pulsar\common\naming\package-info.java,0,2,0,1,0,3
 pulsar-master\pulsar-master\buildtools\src\test\java\org\apache\pulsar\tests\TestRetrySupportSuccessTest.java,37,4,0,2,0,6
 pulsar-master\pulsar-master\pulsar-metadata\src\main\java\org\apache\pulsar\metadata\impl\batching\MetadataOp.java,0,11,0,1,0,12
 pulsar-master\pulsar-master\pulsar-functions\java-examples\src\main\java\org\apache\pulsar\functions\api\examples\JavaNativeAsyncExclamationFunction.java,0,4,0,2,0,6
 pulsar-master\pulsar-master\pulsar-broker\src\main\java\org\apache\pulsar\broker\service\Topic.java,0,107,5,28,0,140
 pulsar-master\pulsar-master\pulsar-broker\src\main\java\org\apache\pulsar\broker\resourcegroup\ResourceGroupNamespaceConfigListener.java,137,51,7,23,0,81
 pulsar-master\pulsar-master\pulsar-proxy\src\test\java\org\apache\pulsar\proxy\server\ProxyConfigurationTest.java,74,24,1,16,0,41
 pulsar-master\pulsar-master\pulsar-broker\src\main\java\org\apache\pulsar\broker\transaction\pendingack\PendingAckStore.java,0,6,0,6,0,12
 pulsar-master\pulsar-master\pulsar-io\flume\src\main\java\org\apache\pulsar\io\flume\source\AbstractSource.java,93,21,2,4,0,27
 pulsar-master\pulsar-master\pulsar-common\src\main\java\org\apache\pulsar\common\util\RateLimitFunction.java,0,1,0,1,0,2
 pulsar-master\pulsar-master\pulsar-io\file\src\main\java\org\apache\pulsar\io\file\utils\GZipFiles.java,51,10,6,3,0,19
 pulsar-master\pulsar-master\pulsar-broker\src\main\java\org\apache\pulsar\compaction\CompactorMXBean.java,0,1,0,1,0,2
 pulsar-master\pulsar-master\pulsar-client-admin-api\src\main\java\org\apache\pulsar\common\policies\data\ConsumerStats.java,0,20,0,2,0,22
 pulsar-master\pulsar-master\pulsar-functions\worker\src\main\java\org\apache\pulsar\functions\worker\WorkerService.java,0,0,0,1,0,1
 pulsar-master\pulsar-master\pulsar-client-api\src\main\java\org\apache\pulsar\client\api\Schema.java,0,125,20,70,0,215
 pulsar-master\pulsar-master\pulsar-io\flume\src\main\java\org\apache\pulsar\io\flume\node\PollingPropertiesFileConfigurationProvider.java,0,40,1,11,0,52
 pulsar-master\pulsar-master\pulsar-broker\src\test\java\org\apache\pulsar\broker\MultiBrokerBaseTest.java,120,36,2,18,0,56
 pulsar-master\pulsar-master\buildtools\src\main\java\org\apache\pulsar\tests\TestRetrySupport.java,72,21,2,13,0,36
 pulsar-master\pulsar-master\pulsar-client-admin-api\src\main\java\org\apache\pulsar\client\admin\Worker.java,0,14,0,4,0,18
 pulsar-master\pulsar-master\pulsar-broker\src\main\java\org\apache\pulsar\broker\delayed\InMemoryDelayedDeliveryTracker.java,0,48,0,15,0,63
 pulsar-master\pulsar-master\managed-ledger\src\test\java\org\apache\bookkeeper\mledger\impl\ManagedLedgerFactoryShutdownTest.java,143,47,1,29,0,77
 pulsar-master\pulsar-master\pulsar-broker\src\test\java\org\apache\pulsar\broker\service\schema\ClientGetSchemaTest.java,130,53,1,29,0,83
 pulsar-master\pulsar-master\pulsar-transaction\coordinator\src\main\java\org\apache\pulsar\transaction\coordinator\impl\package-info.java,0,2,0,1,0,3
 pulsar-master\pulsar-master\pulsar-io\kinesis\src\main\java\org\apache\pulsar\io\kinesis\fbs\EncryptionKey.java,0,107,15,29,0,151
 pulsar-master\pulsar-master\pulsar-proxy\src\main\java\org\apache\pulsar\proxy\extensions\ProxyExtensionsUtils.java,0,29,2,16,0,47
 pulsar-master\pulsar-master\pulsar-functions\runtime\src\test\java\org\apache\pulsar\functions\runtime\RuntimeUtilsTest.java,184,53,2,22,0,77
 pulsar-master\pulsar-master\pulsar-client\src\main\java\org\apache\pulsar\client\impl\schema\package-info.java,0,1,0,1,0,2
 pulsar-master\pulsar-master\pulsar-client\src\main\java\org\apache\pulsar\client\impl\ClientCnx.java,1135,436,39,225,0,700
 pulsar-master\pulsar-master\pulsar-io\influxdb\src\main\java\org\apache\pulsar\io\influxdb\v1\package-info.java,0,1,0,1,0,2
 pulsar-master\pulsar-master\tests\docker-images\java-test-functions\src\main\java\org\apache\pulsar\tests\integration\io\TestPropertySource.java,31,5,2,2,0,9
 pulsar-master\pulsar-master\pulsar-client-admin-api\src\main\java\org\apache\pulsar\common\io\package-info.java,0,2,0,1,0,3
 pulsar-master\pulsar-master\buildtools\src\test\java\org\apache\pulsar\tests\EnumValuesDataProviderTest.java,42,11,2,6,0,19
 pulsar-master\pulsar-master\pulsar-broker\src\main\java\org\apache\pulsar\broker\loadbalance\ServiceRequest.java,4,0,1,1,0,2
 pulsar-master\pulsar-master\pulsar-client-1x-base\pulsar-client-1x\src\main\java\org\apache\pulsar\client\api\Reader.java,0,13,0,8,0,21
 pulsar-master\pulsar-master\pulsar-client\src\test\java\org\apache\pulsar\client\impl\MessageImplTest.java,481,142,9,95,0,246
 pulsar-master\pulsar-master\pulsar-io\netty\src\test\java\org\apache\pulsar\io\netty\server\NettyServerTest.java,140,26,2,2,0,30
 pulsar-master\pulsar-master\pulsar-broker\src\test\java\org\apache\pulsar\broker\admin\AdminApiClusterTest.java,62,16,1,8,0,25
 pulsar-master\pulsar-master\pulsar-io\elastic-search\src\test\java\org\apache\pulsar\io\elasticsearch\v7\ElasticSearch7SinkRawDataTests.java,0,2,0,2,0,4
 pulsar-master\pulsar-master\pulsar-client\src\test\java\org\apache\pulsar\client\impl\ConsumerBuilderImplTest.java,290,69,0,18,0,87
 pulsar-master\pulsar-master\pulsar-client-api\src\main\java\org\apache\pulsar\client\api\interceptor\package-info.java,0,1,0,1,0,2
 pulsar-master\pulsar-master\pulsar-transaction\coordinator\src\main\java\org\apache\pulsar\transaction\coordinator\TransactionMetadataStoreState.java,51,23,3,7,0,33
 pulsar-master\pulsar-master\pulsar-broker\src\main\java\org\apache\pulsar\broker\service\PublishRateLimiter.java,0,6,0,3,0,9
 pulsar-master\pulsar-master\pulsar-client\src\main\java\org\apache\pulsar\client\impl\conf\DefaultCryptoKeyReaderConfigurationData.java,0,24,1,8,0,33
 pulsar-master\pulsar-master\pulsar-client-tools\src\test\java\org\apache\pulsar\admin\cli\TestCmdClusters.java,52,19,0,9,0,28
 pulsar-master\pulsar-master\pulsar-sql\presto-pulsar\src\main\java\org\apache\pulsar\sql\presto\decoder\json\PulsarJsonFieldDecoder.java,0,118,4,48,0,170
 pulsar-master\pulsar-master\pulsar-common\src\main\java\org\apache\pulsar\policies\data\loadbalancer\SystemResourceUsage.java,64,46,0,2,0,48
 pulsar-master\pulsar-master\pulsar-client\src\main\java\org\apache\pulsar\client\impl\auth\AuthenticationDataToken.java,41,11,1,2,0,14
 pulsar-master\pulsar-master\pulsar-io\redis\src\main\java\org\apache\pulsar\io\redis\sink\RedisSink.java,110,21,4,9,0,34
 pulsar-master\pulsar-master\pulsar-common\src\test\java\org\apache\pulsar\common\protocol\CommandUtilsTests.java,198,58,13,29,0,100
 pulsar-master\pulsar-master\pulsar-client\src\test\java\org\apache\pulsar\client\impl\MessageIdCompareToTest.java,374,256,11,98,0,365
 pulsar-master\pulsar-master\pulsar-proxy\src\test\java\org\apache\pulsar\proxy\extensions\SimpleProxyExtensionSeparateThreadPoolTest.java,6,2,0,2,0,4
 pulsar-master\pulsar-master\pulsar-functions\utils\src\test\java\org\apache\pulsar\functions\utils\FunctionConfigUtilsTest.java,551,169,8,101,0,278
 pulsar-master\pulsar-master\buildtools\src\main\java\org\apache\pulsar\tests\PulsarTestListener.java,47,19,3,9,0,31
 pulsar-master\pulsar-master\managed-ledger\src\test\java\org\apache\bookkeeper\mledger\offload\OffloadUtilsTest.java,30,6,0,7,0,13
 pulsar-master\pulsar-master\pulsar-client\src\main\java\org\apache\pulsar\client\impl\schema\ProtobufSchema.java,0,41,5,17,0,63
 pulsar-master\pulsar-master\pulsar-broker\src\main\java\org\apache\pulsar\broker\admin\v2\package-info.java,0,0,0,1,0,1
 pulsar-master\pulsar-master\pulsar-client-admin-api\src\main\java\org\apache\pulsar\common\policies\data\TransactionInPendingAckStats.java,6,1,0,1,0,2
 pulsar-master\pulsar-master\pulsar-sql\presto-pulsar\src\test\java\org\apache\pulsar\sql\presto\decoder\DecoderTestMessage.java,67,62,1,4,0,67
 pulsar-master\pulsar-master\pulsar-common\src\main\java\org\apache\pulsar\common\util\NamespaceBundleStatsComparator.java,0,15,0,4,0,19
 pulsar-master\pulsar-master\pulsar-common\src\main\java\org\apache\pulsar\common\policies\data\stats\CompactionStatsImpl.java,22,6,0,1,0,7
 pulsar-master\pulsar-master\managed-ledger\src\main\java\org\apache\bookkeeper\mledger\util\Futures.java,43,13,1,5,0,19
 pulsar-master\pulsar-master\pulsar-client-admin-api\src\main\java\org\apache\pulsar\client\admin\package-info.java,0,1,0,1,0,2
 pulsar-master\pulsar-master\pulsar-common\src\main\java\org\apache\pulsar\common\util\collections\ConcurrentBitSetRecyclable.java,31,13,1,4,0,18
 pulsar-master\pulsar-master\pulsar-client-tools\src\main\java\org\apache\pulsar\admin\cli\utils\NameValueParameterSplitter.java,0,5,0,4,0,9
 pulsar-master\pulsar-master\pulsar-io\solr\src\main\java\org\apache\pulsar\io\solr\package-info.java,0,1,0,1,0,2
 pulsar-master\pulsar-master\pulsar-io\hdfs3\src\main\java\org\apache\pulsar\io\hdfs3\Compression.java,0,5,0,1,0,6
 pulsar-master\pulsar-master\pulsar-common\src\main\java\org\apache\pulsar\common\policies\path\PolicyPath.java,27,8,1,1,0,10
 pulsar-master\pulsar-master\pulsar-io\kafka-connect-adaptor\src\test\java\org\apache\pulsar\io\kafka\connect\KafkaConnectSinkTest.java,493,113,22,43,0,178
 pulsar-master\pulsar-master\pulsar-common\src\main\java\org\apache\pulsar\common\policies\data\stats\NonPersistentReplicatorStatsImpl.java,16,7,0,4,0,11
 pulsar-master\pulsar-master\pulsar-io\flume\src\main\java\org\apache\pulsar\io\flume\sink\AbstractSink.java,46,17,0,3,0,20
 pulsar-master\pulsar-master\pulsar-io\kafka-connect-adaptor\src\test\java\org\apache\pulsar\io\kafka\connect\PulsarSchemaToKafkaSchemaTest.java,167,51,0,25,0,76
 pulsar-master\pulsar-master\pulsar-broker\src\main\java\org\apache\pulsar\broker\web\plugin\servlet\AdditionalServletWithPulsarService.java,0,2,0,2,0,4
 pulsar-master\pulsar-master\pulsar-functions\java-examples\src\main\java\org\apache\pulsar\functions\api\examples\UserConfigFunction.java,0,4,0,2,0,6
 pulsar-master\pulsar-master\pulsar-common\src\main\java\org\apache\pulsar\common\util\Murmur3_32Hash.java,72,26,2,1,0,29
 pulsar-master\pulsar-master\pulsar-client\src\main\java\org\apache\pulsar\client\impl\ConnectionHandler.java,164,57,16,16,0,89
 pulsar-master\pulsar-master\pulsar-functions\utils\src\main\java\org\apache\pulsar\functions\utils\Exceptions.java,36,10,1,2,0,13
