Class_Location,Class_Length,CheckStyle_Amount,PMD_Amount,SCAX_Amount,SpotBugs_Amount,Total_Amount
rocketmq-develop\rocketmq-develop\openmessaging\src\main\java\io\openmessaging\rocketmq\consumer\PullConsumerImpl.java,145,39,1,13,0,53
rocketmq-develop\rocketmq-develop\broker\src\test\java\org\apache\rocketmq\broker\filter\CommitLogDispatcherCalcBitMapTest.java,160,37,2,10,0,49
rocketmq-develop\rocketmq-develop\common\src\test\java\org\apache\rocketmq\common\MixAllTest.java,82,19,4,6,0,29
rocketmq-develop\rocketmq-develop\broker\src\main\java\org\apache\rocketmq\broker\subscription\SubscriptionGroupManager.java,159,71,2,38,0,111
rocketmq-develop\rocketmq-develop\common\src\main\java\org\apache\rocketmq\common\filter\impl\PolishExpr.java,156,45,8,14,0,67
rocketmq-develop\rocketmq-develop\broker\src\main\java\org\apache\rocketmq\broker\longpolling\NotifyMessageArrivingListener.java,15,15,0,5,0,20
rocketmq-develop\rocketmq-develop\common\src\main\java\org\apache\rocketmq\common\protocol\body\BrokerStatsData.java,33,22,0,1,0,23
rocketmq-develop\rocketmq-develop\namesrv\src\test\java\org\apache\rocketmq\namesrv\processor\ClusterTestRequestProcessorTest.java,63,22,7,9,0,38
rocketmq-develop\rocketmq-develop\remoting\src\main\java\org\apache\rocketmq\remoting\netty\NettyRemotingAbstract.java,569,130,31,89,0,250
rocketmq-develop\rocketmq-develop\store\src\main\java\org\apache\rocketmq\store\SelectMappedBufferResult.java,42,24,0,2,0,26
rocketmq-develop\rocketmq-develop\test\src\main\java\org\apache\rocketmq\test\util\data\collect\DataCollector.java,0,12,0,1,0,13
rocketmq-develop\rocketmq-develop\tools\src\main\java\org\apache\rocketmq\tools\command\CommandUtil.java,115,40,1,31,0,72
rocketmq-develop\rocketmq-develop\common\src\test\java\org\apache\rocketmq\common\filter\FilterAPITest.java,61,11,1,4,0,16
rocketmq-develop\rocketmq-develop\tools\src\main\java\org\apache\rocketmq\tools\command\connection\ConsumerConnectionSubCommand.java,74,18,1,10,0,29
rocketmq-develop\rocketmq-develop\test\src\main\java\org\apache\rocketmq\test\listener\rmq\concurrent\RMQNormalListener.java,46,19,1,5,0,25
rocketmq-develop\rocketmq-develop\namesrv\src\test\java\org\apache\rocketmq\namesrv\routeinfo\RouteInfoManagerBrokerPermTest.java,81,27,2,8,0,37
rocketmq-develop\rocketmq-develop\openmessaging\src\main\java\io\openmessaging\rocketmq\producer\ProducerImpl.java,111,32,5,16,0,53
rocketmq-develop\rocketmq-develop\tools\src\main\java\org\apache\rocketmq\tools\command\broker\BrokerStatusSubCommand.java,76,20,0,11,0,31
rocketmq-develop\rocketmq-develop\common\src\main\java\org\apache\rocketmq\common\protocol\body\KVTable.java,12,7,3,1,0,11
rocketmq-develop\rocketmq-develop\store\src\test\java\org\apache\rocketmq\store\StoreStatsServiceTest.java,81,21,5,11,0,37
rocketmq-develop\rocketmq-develop\acl\src\test\java\org\apache\rocketmq\acl\common\AclSignerTest.java,15,8,0,1,0,9
rocketmq-develop\rocketmq-develop\client\src\main\java\org\apache\rocketmq\client\impl\ClientRemotingProcessor.java,235,75,7,49,0,131
rocketmq-develop\rocketmq-develop\common\src\main\java\org\apache\rocketmq\common\protocol\body\CheckClientRequestBody.java,31,21,0,1,0,22
rocketmq-develop\rocketmq-develop\tools\src\main\java\org\apache\rocketmq\tools\command\message\QueryMsgByIdSubCommand.java,245,29,1,18,0,48
rocketmq-develop\rocketmq-develop\tools\src\main\java\org\apache\rocketmq\tools\command\message\QueryMsgTraceByIdSubCommand.java,121,24,0,11,0,35
rocketmq-develop\rocketmq-develop\common\src\main\java\org\apache\rocketmq\common\filter\ExpressionType.java,49,8,2,4,0,14
rocketmq-develop\rocketmq-develop\broker\src\test\java\org\apache\rocketmq\broker\processor\AbstractSendMessageProcessorTest.java,53,12,4,6,0,22
rocketmq-develop\rocketmq-develop\filter\src\main\java\org\apache\rocketmq\filter\expression\PropertyExpression.java,45,10,0,2,0,12
rocketmq-develop\rocketmq-develop\client\src\main\java\org\apache\rocketmq\client\hook\FilterMessageContext.java,54,36,0,2,0,38
rocketmq-develop\rocketmq-develop\common\src\main\java\org\apache\rocketmq\common\protocol\body\GetConsumerStatusBody.java,22,17,0,4,0,21
rocketmq-develop\rocketmq-develop\test\src\main\java\org\apache\rocketmq\test\util\data\collect\impl\ListDataCollectorImpl.java,70,33,1,1,0,35
rocketmq-develop\rocketmq-develop\client\src\main\java\org\apache\rocketmq\client\trace\TraceContext.java,112,74,1,2,0,77
rocketmq-develop\rocketmq-develop\common\src\main\java\org\apache\rocketmq\common\protocol\header\UpdateConsumerOffsetRequestHeader.java,47,29,1,2,0,32
rocketmq-develop\rocketmq-develop\store\src\main\java\org\apache\rocketmq\store\ha\HAService.java,584,118,25,47,0,190
rocketmq-develop\rocketmq-develop\common\src\main\java\org\apache\rocketmq\common\protocol\header\EndTransactionResponseHeader.java,9,1,1,2,0,4
rocketmq-develop\rocketmq-develop\store\src\main\java\org\apache\rocketmq\store\AppendMessageCallback.java,0,26,2,5,0,33
rocketmq-develop\rocketmq-develop\client\src\test\java\org\apache\rocketmq\client\consumer\store\RemoteBrokerOffsetStoreTest.java,93,58,3,29,0,90
rocketmq-develop\rocketmq-develop\test\src\main\java\org\apache\rocketmq\test\util\data\collect\DataFilter.java,0,0,0,1,0,1
rocketmq-develop\rocketmq-develop\tools\src\main\java\org\apache\rocketmq\tools\command\MQAdminStartup.java,184,28,4,20,0,52
rocketmq-develop\rocketmq-develop\common\src\main\java\org\apache\rocketmq\common\utils\CorrelationIdUtil.java,6,2,1,1,0,4
rocketmq-develop\rocketmq-develop\common\src\main\java\org\apache\rocketmq\common\UtilAll.java,564,146,10,25,0,181
rocketmq-develop\rocketmq-develop\remoting\src\main\java\org\apache\rocketmq\remoting\common\SemaphoreReleaseOnlyOnce.java,21,9,0,1,0,10
rocketmq-develop\rocketmq-develop\client\src\test\java\org\apache\rocketmq\client\consumer\DefaultMQPullConsumerTest.java,111,54,7,15,0,76
rocketmq-develop\rocketmq-develop\common\src\main\java\org\apache\rocketmq\common\admin\TopicOffset.java,30,21,0,1,0,22
rocketmq-develop\rocketmq-develop\broker\src\main\java\org\apache\rocketmq\broker\filtersrv\FilterServerUtil.java,21,4,3,2,0,9
rocketmq-develop\rocketmq-develop\store\src\main\java\org\apache\rocketmq\store\ha\WaitNotifyObject.java,86,22,2,5,0,29
rocketmq-develop\rocketmq-develop\test\src\main\java\org\apache\rocketmq\test\util\RandomUtil.java,0,84,8,5,0,97
rocketmq-develop\rocketmq-develop\acl\src\main\java\org\apache\rocketmq\acl\plain\RemoteAddressStrategy.java,0,1,0,1,0,2
rocketmq-develop\rocketmq-develop\common\src\test\java\org\apache\rocketmq\common\admin\TopicStatsTableTest.java,62,19,3,8,0,30
rocketmq-develop\rocketmq-develop\store\src\test\java\org\apache\rocketmq\store\dledger\MessageStoreTestBase.java,106,52,0,17,0,69
rocketmq-develop\rocketmq-develop\client\src\main\java\org\apache\rocketmq\client\consumer\MessageSelector.java,44,12,1,2,0,15
rocketmq-develop\rocketmq-develop\client\src\main\java\org\apache\rocketmq\client\latency\LatencyFaultTolerance.java,0,11,3,2,0,16
rocketmq-develop\rocketmq-develop\tools\src\main\java\org\apache\rocketmq\tools\command\message\CheckMsgSendRTCommand.java,104,25,0,7,0,32
rocketmq-develop\rocketmq-develop\store\src\main\java\org\apache\rocketmq\store\dledger\DLedgerCommitLog.java,946,278,15,137,0,430
rocketmq-develop\rocketmq-develop\tools\src\main\java\org\apache\rocketmq\tools\command\acl\DeleteAccessConfigSubCommand.java,82,18,0,10,0,28
rocketmq-develop\rocketmq-develop\client\src\main\java\org\apache\rocketmq\client\consumer\LitePullConsumer.java,0,37,3,23,0,63
rocketmq-develop\rocketmq-develop\client\src\main\java\org\apache\rocketmq\client\trace\TraceDispatcherType.java,0,2,0,1,0,3
rocketmq-develop\rocketmq-develop\common\src\main\java\org\apache\rocketmq\common\admin\RollbackStats.java,57,42,0,1,0,43
rocketmq-develop\rocketmq-develop\common\src\main\java\org\apache\rocketmq\common\protocol\header\GetBrokerConfigResponseHeader.java,17,8,1,2,0,11
rocketmq-develop\rocketmq-develop\common\src\main\java\org\apache\rocketmq\common\TopicConfig.java,162,98,9,7,0,114
rocketmq-develop\rocketmq-develop\store\src\test\java\org\apache\rocketmq\store\DefaultMessageStoreShutDownTest.java,41,19,1,4,0,24
rocketmq-develop\rocketmq-develop\tools\src\main\java\org\apache\rocketmq\tools\admin\api\MessageTrack.java,36,24,0,2,0,26
rocketmq-develop\rocketmq-develop\tools\src\main\java\org\apache\rocketmq\tools\command\consumer\ConsumerSubCommand.java,104,29,1,20,0,50
rocketmq-develop\rocketmq-develop\client\src\main\java\org\apache\rocketmq\client\producer\DefaultMQProducer.java,0,385,5,165,0,555
rocketmq-develop\rocketmq-develop\test\src\main\java\org\apache\rocketmq\test\util\TestUtils.java,30,7,1,1,0,9
rocketmq-develop\rocketmq-develop\namesrv\src\test\java\org\apache\rocketmq\namesrv\routeinfo\RouteInfoManagerTestBase.java,155,91,0,29,0,120
rocketmq-develop\rocketmq-develop\tools\src\test\java\org\apache\rocketmq\tools\command\topic\UpdateTopicPermSubCommandTest.java,16,7,0,6,0,13
rocketmq-develop\rocketmq-develop\common\src\main\java\org\apache\rocketmq\common\protocol\header\QueryConsumeTimeSpanRequestHeader.java,27,14,1,1,0,16
rocketmq-develop\rocketmq-develop\common\src\main\java\org\apache\rocketmq\common\protocol\heartbeat\ConsumeType.java,0,6,0,1,0,7
rocketmq-develop\rocketmq-develop\client\src\main\java\org\apache\rocketmq\client\consumer\MQPushConsumer.java,0,35,6,10,0,51
rocketmq-develop\rocketmq-develop\tools\src\main\java\org\apache\rocketmq\tools\command\namesrv\UpdateKvConfigCommand.java,50,12,0,5,0,17
rocketmq-develop\rocketmq-develop\filter\src\main\java\org\apache\rocketmq\filter\expression\UnaryInExpression.java,0,26,1,2,0,29
rocketmq-develop\rocketmq-develop\store\src\test\java\org\apache\rocketmq\store\HATest.java,164,106,8,25,0,139
rocketmq-develop\rocketmq-develop\test\src\test\java\org\apache\rocketmq\test\client\producer\async\AsyncSendExceptionIT.java,112,35,2,10,0,47
rocketmq-develop\rocketmq-develop\common\src\main\java\org\apache\rocketmq\common\protocol\header\CreateAccessConfigRequestHeader.java,91,57,1,1,0,59
rocketmq-develop\rocketmq-develop\common\src\main\java\org\apache\rocketmq\common\ServiceState.java,0,4,0,1,0,5
rocketmq-develop\rocketmq-develop\client\src\main\java\org\apache\rocketmq\client\impl\consumer\PullAPIWrapper.java,222,81,8,32,0,121
rocketmq-develop\rocketmq-develop\common\src\main\java\org\apache\rocketmq\common\protocol\body\ClusterAclVersionInfo.java,55,35,0,1,0,36
rocketmq-develop\rocketmq-develop\common\src\main\java\org\apache\rocketmq\common\sysflag\SubscriptionSysFlag.java,30,9,2,1,0,12
rocketmq-develop\rocketmq-develop\tools\src\main\java\org\apache\rocketmq\tools\command\offset\ResetOffsetByTimeCommand.java,101,20,1,12,0,33
rocketmq-develop\rocketmq-develop\client\src\main\java\org\apache\rocketmq\client\MQAdmin.java,0,32,7,7,0,46
rocketmq-develop\rocketmq-develop\client\src\test\java\org\apache\rocketmq\client\trace\TraceDataEncoderTest.java,238,50,1,25,0,76
rocketmq-develop\rocketmq-develop\common\src\test\java\org\apache\rocketmq\common\DataVersionTest.java,48,10,4,1,0,15
rocketmq-develop\rocketmq-develop\store\src\test\java\org\apache\rocketmq\store\ha\WaitNotifyObjectTest.java,20,5,2,1,0,8
rocketmq-develop\rocketmq-develop\common\src\main\java\org\apache\rocketmq\common\protocol\header\namesrv\GetRouteInfoRequestHeader.java,17,8,1,2,0,11
rocketmq-develop\rocketmq-develop\common\src\main\java\org\apache\rocketmq\common\consistenthash\VirtualNode.java,23,15,0,1,0,16
rocketmq-develop\rocketmq-develop\client\src\main\java\org\apache\rocketmq\client\common\ClientErrorCode.java,10,10,0,1,0,11
rocketmq-develop\rocketmq-develop\test\src\main\java\org\apache\rocketmq\test\util\parallel\ParallelTask.java,23,10,0,1,0,11
rocketmq-develop\rocketmq-develop\tools\src\main\java\org\apache\rocketmq\tools\monitor\DefaultMonitorListener.java,62,31,7,13,0,51
rocketmq-develop\rocketmq-develop\remoting\src\test\java\org\apache\rocketmq\remoting\protocol\RemotingSerializableTest.java,0,56,9,9,0,74
rocketmq-develop\rocketmq-develop\broker\src\test\java\org\apache\rocketmq\broker\client\ProducerManagerTest.java,96,26,3,11,0,40
rocketmq-develop\rocketmq-develop\openmessaging\src\test\java\io\openmessaging\rocketmq\producer\ProducerImplTest.java,59,24,4,14,0,42
rocketmq-develop\rocketmq-develop\openmessaging\src\main\java\io\openmessaging\rocketmq\utils\OMSUtil.java,146,30,1,15,0,46
rocketmq-develop\rocketmq-develop\tools\src\main\java\org\apache\rocketmq\tools\monitor\MonitorConfig.java,23,17,0,2,0,19
rocketmq-develop\rocketmq-develop\filter\src\main\java\org\apache\rocketmq\filter\FilterFactory.java,40,14,0,4,0,18
rocketmq-develop\rocketmq-develop\client\src\main\java\org\apache\rocketmq\client\consumer\listener\ConsumeConcurrentlyContext.java,36,22,0,1,0,23
rocketmq-develop\rocketmq-develop\remoting\src\main\java\org\apache\rocketmq\remoting\protocol\RemotingSysResponseCode.java,13,6,0,1,0,7
rocketmq-develop\rocketmq-develop\store\src\main\java\org\apache\rocketmq\store\PutMessageStatus.java,0,11,0,1,0,12
rocketmq-develop\rocketmq-develop\tools\src\test\java\org\apache\rocketmq\tools\command\server\NameServerMocker.java,39,16,2,7,0,25
rocketmq-develop\rocketmq-develop\common\src\test\java\org\apache\rocketmq\common\MQVersionTest.java,25,9,2,3,0,14
rocketmq-develop\rocketmq-develop\tools\src\main\java\org\apache\rocketmq\tools\command\offset\CloneGroupOffsetCommand.java,73,21,0,13,0,34
rocketmq-develop\rocketmq-develop\common\src\main\java\org\apache\rocketmq\common\sysflag\MessageSysFlag.java,24,24,1,1,0,26
rocketmq-develop\rocketmq-develop\test\src\test\java\org\apache\rocketmq\test\client\consumer\broadcast\normal\BroadCastNormalMsgRecvFailIT.java,40,10,2,4,0,16
rocketmq-develop\rocketmq-develop\example\src\main\java\org\apache\rocketmq\example\simple\LitePullConsumerSubscribe.java,20,7,2,3,0,12
rocketmq-develop\rocketmq-develop\common\src\test\java\org\apache\rocketmq\common\message\MessageDecoderTest.java,345,50,8,25,0,83
rocketmq-develop\rocketmq-develop\common\src\main\java\org\apache\rocketmq\common\protocol\body\CMResult.java,0,6,0,1,0,7
rocketmq-develop\rocketmq-develop\common\src\test\java\org\apache\rocketmq\common\protocol\topic\OffsetMovedEventTest.java,44,12,0,6,0,18
rocketmq-develop\rocketmq-develop\logging\src\main\java\org\apache\rocketmq\logging\InnerLoggerFactory.java,0,154,16,21,0,191
rocketmq-develop\rocketmq-develop\test\src\main\java\org\apache\rocketmq\test\clientinterface\MQConsumer.java,0,4,0,1,0,5
rocketmq-develop\rocketmq-develop\client\src\main\java\org\apache\rocketmq\client\producer\RequestResponseFuture.java,99,65,4,3,0,72
rocketmq-develop\rocketmq-develop\namesrv\src\main\java\org\apache\rocketmq\namesrv\processor\ClusterTestRequestProcessor.java,54,21,0,11,0,32
rocketmq-develop\rocketmq-develop\logging\src\main\java\org\apache\rocketmq\logging\inner\Appender.java,205,76,8,4,0,88
rocketmq-develop\rocketmq-develop\test\src\test\java\org\apache\rocketmq\test\lmq\TestBenchLmqStore.java,46,21,0,18,0,39
rocketmq-develop\rocketmq-develop\remoting\src\test\java\org\apache\rocketmq\remoting\RemotingServerTest.java,0,42,4,14,0,60
rocketmq-develop\rocketmq-develop\common\src\main\java\org\apache\rocketmq\common\annotation\ImportantField.java,0,2,0,2,0,4
rocketmq-develop\rocketmq-develop\broker\src\test\java\org\apache\rocketmq\broker\filter\MessageStoreWithFilterTest.java,321,147,10,55,0,212
rocketmq-develop\rocketmq-develop\common\src\main\java\org\apache\rocketmq\common\protocol\body\BrokerStatsItem.java,30,21,0,1,0,22
rocketmq-develop\rocketmq-develop\test\src\test\java\org\apache\rocketmq\test\client\consumer\broadcast\normal\NormalMsgTwoSameGroupConsumerIT.java,46,12,1,6,0,19
rocketmq-develop\rocketmq-develop\test\src\test\java\org\apache\rocketmq\test\tls\TLS_Mix_IT.java,34,10,2,3,0,15
rocketmq-develop\rocketmq-develop\client\src\test\java\org\apache\rocketmq\client\producer\selector\SelectMessageQueueRetryTest.java,37,8,1,2,0,11
rocketmq-develop\rocketmq-develop\example\src\main\java\org\apache\rocketmq\example\batch\SimpleBatchProducer.java,18,10,1,7,0,18
rocketmq-develop\rocketmq-develop\remoting\src\test\java\org\apache\rocketmq\remoting\netty\FileRegionEncoderTest.java,49,7,0,3,0,10
rocketmq-develop\rocketmq-develop\store\src\main\java\org\apache\rocketmq\store\MultiDispatch.java,127,46,3,26,0,75
rocketmq-develop\rocketmq-develop\common\src\test\java\org\apache\rocketmq\common\protocol\body\QueryCorrectionOffsetBodyTest.java,17,6,0,2,0,8
rocketmq-develop\rocketmq-develop\remoting\src\main\java\org\apache\rocketmq\remoting\exception\RemotingTimeoutException.java,17,11,0,3,0,14
rocketmq-develop\rocketmq-develop\filter\src\test\java\org\apache\rocketmq\filter\BitsArrayTest.java,98,24,0,5,0,29
rocketmq-develop\rocketmq-develop\client\src\main\java\org\apache\rocketmq\client\consumer\PullStatus.java,0,4,0,1,0,5
rocketmq-develop\rocketmq-develop\store\src\test\java\org\apache\rocketmq\store\DefaultMessageStoreTest.java,614,205,26,84,0,315
rocketmq-develop\rocketmq-develop\common\src\main\java\org\apache\rocketmq\common\protocol\header\GetMinOffsetRequestHeader.java,27,15,1,2,0,18
rocketmq-develop\rocketmq-develop\common\src\main\java\org\apache\rocketmq\common\protocol\heartbeat\SubscriptionData.java,156,91,16,5,0,112
rocketmq-develop\rocketmq-develop\common\src\main\java\org\apache\rocketmq\common\protocol\header\GetMaxOffsetRequestHeader.java,27,15,1,2,0,18
rocketmq-develop\rocketmq-develop\common\src\main\java\org\apache\rocketmq\common\protocol\heartbeat\HeartbeatData.java,36,23,0,2,0,25
rocketmq-develop\rocketmq-develop\test\src\test\java\org\apache\rocketmq\test\client\consumer\cluster\DynamicAddAndCrashIT.java,70,27,1,15,0,43
rocketmq-develop\rocketmq-develop\common\src\main\java\org\apache\rocketmq\common\protocol\body\ClusterInfo.java,40,22,6,4,0,32
rocketmq-develop\rocketmq-develop\acl\src\main\java\org\apache\rocketmq\acl\AccessValidator.java,0,16,0,2,0,18
rocketmq-develop\rocketmq-develop\common\src\main\java\org\apache\rocketmq\common\message\MessageDecoder.java,544,151,6,41,0,198
rocketmq-develop\rocketmq-develop\remoting\src\main\java\org\apache\rocketmq\remoting\netty\NettyEventType.java,0,4,0,1,0,5
rocketmq-develop\rocketmq-develop\example\src\main\java\org\apache\rocketmq\example\operation\Producer.java,80,9,1,3,0,13
rocketmq-develop\rocketmq-develop\tools\src\test\java\org\apache\rocketmq\tools\admin\DefaultMQAdminExtTest.java,351,161,7,104,0,272
rocketmq-develop\rocketmq-develop\client\src\test\java\org\apache\rocketmq\client\common\ThreadLocalIndexTest.java,18,4,0,1,0,5
rocketmq-develop\rocketmq-develop\tools\src\test\java\org\apache\rocketmq\tools\command\broker\BrokerConsumeStatsSubCommadTest.java,51,23,5,13,0,41
rocketmq-develop\rocketmq-develop\client\src\test\java\org\apache\rocketmq\client\producer\RequestResponseFutureTest.java,20,6,1,2,0,9
rocketmq-develop\rocketmq-develop\test\src\test\java\org\apache\rocketmq\test\client\consumer\broadcast\normal\BroadCastNormalMsgRecvCrashIT.java,58,14,1,8,0,23
rocketmq-develop\rocketmq-develop\client\src\main\java\org\apache\rocketmq\client\impl\consumer\PullResultExt.java,24,20,0,3,0,23
rocketmq-develop\rocketmq-develop\tools\src\test\java\org\apache\rocketmq\tools\command\broker\GetBrokerConfigCommandTest.java,35,6,1,3,0,10
rocketmq-develop\rocketmq-develop\common\src\main\java\org\apache\rocketmq\common\protocol\header\namesrv\DeleteTopicFromNamesrvRequestHeader.java,17,8,1,2,0,11
rocketmq-develop\rocketmq-develop\remoting\src\main\java\org\apache\rocketmq\remoting\common\ServiceThread.java,56,25,5,4,0,34
rocketmq-develop\rocketmq-develop\tools\src\main\java\org\apache\rocketmq\tools\admin\api\TrackType.java,0,6,0,1,0,7
rocketmq-develop\rocketmq-develop\common\src\test\java\org\apache\rocketmq\common\utils\IOTinyUtilsTest.java,132,25,9,7,0,41
rocketmq-develop\rocketmq-develop\logging\src\test\java\org\apache\rocketmq\logging\inner\LoggerRepositoryTest.java,25,2,1,2,0,5
rocketmq-develop\rocketmq-develop\tools\src\test\java\org\apache\rocketmq\tools\command\topic\UpdateOrderConfCommandTest.java,14,6,0,5,0,11
rocketmq-develop\rocketmq-develop\client\src\main\java\org\apache\rocketmq\client\trace\AsyncTraceDispatcher.java,375,150,13,37,0,200
rocketmq-develop\rocketmq-develop\client\src\main\java\org\apache\rocketmq\client\consumer\rebalance\AllocateMessageQueueByConfig.java,23,15,0,3,0,18
rocketmq-develop\rocketmq-develop\tools\src\main\java\org\apache\rocketmq\tools\command\export\ExportMetadataCommand.java,0,39,0,27,0,66
rocketmq-develop\rocketmq-develop\test\src\test\java\org\apache\rocketmq\test\client\producer\oneway\OneWaySendWithMQIT.java,47,16,2,5,0,23
rocketmq-develop\rocketmq-develop\client\src\main\java\org\apache\rocketmq\client\producer\RequestFutureHolder.java,71,29,5,13,0,47
rocketmq-develop\rocketmq-develop\remoting\src\test\java\org\apache\rocketmq\remoting\netty\NettyServerConfigTest.java,12,4,0,3,0,7
rocketmq-develop\rocketmq-develop\client\src\main\java\org\apache\rocketmq\client\hook\SendMessageContext.java,120,89,0,1,0,90
rocketmq-develop\rocketmq-develop\tools\src\test\java\org\apache\rocketmq\tools\command\message\ConsumeMessageCommandTest.java,134,39,24,28,0,91
rocketmq-develop\rocketmq-develop\broker\src\main\java\org\apache\rocketmq\broker\processor\AbstractSendMessageProcessor.java,347,98,12,56,0,166
rocketmq-develop\rocketmq-develop\remoting\src\main\java\org\apache\rocketmq\remoting\common\TlsMode.java,0,13,0,5,0,18
rocketmq-develop\rocketmq-develop\store\src\test\java\org\apache\rocketmq\store\FlushDiskWatcherTest.java,59,9,1,3,0,13
rocketmq-develop\rocketmq-develop\client\src\main\java\org\apache\rocketmq\client\impl\MQClientAPIImpl.java,2133,742,27,490,0,1259
rocketmq-develop\rocketmq-develop\client\src\main\java\org\apache\rocketmq\client\trace\hook\SendMessageOpenTracingHookImpl.java,59,16,0,8,0,24
rocketmq-develop\rocketmq-develop\common\src\main\java\org\apache\rocketmq\common\message\MessageAccessor.java,79,36,1,10,0,47
rocketmq-develop\rocketmq-develop\tools\src\main\java\org\apache\rocketmq\tools\command\topic\UpdateTopicSubCommand.java,159,30,0,23,0,53
rocketmq-develop\rocketmq-develop\remoting\src\main\java\org\apache\rocketmq\remoting\annotation\CFNotNull.java,0,2,0,2,0,4
rocketmq-develop\rocketmq-develop\tools\src\main\java\org\apache\rocketmq\tools\command\consumer\StartMonitoringSubCommand.java,31,12,2,4,0,18
rocketmq-develop\rocketmq-develop\example\src\main\java\org\apache\rocketmq\example\openmessaging\SimplePullConsumer.java,51,7,1,5,0,13
rocketmq-develop\rocketmq-develop\client\src\main\java\org\apache\rocketmq\client\impl\producer\MQProducerInner.java,0,14,3,3,0,20
rocketmq-develop\rocketmq-develop\client\src\test\java\org\apache\rocketmq\client\impl\MQClientAPIImplTest.java,417,192,22,86,0,300
rocketmq-develop\rocketmq-develop\acl\src\main\java\org\apache\rocketmq\acl\AccessResource.java,0,1,0,1,0,2
rocketmq-develop\rocketmq-develop\common\src\main\java\org\apache\rocketmq\common\admin\ConsumeStats.java,34,21,3,5,0,29
rocketmq-develop\rocketmq-develop\remoting\src\main\java\org\apache\rocketmq\remoting\netty\FileRegionEncoder.java,0,11,2,7,0,20
rocketmq-develop\rocketmq-develop\common\src\main\java\org\apache\rocketmq\common\protocol\header\QueryConsumeQueueRequestHeader.java,54,35,1,1,0,37
rocketmq-develop\rocketmq-develop\test\src\test\java\org\apache\rocketmq\test\client\consumer\broadcast\tag\BroadCastTwoConsumerFilterIT.java,46,13,1,6,0,20
rocketmq-develop\rocketmq-develop\acl\src\main\java\org\apache\rocketmq\acl\common\AclClientRPCHook.java,69,27,2,8,0,37
rocketmq-develop\rocketmq-develop\tools\src\test\java\org\apache\rocketmq\tools\command\broker\CleanUnusedTopicCommandTest.java,25,6,1,3,0,10
rocketmq-develop\rocketmq-develop\acl\src\test\java\org\apache\rocketmq\acl\plain\PlainAccessControlFlowTest.java,339,117,3,73,0,193
rocketmq-develop\rocketmq-develop\remoting\src\test\java\org\apache\rocketmq\remoting\TlsTest.java,257,55,12,47,0,114
rocketmq-develop\rocketmq-develop\common\src\main\java\org\apache\rocketmq\common\protocol\header\ResumeCheckHalfMessageRequestHeader.java,23,9,1,2,0,12
rocketmq-develop\rocketmq-develop\test\src\main\java\org\apache\rocketmq\test\listener\rmq\concurrent\RMQDelayListner.java,32,12,1,2,0,15
rocketmq-develop\rocketmq-develop\namesrv\src\test\java\org\apache\rocketmq\namesrv\processor\DefaultRequestProcessorTest.java,371,122,25,83,0,230
rocketmq-develop\rocketmq-develop\client\src\test\java\org\apache\rocketmq\client\utils\MessageUtilsTest.java,50,16,7,9,0,32
rocketmq-develop\rocketmq-develop\logging\src\test\java\org\apache\rocketmq\logging\inner\LayoutTest.java,32,7,1,5,0,13
rocketmq-develop\rocketmq-develop\client\src\main\java\org\apache\rocketmq\client\AccessChannel.java,0,3,0,3,0,6
rocketmq-develop\rocketmq-develop\common\src\test\java\org\apache\rocketmq\common\protocol\ConsumeStatusTest.java,17,11,0,5,0,16
rocketmq-develop\rocketmq-develop\client\src\test\java\org\apache\rocketmq\client\consumer\rebalance\AllocateMessageQueueAveragelyTest.java,33,9,0,2,0,11
rocketmq-develop\rocketmq-develop\client\src\main\java\org\apache\rocketmq\client\impl\producer\TopicPublishInfo.java,95,49,3,5,0,57
rocketmq-develop\rocketmq-develop\remoting\src\main\java\org\apache\rocketmq\remoting\common\Pair.java,0,20,2,1,0,23
rocketmq-develop\rocketmq-develop\tools\src\main\java\org\apache\rocketmq\tools\command\message\QueryMsgByUniqueKeySubCommand.java,156,41,1,25,0,67
rocketmq-develop\rocketmq-develop\namesrv\src\main\java\org\apache\rocketmq\namesrv\routeinfo\BrokerHousekeepingService.java,28,22,2,5,0,29
rocketmq-develop\rocketmq-develop\common\src\main\java\org\apache\rocketmq\common\AclConfig.java,24,16,0,2,0,18
rocketmq-develop\rocketmq-develop\common\src\main\java\org\apache\rocketmq\common\protocol\header\namesrv\AddWritePermOfBrokerResponseHeader.java,17,7,1,1,0,9
rocketmq-develop\rocketmq-develop\remoting\src\main\java\org\apache\rocketmq\remoting\netty\RequestTask.java,67,39,6,6,0,51
rocketmq-develop\rocketmq-develop\namesrv\src\main\java\org\apache\rocketmq\namesrv\processor\DefaultRequestProcessor.java,533,157,22,104,0,283
rocketmq-develop\rocketmq-develop\client\src\main\java\org\apache\rocketmq\client\consumer\listener\ConsumeOrderlyContext.java,30,22,0,2,0,24
rocketmq-develop\rocketmq-develop\remoting\src\test\java\org\apache\rocketmq\remoting\protocol\RemotingCommandTest.java,0,99,13,37,0,149
rocketmq-develop\rocketmq-develop\common\src\main\java\org\apache\rocketmq\common\filter\impl\Operand.java,8,2,0,1,0,3
rocketmq-develop\rocketmq-develop\acl\src\main\java\org\apache\rocketmq\acl\common\SessionCredentials.java,140,72,11,7,0,90
rocketmq-develop\rocketmq-develop\broker\src\test\java\org\apache\rocketmq\broker\processor\ReplyMessageProcessorTest.java,75,34,4,16,0,54
rocketmq-develop\rocketmq-develop\client\src\main\java\org\apache\rocketmq\client\impl\CommunicationMode.java,0,3,0,1,0,4
rocketmq-develop\rocketmq-develop\tools\src\test\java\org\apache\rocketmq\tools\command\broker\SendMsgStatusCommandTest.java,39,14,5,7,0,26
rocketmq-develop\rocketmq-develop\common\src\main\java\org\apache\rocketmq\common\ServiceThread.java,139,46,11,7,0,64
rocketmq-develop\rocketmq-develop\client\src\main\java\org\apache\rocketmq\client\consumer\listener\ConsumeReturnType.java,0,5,0,1,0,6
rocketmq-develop\rocketmq-develop\filter\src\test\java\org\apache\rocketmq\filter\BloomFilterTest.java,145,50,2,13,0,65
rocketmq-develop\rocketmq-develop\tools\src\main\java\org\apache\rocketmq\tools\command\offset\ResetOffsetByTimeOldCommand.java,98,30,0,15,0,45
rocketmq-develop\rocketmq-develop\remoting\src\main\java\org\apache\rocketmq\remoting\netty\NettyClientConfig.java,140,111,0,14,0,125
rocketmq-develop\rocketmq-develop\client\src\main\java\org\apache\rocketmq\client\hook\EndTransactionContext.java,66,49,0,1,0,50
rocketmq-develop\rocketmq-develop\client\src\main\java\org\apache\rocketmq\client\hook\ConsumeMessageHook.java,0,5,2,1,0,8
rocketmq-develop\rocketmq-develop\remoting\src\test\java\org\apache\rocketmq\remoting\netty\NettyRemotingAbstractTest.java,77,24,3,10,0,37
rocketmq-develop\rocketmq-develop\test\src\main\java\org\apache\rocketmq\test\sendresult\ResultWrapper.java,44,30,0,1,0,31
rocketmq-develop\rocketmq-develop\broker\src\main\java\org\apache\rocketmq\broker\topic\TopicConfigManager.java,435,115,10,55,0,180
rocketmq-develop\rocketmq-develop\example\src\main\java\org\apache\rocketmq\example\tracemessage\TraceProducer.java,25,9,2,3,0,14
rocketmq-develop\rocketmq-develop\store\src\main\java\org\apache\rocketmq\store\GetMessageResult.java,117,69,0,3,0,72
rocketmq-develop\rocketmq-develop\client\src\main\java\org\apache\rocketmq\client\impl\consumer\ConsumeMessageOrderlyService.java,517,164,15,92,0,271
rocketmq-develop\rocketmq-develop\broker\src\main\java\org\apache\rocketmq\broker\processor\ReplyMessageProcessor.java,298,93,6,66,0,165
rocketmq-develop\rocketmq-develop\namesrv\src\main\java\org\apache\rocketmq\namesrv\kvconfig\KVConfigSerializeWrapper.java,12,9,3,3,0,15
rocketmq-develop\rocketmq-develop\acl\src\test\java\org\apache\rocketmq\acl\common\PermissionTest.java,165,55,1,12,0,68
rocketmq-develop\rocketmq-develop\logging\src\test\java\org\apache\rocketmq\logging\BasicLoggerTest.java,40,15,2,4,0,21
rocketmq-develop\rocketmq-develop\namesrv\src\test\java\org\apache\rocketmq\namesrv\kvconfig\KVConfigSerializeWrapperTest.java,29,10,0,7,0,17
rocketmq-develop\rocketmq-develop\test\src\test\java\org\apache\rocketmq\test\client\producer\exception\msg\ChinaPropIT.java,42,10,1,2,0,13
rocketmq-develop\rocketmq-develop\client\src\main\java\org\apache\rocketmq\client\trace\hook\SendMessageTraceHookImpl.java,70,15,0,7,0,22
rocketmq-develop\rocketmq-develop\broker\src\test\java\org\apache\rocketmq\broker\transaction\queue\TransactionalMessageServiceImplTest.java,186,88,3,39,0,130
rocketmq-develop\rocketmq-develop\client\src\main\java\org\apache\rocketmq\client\consumer\MQConsumer.java,0,21,3,7,0,31
rocketmq-develop\rocketmq-develop\test\src\test\java\org\apache\rocketmq\test\client\consumer\tag\TagMessageWithSameGroupConsumerIT.java,80,24,1,7,0,32
rocketmq-develop\rocketmq-develop\store\src\main\java\org\apache\rocketmq\store\PutMessageReentrantLock.java,14,5,0,2,0,7
rocketmq-develop\rocketmq-develop\common\src\main\java\org\apache\rocketmq\common\protocol\header\SearchOffsetRequestHeader.java,39,22,1,2,0,25
rocketmq-develop\rocketmq-develop\remoting\src\main\java\org\apache\rocketmq\remoting\protocol\RemotingSerializable.java,41,16,3,1,0,20
rocketmq-develop\rocketmq-develop\filter\src\main\java\org\apache\rocketmq\filter\expression\UnaryExpression.java,243,49,7,6,0,62
rocketmq-develop\rocketmq-develop\common\src\main\java\org\apache\rocketmq\common\message\MessageConst.java,76,48,1,11,0,60
rocketmq-develop\rocketmq-develop\openmessaging\src\main\java\io\openmessaging\rocketmq\utils\BeanUtils.java,0,33,6,16,0,55
rocketmq-develop\rocketmq-develop\remoting\src\main\java\org\apache\rocketmq\remoting\exception\RemotingTooMuchRequestException.java,8,2,0,1,0,3
rocketmq-develop\rocketmq-develop\client\src\main\java\org\apache\rocketmq\client\utils\MessageUtil.java,30,15,1,12,0,28
rocketmq-develop\rocketmq-develop\store\src\main\java\org\apache\rocketmq\store\StoreStatsService.java,636,223,21,53,0,297
rocketmq-develop\rocketmq-develop\test\src\main\java\org\apache\rocketmq\test\clientinterface\MQCollector.java,91,40,0,3,0,43
rocketmq-develop\rocketmq-develop\tools\src\main\java\org\apache\rocketmq\tools\command\stats\StatsAllSubCommand.java,169,30,7,15,0,52
rocketmq-develop\rocketmq-develop\client\src\test\java\org\apache\rocketmq\client\impl\consumer\DefaultMQPushConsumerImplTest.java,32,10,0,5,0,15
rocketmq-develop\rocketmq-develop\common\src\main\java\org\apache\rocketmq\common\MQVersion.java,928,619,1,1,0,621
rocketmq-develop\rocketmq-develop\common\src\main\java\org\apache\rocketmq\common\protocol\header\UnregisterClientRequestHeader.java,39,21,1,1,0,23
rocketmq-develop\rocketmq-develop\example\src\main\java\org\apache\rocketmq\example\broadcast\PushConsumer.java,26,12,1,6,0,19
rocketmq-develop\rocketmq-develop\openmessaging\src\main\java\io\openmessaging\rocketmq\consumer\LocalMessageCache.java,0,46,2,24,0,72
rocketmq-develop\rocketmq-develop\broker\src\main\java\org\apache\rocketmq\broker\processor\ConsumerManageProcessor.java,116,39,3,30,0,72
rocketmq-develop\rocketmq-develop\common\src\main\java\org\apache\rocketmq\common\protocol\body\LockBatchRequestBody.java,30,21,0,1,0,22
rocketmq-develop\rocketmq-develop\tools\src\main\java\org\apache\rocketmq\tools\command\broker\CleanExpiredCQSubCommand.java,52,13,1,5,0,19
rocketmq-develop\rocketmq-develop\common\src\main\java\org\apache\rocketmq\common\protocol\header\namesrv\GetKVListByNamespaceRequestHeader.java,17,7,1,1,0,9
rocketmq-develop\rocketmq-develop\example\src\main\java\org\apache\rocketmq\example\simple\Producer.java,25,7,2,2,0,11
rocketmq-develop\rocketmq-develop\tools\src\test\java\org\apache\rocketmq\tools\command\connection\ConsumerConnectionSubCommandTest.java,45,11,1,4,0,16
rocketmq-develop\rocketmq-develop\acl\src\main\java\org\apache\rocketmq\acl\plain\RemoteAddressStrategyFactory.java,0,96,4,36,0,136
rocketmq-develop\rocketmq-develop\common\src\main\java\org\apache\rocketmq\common\protocol\body\ResetOffsetBody.java,12,7,0,1,0,8
rocketmq-develop\rocketmq-develop\broker\src\main\java\org\apache\rocketmq\broker\mqtrace\ConsumeMessageContext.java,139,103,0,2,0,105
rocketmq-develop\rocketmq-develop\client\src\main\java\org\apache\rocketmq\client\producer\LocalTransactionState.java,0,3,0,1,0,4
rocketmq-develop\rocketmq-develop\test\src\test\java\org\apache\rocketmq\test\client\producer\order\OrderMsgIT.java,74,20,2,9,0,31
rocketmq-develop\rocketmq-develop\acl\src\main\java\org\apache\rocketmq\acl\common\AclUtils.java,0,89,10,19,0,118
rocketmq-develop\rocketmq-develop\client\src\main\java\org\apache\rocketmq\client\consumer\store\OffsetStore.java,0,25,4,3,0,32
rocketmq-develop\rocketmq-develop\namesrv\src\main\java\org\apache\rocketmq\namesrv\kvconfig\KVConfigManager.java,170,43,5,20,0,68
rocketmq-develop\rocketmq-develop\broker\src\test\java\org\apache\rocketmq\broker\BrokerPathConfigHelperTest.java,20,9,0,8,0,17
rocketmq-develop\rocketmq-develop\example\src\main\java\org\apache\rocketmq\example\quickstart\Producer.java,88,14,1,10,0,25
rocketmq-develop\rocketmq-develop\test\src\main\java\org\apache\rocketmq\test\util\FileUtil.java,85,26,0,2,0,28
rocketmq-develop\rocketmq-develop\broker\src\main\java\org\apache\rocketmq\broker\transaction\queue\GetResult.java,21,14,0,1,0,15
rocketmq-develop\rocketmq-develop\tools\src\main\java\org\apache\rocketmq\tools\command\acl\UpdateAccessConfigSubCommand.java,153,33,0,26,0,59
rocketmq-develop\rocketmq-develop\common\src\main\java\org\apache\rocketmq\common\TopicFilterType.java,0,2,0,1,0,3
rocketmq-develop\rocketmq-develop\common\src\test\java\org\apache\rocketmq\common\protocol\route\TopicRouteDataTest.java,78,21,4,9,0,34
rocketmq-develop\rocketmq-develop\common\src\main\java\org\apache\rocketmq\common\Configuration.java,273,61,7,8,0,76
rocketmq-develop\rocketmq-develop\tools\src\test\java\org\apache\rocketmq\tools\command\topic\AllocateMQSubCommandTest.java,13,6,0,4,0,10
rocketmq-develop\rocketmq-develop\example\src\main\java\org\apache\rocketmq\example\filter\SqlFilterProducer.java,25,5,1,2,0,8
rocketmq-develop\rocketmq-develop\client\src\main\java\org\apache\rocketmq\client\impl\consumer\RebalancePullImpl.java,59,33,2,9,0,44
rocketmq-develop\rocketmq-develop\common\src\main\java\org\apache\rocketmq\common\admin\TopicStatsTable.java,12,8,3,2,0,13
rocketmq-develop\rocketmq-develop\remoting\src\main\java\org\apache\rocketmq\remoting\CommandCustomHeader.java,0,1,0,1,0,2
rocketmq-develop\rocketmq-develop\store\src\main\java\org\apache\rocketmq\store\schedule\DelayOffsetSerializeWrapper.java,13,9,0,1,0,10
rocketmq-develop\rocketmq-develop\common\src\main\java\org\apache\rocketmq\common\message\MessageId.java,26,19,0,1,0,20
rocketmq-develop\rocketmq-develop\logging\src\test\java\org\apache\rocketmq\logging\inner\LoggingBuilderTest.java,86,25,1,11,0,37
rocketmq-develop\rocketmq-develop\test\src\test\java\org\apache\rocketmq\test\client\producer\exception\msg\MessageUserPropIT.java,62,12,1,9,0,22
rocketmq-develop\rocketmq-develop\common\src\test\java\org\apache\rocketmq\common\ConfigManagerTest.java,76,19,5,8,0,32
rocketmq-develop\rocketmq-develop\client\src\main\java\org\apache\rocketmq\client\hook\FilterMessageHook.java,0,3,1,1,0,5
rocketmq-develop\rocketmq-develop\common\src\main\java\org\apache\rocketmq\common\sysflag\TopicSysFlag.java,45,13,1,2,0,16
rocketmq-develop\rocketmq-develop\logging\src\main\java\org\apache\rocketmq\logging\InternalLoggerFactory.java,69,15,4,3,0,22
rocketmq-develop\rocketmq-develop\acl\src\main\java\org\apache\rocketmq\acl\common\AclSigner.java,63,51,2,18,0,71
rocketmq-develop\rocketmq-develop\broker\src\main\java\org\apache\rocketmq\broker\mqtrace\SendMessageHook.java,0,5,2,1,0,8
rocketmq-develop\rocketmq-develop\test\src\main\java\org\apache\rocketmq\test\message\MessageQueueMsg.java,36,19,0,3,0,22
rocketmq-develop\rocketmq-develop\client\src\test\java\org\apache\rocketmq\client\trace\TransactionMQProducerWithOpenTracingTest.java,116,46,4,24,0,74
rocketmq-develop\rocketmq-develop\filter\src\main\java\org\apache\rocketmq\filter\parser\TokenMgrError.java,0,57,5,10,0,72
rocketmq-develop\rocketmq-develop\broker\src\main\java\org\apache\rocketmq\broker\client\ConsumerGroupEvent.java,0,0,0,1,0,1
rocketmq-develop\rocketmq-develop\broker\src\main\java\org\apache\rocketmq\broker\transaction\TransactionStore.java,0,13,3,2,0,18
rocketmq-develop\rocketmq-develop\common\src\main\java\org\apache\rocketmq\common\filter\FilterAPI.java,63,12,2,6,0,20
rocketmq-develop\rocketmq-develop\logging\src\test\java\org\apache\rocketmq\logging\Slf4jLoggerFactoryTest.java,50,8,0,6,0,14
rocketmq-develop\rocketmq-develop\common\src\main\java\org\apache\rocketmq\common\stats\StatsItemSet.java,231,72,6,19,0,97
rocketmq-develop\rocketmq-develop\store\src\main\java\org\apache\rocketmq\store\stats\BrokerStatsManager.java,308,193,3,62,0,258
rocketmq-develop\rocketmq-develop\store\src\main\java\org\apache\rocketmq\store\ConsumeQueueExt.java,579,132,21,40,0,193
rocketmq-develop\rocketmq-develop\common\src\main\java\org\apache\rocketmq\common\protocol\header\GetConsumerListByGroupResponseHeader.java,7,1,1,2,0,4
rocketmq-develop\rocketmq-develop\common\src\main\java\org\apache\rocketmq\common\protocol\header\namesrv\GetKVConfigResponseHeader.java,17,7,1,1,0,9
rocketmq-develop\rocketmq-develop\broker\src\main\java\org\apache\rocketmq\broker\latency\FutureTaskExt.java,18,6,0,1,0,7
rocketmq-develop\rocketmq-develop\common\src\main\java\org\apache\rocketmq\common\protocol\route\QueueData.java,97,53,10,4,0,67
rocketmq-develop\rocketmq-develop\test\src\test\java\org\apache\rocketmq\test\client\consumer\filter\SqlFilterIT.java,101,30,2,11,0,43
rocketmq-develop\rocketmq-develop\test\src\test\java\org\apache\rocketmq\test\client\producer\order\OrderMsgRebalanceIT.java,98,26,2,18,0,46
rocketmq-develop\rocketmq-develop\client\src\test\java\org\apache\rocketmq\client\trace\DefaultMQProducerWithOpenTracingTest.java,104,40,3,21,0,64
rocketmq-develop\rocketmq-develop\common\src\main\java\org\apache\rocketmq\common\protocol\body\ConsumeQueueData.java,80,58,0,1,0,59
rocketmq-develop\rocketmq-develop\client\src\main\java\org\apache\rocketmq\client\impl\consumer\PullMessageService.java,89,29,2,9,0,40
rocketmq-develop\rocketmq-develop\store\src\main\java\org\apache\rocketmq\store\ReferenceResource.java,57,24,5,2,0,31
rocketmq-develop\rocketmq-develop\common\src\main\java\org\apache\rocketmq\common\admin\OffsetWrapper.java,31,21,0,1,0,22
rocketmq-develop\rocketmq-develop\common\src\test\java\org\apache\rocketmq\common\protocol\body\ConsumerRunningInfoTest.java,75,21,1,11,0,33
rocketmq-develop\rocketmq-develop\store\src\test\java\org\apache\rocketmq\store\MappedFileTest.java,30,9,1,3,0,13
rocketmq-develop\rocketmq-develop\client\src\main\java\org\apache\rocketmq\client\trace\TraceBean.java,150,98,0,2,0,100
rocketmq-develop\rocketmq-develop\tools\src\main\java\org\apache\rocketmq\tools\monitor\UndoneMsgs.java,58,37,0,2,0,39
rocketmq-develop\rocketmq-develop\tools\src\test\java\org\apache\rocketmq\tools\command\consumer\ConsumerProgressSubCommandTest.java,52,11,0,4,0,15
rocketmq-develop\rocketmq-develop\client\src\main\java\org\apache\rocketmq\client\impl\consumer\DefaultMQPushConsumerImpl.java,1098,417,31,191,0,639
rocketmq-develop\rocketmq-develop\common\src\main\java\org\apache\rocketmq\common\filter\impl\Operator.java,51,30,9,3,0,42
rocketmq-develop\rocketmq-develop\store\src\test\java\org\apache\rocketmq\store\ScheduleMessageServiceTest.java,144,48,8,29,0,85
rocketmq-develop\rocketmq-develop\tools\src\main\java\org\apache\rocketmq\tools\command\cluster\ClusterListSubCommand.java,242,58,2,46,0,106
rocketmq-develop\rocketmq-develop\broker\src\main\java\org\apache\rocketmq\broker\pagecache\OneMessageTransfer.java,79,30,0,8,0,38
rocketmq-develop\rocketmq-develop\tools\src\main\java\org\apache\rocketmq\tools\command\topic\TopicListSubCommand.java,100,19,1,11,0,31
rocketmq-develop\rocketmq-develop\test\src\main\java\org\apache\rocketmq\test\util\parallel\Task4Test.java,12,4,3,1,0,8
rocketmq-develop\rocketmq-develop\tools\src\main\java\org\apache\rocketmq\tools\command\export\ExportConfigsCommand.java,94,34,0,25,0,59
rocketmq-develop\rocketmq-develop\example\src\main\java\org\apache\rocketmq\example\benchmark\BatchProducer.java,0,111,6,55,0,172
rocketmq-develop\rocketmq-develop\common\src\main\java\org\apache\rocketmq\common\protocol\body\ConsumeByWho.java,48,35,6,1,0,42
rocketmq-develop\rocketmq-develop\broker\src\main\java\org\apache\rocketmq\broker\longpolling\PullRequestHoldService.java,139,48,7,21,0,76
rocketmq-develop\rocketmq-develop\broker\src\main\java\org\apache\rocketmq\broker\latency\BrokerFastFailure.java,100,32,4,18,0,54
rocketmq-develop\rocketmq-develop\filter\src\main\java\org\apache\rocketmq\filter\parser\SelectorParser.java,1317,427,238,26,0,691
rocketmq-develop\rocketmq-develop\logging\src\main\java\org\apache\rocketmq\logging\inner\Logger.java,0,151,5,8,0,164
rocketmq-develop\rocketmq-develop\example\src\main\java\org\apache\rocketmq\example\tracemessage\OpenTracingProducer.java,39,7,1,4,0,12
rocketmq-develop\rocketmq-develop\store\src\main\java\org\apache\rocketmq\store\CommitLog.java,1715,572,59,265,0,896
rocketmq-develop\rocketmq-develop\test\src\main\java\org\apache\rocketmq\test\listener\AbstractListener.java,98,49,5,9,0,63
rocketmq-develop\rocketmq-develop\client\src\main\java\org\apache\rocketmq\client\trace\TraceDispatcher.java,0,11,0,2,0,13
rocketmq-develop\rocketmq-develop\common\src\main\java\org\apache\rocketmq\common\protocol\header\filtersrv\RegisterMessageFilterClassRequestHeader.java,47,29,1,2,0,32
rocketmq-develop\rocketmq-develop\store\src\test\java\org\apache\rocketmq\store\dledger\MixCommitlogTest.java,169,99,0,40,0,139
rocketmq-develop\rocketmq-develop\broker\src\main\java\org\apache\rocketmq\broker\transaction\queue\TransactionalMessageUtil.java,18,7,1,1,0,9
rocketmq-develop\rocketmq-develop\client\src\test\java\org\apache\rocketmq\client\impl\factory\MQClientInstanceTest.java,135,43,0,26,0,69
rocketmq-develop\rocketmq-develop\store\src\main\java\org\apache\rocketmq\store\config\FlushDiskType.java,0,2,0,1,0,3
rocketmq-develop\rocketmq-develop\filter\src\test\java\org\apache\rocketmq\filter\ExpressionTest.java,560,125,28,4,0,157
rocketmq-develop\rocketmq-develop\example\src\main\java\org\apache\rocketmq\example\simple\CachedQueue.java,8,4,2,2,0,8
rocketmq-develop\rocketmq-develop\tools\src\test\java\org\apache\rocketmq\tools\command\namesrv\GetNamesrvConfigCommandTest.java,39,9,0,3,0,12
rocketmq-develop\rocketmq-develop\example\src\main\java\org\apache\rocketmq\example\transaction\TransactionProducer.java,39,17,1,7,0,25
rocketmq-develop\rocketmq-develop\store\src\test\java\stats\BrokerStatsManagerTest.java,149,72,0,42,0,114
rocketmq-develop\rocketmq-develop\test\src\test\java\org\apache\rocketmq\test\client\producer\oneway\OneWaySendWithSelectorIT.java,69,25,2,11,0,38
rocketmq-develop\rocketmq-develop\remoting\src\main\java\org\apache\rocketmq\remoting\ChannelEventListener.java,0,13,4,1,0,18
rocketmq-develop\rocketmq-develop\client\src\main\java\org\apache\rocketmq\client\producer\RequestCallback.java,0,4,2,1,0,7
rocketmq-develop\rocketmq-develop\common\src\test\java\org\apache\rocketmq\common\protocol\ClusterInfoTest.java,67,15,1,10,0,26
rocketmq-develop\rocketmq-develop\test\src\test\java\org\apache\rocketmq\test\client\producer\order\OrderMsgWithTagIT.java,135,29,1,15,0,45
rocketmq-develop\rocketmq-develop\store\src\test\java\org\apache\rocketmq\store\schedule\ScheduleMessageServiceTest.java,188,68,3,20,0,91
rocketmq-develop\rocketmq-develop\example\src\main\java\org\apache\rocketmq\example\simple\PullConsumer.java,114,29,5,20,0,54
rocketmq-develop\rocketmq-develop\store\src\main\java\org\apache\rocketmq\store\config\BrokerRole.java,0,4,0,1,0,5
rocketmq-develop\rocketmq-develop\test\src\test\java\org\apache\rocketmq\test\client\consumer\broadcast\BaseBroadCastIT.java,32,22,1,7,0,30
rocketmq-develop\rocketmq-develop\client\src\main\java\org\apache\rocketmq\client\consumer\rebalance\AllocateMessageQueueAveragelyByCircle.java,40,12,0,5,0,17
rocketmq-develop\rocketmq-develop\store\src\main\java\org\apache\rocketmq\store\FlushDiskWatcher.java,52,17,0,6,0,23
rocketmq-develop\rocketmq-develop\tools\src\main\java\org\apache\rocketmq\tools\command\topic\UpdateTopicPermSubCommand.java,131,23,3,18,0,44
rocketmq-develop\rocketmq-develop\common\src\main\java\org\apache\rocketmq\common\namesrv\TopAddressing.java,77,27,1,6,0,34
rocketmq-develop\rocketmq-develop\example\src\main\java\org\apache\rocketmq\example\schedule\ScheduledMessageConsumer.java,26,13,1,6,0,20
rocketmq-develop\rocketmq-develop\common\src\test\java\org\apache\rocketmq\common\MessageBatchTest.java,47,12,5,1,0,18
rocketmq-develop\rocketmq-develop\openmessaging\src\main\java\io\openmessaging\rocketmq\promise\FutureState.java,0,11,1,1,0,13
rocketmq-develop\rocketmq-develop\common\src\main\java\org\apache\rocketmq\common\constant\PermName.java,36,11,1,1,0,13
rocketmq-develop\rocketmq-develop\common\src\main\java\org\apache\rocketmq\common\Pair.java,0,19,2,1,0,22
rocketmq-develop\rocketmq-develop\common\src\main\java\org\apache\rocketmq\common\protocol\header\DeleteSubscriptionGroupRequestHeader.java,27,15,1,2,0,18
rocketmq-develop\rocketmq-develop\common\src\main\java\org\apache\rocketmq\common\protocol\header\NotifyConsumerIdsChangedRequestHeader.java,17,8,1,2,0,11
rocketmq-develop\rocketmq-develop\store\src\main\java\org\apache\rocketmq\store\index\IndexFile.java,238,88,14,29,0,131
rocketmq-develop\rocketmq-develop\client\src\main\java\org\apache\rocketmq\client\consumer\listener\MessageListenerConcurrently.java,0,8,1,4,0,13
rocketmq-develop\rocketmq-develop\remoting\src\main\java\org\apache\rocketmq\remoting\netty\NettyEvent.java,29,18,0,2,0,20
rocketmq-develop\rocketmq-develop\tools\src\test\java\org\apache\rocketmq\tools\command\offset\GetConsumerStatusCommandTest.java,39,13,0,6,0,19
rocketmq-develop\rocketmq-develop\store\src\main\java\org\apache\rocketmq\store\schedule\ScheduleMessageService.java,755,302,24,109,0,435
rocketmq-develop\rocketmq-develop\common\src\main\java\org\apache\rocketmq\common\message\MessageExt.java,236,153,1,14,0,168
rocketmq-develop\rocketmq-develop\common\src\main\java\org\apache\rocketmq\common\message\MessageClientExt.java,26,8,0,1,0,9
rocketmq-develop\rocketmq-develop\tools\src\test\java\org\apache\rocketmq\tools\command\consumer\ConsumerStatusSubCommandTest.java,43,10,1,4,0,15
rocketmq-develop\rocketmq-develop\broker\src\main\java\org\apache\rocketmq\broker\client\rebalance\RebalanceLockManager.java,238,49,4,27,0,80
rocketmq-develop\rocketmq-develop\example\src\main\java\org\apache\rocketmq\example\schedule\ScheduledMessageProducer.java,21,10,1,3,0,14
rocketmq-develop\rocketmq-develop\common\src\test\java\org\apache\rocketmq\common\utils\NameServerAddressUtilsTest.java,37,17,0,11,0,28
rocketmq-develop\rocketmq-develop\filter\src\main\java\org\apache\rocketmq\filter\parser\Token.java,0,29,1,3,0,33
rocketmq-develop\rocketmq-develop\common\src\test\java\org\apache\rocketmq\common\protocol\body\ConsumerConnectionTest.java,52,8,3,6,0,17
rocketmq-develop\rocketmq-develop\common\src\main\java\org\apache\rocketmq\common\protocol\header\GetTopicStatsInfoRequestHeader.java,17,7,1,1,0,9
rocketmq-develop\rocketmq-develop\store\src\main\java\org\apache\rocketmq\store\CommitLogDispatcher.java,0,3,1,2,0,6
rocketmq-develop\rocketmq-develop\common\src\test\java\org\apache\rocketmq\common\protocol\body\KVTableTest.java,21,4,1,3,0,8
rocketmq-develop\rocketmq-develop\common\src\main\java\org\apache\rocketmq\common\protocol\body\ResetOffsetBodyForC.java,13,7,0,1,0,8
rocketmq-develop\rocketmq-develop\client\src\test\java\org\apache\rocketmq\client\producer\DefaultMQProducerTest.java,449,148,20,51,0,219
rocketmq-develop\rocketmq-develop\test\src\main\java\org\apache\rocketmq\test\factory\MessageFactory.java,38,24,3,5,0,32
rocketmq-develop\rocketmq-develop\namesrv\src\test\java\org\apache\rocketmq\namesrv\routeinfo\RouteInfoManagerStaticRegisterTest.java,115,32,0,9,0,41
rocketmq-develop\rocketmq-develop\broker\src\test\java\org\apache\rocketmq\broker\util\ServiceProviderTest.java,23,8,0,5,0,13
rocketmq-develop\rocketmq-develop\client\src\main\java\org\apache\rocketmq\client\exception\MQBrokerException.java,35,26,0,5,0,31
rocketmq-develop\rocketmq-develop\broker\src\main\java\org\apache\rocketmq\broker\processor\EndTransactionProcessor.java,225,64,5,45,0,114
rocketmq-develop\rocketmq-develop\common\src\main\java\org\apache\rocketmq\common\filter\impl\Op.java,17,8,0,1,0,9
rocketmq-develop\rocketmq-develop\common\src\main\java\org\apache\rocketmq\common\filter\FilterContext.java,12,7,0,1,0,8
rocketmq-develop\rocketmq-develop\filter\src\main\java\org\apache\rocketmq\filter\expression\BooleanExpression.java,0,2,0,2,0,4
rocketmq-develop\rocketmq-develop\client\src\main\java\org\apache\rocketmq\client\consumer\listener\ConsumeOrderlyStatus.java,0,4,0,1,0,5
rocketmq-develop\rocketmq-develop\store\src\main\java\org\apache\rocketmq\store\PutMessageResult.java,37,26,0,5,0,31
rocketmq-develop\rocketmq-develop\example\src\main\java\org\apache\rocketmq\example\simple\PushConsumer.java,21,10,1,6,0,17
rocketmq-develop\rocketmq-develop\test\src\main\java\org\apache\rocketmq\test\factory\ProducerFactory.java,16,4,1,2,0,7
rocketmq-develop\rocketmq-develop\test\src\test\java\org\apache\rocketmq\test\smoke\NormalMessageSendAndRecvIT.java,31,12,2,4,0,18
rocketmq-develop\rocketmq-develop\common\src\main\java\org\apache\rocketmq\common\protocol\header\namesrv\WipeWritePermOfBrokerRequestHeader.java,18,7,1,1,0,9
rocketmq-develop\rocketmq-develop\broker\src\main\java\org\apache\rocketmq\broker\processor\PullMessageProcessor.java,520,161,25,125,0,311
rocketmq-develop\rocketmq-develop\acl\src\test\java\org\apache\rocketmq\acl\plain\PlainPermissionManagerTest.java,237,91,3,40,0,134
rocketmq-develop\rocketmq-develop\common\src\main\java\org\apache\rocketmq\common\ThreadFactoryImpl.java,22,12,0,2,0,14
rocketmq-develop\rocketmq-develop\client\src\test\java\org\apache\rocketmq\client\producer\selector\SelectMessageQueueByHashTest.java,32,8,0,4,0,12
rocketmq-develop\rocketmq-develop\example\src\main\java\org\apache\rocketmq\example\ordermessage\Consumer.java,34,13,3,5,0,21
rocketmq-develop\rocketmq-develop\acl\src\test\java\org\apache\rocketmq\acl\common\SessionCredentialsTest.java,69,57,3,4,0,64
rocketmq-develop\rocketmq-develop\filter\src\main\java\org\apache\rocketmq\filter\parser\SimpleCharStream.java,0,267,41,26,0,334
rocketmq-develop\rocketmq-develop\tools\src\test\java\org\apache\rocketmq\tools\command\message\SendMessageCommandTest.java,46,20,3,9,0,32
rocketmq-develop\rocketmq-develop\common\src\main\java\org\apache\rocketmq\common\protocol\header\namesrv\RegisterBrokerResponseHeader.java,27,14,1,1,0,16
rocketmq-develop\rocketmq-develop\test\src\test\java\org\apache\rocketmq\test\base\dledger\DLedgerProduceAndConsumeIT.java,79,33,1,11,0,45
rocketmq-develop\rocketmq-develop\tools\src\test\java\org\apache\rocketmq\tools\command\acl\ClusterAclConfigVersionListSubCommandTest.java,13,5,0,4,0,9
rocketmq-develop\rocketmq-develop\tools\src\test\java\org\apache\rocketmq\tools\command\namesrv\WipeWritePermSubCommandTest.java,47,10,0,4,0,14
rocketmq-develop\rocketmq-develop\namesrv\src\test\java\org\apache\rocketmq\namesrv\routeinfo\BrokerHousekeepingServiceTest.java,34,9,1,2,0,12
rocketmq-develop\rocketmq-develop\common\src\main\java\org\apache\rocketmq\common\protocol\body\ConsumerConnection.java,60,39,4,3,0,46
rocketmq-develop\rocketmq-develop\tools\src\main\java\org\apache\rocketmq\tools\command\topic\UpdateOrderConfCommand.java,80,17,0,12,0,29
rocketmq-develop\rocketmq-develop\test\src\main\java\org\apache\rocketmq\test\util\Condition.java,0,2,0,1,0,3
rocketmq-develop\rocketmq-develop\broker\src\main\java\org\apache\rocketmq\broker\client\ConsumerIdsChangeListener.java,0,1,0,1,0,2
rocketmq-develop\rocketmq-develop\common\src\main\java\org\apache\rocketmq\common\protocol\header\CreateTopicRequestHeader.java,95,61,0,3,0,64
rocketmq-develop\rocketmq-develop\store\src\main\java\org\apache\rocketmq\store\MessageStore.java,0,68,21,24,0,113
rocketmq-develop\rocketmq-develop\example\src\main\java\org\apache\rocketmq\example\rpc\AsyncRequestProducer.java,37,11,1,3,0,15
rocketmq-develop\rocketmq-develop\client\src\test\java\org\apache\rocketmq\client\consumer\rebalance\AllocateMessageQueueAveragelyByCircleTest.java,0,20,0,8,0,28
rocketmq-develop\rocketmq-develop\acl\src\test\java\org\apache\rocketmq\acl\common\AclUtilsTest.java,284,73,27,32,0,132
rocketmq-develop\rocketmq-develop\client\src\main\java\org\apache\rocketmq\client\producer\TransactionMQProducer.java,0,69,1,18,0,88
rocketmq-develop\rocketmq-develop\test\src\test\java\org\apache\rocketmq\test\client\consumer\balance\NormalMsgStaticBalanceIT.java,76,21,1,13,0,35
rocketmq-develop\rocketmq-develop\broker\src\main\java\org\apache\rocketmq\broker\util\ServiceProvider.java,182,55,13,33,0,101
rocketmq-develop\rocketmq-develop\store\src\main\java\org\apache\rocketmq\store\stats\BrokerStats.java,71,50,4,10,0,64
rocketmq-develop\rocketmq-develop\tools\src\main\java\org\apache\rocketmq\tools\command\consumer\DeleteSubscriptionGroupCommand.java,86,20,0,13,0,33
rocketmq-develop\rocketmq-develop\broker\src\main\java\org\apache\rocketmq\broker\BrokerController.java,1154,461,37,162,0,660
rocketmq-develop\rocketmq-develop\broker\src\main\java\org\apache\rocketmq\broker\plugin\AbstractPluginMessageStore.java,237,119,0,16,0,135
rocketmq-develop\rocketmq-develop\store\src\main\java\org\apache\rocketmq\store\RunningFlags.java,115,41,10,5,0,56
rocketmq-develop\rocketmq-develop\test\src\main\java\org\apache\rocketmq\test\util\data\collect\DataCollectorManager.java,0,20,0,5,0,25
rocketmq-develop\rocketmq-develop\client\src\main\java\org\apache\rocketmq\client\producer\MQProducer.java,0,167,32,42,0,241
rocketmq-develop\rocketmq-develop\broker\src\main\java\org\apache\rocketmq\broker\filter\CommitLogDispatcherCalcBitMap.java,78,25,6,12,0,43
rocketmq-develop\rocketmq-develop\store\src\test\java\org\apache\rocketmq\store\StoreCheckpointTest.java,25,9,0,5,0,14
rocketmq-develop\rocketmq-develop\client\src\main\java\org\apache\rocketmq\client\impl\consumer\MessageQueueLock.java,18,5,0,2,0,7
rocketmq-develop\rocketmq-develop\store\src\test\java\org\apache\rocketmq\store\AppendCallbackTest.java,222,88,8,35,0,131
rocketmq-develop\rocketmq-develop\broker\src\main\java\org\apache\rocketmq\broker\transaction\OperationResult.java,32,21,0,1,0,22
rocketmq-develop\rocketmq-develop\client\src\main\java\org\apache\rocketmq\client\consumer\store\OffsetSerializeWrapper.java,13,9,0,2,0,11
rocketmq-develop\rocketmq-develop\tools\src\main\java\org\apache\rocketmq\tools\command\namesrv\AddWritePermSubCommand.java,53,17,0,9,0,26
rocketmq-develop\rocketmq-develop\tools\src\main\java\org\apache\rocketmq\tools\command\offset\GetConsumerStatusCommand.java,72,17,0,9,0,26
rocketmq-develop\rocketmq-develop\tools\src\main\java\org\apache\rocketmq\tools\command\message\PrintMessageSubCommand.java,137,34,14,21,0,69
rocketmq-develop\rocketmq-develop\srvutil\src\main\java\org\apache\rocketmq\srvutil\AclFileWatchService.java,128,40,9,14,0,63
rocketmq-develop\rocketmq-develop\logging\src\main\java\org\apache\rocketmq\logging\InternalLogger.java,0,21,0,1,0,22
rocketmq-develop\rocketmq-develop\client\src\test\java\org\apache\rocketmq\client\trace\DefaultMQLitePullConsumerWithTraceTest.java,231,83,20,43,0,146
rocketmq-develop\rocketmq-develop\common\src\test\java\org\apache\rocketmq\common\message\MessageTest.java,45,7,2,2,0,11
rocketmq-develop\rocketmq-develop\logging\src\test\java\org\apache\rocketmq\logging\inner\LoggerTest.java,84,13,1,9,0,23
rocketmq-develop\rocketmq-develop\store\src\test\java\org\apache\rocketmq\store\index\IndexFileTest.java,43,19,2,8,0,29
rocketmq-develop\rocketmq-develop\store\src\main\java\org\apache\rocketmq\store\index\IndexHeader.java,99,57,0,1,0,58
rocketmq-develop\rocketmq-develop\common\src\main\java\org\apache\rocketmq\common\topic\TopicValidator.java,139,49,1,15,0,65
rocketmq-develop\rocketmq-develop\client\src\main\java\org\apache\rocketmq\client\producer\selector\SelectMessageQueueByMachineRoom.java,17,12,0,2,0,14
rocketmq-develop\rocketmq-develop\namesrv\src\test\java\org\apache\rocketmq\namesrv\NamesrvControllerTest.java,59,15,0,3,0,18
rocketmq-develop\rocketmq-develop\client\src\main\java\org\apache\rocketmq\client\trace\hook\EndTransactionTraceHookImpl.java,49,12,0,5,0,17
rocketmq-develop\rocketmq-develop\filter\src\main\java\org\apache\rocketmq\filter\util\BitsArray.java,239,59,1,5,0,65
rocketmq-develop\rocketmq-develop\client\src\test\java\org\apache\rocketmq\client\impl\consumer\ConsumeMessageConcurrentlyServiceTest.java,193,83,9,45,0,137
rocketmq-develop\rocketmq-develop\example\src\main\java\org\apache\rocketmq\example\simple\PullConsumerTest.java,26,7,1,3,0,11
rocketmq-develop\rocketmq-develop\remoting\src\main\java\org\apache\rocketmq\remoting\RPCHook.java,0,8,2,2,0,12
rocketmq-develop\rocketmq-develop\broker\src\main\java\org\apache\rocketmq\broker\dledger\DLedgerRoleChangeHandler.java,0,32,5,15,0,52
rocketmq-develop\rocketmq-develop\store\src\main\java\org\apache\rocketmq\store\DispatchRequest.java,154,79,0,2,0,81
rocketmq-develop\rocketmq-develop\filter\src\main\java\org\apache\rocketmq\filter\expression\MQFilterException.java,25,15,0,1,0,16
rocketmq-develop\rocketmq-develop\acl\src\main\java\org\apache\rocketmq\acl\common\AclException.java,49,38,0,2,0,40
rocketmq-develop\rocketmq-develop\broker\src\main\java\org\apache\rocketmq\broker\pagecache\QueryMessageTransfer.java,89,29,0,7,0,36
rocketmq-develop\rocketmq-develop\tools\src\main\java\org\apache\rocketmq\tools\command\topic\TopicClusterSubCommand.java,40,8,0,3,0,11
rocketmq-develop\rocketmq-develop\common\src\test\java\org\apache\rocketmq\common\RemotingUtilTest.java,21,3,0,1,0,4
rocketmq-develop\rocketmq-develop\broker\src\main\java\org\apache\rocketmq\broker\processor\AdminBrokerProcessor.java,1499,414,65,324,0,803
rocketmq-develop\rocketmq-develop\common\src\main\java\org\apache\rocketmq\common\stats\RTStatsItem.java,16,10,0,5,0,15
rocketmq-develop\rocketmq-develop\common\src\main\java\org\apache\rocketmq\common\protocol\header\GetConsumerListByGroupRequestHeader.java,17,8,1,2,0,11
rocketmq-develop\rocketmq-develop\test\src\main\java\org\apache\rocketmq\test\client\rmq\RMQTransactionalProducer.java,78,29,0,7,0,36
rocketmq-develop\rocketmq-develop\store\src\main\java\org\apache\rocketmq\store\AllocateMappedFileService.java,279,95,25,39,0,159
rocketmq-develop\rocketmq-develop\common\src\main\java\org\apache\rocketmq\common\protocol\header\GetConsumerListByGroupResponseBody.java,12,7,0,1,0,8
rocketmq-develop\rocketmq-develop\broker\src\main\java\org\apache\rocketmq\broker\client\ProducerManager.java,146,52,6,29,0,87
rocketmq-develop\rocketmq-develop\test\src\test\java\org\apache\rocketmq\test\delay\DelayConf.java,7,2,0,1,0,3
rocketmq-develop\rocketmq-develop\common\src\main\java\org\apache\rocketmq\common\stats\StatsSnapshot.java,40,28,0,1,0,29
rocketmq-develop\rocketmq-develop\store\src\test\java\org\apache\rocketmq\store\DefaultMessageStoreCleanFilesTest.java,484,202,16,101,0,319
rocketmq-develop\rocketmq-develop\client\src\main\java\org\apache\rocketmq\client\hook\CheckForbiddenHook.java,0,4,1,2,0,7
rocketmq-develop\rocketmq-develop\example\src\main\java\org\apache\rocketmq\example\rpc\RequestProducer.java,25,6,1,3,0,10
rocketmq-develop\rocketmq-develop\test\src\main\java\org\apache\rocketmq\test\factory\SendCallBackFactory.java,14,4,3,1,0,8
rocketmq-develop\rocketmq-develop\tools\src\main\java\org\apache\rocketmq\tools\command\topic\DeleteTopicSubCommand.java,67,17,0,9,0,26
rocketmq-develop\rocketmq-develop\broker\src\main\java\org\apache\rocketmq\broker\mqtrace\SendMessageContext.java,220,159,0,2,0,161
rocketmq-develop\rocketmq-develop\client\src\main\java\org\apache\rocketmq\client\hook\EndTransactionHook.java,0,3,1,1,0,5
rocketmq-develop\rocketmq-develop\test\src\test\java\org\apache\rocketmq\test\tls\TLS_IT.java,32,11,2,3,0,16
rocketmq-develop\rocketmq-develop\common\src\main\java\org\apache\rocketmq\common\protocol\route\TopicRouteData.java,110,55,14,11,0,80
rocketmq-develop\rocketmq-develop\common\src\test\java\org\apache\rocketmq\common\topic\TopicValidatorTest.java,119,24,3,11,0,38
rocketmq-develop\rocketmq-develop\client\src\main\java\org\apache\rocketmq\client\impl\consumer\DefaultMQPullConsumerImpl.java,729,350,13,123,0,486
rocketmq-develop\rocketmq-develop\common\src\main\java\org\apache\rocketmq\common\protocol\header\namesrv\UnRegisterBrokerRequestHeader.java,47,29,1,2,0,32
rocketmq-develop\rocketmq-develop\store\src\main\java\org\apache\rocketmq\store\TransientStorePool.java,60,21,1,3,0,25
rocketmq-develop\rocketmq-develop\broker\src\main\java\org\apache\rocketmq\broker\transaction\TransactionalMessageCheckService.java,36,15,0,7,0,22
rocketmq-develop\rocketmq-develop\example\src\main\java\org\apache\rocketmq\example\openmessaging\SimpleProducer.java,51,16,4,8,0,28
rocketmq-develop\rocketmq-develop\openmessaging\src\test\java\io\openmessaging\rocketmq\consumer\PushConsumerImplTest.java,45,15,1,9,0,25
rocketmq-develop\rocketmq-develop\remoting\src\main\java\org\apache\rocketmq\remoting\InvokeCallback.java,0,2,1,1,0,4
rocketmq-develop\rocketmq-develop\common\src\main\java\org\apache\rocketmq\common\protocol\header\SendMessageRequestHeader.java,136,90,1,2,0,93
rocketmq-develop\rocketmq-develop\openmessaging\src\main\java\io\openmessaging\rocketmq\domain\ConsumeRequest.java,34,20,0,2,0,22
rocketmq-develop\rocketmq-develop\remoting\src\main\java\org\apache\rocketmq\remoting\netty\ResponseFuture.java,111,65,3,4,0,72
rocketmq-develop\rocketmq-develop\example\src\main\java\org\apache\rocketmq\example\ordermessage\Producer.java,31,15,1,8,0,24
rocketmq-develop\rocketmq-develop\client\src\main\java\org\apache\rocketmq\client\log\ClientLogger.java,95,36,2,20,0,58
rocketmq-develop\rocketmq-develop\remoting\src\main\java\org\apache\rocketmq\remoting\netty\TlsSystemConfig.java,104,76,0,32,0,108
rocketmq-develop\rocketmq-develop\broker\src\main\java\org\apache\rocketmq\broker\client\ClientHousekeepingService.java,62,37,2,13,0,52
rocketmq-develop\rocketmq-develop\broker\src\test\java\org\apache\rocketmq\broker\processor\AdminBrokerProcessorTest.java,383,144,12,99,0,255
rocketmq-develop\rocketmq-develop\common\src\test\java\org\apache\rocketmq\common\protocol\body\SubscriptionGroupWrapperTest.java,24,12,0,9,0,21
rocketmq-develop\rocketmq-develop\acl\src\test\java\org\apache\rocketmq\acl\plain\PlainAccessValidatorTest.java,906,249,22,189,0,460
rocketmq-develop\rocketmq-develop\common\src\main\java\org\apache\rocketmq\common\stats\MomentStatsItem.java,51,29,3,2,0,34
rocketmq-develop\rocketmq-develop\client\src\main\java\org\apache\rocketmq\client\impl\producer\DefaultMQProducerImpl.java,1534,546,33,270,0,849
rocketmq-develop\rocketmq-develop\filter\src\main\java\org\apache\rocketmq\filter\expression\EmptyEvaluationContext.java,12,3,1,1,0,5
rocketmq-develop\rocketmq-develop\client\src\test\java\org\apache\rocketmq\client\trace\DefaultMQConsumerWithOpenTracingTest.java,150,55,4,26,0,85
rocketmq-develop\rocketmq-develop\remoting\src\main\java\org\apache\rocketmq\remoting\RemotingServer.java,0,32,6,10,0,48
rocketmq-develop\rocketmq-develop\broker\src\test\java\org\apache\rocketmq\broker\transaction\queue\DefaultTransactionalMessageCheckListenerTest.java,72,24,2,13,0,39
rocketmq-develop\rocketmq-develop\tools\src\main\java\org\apache\rocketmq\tools\command\topic\RebalanceResult.java,12,7,0,2,0,9
rocketmq-develop\rocketmq-develop\common\src\main\java\org\apache\rocketmq\common\protocol\header\PullMessageResponseHeader.java,47,29,1,2,0,32
rocketmq-develop\rocketmq-develop\tools\src\main\java\org\apache\rocketmq\tools\command\broker\SendMsgStatusCommand.java,67,21,0,10,0,31
rocketmq-develop\rocketmq-develop\remoting\src\main\java\org\apache\rocketmq\remoting\RemotingService.java,0,3,0,1,0,4
rocketmq-develop\rocketmq-develop\common\src\main\java\org\apache\rocketmq\common\SystemClock.java,6,2,0,1,0,3
rocketmq-develop\rocketmq-develop\tools\src\main\java\org\apache\rocketmq\tools\command\connection\ProducerConnectionSubCommand.java,57,13,1,6,0,20
rocketmq-develop\rocketmq-develop\acl\src\main\java\org\apache\rocketmq\acl\common\Permission.java,90,30,3,9,0,42
rocketmq-develop\rocketmq-develop\common\src\main\java\org\apache\rocketmq\common\protocol\header\DeleteAccessConfigRequestHeader.java,18,7,1,1,0,9
rocketmq-develop\rocketmq-develop\tools\src\main\java\org\apache\rocketmq\tools\command\consumer\ConsumerProgressSubCommand.java,0,79,6,40,0,125
rocketmq-develop\rocketmq-develop\common\src\main\java\org\apache\rocketmq\common\protocol\header\CloneGroupOffsetRequestHeader.java,46,29,1,2,0,32
rocketmq-develop\rocketmq-develop\broker\src\main\java\org\apache\rocketmq\broker\latency\BrokerFixedThreadPoolExecutor.java,32,16,0,12,0,28
rocketmq-develop\rocketmq-develop\client\src\main\java\org\apache\rocketmq\client\impl\consumer\ConsumeMessageService.java,0,15,2,2,0,19
rocketmq-develop\rocketmq-develop\example\src\main\java\org\apache\rocketmq\example\benchmark\AclClient.java,15,8,1,1,0,10
rocketmq-develop\rocketmq-develop\remoting\src\main\java\org\apache\rocketmq\remoting\protocol\RemotingCommand.java,511,209,21,45,0,275
rocketmq-develop\rocketmq-develop\common\src\main\java\org\apache\rocketmq\common\protocol\header\QueryConsumerOffsetResponseHeader.java,17,8,1,2,0,11
rocketmq-develop\rocketmq-develop\test\src\main\java\org\apache\rocketmq\test\util\data\collect\impl\MapDataCollectorImpl.java,84,33,1,2,0,36
rocketmq-develop\rocketmq-develop\tools\src\main\java\org\apache\rocketmq\tools\command\acl\ClusterAclConfigVersionListSubCommand.java,94,21,1,13,0,35
rocketmq-develop\rocketmq-develop\client\src\main\java\org\apache\rocketmq\client\consumer\AllocateMessageQueueStrategy.java,0,8,1,1,0,10
rocketmq-develop\rocketmq-develop\broker\src\main\java\org\apache\rocketmq\broker\mqtrace\ConsumeMessageHook.java,0,5,2,1,0,8
rocketmq-develop\rocketmq-develop\test\src\test\java\org\apache\rocketmq\test\client\consumer\tag\MulTagSubIT.java,121,28,1,12,0,41
rocketmq-develop\rocketmq-develop\namesrv\src\main\java\org\apache\rocketmq\namesrv\NamesrvStartup.java,133,31,3,15,0,49
rocketmq-develop\rocketmq-develop\acl\src\main\java\org\apache\rocketmq\acl\common\SigningAlgorithm.java,0,3,0,1,0,4
rocketmq-develop\rocketmq-develop\client\src\main\java\org\apache\rocketmq\client\impl\factory\MQClientInstance.java,1119,328,27,161,0,516
rocketmq-develop\rocketmq-develop\filter\src\main\java\org\apache\rocketmq\filter\parser\SelectorParserTokenManager.java,902,636,118,13,0,767
rocketmq-develop\rocketmq-develop\test\src\main\java\org\apache\rocketmq\test\util\StatUtil.java,440,144,10,22,0,176
rocketmq-develop\rocketmq-develop\broker\src\test\java\org\apache\rocketmq\broker\util\TransactionalMessageServiceImpl.java,44,23,1,8,0,32
rocketmq-develop\rocketmq-develop\broker\src\main\java\org\apache\rocketmq\broker\client\net\Broker2Client.java,247,91,8,57,0,156
rocketmq-develop\rocketmq-develop\broker\src\test\java\org\apache\rocketmq\broker\pagecache\OneMessageTransferTest.java,29,41,4,7,0,52
rocketmq-develop\rocketmq-develop\common\src\main\java\org\apache\rocketmq\common\protocol\header\namesrv\RegisterOrderTopicRequestHeader.java,28,15,1,2,0,18
rocketmq-develop\rocketmq-develop\common\src\main\java\org\apache\rocketmq\common\protocol\body\QueryConsumeTimeSpanBody.java,12,8,0,1,0,9
rocketmq-develop\rocketmq-develop\tools\src\main\java\org\apache\rocketmq\tools\command\topic\AllocateMQSubCommand.java,61,15,0,8,0,23
rocketmq-develop\rocketmq-develop\tools\src\main\java\org\apache\rocketmq\tools\monitor\DeleteMsgsEvent.java,27,16,0,2,0,18
rocketmq-develop\rocketmq-develop\common\src\main\java\org\apache\rocketmq\common\protocol\header\SearchOffsetResponseHeader.java,17,8,1,2,0,11
rocketmq-develop\rocketmq-develop\common\src\test\java\org\apache\rocketmq\common\protocol\QueryConsumeTimeSpanBodyTest.java,82,50,0,31,0,81
rocketmq-develop\rocketmq-develop\client\src\main\java\org\apache\rocketmq\client\impl\consumer\MQConsumerInner.java,0,16,2,2,0,20
rocketmq-develop\rocketmq-develop\openmessaging\src\main\java\io\openmessaging\rocketmq\domain\BytesMessageImpl.java,89,38,0,2,0,40
rocketmq-develop\rocketmq-develop\remoting\src\main\java\org\apache\rocketmq\remoting\netty\RemotingResponseCallback.java,0,1,0,1,0,2
rocketmq-develop\rocketmq-develop\common\src\main\java\org\apache\rocketmq\common\protocol\body\SubscriptionGroupWrapper.java,23,17,0,3,0,20
rocketmq-develop\rocketmq-develop\common\src\main\java\org\apache\rocketmq\common\queue\ConcurrentTreeMap.java,0,19,3,2,0,24
rocketmq-develop\rocketmq-develop\client\src\main\java\org\apache\rocketmq\client\trace\TraceType.java,0,4,0,1,0,5
rocketmq-develop\rocketmq-develop\test\src\main\java\org\apache\rocketmq\test\util\DuplicateMessageInfo.java,109,28,6,13,0,47
rocketmq-develop\rocketmq-develop\test\src\main\java\org\apache\rocketmq\test\util\MQAdmin.java,136,48,6,15,0,69
rocketmq-develop\rocketmq-develop\test\src\main\java\org\apache\rocketmq\test\clientinterface\AbstractMQProducer.java,125,79,1,5,0,85
rocketmq-develop\rocketmq-develop\tools\src\main\java\org\apache\rocketmq\tools\command\consumer\ConsumerStatusSubCommand.java,116,29,1,20,0,50
rocketmq-develop\rocketmq-develop\broker\src\test\java\org\apache\rocketmq\broker\pagecache\ManyMessageTransferTest.java,41,33,5,5,0,43
rocketmq-develop\rocketmq-develop\store\src\main\java\org\apache\rocketmq\store\index\QueryOffsetResult.java,25,17,0,2,0,19
rocketmq-develop\rocketmq-develop\client\src\main\java\org\apache\rocketmq\client\producer\selector\SelectMessageQueueByRandom.java,10,6,0,2,0,8
rocketmq-develop\rocketmq-develop\store\src\test\java\org\apache\rocketmq\store\BatchPutMessageTest.java,196,76,8,25,0,109
rocketmq-develop\rocketmq-develop\tools\src\test\java\org\apache\rocketmq\tools\command\broker\CleanExpiredCQSubCommandTest.java,25,6,1,3,0,10
rocketmq-develop\rocketmq-develop\test\src\test\java\org\apache\rocketmq\test\client\consumer\topic\OneConsumerMulTopicIT.java,73,18,0,10,0,28
rocketmq-develop\rocketmq-develop\client\src\main\java\org\apache\rocketmq\client\impl\consumer\ProcessQueue.java,401,127,14,24,0,165
rocketmq-develop\rocketmq-develop\openmessaging\src\main\java\io\openmessaging\rocketmq\domain\SendResultImpl.java,19,8,0,1,0,9
rocketmq-develop\rocketmq-develop\tools\src\main\java\org\apache\rocketmq\tools\admin\MQAdminExt.java,0,208,42,71,0,321
rocketmq-develop\rocketmq-develop\broker\src\main\java\org\apache\rocketmq\broker\transaction\AbstractTransactionalMessageCheckListener.java,82,41,1,17,0,59
rocketmq-develop\rocketmq-develop\tools\src\main\java\org\apache\rocketmq\tools\monitor\MonitorListener.java,0,7,1,2,0,10
rocketmq-develop\rocketmq-develop\tools\src\main\java\org\apache\rocketmq\tools\command\consumer\UpdateSubGroupSubCommand.java,161,30,0,24,0,54
rocketmq-develop\rocketmq-develop\example\src\main\java\org\apache\rocketmq\example\transaction\TransactionListenerImpl.java,32,11,0,3,0,14
rocketmq-develop\rocketmq-develop\test\src\main\java\org\apache\rocketmq\test\clientinterface\AbstractMQConsumer.java,92,73,1,1,0,75
rocketmq-develop\rocketmq-develop\client\src\main\java\org\apache\rocketmq\client\consumer\store\ReadOffsetType.java,0,3,0,1,0,4
rocketmq-develop\rocketmq-develop\test\src\main\java\org\apache\rocketmq\test\factory\ConsumerFactory.java,47,39,1,10,0,50
rocketmq-develop\rocketmq-develop\tools\src\main\java\org\apache\rocketmq\tools\command\namesrv\DeleteKvConfigCommand.java,44,11,0,4,0,15
rocketmq-develop\rocketmq-develop\tools\src\main\java\org\apache\rocketmq\tools\command\topic\TopicRouteSubCommand.java,82,20,1,9,0,30
rocketmq-develop\rocketmq-develop\openmessaging\src\test\java\io\openmessaging\rocketmq\consumer\LocalMessageCacheTest.java,54,24,1,6,0,31
rocketmq-develop\rocketmq-develop\tools\src\main\java\org\apache\rocketmq\tools\command\acl\GetAccessConfigSubCommand.java,90,20,2,12,0,34
rocketmq-develop\rocketmq-develop\common\src\main\java\org\apache\rocketmq\common\protocol\header\GetConsumerRunningInfoRequestHeader.java,37,22,1,2,0,25
rocketmq-develop\rocketmq-develop\tools\src\test\java\org\apache\rocketmq\tools\command\consumer\GetConsumerConfigSubCommandTest.java,67,12,1,5,0,18
rocketmq-develop\rocketmq-develop\common\src\main\java\org\apache\rocketmq\common\filter\impl\Type.java,0,5,0,1,0,6
rocketmq-develop\rocketmq-develop\store\src\main\java\org\apache\rocketmq\store\AppendMessageStatus.java,0,6,0,1,0,7
rocketmq-develop\rocketmq-develop\client\src\main\java\org\apache\rocketmq\client\impl\MQAdminImpl.java,392,170,5,88,0,263
rocketmq-develop\rocketmq-develop\store\src\main\java\org\apache\rocketmq\store\MappedFile.java,555,177,29,49,0,255
rocketmq-develop\rocketmq-develop\broker\src\main\java\org\apache\rocketmq\broker\plugin\MessageStorePluginContext.java,34,22,0,2,0,24
rocketmq-develop\rocketmq-develop\common\src\main\java\org\apache\rocketmq\common\protocol\header\SendMessageResponseHeader.java,46,29,1,2,0,32
rocketmq-develop\rocketmq-develop\tools\src\test\java\org\apache\rocketmq\tools\command\connection\ProducerConnectionSubCommandTest.java,44,11,1,5,0,17
rocketmq-develop\rocketmq-develop\filter\src\main\java\org\apache\rocketmq\filter\util\BloomFilterData.java,62,29,6,1,0,36
rocketmq-develop\rocketmq-develop\remoting\src\main\java\org\apache\rocketmq\remoting\exception\RemotingSendRequestException.java,12,5,0,1,0,6
rocketmq-develop\rocketmq-develop\tools\src\main\java\org\apache\rocketmq\tools\command\namesrv\UpdateNamesrvConfigCommand.java,62,7,0,3,0,10
rocketmq-develop\rocketmq-develop\broker\src\main\java\org\apache\rocketmq\broker\transaction\TransactionalMessageService.java,0,12,0,11,0,23
rocketmq-develop\rocketmq-develop\common\src\main\java\org\apache\rocketmq\common\consumer\ConsumeFromWhere.java,0,7,0,1,0,8
rocketmq-develop\rocketmq-develop\broker\src\test\java\org\apache\rocketmq\broker\util\LogTransactionalMessageCheckListener.java,8,3,1,3,0,7
rocketmq-develop\rocketmq-develop\client\src\main\java\org\apache\rocketmq\client\MQHelper.java,58,7,1,5,0,13
rocketmq-develop\rocketmq-develop\broker\src\main\java\org\apache\rocketmq\broker\transaction\jdbc\JDBCTransactionStore.java,207,30,7,9,0,46
rocketmq-develop\rocketmq-develop\remoting\src\main\java\org\apache\rocketmq\remoting\annotation\CFNullable.java,0,1,0,2,0,3
rocketmq-develop\rocketmq-develop\test\src\test\java\org\apache\rocketmq\test\client\consumer\broadcast\tag\BroadCastTwoConsumerSubTagIT.java,43,12,1,6,0,19
rocketmq-develop\rocketmq-develop\common\src\main\java\org\apache\rocketmq\common\protocol\header\ViewMessageResponseHeader.java,7,1,1,2,0,4
rocketmq-develop\rocketmq-develop\example\src\main\java\org\apache\rocketmq\example\tracemessage\OpenTracingPushConsumer.java,38,13,1,9,0,23
rocketmq-develop\rocketmq-develop\store\src\main\java\org\apache\rocketmq\store\MessageArrivingListener.java,0,1,0,1,0,2
rocketmq-develop\rocketmq-develop\client\src\main\java\org\apache\rocketmq\client\exception\RequestTimeoutException.java,36,21,0,1,0,22
rocketmq-develop\rocketmq-develop\common\src\main\java\org\apache\rocketmq\common\protocol\heartbeat\MessageModel.java,0,7,0,1,0,8
rocketmq-develop\rocketmq-develop\remoting\src\main\java\org\apache\rocketmq\remoting\netty\AsyncNettyRequestProcessor.java,8,8,0,3,0,11
rocketmq-develop\rocketmq-develop\tools\src\test\java\org\apache\rocketmq\tools\command\topic\TopicRouteSubCommandTest.java,12,4,0,3,0,7
rocketmq-develop\rocketmq-develop\filter\src\main\java\org\apache\rocketmq\filter\util\BloomFilter.java,278,89,11,14,0,114
rocketmq-develop\rocketmq-develop\tools\src\main\java\org\apache\rocketmq\tools\command\broker\BrokerConsumeStatsSubCommad.java,125,36,1,21,0,58
rocketmq-develop\rocketmq-develop\test\src\test\java\org\apache\rocketmq\test\client\producer\order\OrderMsgDynamicRebalanceIT.java,80,28,1,16,0,45
rocketmq-develop\rocketmq-develop\openmessaging\src\main\java\io\openmessaging\rocketmq\domain\NonStandardKeys.java,0,11,10,1,0,22
rocketmq-develop\rocketmq-develop\common\src\main\java\org\apache\rocketmq\common\protocol\header\GetConsumeStatsInBrokerHeader.java,18,7,1,1,0,9
rocketmq-develop\rocketmq-develop\openmessaging\src\test\java\io\openmessaging\rocketmq\utils\BeanUtilsTest.java,85,54,2,7,0,63
rocketmq-develop\rocketmq-develop\acl\src\main\java\org\apache\rocketmq\acl\plain\PlainAccessResource.java,178,106,2,4,0,112
rocketmq-develop\rocketmq-develop\client\src\main\java\org\apache\rocketmq\client\consumer\listener\ConsumeConcurrentlyStatus.java,0,2,0,1,0,3
rocketmq-develop\rocketmq-develop\filter\src\main\java\org\apache\rocketmq\filter\expression\BinaryExpression.java,65,25,0,4,0,29
rocketmq-develop\rocketmq-develop\common\src\main\java\org\apache\rocketmq\common\protocol\body\LockBatchResponseBody.java,14,7,0,1,0,8
rocketmq-develop\rocketmq-develop\namesrv\src\test\java\org\apache\rocketmq\namesrv\routeinfo\RouteInfoManagerBrokerRegisterTest.java,93,31,1,11,0,43
rocketmq-develop\rocketmq-develop\common\src\main\java\org\apache\rocketmq\common\protocol\header\QueryCorrectionOffsetHeader.java,37,22,1,2,0,25
rocketmq-develop\rocketmq-develop\test\src\test\java\org\apache\rocketmq\test\client\producer\querymsg\QueryMsgByIdExceptionIT.java,52,12,3,3,0,18
rocketmq-develop\rocketmq-develop\store\src\main\java\org\apache\rocketmq\store\MultiPathMappedFileQueue.java,96,23,0,10,0,33
rocketmq-develop\rocketmq-develop\common\src\main\java\org\apache\rocketmq\common\protocol\header\ConsumerSendMsgBackRequestHeader.java,81,51,1,3,0,55
rocketmq-develop\rocketmq-develop\common\src\main\java\org\apache\rocketmq\common\protocol\header\ViewMessageRequestHeader.java,17,8,1,2,0,11
rocketmq-develop\rocketmq-develop\test\src\main\java\org\apache\rocketmq\test\util\TestUtil.java,0,29,1,5,0,35
rocketmq-develop\rocketmq-develop\common\src\main\java\org\apache\rocketmq\common\BrokerConfig.java,821,636,0,48,0,684
rocketmq-develop\rocketmq-develop\test\src\test\java\org\apache\rocketmq\test\client\producer\exception\producer\ProducerGroupAndInstanceNameValidityIT.java,41,7,1,3,0,11
rocketmq-develop\rocketmq-develop\tools\src\main\java\org\apache\rocketmq\tools\monitor\MonitorService.java,269,63,21,32,0,116
rocketmq-develop\rocketmq-develop\tools\src\test\java\org\apache\rocketmq\tools\command\server\ServerResponseMocker.java,109,33,7,7,0,47
rocketmq-develop\rocketmq-develop\broker\src\test\java\org\apache\rocketmq\broker\processor\SendMessageProcessorTest.java,226,86,12,42,0,140
rocketmq-develop\rocketmq-develop\common\src\main\java\org\apache\rocketmq\common\protocol\header\QueryMessageRequestHeader.java,58,36,1,2,0,39
rocketmq-develop\rocketmq-develop\broker\src\main\java\org\apache\rocketmq\broker\client\ConsumerGroupInfo.java,215,89,5,18,0,112
rocketmq-develop\rocketmq-develop\test\src\test\java\org\apache\rocketmq\test\client\producer\oneway\OneWaySendIT.java,33,12,1,4,0,17
rocketmq-develop\rocketmq-develop\client\src\main\java\org\apache\rocketmq\client\consumer\PullCallback.java,0,5,2,1,0,8
rocketmq-develop\rocketmq-develop\common\src\main\java\org\apache\rocketmq\common\protocol\header\filtersrv\RegisterFilterServerResponseHeader.java,27,14,1,1,0,16
rocketmq-develop\rocketmq-develop\common\src\test\java\org\apache\rocketmq\common\CountDownLatch2Test.java,89,11,1,2,0,14
rocketmq-develop\rocketmq-develop\common\src\main\java\org\apache\rocketmq\common\protocol\body\ConsumerRunningInfo.java,285,94,12,34,0,140
rocketmq-develop\rocketmq-develop\broker\src\test\java\org\apache\rocketmq\broker\transaction\queue\TransactionalMessageBridgeTest.java,158,60,0,30,0,90
rocketmq-develop\rocketmq-develop\client\src\test\java\org\apache\rocketmq\client\consumer\store\LocalFileOffsetStoreTest.java,53,34,1,13,0,48
rocketmq-develop\rocketmq-develop\common\src\main\java\org\apache\rocketmq\common\consistenthash\HashFunction.java,0,2,0,1,0,3
rocketmq-develop\rocketmq-develop\client\src\main\java\org\apache\rocketmq\client\trace\TraceView.java,157,98,0,4,0,102
rocketmq-develop\rocketmq-develop\common\src\main\java\org\apache\rocketmq\common\BrokerConfigSingleton.java,19,7,1,1,0,9
rocketmq-develop\rocketmq-develop\tools\src\main\java\org\apache\rocketmq\tools\command\broker\CleanUnusedTopicCommand.java,52,12,1,4,0,17
rocketmq-develop\rocketmq-develop\test\src\test\java\org\apache\rocketmq\test\delay\NormalMsgDelayIT.java,85,37,3,15,0,55
rocketmq-develop\rocketmq-develop\client\src\main\java\org\apache\rocketmq\client\consumer\store\RemoteBrokerOffsetStore.java,208,76,5,33,0,114
rocketmq-develop\rocketmq-develop\example\src\main\java\org\apache\rocketmq\example\openmessaging\SimplePushConsumer.java,32,8,1,4,0,13
rocketmq-develop\rocketmq-develop\store\src\main\java\org\apache\rocketmq\store\StoreCheckpoint.java,95,47,10,6,0,63
rocketmq-develop\rocketmq-develop\common\src\main\java\org\apache\rocketmq\common\protocol\body\ConsumeStatsList.java,30,23,0,3,0,26
rocketmq-develop\rocketmq-develop\common\src\main\java\org\apache\rocketmq\common\protocol\header\GetProducerConnectionListRequestHeader.java,19,8,0,2,0,10
rocketmq-develop\rocketmq-develop\common\src\main\java\org\apache\rocketmq\common\namesrv\RegisterBrokerResult.java,30,21,0,1,0,22
rocketmq-develop\rocketmq-develop\common\src\main\java\org\apache\rocketmq\common\protocol\header\filtersrv\RegisterFilterServerRequestHeader.java,17,8,1,1,0,10
rocketmq-develop\rocketmq-develop\broker\src\main\java\org\apache\rocketmq\broker\client\ConsumerManager.java,155,60,3,31,0,94
rocketmq-develop\rocketmq-develop\common\src\test\java\org\apache\rocketmq\common\protocol\body\BrokerStatsDataTest.java,47,30,0,11,0,41
rocketmq-develop\rocketmq-develop\tools\src\main\java\org\apache\rocketmq\tools\command\message\ConsumeMessageCommand.java,274,51,0,27,0,78
rocketmq-develop\rocketmq-develop\common\src\test\java\org\apache\rocketmq\common\protocol\body\QueryConsumeQueueResponseBodyTest.java,43,7,0,3,0,10
rocketmq-develop\rocketmq-develop\common\src\main\java\org\apache\rocketmq\common\namesrv\NamesrvUtil.java,4,3,0,2,0,5
rocketmq-develop\rocketmq-develop\client\src\main\java\org\apache\rocketmq\client\consumer\rebalance\AllocateMessageQueueConsistentHash.java,89,32,0,9,0,41
rocketmq-develop\rocketmq-develop\client\src\main\java\org\apache\rocketmq\client\impl\consumer\RebalanceLitePullImpl.java,129,51,3,23,0,77
rocketmq-develop\rocketmq-develop\common\src\main\java\org\apache\rocketmq\common\protocol\header\CheckTransactionStateRequestHeader.java,54,37,1,2,0,40
rocketmq-develop\rocketmq-develop\client\src\main\java\org\apache\rocketmq\client\producer\TransactionListener.java,0,7,2,4,0,13
rocketmq-develop\rocketmq-develop\tools\src\test\java\org\apache\rocketmq\tools\command\namesrv\UpdateKvConfigCommandTest.java,37,10,0,4,0,14
rocketmq-develop\rocketmq-develop\client\src\main\java\org\apache\rocketmq\client\producer\SendResult.java,113,81,1,4,0,86
rocketmq-develop\rocketmq-develop\remoting\src\main\java\org\apache\rocketmq\remoting\netty\NettyRemotingServer.java,441,156,6,79,0,241
rocketmq-develop\rocketmq-develop\common\src\main\java\org\apache\rocketmq\common\utils\IOTinyUtils.java,124,37,3,6,0,46
rocketmq-develop\rocketmq-develop\test\src\main\java\org\apache\rocketmq\test\factory\MQMessageFactory.java,100,53,2,13,0,68
rocketmq-develop\rocketmq-develop\tools\src\main\java\org\apache\rocketmq\tools\command\export\ExportMetricsCommand.java,232,75,5,52,0,132
rocketmq-develop\rocketmq-develop\openmessaging\src\main\java\io\openmessaging\rocketmq\domain\RocketMQConstants.java,0,2,1,1,0,4
rocketmq-develop\rocketmq-develop\example\src\main\java\org\apache\rocketmq\example\namespace\PushConsumerWithNamespace.java,16,9,1,4,0,14
rocketmq-develop\rocketmq-develop\remoting\src\main\java\org\apache\rocketmq\remoting\exception\RemotingException.java,12,5,0,1,0,6
rocketmq-develop\rocketmq-develop\namesrv\src\test\java\org\apache\rocketmq\namesrv\NamesrvStartupTest.java,37,9,0,1,0,10
rocketmq-develop\rocketmq-develop\client\src\main\java\org\apache\rocketmq\client\consumer\rebalance\AllocateMessageQueueByMachineRoom.java,55,17,0,4,0,21
rocketmq-develop\rocketmq-develop\common\src\main\java\org\apache\rocketmq\common\MixAll.java,407,111,25,35,0,171
rocketmq-develop\rocketmq-develop\common\src\test\java\org\apache\rocketmq\common\message\MessageClientIDSetterTest.java,46,13,1,2,0,16
rocketmq-develop\rocketmq-develop\openmessaging\src\main\java\io\openmessaging\rocketmq\MessagingAccessPointImpl.java,74,23,0,5,0,28
rocketmq-develop\rocketmq-develop\broker\src\main\java\org\apache\rocketmq\broker\transaction\queue\TransactionalMessageBridge.java,298,122,7,50,0,179
rocketmq-develop\rocketmq-develop\common\src\main\java\org\apache\rocketmq\common\sysflag\PullSysFlag.java,66,25,1,5,0,31
rocketmq-develop\rocketmq-develop\tools\src\main\java\org\apache\rocketmq\tools\command\cluster\CLusterSendMsgRTCommand.java,174,39,5,21,0,65
rocketmq-develop\rocketmq-develop\common\src\main\java\org\apache\rocketmq\common\subscription\SubscriptionGroupConfig.java,152,101,14,11,0,126
rocketmq-develop\rocketmq-develop\example\src\main\java\org\apache\rocketmq\example\simple\LitePullConsumerAssign.java,29,8,2,3,0,13
rocketmq-develop\rocketmq-develop\openmessaging\src\test\java\io\openmessaging\rocketmq\promise\DefaultPromiseTest.java,93,24,4,3,0,31
rocketmq-develop\rocketmq-develop\tools\src\test\java\org\apache\rocketmq\tools\monitor\DefaultMonitorListenerTest.java,55,13,0,3,0,16
rocketmq-develop\rocketmq-develop\common\src\main\java\org\apache\rocketmq\common\filter\MessageFilter.java,0,3,1,1,0,5
rocketmq-develop\rocketmq-develop\client\src\test\java\org\apache\rocketmq\client\ValidatorsTest.java,72,18,4,8,0,30
rocketmq-develop\rocketmq-develop\common\src\main\java\org\apache\rocketmq\common\constant\LoggerName.java,23,23,0,3,0,26
rocketmq-develop\rocketmq-develop\logging\src\main\java\org\apache\rocketmq\logging\Slf4jLoggerFactory.java,137,68,1,1,0,70
rocketmq-develop\rocketmq-develop\remoting\src\main\java\org\apache\rocketmq\remoting\exception\RemotingConnectException.java,12,5,0,1,0,6
rocketmq-develop\rocketmq-develop\broker\src\test\java\org\apache\rocketmq\broker\latency\BrokerFastFailureTest.java,40,6,1,2,0,9
rocketmq-develop\rocketmq-develop\tools\src\main\java\org\apache\rocketmq\tools\command\SubCommandException.java,19,3,0,1,0,4
rocketmq-develop\rocketmq-develop\client\src\main\java\org\apache\rocketmq\client\Validators.java,80,28,1,14,0,43
rocketmq-develop\rocketmq-develop\test\src\test\java\org\apache\rocketmq\test\client\consumer\balance\NormalMsgDynamicBalanceIT.java,81,22,1,13,0,36
rocketmq-develop\rocketmq-develop\acl\src\main\java\org\apache\rocketmq\acl\plain\PlainPermissionManager.java,634,253,17,168,0,438
rocketmq-develop\rocketmq-develop\store\src\test\java\org\apache\rocketmq\store\MultiPathMappedFileQueueTest.java,128,55,0,27,0,82
rocketmq-develop\rocketmq-develop\broker\src\main\java\org\apache\rocketmq\broker\topic\LmqTopicConfigManager.java,27,7,0,2,0,9
rocketmq-develop\rocketmq-develop\client\src\main\java\org\apache\rocketmq\client\impl\consumer\RebalancePushImpl.java,203,72,6,39,0,117
rocketmq-develop\rocketmq-develop\client\src\main\java\org\apache\rocketmq\client\producer\selector\SelectMessageQueueByHash.java,12,6,0,2,0,8
rocketmq-develop\rocketmq-develop\test\src\main\java\org\apache\rocketmq\test\clientinterface\MQProducer.java,0,4,0,1,0,5
rocketmq-develop\rocketmq-develop\filter\src\main\java\org\apache\rocketmq\filter\expression\EvaluationContext.java,0,5,0,2,0,7
rocketmq-develop\rocketmq-develop\tools\src\main\java\org\apache\rocketmq\tools\command\topic\TopicStatusSubCommand.java,68,12,0,6,0,18
rocketmq-develop\rocketmq-develop\filter\src\main\java\org\apache\rocketmq\filter\expression\ComparisonExpression.java,378,100,22,39,0,161
rocketmq-develop\rocketmq-develop\tools\src\main\java\org\apache\rocketmq\tools\command\queue\QueryConsumeQueueCommand.java,128,26,2,16,0,44
rocketmq-develop\rocketmq-develop\tools\src\test\java\org\apache\rocketmq\tools\command\acl\UpdateAccessConfigSubCommandTest.java,60,11,0,11,0,22
rocketmq-develop\rocketmq-develop\broker\src\main\java\org\apache\rocketmq\broker\filter\ExpressionMessageFilter.java,130,41,5,19,0,65
rocketmq-develop\rocketmq-develop\test\src\main\java\org\apache\rocketmq\test\lmq\benchmark\BenchLmqStore.java,256,103,3,52,0,158
rocketmq-develop\rocketmq-develop\client\src\test\java\org\apache\rocketmq\client\consumer\DefaultLitePullConsumerTest.java,601,205,37,108,0,350
rocketmq-develop\rocketmq-develop\broker\src\main\java\org\apache\rocketmq\broker\util\PositiveAtomicCounter.java,21,7,0,1,0,8
rocketmq-develop\rocketmq-develop\tools\src\main\java\org\apache\rocketmq\tools\command\namesrv\GetNamesrvConfigCommand.java,53,11,0,7,0,18
rocketmq-develop\rocketmq-develop\test\src\test\java\org\apache\rocketmq\test\client\consumer\broadcast\order\OrderMsgBroadCastIT.java,42,17,1,6,0,24
rocketmq-develop\rocketmq-develop\common\src\test\java\org\apache\rocketmq\common\RegisterBrokerBodyTest.java,25,10,1,7,0,18
rocketmq-develop\rocketmq-develop\store\src\test\java\org\apache\rocketmq\store\ConsumeQueueExtTest.java,214,46,2,11,0,59
rocketmq-develop\rocketmq-develop\srvutil\src\main\java\org\apache\rocketmq\srvutil\ShutdownHookThread.java,43,14,3,7,0,24
rocketmq-develop\rocketmq-develop\namesrv\src\main\java\org\apache\rocketmq\namesrv\NamesrvController.java,148,64,1,17,0,82
rocketmq-develop\rocketmq-develop\test\src\test\java\org\apache\rocketmq\test\client\producer\batch\BatchSendIT.java,94,20,3,5,0,28
rocketmq-develop\rocketmq-develop\logging\src\test\java\org\apache\rocketmq\logging\InternalLoggerTest.java,40,7,1,6,0,14
rocketmq-develop\rocketmq-develop\namesrv\src\test\java\org\apache\rocketmq\namesrv\kvconfig\KVConfigManagerTest.java,28,12,0,7,0,19
rocketmq-develop\rocketmq-develop\acl\src\main\java\org\apache\rocketmq\acl\plain\PlainAccessValidator.java,128,47,1,33,0,81
rocketmq-develop\rocketmq-develop\filter\src\test\java\org\apache\rocketmq\filter\FilterSpiTest.java,56,5,0,4,0,9
rocketmq-develop\rocketmq-develop\remoting\src\main\java\org\apache\rocketmq\remoting\netty\NettyServerConfig.java,143,111,1,7,0,119
rocketmq-develop\rocketmq-develop\common\src\main\java\org\apache\rocketmq\common\protocol\header\namesrv\RegisterBrokerRequestHeader.java,76,51,1,2,0,54
rocketmq-develop\rocketmq-develop\common\src\main\java\org\apache\rocketmq\common\protocol\heartbeat\ConsumerData.java,64,47,0,5,0,52
rocketmq-develop\rocketmq-develop\client\src\main\java\org\apache\rocketmq\client\consumer\MQPullConsumer.java,0,143,14,32,0,189
rocketmq-develop\rocketmq-develop\test\src\test\java\org\apache\rocketmq\test\base\BaseConf.java,139,109,4,19,0,132
rocketmq-develop\rocketmq-develop\test\src\test\java\org\apache\rocketmq\test\client\producer\oneway\OneWaySendExceptionIT.java,46,20,3,8,0,31
rocketmq-develop\rocketmq-develop\acl\src\test\java\org\apache\rocketmq\acl\plain\RemoteAddressStrategyTest.java,0,139,21,94,0,254
rocketmq-develop\rocketmq-develop\store\src\test\java\org\apache\rocketmq\store\MappedFileQueueTest.java,228,95,2,14,0,111
rocketmq-develop\rocketmq-develop\common\src\main\java\org\apache\rocketmq\common\message\MessageExtBatch.java,20,9,0,1,0,10
rocketmq-develop\rocketmq-develop\remoting\src\main\java\org\apache\rocketmq\remoting\netty\NettyLogger.java,336,91,3,9,0,103
rocketmq-develop\rocketmq-develop\tools\src\test\java\org\apache\rocketmq\tools\command\namesrv\AddWritePermSubCommandTest.java,45,10,0,3,0,13
rocketmq-develop\rocketmq-develop\client\src\main\java\org\apache\rocketmq\client\trace\hook\EndTransactionOpenTracingHookImpl.java,43,13,0,7,0,20
rocketmq-develop\rocketmq-develop\common\src\main\java\org\apache\rocketmq\common\protocol\header\EndTransactionRequestHeader.java,107,59,0,1,0,60
rocketmq-develop\rocketmq-develop\broker\src\test\java\org\apache\rocketmq\broker\processor\ClientManageProcessorTest.java,85,33,3,17,0,53
rocketmq-develop\rocketmq-develop\logging\src\main\java\org\apache\rocketmq\logging\inner\SysLogger.java,71,27,1,1,0,29
rocketmq-develop\rocketmq-develop\remoting\src\main\java\org\apache\rocketmq\remoting\netty\NettyRequestProcessor.java,0,4,0,2,0,6
rocketmq-develop\rocketmq-develop\test\src\test\java\org\apache\rocketmq\test\client\consumer\topic\MulConsumerMulTopicIT.java,77,21,0,12,0,33
rocketmq-develop\rocketmq-develop\common\src\main\java\org\apache\rocketmq\common\protocol\header\GetConsumerStatusRequestHeader.java,37,21,1,1,0,23
rocketmq-develop\rocketmq-develop\filter\src\main\java\org\apache\rocketmq\filter\expression\ConstantExpression.java,106,26,2,4,0,32
rocketmq-develop\rocketmq-develop\tools\src\test\java\org\apache\rocketmq\tools\command\message\QueryMsgTraceByIdSubCommandTest.java,82,19,2,10,0,31
rocketmq-develop\rocketmq-develop\client\src\main\java\org\apache\rocketmq\client\ClientConfig.java,296,170,1,21,0,192
rocketmq-develop\rocketmq-develop\client\src\test\java\org\apache\rocketmq\client\consumer\rebalance\AllocateMachineRoomNearByTest.java,206,230,4,29,0,263
rocketmq-develop\rocketmq-develop\tools\src\test\java\org\apache\rocketmq\tools\monitor\MonitorServiceTest.java,114,37,11,21,0,69
rocketmq-develop\rocketmq-develop\store\src\main\java\org\apache\rocketmq\store\StoreUtil.java,15,10,1,4,0,15
rocketmq-develop\rocketmq-develop\store\src\main\java\org\apache\rocketmq\store\DefaultMessageFilter.java,28,11,0,3,0,14
rocketmq-develop\rocketmq-develop\acl\src\main\java\org\apache\rocketmq\acl\common\AclConstants.java,43,22,0,2,0,24
rocketmq-develop\rocketmq-develop\client\src\main\java\org\apache\rocketmq\client\impl\MQClientManager.java,43,19,1,7,0,27
rocketmq-develop\rocketmq-develop\common\src\main\java\org\apache\rocketmq\common\protocol\header\GetAllTopicConfigResponseHeader.java,7,1,1,2,0,4
rocketmq-develop\rocketmq-develop\common\src\main\java\org\apache\rocketmq\common\protocol\header\namesrv\WipeWritePermOfBrokerResponseHeader.java,17,8,1,2,0,11
rocketmq-develop\rocketmq-develop\tools\src\test\java\org\apache\rocketmq\tools\command\acl\DeleteAccessConfigSubCommandTest.java,14,4,0,4,0,8
rocketmq-develop\rocketmq-develop\broker\src\main\java\org\apache\rocketmq\broker\processor\ClientManageProcessor.java,161,49,2,28,0,79
rocketmq-develop\rocketmq-develop\store\src\test\java\org\apache\rocketmq\store\dledger\DLedgerCommitlogTest.java,344,152,0,76,0,228
rocketmq-develop\rocketmq-develop\test\src\main\java\org\apache\rocketmq\test\client\rmq\RMQNormalProducer.java,148,59,0,7,0,66
rocketmq-develop\rocketmq-develop\broker\src\test\java\org\apache\rocketmq\broker\filter\ConsumerFilterManagerTest.java,245,62,6,15,0,83
rocketmq-develop\rocketmq-develop\tools\src\test\java\org\apache\rocketmq\tools\command\CommandUtilTest.java,65,26,6,12,0,44
rocketmq-develop\rocketmq-develop\example\src\main\java\org\apache\rocketmq\example\simple\AsyncProducer.java,40,9,1,3,0,13
rocketmq-develop\rocketmq-develop\test\src\test\java\org\apache\rocketmq\test\client\producer\querymsg\QueryMsgByKeyIT.java,127,35,4,8,0,47
rocketmq-develop\rocketmq-develop\broker\src\main\java\org\apache\rocketmq\broker\offset\LmqConsumerOffsetManager.java,87,26,1,8,0,35
rocketmq-develop\rocketmq-develop\test\src\main\java\org\apache\rocketmq\test\listener\rmq\order\RMQOrderListener.java,57,20,1,4,0,25
rocketmq-develop\rocketmq-develop\common\src\main\java\org\apache\rocketmq\common\protocol\body\Connection.java,39,28,0,1,0,29
rocketmq-develop\rocketmq-develop\test\src\test\java\org\apache\rocketmq\test\client\producer\exception\msg\MessageExceptionIT.java,97,36,4,13,0,53
rocketmq-develop\rocketmq-develop\common\src\test\java\org\apache\rocketmq\common\sysflag\PullSysFlagTest.java,15,3,0,1,0,4
rocketmq-develop\rocketmq-develop\broker\src\main\java\org\apache\rocketmq\broker\slave\SlaveSynchronize.java,115,37,1,22,0,60
rocketmq-develop\rocketmq-develop\logging\src\main\java\org\apache\rocketmq\logging\inner\LoggingBuilder.java,1188,328,44,45,0,417
rocketmq-develop\rocketmq-develop\remoting\src\main\java\org\apache\rocketmq\remoting\protocol\RemotingCommandType.java,0,2,0,1,0,3
rocketmq-develop\rocketmq-develop\client\src\main\java\org\apache\rocketmq\client\consumer\MQPullConsumerScheduleService.java,175,78,3,19,0,100
rocketmq-develop\rocketmq-develop\example\src\main\java\org\apache\rocketmq\example\namespace\PullConsumerWithNamespace.java,63,17,1,7,0,25
rocketmq-develop\rocketmq-develop\broker\src\main\java\org\apache\rocketmq\broker\filter\ExpressionForRetryMessageFilter.java,66,16,3,10,0,29
rocketmq-develop\rocketmq-develop\common\src\main\java\org\apache\rocketmq\common\protocol\topic\OffsetMovedEvent.java,45,32,0,3,0,35
rocketmq-develop\rocketmq-develop\common\src\main\java\org\apache\rocketmq\common\protocol\body\GroupList.java,12,7,3,1,0,11
rocketmq-develop\rocketmq-develop\remoting\src\main\java\org\apache\rocketmq\remoting\netty\NettySystemConfig.java,53,53,0,20,0,73
rocketmq-develop\rocketmq-develop\broker\src\main\java\org\apache\rocketmq\broker\longpolling\PullRequest.java,50,37,0,2,0,39
rocketmq-develop\rocketmq-develop\common\src\main\java\org\apache\rocketmq\common\utils\NameServerAddressUtils.java,30,23,1,11,0,35
rocketmq-develop\rocketmq-develop\test\src\test\java\org\apache\rocketmq\test\client\consumer\broadcast\normal\BroadCastNormalMsgTwoDiffGroupRecvIT.java,46,12,1,6,0,19
rocketmq-develop\rocketmq-develop\client\src\test\java\org\apache\rocketmq\client\trace\TraceViewTest.java,33,8,0,6,0,14
rocketmq-develop\rocketmq-develop\tools\src\main\java\org\apache\rocketmq\tools\command\message\QueryMsgByOffsetSubCommand.java,77,15,0,8,0,23
rocketmq-develop\rocketmq-develop\common\src\main\java\org\apache\rocketmq\common\PlainAccessConfig.java,83,56,0,1,0,57
rocketmq-develop\rocketmq-develop\store\src\main\java\org\apache\rocketmq\store\ConsumeQueue.java,611,172,19,71,0,262
rocketmq-develop\rocketmq-develop\test\src\main\java\org\apache\rocketmq\test\util\VerifyUtils.java,122,54,5,12,0,71
rocketmq-develop\rocketmq-develop\common\src\main\java\org\apache\rocketmq\common\protocol\header\GetConsumerConnectionListRequestHeader.java,19,8,0,2,0,10
rocketmq-develop\rocketmq-develop\example\src\main\java\org\apache\rocketmq\example\namespace\ProducerWithNamespace.java,18,9,1,4,0,14
rocketmq-develop\rocketmq-develop\test\src\main\java\org\apache\rocketmq\test\util\RandomUtils.java,70,18,1,1,0,20
rocketmq-develop\rocketmq-develop\client\src\main\java\org\apache\rocketmq\client\impl\consumer\AssignedMessageQueue.java,224,102,4,23,0,129
rocketmq-develop\rocketmq-develop\client\src\main\java\org\apache\rocketmq\client\consumer\PullTaskCallback.java,0,3,1,1,0,5
rocketmq-develop\rocketmq-develop\common\src\main\java\org\apache\rocketmq\common\protocol\header\GetBrokerClusterAclConfigResponseHeader.java,18,9,1,3,0,13
rocketmq-develop\rocketmq-develop\common\src\main\java\org\apache\rocketmq\common\protocol\body\UnlockBatchRequestBody.java,30,21,0,1,0,22
rocketmq-develop\rocketmq-develop\broker\src\main\java\org\apache\rocketmq\broker\longpolling\LmqPullRequestHoldService.java,38,10,1,5,0,16
rocketmq-develop\rocketmq-develop\client\src\main\java\org\apache\rocketmq\client\hook\ConsumeMessageContext.java,75,56,0,1,0,57
rocketmq-develop\rocketmq-develop\common\src\main\java\org\apache\rocketmq\common\consistenthash\ConsistentHashRouter.java,108,39,3,9,0,51
rocketmq-develop\rocketmq-develop\common\src\test\java\org\apache\rocketmq\common\protocol\body\ConsumeMessageDirectlyResultTest.java,28,5,0,4,0,9
rocketmq-develop\rocketmq-develop\store\src\main\java\org\apache\rocketmq\store\GetMessageStatus.java,0,9,0,1,0,10
rocketmq-develop\rocketmq-develop\store\src\test\java\org\apache\rocketmq\store\ConsumeQueueTest.java,398,127,10,43,0,180
rocketmq-develop\rocketmq-develop\test\src\main\java\org\apache\rocketmq\test\client\rmq\RMQBroadCastConsumer.java,15,9,1,2,0,12
rocketmq-develop\rocketmq-develop\client\src\main\java\org\apache\rocketmq\client\producer\MessageQueueSelector.java,0,5,1,2,0,8
rocketmq-develop\rocketmq-develop\remoting\src\test\java\org\apache\rocketmq\remoting\protocol\LanguageCodeTest.java,13,4,0,1,0,5
rocketmq-develop\rocketmq-develop\test\src\test\java\org\apache\rocketmq\test\base\IntegrationTestBase.java,157,65,6,23,0,94
rocketmq-develop\rocketmq-develop\test\src\test\java\org\apache\rocketmq\test\client\producer\async\AsyncSendWithOnlySendCallBackIT.java,33,12,1,4,0,17
rocketmq-develop\rocketmq-develop\common\src\test\java\org\apache\rocketmq\common\protocol\body\ConsumeStatsListTest.java,33,10,0,8,0,18
rocketmq-develop\rocketmq-develop\client\src\test\java\org\apache\rocketmq\client\trace\TransactionMQProducerWithTraceTest.java,138,51,8,25,0,84
rocketmq-develop\rocketmq-develop\client\src\main\java\org\apache\rocketmq\client\consumer\rebalance\AllocateMessageQueueAveragely.java,44,14,2,7,0,23
rocketmq-develop\rocketmq-develop\remoting\src\main\java\org\apache\rocketmq\remoting\common\RemotingHelper.java,167,25,4,13,0,42
rocketmq-develop\rocketmq-develop\client\src\main\java\org\apache\rocketmq\client\trace\hook\ConsumeMessageTraceHookImpl.java,85,35,1,11,0,47
rocketmq-develop\rocketmq-develop\client\src\main\java\org\apache\rocketmq\client\consumer\listener\MessageListener.java,0,1,0,2,0,3
rocketmq-develop\rocketmq-develop\client\src\main\java\org\apache\rocketmq\client\consumer\listener\MessageListenerOrderly.java,0,7,1,4,0,12
rocketmq-develop\rocketmq-develop\client\src\main\java\org\apache\rocketmq\client\impl\consumer\DefaultLitePullConsumerImpl.java,1088,369,32,159,0,560
rocketmq-develop\rocketmq-develop\common\src\main\java\org\apache\rocketmq\common\protocol\header\GetConsumeStatsRequestHeader.java,26,14,1,1,0,16
rocketmq-develop\rocketmq-develop\common\src\main\java\org\apache\rocketmq\common\message\MessageQueueForC.java,0,55,10,5,0,70
rocketmq-develop\rocketmq-develop\common\src\main\java\org\apache\rocketmq\common\queue\RoundQueue.java,24,10,0,1,0,11
rocketmq-develop\rocketmq-develop\broker\src\main\java\org\apache\rocketmq\broker\transaction\queue\TransactionalMessageServiceImpl.java,453,143,22,81,0,246
rocketmq-develop\rocketmq-develop\client\src\main\java\org\apache\rocketmq\client\latency\LatencyFaultToleranceImpl.java,162,42,10,10,0,62
rocketmq-develop\rocketmq-develop\common\src\main\java\org\apache\rocketmq\common\protocol\NamespaceUtil.java,152,58,2,25,0,85
rocketmq-develop\rocketmq-develop\common\src\main\java\org\apache\rocketmq\common\protocol\body\ConsumerOffsetSerializeWrapper.java,13,11,0,4,0,15
rocketmq-develop\rocketmq-develop\common\src\main\java\org\apache\rocketmq\common\DataVersion.java,70,26,4,1,0,31
rocketmq-develop\rocketmq-develop\example\src\main\java\org\apache\rocketmq\example\operation\Consumer.java,79,13,2,4,0,19
rocketmq-develop\rocketmq-develop\store\src\main\java\org\apache\rocketmq\store\PutMessageSpinLock.java,19,5,0,2,0,7
rocketmq-develop\rocketmq-develop\client\src\main\java\org\apache\rocketmq\client\hook\CheckForbiddenContext.java,101,74,0,4,0,78
rocketmq-develop\rocketmq-develop\test\src\test\java\org\apache\rocketmq\test\client\consumer\cluster\DynamicCrashConsumerIT.java,67,26,1,15,0,42
rocketmq-develop\rocketmq-develop\store\src\main\java\org\apache\rocketmq\store\util\LibC.java,0,17,0,2,0,19
rocketmq-develop\rocketmq-develop\remoting\src\main\java\org\apache\rocketmq\remoting\netty\NettyEncoder.java,23,9,2,4,0,15
rocketmq-develop\rocketmq-develop\client\src\main\java\org\apache\rocketmq\client\consumer\PullResult.java,49,34,0,4,0,38
rocketmq-develop\rocketmq-develop\common\src\main\java\org\apache\rocketmq\common\help\FAQUrl.java,70,19,1,1,0,21
rocketmq-develop\rocketmq-develop\test\src\main\java\org\apache\rocketmq\test\client\rmq\RMQSqlConsumer.java,21,10,0,1,0,11
rocketmq-develop\rocketmq-develop\client\src\main\java\org\apache\rocketmq\client\trace\TraceTransferBean.java,21,15,0,1,0,16
rocketmq-develop\rocketmq-develop\common\src\test\java\org\apache\rocketmq\common\BrokerConfigTest.java,28,11,0,4,0,15
rocketmq-develop\rocketmq-develop\common\src\main\java\org\apache\rocketmq\common\protocol\body\ConsumeStatus.java,58,42,0,1,0,43
rocketmq-develop\rocketmq-develop\broker\src\test\java\org\apache\rocketmq\broker\BrokerControllerTest.java,47,8,2,3,0,13
rocketmq-develop\rocketmq-develop\example\src\main\java\org\apache\rocketmq\example\simple\OnewayProducer.java,24,9,1,3,0,13
rocketmq-develop\rocketmq-develop\example\src\main\java\org\apache\rocketmq\example\benchmark\Producer.java,0,98,8,61,0,167
rocketmq-develop\rocketmq-develop\tools\src\main\java\org\apache\rocketmq\tools\command\broker\GetBrokerConfigCommand.java,94,12,0,8,0,20
rocketmq-develop\rocketmq-develop\common\src\main\java\org\apache\rocketmq\common\protocol\header\UpdateConsumerOffsetResponseHeader.java,7,1,1,2,0,4
rocketmq-develop\rocketmq-develop\broker\src\main\java\org\apache\rocketmq\broker\transaction\queue\DefaultTransactionalMessageCheckListener.java,48,22,3,15,0,40
rocketmq-develop\rocketmq-develop\test\src\test\java\org\apache\rocketmq\test\client\consumer\tag\TagMessageWith1ConsumerIT.java,164,51,1,27,0,79
rocketmq-develop\rocketmq-develop\common\src\main\java\org\apache\rocketmq\common\protocol\body\TopicConfigSerializeWrapper.java,22,15,0,2,0,17
rocketmq-develop\rocketmq-develop\common\src\main\java\org\apache\rocketmq\common\protocol\header\GetBrokerAclConfigResponseHeader.java,60,35,1,1,0,37
rocketmq-develop\rocketmq-develop\example\src\main\java\org\apache\rocketmq\example\benchmark\TransactionProducer.java,0,146,3,59,0,208
rocketmq-develop\rocketmq-develop\namesrv\src\main\java\org\apache\rocketmq\namesrv\routeinfo\RouteInfoManager.java,0,178,23,92,0,293
rocketmq-develop\rocketmq-develop\common\src\main\java\org\apache\rocketmq\common\utils\ChannelUtil.java,12,6,1,3,0,10
rocketmq-develop\rocketmq-develop\broker\src\main\java\org\apache\rocketmq\broker\pagecache\ManyMessageTransfer.java,89,30,0,7,0,37
rocketmq-develop\rocketmq-develop\broker\src\main\java\org\apache\rocketmq\broker\filter\MessageEvaluationContext.java,32,7,1,2,0,10
rocketmq-develop\rocketmq-develop\common\src\main\java\org\apache\rocketmq\common\protocol\header\namesrv\PutKVConfigRequestHeader.java,37,21,1,1,0,23
rocketmq-develop\rocketmq-develop\common\src\main\java\org\apache\rocketmq\common\protocol\header\QueryTopicConsumeByWhoRequestHeader.java,18,9,1,3,0,13
rocketmq-develop\rocketmq-develop\test\src\main\java\org\apache\rocketmq\test\util\parallel\ParallelTaskExecutor.java,43,14,2,1,0,17
rocketmq-develop\rocketmq-develop\store\src\main\java\org\apache\rocketmq\store\MappedFileQueue.java,593,156,23,44,0,223
rocketmq-develop\rocketmq-develop\common\src\main\java\org\apache\rocketmq\common\protocol\header\ResetOffsetRequestHeader.java,48,28,1,1,0,30
rocketmq-develop\rocketmq-develop\tools\src\main\java\org\apache\rocketmq\tools\command\message\QueryMsgByKeySubCommand.java,58,15,0,7,0,22
rocketmq-develop\rocketmq-develop\common\src\main\java\org\apache\rocketmq\common\protocol\RequestCode.java,175,96,0,2,0,98
rocketmq-develop\rocketmq-develop\client\src\test\java\org\apache\rocketmq\client\trace\DefaultMQConsumerWithTraceTest.java,248,86,17,39,0,142
rocketmq-develop\rocketmq-develop\common\src\main\java\org\apache\rocketmq\common\protocol\header\PullMessageRequestHeader.java,116,78,1,2,0,81
rocketmq-develop\rocketmq-develop\tools\src\test\java\org\apache\rocketmq\tools\command\broker\BrokerStatusSubCommandTest.java,31,6,0,3,0,9
rocketmq-develop\rocketmq-develop\tools\src\test\java\org\apache\rocketmq\tools\command\offset\ResetOffsetByTimeOldCommandTest.java,14,7,0,6,0,13
rocketmq-develop\rocketmq-develop\common\src\test\java\org\apache\rocketmq\common\protocol\body\ResetOffsetBodyTest.java,19,4,0,2,0,6
rocketmq-develop\rocketmq-develop\common\src\main\java\org\apache\rocketmq\common\protocol\body\RegisterBrokerBody.java,158,56,1,26,0,83
rocketmq-develop\rocketmq-develop\broker\src\main\java\org\apache\rocketmq\broker\out\BrokerOuterAPI.java,339,117,5,70,0,192
rocketmq-develop\rocketmq-develop\logging\src\test\java\org\apache\rocketmq\logging\InnerLoggerFactoryTest.java,62,10,0,5,0,15
rocketmq-develop\rocketmq-develop\common\src\main\java\org\apache\rocketmq\common\protocol\body\ConsumeMessageDirectlyResult.java,55,38,0,3,0,41
rocketmq-develop\rocketmq-develop\broker\src\main\java\org\apache\rocketmq\broker\client\ClientChannelInfo.java,80,47,5,7,0,59
rocketmq-develop\rocketmq-develop\example\src\main\java\org\apache\rocketmq\example\filter\TagFilterProducer.java,22,5,1,2,0,8
rocketmq-develop\rocketmq-develop\broker\src\main\java\org\apache\rocketmq\broker\processor\ForwardRequestProcessor.java,20,12,3,4,0,19
rocketmq-develop\rocketmq-develop\tools\src\main\java\org\apache\rocketmq\tools\command\namesrv\WipeWritePermSubCommand.java,57,16,0,9,0,25
rocketmq-develop\rocketmq-develop\common\src\test\java\org\apache\rocketmq\common\protocol\body\CheckClientRequestBodyTest.java,19,4,0,3,0,7
rocketmq-develop\rocketmq-develop\common\src\main\java\org\apache\rocketmq\common\utils\ThreadUtils.java,0,62,3,21,0,86
rocketmq-develop\rocketmq-develop\remoting\src\main\java\org\apache\rocketmq\remoting\protocol\RocketMQSerializable.java,187,25,10,5,0,40
rocketmq-develop\rocketmq-develop\common\src\main\java\org\apache\rocketmq\common\protocol\header\namesrv\QueryDataVersionRequestHeader.java,48,28,1,1,0,30
rocketmq-develop\rocketmq-develop\common\src\main\java\org\apache\rocketmq\common\protocol\header\SendMessageRequestHeaderV2.java,174,95,1,14,0,110
rocketmq-develop\rocketmq-develop\client\src\test\java\org\apache\rocketmq\client\latency\LatencyFaultToleranceImplTest.java,44,24,0,4,0,28
rocketmq-develop\rocketmq-develop\store\src\main\java\org\apache\rocketmq\store\MessageFilter.java,0,11,2,6,0,19
rocketmq-develop\rocketmq-develop\common\src\test\java\org\apache\rocketmq\common\protocol\GroupListTest.java,23,9,1,1,0,11
rocketmq-develop\rocketmq-develop\srvutil\src\main\test\org\apache\rocketmq\srvutil\FileWatchServiceTest.java,0,32,5,8,0,45
rocketmq-develop\rocketmq-develop\logging\src\test\java\org\apache\rocketmq\logging\inner\MessageFormatterTest.java,17,6,0,3,0,9
rocketmq-develop\rocketmq-develop\broker\src\main\java\org\apache\rocketmq\broker\client\DefaultConsumerIdsChangeListener.java,40,14,0,7,0,21
rocketmq-develop\rocketmq-develop\client\src\main\java\org\apache\rocketmq\client\consumer\DefaultMQPullConsumer.java,410,282,1,83,0,366
rocketmq-develop\rocketmq-develop\example\src\main\java\org\apache\rocketmq\example\benchmark\Consumer.java,0,68,3,44,0,115
rocketmq-develop\rocketmq-develop\common\src\test\java\org\apache\rocketmq\common\ServiceThreadTest.java,116,22,1,1,0,24
rocketmq-develop\rocketmq-develop\filter\src\main\java\org\apache\rocketmq\filter\parser\SelectorParserConstants.java,0,1,19,1,0,21
rocketmq-develop\rocketmq-develop\client\src\main\java\org\apache\rocketmq\client\impl\consumer\PullRequest.java,85,49,7,4,0,60
rocketmq-develop\rocketmq-develop\client\src\test\java\org\apache\rocketmq\client\impl\consumer\ProcessQueueTest.java,78,27,0,3,0,30
rocketmq-develop\rocketmq-develop\example\src\main\java\org\apache\rocketmq\example\filter\SqlFilterConsumer.java,26,11,1,5,0,17
rocketmq-develop\rocketmq-develop\broker\src\main\java\org\apache\rocketmq\broker\filter\ConsumerFilterData.java,118,70,0,5,0,75
rocketmq-develop\rocketmq-develop\client\src\main\java\org\apache\rocketmq\client\consumer\PullTaskContext.java,23,15,0,1,0,16
rocketmq-develop\rocketmq-develop\test\src\main\java\org\apache\rocketmq\test\util\MQRandomUtils.java,10,3,1,1,0,5
rocketmq-develop\rocketmq-develop\store\src\main\java\org\apache\rocketmq\store\MessageExtBrokerInner.java,42,25,0,2,0,27
rocketmq-develop\rocketmq-develop\example\src\main\java\org\apache\rocketmq\example\rpc\ResponseConsumer.java,46,16,1,11,0,28
rocketmq-develop\rocketmq-develop\client\src\main\java\org\apache\rocketmq\client\producer\TransactionSendResult.java,15,9,2,2,0,13
rocketmq-develop\rocketmq-develop\filter\src\main\java\org\apache\rocketmq\filter\expression\NowExpression.java,15,5,2,1,0,8
rocketmq-develop\rocketmq-develop\store\src\main\java\org\apache\rocketmq\store\index\IndexService.java,338,68,12,24,0,104
rocketmq-develop\rocketmq-develop\common\src\main\java\org\apache\rocketmq\common\message\MessageBatch.java,50,13,2,6,0,21
rocketmq-develop\rocketmq-develop\test\src\main\java\org\apache\rocketmq\test\client\mq\MQAsyncProducer.java,62,25,4,3,0,32
rocketmq-develop\rocketmq-develop\client\src\main\java\org\apache\rocketmq\client\impl\FindBrokerResult.java,30,22,0,2,0,24
rocketmq-develop\rocketmq-develop\common\src\main\java\org\apache\rocketmq\common\stats\MomentStatsItemSet.java,85,38,1,9,0,48
rocketmq-develop\rocketmq-develop\store\src\test\java\org\apache\rocketmq\store\StoreTestUtil.java,71,29,8,14,0,51
rocketmq-develop\rocketmq-develop\store\src\test\java\org\apache\rocketmq\store\MultiDispatchTest.java,64,31,9,15,0,55
rocketmq-develop\rocketmq-develop\common\src\main\java\org\apache\rocketmq\common\message\MessageType.java,0,4,0,1,0,5
rocketmq-develop\rocketmq-develop\example\src\main\java\org\apache\rocketmq\example\quickstart\Consumer.java,53,15,1,10,0,26
rocketmq-develop\rocketmq-develop\client\src\main\java\org\apache\rocketmq\client\exception\MQClientException.java,36,22,0,2,0,24
rocketmq-develop\rocketmq-develop\client\src\main\java\org\apache\rocketmq\client\hook\SendMessageHook.java,0,5,2,1,0,8
rocketmq-develop\rocketmq-develop\broker\src\main\java\org\apache\rocketmq\broker\plugin\MessageStoreFactory.java,0,10,3,5,0,18
rocketmq-develop\rocketmq-develop\tools\src\test\java\org\apache\rocketmq\tools\command\offset\ResetOffsetByTimeCommandTest.java,39,11,0,5,0,16
rocketmq-develop\rocketmq-develop\remoting\src\test\java\org\apache\rocketmq\remoting\protocol\RocketMQSerializableTest.java,149,64,5,14,0,83
rocketmq-develop\rocketmq-develop\test\src\test\java\org\apache\rocketmq\test\tls\TLS_Mix2_IT.java,33,10,2,3,0,15
rocketmq-develop\rocketmq-develop\tools\src\test\java\org\apache\rocketmq\tools\command\message\QueryMsgByUniqueKeySubCommandTest.java,191,59,11,34,0,104
rocketmq-develop\rocketmq-develop\common\src\main\java\org\apache\rocketmq\common\protocol\header\namesrv\DeleteKVConfigRequestHeader.java,27,14,1,1,0,16
rocketmq-develop\rocketmq-develop\common\src\main\java\org\apache\rocketmq\common\protocol\header\QueryMessageResponseHeader.java,27,15,1,2,0,18
rocketmq-develop\rocketmq-develop\tools\src\main\java\org\apache\rocketmq\tools\command\acl\UpdateGlobalWhiteAddrSubCommand.java,72,20,0,13,0,33
rocketmq-develop\rocketmq-develop\tools\src\main\java\org\apache\rocketmq\tools\command\SubCommand.java,0,9,2,2,0,13
rocketmq-develop\rocketmq-develop\common\src\main\java\org\apache\rocketmq\common\protocol\body\TopicList.java,21,14,0,1,0,15
rocketmq-develop\rocketmq-develop\store\src\main\java\org\apache\rocketmq\store\stats\LmqBrokerStatsManager.java,101,15,0,6,0,21
rocketmq-develop\rocketmq-develop\broker\src\main\java\org\apache\rocketmq\broker\offset\ConsumerOffsetManager.java,217,75,2,29,0,106
rocketmq-develop\rocketmq-develop\common\src\main\java\org\apache\rocketmq\common\protocol\header\GetMaxOffsetResponseHeader.java,17,8,1,2,0,11
rocketmq-develop\rocketmq-develop\filter\src\main\java\org\apache\rocketmq\filter\expression\BooleanConstantExpression.java,16,13,1,5,0,19
rocketmq-develop\rocketmq-develop\broker\src\main\java\org\apache\rocketmq\broker\transaction\jdbc\JDBCTransactionStoreConfig.java,39,29,0,2,0,31
rocketmq-develop\rocketmq-develop\common\src\main\java\org\apache\rocketmq\common\protocol\body\ProcessQueueInfo.java,146,105,0,8,0,113
rocketmq-develop\rocketmq-develop\common\src\main\java\org\apache\rocketmq\common\message\Message.java,198,115,1,6,0,122
rocketmq-develop\rocketmq-develop\common\src\main\java\org\apache\rocketmq\common\protocol\header\QueryConsumerOffsetRequestHeader.java,37,22,1,2,0,25
rocketmq-develop\rocketmq-develop\client\src\test\java\org\apache\rocketmq\client\consumer\rebalance\AllocateMessageQueueConsitentHashTest.java,213,81,4,30,0,115
rocketmq-develop\rocketmq-develop\logging\src\test\java\org\apache\rocketmq\logging\inner\LevelTest.java,16,6,0,1,0,7
rocketmq-develop\rocketmq-develop\client\src\main\java\org\apache\rocketmq\client\trace\hook\ConsumeMessageOpenTracingHookImpl.java,61,17,0,8,0,25
rocketmq-develop\rocketmq-develop\remoting\src\main\java\org\apache\rocketmq\remoting\protocol\SerializeType.java,0,8,0,1,0,9
rocketmq-develop\rocketmq-develop\client\src\main\java\org\apache\rocketmq\client\consumer\store\LocalFileOffsetStore.java,190,53,6,20,0,79
rocketmq-develop\rocketmq-develop\logging\src\test\java\org\apache\rocketmq\logging\inner\AppenderTest.java,0,27,1,15,0,43
rocketmq-develop\rocketmq-develop\store\src\main\java\org\apache\rocketmq\store\PutMessageLock.java,0,3,0,1,0,4
rocketmq-develop\rocketmq-develop\client\src\main\java\org\apache\rocketmq\client\common\ThreadLocalIndex.java,23,8,0,2,0,10
rocketmq-develop\rocketmq-develop\remoting\src\main\java\org\apache\rocketmq\remoting\common\RemotingUtil.java,193,41,9,18,0,68
rocketmq-develop\rocketmq-develop\common\src\main\java\org\apache\rocketmq\common\protocol\header\GetBrokerClusterAclConfigResponseBody.java,23,16,0,3,0,19
rocketmq-develop\rocketmq-develop\test\src\test\java\org\apache\rocketmq\test\client\consumer\tag\TagMessageWithMulConsumerIT.java,161,37,1,24,0,62
rocketmq-develop\rocketmq-develop\store\src\main\java\org\apache\rocketmq\store\AppendMessageResult.java,130,104,0,3,0,107
rocketmq-develop\rocketmq-develop\common\src\main\java\org\apache\rocketmq\common\protocol\header\GetTopicsByClusterRequestHeader.java,17,7,1,1,0,9
rocketmq-develop\rocketmq-develop\broker\src\main\java\org\apache\rocketmq\broker\BrokerStartup.java,231,55,6,31,0,92
rocketmq-develop\rocketmq-develop\test\src\main\java\org\apache\rocketmq\test\factory\TagMessage.java,84,44,0,3,0,47
rocketmq-develop\rocketmq-develop\client\src\main\java\org\apache\rocketmq\client\consumer\DefaultLitePullConsumer.java,522,286,1,57,0,344
rocketmq-develop\rocketmq-develop\common\src\main\java\org\apache\rocketmq\common\protocol\header\namesrv\QueryDataVersionResponseHeader.java,26,9,1,2,0,12
rocketmq-develop\rocketmq-develop\openmessaging\src\main\java\io\openmessaging\rocketmq\consumer\PushConsumerImpl.java,167,49,5,23,0,77
rocketmq-develop\rocketmq-develop\client\src\test\java\org\apache\rocketmq\client\impl\consumer\RebalanceLitePullImplTest.java,66,44,4,21,0,69
rocketmq-develop\rocketmq-develop\store\src\main\java\org\apache\rocketmq\store\config\StorePathConfigHelper.java,40,13,1,4,0,18
rocketmq-develop\rocketmq-develop\common\src\main\java\org\apache\rocketmq\common\consistenthash\Node.java,0,1,0,1,0,2
rocketmq-develop\rocketmq-develop\client\src\main\java\org\apache\rocketmq\client\producer\TransactionCheckListener.java,0,3,1,2,0,6
rocketmq-develop\rocketmq-develop\client\src\main\java\org\apache\rocketmq\client\consumer\MessageQueueListener.java,0,5,1,2,0,8
rocketmq-develop\rocketmq-develop\store\src\main\java\org\apache\rocketmq\store\ha\HAConnection.java,371,94,19,44,0,157
rocketmq-develop\rocketmq-develop\filter\src\main\java\org\apache\rocketmq\filter\SqlFilter.java,13,4,0,3,0,7
rocketmq-develop\rocketmq-develop\test\src\main\java\org\apache\rocketmq\test\client\rmq\RMQAsyncSendProducer.java,195,89,0,10,0,99
rocketmq-develop\rocketmq-develop\tools\src\main\java\org\apache\rocketmq\tools\command\message\SendMessageCommand.java,134,25,0,14,0,39
rocketmq-develop\rocketmq-develop\example\src\main\java\org\apache\rocketmq\example\batch\SplitBatchProducer.java,0,21,1,6,0,28
rocketmq-develop\rocketmq-develop\common\src\main\java\org\apache\rocketmq\common\protocol\header\ReplyMessageRequestHeader.java,147,99,1,1,0,101
rocketmq-develop\rocketmq-develop\test\src\main\java\org\apache\rocketmq\test\client\rmq\RMQNormalConsumer.java,70,31,1,2,0,34
rocketmq-develop\rocketmq-develop\test\src\test\java\org\apache\rocketmq\test\client\producer\async\AsyncSendWithMessageQueueSelectorIT.java,71,28,1,11,0,40
rocketmq-develop\rocketmq-develop\tools\src\test\java\org\apache\rocketmq\tools\command\offset\SkipAccumulationCommandTest.java,41,14,3,7,0,24
rocketmq-develop\rocketmq-develop\common\src\test\java\org\apache\rocketmq\common\UtilAllTest.java,143,44,4,11,0,59
rocketmq-develop\rocketmq-develop\broker\src\main\java\org\apache\rocketmq\broker\processor\QueryMessageProcessor.java,127,44,4,26,0,74
rocketmq-develop\rocketmq-develop\common\src\test\java\org\apache\rocketmq\common\MessageEncodeDecodeTest.java,48,7,7,3,0,17
rocketmq-develop\rocketmq-develop\tools\src\main\java\org\apache\rocketmq\tools\command\message\PrintMessageByQueueCommand.java,217,53,15,29,0,97
rocketmq-develop\rocketmq-develop\common\src\main\java\org\apache\rocketmq\common\protocol\header\ViewBrokerStatsDataRequestHeader.java,28,14,1,1,0,16
rocketmq-develop\rocketmq-develop\client\src\main\java\org\apache\rocketmq\client\trace\TraceConstants.java,25,27,0,6,0,33
rocketmq-develop\rocketmq-develop\srvutil\src\main\java\org\apache\rocketmq\srvutil\FileWatchService.java,72,18,6,5,0,29
rocketmq-develop\rocketmq-develop\store\src\main\java\org\apache\rocketmq\store\QueryMessageResult.java,48,26,0,2,0,28
rocketmq-develop\rocketmq-develop\remoting\src\main\java\org\apache\rocketmq\remoting\RemotingClient.java,0,32,7,8,0,47
rocketmq-develop\rocketmq-develop\broker\src\test\java\org\apache\rocketmq\broker\BrokerStartupTest.java,17,6,2,4,0,12
rocketmq-develop\rocketmq-develop\remoting\src\test\java\org\apache\rocketmq\remoting\netty\NettyRemotingClientTest.java,12,5,0,3,0,8
rocketmq-develop\rocketmq-develop\tools\src\test\java\org\apache\rocketmq\tools\command\acl\GetAccessConfigSubCommandTest.java,13,4,1,3,0,8
rocketmq-develop\rocketmq-develop\test\src\test\java\org\apache\rocketmq\test\client\producer\querymsg\QueryMsgByIdIT.java,41,14,3,6,0,23
rocketmq-develop\rocketmq-develop\test\src\test\java\org\apache\rocketmq\test\client\producer\async\AsyncSendWithMessageQueueIT.java,52,17,1,7,0,25
rocketmq-develop\rocketmq-develop\tools\src\main\java\org\apache\rocketmq\tools\admin\DefaultMQAdminExt.java,539,370,0,116,0,486
rocketmq-develop\rocketmq-develop\common\src\test\java\org\apache\rocketmq\common\protocol\NamespaceUtilTest.java,68,41,0,25,0,66
rocketmq-develop\rocketmq-develop\example\src\main\java\org\apache\rocketmq\example\simple\AclClient.java,126,36,5,14,0,55
rocketmq-develop\rocketmq-develop\remoting\src\main\java\org\apache\rocketmq\remoting\exception\RemotingCommandException.java,12,6,0,1,0,7
rocketmq-develop\rocketmq-develop\tools\src\main\java\org\apache\rocketmq\tools\command\broker\UpdateBrokerConfigSubCommand.java,81,16,0,9,0,25
rocketmq-develop\rocketmq-develop\client\src\test\java\org\apache\rocketmq\client\impl\consumer\ConsumeMessageOrderlyServiceTest.java,194,77,11,41,0,129
rocketmq-develop\rocketmq-develop\common\src\main\java\org\apache\rocketmq\common\protocol\header\GetEarliestMsgStoretimeResponseHeader.java,17,9,1,3,0,13
rocketmq-develop\rocketmq-develop\test\src\test\java\org\apache\rocketmq\test\client\consumer\broadcast\normal\BroadCastNormalMsgRecvStartLaterIT.java,56,14,1,8,0,23
rocketmq-develop\rocketmq-develop\client\src\main\java\org\apache\rocketmq\client\producer\LocalTransactionExecuter.java,0,5,1,3,0,9
rocketmq-develop\rocketmq-develop\common\src\main\java\org\apache\rocketmq\common\utils\HttpTinyClient.java,108,48,2,8,0,58
rocketmq-develop\rocketmq-develop\common\src\main\java\org\apache\rocketmq\common\protocol\header\DeleteTopicRequestHeader.java,17,8,1,2,0,11
rocketmq-develop\rocketmq-develop\common\src\main\java\org\apache\rocketmq\common\running\RunningStats.java,0,6,0,1,0,7
rocketmq-develop\rocketmq-develop\broker\src\test\java\org\apache\rocketmq\broker\processor\EndTransactionProcessorTest.java,100,49,3,25,0,77
rocketmq-develop\rocketmq-develop\tools\src\main\java\org\apache\rocketmq\tools\command\message\DecodeMessageIdCommond.java,39,9,0,4,0,13
rocketmq-develop\rocketmq-develop\openmessaging\src\main\java\io\openmessaging\rocketmq\promise\DefaultPromise.java,0,32,10,8,0,50
rocketmq-develop\rocketmq-develop\common\src\main\java\org\apache\rocketmq\common\protocol\body\ProducerConnection.java,12,7,3,1,0,11
rocketmq-develop\rocketmq-develop\common\src\test\java\org\apache\rocketmq\common\stats\StatsItemSetTest.java,114,72,5,22,0,99
rocketmq-develop\rocketmq-develop\client\src\main\java\org\apache\rocketmq\client\impl\consumer\RebalanceImpl.java,450,154,17,63,0,234
rocketmq-develop\rocketmq-develop\common\src\main\java\org\apache\rocketmq\common\protocol\MQProtosHelper.java,24,10,1,7,0,18
rocketmq-develop\rocketmq-develop\broker\src\test\java\org\apache\rocketmq\broker\processor\PullMessageProcessorTest.java,172,76,8,39,0,123
rocketmq-develop\rocketmq-develop\openmessaging\src\main\java\io\openmessaging\rocketmq\config\ClientConfig.java,0,127,0,3,0,130
rocketmq-develop\rocketmq-develop\client\src\main\java\org\apache\rocketmq\client\impl\consumer\ConsumeMessageConcurrentlyService.java,409,111,14,59,0,184
rocketmq-develop\rocketmq-develop\common\src\test\java\org\apache\rocketmq\common\protocol\heartbeat\SubscriptionDataTest.java,60,19,0,12,0,31
rocketmq-develop\rocketmq-develop\client\src\main\java\org\apache\rocketmq\client\producer\SendStatus.java,0,4,0,1,0,5
rocketmq-develop\rocketmq-develop\client\src\main\java\org\apache\rocketmq\client\consumer\TopicMessageQueueChangeListener.java,0,2,0,2,0,4
rocketmq-develop\rocketmq-develop\common\src\main\java\org\apache\rocketmq\common\protocol\header\ConsumeMessageDirectlyResultRequestHeader.java,47,29,1,2,0,32
rocketmq-develop\rocketmq-develop\common\src\main\java\org\apache\rocketmq\common\protocol\header\namesrv\AddWritePermOfBrokerRequestHeader.java,18,8,1,1,0,10
rocketmq-develop\rocketmq-develop\client\src\main\java\org\apache\rocketmq\client\producer\SendCallback.java,0,4,2,1,0,7
rocketmq-develop\rocketmq-develop\common\src\main\java\org\apache\rocketmq\common\message\MessageClientIDSetter.java,128,47,2,5,0,54
rocketmq-develop\rocketmq-develop\logging\src\main\java\org\apache\rocketmq\logging\inner\Layout.java,21,10,0,1,0,11
rocketmq-develop\rocketmq-develop\test\src\test\java\org\apache\rocketmq\test\client\consumer\cluster\DynamicAddConsumerIT.java,64,26,1,15,0,42
rocketmq-develop\rocketmq-develop\tools\src\test\java\org\apache\rocketmq\tools\command\topic\UpdateTopicSubCommandTest.java,27,5,0,4,0,9
rocketmq-develop\rocketmq-develop\common\src\main\java\org\apache\rocketmq\common\protocol\heartbeat\ProducerData.java,17,8,0,1,0,9
rocketmq-develop\rocketmq-develop\srvutil\src\main\java\org\apache\rocketmq\srvutil\ServerUtil.java,60,14,1,5,0,20
rocketmq-develop\rocketmq-develop\tools\src\test\java\org\apache\rocketmq\tools\command\acl\UpdateGlobalWhiteAddrSubCommandTest.java,14,6,0,6,0,12
rocketmq-develop\rocketmq-develop\remoting\src\main\java\org\apache\rocketmq\remoting\netty\NettyRemotingClient.java,641,178,10,95,0,283
rocketmq-develop\rocketmq-develop\tools\src\main\java\org\apache\rocketmq\tools\command\offset\SkipAccumulationSubCommand.java,93,22,0,13,0,35
rocketmq-develop\rocketmq-develop\logging\src\main\java\org\apache\rocketmq\logging\inner\LoggingEvent.java,0,38,4,2,0,44
rocketmq-develop\rocketmq-develop\broker\src\main\java\org\apache\rocketmq\broker\subscription\LmqSubscriptionGroupManager.java,25,8,0,4,0,12
rocketmq-develop\rocketmq-develop\client\src\main\java\org\apache\rocketmq\client\admin\MQAdminExtInner.java,0,1,0,1,0,2
rocketmq-develop\rocketmq-develop\common\src\main\java\org\apache\rocketmq\common\namesrv\NamesrvConfig.java,59,48,1,5,0,54
rocketmq-develop\rocketmq-develop\example\src\main\java\org\apache\rocketmq\example\tracemessage\OpenTracingTransactionProducer.java,51,16,1,9,0,26
rocketmq-develop\rocketmq-develop\filter\src\test\java\org\apache\rocketmq\filter\ParserTest.java,105,33,9,7,0,49
rocketmq-develop\rocketmq-develop\broker\src\main\java\org\apache\rocketmq\broker\BrokerPathConfigHelper.java,33,16,1,7,0,24
rocketmq-develop\rocketmq-develop\namesrv\src\test\java\org\apache\rocketmq\namesrv\NameServerInstanceTest.java,23,12,0,3,0,15
rocketmq-develop\rocketmq-develop\example\src\main\java\org\apache\rocketmq\example\simple\PullScheduleService.java,43,12,2,5,0,19
rocketmq-develop\rocketmq-develop\filter\src\main\java\org\apache\rocketmq\filter\constant\UnaryType.java,0,6,0,1,0,7
rocketmq-develop\rocketmq-develop\common\src\main\java\org\apache\rocketmq\common\protocol\route\BrokerData.java,100,49,12,6,0,67
rocketmq-develop\rocketmq-develop\store\src\main\java\org\apache\rocketmq\store\DefaultMessageStore.java,2087,596,69,304,0,969
rocketmq-develop\rocketmq-develop\store\src\main\java\org\apache\rocketmq\store\config\MessageStoreConfig.java,792,649,2,43,0,694
rocketmq-develop\rocketmq-develop\client\src\main\java\org\apache\rocketmq\client\QueryResult.java,24,14,0,3,0,17
rocketmq-develop\rocketmq-develop\remoting\src\main\java\org\apache\rocketmq\remoting\netty\NettyDecoder.java,35,13,1,5,0,19
rocketmq-develop\rocketmq-develop\test\src\main\java\org\apache\rocketmq\test\util\MQWait.java,67,23,5,6,0,34
rocketmq-develop\rocketmq-develop\filter\src\main\java\org\apache\rocketmq\filter\expression\Expression.java,0,0,0,1,0,1
rocketmq-develop\rocketmq-develop\common\src\main\java\org\apache\rocketmq\common\CountDownLatch2.java,0,19,3,5,0,27
rocketmq-develop\rocketmq-develop\common\src\main\java\org\apache\rocketmq\common\protocol\header\namesrv\GetKVConfigRequestHeader.java,27,14,1,1,0,16
rocketmq-develop\rocketmq-develop\example\src\main\java\org\apache\rocketmq\example\filter\TagFilterConsumer.java,24,9,1,5,0,15
rocketmq-develop\rocketmq-develop\common\src\main\java\org\apache\rocketmq\common\protocol\body\QueueTimeSpan.java,60,44,0,4,0,48
rocketmq-develop\rocketmq-develop\common\src\main\java\org\apache\rocketmq\common\message\MessageQueue.java,0,47,9,3,0,59
rocketmq-develop\rocketmq-develop\client\src\main\java\org\apache\rocketmq\client\stat\ConsumerStatsManager.java,129,59,2,26,0,87
rocketmq-develop\rocketmq-develop\example\src\main\java\org\apache\rocketmq\example\simple\TestProducer.java,29,8,2,3,0,13
rocketmq-develop\rocketmq-develop\logging\src\main\java\org\apache\rocketmq\logging\package-info.java,0,3,0,2,0,5
rocketmq-develop\rocketmq-develop\tools\src\test\java\org\apache\rocketmq\tools\command\topic\DeleteTopicSubCommandTest.java,13,5,0,4,0,9
rocketmq-develop\rocketmq-develop\client\src\main\java\org\apache\rocketmq\client\trace\TraceDataEncoder.java,201,109,1,54,0,164
rocketmq-develop\rocketmq-develop\common\src\main\java\org\apache\rocketmq\common\protocol\header\UnregisterClientResponseHeader.java,9,0,1,1,0,2
rocketmq-develop\rocketmq-develop\broker\src\main\java\org\apache\rocketmq\broker\processor\SendMessageProcessor.java,656,246,5,169,0,420
rocketmq-develop\rocketmq-develop\client\src\main\java\org\apache\rocketmq\client\impl\consumer\RebalanceService.java,29,8,2,1,0,11
rocketmq-develop\rocketmq-develop\remoting\src\main\java\org\apache\rocketmq\remoting\protocol\LanguageCode.java,0,20,0,1,0,21
rocketmq-develop\rocketmq-develop\broker\src\test\java\org\apache\rocketmq\broker\BrokerOuterAPITest.java,139,54,16,27,0,97
rocketmq-develop\rocketmq-develop\common\src\main\java\org\apache\rocketmq\common\protocol\body\QueryCorrectionOffsetBody.java,12,7,0,1,0,8
rocketmq-develop\rocketmq-develop\tools\src\test\java\org\apache\rocketmq\tools\command\topic\TopicStatusSubCommandTest.java,12,4,0,3,0,7
rocketmq-develop\rocketmq-develop\client\src\test\java\org\apache\rocketmq\client\consumer\DefaultMQPushConsumerTest.java,266,100,8,43,0,151
rocketmq-develop\rocketmq-develop\broker\src\main\java\org\apache\rocketmq\broker\filtersrv\FilterServerManager.java,131,44,2,12,0,58
rocketmq-develop\rocketmq-develop\tools\src\test\java\org\apache\rocketmq\tools\command\topic\TopicClusterSubCommandTest.java,12,4,0,3,0,7
rocketmq-develop\rocketmq-develop\filter\src\main\java\org\apache\rocketmq\filter\parser\ParseException.java,0,36,3,8,0,47
rocketmq-develop\rocketmq-develop\common\src\main\java\org\apache\rocketmq\common\protocol\header\GetEarliestMsgStoretimeRequestHeader.java,27,16,1,3,0,20
rocketmq-develop\rocketmq-develop\broker\src\main\java\org\apache\rocketmq\broker\transaction\TransactionRecord.java,22,15,0,2,0,17
rocketmq-develop\rocketmq-develop\common\src\main\java\org\apache\rocketmq\common\hook\FilterCheckHook.java,0,6,1,2,0,9
rocketmq-develop\rocketmq-develop\common\src\main\java\org\apache\rocketmq\common\constant\DBMsgConstants.java,4,3,0,1,0,4
rocketmq-develop\rocketmq-develop\logging\src\main\java\org\apache\rocketmq\logging\inner\Level.java,135,64,8,1,0,73
rocketmq-develop\rocketmq-develop\common\src\main\java\org\apache\rocketmq\common\stats\StatsItem.java,0,100,16,19,0,135
rocketmq-develop\rocketmq-develop\client\src\test\java\org\apache\rocketmq\client\impl\consumer\RebalancePushImplTest.java,180,112,7,64,0,183
rocketmq-develop\rocketmq-develop\tools\src\test\java\org\apache\rocketmq\tools\command\broker\UpdateBrokerConfigSubCommandTest.java,25,6,1,3,0,10
rocketmq-develop\rocketmq-develop\tools\src\main\java\org\apache\rocketmq\tools\monitor\FailedMsgs.java,36,22,0,1,0,23
rocketmq-develop\rocketmq-develop\test\src\test\java\org\apache\rocketmq\test\client\consumer\broadcast\normal\BroadCastNormalMsgNotRecvIT.java,42,14,1,6,0,21
rocketmq-develop\rocketmq-develop\client\src\main\java\org\apache\rocketmq\client\latency\MQFaultStrategy.java,85,53,3,11,0,67
rocketmq-develop\rocketmq-develop\common\src\main\java\org\apache\rocketmq\common\ConfigManager.java,61,14,7,3,0,24
rocketmq-develop\rocketmq-develop\broker\src\main\java\org\apache\rocketmq\broker\longpolling\ManyPullRequest.java,26,10,3,2,0,15
rocketmq-develop\rocketmq-develop\filter\src\main\java\org\apache\rocketmq\filter\expression\LogicExpression.java,70,19,1,5,0,25
rocketmq-develop\rocketmq-develop\example\src\main\java\org\apache\rocketmq\example\tracemessage\TracePushConsumer.java,21,11,1,6,0,18
rocketmq-develop\rocketmq-develop\store\src\test\java\org\apache\rocketmq\store\StoreTestBase.java,146,47,5,10,0,62
rocketmq-develop\rocketmq-develop\common\src\main\java\org\apache\rocketmq\common\protocol\header\CheckTransactionStateResponseHeader.java,58,31,0,3,0,34
rocketmq-develop\rocketmq-develop\tools\src\main\java\org\apache\rocketmq\tools\admin\DefaultMQAdminExtImpl.java,0,488,14,227,0,729
rocketmq-develop\rocketmq-develop\common\src\main\java\org\apache\rocketmq\common\protocol\ResponseCode.java,63,31,0,1,0,32
rocketmq-develop\rocketmq-develop\broker\src\main\java\org\apache\rocketmq\broker\filter\ConsumerFilterManager.java,427,131,10,58,0,199
rocketmq-develop\rocketmq-develop\filter\src\main\java\org\apache\rocketmq\filter\FilterSpi.java,0,4,1,1,0,6
rocketmq-develop\rocketmq-develop\client\src\main\java\org\apache\rocketmq\client\consumer\DefaultMQPushConsumer.java,852,380,3,128,0,511
rocketmq-develop\rocketmq-develop\openmessaging\src\main\java\io\openmessaging\rocketmq\producer\AbstractOMSProducer.java,0,40,1,19,0,60
rocketmq-develop\rocketmq-develop\test\src\test\java\org\apache\rocketmq\test\client\consumer\broadcast\tag\BroadCastTwoConsumerSubDiffTagIT.java,43,12,1,6,0,19
rocketmq-develop\rocketmq-develop\client\src\test\java\org\apache\rocketmq\client\trace\DefaultMQProducerWithTraceTest.java,163,57,11,23,0,91
rocketmq-develop\rocketmq-develop\common\src\main\java\org\apache\rocketmq\common\protocol\body\QueryConsumeQueueResponseBody.java,49,35,0,1,0,36
rocketmq-develop\rocketmq-develop\common\src\main\java\org\apache\rocketmq\common\protocol\header\UpdateGlobalWhiteAddrsConfigRequestHeader.java,18,8,1,2,0,11
rocketmq-develop\rocketmq-develop\remoting\src\main\java\org\apache\rocketmq\remoting\netty\TlsHelper.java,174,48,4,62,0,114
rocketmq-develop\rocketmq-develop\test\src\test\java\org\apache\rocketmq\test\client\producer\transaction\TransactionalMsgIT.java,78,31,1,11,0,43
rocketmq-develop\rocketmq-develop\client\src\main\java\org\apache\rocketmq\client\consumer\rebalance\AllocateMachineRoomNearby.java,109,43,0,26,0,69
rocketmq-develop\rocketmq-develop\example\src\main\java\org\apache\rocketmq\example\simple\RandomAsyncCommit.java,32,9,0,2,0,11
rocketmq-develop\rocketmq-develop\openmessaging\src\test\java\io\openmessaging\rocketmq\consumer\PullConsumerImplTest.java,59,20,3,10,0,33
rocketmq-develop\rocketmq-develop\remoting\src\test\java\org\apache\rocketmq\remoting\netty\NettyClientConfigTest.java,39,22,0,15,0,37
rocketmq-develop\rocketmq-develop\broker\src\test\java\org\apache\rocketmq\broker\offset\LmqConsumerOffsetManagerTest.java,71,36,4,23,0,63
rocketmq-develop\rocketmq-develop\common\src\main\java\org\apache\rocketmq\common\protocol\header\GetMinOffsetResponseHeader.java,17,8,1,2,0,11
rocketmq-develop\rocketmq-develop\tools\src\main\java\org\apache\rocketmq\tools\command\consumer\GetConsumerConfigSubCommand.java,0,40,2,17,0,59
