Class_Location,Class_Length,CheckStyle_Amount,PMD_Amount,SCAX_Amount,SpotBugs_Amount,Total_Amount
 shardingsphere-master\shardingsphere-master\shardingsphere-mode\shardingsphere-mode-type\shardingsphere-cluster-mode\shardingsphere-cluster-mode-core\src\test\java\org\apache\shardingsphere\mode\manager\cluster\coordinator\registry\metadata\watcher\MetaDataChangedWatcherTest.java,0,27,0,15,0,42
shardingsphere-master\shardingsphere-master\shardingsphere-distsql\shardingsphere-distsql-statement\src\main\java\org\apache\shardingsphere\distsql\parser\statement\ral\common\updatable\DiscardDistSQLStatement.java,0,0,0,2,0,2
 shardingsphere-master\shardingsphere-master\shardingsphere-test\shardingsphere-parser-test\src\main\java\org\apache\shardingsphere\test\sql\parser\parameterized\jaxb\cases\domain\statement\dcl\AlterLoginStatementTestCase.java,0,3,0,4,0,7
 shardingsphere-master\shardingsphere-master\shardingsphere-test\shardingsphere-parser-test\src\main\java\org\apache\shardingsphere\test\sql\parser\parameterized\jaxb\cases\domain\segment\impl\insert\ExpectedInsertColumnsClause.java,0,4,0,5,0,9
 shardingsphere-master\shardingsphere-master\shardingsphere-proxy\shardingsphere-proxy-backend\src\test\java\org\apache\shardingsphere\proxy\backend\text\data\impl\BroadcastDatabaseBackendHandlerTest.java,0,34,2,20,0,56
 shardingsphere-master\shardingsphere-master\shardingsphere-infra\shardingsphere-infra-common\src\test\java\org\apache\shardingsphere\infra\datasource\props\synonym\ConnectionPropertySynonymsTest.java,0,26,0,9,0,35
 shardingsphere-master\shardingsphere-master\shardingsphere-test\shardingsphere-parser-test\src\main\java\org\apache\shardingsphere\test\sql\parser\parameterized\jaxb\distsql\loader\DistSQLCasesLoader.java,0,12,0,12,0,24
 shardingsphere-master\shardingsphere-master\shardingsphere-db-protocol\shardingsphere-db-protocol-mysql\src\test\java\org\apache\shardingsphere\db\protocol\mysql\packet\generic\MySQLEofPacketTest.java,0,15,0,5,0,20
 shardingsphere-master\shardingsphere-master\examples\shardingsphere-example-generator\src\main\java\org\apache\shardingsphere\example\generator\core\ExampleGenerator.java,0,24,1,11,0,36
 shardingsphere-master\shardingsphere-master\shardingsphere-sql-parser\shardingsphere-sql-parser-statement\src\main\java\org\apache\shardingsphere\sql\parser\sql\dialect\statement\mysql\dal\MySQLShowVariablesStatement.java,0,4,0,6,1,11
 shardingsphere-master\shardingsphere-master\shardingsphere-kernel\shardingsphere-data-pipeline\shardingsphere-data-pipeline-dialect\shardingsphere-data-pipeline-mysql\src\main\java\org\apache\shardingsphere\data\pipeline\mysql\ingest\binlog\event\AbstractBinlogEvent.java,11,9,1,1,0,11
 shardingsphere-master\shardingsphere-master\shardingsphere-test\shardingsphere-parser-test\src\main\java\org\apache\shardingsphere\test\sql\parser\parameterized\jaxb\cases\domain\segment\impl\distsql\rdl\ExpectedEncryptRule.java,0,5,0,4,0,9
 shardingsphere-master\shardingsphere-master\shardingsphere-sql-parser\shardingsphere-sql-parser-statement\src\main\java\org\apache\shardingsphere\sql\parser\sql\dialect\statement\postgresql\ddl\PostgreSQLAlterAggregateStatement.java,0,2,0,5,0,7
 shardingsphere-master\shardingsphere-master\shardingsphere-test\shardingsphere-parser-test\src\main\java\org\apache\shardingsphere\test\sql\parser\parameterized\jaxb\cases\domain\segment\impl\with\ExpectedCommonTableExpressColumnsClause.java,0,4,0,5,0,9
 shardingsphere-master\shardingsphere-master\shardingsphere-test\shardingsphere-parser-test\src\main\java\org\apache\shardingsphere\test\sql\parser\parameterized\asserts\statement\dml\impl\UpdateStatementAssert.java,0,27,0,35,0,62
 shardingsphere-master\shardingsphere-master\shardingsphere-test\shardingsphere-parser-test\src\main\java\org\apache\shardingsphere\test\sql\parser\parameterized\jaxb\cases\domain\statement\ddl\DropServerStatementTestCase.java,0,0,0,3,0,3
 shardingsphere-master\shardingsphere-master\shardingsphere-features\shardingsphere-sharding\shardingsphere-sharding-core\src\main\java\org\apache\shardingsphere\sharding\algorithm\sharding\cosid\CosIdModShardingAlgorithm.java,0,19,1,11,0,31
 shardingsphere-master\shardingsphere-master\examples\shardingsphere-jdbc-example\single-feature-example\cluster-mode-example\cluster-mode-raw-jdbc-example\src\main\java\org\apache\shardingsphere\example\cluster\mode\raw\jdbc\config\local\LocalEncryptConfiguration.java,0,16,0,10,0,26
 shardingsphere-master\shardingsphere-master\shardingsphere-agent\shardingsphere-agent-core\src\main\java\org\apache\shardingsphere\agent\core\config\registry\AgentConfigurationRegistry.java,0,7,0,2,0,9
 shardingsphere-master\shardingsphere-master\shardingsphere-test\shardingsphere-parser-test\src\main\java\org\apache\shardingsphere\test\sql\parser\parameterized\jaxb\cases\domain\statement\distsql\ral\ParseStatementTestCase.java,0,2,0,3,0,5
 shardingsphere-master\shardingsphere-master\shardingsphere-sql-parser\shardingsphere-sql-parser-dialect\shardingsphere-sql-parser-mysql\src\test\java\org\apache\shardingsphere\sql\parser\mysql\MySQLFormatTest.java,0,44,0,33,0,77
 shardingsphere-master\shardingsphere-master\shardingsphere-proxy\shardingsphere-proxy-backend\src\test\java\org\apache\shardingsphere\proxy\backend\text\distsql\rdl\resource\ResourceSegmentsConverterTest.java,0,8,1,6,0,15
 shardingsphere-master\shardingsphere-master\shardingsphere-proxy\shardingsphere-proxy-backend\src\test\java\org\apache\shardingsphere\proxy\backend\text\distsql\ral\common\queryable\ExportSchemaConfigurationHandlerTest.java,0,37,0,32,0,69
 shardingsphere-master\shardingsphere-master\shardingsphere-infra\shardingsphere-infra-common\src\main\java\org\apache\shardingsphere\infra\config\algorithm\ShardingSphereAlgorithmPostProcessor.java,0,1,0,1,0,2
 shardingsphere-master\shardingsphere-master\shardingsphere-features\shardingsphere-sharding\shardingsphere-sharding-spring\shardingsphere-sharding-spring-namespace\src\main\java\org\apache\shardingsphere\sharding\spring\namespace\parser\strategy\ShardingStrategyBeanDefinitionParser.java,0,22,0,23,0,45
 shardingsphere-master\shardingsphere-master\shardingsphere-sql-parser\shardingsphere-sql-parser-statement\src\main\java\org\apache\shardingsphere\sql\parser\sql\dialect\statement\mysql\ddl\MySQLAlterDatabaseStatement.java,0,2,0,5,0,7
 shardingsphere-master\shardingsphere-master\shardingsphere-kernel\shardingsphere-data-pipeline\shardingsphere-data-pipeline-dialect\shardingsphere-data-pipeline-postgresql\src\main\java\org\apache\shardingsphere\data\pipeline\postgresql\ingest\wal\event\DeleteRowEvent.java,0,2,0,1,0,3
 shardingsphere-master\shardingsphere-master\shardingsphere-distsql\shardingsphere-distsql-statement\src\main\java\org\apache\shardingsphere\distsql\parser\statement\ral\common\updatable\LabelInstanceStatement.java,11,8,0,2,0,10
 shardingsphere-master\shardingsphere-master\shardingsphere-features\shardingsphere-encrypt\shardingsphere-encrypt-core\src\main\java\org\apache\shardingsphere\encrypt\metadata\EncryptTableMetaDataBuilder.java,0,30,0,26,0,56
 shardingsphere-master\shardingsphere-master\shardingsphere-test\shardingsphere-parser-test\src\main\java\org\apache\shardingsphere\test\sql\parser\parameterized\asserts\statement\dal\impl\MySQLDelimiterStatementAssert.java,0,4,0,7,0,11
 shardingsphere-master\shardingsphere-master\shardingsphere-sql-parser\shardingsphere-sql-parser-statement\src\main\java\org\apache\shardingsphere\sql\parser\sql\common\statement\ddl\PrepareStatement.java,47,13,0,7,4,24
 shardingsphere-master\shardingsphere-master\shardingsphere-infra\shardingsphere-infra-common\src\main\java\org\apache\shardingsphere\infra\datanode\DataNodeBuilder.java,0,2,0,2,0,4
 shardingsphere-master\shardingsphere-master\shardingsphere-sql-parser\shardingsphere-sql-parser-statement\src\main\java\org\apache\shardingsphere\sql\parser\sql\dialect\statement\mysql\ddl\MySQLDropIndexStatement.java,0,4,0,5,1,10
 shardingsphere-master\shardingsphere-master\shardingsphere-infra\shardingsphere-infra-common\src\test\java\org\apache\shardingsphere\infra\database\metadata\DataSourceMetaDataTest.java,0,23,0,22,0,45
 shardingsphere-master\shardingsphere-master\shardingsphere-sql-parser\shardingsphere-sql-parser-statement\src\main\java\org\apache\shardingsphere\sql\parser\sql\dialect\statement\postgresql\dml\PostgreSQLDoStatement.java,0,1,0,5,0,6
 shardingsphere-master\shardingsphere-master\shardingsphere-sql-parser\shardingsphere-sql-parser-engine\src\test\java\org\apache\shardingsphere\sql\parser\core\database\cache\ParseTreeCacheLoaderTest.java,0,7,1,5,1,14
 shardingsphere-master\shardingsphere-master\shardingsphere-infra\shardingsphere-infra-common\src\test\java\org\apache\shardingsphere\infra\config\fixture\WithoutInitAlgorithm.java,0,3,0,1,0,4
 shardingsphere-master\shardingsphere-master\shardingsphere-features\shardingsphere-encrypt\shardingsphere-encrypt-core\src\main\java\org\apache\shardingsphere\encrypt\rewrite\token\generator\EncryptInsertOnUpdateTokenGenerator.java,0,80,0,76,0,156
 shardingsphere-master\shardingsphere-master\examples\shardingsphere-jdbc-example\single-feature-example\transaction-example\transaction-2pc-xa-spring-boot-example\src\main\java\org\apache\shardingsphere\example\transaction\xa\spring\boot\TransactionConfiguration.java,25,3,0,1,0,4
 shardingsphere-master\shardingsphere-master\examples\other-example\shardingsphere-parser-example\src\main\java\org\apache\shardingsphere\example\parser\mysql\statement\MySQLParserStatementExample.java,0,35,1,10,0,46
 shardingsphere-master\shardingsphere-master\shardingsphere-mode\shardingsphere-mode-type\shardingsphere-cluster-mode\shardingsphere-cluster-mode-core\src\test\java\org\apache\shardingsphere\mode\manager\cluster\coordinator\lock\util\LockNodeUtilTest.java,0,6,0,2,0,8
 shardingsphere-master\shardingsphere-master\shardingsphere-sql-parser\shardingsphere-sql-parser-statement\src\main\java\org\apache\shardingsphere\sql\parser\sql\common\value\literal\impl\StringLiteralValue.java,0,5,0,2,0,7
 shardingsphere-master\shardingsphere-master\shardingsphere-agent\shardingsphere-agent-plugins\shardingsphere-agent-plugin-metrics\shardingsphere-agent-metrics-api\src\test\java\org\apache\shardingsphere\agent\metrics\api\fixture\FixtureWrapperFactory.java,0,1,0,1,0,2
 shardingsphere-master\shardingsphere-master\shardingsphere-kernel\shardingsphere-single-table\shardingsphere-single-table-core\src\main\java\org\apache\shardingsphere\singletable\rule\builder\DefaultSingleTableSchemaRuleConfigurationBuilder.java,0,5,0,4,0,9
 shardingsphere-master\shardingsphere-master\shardingsphere-proxy\shardingsphere-proxy-backend\src\test\java\org\apache\shardingsphere\proxy\backend\text\admin\mysql\executor\ShowVersionExecutorTest.java,0,3,0,2,0,5
 shardingsphere-master\shardingsphere-master\shardingsphere-features\shardingsphere-sharding\shardingsphere-sharding-core\src\test\java\org\apache\shardingsphere\sharding\merge\dql\pagination\LimitDecoratorMergedResultTest.java,0,23,0,21,0,44
 shardingsphere-master\shardingsphere-master\shardingsphere-db-protocol\shardingsphere-db-protocol-mysql\src\main\java\org\apache\shardingsphere\db\protocol\mysql\packet\generic\MySQLErrPacket.java,0,23,0,5,0,28
 shardingsphere-master\shardingsphere-master\shardingsphere-test\shardingsphere-parser-test\src\main\java\org\apache\shardingsphere\test\sql\parser\parameterized\asserts\segment\distsql\rdl\EncryptColumnAssert.java,0,11,0,14,0,25
 shardingsphere-master\shardingsphere-master\shardingsphere-test\shardingsphere-parser-test\src\main\java\org\apache\shardingsphere\test\sql\parser\parameterized\jaxb\cases\domain\statement\distsql\rdl\drop\DropShardingAlgorithmStatementTestCase.java,0,3,0,4,0,7
 shardingsphere-master\shardingsphere-master\shardingsphere-agent\shardingsphere-agent-plugins\shardingsphere-agent-plugin-tracing\shardingsphere-agent-tracing-zipkin\src\main\java\org\apache\shardingsphere\agent\plugin\tracing\zipkin\advice\JDBCExecutorCallbackAdvice.java,0,18,1,17,0,36
 shardingsphere-master\shardingsphere-master\shardingsphere-db-protocol\shardingsphere-db-protocol-postgresql\src\main\java\org\apache\shardingsphere\db\protocol\postgresql\packet\command\query\extended\bind\protocol\PostgreSQLInt8BinaryProtocolValue.java,0,8,0,7,0,15
 shardingsphere-master\shardingsphere-master\shardingsphere-infra\shardingsphere-infra-common\src\test\java\org\apache\shardingsphere\infra\metadata\user\ShardingSphereUsersTest.java,0,4,0,4,0,8
 shardingsphere-master\shardingsphere-master\shardingsphere-features\shardingsphere-sharding\shardingsphere-sharding-core\src\test\java\org\apache\shardingsphere\sharding\route\engine\type\standard\SubqueryRouteTest.java,0,54,0,17,0,71
 shardingsphere-master\shardingsphere-master\shardingsphere-features\shardingsphere-shadow\shardingsphere-shadow-core\src\main\java\org\apache\shardingsphere\shadow\rule\ShadowRule.java,0,75,0,48,0,123
 shardingsphere-master\shardingsphere-master\shardingsphere-spi\src\main\java\org\apache\shardingsphere\spi\singleton\TypedSingletonSPIHolder.java,0,15,1,5,0,21
 shardingsphere-master\shardingsphere-master\shardingsphere-proxy\shardingsphere-proxy-frontend\shardingsphere-proxy-frontend-postgresql\src\main\java\org\apache\shardingsphere\proxy\frontend\postgresql\command\query\extended\close\PostgreSQLComCloseExecutor.java,0,11,0,9,0,20
 shardingsphere-master\shardingsphere-master\shardingsphere-kernel\shardingsphere-transaction\shardingsphere-transaction-type\shardingsphere-transaction-xa\shardingsphere-transaction-xa-core\src\test\java\org\apache\shardingsphere\transaction\xa\manager\XATransactionManagerProviderLoaderTest.java,0,7,0,4,0,11
 shardingsphere-master\shardingsphere-master\shardingsphere-features\shardingsphere-encrypt\shardingsphere-encrypt-api\src\main\java\org\apache\shardingsphere\encrypt\api\config\rule\EncryptColumnRuleConfiguration.java,0,28,0,3,0,31
 shardingsphere-master\shardingsphere-master\shardingsphere-proxy\shardingsphere-proxy-backend\src\main\java\org\apache\shardingsphere\proxy\backend\communication\jdbc\recognizer\spi\JDBCDriverURLRecognizer.java,0,4,0,2,0,6
 shardingsphere-master\shardingsphere-master\shardingsphere-features\shardingsphere-sharding\shardingsphere-sharding-spring\shardingsphere-sharding-spring-namespace\src\main\java\org\apache\shardingsphere\sharding\spring\namespace\factorybean\KeyGenerateAlgorithmFactoryBean.java,0,6,0,4,0,10
 shardingsphere-master\shardingsphere-master\shardingsphere-db-protocol\shardingsphere-db-protocol-opengauss\src\main\java\org\apache\shardingsphere\db\protocol\opengauss\packet\command\query\extended\bind\OpenGaussComBatchBindPacket.java,0,41,1,24,0,66
 shardingsphere-master\shardingsphere-master\shardingsphere-db-protocol\shardingsphere-db-protocol-mysql\src\main\java\org\apache\shardingsphere\db\protocol\mysql\packet\command\query\text\MySQLTextResultSetRowPacket.java,0,17,2,8,0,27
 shardingsphere-master\shardingsphere-master\shardingsphere-features\shardingsphere-readwrite-splitting\shardingsphere-readwrite-splitting-core\src\main\java\org\apache\shardingsphere\readwritesplitting\route\impl\ReadwriteSplittingDataSourceRouter.java,0,14,1,11,0,26
 shardingsphere-master\shardingsphere-master\shardingsphere-features\shardingsphere-sharding\shardingsphere-sharding-core\src\main\java\org\apache\shardingsphere\sharding\algorithm\sharding\cosid\PropertiesUtil.java,0,6,1,5,0,12
 shardingsphere-master\shardingsphere-master\shardingsphere-jdbc\shardingsphere-jdbc-core\src\main\java\org\apache\shardingsphere\driver\state\circuit\connection\CircuitBreakerConnection.java,0,42,10,14,0,66
 shardingsphere-master\shardingsphere-master\shardingsphere-sql-parser\shardingsphere-sql-parser-statement\src\main\java\org\apache\shardingsphere\sql\parser\sql\common\segment\dml\pagination\limit\ParameterMarkerLimitValueSegment.java,0,7,0,5,0,12
 shardingsphere-master\shardingsphere-master\shardingsphere-jdbc\shardingsphere-jdbc-core\src\main\java\org\apache\shardingsphere\driver\jdbc\adapter\AbstractConnectionAdapter.java,34,9,4,3,0,16
 shardingsphere-master\shardingsphere-master\shardingsphere-proxy\shardingsphere-proxy-frontend\shardingsphere-proxy-frontend-reactive-core\src\test\java\org\apache\shardingsphere\proxy\frontend\reactive\command\ReactiveCommandExecuteTaskTest.java,0,44,0,23,0,67
 shardingsphere-master\shardingsphere-master\shardingsphere-kernel\shardingsphere-data-pipeline\shardingsphere-data-pipeline-core\src\main\java\org\apache\shardingsphere\data\pipeline\core\job\progress\yaml\YamlJobProgress.java,0,18,0,2,0,20
 shardingsphere-master\shardingsphere-master\shardingsphere-sql-parser\shardingsphere-sql-parser-statement\src\main\java\org\apache\shardingsphere\sql\parser\sql\dialect\statement\oracle\ddl\OracleAuditStatement.java,0,1,0,5,0,6
 shardingsphere-master\shardingsphere-master\shardingsphere-db-protocol\shardingsphere-db-protocol-postgresql\src\test\java\org\apache\shardingsphere\db\protocol\postgresql\packet\command\query\extended\bind\protocol\PostgreSQLArrayParameterDecoderTest.java,0,46,0,11,0,57
 shardingsphere-master\shardingsphere-master\shardingsphere-features\shardingsphere-sharding\shardingsphere-sharding-distsql\shardingsphere-sharding-distsql-statement\src\main\java\org\apache\shardingsphere\sharding\distsql\parser\statement\CreateDefaultShardingStrategyStatement.java,0,11,0,3,0,14
 shardingsphere-master\shardingsphere-master\shardingsphere-proxy\shardingsphere-proxy-backend\src\main\java\org\apache\shardingsphere\proxy\backend\exception\TableModifyInTransactionException.java,0,8,0,4,0,12
 shardingsphere-master\shardingsphere-master\shardingsphere-proxy\shardingsphere-proxy-backend\src\main\java\org\apache\shardingsphere\proxy\backend\text\distsql\ral\common\updatable\CreateTrafficRuleHandler.java,0,26,0,30,0,56
 shardingsphere-master\shardingsphere-master\shardingsphere-mode\shardingsphere-mode-type\shardingsphere-cluster-mode\shardingsphere-cluster-mode-repository\shardingsphere-cluster-mode-repository-provider\shardingsphere-cluster-mode-repository-zookeeper-curator\src\test\java\org\apache\shardingsphere\mode\repository\cluster\zookeeper\handler\CuratorZookeeperExceptionHandlerTest.java,0,5,1,4,0,10
 shardingsphere-master\shardingsphere-master\shardingsphere-kernel\shardingsphere-data-pipeline\shardingsphere-data-pipeline-core\src\main\java\org\apache\shardingsphere\data\pipeline\core\context\PipelineContext.java,0,12,3,1,0,16
 shardingsphere-master\shardingsphere-master\shardingsphere-features\shardingsphere-shadow\shardingsphere-shadow-spring\shardingsphere-shadow-spring-boot-starter\src\main\java\org\apache\shardingsphere\shadow\spring\boot\ShadowRuleSpringBootConfiguration.java,35,14,0,13,0,27
 shardingsphere-master\shardingsphere-master\shardingsphere-proxy\shardingsphere-proxy-frontend\shardingsphere-proxy-frontend-core\src\main\java\org\apache\shardingsphere\proxy\frontend\exception\UnsupportedCommandException.java,0,3,0,1,0,4
 shardingsphere-master\shardingsphere-master\shardingsphere-infra\shardingsphere-infra-federation\shardingsphere-infra-federation-executor\src\main\java\org\apache\shardingsphere\infra\federation\executor\customized\CustomizedFilterableExecuteDataContext.java,0,15,0,6,0,21
 shardingsphere-master\shardingsphere-master\shardingsphere-infra\shardingsphere-infra-rewrite\src\main\java\org\apache\shardingsphere\infra\rewrite\sql\token\generator\SQLTokenGenerators.java,0,13,0,10,0,23
 shardingsphere-master\shardingsphere-master\shardingsphere-agent\shardingsphere-agent-core\src\main\java\org\apache\shardingsphere\agent\core\config\yaml\engine\YamlEngine.java,0,5,0,3,0,8
 shardingsphere-master\shardingsphere-master\shardingsphere-proxy\shardingsphere-proxy-backend\src\main\java\org\apache\shardingsphere\proxy\backend\text\admin\DatabaseAdminBackendHandlerFactory.java,0,22,0,21,0,43
 shardingsphere-master\shardingsphere-master\shardingsphere-sql-parser\shardingsphere-sql-parser-statement\src\main\java\org\apache\shardingsphere\sql\parser\sql\dialect\statement\sqlserver\ddl\SQLServerAlterTriggerStatement.java,0,1,0,6,0,7
 shardingsphere-master\shardingsphere-master\shardingsphere-infra\shardingsphere-infra-federation\shardingsphere-infra-federation-optimizer\src\main\java\org\apache\shardingsphere\infra\federation\optimizer\metadata\FederationDatabaseMetaData.java,0,14,1,4,0,19
 shardingsphere-master\shardingsphere-master\shardingsphere-sql-parser\shardingsphere-sql-parser-statement\src\main\java\org\apache\shardingsphere\sql\parser\sql\dialect\statement\postgresql\ddl\PostgreSQLDropViewStatement.java,0,1,0,5,0,6
 shardingsphere-master\shardingsphere-master\shardingsphere-kernel\shardingsphere-transaction\shardingsphere-transaction-type\shardingsphere-transaction-xa\shardingsphere-transaction-xa-provider\shardingsphere-transaction-xa-narayana\src\main\java\org\apache\shardingsphere\transaction\xa\narayana\manager\NarayanaXATransactionManagerProvider.java,0,35,7,20,0,62
 shardingsphere-master\shardingsphere-master\shardingsphere-sql-parser\shardingsphere-sql-parser-statement\src\main\java\org\apache\shardingsphere\sql\parser\sql\dialect\statement\mysql\dal\MySQLCacheIndexStatement.java,0,7,0,9,1,17
 shardingsphere-master\shardingsphere-master\shardingsphere-kernel\shardingsphere-transaction\shardingsphere-transaction-type\shardingsphere-transaction-xa\shardingsphere-transaction-xa-core\src\main\java\org\apache\shardingsphere\transaction\xa\manager\XATransactionManagerProviderLoader.java,0,10,0,6,0,16
 shardingsphere-master\shardingsphere-master\shardingsphere-infra\shardingsphere-infra-binder\src\test\java\org\apache\shardingsphere\infra\binder\statement\dcl\RevokeStatementContextTest.java,0,9,0,15,0,24
 shardingsphere-master\shardingsphere-master\shardingsphere-sql-parser\shardingsphere-sql-parser-statement\src\main\java\org\apache\shardingsphere\sql\parser\sql\common\statement\tcl\CommitStatement.java,3,1,1,3,0,5
 shardingsphere-master\shardingsphere-master\shardingsphere-infra\shardingsphere-infra-common\src\main\java\org\apache\shardingsphere\infra\yaml\config\pojo\rulealtered\YamlOnRuleAlteredActionConfiguration.java,0,34,0,5,0,39
 shardingsphere-master\shardingsphere-master\shardingsphere-proxy\shardingsphere-proxy-backend\src\main\java\org\apache\shardingsphere\proxy\backend\text\distsql\DistSQLBackendHandlerFactory.java,0,13,0,17,0,30
 shardingsphere-master\shardingsphere-master\shardingsphere-mode\shardingsphere-mode-core\src\main\java\org\apache\shardingsphere\mode\metadata\persist\service\impl\GlobalRulePersistService.java,0,14,0,10,0,24
 shardingsphere-master\shardingsphere-master\shardingsphere-sql-parser\shardingsphere-sql-parser-statement\src\main\java\org\apache\shardingsphere\sql\parser\sql\dialect\statement\sqlserver\ddl\SQLServerCreateIndexStatement.java,0,1,0,5,0,6
 shardingsphere-master\shardingsphere-master\shardingsphere-sql-parser\shardingsphere-sql-parser-statement\src\main\java\org\apache\shardingsphere\sql\parser\sql\dialect\statement\opengauss\OpenGaussStatement.java,0,1,0,1,0,2
 shardingsphere-master\shardingsphere-master\shardingsphere-infra\shardingsphere-infra-binder\src\test\java\org\apache\shardingsphere\infra\binder\segment\select\pagination\PaginationContextTest.java,0,95,0,42,0,137
 shardingsphere-master\shardingsphere-master\shardingsphere-sql-parser\shardingsphere-sql-parser-statement\src\main\java\org\apache\shardingsphere\sql\parser\sql\common\statement\dal\UseStatement.java,5,3,1,3,0,7
 shardingsphere-master\shardingsphere-master\shardingsphere-features\shardingsphere-sharding\shardingsphere-sharding-distsql\shardingsphere-sharding-distsql-handler\src\test\java\org\apache\shardingsphere\sharding\distsql\query\UnusedShardingKeyGeneratorsQueryResultSetTest.java,0,16,0,15,0,31
 shardingsphere-master\shardingsphere-master\shardingsphere-proxy\shardingsphere-proxy-bootstrap\src\test\java\org\apache\shardingsphere\proxy\fixture\FixtureClusterPersistRepository.java,0,21,5,9,0,35
 shardingsphere-master\shardingsphere-master\shardingsphere-test\shardingsphere-parser-test\src\main\java\org\apache\shardingsphere\test\sql\parser\parameterized\asserts\statement\distsql\rdl\alter\impl\AlterShadowRuleStatementAssert.java,0,10,0,17,0,27
 shardingsphere-master\shardingsphere-master\shardingsphere-test\shardingsphere-parser-test\src\main\java\org\apache\shardingsphere\test\sql\parser\parameterized\jaxb\cases\domain\segment\impl\projection\impl\expression\ExpectedExpressionProjection.java,0,6,0,7,0,13
 shardingsphere-master\shardingsphere-master\shardingsphere-infra\shardingsphere-infra-common\src\test\java\org\apache\shardingsphere\infra\metadata\schema\QualifiedSchemaTest.java,0,4,0,2,0,6
 shardingsphere-master\shardingsphere-master\shardingsphere-infra\shardingsphere-infra-binder\src\test\java\org\apache\shardingsphere\infra\binder\segment\select\pagination\engine\LimitPaginationContextEngineTest.java,0,26,0,13,0,39
 shardingsphere-master\shardingsphere-master\shardingsphere-infra\shardingsphere-infra-common\src\main\java\org\apache\shardingsphere\infra\config\function\DistributedRuleConfiguration.java,0,1,0,1,0,2
 shardingsphere-master\shardingsphere-master\shardingsphere-kernel\shardingsphere-authority\shardingsphere-authority-core\src\main\java\org\apache\shardingsphere\authority\rule\builder\DefaultUser.java,0,7,0,1,0,8
 shardingsphere-master\shardingsphere-master\shardingsphere-features\shardingsphere-db-discovery\shardingsphere-db-discovery-distsql\shardingsphere-db-discovery-distsql-statement\src\main\java\org\apache\shardingsphere\dbdiscovery\distsql\parser\statement\ShowDatabaseDiscoveryTypesStatement.java,0,3,0,4,0,7
 shardingsphere-master\shardingsphere-master\shardingsphere-features\shardingsphere-sharding\shardingsphere-sharding-distsql\shardingsphere-sharding-distsql-statement\src\main\java\org\apache\shardingsphere\scaling\distsql\statement\segment\ShardingScalingRuleConfigurationSegment.java,0,5,0,1,0,6
 shardingsphere-master\shardingsphere-master\shardingsphere-features\shardingsphere-encrypt\shardingsphere-encrypt-core\src\main\java\org\apache\shardingsphere\encrypt\rewrite\token\generator\AssistQueryAndPlainInsertColumnsTokenGenerator.java,0,16,1,15,0,32
 shardingsphere-master\shardingsphere-master\shardingsphere-kernel\shardingsphere-transaction\shardingsphere-transaction-type\shardingsphere-transaction-base\shardingsphere-transaction-base-seata-at\src\main\java\org\apache\shardingsphere\transaction\base\seata\at\SeataATShardingSphereTransactionManager.java,0,35,0,16,0,51
 shardingsphere-master\shardingsphere-master\shardingsphere-infra\shardingsphere-infra-common\src\main\java\org\apache\shardingsphere\infra\distsql\update\RuleDefinitionUpdater.java,0,6,0,3,0,9
 shardingsphere-master\shardingsphere-master\shardingsphere-test\shardingsphere-integration-test\shardingsphere-integration-test-suite\src\test\java\org\apache\shardingsphere\test\integration\cases\dataset\metadata\DataSetMetaData.java,0,8,0,1,0,9
 shardingsphere-master\shardingsphere-master\shardingsphere-infra\shardingsphere-infra-binder\src\main\java\org\apache\shardingsphere\infra\binder\statement\dcl\GrantStatementContext.java,0,7,0,6,0,13
 shardingsphere-master\shardingsphere-master\examples\shardingsphere-jdbc-example\single-feature-example\transaction-example\transaction-2pc-xa-bitronix-raw-jdbc-example\src\main\java\org\apache\shardingsphere\example\transaction\xa\bitronix\raw\jdbc\OrderServiceImpl.java,0,23,8,12,0,43
 shardingsphere-master\shardingsphere-master\shardingsphere-infra\shardingsphere-infra-common\src\main\java\org\apache\shardingsphere\infra\database\DefaultSchema.java,0,3,0,1,0,4
 shardingsphere-master\shardingsphere-master\shardingsphere-infra\shardingsphere-infra-binder\src\test\java\org\apache\shardingsphere\infra\binder\segment\select\projection\impl\ShorthandProjectionTest.java,0,12,0,5,0,17
 shardingsphere-master\shardingsphere-master\shardingsphere-jdbc\shardingsphere-jdbc-core\src\test\java\org\apache\shardingsphere\driver\executor\batch\BatchExecutionUnitTest.java,0,18,0,8,0,26
 shardingsphere-master\shardingsphere-master\examples\example-core\example-raw-jdbc\src\main\java\org\apache\shardingsphere\example\core\jdbc\repository\UserRepositoryImpl.java,0,18,0,6,0,24
 shardingsphere-master\shardingsphere-master\shardingsphere-test\shardingsphere-integration-test\shardingsphere-integration-test-suite\src\test\java\org\apache\shardingsphere\test\integration\framework\container\atomic\adapter\AdapterContainer.java,0,2,0,3,0,5
 shardingsphere-master\shardingsphere-master\shardingsphere-sql-parser\shardingsphere-sql-parser-statement\src\main\java\org\apache\shardingsphere\sql\parser\sql\dialect\statement\postgresql\ddl\PostgreSQLCreateExtensionStatement.java,0,1,0,5,0,6
 shardingsphere-master\shardingsphere-master\shardingsphere-proxy\shardingsphere-proxy-backend\src\test\java\org\apache\shardingsphere\proxy\backend\session\ConnectionSessionTest.java,0,31,0,9,0,40
 shardingsphere-master\shardingsphere-master\shardingsphere-jdbc\shardingsphere-jdbc-core\src\main\java\org\apache\shardingsphere\driver\state\ok\OKDriverState.java,0,4,0,3,0,7
 shardingsphere-master\shardingsphere-master\shardingsphere-test\shardingsphere-parser-test\src\main\java\org\apache\shardingsphere\test\sql\parser\parameterized\asserts\statement\dal\impl\MySQLSetResourceGroupStatementAssert.java,0,5,0,8,0,13
 shardingsphere-master\shardingsphere-master\shardingsphere-features\shardingsphere-encrypt\shardingsphere-encrypt-spring\shardingsphere-encrypt-spring-boot-starter\src\main\java\org\apache\shardingsphere\encrypt\spring\boot\condition\EncryptSpringBootCondition.java,0,8,0,5,0,13
 shardingsphere-master\shardingsphere-master\shardingsphere-test\shardingsphere-parser-test\src\main\java\org\apache\shardingsphere\test\sql\parser\parameterized\asserts\statement\tcl\impl\UnlockStatementAssert.java,0,4,1,6,0,11
 shardingsphere-master\shardingsphere-master\shardingsphere-sql-parser\shardingsphere-sql-parser-statement\src\main\java\org\apache\shardingsphere\sql\parser\sql\dialect\statement\opengauss\ddl\OpenGaussCreateFunctionStatement.java,0,1,0,5,0,6
 shardingsphere-master\shardingsphere-master\shardingsphere-features\shardingsphere-shadow\shardingsphere-shadow-core\src\test\java\org\apache\shardingsphere\shadow\yaml\swapper\YamlRootRuleConfigurationsForYamlShadowRuleConfigurationTest.java,0,9,0,6,0,15
 shardingsphere-master\shardingsphere-master\shardingsphere-db-protocol\shardingsphere-db-protocol-postgresql\src\test\java\org\apache\shardingsphere\db\protocol\postgresql\packet\command\query\PostgreSQLRowDescriptionPacketTest.java,0,13,0,7,0,20
 shardingsphere-master\shardingsphere-master\shardingsphere-agent\shardingsphere-agent-plugins\shardingsphere-agent-plugin-tracing\shardingsphere-agent-tracing-zipkin\src\main\java\org\apache\shardingsphere\agent\plugin\tracing\zipkin\definition\ZipkinPluginDefinitionService.java,0,34,0,13,0,47
 shardingsphere-master\shardingsphere-master\shardingsphere-sql-parser\shardingsphere-sql-parser-statement\src\main\java\org\apache\shardingsphere\sql\parser\sql\common\segment\ddl\column\position\ColumnFirstPositionSegment.java,0,3,0,4,0,7
 shardingsphere-master\shardingsphere-master\shardingsphere-db-protocol\shardingsphere-db-protocol-mysql\src\main\java\org\apache\shardingsphere\db\protocol\mysql\packet\binlog\row\column\MySQLBinlogColumnDef.java,0,6,0,3,0,9
 shardingsphere-master\shardingsphere-master\shardingsphere-test\shardingsphere-parser-test\src\main\java\org\apache\shardingsphere\test\sql\parser\parameterized\asserts\statement\distsql\rdl\create\impl\CreateDefaultShadowAlgorithmStatementAssert.java,0,9,0,11,0,20
 shardingsphere-master\shardingsphere-master\shardingsphere-db-protocol\shardingsphere-db-protocol-mysql\src\main\java\org\apache\shardingsphere\db\protocol\mysql\packet\binlog\row\column\value\decimal\MySQLDecimalBinlogProtocolValue.java,0,47,0,21,0,68
 shardingsphere-master\shardingsphere-master\shardingsphere-mode\shardingsphere-mode-type\shardingsphere-cluster-mode\shardingsphere-cluster-mode-core\src\main\java\org\apache\shardingsphere\mode\manager\cluster\coordinator\registry\status\compute\event\XaRecoveryIdEvent.java,0,4,0,3,0,7
 shardingsphere-master\shardingsphere-master\shardingsphere-sql-parser\shardingsphere-sql-parser-dialect\shardingsphere-sql-parser-sqlserver\src\test\java\org\apache\shardingsphere\sql\parser\sqlserver\UnsupportedSQLServerParserParameterizedTest.java,0,7,0,6,0,13
 shardingsphere-master\shardingsphere-master\shardingsphere-infra\shardingsphere-infra-binder\src\test\java\org\apache\shardingsphere\infra\binder\statement\dal\ShowIndexStatementContextTest.java,0,5,0,10,0,15
 shardingsphere-master\shardingsphere-master\shardingsphere-test\shardingsphere-parser-test\src\main\java\org\apache\shardingsphere\test\sql\parser\parameterized\jaxb\cases\domain\statement\distsql\ral\ShowTableMetadataStatementTestCase.java,0,5,0,5,0,10
 shardingsphere-master\shardingsphere-master\shardingsphere-proxy\shardingsphere-proxy-backend\src\main\java\org\apache\shardingsphere\proxy\backend\text\data\DatabaseBackendHandler.java,0,2,0,1,0,3
 shardingsphere-master\shardingsphere-master\shardingsphere-test\shardingsphere-parser-test\src\main\java\org\apache\shardingsphere\test\sql\parser\parameterized\asserts\segment\insert\InsertValuesClauseAssert.java,0,10,0,15,0,25
 shardingsphere-master\shardingsphere-master\shardingsphere-features\shardingsphere-sharding\shardingsphere-sharding-core\src\test\java\org\apache\shardingsphere\sharding\route\engine\condition\generator\impl\ConditionValueCompareOperatorGeneratorTest.java,0,56,0,43,0,99
 shardingsphere-master\shardingsphere-master\shardingsphere-sql-parser\shardingsphere-sql-parser-engine\src\main\java\org\apache\shardingsphere\sql\parser\api\CacheOption.java,0,7,0,1,0,8
 shardingsphere-master\shardingsphere-master\shardingsphere-kernel\shardingsphere-data-pipeline\shardingsphere-data-pipeline-spi\src\main\java\org\apache\shardingsphere\data\pipeline\api\job\JobStatus.java,0,10,0,1,0,11
 shardingsphere-master\shardingsphere-master\shardingsphere-agent\shardingsphere-agent-plugins\shardingsphere-agent-plugin-tracing\shardingsphere-agent-tracing-zipkin\src\test\java\org\apache\shardingsphere\agent\plugin\tracing\zipkin\definition\ZipkinPluginDefinitionServiceTest.java,0,10,0,3,0,13
 shardingsphere-master\shardingsphere-master\shardingsphere-proxy\shardingsphere-proxy-backend\src\main\java\org\apache\shardingsphere\proxy\backend\exception\RuleNotExistedException.java,0,1,0,1,0,2
 shardingsphere-master\shardingsphere-master\shardingsphere-db-protocol\shardingsphere-db-protocol-postgresql\src\test\java\org\apache\shardingsphere\db\protocol\postgresql\packet\ByteBufTestUtils.java,0,7,0,4,0,11
 shardingsphere-master\shardingsphere-master\shardingsphere-test\shardingsphere-parser-test\src\main\java\org\apache\shardingsphere\test\sql\parser\parameterized\asserts\statement\dml\impl\SelectStatementAssert.java,0,72,0,84,0,156
 shardingsphere-master\shardingsphere-master\shardingsphere-sql-parser\shardingsphere-sql-parser-dialect\shardingsphere-sql-parser-sqlserver\src\main\java\org\apache\shardingsphere\sql\parser\sqlserver\parser\SQLServerParserFacade.java,0,4,0,2,0,6
 shardingsphere-master\shardingsphere-master\shardingsphere-infra\shardingsphere-infra-common\src\main\java\org\apache\shardingsphere\infra\datasource\pool\metadata\type\hikari\HikariDataSourcePoolMetaData.java,0,26,0,4,0,30
 shardingsphere-master\shardingsphere-master\shardingsphere-test\shardingsphere-parser-test\src\main\java\org\apache\shardingsphere\test\sql\parser\parameterized\asserts\statement\distsql\ral\impl\common\updatable\SetVariableStatementAssert.java,0,3,2,6,0,11
 shardingsphere-master\shardingsphere-master\shardingsphere-test\shardingsphere-parser-test\src\main\java\org\apache\shardingsphere\test\sql\parser\parameterized\asserts\statement\dal\impl\ShowColumnsStatementAssert.java,0,7,0,12,0,19
 shardingsphere-master\shardingsphere-master\shardingsphere-test\shardingsphere-parser-test\src\main\java\org\apache\shardingsphere\test\sql\parser\parameterized\jaxb\cases\domain\segment\impl\table\ExpectedTable.java,0,5,0,3,0,8
 shardingsphere-master\shardingsphere-master\shardingsphere-test\shardingsphere-parser-test\src\main\java\org\apache\shardingsphere\test\sql\parser\parameterized\jaxb\cases\domain\segment\impl\table\ExpectedJoinTable.java,0,6,0,6,0,12
 shardingsphere-master\shardingsphere-master\shardingsphere-test\shardingsphere-parser-test\src\main\java\org\apache\shardingsphere\test\sql\parser\parameterized\jaxb\cases\domain\statement\dcl\SetDefaultRoleStatementTestCase.java,0,0,0,3,0,3
 shardingsphere-master\shardingsphere-master\shardingsphere-db-protocol\shardingsphere-db-protocol-mysql\src\test\java\org\apache\shardingsphere\db\protocol\mysql\packet\command\query\binary\execute\protocol\MySQLMySQLBinaryProtocolValueFactoryTest.java,0,80,0,29,0,109
 shardingsphere-master\shardingsphere-master\shardingsphere-kernel\shardingsphere-transaction\shardingsphere-transaction-type\shardingsphere-transaction-base\shardingsphere-transaction-base-seata-at\src\main\java\org\apache\shardingsphere\transaction\base\seata\at\SeataTransactionHolder.java,0,7,0,2,0,9
 shardingsphere-master\shardingsphere-master\shardingsphere-test\shardingsphere-parser-test\src\main\java\org\apache\shardingsphere\test\sql\parser\parameterized\asserts\statement\distsql\ral\impl\common\queryable\ShowAuthorityRuleStatementAssert.java,0,4,2,7,0,13
 shardingsphere-master\shardingsphere-master\shardingsphere-test\shardingsphere-parser-test\src\main\java\org\apache\shardingsphere\test\sql\parser\parameterized\jaxb\cases\domain\statement\distsql\ral\scaling\ResetScalingStatementTestCase.java,0,2,0,3,0,5
 shardingsphere-master\shardingsphere-master\shardingsphere-distsql\shardingsphere-distsql-parser\src\main\java\org\apache\shardingsphere\distsql\parser\core\featured\FeaturedDistSQLStatementParserEngine.java,0,16,0,12,0,28
 shardingsphere-master\shardingsphere-master\shardingsphere-distsql\shardingsphere-distsql-statement\src\main\java\org\apache\shardingsphere\distsql\parser\statement\ral\common\updatable\PrepareDistSQLStatement.java,0,0,0,2,0,2
 shardingsphere-master\shardingsphere-master\shardingsphere-proxy\shardingsphere-proxy-backend\src\main\java\org\apache\shardingsphere\proxy\backend\text\distsql\ral\common\queryable\ShowTransactionRuleHandler.java,0,15,0,12,0,27
 shardingsphere-master\shardingsphere-master\shardingsphere-features\shardingsphere-shadow\shardingsphere-shadow-distsql\shardingsphere-shadow-distsql-handler\src\test\java\org\apache\shardingsphere\shadow\distsql\update\CreateShadowAlgorithmStatementUpdaterTest.java,0,32,0,20,0,52
 shardingsphere-master\shardingsphere-master\shardingsphere-proxy\shardingsphere-proxy-frontend\shardingsphere-proxy-frontend-postgresql\src\main\java\org\apache\shardingsphere\proxy\frontend\postgresql\command\query\extended\Portal.java,0,6,0,2,0,8
 shardingsphere-master\shardingsphere-master\shardingsphere-proxy\shardingsphere-proxy-frontend\shardingsphere-proxy-frontend-postgresql\src\main\java\org\apache\shardingsphere\proxy\frontend\postgresql\command\PostgreSQLCommandExecuteEngine.java,0,32,0,37,0,69
 shardingsphere-master\shardingsphere-master\shardingsphere-kernel\shardingsphere-data-pipeline\shardingsphere-data-pipeline-spi\src\main\java\org\apache\shardingsphere\data\pipeline\api\config\rulealtered\JobConfiguration.java,0,26,0,15,0,41
 shardingsphere-master\shardingsphere-master\shardingsphere-proxy\shardingsphere-proxy-backend\src\main\java\org\apache\shardingsphere\proxy\backend\communication\jdbc\JDBCDatabaseCommunicationEngine.java,0,64,4,62,0,130
 shardingsphere-master\shardingsphere-master\shardingsphere-test\shardingsphere-parser-test\src\main\java\org\apache\shardingsphere\test\sql\parser\parameterized\jaxb\cases\domain\statement\distsql\rdl\alter\AlterResourceStatementTestCase.java,0,2,0,4,0,6
 shardingsphere-master\shardingsphere-master\shardingsphere-agent\shardingsphere-agent-plugins\shardingsphere-agent-plugin-tracing\shardingsphere-agent-tracing-opentelemetry\src\test\java\org\apache\shardingsphere\agent\plugin\tracing\opentelemetry\advice\JDBCExecutorCallbackAdviceTest.java,0,20,0,19,0,39
 shardingsphere-master\shardingsphere-master\shardingsphere-infra\shardingsphere-infra-common\src\main\java\org\apache\shardingsphere\infra\database\metadata\dialect\MariaDBDataSourceMetaData.java,0,27,0,12,0,39
 shardingsphere-master\shardingsphere-master\shardingsphere-proxy\shardingsphere-proxy-backend\src\main\java\org\apache\shardingsphere\proxy\backend\text\distsql\ral\common\HintDistSQLBackendHandler.java,0,15,0,9,0,24
 shardingsphere-master\shardingsphere-master\shardingsphere-sql-parser\shardingsphere-sql-parser-statement\src\main\java\org\apache\shardingsphere\sql\parser\sql\dialect\statement\mysql\dal\MySQLShowDatabasesStatement.java,0,4,0,6,1,11
 shardingsphere-master\shardingsphere-master\shardingsphere-test\shardingsphere-parser-test\src\main\java\org\apache\shardingsphere\test\sql\parser\parameterized\asserts\statement\distsql\rql\impl\rule\ShowShardingAlgorithmsStatementAssert.java,0,7,0,11,0,18
 shardingsphere-master\shardingsphere-master\shardingsphere-kernel\shardingsphere-traffic\shardingsphere-traffic-api\src\main\java\org\apache\shardingsphere\traffic\api\config\TrafficRuleConfiguration.java,0,10,0,5,0,15
 shardingsphere-master\shardingsphere-master\shardingsphere-test\shardingsphere-parser-test\src\main\java\org\apache\shardingsphere\test\sql\parser\parameterized\jaxb\cases\domain\statement\distsql\rdl\drop\DropDataBaseDiscoveryTypeStatementTestCase.java,0,5,0,4,0,9
 shardingsphere-master\shardingsphere-master\shardingsphere-sql-parser\shardingsphere-sql-parser-statement\src\main\java\org\apache\shardingsphere\sql\parser\sql\dialect\statement\postgresql\ddl\PostgreSQLCreateIndexStatement.java,0,4,0,5,0,9
 shardingsphere-master\shardingsphere-master\shardingsphere-test\shardingsphere-parser-test\src\main\java\org\apache\shardingsphere\test\sql\parser\parameterized\jaxb\cases\domain\statement\distsql\rdl\drop\DropDataBaseDiscoveryHeartbeatStatementTestCase.java,0,6,0,4,0,10
 shardingsphere-master\shardingsphere-master\shardingsphere-test\shardingsphere-parser-test\src\main\java\org\apache\shardingsphere\test\sql\parser\parameterized\jaxb\cases\domain\statement\ddl\CreateConversionStatementTestCase.java,0,0,0,3,0,3
 shardingsphere-master\shardingsphere-master\shardingsphere-proxy\shardingsphere-proxy-backend\src\main\java\org\apache\shardingsphere\proxy\backend\text\distsql\rql\RQLBackendHandlerFactory.java,0,7,0,4,0,11
 shardingsphere-master\shardingsphere-master\shardingsphere-sql-parser\shardingsphere-sql-parser-dialect\shardingsphere-sql-parser-postgresql\src\main\java\org\apache\shardingsphere\sql\parser\postgresql\visitor\statement\facade\PostgreSQLStatementSQLVisitorFacade.java,0,10,0,8,0,18
 shardingsphere-master\shardingsphere-master\shardingsphere-kernel\shardingsphere-transaction\shardingsphere-transaction-core\src\test\java\org\apache\shardingsphere\transaction\ShardingSphereTransactionManagerEngineTest.java,0,11,0,8,0,19
 shardingsphere-master\shardingsphere-master\shardingsphere-infra\shardingsphere-infra-common\src\test\java\org\apache\shardingsphere\infra\metadata\schema\util\TableMetaDataUtilTest.java,0,6,0,7,0,13
 shardingsphere-master\shardingsphere-master\shardingsphere-features\shardingsphere-encrypt\shardingsphere-encrypt-core\src\test\java\org\apache\shardingsphere\encrypt\rewrite\impl\EncryptAlterTableTokenGeneratorTest.java,0,119,0,74,0,193
 shardingsphere-master\shardingsphere-master\shardingsphere-kernel\shardingsphere-authority\shardingsphere-authority-api\src\main\java\org\apache\shardingsphere\authority\model\AccessSubject.java,0,1,0,1,0,2
 shardingsphere-master\shardingsphere-master\shardingsphere-mode\shardingsphere-mode-core\src\test\java\org\apache\shardingsphere\mode\metadata\persist\node\SchemaMetaDataNodeTest.java,85,36,0,14,0,50
 shardingsphere-master\shardingsphere-master\shardingsphere-infra\shardingsphere-infra-federation\shardingsphere-infra-federation-optimizer\src\main\java\org\apache\shardingsphere\infra\federation\optimizer\converter\statement\SelectStatementConverter.java,0,37,0,48,0,85
 shardingsphere-master\shardingsphere-master\shardingsphere-infra\shardingsphere-infra-executor\src\main\java\org\apache\shardingsphere\infra\executor\sql\execute\result\query\QueryResultMetaData.java,0,11,0,1,0,12
 shardingsphere-master\shardingsphere-master\shardingsphere-proxy\shardingsphere-proxy-backend\src\test\java\org\apache\shardingsphere\proxy\backend\text\data\DatabaseBackendHandlerFactoryTest.java,0,25,0,22,0,47
 shardingsphere-master\shardingsphere-master\shardingsphere-sql-parser\shardingsphere-sql-parser-statement\src\main\java\org\apache\shardingsphere\sql\parser\sql\dialect\statement\postgresql\ddl\PostgreSQLDropGroupStatement.java,0,1,0,5,0,6
 shardingsphere-master\shardingsphere-master\shardingsphere-proxy\shardingsphere-proxy-frontend\shardingsphere-proxy-frontend-postgresql\src\main\java\org\apache\shardingsphere\proxy\frontend\postgresql\command\query\extended\bind\PostgreSQLComBindExecutor.java,0,12,0,14,0,26
 shardingsphere-master\shardingsphere-master\shardingsphere-test\shardingsphere-parser-test\src\main\java\org\apache\shardingsphere\test\sql\parser\parameterized\asserts\statement\ddl\impl\RenameTableStatementAssert.java,0,9,0,14,0,23
 shardingsphere-master\shardingsphere-master\shardingsphere-features\shardingsphere-sharding\shardingsphere-sharding-core\src\main\java\org\apache\shardingsphere\sharding\yaml\swapper\strategy\ShardingStrategyConfigurationYamlSwapper.java,0,31,0,35,0,66
 shardingsphere-master\shardingsphere-master\shardingsphere-test\shardingsphere-parser-test\src\main\java\org\apache\shardingsphere\test\sql\parser\parameterized\jaxb\cases\domain\segment\impl\projection\impl\column\ExpectedColumnProjection.java,0,6,0,6,0,12
 shardingsphere-master\shardingsphere-master\shardingsphere-test\shardingsphere-parser-test\src\main\java\org\apache\shardingsphere\test\sql\parser\parameterized\asserts\statement\dcl\impl\mysql\MySQLGrantStatementAssert.java,0,6,0,9,0,15
 shardingsphere-master\shardingsphere-master\shardingsphere-features\shardingsphere-sharding\shardingsphere-sharding-core\src\main\java\org\apache\shardingsphere\sharding\yaml\config\strategy\sharding\YamlHintShardingStrategyConfiguration.java,0,3,0,2,0,5
 shardingsphere-master\shardingsphere-master\shardingsphere-features\shardingsphere-encrypt\shardingsphere-encrypt-core\src\main\java\org\apache\shardingsphere\encrypt\merge\EncryptResultDecoratorEngine.java,0,8,0,9,0,17
 shardingsphere-master\shardingsphere-master\shardingsphere-db-protocol\shardingsphere-db-protocol-opengauss\src\main\java\org\apache\shardingsphere\db\protocol\opengauss\packet\identifier\OpenGaussIdentifierTag.java,0,1,0,2,0,3
 shardingsphere-master\shardingsphere-master\shardingsphere-agent\shardingsphere-agent-core\src\main\java\org\apache\shardingsphere\agent\core\plugin\interceptor\compose\ComposeInstanceMethodInterceptorArgsOverride.java,7,5,0,6,0,11
 shardingsphere-master\shardingsphere-master\shardingsphere-jdbc\shardingsphere-jdbc-core\src\main\java\org\apache\shardingsphere\driver\jdbc\unsupported\AbstractUnsupportedOperationPreparedStatement.java,93,42,0,25,0,67
 shardingsphere-master\shardingsphere-master\shardingsphere-kernel\shardingsphere-traffic\shardingsphere-traffic-core\src\main\java\org\apache\shardingsphere\traffic\engine\TrafficEngine.java,0,15,0,9,0,24
 shardingsphere-master\shardingsphere-master\shardingsphere-db-protocol\shardingsphere-db-protocol-postgresql\src\test\java\org\apache\shardingsphere\db\protocol\postgresql\packet\handshake\PostgreSQLRandomGeneratorTest.java,0,5,0,2,0,7
 shardingsphere-master\shardingsphere-master\shardingsphere-features\shardingsphere-shadow\shardingsphere-shadow-core\src\main\java\org\apache\shardingsphere\shadow\datanode\ShadowDataNodeBuilder.java,0,7,0,4,0,11
 shardingsphere-master\shardingsphere-master\shardingsphere-sql-parser\shardingsphere-sql-parser-statement\src\main\java\org\apache\shardingsphere\sql\parser\sql\dialect\statement\mysql\dal\MySQLExplainStatement.java,0,7,0,6,2,15
 shardingsphere-master\shardingsphere-master\shardingsphere-features\shardingsphere-readwrite-splitting\shardingsphere-readwrite-splitting-core\src\main\java\org\apache\shardingsphere\readwritesplitting\checker\AlgorithmProvidedReadwriteSplittingRuleConfigurationChecker.java,0,6,0,7,0,13
 shardingsphere-master\shardingsphere-master\shardingsphere-features\shardingsphere-encrypt\shardingsphere-encrypt-spring\shardingsphere-encrypt-spring-namespace\src\main\java\org\apache\shardingsphere\encrypt\spring\namespace\factorybean\EncryptAlgorithmFactoryBean.java,0,6,0,4,0,10
 shardingsphere-master\shardingsphere-master\shardingsphere-kernel\shardingsphere-data-pipeline\shardingsphere-data-pipeline-core\src\main\java\org\apache\shardingsphere\data\pipeline\core\api\GovernanceRepositoryAPI.java,0,13,0,4,0,17
 shardingsphere-master\shardingsphere-master\shardingsphere-features\shardingsphere-sharding\shardingsphere-sharding-core\src\main\java\org\apache\shardingsphere\sharding\rewrite\token\generator\IgnoreForSingleRoute.java,0,1,0,1,0,2
 shardingsphere-master\shardingsphere-master\shardingsphere-proxy\shardingsphere-proxy-backend\src\test\java\org\apache\shardingsphere\proxy\backend\communication\jdbc\transaction\TransactionStatusTest.java,0,8,0,2,0,10
 shardingsphere-master\shardingsphere-master\shardingsphere-agent\shardingsphere-agent-plugins\shardingsphere-agent-plugin-tracing\shardingsphere-agent-tracing-test\src\main\java\org\apache\shardingsphere\agent\plugin\tracing\advice\AbstractJDBCExecutorCallbackAdviceTest.java,42,14,2,7,0,23
 shardingsphere-master\shardingsphere-master\shardingsphere-features\shardingsphere-sharding\shardingsphere-sharding-spring\shardingsphere-sharding-spring-namespace\src\test\java\org\apache\shardingsphere\sharding\spring\namespace\fixture\sharding\HintShardingAlgorithmFixture.java,0,5,1,4,0,10
 shardingsphere-master\shardingsphere-master\shardingsphere-test\shardingsphere-parser-test\src\main\java\org\apache\shardingsphere\test\sql\parser\parameterized\jaxb\cases\domain\statement\distsql\rql\ShowEncryptRulesStatementTestCase.java,0,4,0,4,0,8
 shardingsphere-master\shardingsphere-master\shardingsphere-mode\shardingsphere-mode-type\shardingsphere-cluster-mode\shardingsphere-cluster-mode-core\src\test\java\org\apache\shardingsphere\mode\manager\cluster\coordinator\registry\status\compute\service\ComputeNodeStatusServiceTest.java,0,9,0,6,0,15
 shardingsphere-master\shardingsphere-master\shardingsphere-mode\shardingsphere-mode-core\src\test\java\org\apache\shardingsphere\mode\manager\ContextManagerBuilderParameterTest.java,0,37,1,27,0,65
 shardingsphere-master\shardingsphere-master\shardingsphere-features\shardingsphere-sharding\shardingsphere-sharding-distsql\shardingsphere-sharding-distsql-statement\src\main\java\org\apache\shardingsphere\sharding\distsql\parser\statement\hint\AddShardingHintDatabaseValueStatement.java,0,6,0,3,0,9
 shardingsphere-master\shardingsphere-master\shardingsphere-proxy\shardingsphere-proxy-backend\src\main\java\org\apache\shardingsphere\proxy\backend\text\distsql\ral\common\exception\CommonDistSQLException.java,6,2,0,2,0,4
 shardingsphere-master\shardingsphere-master\shardingsphere-test\shardingsphere-parser-test\src\main\java\org\apache\shardingsphere\test\sql\parser\parameterized\jaxb\cases\domain\segment\impl\distsql\rdl\ExpectedShardingStrategy.java,0,8,0,5,0,13
 shardingsphere-master\shardingsphere-master\shardingsphere-jdbc\shardingsphere-jdbc-core\src\main\java\org\apache\shardingsphere\driver\jdbc\core\resultset\GeneratedKeysResultSet.java,0,48,0,5,0,53
 shardingsphere-master\shardingsphere-master\shardingsphere-sql-parser\shardingsphere-sql-parser-statement\src\main\java\org\apache\shardingsphere\sql\parser\sql\dialect\statement\sqlserver\ddl\SQLServerAlterProcedureStatement.java,0,1,0,5,0,6
 shardingsphere-master\shardingsphere-master\shardingsphere-infra\shardingsphere-infra-common\src\test\java\org\apache\shardingsphere\infra\datasource\pool\metadata\fixture\MockedDataSourcePoolMetaData.java,0,8,0,3,0,11
 shardingsphere-master\shardingsphere-master\shardingsphere-db-protocol\shardingsphere-db-protocol-postgresql\src\test\java\org\apache\shardingsphere\db\protocol\postgresql\packet\identifier\PostgreSQLMessagePacketTypeTest.java,0,6,0,2,0,8
 shardingsphere-master\shardingsphere-master\shardingsphere-infra\shardingsphere-infra-common\src\test\java\org\apache\shardingsphere\infra\metadata\schema\loader\common\SchemaMetaDataLoaderTest.java,0,9,2,3,0,14
 shardingsphere-master\shardingsphere-master\shardingsphere-proxy\shardingsphere-proxy-backend\src\main\java\org\apache\shardingsphere\proxy\backend\text\distsql\ral\common\updatable\DiscardDistSQLHandler.java,0,3,0,6,0,9
 shardingsphere-master\shardingsphere-master\shardingsphere-features\shardingsphere-sharding\shardingsphere-sharding-distsql\shardingsphere-sharding-distsql-handler\src\test\java\org\apache\shardingsphere\sharding\distsql\update\CreateShardingTableRuleStatementUpdaterTest.java,0,76,0,64,0,140
 shardingsphere-master\shardingsphere-master\shardingsphere-features\shardingsphere-shadow\shardingsphere-shadow-core\src\main\java\org\apache\shardingsphere\shadow\route\engine\dml\ShadowSelectStatementRoutingEngine.java,0,30,0,20,0,50
 shardingsphere-master\shardingsphere-master\shardingsphere-infra\shardingsphere-infra-federation\shardingsphere-infra-federation-optimizer\src\main\java\org\apache\shardingsphere\infra\federation\optimizer\context\parser\dialect\OptimizerSQLDialectBuilder.java,0,3,0,2,0,5
 shardingsphere-master\shardingsphere-master\shardingsphere-features\shardingsphere-sharding\shardingsphere-sharding-core\src\main\java\org\apache\shardingsphere\sharding\merge\dal\common\SingleLocalDataMergedResult.java,0,14,0,3,0,17
 shardingsphere-master\shardingsphere-master\shardingsphere-infra\shardingsphere-infra-common\src\test\java\org\apache\shardingsphere\infra\fixture\ReadWriteSplittingRuleFixture.java,0,3,0,3,0,6
 shardingsphere-master\shardingsphere-master\shardingsphere-sql-parser\shardingsphere-sql-parser-statement\src\main\java\org\apache\shardingsphere\sql\parser\sql\dialect\statement\postgresql\ddl\PostgreSQLCreateSchemaStatement.java,0,1,0,6,0,7
 shardingsphere-master\shardingsphere-master\shardingsphere-test\shardingsphere-parser-test\src\main\java\org\apache\shardingsphere\test\sql\parser\parameterized\asserts\statement\distsql\ral\impl\scaling\query\ShowScalingStatusStatementAssert.java,0,11,1,13,0,25
 shardingsphere-master\shardingsphere-master\shardingsphere-mode\shardingsphere-mode-core\src\main\java\org\apache\shardingsphere\mode\metadata\persist\service\SchemaBasedPersistService.java,0,9,0,1,0,10
 shardingsphere-master\shardingsphere-master\shardingsphere-sql-parser\shardingsphere-sql-parser-statement\src\test\java\org\apache\shardingsphere\sql\parser\sql\dialect\handler\dml\UpdateStatementHandlerTest.java,0,13,0,9,0,22
 shardingsphere-master\shardingsphere-master\shardingsphere-proxy\shardingsphere-proxy-backend\src\test\java\org\apache\shardingsphere\proxy\backend\response\header\query\QueryHeaderBuilderFactoryTest.java,0,7,0,6,0,13
 shardingsphere-master\shardingsphere-master\shardingsphere-sql-parser\shardingsphere-sql-parser-statement\src\main\java\org\apache\shardingsphere\sql\parser\sql\dialect\statement\sqlserver\dml\SQLServerDeleteStatement.java,0,6,0,7,1,14
 shardingsphere-master\shardingsphere-master\shardingsphere-proxy\shardingsphere-proxy-frontend\shardingsphere-proxy-frontend-mysql\src\test\java\org\apache\shardingsphere\proxy\frontend\mysql\command\MySQLCommandExecutorFactoryTest.java,0,60,1,52,0,113
 shardingsphere-master\shardingsphere-master\shardingsphere-sql-parser\shardingsphere-sql-parser-statement\src\main\java\org\apache\shardingsphere\sql\parser\sql\dialect\statement\oracle\tcl\OracleSetTransactionStatement.java,0,1,0,4,0,5
 shardingsphere-master\shardingsphere-master\shardingsphere-infra\shardingsphere-infra-executor\src\test\java\org\apache\shardingsphere\infra\executor\sql\context\ExecutionContextBuilderTest.java,0,53,0,45,0,98
 shardingsphere-master\shardingsphere-master\shardingsphere-features\shardingsphere-sharding\shardingsphere-sharding-core\src\test\java\org\apache\shardingsphere\sharding\route\engine\validator\ddl\ShardingAlterIndexStatementValidatorTest.java,0,29,3,24,0,56
 shardingsphere-master\shardingsphere-master\shardingsphere-test\shardingsphere-parser-test\src\main\java\org\apache\shardingsphere\test\sql\parser\parameterized\asserts\statement\distsql\rdl\drop\impl\DropDatabaseDiscoveryHeartbeatStatementAssert.java,0,10,0,12,0,22
 shardingsphere-master\shardingsphere-master\shardingsphere-features\shardingsphere-sharding\shardingsphere-sharding-core\src\test\java\org\apache\shardingsphere\sharding\route\engine\validator\ddl\ShardingAlterViewStatementValidatorTest.java,0,12,0,15,0,27
 shardingsphere-master\shardingsphere-master\shardingsphere-test\shardingsphere-parser-test\src\main\java\org\apache\shardingsphere\test\sql\parser\parameterized\asserts\statement\distsql\rdl\drop\impl\DropShadowRuleStatementAssert.java,0,7,0,10,0,17
 shardingsphere-master\shardingsphere-master\examples\shardingsphere-jdbc-example\single-feature-example\transaction-example\transaction-base-seata-raw-jdbc-example\src\main\java\org\apache\shardingsphere\example\transaction\base\seata\raw\jdbc\TransactionBaseSeataRawExample.java,0,5,1,3,0,9
 shardingsphere-master\shardingsphere-master\shardingsphere-proxy\shardingsphere-proxy-backend\src\main\java\org\apache\shardingsphere\proxy\backend\text\distsql\ral\common\hint\executor\AddShardingHintDatabaseValueExecutor.java,0,5,0,8,0,13
 shardingsphere-master\shardingsphere-master\shardingsphere-proxy\shardingsphere-proxy-bootstrap\src\main\java\org\apache\shardingsphere\proxy\Bootstrap.java,0,5,0,3,0,8
 shardingsphere-master\shardingsphere-master\shardingsphere-features\shardingsphere-encrypt\shardingsphere-encrypt-distsql\shardingsphere-encrypt-distsql-handler\src\test\java\org\apache\shardingsphere\encrypt\distsql\handler\update\AlterEncryptRuleStatementUpdaterTest.java,0,35,0,27,0,62
 shardingsphere-master\shardingsphere-master\examples\shardingsphere-jdbc-example\single-feature-example\sharding-example\sharding-raw-jdbc-example\src\main\java\org\apache\shardingsphere\example\sharding\raw\jdbc\factory\RangeDataSourceFactory.java,0,6,1,7,0,14
 shardingsphere-master\shardingsphere-master\shardingsphere-test\shardingsphere-parser-test\src\main\java\org\apache\shardingsphere\test\sql\parser\parameterized\jaxb\cases\domain\statement\ddl\FlashbackDatabaseStatementTestCase.java,0,1,0,4,0,5
 shardingsphere-master\shardingsphere-master\shardingsphere-infra\shardingsphere-infra-executor\src\main\java\org\apache\shardingsphere\infra\executor\sql\execute\engine\SQLExecutorExceptionHandler.java,0,11,0,3,0,14
 shardingsphere-master\shardingsphere-master\shardingsphere-sql-parser\shardingsphere-sql-parser-statement\src\main\java\org\apache\shardingsphere\sql\parser\sql\dialect\handler\dml\DeleteStatementHandler.java,0,12,0,17,4,33
 shardingsphere-master\shardingsphere-master\shardingsphere-proxy\shardingsphere-proxy-backend\src\main\java\org\apache\shardingsphere\proxy\backend\communication\jdbc\recognizer\spi\JDBCDriverComposeURLRecognizer.java,0,3,0,3,0,6
 shardingsphere-master\shardingsphere-master\shardingsphere-infra\shardingsphere-infra-common\src\main\java\org\apache\shardingsphere\infra\metadata\schema\util\TableMetaDataUtil.java,46,19,0,17,0,36
 shardingsphere-master\shardingsphere-master\shardingsphere-test\shardingsphere-parser-test\src\main\java\org\apache\shardingsphere\test\sql\parser\parameterized\jaxb\cases\domain\statement\distsql\ral\SetVariableStatementTestCase.java,0,0,0,3,0,3
 shardingsphere-master\shardingsphere-master\shardingsphere-proxy\shardingsphere-proxy-backend\src\test\java\org\apache\shardingsphere\proxy\backend\text\distsql\fixture\TestDatabaseDiscoveryType.java,0,10,3,5,0,18
 shardingsphere-master\shardingsphere-master\shardingsphere-jdbc\shardingsphere-jdbc-spring\shardingsphere-jdbc-core-spring\shardingsphere-jdbc-core-spring-boot-starter\src\test\java\org\apache\shardingsphere\spring\boot\jndi\SpringBootJNDIDataSourceTest.java,21,11,0,7,0,18
 shardingsphere-master\shardingsphere-master\shardingsphere-features\shardingsphere-encrypt\shardingsphere-encrypt-core\src\test\java\org\apache\shardingsphere\encrypt\merge\EncryptResultDecoratorEngineTest.java,0,22,0,15,0,37
 shardingsphere-master\shardingsphere-master\shardingsphere-kernel\shardingsphere-traffic\shardingsphere-traffic-core\src\test\java\org\apache\shardingsphere\traffic\context\TrafficContextHolderTest.java,0,5,0,1,0,6
 shardingsphere-master\shardingsphere-master\shardingsphere-sql-parser\shardingsphere-sql-parser-dialect\shardingsphere-sql-parser-opengauss\src\main\java\org\apache\shardingsphere\sql\parser\opengauss\parser\OpenGaussParserFacade.java,0,4,0,2,0,6
 shardingsphere-master\shardingsphere-master\shardingsphere-infra\shardingsphere-infra-common\src\test\java\org\apache\shardingsphere\infra\database\metadata\dialect\H2DataSourceMetaDataTest.java,0,41,1,22,0,64
 shardingsphere-master\shardingsphere-master\shardingsphere-infra\shardingsphere-infra-route\src\test\java\org\apache\shardingsphere\infra\route\fixture\rule\RouteRuleFixture.java,0,1,0,1,0,2
 shardingsphere-master\shardingsphere-master\shardingsphere-jdbc\shardingsphere-jdbc-core\src\test\java\org\apache\shardingsphere\driver\jdbc\core\resultset\GeneratedKeysResultSetTest.java,0,52,2,8,0,62
 shardingsphere-master\shardingsphere-master\shardingsphere-test\shardingsphere-parser-test\src\main\java\org\apache\shardingsphere\test\sql\parser\parameterized\asserts\statement\distsql\rdl\drop\impl\DropShardingBindingTableRulesStatementAssert.java,0,8,0,11,0,19
 shardingsphere-master\shardingsphere-master\shardingsphere-sql-parser\shardingsphere-sql-parser-statement\src\main\java\org\apache\shardingsphere\sql\parser\sql\common\statement\dml\DMLStatement.java,0,0,0,1,0,1
 shardingsphere-master\shardingsphere-master\shardingsphere-proxy\shardingsphere-proxy-backend\src\test\java\org\apache\shardingsphere\proxy\backend\response\header\query\impl\PostgreSQLQueryHeaderBuilderTest.java,0,12,0,9,0,21
 shardingsphere-master\shardingsphere-master\shardingsphere-mode\shardingsphere-mode-core\src\main\java\org\apache\shardingsphere\mode\metadata\persist\node\GlobalNode.java,0,7,0,1,0,8
 shardingsphere-master\shardingsphere-master\shardingsphere-test\shardingsphere-parser-test\src\main\java\org\apache\shardingsphere\test\sql\parser\parameterized\jaxb\cases\domain\statement\distsql\rql\ShowShardingTableRulesUsedKeyGeneratorStatementTestCase.java,0,5,0,5,0,10
 shardingsphere-master\shardingsphere-master\shardingsphere-sql-parser\shardingsphere-sql-parser-statement\src\main\java\org\apache\shardingsphere\sql\parser\sql\common\segment\dml\expr\subquery\SubquerySegment.java,0,8,0,4,2,14
 shardingsphere-master\shardingsphere-master\shardingsphere-agent\shardingsphere-agent-core\src\test\java\org\apache\shardingsphere\agent\core\plugin\loader\ApmPluginLoaderTest.java,0,27,0,13,0,40
 shardingsphere-master\shardingsphere-master\shardingsphere-test\shardingsphere-parser-test\src\main\java\org\apache\shardingsphere\test\sql\parser\parameterized\asserts\statement\distsql\rql\impl\rule\ShowShardingKeyGeneratorsStatementAssert.java,0,7,0,11,0,18
 shardingsphere-master\shardingsphere-master\shardingsphere-sql-parser\shardingsphere-sql-parser-statement\src\main\java\org\apache\shardingsphere\sql\parser\sql\common\segment\ddl\constraint\DropPrimaryKeySegment.java,0,4,0,1,0,5
 shardingsphere-master\shardingsphere-master\examples\example-core\example-raw-jdbc\src\main\java\org\apache\shardingsphere\example\core\jdbc\repository\OrderRepositoryImpl.java,87,27,0,6,0,33
 shardingsphere-master\shardingsphere-master\shardingsphere-infra\shardingsphere-infra-rewrite\src\main\java\org\apache\shardingsphere\infra\rewrite\sql\token\pojo\generic\SubstitutableColumnNameToken.java,0,39,0,14,0,53
 shardingsphere-master\shardingsphere-master\shardingsphere-features\shardingsphere-sharding\shardingsphere-sharding-distsql\shardingsphere-sharding-distsql-handler\src\main\java\org\apache\shardingsphere\scaling\distsql\handler\StopScalingUpdater.java,0,6,0,3,0,9
 shardingsphere-master\shardingsphere-master\shardingsphere-jdbc\shardingsphere-jdbc-core\src\test\java\org\apache\shardingsphere\driver\jdbc\base\AbstractShardingSphereDataSourceForReadwriteSplittingTest.java,39,20,0,10,0,30
 shardingsphere-master\shardingsphere-master\shardingsphere-features\shardingsphere-readwrite-splitting\shardingsphere-readwrite-splitting-distsql\shardingsphere-readwrite-splitting-distsql-handler\src\main\java\org\apache\shardingsphere\readwritesplitting\distsql\handler\query\ReadwriteSplittingRuleQueryResultSet.java,0,47,0,31,0,78
 shardingsphere-master\shardingsphere-master\shardingsphere-sql-parser\shardingsphere-sql-parser-statement\src\main\java\org\apache\shardingsphere\sql\parser\sql\dialect\statement\mysql\segment\MySQLPrivilegeSegment.java,0,8,0,3,1,12
 shardingsphere-master\shardingsphere-master\shardingsphere-agent\shardingsphere-agent-plugins\shardingsphere-agent-plugin-tracing\shardingsphere-agent-tracing-jaeger\src\main\java\org\apache\shardingsphere\agent\plugin\tracing\jaeger\constant\JaegerConstants.java,0,21,0,3,0,24
 shardingsphere-master\shardingsphere-master\shardingsphere-features\shardingsphere-encrypt\shardingsphere-encrypt-core\src\test\java\org\apache\shardingsphere\encrypt\rule\builder\AlgorithmProvidedEncryptRuleBuilderTest.java,0,7,0,5,0,12
 shardingsphere-master\shardingsphere-master\shardingsphere-sql-parser\shardingsphere-sql-parser-statement\src\main\java\org\apache\shardingsphere\sql\parser\sql\common\statement\dml\EmptyStatement.java,0,1,0,2,0,3
 shardingsphere-master\shardingsphere-master\shardingsphere-proxy\shardingsphere-proxy-bootstrap\src\test\java\org\apache\shardingsphere\proxy\database\DatabaseServerInfoTest.java,0,9,0,3,0,12
 shardingsphere-master\shardingsphere-master\shardingsphere-features\shardingsphere-sharding\shardingsphere-sharding-core\src\main\java\org\apache\shardingsphere\sharding\route\engine\condition\generator\impl\ConditionValueBetweenOperatorGenerator.java,0,13,0,20,0,33
 shardingsphere-master\shardingsphere-master\shardingsphere-infra\shardingsphere-infra-common\src\main\java\org\apache\shardingsphere\infra\metadata\schema\loader\common\DataTypeLoader.java,0,6,0,4,0,10
 shardingsphere-master\shardingsphere-master\shardingsphere-test\shardingsphere-integration-test\shardingsphere-integration-test-suite\src\test\java\org\apache\shardingsphere\test\integration\framework\container\atomic\storage\impl\MySQLContainer.java,0,7,0,5,0,12
 shardingsphere-master\shardingsphere-master\shardingsphere-sql-parser\shardingsphere-sql-parser-statement\src\main\java\org\apache\shardingsphere\sql\parser\sql\dialect\statement\opengauss\ddl\OpenGaussDropProcedureStatement.java,0,1,0,5,0,6
 shardingsphere-master\shardingsphere-master\shardingsphere-kernel\shardingsphere-schedule\shardingsphere-schedule-core\src\main\java\org\apache\shardingsphere\schedule\core\api\ModeScheduleContext.java,0,33,2,16,0,51
 shardingsphere-master\shardingsphere-master\examples\example-core\config-utility\src\main\java\org\apache\shardingsphere\example\fixture\TestQueryAssistedShardingEncryptAlgorithm.java,0,10,1,5,0,16
 shardingsphere-master\shardingsphere-master\shardingsphere-test\shardingsphere-pipeline-test\src\test\java\org\apache\shardingsphere\data\pipeline\core\fixture\FixtureH2SingleTableDataCalculator.java,0,5,0,5,0,10
 shardingsphere-master\shardingsphere-master\shardingsphere-test\shardingsphere-parser-test\src\main\java\org\apache\shardingsphere\test\sql\parser\parameterized\asserts\segment\definition\ColumnPositionAssert.java,0,10,0,13,0,23
 shardingsphere-master\shardingsphere-master\shardingsphere-test\shardingsphere-parser-test\src\main\java\org\apache\shardingsphere\test\sql\parser\parameterized\jaxb\cases\domain\segment\impl\orderby\item\impl\ExpectedColumnOrderByItem.java,0,6,0,6,0,12
 shardingsphere-master\shardingsphere-master\examples\shardingsphere-proxy-example\shardingsphere-proxy-distsql-example\src\main\java\org\apache\shardingsphere\example\proxy\distsql\config\DatasourceConfiguration.java,0,29,0,1,0,30
 shardingsphere-master\shardingsphere-master\shardingsphere-infra\shardingsphere-infra-common\src\test\java\org\apache\shardingsphere\infra\yaml\schema\swapper\SchemaYamlSwapperTest.java,0,31,0,16,0,47
 shardingsphere-master\shardingsphere-master\shardingsphere-features\shardingsphere-shadow\shardingsphere-shadow-core\src\main\java\org\apache\shardingsphere\shadow\rule\builder\AlgorithmProvidedShadowRuleBuilder.java,0,7,0,5,0,12
 shardingsphere-master\shardingsphere-master\shardingsphere-features\shardingsphere-db-discovery\shardingsphere-db-discovery-distsql\shardingsphere-db-discovery-distsql-parser\src\main\java\org\apache\shardingsphere\dbdiscovery\distsql\parser\facade\DatabaseDiscoveryDistSQLStatementParserFacade.java,0,6,0,6,0,12
 shardingsphere-master\shardingsphere-master\shardingsphere-infra\shardingsphere-infra-common\src\test\java\org\apache\shardingsphere\infra\datanode\DataNodeUtilTest.java,0,12,0,7,0,19
 shardingsphere-master\shardingsphere-master\shardingsphere-proxy\shardingsphere-proxy-frontend\shardingsphere-proxy-frontend-core\src\main\java\org\apache\shardingsphere\proxy\frontend\executor\ConnectionThreadExecutorGroup.java,0,16,0,7,0,23
 shardingsphere-master\shardingsphere-master\examples\shardingsphere-proxy-example\shardingsphere-proxy-distsql-example\src\main\java\org\apache\shardingsphere\example\proxy\distsql\hint\impl\SetReadwriteSplittingExecutor.java,0,13,3,5,0,21
 shardingsphere-master\shardingsphere-master\shardingsphere-features\shardingsphere-sharding\shardingsphere-sharding-core\src\main\java\org\apache\shardingsphere\sharding\rewrite\token\generator\impl\ShardingRemoveTokenGenerator.java,0,9,0,11,0,20
 shardingsphere-master\shardingsphere-master\shardingsphere-kernel\shardingsphere-traffic\shardingsphere-traffic-core\src\main\java\org\apache\shardingsphere\traffic\executor\TrafficExecutorCallback.java,0,2,0,1,0,3
 shardingsphere-master\shardingsphere-master\shardingsphere-test\shardingsphere-parser-test\src\main\java\org\apache\shardingsphere\test\sql\parser\parameterized\jaxb\cases\domain\statement\distsql\rdl\drop\DropDefaultShardingStrategyStatementTestCase.java,0,3,0,4,0,7
 shardingsphere-master\shardingsphere-master\shardingsphere-test\shardingsphere-parser-test\src\main\java\org\apache\shardingsphere\test\sql\parser\parameterized\asserts\statement\distsql\ral\impl\advanced\ParseStatementAssert.java,0,7,1,9,0,17
 shardingsphere-master\shardingsphere-master\shardingsphere-features\shardingsphere-encrypt\shardingsphere-encrypt-api\src\main\java\org\apache\shardingsphere\encrypt\spi\QueryAssistedEncryptAlgorithm.java,0,2,0,2,0,4
 shardingsphere-master\shardingsphere-master\shardingsphere-agent\shardingsphere-agent-plugins\shardingsphere-agent-plugin-metrics\shardingsphere-agent-metrics-prometheus\src\main\java\org\apache\shardingsphere\agent\metrics\prometheus\wrapper\SummaryWrapper.java,0,3,0,1,0,4
 shardingsphere-master\shardingsphere-master\shardingsphere-jdbc\shardingsphere-jdbc-core\src\main\java\org\apache\shardingsphere\driver\jdbc\adapter\executor\ForceExecuteCallback.java,0,4,0,1,0,5
 shardingsphere-master\shardingsphere-master\shardingsphere-features\shardingsphere-sharding\shardingsphere-sharding-distsql\shardingsphere-sharding-distsql-parser\src\main\java\org\apache\shardingsphere\scaling\distsql\parser\core\ScalingSQLStatementVisitor.java,0,62,0,80,0,142
 shardingsphere-master\shardingsphere-master\shardingsphere-features\shardingsphere-sharding\shardingsphere-sharding-core\src\test\java\org\apache\shardingsphere\sharding\algorithm\sharding\cosid\CosIdModShardingAlgorithmTest.java,0,112,1,37,0,150
 shardingsphere-master\shardingsphere-master\shardingsphere-sql-parser\shardingsphere-sql-parser-statement\src\main\java\org\apache\shardingsphere\sql\parser\sql\dialect\statement\mysql\ddl\MySQLPrepareStatement.java,0,1,0,4,0,5
 shardingsphere-master\shardingsphere-master\shardingsphere-sql-parser\shardingsphere-sql-parser-statement\src\main\java\org\apache\shardingsphere\sql\parser\sql\dialect\statement\mysql\dal\MySQLShowCreateTableStatement.java,0,3,0,6,2,11
 shardingsphere-master\shardingsphere-master\shardingsphere-sql-parser\shardingsphere-sql-parser-dialect\shardingsphere-sql-parser-mysql\src\main\java\org\apache\shardingsphere\sql\parser\mysql\visitor\statement\impl\MySQLDDLStatementSQLVisitor.java,0,186,0,257,0,443
 shardingsphere-master\shardingsphere-master\shardingsphere-mode\shardingsphere-mode-type\shardingsphere-cluster-mode\shardingsphere-cluster-mode-core\src\test\java\org\apache\shardingsphere\mode\manager\cluster\coordinator\registry\status\storage\watcher\StorageNodeStateChangedWatcherTest.java,0,29,0,27,0,56
 shardingsphere-master\shardingsphere-master\shardingsphere-infra\shardingsphere-infra-merge\src\test\java\org\apache\shardingsphere\infra\merge\fixture\decorator\ResultDecoratorEngineFixture.java,0,8,0,5,0,13
 shardingsphere-master\shardingsphere-master\shardingsphere-sql-parser\shardingsphere-sql-parser-statement\src\main\java\org\apache\shardingsphere\sql\parser\sql\common\statement\tcl\SetTransactionStatement.java,9,4,1,5,0,10
 shardingsphere-master\shardingsphere-master\shardingsphere-infra\shardingsphere-infra-merge\src\main\java\org\apache\shardingsphere\infra\merge\result\impl\memory\MemoryMergedResult.java,56,24,0,12,0,36
 shardingsphere-master\shardingsphere-master\shardingsphere-sql-parser\shardingsphere-sql-parser-statement\src\main\java\org\apache\shardingsphere\sql\parser\sql\dialect\statement\mysql\tcl\MySQLLockStatement.java,0,3,0,5,2,10
 shardingsphere-master\shardingsphere-master\shardingsphere-proxy\shardingsphere-proxy-backend\src\main\java\org\apache\shardingsphere\proxy\backend\text\admin\postgresql\executor\SelectDatabaseExecutor.java,0,45,0,25,0,70
 shardingsphere-master\shardingsphere-master\shardingsphere-sql-parser\shardingsphere-sql-parser-engine\src\test\java\org\apache\shardingsphere\sql\parser\api\SQLParserEngineTest.java,0,18,2,8,3,31
 shardingsphere-master\shardingsphere-master\shardingsphere-test\shardingsphere-pipeline-test\src\test\java\org\apache\shardingsphere\data\pipeline\core\job\progress\yaml\JobProgressYamlSwapperTest.java,0,16,0,12,0,28
 shardingsphere-master\shardingsphere-master\shardingsphere-infra\shardingsphere-infra-common\src\main\java\org\apache\shardingsphere\infra\hint\HintManager.java,0,43,1,15,0,59
 shardingsphere-master\shardingsphere-master\shardingsphere-features\shardingsphere-shadow\shardingsphere-shadow-core\src\test\java\org\apache\shardingsphere\shadow\checker\AlgorithmProvidedShadowRuleConfigurationCheckerTest.java,0,27,0,15,0,42
 shardingsphere-master\shardingsphere-master\shardingsphere-infra\shardingsphere-infra-common\src\main\java\org\apache\shardingsphere\infra\datasource\props\DataSourcePropertiesValidator.java,0,9,1,9,0,19
 shardingsphere-master\shardingsphere-master\shardingsphere-infra\shardingsphere-infra-rewrite\src\test\java\org\apache\shardingsphere\infra\rewrite\sql\token\generator\builder\DefaultTokenGeneratorBuilderTest.java,0,15,0,17,0,32
 shardingsphere-master\shardingsphere-master\shardingsphere-agent\shardingsphere-agent-plugins\shardingsphere-agent-plugin-tracing\shardingsphere-agent-tracing-jaeger\src\main\java\org\apache\shardingsphere\agent\plugin\tracing\jaeger\definition\JaegerPluginDefinitionService.java,0,34,0,13,0,47
 shardingsphere-master\shardingsphere-master\shardingsphere-features\shardingsphere-shadow\shardingsphere-shadow-core\src\main\java\org\apache\shardingsphere\shadow\route\ShadowSQLRouter.java,0,8,0,4,0,12
 shardingsphere-master\shardingsphere-master\shardingsphere-features\shardingsphere-encrypt\shardingsphere-encrypt-core\src\main\java\org\apache\shardingsphere\encrypt\yaml\config\rule\YamlEncryptTableRuleConfiguration.java,0,8,0,3,0,11
 shardingsphere-master\shardingsphere-master\shardingsphere-test\shardingsphere-parser-test\src\main\java\org\apache\shardingsphere\test\sql\parser\parameterized\asserts\statement\dal\impl\MySQLResetStatementAssert.java,0,17,0,22,0,39
 shardingsphere-master\shardingsphere-master\shardingsphere-kernel\shardingsphere-transaction\shardingsphere-transaction-type\shardingsphere-transaction-xa\shardingsphere-transaction-xa-provider\shardingsphere-transaction-xa-narayana\src\main\java\org\apache\shardingsphere\transaction\xa\narayana\manager\DataSourceXAResourceRecoveryHelper.java,0,39,0,5,0,44
 shardingsphere-master\shardingsphere-master\shardingsphere-infra\shardingsphere-infra-binder\src\main\java\org\apache\shardingsphere\infra\binder\segment\insert\values\expression\DerivedSimpleExpressionSegment.java,0,1,0,3,0,4
 shardingsphere-master\shardingsphere-master\shardingsphere-kernel\shardingsphere-data-pipeline\shardingsphere-data-pipeline-core\src\main\java\org\apache\shardingsphere\data\pipeline\core\check\consistency\SingleTableDataCalculatorRegistry.java,0,17,2,15,0,34
 shardingsphere-master\shardingsphere-master\shardingsphere-db-protocol\shardingsphere-db-protocol-mysql\src\test\java\org\apache\shardingsphere\db\protocol\mysql\packet\command\query\binary\MySQLPreparedStatementRegistryTest.java,0,26,0,12,0,38
 shardingsphere-master\shardingsphere-master\shardingsphere-infra\shardingsphere-infra-common\src\test\java\org\apache\shardingsphere\infra\database\type\dialect\SQLServerDatabaseTypeTest.java,0,16,1,6,0,23
 shardingsphere-master\shardingsphere-master\shardingsphere-sql-parser\shardingsphere-sql-parser-statement\src\main\java\org\apache\shardingsphere\sql\parser\sql\dialect\statement\mysql\segment\SSLTypeEnum.java,0,10,0,2,0,12
 shardingsphere-master\shardingsphere-master\shardingsphere-test\shardingsphere-parser-test\src\main\java\org\apache\shardingsphere\test\sql\parser\parameterized\asserts\statement\distsql\ral\impl\scaling\QueryableScalingRALStatementAssert.java,0,8,0,22,0,30
 shardingsphere-master\shardingsphere-master\shardingsphere-features\shardingsphere-db-discovery\shardingsphere-db-discovery-distsql\shardingsphere-db-discovery-distsql-handler\src\test\java\org\apache\shardingsphere\dbdiscovery\distsql\handler\fixture\MGRDatabaseDiscoveryTypeFixture.java,0,13,3,5,0,21
 shardingsphere-master\shardingsphere-master\shardingsphere-sql-parser\shardingsphere-sql-parser-statement\src\main\java\org\apache\shardingsphere\sql\parser\sql\dialect\statement\oracle\ddl\OracleCreateDatabaseLinkStatement.java,0,1,0,5,0,6
 shardingsphere-master\shardingsphere-master\shardingsphere-test\shardingsphere-parser-test\src\main\java\org\apache\shardingsphere\test\sql\parser\parameterized\asserts\segment\distsql\rdl\ShardingBindingTableRuleAssert.java,0,8,0,11,0,19
 shardingsphere-master\shardingsphere-master\shardingsphere-features\shardingsphere-sharding\shardingsphere-sharding-core\src\main\java\org\apache\shardingsphere\sharding\algorithm\keygen\CosIdSnowflakeKeyGenerateAlgorithm.java,0,27,2,11,0,40
 shardingsphere-master\shardingsphere-master\examples\shardingsphere-jdbc-example\single-feature-example\sharding-example\sharding-raw-jdbc-example\src\main\java\org\apache\shardingsphere\example\sharding\raw\jdbc\ShardingHintRawExample.java,0,19,1,12,0,32
 shardingsphere-master\shardingsphere-master\shardingsphere-features\shardingsphere-encrypt\shardingsphere-encrypt-core\src\main\java\org\apache\shardingsphere\encrypt\rewrite\token\generator\EncryptPredicateColumnTokenGenerator.java,0,28,0,26,0,54
 shardingsphere-master\shardingsphere-master\shardingsphere-test\shardingsphere-parser-test\src\main\java\org\apache\shardingsphere\test\sql\parser\parameterized\asserts\statement\distsql\rdl\create\AddResourceStatementAssert.java,0,13,0,16,0,29
 shardingsphere-master\shardingsphere-master\shardingsphere-sql-parser\shardingsphere-sql-parser-statement\src\main\java\org\apache\shardingsphere\sql\parser\sql\common\statement\ddl\AlterExtensionStatement.java,3,1,1,3,0,5
 shardingsphere-master\shardingsphere-master\shardingsphere-test\shardingsphere-parser-test\src\main\java\org\apache\shardingsphere\test\sql\parser\parameterized\asserts\statement\distsql\rdl\alter\impl\AlterDefaultShardingStrategyStatementAssert.java,0,19,0,18,0,37
 shardingsphere-master\shardingsphere-master\shardingsphere-kernel\shardingsphere-data-pipeline\shardingsphere-data-pipeline-dialect\shardingsphere-data-pipeline-mysql\src\test\java\org\apache\shardingsphere\data\pipeline\mysql\ingest\column\value\UnsignedIntHandlerTest.java,0,5,0,1,0,6
 shardingsphere-master\shardingsphere-master\shardingsphere-test\shardingsphere-parser-test\src\main\java\org\apache\shardingsphere\test\sql\parser\parameterized\asserts\statement\dcl\impl\DropUserStatementAssert.java,0,4,1,6,0,11
 shardingsphere-master\shardingsphere-master\shardingsphere-features\shardingsphere-shadow\shardingsphere-shadow-distsql\shardingsphere-shadow-distsql-statement\src\main\java\org\apache\shardingsphere\shadow\distsql\parser\statement\CreateDefaultShadowAlgorithmStatement.java,0,2,0,3,0,5
 shardingsphere-master\shardingsphere-master\shardingsphere-test\shardingsphere-parser-test\src\main\java\org\apache\shardingsphere\test\sql\parser\parameterized\jaxb\cases\domain\segment\impl\distsql\ExpectedCacheOption.java,0,5,0,4,0,9
 shardingsphere-master\shardingsphere-master\shardingsphere-kernel\shardingsphere-authority\shardingsphere-authority-api\src\main\java\org\apache\shardingsphere\authority\config\AuthorityRuleConfiguration.java,0,6,0,3,0,9
 shardingsphere-master\shardingsphere-master\shardingsphere-proxy\shardingsphere-proxy-backend\src\test\java\org\apache\shardingsphere\proxy\backend\communication\jdbc\statement\impl\MySQLStatementMemoryStrictlyFetchSizeSetterTest.java,0,19,2,9,0,30
 shardingsphere-master\shardingsphere-master\shardingsphere-distsql\shardingsphere-distsql-statement\src\main\java\org\apache\shardingsphere\distsql\parser\statement\rql\show\ShowSingleTableRulesStatement.java,0,2,0,2,0,4
 shardingsphere-master\shardingsphere-master\shardingsphere-sql-parser\shardingsphere-sql-parser-dialect\shardingsphere-sql-parser-opengauss\src\main\java\org\apache\shardingsphere\sql\parser\opengauss\visitor\statement\impl\OpenGaussDDLStatementSQLVisitor.java,0,169,0,249,0,418
 shardingsphere-master\shardingsphere-master\shardingsphere-features\shardingsphere-sharding\shardingsphere-sharding-core\src\test\java\org\apache\shardingsphere\sharding\merge\dal\show\ShowTableStatusMergedResultTest.java,0,43,3,14,0,60
 shardingsphere-master\shardingsphere-master\examples\shardingsphere-proxy-example\shardingsphere-proxy-hint-example\src\main\java\org\apache\shardingsphere\example\proxy\hint\HintType.java,0,6,0,1,0,7
 shardingsphere-master\shardingsphere-master\shardingsphere-sql-parser\shardingsphere-sql-parser-statement\src\main\java\org\apache\shardingsphere\sql\parser\sql\dialect\statement\opengauss\tcl\OpenGaussStartTransactionStatement.java,0,1,0,5,0,6
 shardingsphere-master\shardingsphere-master\shardingsphere-mode\shardingsphere-mode-core\src\main\java\org\apache\shardingsphere\mode\manager\ContextManagerBuilderFactory.java,0,6,0,3,0,9
 shardingsphere-master\shardingsphere-master\shardingsphere-mode\shardingsphere-mode-type\shardingsphere-standalone-mode\shardingsphere-standalone-mode-core\src\test\java\org\apache\shardingsphere\mode\manager\standalone\StandalonePersistRepositoryConfigurationYamlSwapperTest.java,0,10,0,9,0,19
 shardingsphere-master\shardingsphere-master\shardingsphere-test\shardingsphere-parser-test\src\main\java\org\apache\shardingsphere\test\sql\parser\parameterized\jaxb\cases\domain\statement\dal\ShowStatementTestCase.java,0,0,0,3,0,3
 shardingsphere-master\shardingsphere-master\shardingsphere-test\shardingsphere-parser-test\src\main\java\org\apache\shardingsphere\test\sql\parser\parameterized\jaxb\cases\domain\statement\ddl\CreateViewStatementTestCase.java,0,0,0,3,0,3
 shardingsphere-master\shardingsphere-master\shardingsphere-agent\shardingsphere-agent-api\src\main\java\org\apache\shardingsphere\agent\spi\type\AgentTypedSPI.java,0,3,0,1,0,4
 shardingsphere-master\shardingsphere-master\shardingsphere-infra\shardingsphere-infra-federation\shardingsphere-infra-federation-optimizer\src\main\java\org\apache\shardingsphere\infra\federation\optimizer\converter\segment\expression\impl\ColumnConverter.java,0,10,0,13,0,23
 shardingsphere-master\shardingsphere-master\shardingsphere-test\shardingsphere-parser-test\src\main\java\org\apache\shardingsphere\test\sql\parser\parameterized\jaxb\cases\domain\segment\impl\charset\ExpectedCollate.java,0,2,0,3,0,5
 shardingsphere-master\shardingsphere-master\shardingsphere-db-protocol\shardingsphere-db-protocol-mysql\src\test\java\org\apache\shardingsphere\db\protocol\mysql\packet\command\query\binary\execute\protocol\MySQLFloatBinaryProtocolValueTest.java,0,8,0,4,0,12
 shardingsphere-master\shardingsphere-master\shardingsphere-test\shardingsphere-parser-test\src\main\java\org\apache\shardingsphere\test\sql\parser\parameterized\asserts\statement\distsql\ral\RALStatementAssert.java,0,8,0,17,0,25
 shardingsphere-master\shardingsphere-master\shardingsphere-kernel\shardingsphere-traffic\shardingsphere-traffic-core\src\main\java\org\apache\shardingsphere\traffic\context\TrafficContextHolder.java,0,7,0,2,0,9
 shardingsphere-master\shardingsphere-master\shardingsphere-infra\shardingsphere-infra-common\src\main\java\org\apache\shardingsphere\infra\storage\StorageNodeDataSource.java,0,17,4,3,0,24
 shardingsphere-master\shardingsphere-master\shardingsphere-sql-parser\shardingsphere-sql-parser-statement\src\main\java\org\apache\shardingsphere\sql\parser\sql\dialect\statement\mysql\dal\MySQLShowMasterStatusStatement.java,0,1,0,5,0,6
 shardingsphere-master\shardingsphere-master\shardingsphere-agent\shardingsphere-agent-core\src\test\java\org\apache\shardingsphere\agent\core\mock\advice\MockInstanceMethodAroundRepeatedAdvice.java,0,7,0,5,0,12
 shardingsphere-master\shardingsphere-master\shardingsphere-test\shardingsphere-parser-test\src\main\java\org\apache\shardingsphere\test\sql\parser\parameterized\asserts\statement\dml\impl\CallStatementAssert.java,0,17,0,23,0,40
 shardingsphere-master\shardingsphere-master\shardingsphere-sql-parser\shardingsphere-sql-parser-statement\src\main\java\org\apache\shardingsphere\sql\parser\sql\dialect\statement\mysql\dal\MySQLShowWarningsStatement.java,0,3,0,6,0,9
 shardingsphere-master\shardingsphere-master\shardingsphere-test\shardingsphere-parser-test\src\main\java\org\apache\shardingsphere\test\sql\parser\parameterized\jaxb\cases\domain\segment\impl\index\ExpectedPartitionDefinition.java,0,5,0,5,0,10
 shardingsphere-master\shardingsphere-master\shardingsphere-test\shardingsphere-parser-test\src\main\java\org\apache\shardingsphere\test\sql\parser\parameterized\asserts\statement\AbstractSQLStatementAssert.java,0,4,0,7,0,11
 shardingsphere-master\shardingsphere-master\shardingsphere-sql-parser\shardingsphere-sql-parser-statement\src\main\java\org\apache\shardingsphere\sql\parser\sql\common\segment\dml\item\ExpressionProjectionSegment.java,0,25,0,9,0,34
 shardingsphere-master\shardingsphere-master\shardingsphere-infra\shardingsphere-infra-route\src\test\java\org\apache\shardingsphere\infra\route\fixture\router\SQLRouterFixture.java,0,9,0,5,0,14
 shardingsphere-master\shardingsphere-master\shardingsphere-db-protocol\shardingsphere-db-protocol-mysql\src\test\java\org\apache\shardingsphere\db\protocol\mysql\constant\MySQLCapabilityFlagTest.java,0,11,0,4,0,15
 shardingsphere-master\shardingsphere-master\shardingsphere-proxy\shardingsphere-proxy-frontend\shardingsphere-proxy-frontend-postgresql\src\main\java\org\apache\shardingsphere\proxy\frontend\postgresql\command\query\extended\sync\PostgreSQLComSyncExecutor.java,0,5,0,5,0,10
 shardingsphere-master\shardingsphere-master\shardingsphere-infra\shardingsphere-infra-common\src\main\java\org\apache\shardingsphere\infra\yaml\schema\pojo\YamlIndexMetaData.java,0,2,0,1,0,3
 shardingsphere-master\shardingsphere-master\shardingsphere-features\shardingsphere-readwrite-splitting\shardingsphere-readwrite-splitting-core\src\main\java\org\apache\shardingsphere\readwritesplitting\checker\ReadwriteSplittingRuleConfigurationChecker.java,0,5,0,6,0,11
 shardingsphere-master\shardingsphere-master\shardingsphere-proxy\shardingsphere-proxy-frontend\shardingsphere-proxy-frontend-opengauss\src\main\java\org\apache\shardingsphere\proxy\frontend\opengauss\command\OpenGaussCommandExecuteEngine.java,0,20,0,22,0,42
 shardingsphere-master\shardingsphere-master\shardingsphere-sql-parser\shardingsphere-sql-parser-statement\src\main\java\org\apache\shardingsphere\sql\parser\sql\common\statement\ddl\CreateTablespaceStatement.java,3,1,1,3,0,5
 shardingsphere-master\shardingsphere-master\shardingsphere-features\shardingsphere-shadow\shardingsphere-shadow-distsql\shardingsphere-shadow-distsql-parser\src\main\java\org\apache\shardingsphere\shadow\distsql\parser\facade\ShadowDistSQLStatementParserFacade.java,0,6,0,4,0,10
 shardingsphere-master\shardingsphere-master\shardingsphere-sql-parser\shardingsphere-sql-parser-spi\src\main\java\org\apache\shardingsphere\sql\parser\api\visitor\type\DALSQLVisitor.java,0,1,0,1,0,2
 shardingsphere-master\shardingsphere-master\shardingsphere-features\shardingsphere-sharding\shardingsphere-sharding-core\src\test\java\org\apache\shardingsphere\sharding\route\engine\type\federated\ShardingFederatedRoutingEngineTest.java,0,56,0,40,0,96
 shardingsphere-master\shardingsphere-master\shardingsphere-proxy\shardingsphere-proxy-frontend\shardingsphere-proxy-frontend-core\src\test\java\org\apache\shardingsphere\proxy\frontend\fixture\FixtureDatabaseType.java,0,8,0,2,0,10
 shardingsphere-master\shardingsphere-master\shardingsphere-db-protocol\shardingsphere-db-protocol-postgresql\src\test\java\org\apache\shardingsphere\db\protocol\postgresql\constant\PostgreSQLArrayColumnTypeTest.java,0,6,0,1,0,7
 shardingsphere-master\shardingsphere-master\shardingsphere-kernel\shardingsphere-transaction\shardingsphere-transaction-core\src\main\java\org\apache\shardingsphere\transaction\core\ResourceDataSource.java,0,13,0,3,0,16
 shardingsphere-master\shardingsphere-master\shardingsphere-features\shardingsphere-encrypt\shardingsphere-encrypt-core\src\test\java\org\apache\shardingsphere\encrypt\merge\dal\impl\fixture\TestStatementContext.java,0,12,0,3,0,15
 shardingsphere-master\shardingsphere-master\shardingsphere-sql-parser\shardingsphere-sql-parser-spi\src\main\java\org\apache\shardingsphere\sql\parser\api\visitor\type\DMLSQLVisitor.java,0,0,0,1,0,1
 shardingsphere-master\shardingsphere-master\shardingsphere-test\shardingsphere-integration-test\shardingsphere-integration-test-suite\src\test\java\org\apache\shardingsphere\test\integration\engine\ddl\GeneralDDLIT.java,0,21,0,14,0,35
 shardingsphere-master\shardingsphere-master\shardingsphere-sql-parser\shardingsphere-sql-parser-statement\src\main\java\org\apache\shardingsphere\sql\parser\sql\dialect\statement\mysql\segment\CacheTableIndexSegment.java,0,5,0,5,1,11
 shardingsphere-master\shardingsphere-master\shardingsphere-proxy\shardingsphere-proxy-backend\src\test\java\org\apache\shardingsphere\proxy\backend\text\distsql\ral\common\updatable\SetVariableBackendHandlerTest.java,0,57,0,33,0,90
 shardingsphere-master\shardingsphere-master\shardingsphere-mode\shardingsphere-mode-type\shardingsphere-cluster-mode\shardingsphere-cluster-mode-core\src\main\java\org\apache\shardingsphere\mode\manager\cluster\coordinator\registry\workerid\generator\ClusterWorkerIdGenerator.java,0,12,0,7,0,19
 shardingsphere-master\shardingsphere-master\shardingsphere-db-protocol\shardingsphere-db-protocol-postgresql\src\main\java\org\apache\shardingsphere\db\protocol\postgresql\packet\handshake\PostgreSQLComStartupPacket.java,0,18,1,2,0,21
 shardingsphere-master\shardingsphere-master\shardingsphere-kernel\shardingsphere-data-pipeline\shardingsphere-data-pipeline-dialect\shardingsphere-data-pipeline-mysql\src\test\java\org\apache\shardingsphere\data\pipeline\mysql\ingest\column\value\UnsignedMediumintHandlerTest.java,0,6,0,2,0,8
 shardingsphere-master\shardingsphere-master\shardingsphere-proxy\shardingsphere-proxy-frontend\shardingsphere-proxy-frontend-opengauss\src\test\java\org\apache\shardingsphere\proxy\frontend\opengauss\err\OpenGaussErrorPacketFactoryTest.java,0,6,0,5,0,11
 shardingsphere-master\shardingsphere-master\shardingsphere-features\shardingsphere-readwrite-splitting\shardingsphere-readwrite-splitting-distsql\shardingsphere-readwrite-splitting-distsql-statement\src\main\java\org\apache\shardingsphere\readwritesplitting\distsql\parser\statement\CreateReadwriteSplittingRuleStatement.java,0,3,0,4,0,7
 shardingsphere-master\shardingsphere-master\shardingsphere-jdbc\shardingsphere-jdbc-core\src\main\java\org\apache\shardingsphere\driver\config\datasource\ShardingSpherePipelineDataSourceCreator.java,0,13,0,14,0,27
 shardingsphere-master\shardingsphere-master\shardingsphere-infra\shardingsphere-infra-datetime\shardingsphere-infra-datetime-type\shardingsphere-database-datetime\src\main\java\org\apache\shardingsphere\datetime\database\DatabaseDatetimeService.java,0,10,0,8,0,18
 shardingsphere-master\shardingsphere-master\shardingsphere-infra\shardingsphere-infra-rewrite\src\test\java\org\apache\shardingsphere\infra\rewrite\sql\token\pojo\generic\OwnerTokenTest.java,0,20,0,10,0,30
 shardingsphere-master\shardingsphere-master\shardingsphere-infra\shardingsphere-infra-federation\shardingsphere-infra-federation-optimizer\src\main\java\org\apache\shardingsphere\infra\federation\optimizer\converter\context\ConverterContext.java,0,3,0,1,0,4
 shardingsphere-master\shardingsphere-master\shardingsphere-sql-parser\shardingsphere-sql-parser-dialect\shardingsphere-sql-parser-oracle\src\main\java\org\apache\shardingsphere\sql\parser\oracle\visitor\statement\impl\OracleDMLStatementSQLVisitor.java,0,296,15,338,0,649
 shardingsphere-master\shardingsphere-master\shardingsphere-sql-parser\shardingsphere-sql-parser-statement\src\main\java\org\apache\shardingsphere\sql\parser\sql\dialect\statement\mysql\rl\MySQLStopSlaveStatement.java,0,1,0,4,0,5
 shardingsphere-master\shardingsphere-master\shardingsphere-jdbc\shardingsphere-jdbc-core\src\main\java\org\apache\shardingsphere\driver\jdbc\unsupported\AbstractUnsupportedOperationConnection.java,93,24,0,8,0,32
 shardingsphere-master\shardingsphere-master\examples\shardingsphere-jdbc-example\single-feature-example\extension-example\custom-sharding-algortihm-example\class-based-sharding-algorithm-example\class-based-sharding-spring-namespace-mybatis-example\src\main\java\org\apache\shardingsphere\example\extension\classbased\sharding\spring\namespace\mybatis\fixture\ClassBasedOrderItemStandardShardingAlgorithmFixture.java,0,16,0,11,0,27
 shardingsphere-master\shardingsphere-master\shardingsphere-agent\shardingsphere-agent-plugins\shardingsphere-agent-plugin-metrics\shardingsphere-agent-metrics-prometheus\src\main\java\org\apache\shardingsphere\agent\metrics\prometheus\wrapper\CounterWrapper.java,0,6,0,1,0,7
 shardingsphere-master\shardingsphere-master\shardingsphere-features\shardingsphere-sharding\shardingsphere-sharding-distsql\shardingsphere-sharding-distsql-handler\src\test\java\org\apache\shardingsphere\data\pipeline\spi\ratelimit\FixtureOutputJobRateLimitAlgorithm.java,0,4,2,2,0,8
 shardingsphere-master\shardingsphere-master\shardingsphere-test\shardingsphere-parser-test\src\main\java\org\apache\shardingsphere\test\sql\parser\parameterized\asserts\statement\distsql\ral\impl\scaling\query\CheckScalingStatementAssert.java,0,18,1,19,0,38
 shardingsphere-master\shardingsphere-master\shardingsphere-kernel\shardingsphere-data-pipeline\shardingsphere-data-pipeline-spi\src\main\java\org\apache\shardingsphere\data\pipeline\api\config\rulealtered\PipelineConfiguration.java,0,10,0,3,0,13
 shardingsphere-master\shardingsphere-master\shardingsphere-features\shardingsphere-db-discovery\shardingsphere-db-discovery-distsql\shardingsphere-db-discovery-distsql-handler\src\main\java\org\apache\shardingsphere\dbdiscovery\distsql\handler\update\DropDatabaseDiscoveryRuleStatementUpdater.java,0,37,0,32,0,69
 shardingsphere-master\shardingsphere-master\examples\shardingsphere-jdbc-example\single-feature-example\extension-example\custom-sharding-algortihm-example\class-based-sharding-algorithm-example\class-based-sharding-spring-boot-mybatis-example\src\main\java\org\apache\shardingsphere\example\extension\classbased\sharding\spring\boot\mybatis\ClassBasedShardingSpringBootMybatisExample.java,9,7,1,5,0,13
 shardingsphere-master\shardingsphere-master\shardingsphere-test\shardingsphere-integration-agent-test\shardingsphere-integration-agent-test-plugins\shardingsphere-integration-agent-test-common\src\test\java\org\apache\shardingsphere\integration\agent\test\common\env\EnvironmentProperties.java,0,5,0,2,0,7
 shardingsphere-master\shardingsphere-master\examples\example-core\example-raw-jdbc\src\main\java\org\apache\shardingsphere\example\core\jdbc\repository\AccountRepositoryImpl.java,85,25,0,5,0,30
 shardingsphere-master\shardingsphere-master\shardingsphere-test\shardingsphere-parser-test\src\main\java\org\apache\shardingsphere\test\sql\parser\parameterized\jaxb\cases\domain\statement\ddl\AlterCollationStatementTestCase.java,0,0,0,3,0,3
 shardingsphere-master\shardingsphere-master\shardingsphere-db-protocol\shardingsphere-db-protocol-postgresql\src\test\java\org\apache\shardingsphere\db\protocol\postgresql\packet\command\query\PostgreSQLDataRowPacketTest.java,0,31,0,12,0,43
 shardingsphere-master\shardingsphere-master\shardingsphere-test\shardingsphere-integration-agent-test\shardingsphere-integration-agent-test-plugins\shardingsphere-integration-agent-test-metrics\src\test\java\org\apache\shardingsphere\integration\agent\test\metrics\MetricsPluginIT.java,0,36,1,10,0,47
 shardingsphere-master\shardingsphere-master\shardingsphere-kernel\shardingsphere-data-pipeline\shardingsphere-data-pipeline-spi\src\main\java\org\apache\shardingsphere\data\pipeline\api\datanode\JobDataNodeEntry.java,0,12,0,5,0,17
 shardingsphere-master\shardingsphere-master\shardingsphere-agent\shardingsphere-agent-core\src\main\java\org\apache\shardingsphere\agent\core\plugin\ApmPluginLoader.java,0,68,5,36,0,109
 shardingsphere-master\shardingsphere-master\shardingsphere-test\shardingsphere-parser-test\src\main\java\org\apache\shardingsphere\test\sql\parser\parameterized\asserts\statement\distsql\rdl\alter\impl\AlterShardingKeyGeneratorStatementAssert.java,0,13,0,18,0,31
 shardingsphere-master\shardingsphere-master\examples\shardingsphere-example-generator\src\main\java\org\apache\shardingsphere\example\generator\scenario\ExampleScenario.java,0,7,0,1,0,8
 shardingsphere-master\shardingsphere-master\shardingsphere-agent\shardingsphere-agent-plugins\shardingsphere-agent-plugin-tracing\shardingsphere-agent-tracing-zipkin\src\test\java\org\apache\shardingsphere\agent\plugin\tracing\zipkin\advice\CommandExecutorTaskAdviceTest.java,0,23,2,16,0,41
 shardingsphere-master\shardingsphere-master\shardingsphere-db-protocol\shardingsphere-db-protocol-mysql\src\test\java\org\apache\shardingsphere\db\protocol\mysql\packet\binlog\management\MySQLBinlogFormatDescriptionEventPacketTest.java,0,21,0,6,0,27
 shardingsphere-master\shardingsphere-master\shardingsphere-sql-parser\shardingsphere-sql-parser-statement\src\main\java\org\apache\shardingsphere\sql\parser\sql\dialect\statement\postgresql\dal\PostgreSQLSetStatement.java,0,1,0,5,0,6
 shardingsphere-master\shardingsphere-master\shardingsphere-db-protocol\shardingsphere-db-protocol-mysql\src\test\java\org\apache\shardingsphere\db\protocol\mysql\packet\command\admin\initdb\MySQLComInitDbPacketTest.java,0,8,0,3,0,11
 shardingsphere-master\shardingsphere-master\shardingsphere-proxy\shardingsphere-proxy-backend\src\main\java\org\apache\shardingsphere\proxy\backend\text\distsql\ral\advanced\FormatHandler.java,0,14,1,9,0,24
 shardingsphere-master\shardingsphere-master\shardingsphere-sql-parser\shardingsphere-sql-parser-statement\src\main\java\org\apache\shardingsphere\sql\parser\sql\dialect\statement\opengauss\dml\OpenGaussSelectStatement.java,0,7,0,8,0,15
 shardingsphere-master\shardingsphere-master\shardingsphere-sql-parser\shardingsphere-sql-parser-statement\src\main\java\org\apache\shardingsphere\sql\parser\sql\dialect\statement\postgresql\ddl\PostgreSQLDropOwnedStatement.java,0,1,0,5,0,6
 shardingsphere-master\shardingsphere-master\shardingsphere-infra\shardingsphere-infra-common\src\main\java\org\apache\shardingsphere\infra\database\metadata\DataSourceMetaData.java,0,14,0,3,0,17
 shardingsphere-master\shardingsphere-master\shardingsphere-sql-parser\shardingsphere-sql-parser-statement\src\main\java\org\apache\shardingsphere\sql\parser\sql\dialect\statement\oracle\dml\OracleInsertStatement.java,0,8,0,7,1,16
 shardingsphere-master\shardingsphere-master\shardingsphere-kernel\shardingsphere-data-pipeline\shardingsphere-data-pipeline-core\src\main\java\org\apache\shardingsphere\data\pipeline\core\api\PipelineAPIFactory.java,0,34,5,17,0,56
 shardingsphere-master\shardingsphere-master\shardingsphere-db-protocol\shardingsphere-db-protocol-postgresql\src\main\java\org\apache\shardingsphere\db\protocol\postgresql\packet\handshake\PostgreSQLSSLNegativePacket.java,0,3,0,2,0,5
 shardingsphere-master\shardingsphere-master\shardingsphere-spi\src\test\java\org\apache\shardingsphere\spi\fixture\required\RequiredSPIFixtureDefaultFalseImpl.java,0,1,0,2,0,3
 shardingsphere-master\shardingsphere-master\shardingsphere-mode\shardingsphere-mode-type\shardingsphere-cluster-mode\shardingsphere-cluster-mode-core\src\main\java\org\apache\shardingsphere\mode\manager\cluster\coordinator\registry\status\storage\event\PrimaryStateChangedEvent.java,0,2,0,3,0,5
 shardingsphere-master\shardingsphere-master\shardingsphere-infra\shardingsphere-infra-common\src\main\java\org\apache\shardingsphere\infra\yaml\config\swapper\rulealtered\OnRuleAlteredActionConfigurationYamlSwapper.java,0,44,0,34,0,78
 shardingsphere-master\shardingsphere-master\shardingsphere-infra\shardingsphere-infra-common\src\test\java\org\apache\shardingsphere\infra\metadata\schema\loader\common\TableMetaDataLoaderTest.java,0,41,0,19,0,60
 shardingsphere-master\shardingsphere-master\shardingsphere-distsql\shardingsphere-distsql-statement\src\main\java\org\apache\shardingsphere\distsql\parser\statement\rdl\RuleDefinitionStatement.java,3,0,1,1,0,2
 shardingsphere-master\shardingsphere-master\shardingsphere-infra\shardingsphere-infra-executor\src\main\java\org\apache\shardingsphere\infra\executor\sql\execute\engine\driver\jdbc\sane\SaneQueryResultEngine.java,0,2,0,3,0,5
 shardingsphere-master\shardingsphere-master\shardingsphere-infra\shardingsphere-infra-binder\src\main\java\org\apache\shardingsphere\infra\binder\statement\dal\ShowCreateTableStatementContext.java,0,9,0,8,0,17
 shardingsphere-master\shardingsphere-master\shardingsphere-sql-parser\shardingsphere-sql-parser-statement\src\main\java\org\apache\shardingsphere\sql\parser\sql\dialect\statement\mysql\dml\MySQLDeleteStatement.java,0,7,0,6,0,13
 shardingsphere-master\shardingsphere-master\shardingsphere-proxy\shardingsphere-proxy-backend\src\main\java\org\apache\shardingsphere\proxy\backend\communication\jdbc\executor\callback\impl\ProxyPreparedStatementExecutorCallback.java,0,9,0,9,0,18
 shardingsphere-master\shardingsphere-master\shardingsphere-proxy\shardingsphere-proxy-frontend\shardingsphere-proxy-frontend-postgresql\src\test\java\org\apache\shardingsphere\proxy\frontend\postgresql\command\PostgreSQLConnectionContextTest.java,0,15,0,3,0,18
 shardingsphere-master\shardingsphere-master\shardingsphere-sql-parser\shardingsphere-sql-parser-statement\src\main\java\org\apache\shardingsphere\sql\parser\sql\common\statement\ddl\CreateFunctionStatement.java,3,1,1,3,0,5
 shardingsphere-master\shardingsphere-master\shardingsphere-features\shardingsphere-sharding\shardingsphere-sharding-distsql\shardingsphere-sharding-distsql-handler\src\test\java\org\apache\shardingsphere\scaling\distsql\handler\query\ShardingScalingRulesQueryResultSetTest.java,0,40,0,29,0,69
 shardingsphere-master\shardingsphere-master\shardingsphere-db-protocol\shardingsphere-db-protocol-postgresql\src\test\java\org\apache\shardingsphere\db\protocol\postgresql\packet\command\query\extended\PostgreSQLAggregatedResponsesPacketTest.java,0,9,0,9,0,18
 shardingsphere-master\shardingsphere-master\shardingsphere-test\shardingsphere-parser-test\src\main\java\org\apache\shardingsphere\test\sql\parser\parameterized\jaxb\cases\domain\segment\impl\output\ExpectedOutputColumn.java,0,3,0,5,0,8
 shardingsphere-master\shardingsphere-master\shardingsphere-kernel\shardingsphere-data-pipeline\shardingsphere-data-pipeline-spi\src\main\java\org\apache\shardingsphere\data\pipeline\api\ingest\channel\AckCallback.java,0,2,0,1,0,3
 shardingsphere-master\shardingsphere-master\shardingsphere-distsql\shardingsphere-distsql-statement\src\main\java\org\apache\shardingsphere\distsql\parser\segment\TransactionProviderSegment.java,0,4,0,1,0,5
 shardingsphere-master\shardingsphere-master\shardingsphere-features\shardingsphere-sharding\shardingsphere-sharding-core\src\main\java\org\apache\shardingsphere\sharding\route\engine\type\complex\ShardingCartesianRoutingEngine.java,0,27,0,18,0,45
 shardingsphere-master\shardingsphere-master\shardingsphere-features\shardingsphere-sharding\shardingsphere-sharding-core\src\main\java\org\apache\shardingsphere\sharding\algorithm\sharding\datetime\IntervalShardingAlgorithm.java,0,73,1,35,0,109
 shardingsphere-master\shardingsphere-master\shardingsphere-features\shardingsphere-sharding\shardingsphere-sharding-core\src\test\java\org\apache\shardingsphere\sharding\rewrite\token\GeneratedKeyInsertValuesTokenGeneratorTest.java,0,14,0,23,0,37
 shardingsphere-master\shardingsphere-master\shardingsphere-infra\shardingsphere-infra-context\src\main\java\org\apache\shardingsphere\infra\context\refresher\type\CreateIndexStatementSchemaRefresher.java,0,12,0,12,0,24
 shardingsphere-master\shardingsphere-master\shardingsphere-agent\shardingsphere-agent-core\src\test\java\org\apache\shardingsphere\agent\core\util\ReflectiveUtil.java,0,5,1,3,0,9
 shardingsphere-master\shardingsphere-master\shardingsphere-sql-parser\shardingsphere-sql-parser-engine\src\main\java\org\apache\shardingsphere\sql\parser\core\ParseASTNode.java,0,10,0,2,0,12
 shardingsphere-master\shardingsphere-master\shardingsphere-test\shardingsphere-rewrite-test\src\test\java\org\apache\shardingsphere\sharding\rewrite\parameterized\loader\RewriteAssertionsRootEntityLoader.java,0,4,0,4,0,8
 shardingsphere-master\shardingsphere-master\shardingsphere-infra\shardingsphere-infra-common\src\main\java\org\apache\shardingsphere\infra\instance\utils\IpUtils.java,0,14,1,4,0,19
 shardingsphere-master\shardingsphere-master\shardingsphere-features\shardingsphere-shadow\shardingsphere-shadow-core\src\main\java\org\apache\shardingsphere\shadow\yaml\swapper\table\ShadowTableConfigurationYamlSwapper.java,0,10,0,9,0,19
 shardingsphere-master\shardingsphere-master\shardingsphere-infra\shardingsphere-infra-route\src\main\java\org\apache\shardingsphere\infra\route\engine\impl\AllSQLRouteExecutor.java,0,4,0,3,0,7
 shardingsphere-master\shardingsphere-master\shardingsphere-features\shardingsphere-encrypt\shardingsphere-encrypt-core\src\main\java\org\apache\shardingsphere\encrypt\algorithm\MD5EncryptAlgorithm.java,0,9,1,4,0,14
 shardingsphere-master\shardingsphere-master\shardingsphere-proxy\shardingsphere-proxy-backend\src\main\java\org\apache\shardingsphere\proxy\backend\communication\ReactiveProxySQLExecutor.java,0,46,0,47,0,93
 shardingsphere-master\shardingsphere-master\shardingsphere-test\shardingsphere-parser-test\src\main\java\org\apache\shardingsphere\test\sql\parser\parameterized\jaxb\cases\domain\statement\dcl\AlterUserStatementTestCase.java,0,0,0,3,0,3
 shardingsphere-master\shardingsphere-master\shardingsphere-features\shardingsphere-readwrite-splitting\shardingsphere-readwrite-splitting-core\src\test\java\org\apache\shardingsphere\readwritesplitting\rule\ReadwriteSplittingDataSourceRuleTest.java,0,51,0,29,0,80
 shardingsphere-master\shardingsphere-master\shardingsphere-kernel\shardingsphere-data-pipeline\shardingsphere-data-pipeline-dialect\shardingsphere-data-pipeline-mysql\src\main\java\org\apache\shardingsphere\data\pipeline\mysql\ingest\binlog\event\UpdateRowsEvent.java,0,4,0,1,0,5
 shardingsphere-master\shardingsphere-master\shardingsphere-db-protocol\shardingsphere-db-protocol-mysql\src\test\java\org\apache\shardingsphere\db\protocol\mysql\packet\binlog\row\column\value\string\MySQLJsonBinlogProtocolValueTest.java,0,45,0,13,0,58
 shardingsphere-master\shardingsphere-master\shardingsphere-test\shardingsphere-parser-test\src\main\java\org\apache\shardingsphere\test\sql\parser\parameterized\jaxb\cases\domain\statement\dml\CopyStatementTestCase.java,0,0,0,3,0,3
 shardingsphere-master\shardingsphere-master\shardingsphere-features\shardingsphere-sharding\shardingsphere-sharding-core\src\test\java\org\apache\shardingsphere\sharding\rule\BindingTableRuleTest.java,0,31,1,16,0,48
 shardingsphere-master\shardingsphere-master\shardingsphere-db-protocol\shardingsphere-db-protocol-mysql\src\test\java\org\apache\shardingsphere\db\protocol\mysql\packet\command\query\MySQLFieldCountPacketTest.java,0,7,0,1,0,8
 shardingsphere-master\shardingsphere-master\shardingsphere-test\shardingsphere-pipeline-test\src\test\java\org\apache\shardingsphere\data\pipeline\core\job\RuleAlteredJobIdTest.java,0,7,0,5,0,12
 shardingsphere-master\shardingsphere-master\shardingsphere-agent\shardingsphere-agent-api\src\main\java\org\apache\shardingsphere\agent\api\advice\OverrideArgsInvoker.java,0,1,0,1,0,2
 shardingsphere-master\shardingsphere-master\examples\example-core\example-api\src\main\java\org\apache\shardingsphere\example\core\api\entity\Account.java,40,32,0,2,0,34
 shardingsphere-master\shardingsphere-master\shardingsphere-proxy\shardingsphere-proxy-frontend\shardingsphere-proxy-frontend-core\src\test\java\org\apache\shardingsphere\proxy\frontend\netty\FrontendChannelInboundHandlerTest.java,0,35,1,18,0,54
 shardingsphere-master\shardingsphere-master\shardingsphere-features\shardingsphere-sharding\shardingsphere-sharding-core\src\test\java\org\apache\shardingsphere\sharding\route\strategy\fixture\StandardShardingAlgorithmFixture.java,0,8,1,8,0,17
 shardingsphere-master\shardingsphere-master\shardingsphere-test\shardingsphere-integration-test\shardingsphere-integration-test-suite\src\test\java\org\apache\shardingsphere\test\integration\cases\assertion\IntegrationTestCase.java,0,10,0,2,0,12
 shardingsphere-master\shardingsphere-master\shardingsphere-test\shardingsphere-integration-test\shardingsphere-integration-test-suite\src\test\java\org\apache\shardingsphere\test\integration\framework\runner\parallel\ParallelRunnerScheduler.java,0,10,0,8,0,18
 shardingsphere-master\shardingsphere-master\shardingsphere-test\shardingsphere-parser-test\src\main\java\org\apache\shardingsphere\test\sql\parser\parameterized\asserts\statement\dal\impl\ShowCollationStatementAssert.java,0,4,0,8,0,12
 shardingsphere-master\shardingsphere-master\shardingsphere-kernel\shardingsphere-data-pipeline\shardingsphere-data-pipeline-dialect\shardingsphere-data-pipeline-mysql\src\main\java\org\apache\shardingsphere\data\pipeline\mysql\ingest\client\ServerVersion.java,0,17,0,3,0,20
 shardingsphere-master\shardingsphere-master\shardingsphere-infra\shardingsphere-infra-common\src\test\java\org\apache\shardingsphere\infra\datanode\DataNodeTest.java,0,22,2,4,0,28
 shardingsphere-master\shardingsphere-master\shardingsphere-features\shardingsphere-sharding\shardingsphere-sharding-distsql\shardingsphere-sharding-distsql-statement\src\main\java\org\apache\shardingsphere\scaling\distsql\statement\ShowScalingStatusStatement.java,0,3,0,3,0,6
 shardingsphere-master\shardingsphere-master\shardingsphere-features\shardingsphere-sharding\shardingsphere-sharding-core\src\test\java\org\apache\shardingsphere\sharding\rewrite\token\pojo\GeneratedKeyInsertColumnTokenTest.java,0,7,0,2,0,9
 shardingsphere-master\shardingsphere-master\shardingsphere-proxy\shardingsphere-proxy-frontend\shardingsphere-proxy-frontend-postgresql\src\main\java\org\apache\shardingsphere\proxy\frontend\postgresql\command\query\simple\PostgreSQLComQueryExecutor.java,0,38,1,41,0,80
 shardingsphere-master\shardingsphere-master\shardingsphere-agent\shardingsphere-agent-plugins\shardingsphere-agent-plugin-metrics\shardingsphere-agent-metrics-prometheus\src\test\java\org\apache\shardingsphere\agent\metrics\prometheus\definition\PrometheusPluginDefinitionServiceTest.java,0,5,0,2,0,7
 shardingsphere-master\shardingsphere-master\shardingsphere-infra\shardingsphere-infra-common\src\main\java\org\apache\shardingsphere\infra\database\type\BranchDatabaseType.java,0,3,0,1,0,4
 shardingsphere-master\shardingsphere-master\shardingsphere-kernel\shardingsphere-data-pipeline\shardingsphere-data-pipeline-spi\src\main\java\org\apache\shardingsphere\data\pipeline\api\ingest\record\Column.java,0,18,0,2,0,20
 shardingsphere-master\shardingsphere-master\shardingsphere-db-protocol\shardingsphere-db-protocol-postgresql\src\main\java\org\apache\shardingsphere\db\protocol\postgresql\packet\command\query\extended\bind\protocol\PostgreSQLInt4ArrayBinaryProtocolValue.java,0,11,0,9,0,20
 shardingsphere-master\shardingsphere-master\shardingsphere-distsql\shardingsphere-distsql-statement\src\main\java\org\apache\shardingsphere\distsql\parser\statement\rdl\alter\AlterDefaultSingleTableRuleStatement.java,0,4,0,2,0,6
 shardingsphere-master\shardingsphere-master\examples\example-core\example-spring-jpa\src\main\java\org\apache\shardingsphere\example\core\jpa\entity\AddressEntity.java,0,3,0,1,0,4
 shardingsphere-master\shardingsphere-master\shardingsphere-test\shardingsphere-parser-test\src\main\java\org\apache\shardingsphere\test\sql\parser\parameterized\asserts\statement\distsql\rql\impl\rule\CountSchemaRulesStatementAssert.java,0,8,0,11,0,19
 shardingsphere-master\shardingsphere-master\shardingsphere-kernel\shardingsphere-parser\shardingsphere-parser-spring\shardingsphere-parser-spring-boot-starter\src\test\java\org\apache\shardingsphere\parser\spring\boot\SQLParserSpringBootStarterTest.java,19,10,0,2,0,12
 shardingsphere-master\shardingsphere-master\shardingsphere-features\shardingsphere-sharding\shardingsphere-sharding-core\src\main\java\org\apache\shardingsphere\sharding\rewrite\token\generator\impl\ProjectionsTokenGenerator.java,0,37,0,41,0,78
 shardingsphere-master\shardingsphere-master\examples\shardingsphere-jdbc-example\single-feature-example\sharding-example\sharding-raw-jdbc-example\src\main\java\org\apache\shardingsphere\example\sharding\raw\jdbc\ShardingRawJavaConfigurationExample.java,0,8,1,5,0,14
 shardingsphere-master\shardingsphere-master\shardingsphere-kernel\shardingsphere-authority\shardingsphere-authority-core\src\test\java\org\apache\shardingsphere\authority\provider\simple\SchemaPrivilegesPermittedAuthorityProviderAlgorithmTest.java,0,14,4,12,0,30
 shardingsphere-master\shardingsphere-master\shardingsphere-infra\shardingsphere-infra-executor\src\main\java\org\apache\shardingsphere\infra\executor\sql\execute\result\query\impl\driver\jdbc\type\stream\JDBCStreamQueryResult.java,0,17,0,9,0,26
 shardingsphere-master\shardingsphere-master\shardingsphere-test\shardingsphere-parser-test\src\main\java\org\apache\shardingsphere\test\sql\parser\parameterized\engine\SQLParserParameterizedTest.java,41,33,0,21,0,54
 shardingsphere-master\shardingsphere-master\shardingsphere-features\shardingsphere-sharding\shardingsphere-sharding-core\src\main\java\org\apache\shardingsphere\sharding\yaml\engine\construct\NoneShardingStrategyConfigurationYamlConstruct.java,0,5,1,4,0,10
 shardingsphere-master\shardingsphere-master\examples\shardingsphere-jdbc-example\single-feature-example\transaction-example\transaction-base-seata-spring-boot-example\src\main\java\org\apache\shardingsphere\example\transaction\base\seata\spring\boot\TransactionConfiguration.java,25,2,0,1,0,3
 shardingsphere-master\shardingsphere-master\shardingsphere-infra\shardingsphere-infra-binder\src\test\java\org\apache\shardingsphere\infra\binder\segment\table\TablesContextTest.java,0,118,1,92,0,211
 shardingsphere-master\shardingsphere-master\examples\example-core\example-api\src\main\java\org\apache\shardingsphere\example\core\api\ExampleExecuteTemplate.java,0,7,1,3,0,11
 shardingsphere-master\shardingsphere-master\shardingsphere-features\shardingsphere-sharding\shardingsphere-sharding-core\src\test\java\org\apache\shardingsphere\sharding\route\strategy\type\complex\ComplexShardingStrategyTest.java,0,11,0,9,0,20
 shardingsphere-master\shardingsphere-master\shardingsphere-kernel\shardingsphere-data-pipeline\shardingsphere-data-pipeline-core\src\main\java\org\apache\shardingsphere\data\pipeline\core\check\consistency\DataConsistencyChecker.java,0,6,0,6,0,12
 shardingsphere-master\shardingsphere-master\shardingsphere-infra\shardingsphere-infra-binder\src\main\java\org\apache\shardingsphere\infra\binder\statement\ddl\DropViewStatementContext.java,0,6,0,5,0,11
 shardingsphere-master\shardingsphere-master\shardingsphere-infra\shardingsphere-infra-parser\src\main\java\org\apache\shardingsphere\infra\parser\sql\SQLStatementParserEngine.java,0,11,0,5,0,16
 shardingsphere-master\shardingsphere-master\shardingsphere-test\shardingsphere-integration-test\shardingsphere-integration-test-suite\src\test\java\org\apache\shardingsphere\test\integration\framework\container\atomic\governance\impl\ZookeeperContainer.java,0,6,0,4,0,10
 shardingsphere-master\shardingsphere-master\shardingsphere-infra\shardingsphere-infra-common\src\main\java\org\apache\shardingsphere\infra\rule\identifier\type\MutableDataNodeRule.java,0,3,0,1,0,4
 shardingsphere-master\shardingsphere-master\shardingsphere-sql-parser\shardingsphere-sql-parser-engine\src\test\java\org\apache\shardingsphere\sql\parser\core\database\cache\ParseTreeCacheBuilderTest.java,0,5,0,2,0,7
 shardingsphere-master\shardingsphere-master\shardingsphere-sql-parser\shardingsphere-sql-parser-statement\src\main\java\org\apache\shardingsphere\sql\parser\sql\dialect\statement\opengauss\ddl\OpenGaussCreateTablespaceStatement.java,0,1,0,5,0,6
 shardingsphere-master\shardingsphere-master\shardingsphere-sql-parser\shardingsphere-sql-parser-statement\src\main\java\org\apache\shardingsphere\sql\parser\sql\common\segment\dml\pagination\rownum\ParameterMarkerRowNumberValueSegment.java,0,7,0,5,0,12
 shardingsphere-master\shardingsphere-master\shardingsphere-proxy\shardingsphere-proxy-frontend\shardingsphere-proxy-frontend-opengauss\src\main\java\org\apache\shardingsphere\proxy\frontend\opengauss\err\OpenGaussErrorPacketFactory.java,0,42,1,32,0,75
 shardingsphere-master\shardingsphere-master\shardingsphere-infra\shardingsphere-infra-federation\shardingsphere-infra-federation-optimizer\src\main\java\org\apache\shardingsphere\infra\federation\optimizer\metadata\calcite\FederationDatabase.java,0,8,0,5,0,13
 shardingsphere-master\shardingsphere-master\shardingsphere-db-protocol\shardingsphere-db-protocol-mysql\src\main\java\org\apache\shardingsphere\db\protocol\mysql\packet\command\admin\MySQLUnsupportedCommandPacket.java,0,2,0,3,0,5
 shardingsphere-master\shardingsphere-master\shardingsphere-kernel\shardingsphere-transaction\shardingsphere-transaction-type\shardingsphere-transaction-xa\shardingsphere-transaction-xa-provider\shardingsphere-transaction-xa-bitronix\src\main\java\org\apache\shardingsphere\transaction\xa\bitronix\manager\BitronixXATransactionManagerProvider.java,0,13,0,7,0,20
 shardingsphere-master\shardingsphere-master\shardingsphere-features\shardingsphere-sharding\shardingsphere-sharding-core\src\main\java\org\apache\shardingsphere\sharding\route\engine\type\ShardingRouteEngineFactory.java,0,77,2,97,0,176
 shardingsphere-master\shardingsphere-master\shardingsphere-sql-parser\shardingsphere-sql-parser-statement\src\main\java\org\apache\shardingsphere\sql\parser\sql\dialect\statement\postgresql\ddl\PostgreSQLDropCastStatement.java,0,1,0,5,0,6
 shardingsphere-master\shardingsphere-master\shardingsphere-sql-parser\shardingsphere-sql-parser-statement\src\main\java\org\apache\shardingsphere\sql\parser\sql\dialect\statement\mysql\dal\MySQLShowCharsetStatement.java,0,1,0,5,0,6
 shardingsphere-master\shardingsphere-master\shardingsphere-infra\shardingsphere-infra-common\src\test\java\org\apache\shardingsphere\infra\metadata\user\yaml\swapper\YamlEngineUserConfigurationTest.java,0,9,0,5,0,14
 shardingsphere-master\shardingsphere-master\shardingsphere-features\shardingsphere-sharding\shardingsphere-sharding-distsql\shardingsphere-sharding-distsql-handler\src\test\java\org\apache\shardingsphere\sharding\distsql\converter\ShardingRuleStatementConverterTest.java,0,36,0,36,0,72
 shardingsphere-master\shardingsphere-master\shardingsphere-features\shardingsphere-readwrite-splitting\shardingsphere-readwrite-splitting-distsql\shardingsphere-readwrite-splitting-distsql-parser\src\main\java\org\apache\shardingsphere\readwritesplitting\distsql\parser\facade\ReadwriteSplittingDistSQLStatementParserFacade.java,0,6,0,6,0,12
 shardingsphere-master\shardingsphere-master\shardingsphere-test\shardingsphere-parser-test\src\main\java\org\apache\shardingsphere\test\sql\parser\parameterized\jaxb\cases\domain\segment\impl\distsql\rdl\ExceptedReadwriteSplittingRule.java,0,12,0,5,0,17
 shardingsphere-master\shardingsphere-master\shardingsphere-kernel\shardingsphere-data-pipeline\shardingsphere-data-pipeline-spi\src\main\java\org\apache\shardingsphere\data\pipeline\spi\ingest\position\PositionInitializer.java,0,4,1,2,0,7
 shardingsphere-master\shardingsphere-master\shardingsphere-test\shardingsphere-parser-test\src\main\java\org\apache\shardingsphere\test\sql\parser\parameterized\jaxb\cases\domain\statement\ddl\AlterSynonymStatementTestCase.java,0,0,0,3,0,3
 shardingsphere-master\shardingsphere-master\shardingsphere-kernel\shardingsphere-data-pipeline\shardingsphere-data-pipeline-core\src\main\java\org\apache\shardingsphere\data\pipeline\core\execute\PipelineJobExecutor.java,0,23,4,24,0,51
 shardingsphere-master\shardingsphere-master\shardingsphere-features\shardingsphere-sharding\shardingsphere-sharding-core\src\main\java\org\apache\shardingsphere\sharding\rewrite\token\pojo\ShardingInsertValue.java,0,6,0,4,0,10
 shardingsphere-master\shardingsphere-master\shardingsphere-infra\shardingsphere-infra-executor\src\main\java\org\apache\shardingsphere\infra\executor\sql\execute\engine\raw\RawExecutor.java,0,16,0,14,0,30
 shardingsphere-master\shardingsphere-master\shardingsphere-test\shardingsphere-parser-test\src\main\java\org\apache\shardingsphere\test\sql\parser\parameterized\asserts\statement\distsql\ral\impl\scaling\update\StopScalingSourceWritingStatementAssert.java,0,12,1,14,0,27
 shardingsphere-master\shardingsphere-master\shardingsphere-proxy\shardingsphere-proxy-backend\src\main\java\org\apache\shardingsphere\proxy\backend\text\admin\FunctionWithException.java,0,2,0,1,0,3
 shardingsphere-master\shardingsphere-master\shardingsphere-features\shardingsphere-sharding\shardingsphere-sharding-core\src\main\java\org\apache\shardingsphere\sharding\route\engine\condition\engine\impl\WhereClauseShardingConditionEngine.java,0,47,1,49,0,97
 shardingsphere-master\shardingsphere-master\shardingsphere-features\shardingsphere-readwrite-splitting\shardingsphere-readwrite-splitting-distsql\shardingsphere-readwrite-splitting-distsql-handler\src\test\java\org\apache\shardingsphere\readwritesplitting\distsql\handler\update\AlterReadwriteSplittingRuleStatementUpdaterTest.java,0,36,0,25,0,61
 shardingsphere-master\shardingsphere-master\shardingsphere-features\shardingsphere-sharding\shardingsphere-sharding-core\src\main\java\org\apache\shardingsphere\sharding\route\engine\condition\engine\ShardingConditionEngineFactory.java,0,7,0,7,0,14
 shardingsphere-master\shardingsphere-master\shardingsphere-features\shardingsphere-readwrite-splitting\shardingsphere-readwrite-splitting-distsql\shardingsphere-readwrite-splitting-distsql-statement\src\main\java\org\apache\shardingsphere\readwritesplitting\distsql\parser\segment\ReadwriteSplittingRuleSegment.java,0,30,0,3,0,33
 shardingsphere-master\shardingsphere-master\shardingsphere-proxy\shardingsphere-proxy-frontend\shardingsphere-proxy-frontend-postgresql\src\test\java\org\apache\shardingsphere\proxy\frontend\postgresql\authentication\authenticator\PostgreSQLPasswordAuthenticatorTest.java,0,15,2,8,0,25
 shardingsphere-master\shardingsphere-master\examples\shardingsphere-jdbc-example\single-feature-example\transaction-example\transaction-2pc-xa-narayana-raw-jdbc-example\src\main\java\org\apache\shardingsphere\example\transaction\xa\narayana\raw\jdbc\OrderServiceImpl.java,0,23,8,12,0,43
 shardingsphere-master\shardingsphere-master\shardingsphere-infra\shardingsphere-infra-rewrite\src\test\java\org\apache\shardingsphere\infra\rewrite\sql\fixture\SQLTokenFixture.java,0,6,0,1,0,7
 shardingsphere-master\shardingsphere-master\shardingsphere-test\shardingsphere-rewrite-test\src\test\java\org\apache\shardingsphere\sharding\rewrite\parameterized\entity\RewriteAssertionEntity.java,0,9,0,1,0,10
 shardingsphere-master\shardingsphere-master\shardingsphere-kernel\shardingsphere-transaction\shardingsphere-transaction-core\src\test\java\org\apache\shardingsphere\transaction\core\fixture\ShardingSphereTransactionManagerFixture.java,0,11,5,4,0,20
 shardingsphere-master\shardingsphere-master\shardingsphere-features\shardingsphere-sharding\shardingsphere-sharding-distsql\shardingsphere-sharding-distsql-statement\src\main\java\org\apache\shardingsphere\sharding\distsql\parser\statement\CreateShardingAlgorithmStatement.java,0,3,0,4,0,7
 shardingsphere-master\shardingsphere-master\shardingsphere-features\shardingsphere-sharding\shardingsphere-sharding-core\src\test\java\org\apache\shardingsphere\sharding\merge\dql\orderby\OrderByStreamMergedResultTest.java,0,48,0,38,0,86
 shardingsphere-master\shardingsphere-master\shardingsphere-infra\shardingsphere-infra-common\src\main\java\org\apache\shardingsphere\infra\datasource\config\PoolConfiguration.java,0,14,0,1,0,15
 shardingsphere-master\shardingsphere-master\shardingsphere-sql-parser\shardingsphere-sql-parser-statement\src\main\java\org\apache\shardingsphere\sql\parser\sql\dialect\statement\opengauss\tcl\OpenGaussCommitStatement.java,0,1,0,5,0,6
 shardingsphere-master\shardingsphere-master\shardingsphere-sql-parser\shardingsphere-sql-parser-statement\src\main\java\org\apache\shardingsphere\sql\parser\sql\dialect\statement\mysql\ddl\MySQLCreateIndexStatement.java,0,1,0,4,0,5
 shardingsphere-master\shardingsphere-master\shardingsphere-features\shardingsphere-sharding\shardingsphere-sharding-core\src\main\java\org\apache\shardingsphere\sharding\algorithm\sharding\range\VolumeBasedRangeShardingAlgorithm.java,0,19,0,11,0,30
 shardingsphere-master\shardingsphere-master\shardingsphere-features\shardingsphere-sharding\shardingsphere-sharding-distsql\shardingsphere-sharding-distsql-handler\src\main\java\org\apache\shardingsphere\sharding\distsql\handler\query\DefaultShardingStrategyQueryResultSet.java,0,24,1,19,0,44
 shardingsphere-master\shardingsphere-master\shardingsphere-agent\shardingsphere-agent-plugins\shardingsphere-agent-plugin-metrics\shardingsphere-agent-metrics-api\src\main\java\org\apache\shardingsphere\agent\metrics\api\MetricsWrapper.java,0,10,6,1,0,17
 shardingsphere-master\shardingsphere-master\shardingsphere-features\shardingsphere-sharding\shardingsphere-sharding-core\src\test\java\org\apache\shardingsphere\sharding\merge\dal\show\ShowTablesMergedResultTest.java,0,20,0,10,0,30
 shardingsphere-master\shardingsphere-master\shardingsphere-features\shardingsphere-db-discovery\shardingsphere-db-discovery-distsql\shardingsphere-db-discovery-distsql-statement\src\main\java\org\apache\shardingsphere\dbdiscovery\distsql\parser\statement\AlterDatabaseDiscoveryHeartbeatStatement.java,0,4,0,4,0,8
 shardingsphere-master\shardingsphere-master\shardingsphere-jdbc\shardingsphere-jdbc-spring\shardingsphere-jdbc-spring-infra\shardingsphere-jdbc-spring-namespace-infra\src\test\java\org\apache\shardingsphere\spring\namespace\fixture\handler\ShardingSphereAlgorithmFixtureNamespaceHandler.java,0,4,0,5,0,9
 shardingsphere-master\shardingsphere-master\shardingsphere-test\shardingsphere-parser-test\src\main\java\org\apache\shardingsphere\test\sql\parser\parameterized\jaxb\cases\domain\statement\tcl\UnlockStatementTestCase.java,0,0,0,3,0,3
 shardingsphere-master\shardingsphere-master\shardingsphere-features\shardingsphere-readwrite-splitting\shardingsphere-readwrite-splitting-core\src\test\java\org\apache\shardingsphere\readwritesplitting\rule\ReadWriteSplittingDataSourceRuleConfigurationTest.java,0,15,0,10,0,25
 shardingsphere-master\shardingsphere-master\shardingsphere-test\shardingsphere-parser-test\src\main\java\org\apache\shardingsphere\test\sql\parser\parameterized\jaxb\cases\domain\statement\dal\UninstallPluginStatementTestCase.java,0,2,0,4,0,6
 shardingsphere-master\shardingsphere-master\shardingsphere-mode\shardingsphere-mode-type\shardingsphere-memory-mode\shardingsphere-memory-mode-core\src\main\java\org\apache\shardingsphere\mode\manager\memory\MemoryContextManagerBuilder.java,0,27,0,23,0,50
 shardingsphere-master\shardingsphere-master\shardingsphere-proxy\shardingsphere-proxy-backend\src\test\java\org\apache\shardingsphere\proxy\backend\text\distsql\rdl\rule\AlterDefaultSingleTableRuleUpdaterTest.java,0,35,0,20,0,55
 shardingsphere-master\shardingsphere-master\shardingsphere-features\shardingsphere-shadow\shardingsphere-shadow-core\src\main\java\org\apache\shardingsphere\shadow\condition\ShadowColumnCondition.java,0,7,0,1,0,8
 shardingsphere-master\shardingsphere-master\shardingsphere-agent\shardingsphere-agent-core\src\main\java\org\apache\shardingsphere\agent\core\plugin\PluginLoader.java,0,4,0,3,0,7
 shardingsphere-master\shardingsphere-master\shardingsphere-test\shardingsphere-integration-test\shardingsphere-integration-test-suite\src\test\java\org\apache\shardingsphere\test\integration\engine\BatchITCase.java,117,45,0,30,0,75
 shardingsphere-master\shardingsphere-master\shardingsphere-db-protocol\shardingsphere-db-protocol-postgresql\src\test\java\org\apache\shardingsphere\db\protocol\postgresql\packet\command\query\extended\sync\PostgreSQLComSyncPacketTest.java,0,6,0,5,0,11
 shardingsphere-master\shardingsphere-master\shardingsphere-sql-parser\shardingsphere-sql-parser-statement\src\main\java\org\apache\shardingsphere\sql\parser\sql\common\segment\generic\AliasSegment.java,0,6,0,2,0,8
 shardingsphere-master\shardingsphere-master\shardingsphere-mode\shardingsphere-mode-core\src\test\java\org\apache\shardingsphere\mode\metadata\persist\service\impl\PropertiesPersistServiceTest.java,0,8,0,3,0,11
 shardingsphere-master\shardingsphere-master\shardingsphere-sql-parser\shardingsphere-sql-parser-statement\src\main\java\org\apache\shardingsphere\sql\parser\sql\dialect\statement\opengauss\ddl\OpenGaussCreateViewStatement.java,0,1,0,5,0,6
 shardingsphere-master\shardingsphere-master\shardingsphere-test\shardingsphere-parser-test\src\main\java\org\apache\shardingsphere\test\sql\parser\parameterized\jaxb\cases\domain\statement\dal\ShowVariablesStatementTestCase.java,0,2,0,4,0,6
 shardingsphere-master\shardingsphere-master\examples\example-core\example-spring-jpa\src\main\java\org\apache\shardingsphere\example\core\jpa\repository\OrderItemRepositoryImpl.java,40,17,0,5,0,22
 shardingsphere-master\shardingsphere-master\shardingsphere-db-protocol\shardingsphere-db-protocol-postgresql\src\test\java\org\apache\shardingsphere\db\protocol\postgresql\packet\generic\PostgreSQLAuthenticationOKPacketTest.java,0,9,0,7,0,16
 shardingsphere-master\shardingsphere-master\examples\shardingsphere-jdbc-example\mixed-feature-example\sharding-readwrite-splitting-example\sharding-readwrite-splitting-spring-namespace-mybatis-example\src\main\java\org\apache\shardingsphere\example\sharding\readwrite\splitting\spring\namespace\mybatis\ShardingReadwriteSplittingSpringNamespaceMybatisExample.java,0,9,1,5,0,15
 shardingsphere-master\shardingsphere-master\shardingsphere-test\shardingsphere-parser-test\src\main\java\org\apache\shardingsphere\test\sql\parser\parameterized\jaxb\cases\domain\statement\dcl\GrantStatementTestCase.java,0,4,0,5,0,9
 shardingsphere-master\shardingsphere-master\shardingsphere-agent\shardingsphere-agent-core\src\main\java\org\apache\shardingsphere\agent\core\bytebuddy\transformer\advice\ComposeConstructorAdvice.java,0,4,0,2,0,6
 shardingsphere-master\shardingsphere-master\shardingsphere-test\shardingsphere-parser-test\src\main\java\org\apache\shardingsphere\test\sql\parser\parameterized\jaxb\cases\domain\statement\dal\KillStatementTestCase.java,0,2,0,3,0,5
 shardingsphere-master\shardingsphere-master\examples\example-core\example-spring-mybatis\src\main\java\org\apache\shardingsphere\example\core\mybatis\service\OrderServiceImpl.java,97,27,0,10,0,37
 shardingsphere-master\shardingsphere-master\shardingsphere-sql-parser\shardingsphere-sql-parser-statement\src\main\java\org\apache\shardingsphere\sql\parser\sql\dialect\statement\sqlserver\ddl\SQLServerAlterIndexStatement.java,0,4,0,6,1,11
 shardingsphere-master\shardingsphere-master\shardingsphere-mode\shardingsphere-mode-type\shardingsphere-cluster-mode\shardingsphere-cluster-mode-core\src\test\java\org\apache\shardingsphere\mode\manager\cluster\coordinator\registry\status\storage\node\StorageStatusNodeTest.java,0,7,0,4,0,11
 shardingsphere-master\shardingsphere-master\shardingsphere-features\shardingsphere-sharding\shardingsphere-sharding-distsql\shardingsphere-sharding-distsql-handler\src\test\java\org\apache\shardingsphere\sharding\distsql\update\DropShardingAlgorithmStatementUpdaterTest.java,0,59,0,43,0,102
 shardingsphere-master\shardingsphere-master\shardingsphere-sql-parser\shardingsphere-sql-parser-engine\src\test\java\org\apache\shardingsphere\sql\parser\core\DatabaseTypedSQLParserFacadeRegistryTest.java,0,8,0,8,0,16
 shardingsphere-master\shardingsphere-master\shardingsphere-sql-parser\shardingsphere-sql-parser-statement\src\main\java\org\apache\shardingsphere\sql\parser\sql\dialect\statement\mysql\dal\MySQLShowRelaylogEventsStatement.java,0,6,0,6,0,12
 shardingsphere-master\shardingsphere-master\shardingsphere-proxy\shardingsphere-proxy-bootstrap\src\test\java\org\apache\shardingsphere\proxy\arguments\BootstrapArgumentsTest.java,0,27,0,7,0,34
 shardingsphere-master\shardingsphere-master\shardingsphere-kernel\shardingsphere-data-pipeline\shardingsphere-data-pipeline-dialect\shardingsphere-data-pipeline-mysql\src\main\java\org\apache\shardingsphere\data\pipeline\mysql\MySQLScalingEntry.java,0,5,0,3,0,8
 shardingsphere-master\shardingsphere-master\shardingsphere-infra\shardingsphere-infra-executor\src\main\java\org\apache\shardingsphere\infra\executor\sql\execute\result\query\QueryResult.java,0,11,0,4,0,15
 shardingsphere-master\shardingsphere-master\shardingsphere-infra\shardingsphere-infra-common\src\main\java\org\apache\shardingsphere\infra\metadata\schema\builder\SystemSchemaBuilderRule.java,0,36,0,12,0,48
 shardingsphere-master\shardingsphere-master\examples\shardingsphere-jdbc-example\single-feature-example\cluster-mode-example\cluster-mode-raw-jdbc-example\src\main\java\org\apache\shardingsphere\example\cluster\mode\raw\jdbc\config\local\LocalShadowConfiguration.java,0,10,0,3,0,13
 shardingsphere-master\shardingsphere-master\shardingsphere-sql-parser\shardingsphere-sql-parser-statement\src\main\java\org\apache\shardingsphere\sql\parser\sql\dialect\statement\mysql\segment\UserResourceSpecifiedLimitEnum.java,0,8,0,2,0,10
 shardingsphere-master\shardingsphere-master\shardingsphere-sql-parser\shardingsphere-sql-parser-statement\src\main\java\org\apache\shardingsphere\sql\parser\sql\dialect\statement\sqlserver\tcl\SQLServerSetAutoCommitStatement.java,0,1,0,5,0,6
 shardingsphere-master\shardingsphere-master\shardingsphere-sql-parser\shardingsphere-sql-parser-statement\src\main\java\org\apache\shardingsphere\sql\parser\sql\dialect\statement\mysql\segment\ResetOptionSegment.java,7,2,1,2,0,5
 shardingsphere-master\shardingsphere-master\shardingsphere-db-protocol\shardingsphere-db-protocol-mysql\src\main\java\org\apache\shardingsphere\db\protocol\mysql\constant\MySQLConstants.java,0,7,0,3,0,10
 shardingsphere-master\shardingsphere-master\shardingsphere-features\shardingsphere-readwrite-splitting\shardingsphere-readwrite-splitting-spring\shardingsphere-readwrite-splitting-spring-boot-starter\src\test\java\org\apache\shardingsphere\readwritesplitting\spring\boot\condition\ReadwriteSplittingSpringBootConditionTest.java,0,12,0,8,0,20
 shardingsphere-master\shardingsphere-master\shardingsphere-mode\shardingsphere-mode-type\shardingsphere-cluster-mode\shardingsphere-cluster-mode-core\src\test\java\org\apache\shardingsphere\mode\manager\cluster\coordinator\registry\process\subscriber\ProcessRegistrySubscriberTestNoMock.java,0,50,2,46,0,98
 shardingsphere-master\shardingsphere-master\shardingsphere-proxy\shardingsphere-proxy-backend\src\main\java\org\apache\shardingsphere\proxy\backend\text\distsql\rql\RQLBackendHandler.java,0,16,0,10,0,26
 shardingsphere-master\shardingsphere-master\shardingsphere-test\shardingsphere-integration-test\shardingsphere-integration-test-suite\src\test\java\org\apache\shardingsphere\test\integration\cases\dataset\DataSetLoader.java,0,13,1,9,0,23
 shardingsphere-master\shardingsphere-master\shardingsphere-infra\shardingsphere-infra-federation\shardingsphere-infra-federation-optimizer\src\main\java\org\apache\shardingsphere\infra\federation\optimizer\context\parser\dialect\impl\PostgreSQLOptimizerBuilder.java,0,6,0,7,0,13
 shardingsphere-master\shardingsphere-master\shardingsphere-sql-parser\shardingsphere-sql-parser-statement\src\main\java\org\apache\shardingsphere\sql\parser\sql\common\segment\generic\CommentSegment.java,0,6,0,1,0,7
 shardingsphere-master\shardingsphere-master\shardingsphere-test\shardingsphere-integration-test\shardingsphere-integration-test-suite\src\test\java\org\apache\shardingsphere\test\integration\env\scenario\authority\AuthorityEnvironment.java,0,5,0,1,0,6
 shardingsphere-master\shardingsphere-master\shardingsphere-test\shardingsphere-parser-test\src\main\java\org\apache\shardingsphere\test\sql\parser\parameterized\jaxb\cases\domain\statement\ddl\AlterLanguageStatementTestCase.java,0,0,0,3,0,3
 shardingsphere-master\shardingsphere-master\shardingsphere-distsql\shardingsphere-distsql-parser\src\main\java\org\apache\shardingsphere\distsql\parser\core\common\CommonDistSQLParser.java,0,5,0,4,0,9
 shardingsphere-master\shardingsphere-master\shardingsphere-proxy\shardingsphere-proxy-frontend\shardingsphere-proxy-frontend-core\src\main\java\org\apache\shardingsphere\proxy\frontend\netty\FrontendChannelInboundHandler.java,0,34,2,24,0,60
 shardingsphere-master\shardingsphere-master\shardingsphere-sql-parser\shardingsphere-sql-parser-statement\src\main\java\org\apache\shardingsphere\sql\parser\sql\common\statement\ddl\AlterViewStatement.java,5,3,1,4,2,10
 shardingsphere-master\shardingsphere-master\shardingsphere-sql-parser\shardingsphere-sql-parser-statement\src\main\java\org\apache\shardingsphere\sql\parser\sql\dialect\statement\mysql\dal\MySQLSetResourceGroupStatement.java,0,3,0,5,0,8
 shardingsphere-master\shardingsphere-master\shardingsphere-agent\shardingsphere-agent-plugins\shardingsphere-agent-plugin-metrics\shardingsphere-agent-metrics-api\src\test\java\org\apache\shardingsphere\agent\metrics\api\util\ReflectiveUtil.java,0,5,1,3,0,9
 shardingsphere-master\shardingsphere-master\shardingsphere-sql-parser\shardingsphere-sql-parser-dialect\shardingsphere-sql-parser-postgresql\src\test\java\org\apache\shardingsphere\sql\parser\postgresql\PostgreSQLParserParameterizedTest.java,0,7,0,5,0,12
 shardingsphere-master\shardingsphere-master\shardingsphere-features\shardingsphere-sharding\shardingsphere-sharding-core\src\test\java\org\apache\shardingsphere\sharding\rewrite\token\pojo\OrderByTokenTest.java,0,5,0,3,0,8
 shardingsphere-master\shardingsphere-master\shardingsphere-db-protocol\shardingsphere-db-protocol-postgresql\src\main\java\org\apache\shardingsphere\db\protocol\postgresql\packet\generic\PostgreSQLComTerminationPacket.java,0,6,1,7,0,14
 shardingsphere-master\shardingsphere-master\shardingsphere-jdbc\shardingsphere-jdbc-core\src\test\java\org\apache\shardingsphere\driver\jdbc\unsupported\UnsupportedOperationConnectionTest.java,0,45,0,7,0,52
 shardingsphere-master\shardingsphere-master\shardingsphere-proxy\shardingsphere-proxy-backend\src\main\java\org\apache\shardingsphere\proxy\backend\text\distsql\ral\common\queryable\ShowAuthorityRuleHandler.java,0,15,0,11,0,26
 shardingsphere-master\shardingsphere-master\shardingsphere-proxy\shardingsphere-proxy-backend\src\main\java\org\apache\shardingsphere\proxy\backend\text\admin\mysql\executor\NoResourceSetExecutor.java,0,4,1,4,0,9
 shardingsphere-master\shardingsphere-master\shardingsphere-proxy\shardingsphere-proxy-frontend\shardingsphere-proxy-frontend-reactive-spi\src\main\java\org\apache\shardingsphere\proxy\frontend\reactive\command\executor\ReactiveCommandExecutor.java,0,3,0,1,0,4
 shardingsphere-master\shardingsphere-master\shardingsphere-features\shardingsphere-sharding\shardingsphere-sharding-core\src\test\java\org\apache\shardingsphere\sharding\fixture\ClassBasedHintShardingAlgorithmFixture.java,0,2,1,4,0,7
 shardingsphere-master\shardingsphere-master\shardingsphere-test\shardingsphere-parser-test\src\main\java\org\apache\shardingsphere\test\sql\parser\parameterized\asserts\statement\comment\CommentAssert.java,0,13,0,15,0,28
 shardingsphere-master\shardingsphere-master\shardingsphere-agent\shardingsphere-agent-core\src\main\java\org\apache\shardingsphere\agent\core\bytebuddy\transformer\advice\ComposeClassStaticMethodAroundAdvice.java,0,11,0,6,0,17
 shardingsphere-master\shardingsphere-master\shardingsphere-sql-parser\shardingsphere-sql-parser-statement\src\main\java\org\apache\shardingsphere\sql\parser\sql\common\value\identifier\IdentifierValue.java,0,12,0,3,0,15
 shardingsphere-master\shardingsphere-master\examples\shardingsphere-proxy-example\shardingsphere-proxy-distsql-example\src\main\java\org\apache\shardingsphere\example\proxy\distsql\utils\FileUtil.java,0,5,1,2,0,8
 shardingsphere-master\shardingsphere-master\shardingsphere-spi\src\test\java\org\apache\shardingsphere\spi\ShardingSphereServiceLoaderTest.java,0,24,1,13,0,38
 shardingsphere-master\shardingsphere-master\shardingsphere-features\shardingsphere-sharding\shardingsphere-sharding-core\src\main\java\org\apache\shardingsphere\sharding\rewrite\token\pojo\IndexToken.java,0,37,1,17,0,55
 shardingsphere-master\shardingsphere-master\shardingsphere-db-protocol\shardingsphere-db-protocol-mysql\src\main\java\org\apache\shardingsphere\db\protocol\mysql\packet\binlog\row\column\value\time\MySQLTimeBinlogProtocolValue.java,0,9,0,8,0,17
 shardingsphere-master\shardingsphere-master\examples\shardingsphere-example-generator\src\main\java\org\apache\shardingsphere\example\generator\scenario\feature\type\ShardingExampleScenario.java,0,5,0,2,0,7
 shardingsphere-master\shardingsphere-master\shardingsphere-infra\shardingsphere-infra-common\src\main\java\org\apache\shardingsphere\infra\database\metadata\url\StandardJdbcUrlParser.java,0,28,0,9,0,37
 shardingsphere-master\shardingsphere-master\examples\shardingsphere-example-generator\src\main\java\org\apache\shardingsphere\example\generator\core\GenerateUtil.java,0,19,1,10,0,30
 shardingsphere-master\shardingsphere-master\shardingsphere-features\shardingsphere-sharding\shardingsphere-sharding-core\src\main\java\org\apache\shardingsphere\sharding\rule\builder\AlgorithmProvidedShardingRuleBuilder.java,0,8,0,6,0,14
 shardingsphere-master\shardingsphere-master\shardingsphere-sql-parser\shardingsphere-sql-parser-dialect\shardingsphere-sql-parser-mysql\src\test\java\org\apache\shardingsphere\sql\parser\mysql\MySQLTableVistorTest.java,0,31,0,11,0,42
 shardingsphere-master\shardingsphere-master\shardingsphere-distsql\shardingsphere-distsql-statement\src\main\java\org\apache\shardingsphere\distsql\parser\statement\ral\common\updatable\AlterSQLParserRuleStatement.java,0,6,0,2,0,8
 shardingsphere-master\shardingsphere-master\shardingsphere-test\shardingsphere-parser-test\src\main\java\org\apache\shardingsphere\test\sql\parser\parameterized\jaxb\cases\domain\statement\distsql\ral\ShowShardingHintStatusStatementTestCase.java,0,1,0,4,0,5
 shardingsphere-master\shardingsphere-master\shardingsphere-features\shardingsphere-sharding\shardingsphere-sharding-core\src\main\java\org\apache\shardingsphere\sharding\route\engine\validator\ddl\impl\ShardingPrepareStatementValidator.java,0,12,1,11,0,24
 shardingsphere-master\shardingsphere-master\shardingsphere-infra\shardingsphere-infra-common\src\main\templates\org\apache\shardingsphere\infra\autogen\version\ShardingSphereVersion.java,0,32,1,8,0,41
 shardingsphere-master\shardingsphere-master\shardingsphere-proxy\shardingsphere-proxy-backend\src\main\java\org\apache\shardingsphere\proxy\backend\text\admin\executor\DatabaseAdminExecutor.java,0,2,0,1,0,3
 shardingsphere-master\shardingsphere-master\shardingsphere-features\shardingsphere-sharding\shardingsphere-sharding-core\src\test\java\org\apache\shardingsphere\sharding\rewrite\token\GeneratedKeyAssignmentTokenGeneratorTest.java,0,12,0,19,0,31
 shardingsphere-master\shardingsphere-master\shardingsphere-sql-parser\shardingsphere-sql-parser-statement\src\main\java\org\apache\shardingsphere\sql\parser\sql\common\segment\dml\expr\ExpressionSegment.java,0,0,0,1,0,1
 shardingsphere-master\shardingsphere-master\shardingsphere-sql-parser\shardingsphere-sql-parser-statement\src\main\java\org\apache\shardingsphere\sql\parser\sql\dialect\statement\mysql\segment\ACLAttributeEnum.java,0,6,0,2,0,8
 shardingsphere-master\shardingsphere-master\shardingsphere-db-protocol\shardingsphere-db-protocol-mysql\src\main\java\org\apache\shardingsphere\db\protocol\mysql\payload\MySQLPacketPayload.java,0,113,0,31,0,144
 shardingsphere-master\shardingsphere-master\shardingsphere-infra\shardingsphere-infra-binder\src\main\java\org\apache\shardingsphere\infra\binder\statement\ddl\DropTableStatementContext.java,0,7,0,6,0,13
 shardingsphere-master\shardingsphere-master\shardingsphere-proxy\shardingsphere-proxy-backend\src\test\java\org\apache\shardingsphere\proxy\backend\text\distsql\rql\SingleTableQueryResultSetTest.java,0,26,0,17,0,43
 shardingsphere-master\shardingsphere-master\examples\shardingsphere-jdbc-example\single-feature-example\extension-example\custom-sharding-algortihm-example\class-based-sharding-algorithm-example\class-based-sharding-spring-boot-mybatis-example\src\main\java\org\apache\shardingsphere\example\extension\classbased\sharding\spring\boot\mybatis\fixture\ClassBasedOrderItemStandardShardingAlgorithmFixture.java,0,16,0,11,0,27
 shardingsphere-master\shardingsphere-master\shardingsphere-sql-parser\shardingsphere-sql-parser-statement\src\main\java\org\apache\shardingsphere\sql\parser\sql\dialect\statement\postgresql\dcl\PostgreSQLDropUserStatement.java,0,1,0,5,0,6
 shardingsphere-master\shardingsphere-master\shardingsphere-infra\shardingsphere-infra-context\src\main\java\org\apache\shardingsphere\infra\context\refresher\type\DropTableStatementSchemaRefresher.java,0,13,0,15,0,28
 shardingsphere-master\shardingsphere-master\shardingsphere-test\shardingsphere-parser-test\src\main\java\org\apache\shardingsphere\test\sql\parser\parameterized\jaxb\cases\domain\statement\distsql\ral\ShowTransactionRuleStatementTestCase.java,0,1,0,4,0,5
 shardingsphere-master\shardingsphere-master\shardingsphere-sql-parser\shardingsphere-sql-parser-statement\src\main\java\org\apache\shardingsphere\sql\parser\sql\common\segment\dml\assignment\InsertValuesSegment.java,0,6,0,2,2,10
 shardingsphere-master\shardingsphere-master\shardingsphere-infra\shardingsphere-infra-common\src\main\java\org\apache\shardingsphere\infra\config\schema\SchemaConfiguration.java,0,5,0,1,0,6
 shardingsphere-master\shardingsphere-master\shardingsphere-db-protocol\shardingsphere-db-protocol-postgresql\src\test\java\org\apache\shardingsphere\db\protocol\postgresql\packet\command\query\PostgreSQLEmptyQueryResponsePacketTest.java,0,4,0,5,0,9
 shardingsphere-master\shardingsphere-master\shardingsphere-test\shardingsphere-parser-test\src\main\java\org\apache\shardingsphere\test\sql\parser\parameterized\asserts\segment\orderby\OrderByClauseAssert.java,0,5,0,7,0,12
 shardingsphere-master\shardingsphere-master\shardingsphere-features\shardingsphere-encrypt\shardingsphere-encrypt-spring\shardingsphere-encrypt-spring-namespace\src\main\java\org\apache\shardingsphere\encrypt\spring\namespace\parser\EncryptRuleBeanDefinitionParser.java,0,30,0,31,0,61
 shardingsphere-master\shardingsphere-master\shardingsphere-infra\shardingsphere-infra-route\src\main\java\org\apache\shardingsphere\infra\route\context\RouteStageContext.java,0,0,0,1,0,1
 shardingsphere-master\shardingsphere-master\shardingsphere-features\shardingsphere-sharding\shardingsphere-sharding-core\src\main\java\org\apache\shardingsphere\sharding\merge\dql\pagination\RowNumberDecoratorMergedResult.java,0,14,0,6,0,20
 shardingsphere-master\shardingsphere-master\shardingsphere-sql-parser\shardingsphere-sql-parser-statement\src\main\java\org\apache\shardingsphere\sql\parser\sql\dialect\statement\mysql\tcl\MySQLSavepointStatement.java,0,1,0,4,0,5
 shardingsphere-master\shardingsphere-master\shardingsphere-proxy\shardingsphere-proxy-frontend\shardingsphere-proxy-frontend-mysql\src\main\java\org\apache\shardingsphere\proxy\frontend\mysql\MySQLFrontendEngine.java,0,18,1,11,0,30
 shardingsphere-master\shardingsphere-master\shardingsphere-jdbc\shardingsphere-jdbc-spring\shardingsphere-jdbc-core-spring\shardingsphere-jdbc-core-spring-namespace\src\main\java\org\apache\shardingsphere\spring\namespace\handler\DataSourceNamespaceHandler.java,0,4,0,7,0,11
 shardingsphere-master\shardingsphere-master\shardingsphere-proxy\shardingsphere-proxy-frontend\shardingsphere-proxy-frontend-postgresql\src\test\java\org\apache\shardingsphere\proxy\frontend\postgresql\authentication\PostgreSQLAuthenticationHandlerTest.java,0,79,7,42,0,128
 shardingsphere-master\shardingsphere-master\shardingsphere-infra\shardingsphere-infra-common\src\main\java\org\apache\shardingsphere\infra\config\props\ConfigurationPropertyKey.java,0,47,0,24,0,71
 shardingsphere-master\shardingsphere-master\shardingsphere-test\shardingsphere-parser-test\src\main\java\org\apache\shardingsphere\test\sql\parser\parameterized\asserts\statement\distsql\rdl\drop\impl\DropReadwriteSplittingRuleStatementAssert.java,0,9,0,12,0,21
 shardingsphere-master\shardingsphere-master\shardingsphere-db-protocol\shardingsphere-db-protocol-mysql\src\main\java\org\apache\shardingsphere\db\protocol\mysql\packet\binlog\row\column\value\time\MySQLDatetime2BinlogProtocolValue.java,0,26,0,12,0,38
 shardingsphere-master\shardingsphere-master\shardingsphere-agent\shardingsphere-agent-core\src\main\java\org\apache\shardingsphere\agent\core\plugin\interceptor\InstanceMethodAroundInterceptor.java,64,12,7,10,0,29
 shardingsphere-master\shardingsphere-master\shardingsphere-features\shardingsphere-db-discovery\shardingsphere-db-discovery-distsql\shardingsphere-db-discovery-distsql-handler\src\test\java\org\apache\shardingsphere\dbdiscovery\distsql\handler\converter\DatabaseDiscoveryRuleStatementConverterTest.java,0,17,0,19,0,36
 shardingsphere-master\shardingsphere-master\shardingsphere-infra\shardingsphere-infra-common\src\test\java\org\apache\shardingsphere\infra\yaml\engine\fixture\CustomizedClassFixture.java,0,1,0,1,0,2
 shardingsphere-master\shardingsphere-master\shardingsphere-sql-parser\shardingsphere-sql-parser-statement\src\main\java\org\apache\shardingsphere\sql\parser\sql\dialect\statement\postgresql\dal\PostgreSQLShowStatement.java,0,1,0,5,0,6
 shardingsphere-master\shardingsphere-master\shardingsphere-sql-parser\shardingsphere-sql-parser-statement\src\main\java\org\apache\shardingsphere\sql\parser\sql\common\extractor\TableExtractor.java,0,68,0,80,2,150
 shardingsphere-master\shardingsphere-master\shardingsphere-test\shardingsphere-integration-test\shardingsphere-integration-test-suite\src\test\java\org\apache\shardingsphere\test\integration\env\scenario\path\ScenarioCommonPath.java,0,14,0,2,0,16
 shardingsphere-master\shardingsphere-master\shardingsphere-test\shardingsphere-parser-test\src\main\java\org\apache\shardingsphere\test\sql\parser\parameterized\jaxb\cases\domain\statement\dml\InsertStatementTestCase.java,0,20,0,11,0,31
 shardingsphere-master\shardingsphere-master\shardingsphere-sql-parser\shardingsphere-sql-parser-statement\src\main\java\org\apache\shardingsphere\sql\parser\sql\dialect\statement\sqlserver\ddl\SQLServerCreateProcedureStatement.java,0,1,0,5,0,6
 shardingsphere-master\shardingsphere-master\shardingsphere-features\shardingsphere-sharding\shardingsphere-sharding-distsql\shardingsphere-sharding-distsql-statement\src\main\java\org\apache\shardingsphere\sharding\distsql\parser\statement\DropShardingKeyGeneratorStatement.java,0,1,0,2,0,3
 shardingsphere-master\shardingsphere-master\shardingsphere-features\shardingsphere-db-discovery\shardingsphere-db-discovery-spring\shardingsphere-db-discovery-spring-boot-starter\src\main\java\org\apache\shardingsphere\dbdiscovery\spring\boot\condition\DatabaseDiscoverySpringBootCondition.java,0,9,0,6,0,15
 shardingsphere-master\shardingsphere-master\shardingsphere-infra\shardingsphere-infra-common\src\main\java\org\apache\shardingsphere\infra\yaml\schema\pojo\YamlTableMetaData.java,0,8,0,1,0,9
 shardingsphere-master\shardingsphere-master\shardingsphere-proxy\shardingsphere-proxy-frontend\shardingsphere-proxy-frontend-mysql\src\main\java\org\apache\shardingsphere\proxy\frontend\mysql\command\query\binary\prepare\MySQLComStmtPrepareChecker.java,0,19,0,65,0,84
 shardingsphere-master\shardingsphere-master\shardingsphere-kernel\shardingsphere-data-pipeline\shardingsphere-data-pipeline-spi\src\main\java\org\apache\shardingsphere\data\pipeline\api\check\consistency\DataConsistencyCheckResult.java,0,13,0,2,0,15
 shardingsphere-master\shardingsphere-master\shardingsphere-infra\shardingsphere-infra-federation\shardingsphere-infra-federation-executor\src\main\java\org\apache\shardingsphere\infra\federation\executor\original\FederationTableStatistic.java,0,2,0,1,0,3
 shardingsphere-master\shardingsphere-master\shardingsphere-features\shardingsphere-sharding\shardingsphere-sharding-distsql\shardingsphere-sharding-distsql-handler\src\main\java\org\apache\shardingsphere\sharding\distsql\handler\update\AlterDefaultShardingStrategyStatementUpdater.java,0,60,2,53,0,115
 shardingsphere-master\shardingsphere-master\shardingsphere-sql-parser\shardingsphere-sql-parser-engine\src\test\java\org\apache\shardingsphere\sql\parser\exception\SQLParsingExceptionTest.java,0,4,0,2,0,6
 shardingsphere-master\shardingsphere-master\shardingsphere-proxy\shardingsphere-proxy-backend\src\test\java\org\apache\shardingsphere\proxy\backend\text\distsql\ral\advance\ParseDistSQLBackendHandlerTest.java,0,20,0,14,0,34
 shardingsphere-master\shardingsphere-master\shardingsphere-agent\shardingsphere-agent-plugins\shardingsphere-agent-plugin-tracing\shardingsphere-agent-tracing-jaeger\src\main\java\org\apache\shardingsphere\agent\plugin\tracing\jaeger\advice\JDBCExecutorCallbackAdvice.java,0,16,1,16,0,33
 shardingsphere-master\shardingsphere-master\shardingsphere-kernel\shardingsphere-transaction\shardingsphere-transaction-core\src\main\java\org\apache\shardingsphere\transaction\core\ResourceIDGenerator.java,0,7,0,2,0,9
 shardingsphere-master\shardingsphere-master\shardingsphere-features\shardingsphere-db-discovery\shardingsphere-db-discovery-distsql\shardingsphere-db-discovery-distsql-handler\src\test\java\org\apache\shardingsphere\dbdiscovery\distsql\handler\update\AlterDatabaseDiscoveryRuleStatementUpdaterTest.java,0,91,0,71,0,162
 shardingsphere-master\shardingsphere-master\shardingsphere-db-protocol\shardingsphere-db-protocol-core\src\main\java\org\apache\shardingsphere\db\protocol\packet\DatabasePacket.java,0,1,0,1,0,2
 shardingsphere-master\shardingsphere-master\shardingsphere-proxy\shardingsphere-proxy-frontend\shardingsphere-proxy-frontend-spi\src\main\java\org\apache\shardingsphere\proxy\frontend\command\executor\QueryCommandExecutor.java,0,3,0,1,0,4
 shardingsphere-master\shardingsphere-master\shardingsphere-features\shardingsphere-sharding\shardingsphere-sharding-core\src\main\java\org\apache\shardingsphere\sharding\merge\dql\groupby\aggregation\ComparableAggregationUnit.java,0,6,0,1,0,7
 shardingsphere-master\shardingsphere-master\shardingsphere-agent\shardingsphere-agent-core\src\test\java\org\apache\shardingsphere\agent\core\mock\advice\MockConstructorAdvice.java,0,7,0,3,0,10
 shardingsphere-master\shardingsphere-master\shardingsphere-kernel\shardingsphere-authority\shardingsphere-authority-core\src\main\java\org\apache\shardingsphere\authority\provider\schema\builder\SchemaPrivilegeBuilder.java,0,28,0,23,0,51
 shardingsphere-master\shardingsphere-master\shardingsphere-infra\shardingsphere-infra-executor\src\test\java\org\apache\shardingsphere\infra\executor\sql\log\SQLLoggerTest.java,0,40,3,20,0,63
 shardingsphere-master\shardingsphere-master\shardingsphere-test\shardingsphere-pipeline-test\src\test\java\org\apache\shardingsphere\data\pipeline\core\fixture\FixtureDataConsistencyCheckAlgorithm.java,0,17,1,9,0,27
 shardingsphere-master\shardingsphere-master\shardingsphere-test\shardingsphere-integration-test\shardingsphere-integration-test-suite\src\test\java\org\apache\shardingsphere\test\integration\engine\dml\BatchDMLIT.java,0,17,0,14,0,31
 shardingsphere-master\shardingsphere-master\shardingsphere-test\shardingsphere-parser-test\src\main\java\org\apache\shardingsphere\test\sql\parser\parameterized\jaxb\cases\domain\statement\ddl\AlterGroupStatementTestCase.java,0,0,0,3,0,3
 shardingsphere-master\shardingsphere-master\shardingsphere-sql-parser\shardingsphere-sql-parser-statement\src\main\java\org\apache\shardingsphere\sql\parser\sql\common\segment\dml\pagination\NumberLiteralPaginationValueSegment.java,0,4,0,2,0,6
 shardingsphere-master\shardingsphere-master\shardingsphere-sql-parser\shardingsphere-sql-parser-statement\src\main\java\org\apache\shardingsphere\sql\parser\sql\dialect\statement\mysql\ddl\MySQLDropServerStatement.java,0,1,0,5,0,6
 shardingsphere-master\shardingsphere-master\shardingsphere-sql-parser\shardingsphere-sql-parser-statement\src\main\java\org\apache\shardingsphere\sql\parser\sql\dialect\statement\sqlserver\ddl\SQLServerDropIndexStatement.java,0,6,0,6,1,13
 shardingsphere-master\shardingsphere-master\shardingsphere-infra\shardingsphere-infra-common\src\test\java\org\apache\shardingsphere\infra\datasource\pool\creator\type\DBCPDataSourcePoolCreatorTest.java,0,9,1,5,0,15
 shardingsphere-master\shardingsphere-master\shardingsphere-proxy\shardingsphere-proxy-backend\src\main\java\org\apache\shardingsphere\proxy\backend\text\distsql\ral\common\queryable\ShowVariableHandler.java,0,35,6,27,0,68
 shardingsphere-master\shardingsphere-master\shardingsphere-features\shardingsphere-sharding\shardingsphere-sharding-distsql\shardingsphere-sharding-distsql-handler\src\main\java\org\apache\shardingsphere\scaling\distsql\handler\CreateShardingScalingRuleStatementUpdater.java,0,56,0,45,0,101
 shardingsphere-master\shardingsphere-master\examples\shardingsphere-jdbc-example\single-feature-example\extension-example\custom-sharding-algortihm-example\spi-based-sharding-algorithm-example\spi-based-sharding-spring-boot-mybatis-example\src\main\java\org\apache\shardingsphere\example\extension\spibased\sharding\spring\boot\mybatis\fixture\SPIBasedDatasourceStandardShardingAlgorithmFixture.java,0,9,1,8,0,18
 shardingsphere-master\shardingsphere-master\examples\shardingsphere-jdbc-example\single-feature-example\shadow-example\shadow-raw-jdbc-example\src\main\java\org\apache\shardingsphere\example\shadow\raw\jdbc\config\BaseShadowConfiguration.java,55,25,0,10,0,35
 shardingsphere-master\shardingsphere-master\shardingsphere-test\shardingsphere-pipeline-test\src\test\java\org\apache\shardingsphere\data\pipeline\core\fixture\FixturePipelineSQLBuilder.java,0,9,1,4,0,14
 shardingsphere-master\shardingsphere-master\shardingsphere-kernel\shardingsphere-data-pipeline\shardingsphere-data-pipeline-spi\src\main\java\org\apache\shardingsphere\data\pipeline\api\config\rulealtered\HandleConfiguration.java,0,27,0,3,0,30
 shardingsphere-master\shardingsphere-master\shardingsphere-test\shardingsphere-parser-test\src\main\java\org\apache\shardingsphere\test\sql\parser\parameterized\jaxb\cases\domain\statement\distsql\ral\scaling\CheckScalingStatementTestCase.java,0,4,0,4,0,8
 shardingsphere-master\shardingsphere-master\shardingsphere-infra\shardingsphere-infra-context\src\main\java\org\apache\shardingsphere\infra\context\refresher\MetaDataRefreshEngine.java,0,18,0,8,0,26
 shardingsphere-master\shardingsphere-master\shardingsphere-features\shardingsphere-readwrite-splitting\shardingsphere-readwrite-splitting-distsql\shardingsphere-readwrite-splitting-distsql-statement\src\main\java\org\apache\shardingsphere\readwritesplitting\distsql\parser\statement\ShowReadwriteSplittingRulesStatement.java,0,3,0,4,0,7
 shardingsphere-master\shardingsphere-master\shardingsphere-features\shardingsphere-sharding\shardingsphere-sharding-distsql\shardingsphere-sharding-distsql-parser\src\main\java\org\apache\shardingsphere\sharding\distsql\parser\core\ShardingDistSQLStatementVisitor.java,0,174,4,220,0,398
 shardingsphere-master\shardingsphere-master\shardingsphere-agent\shardingsphere-agent-plugins\shardingsphere-agent-plugin-metrics\shardingsphere-agent-metrics-api\src\test\java\org\apache\shardingsphere\agent\metrics\api\advice\SQLRouteEngineAdviceTest.java,0,25,1,17,0,43
 shardingsphere-master\shardingsphere-master\shardingsphere-features\shardingsphere-encrypt\shardingsphere-encrypt-core\src\main\java\org\apache\shardingsphere\encrypt\rewrite\condition\EncryptCondition.java,0,14,0,1,0,15
 shardingsphere-master\shardingsphere-master\shardingsphere-features\shardingsphere-shadow\shardingsphere-shadow-core\src\main\java\org\apache\shardingsphere\shadow\algorithm\shadow\hint\SimpleHintShadowAlgorithm.java,0,12,0,7,0,19
 shardingsphere-master\shardingsphere-master\shardingsphere-kernel\shardingsphere-data-pipeline\shardingsphere-data-pipeline-dialect\shardingsphere-data-pipeline-opengauss\src\main\java\org\apache\shardingsphere\data\pipeline\opengauss\check\datasource\OpenGaussDataSourceChecker.java,0,3,0,3,0,6
 shardingsphere-master\shardingsphere-master\shardingsphere-sql-parser\shardingsphere-sql-parser-statement\src\main\java\org\apache\shardingsphere\sql\parser\sql\common\segment\dml\item\ShorthandProjectionSegment.java,0,8,0,4,1,13
 shardingsphere-master\shardingsphere-master\shardingsphere-infra\shardingsphere-infra-executor\src\main\java\org\apache\shardingsphere\infra\executor\kernel\model\ExecutionGroupContext.java,0,9,2,2,0,13
 shardingsphere-master\shardingsphere-master\shardingsphere-features\shardingsphere-sharding\shardingsphere-sharding-core\src\test\java\org\apache\shardingsphere\sharding\rewrite\token\GeneratedKeyInsertColumnTokenGeneratorTest.java,0,8,0,12,0,20
 shardingsphere-master\shardingsphere-master\examples\shardingsphere-jdbc-example\single-feature-example\readwrite-splitting-example\readwrite-splitting-raw-jdbc-example\src\main\java\org\apache\shardingsphere\example\readwrite\splitting\raw\jdbc\factory\YamlDataSourceFactory.java,0,7,1,5,0,13
 shardingsphere-master\shardingsphere-master\shardingsphere-kernel\shardingsphere-data-pipeline\shardingsphere-data-pipeline-core\src\main\java\org\apache\shardingsphere\data\pipeline\core\exception\PipelineJobCreationException.java,0,13,1,3,0,17
 shardingsphere-master\shardingsphere-master\shardingsphere-agent\shardingsphere-agent-plugins\shardingsphere-agent-plugin-tracing\shardingsphere-agent-tracing-jaeger\src\main\java\org\apache\shardingsphere\agent\plugin\tracing\jaeger\advice\SQLParserEngineAdvice.java,0,9,0,7,0,16
 shardingsphere-master\shardingsphere-master\shardingsphere-infra\shardingsphere-infra-federation\shardingsphere-infra-federation-executor\src\main\java\org\apache\shardingsphere\infra\federation\executor\original\FilterableSchema.java,0,12,0,10,0,22
 shardingsphere-master\shardingsphere-master\shardingsphere-test\shardingsphere-pipeline-test\src\test\java\org\apache\shardingsphere\data\pipeline\core\datasource\PipelineDataSourceManagerTest.java,0,16,0,12,0,28
 shardingsphere-master\shardingsphere-master\shardingsphere-sql-parser\shardingsphere-sql-parser-statement\src\main\java\org\apache\shardingsphere\sql\parser\sql\common\segment\tcl\AutoCommitSegment.java,0,7,0,1,0,8
 shardingsphere-master\shardingsphere-master\shardingsphere-test\shardingsphere-integration-agent-test\shardingsphere-integration-agent-test-plugins\shardingsphere-integration-agent-test-common\src\test\java\org\apache\shardingsphere\integration\agent\test\common\entity\OrderEntity.java,0,5,0,1,0,6
 shardingsphere-master\shardingsphere-master\shardingsphere-features\shardingsphere-sharding\shardingsphere-sharding-core\src\test\java\org\apache\shardingsphere\sharding\merge\dql\groupby\GroupByRowComparatorTest.java,0,129,1,105,0,235
 shardingsphere-master\shardingsphere-master\shardingsphere-test\shardingsphere-parser-test\src\main\java\org\apache\shardingsphere\test\sql\parser\parameterized\jaxb\cases\domain\statement\ddl\CreateIndexStatementTestCase.java,0,4,0,5,0,9
 shardingsphere-master\shardingsphere-master\shardingsphere-features\shardingsphere-sharding\shardingsphere-sharding-core\src\test\java\org\apache\shardingsphere\sharding\route\engine\type\complex\ShardingComplexRoutingEngineTest.java,0,28,1,20,0,49
 shardingsphere-master\shardingsphere-master\shardingsphere-test\shardingsphere-integration-test\shardingsphere-integration-test-suite\src\test\java\org\apache\shardingsphere\test\integration\framework\container\atomic\storage\EmbeddedStorageContainer.java,0,24,0,12,0,36
 shardingsphere-master\shardingsphere-master\shardingsphere-infra\shardingsphere-infra-common\src\main\java\org\apache\shardingsphere\infra\datasource\pool\destroyer\detector\DataSourcePoolActiveDetectorFactory.java,0,8,1,5,0,14
 shardingsphere-master\shardingsphere-master\shardingsphere-sql-parser\shardingsphere-sql-parser-statement\src\main\java\org\apache\shardingsphere\sql\parser\sql\common\segment\dml\expr\complex\ComplexExpressionSegment.java,0,0,0,3,0,3
 shardingsphere-master\shardingsphere-master\shardingsphere-test\shardingsphere-parser-test\src\main\java\org\apache\shardingsphere\test\sql\parser\parameterized\jaxb\cases\SQLParserTestCasesRegistry.java,0,29,0,20,0,49
 shardingsphere-master\shardingsphere-master\shardingsphere-infra\shardingsphere-infra-common\src\main\java\org\apache\shardingsphere\infra\database\type\dialect\SQLServerDatabaseType.java,0,8,0,3,0,11
 shardingsphere-master\shardingsphere-master\shardingsphere-db-protocol\shardingsphere-db-protocol-mysql\src\main\java\org\apache\shardingsphere\db\protocol\mysql\packet\binlog\row\column\value\MySQLBinlogProtocolValue.java,0,6,0,7,0,13
 shardingsphere-master\shardingsphere-master\shardingsphere-proxy\shardingsphere-proxy-backend\src\main\java\org\apache\shardingsphere\proxy\backend\text\admin\mysql\executor\ShowTransactionExecutor.java,0,17,1,12,0,30
 shardingsphere-master\shardingsphere-master\shardingsphere-infra\shardingsphere-infra-binder\src\test\java\org\apache\shardingsphere\infra\binder\statement\dcl\GrantStatementContextTest.java,0,9,0,15,0,24
 shardingsphere-master\shardingsphere-master\shardingsphere-sql-parser\shardingsphere-sql-parser-dialect\shardingsphere-sql-parser-sqlserver\src\test\java\org\apache\shardingsphere\sql\parser\sqlserver\SQLServerParserParameterizedTest.java,0,7,0,5,0,12
 shardingsphere-master\shardingsphere-master\shardingsphere-kernel\shardingsphere-transaction\shardingsphere-transaction-core\src\main\java\org\apache\shardingsphere\transaction\context\TransactionContexts.java,0,6,0,2,0,8
 shardingsphere-master\shardingsphere-master\shardingsphere-test\shardingsphere-test-common\src\main\java\org\apache\shardingsphere\test\mock\MockedDataSource.java,0,44,2,4,7,57
 shardingsphere-master\shardingsphere-master\shardingsphere-infra\shardingsphere-infra-binder\src\main\java\org\apache\shardingsphere\infra\binder\statement\SQLStatementContext.java,0,6,0,1,0,7
 shardingsphere-master\shardingsphere-master\shardingsphere-sql-parser\shardingsphere-sql-parser-statement\src\main\java\org\apache\shardingsphere\sql\parser\sql\dialect\statement\mysql\rl\MySQLStartSlaveStatement.java,0,1,0,4,0,5
 shardingsphere-master\shardingsphere-master\shardingsphere-kernel\shardingsphere-data-pipeline\shardingsphere-data-pipeline-dialect\shardingsphere-data-pipeline-mysql\src\test\java\org\apache\shardingsphere\data\pipeline\mysql\check\consistency\CRC32MatchMySQLSingleTableDataCalculatorTest.java,0,34,1,26,0,61
 shardingsphere-master\shardingsphere-master\shardingsphere-spi\src\test\java\org\apache\shardingsphere\spi\fixture\required\RequiredSPIFixtureDefaultTrueImpl.java,0,2,0,2,0,4
 shardingsphere-master\shardingsphere-master\shardingsphere-features\shardingsphere-sharding\shardingsphere-sharding-core\src\main\java\org\apache\shardingsphere\sharding\merge\dql\groupby\aggregation\AggregationUnit.java,0,4,0,1,0,5
 shardingsphere-master\shardingsphere-master\shardingsphere-sql-parser\shardingsphere-sql-parser-statement\src\main\java\org\apache\shardingsphere\sql\parser\sql\common\segment\dml\predicate\AndPredicate.java,0,7,2,2,3,14
 shardingsphere-master\shardingsphere-master\shardingsphere-sql-parser\shardingsphere-sql-parser-statement\src\main\java\org\apache\shardingsphere\sql\parser\sql\dialect\statement\postgresql\dcl\PostgreSQLDropRoleStatement.java,0,1,0,5,0,6
 shardingsphere-master\shardingsphere-master\shardingsphere-features\shardingsphere-sharding\shardingsphere-sharding-core\src\test\java\org\apache\shardingsphere\sharding\route\engine\type\standard\AbstractSQLRouteTest.java,40,36,0,26,0,62
 shardingsphere-master\shardingsphere-master\shardingsphere-proxy\shardingsphere-proxy-backend\src\test\java\org\apache\shardingsphere\proxy\backend\text\distsql\rdl\rule\CreateDefaultSingleTableRuleUpdaterTest.java,0,31,0,19,0,50
 shardingsphere-master\shardingsphere-master\shardingsphere-test\shardingsphere-parser-test\src\main\java\org\apache\shardingsphere\test\sql\parser\parameterized\asserts\statement\distsql\ral\impl\common\updatable\RefreshTableMetadataStatementAssert.java,0,8,1,11,0,20
 shardingsphere-master\shardingsphere-master\shardingsphere-sql-parser\shardingsphere-sql-parser-statement\src\main\java\org\apache\shardingsphere\sql\parser\sql\dialect\statement\oracle\dcl\OracleSetRoleStatement.java,0,1,0,4,0,5
 shardingsphere-master\shardingsphere-master\shardingsphere-features\shardingsphere-sharding\shardingsphere-sharding-distsql\shardingsphere-sharding-distsql-handler\src\main\java\org\apache\shardingsphere\scaling\distsql\handler\ResetScalingUpdater.java,0,6,0,4,0,10
 shardingsphere-master\shardingsphere-master\shardingsphere-sql-parser\shardingsphere-sql-parser-dialect\shardingsphere-sql-parser-postgresql\src\main\java\org\apache\shardingsphere\sql\parser\postgresql\visitor\statement\impl\PostgreSQLDCLStatementSQLVisitor.java,0,19,0,29,0,48
 shardingsphere-master\shardingsphere-master\shardingsphere-infra\shardingsphere-infra-common\src\main\java\org\apache\shardingsphere\infra\datanode\DataNodeUtil.java,0,8,0,5,0,13
 shardingsphere-master\shardingsphere-master\shardingsphere-sql-parser\shardingsphere-sql-parser-dialect\shardingsphere-sql-parser-sqlserver\src\main\java\org\apache\shardingsphere\sql\parser\sqlserver\parser\SQLServerParser.java,0,5,0,3,0,8
 shardingsphere-master\shardingsphere-master\shardingsphere-db-protocol\shardingsphere-db-protocol-mysql\src\main\java\org\apache\shardingsphere\db\protocol\mysql\packet\command\MySQLCommandPacketFactory.java,0,3,0,13,0,16
 shardingsphere-master\shardingsphere-master\shardingsphere-infra\shardingsphere-infra-common\src\test\java\org\apache\shardingsphere\infra\datasource\props\synonym\PoolPropertySynonymsTest.java,0,60,0,13,0,73
 shardingsphere-master\shardingsphere-master\shardingsphere-test\shardingsphere-parser-test\src\main\java\org\apache\shardingsphere\test\sql\parser\parameterized\asserts\statement\distsql\rdl\drop\impl\DropDatabaseDiscoveryTypeStatementAssert.java,0,8,0,11,0,19
 shardingsphere-master\shardingsphere-master\shardingsphere-jdbc\shardingsphere-jdbc-spring\shardingsphere-jdbc-core-spring\shardingsphere-jdbc-core-spring-namespace\src\main\java\org\apache\shardingsphere\spring\namespace\tag\mode\ClusterPersistRepositoryBeanDefinitionTag.java,0,12,0,1,0,13
 shardingsphere-master\shardingsphere-master\shardingsphere-test\shardingsphere-parser-test\src\main\java\org\apache\shardingsphere\test\sql\parser\parameterized\jaxb\cases\domain\statement\distsql\ral\AddShardingHintDatabaseValueStatementTestCase.java,0,2,0,4,0,6
 shardingsphere-master\shardingsphere-master\shardingsphere-features\shardingsphere-sharding\shardingsphere-sharding-core\src\test\java\org\apache\shardingsphere\sharding\route\engine\type\broadcast\ShardingTableBroadcastRoutingEngineTest.java,0,56,0,45,0,101
 shardingsphere-master\shardingsphere-master\shardingsphere-infra\shardingsphere-infra-context\src\main\java\org\apache\shardingsphere\infra\context\refresher\MetaDataRefresher.java,0,5,0,5,0,10
 shardingsphere-master\shardingsphere-master\shardingsphere-features\shardingsphere-shadow\shardingsphere-shadow-core\src\main\java\org\apache\shardingsphere\shadow\route\engine\determiner\ColumnShadowAlgorithmDeterminer.java,0,13,0,11,0,24
 shardingsphere-master\shardingsphere-master\shardingsphere-infra\shardingsphere-infra-merge\src\test\java\org\apache\shardingsphere\infra\merge\fixture\merger\ResultMergerEngineFixture.java,0,8,0,4,0,12
 shardingsphere-master\shardingsphere-master\shardingsphere-mode\shardingsphere-mode-type\shardingsphere-cluster-mode\shardingsphere-cluster-mode-core\src\main\java\org\apache\shardingsphere\mode\manager\cluster\coordinator\lock\event\GlobalAckLockedEvent.java,0,5,0,2,0,7
 shardingsphere-master\shardingsphere-master\shardingsphere-test\shardingsphere-parser-test\src\main\java\org\apache\shardingsphere\test\sql\parser\parameterized\asserts\statement\dal\impl\ShowVariablesStatementAssert.java,0,5,0,9,0,14
 shardingsphere-master\shardingsphere-master\shardingsphere-features\shardingsphere-readwrite-splitting\shardingsphere-readwrite-splitting-api\src\main\java\org\apache\shardingsphere\readwritesplitting\api\rule\ReadwriteSplittingDataSourceRuleConfiguration.java,0,13,0,2,0,15
 shardingsphere-master\shardingsphere-master\shardingsphere-infra\shardingsphere-infra-common\src\main\java\org\apache\shardingsphere\infra\config\schema\impl\DataSourceGeneratedSchemaConfiguration.java,0,17,0,10,0,27
 shardingsphere-master\shardingsphere-master\shardingsphere-spi\src\test\java\org\apache\shardingsphere\spi\fixture\ordered\OrderedSPIFixtureImpl.java,0,4,0,2,0,6
 shardingsphere-master\shardingsphere-master\shardingsphere-kernel\shardingsphere-data-pipeline\shardingsphere-data-pipeline-core\src\main\java\org\apache\shardingsphere\data\pipeline\scenario\rulealtered\RuleAlteredJobContext.java,0,41,0,15,0,56
 shardingsphere-master\shardingsphere-master\shardingsphere-sql-parser\shardingsphere-sql-parser-statement\src\main\java\org\apache\shardingsphere\sql\parser\sql\dialect\statement\sqlserver\ddl\SQLServerDropServiceStatement.java,0,1,0,6,0,7
 shardingsphere-master\shardingsphere-master\shardingsphere-test\shardingsphere-parser-test\src\main\java\org\apache\shardingsphere\test\sql\parser\parameterized\jaxb\cases\domain\statement\distsql\rdl\alter\AlterReadwriteSplittingRuleStatementTestCase.java,0,4,0,6,0,10
 shardingsphere-master\shardingsphere-master\shardingsphere-agent\shardingsphere-agent-plugins\shardingsphere-agent-plugin-tracing\shardingsphere-agent-tracing-jaeger\src\main\java\org\apache\shardingsphere\agent\plugin\tracing\jaeger\span\JaegerErrorSpan.java,0,9,0,5,0,14
 shardingsphere-master\shardingsphere-master\shardingsphere-kernel\shardingsphere-traffic\shardingsphere-traffic-core\src\main\java\org\apache\shardingsphere\traffic\algorithm\loadbalance\RandomTrafficLoadBalanceAlgorithm.java,0,6,0,4,0,10
 shardingsphere-master\shardingsphere-master\shardingsphere-sql-parser\shardingsphere-sql-parser-spi\src\main\java\org\apache\shardingsphere\sql\parser\api\visitor\operation\SQLFormatVisitor.java,0,1,0,1,0,2
 shardingsphere-master\shardingsphere-master\examples\example-core\example-spring-jpa\src\main\java\org\apache\shardingsphere\example\core\jpa\service\AccountServiceImpl.java,62,22,2,8,0,32
 shardingsphere-master\shardingsphere-master\shardingsphere-test\shardingsphere-parser-test\src\main\java\org\apache\shardingsphere\test\sql\parser\parameterized\asserts\segment\distsql\PropertiesAssert.java,0,6,0,9,0,15
 shardingsphere-master\shardingsphere-master\shardingsphere-proxy\shardingsphere-proxy-frontend\shardingsphere-proxy-frontend-reactive-core\src\test\java\org\apache\shardingsphere\proxy\frontend\reactive\protocol\fixture\DummyDatabaseType.java,0,9,1,2,0,12
 shardingsphere-master\shardingsphere-master\shardingsphere-sql-parser\shardingsphere-sql-parser-statement\src\main\java\org\apache\shardingsphere\sql\parser\sql\dialect\statement\mysql\tcl\MySQLXAStatement.java,0,1,0,4,0,5
 shardingsphere-master\shardingsphere-master\shardingsphere-infra\shardingsphere-infra-rewrite\src\main\java\org\apache\shardingsphere\infra\rewrite\sql\token\generator\CollectionSQLTokenGenerator.java,0,5,0,2,0,7
 shardingsphere-master\shardingsphere-master\shardingsphere-sql-parser\shardingsphere-sql-parser-statement\src\main\java\org\apache\shardingsphere\sql\parser\sql\dialect\statement\mysql\dml\MySQLCallStatement.java,0,6,0,5,2,13
 shardingsphere-master\shardingsphere-master\shardingsphere-sql-parser\shardingsphere-sql-parser-statement\src\main\java\org\apache\shardingsphere\sql\parser\sql\common\statement\dcl\DropRoleStatement.java,3,1,1,3,0,5
 shardingsphere-master\shardingsphere-master\shardingsphere-kernel\shardingsphere-data-pipeline\shardingsphere-data-pipeline-core\src\main\java\org\apache\shardingsphere\data\pipeline\core\lock\PipelineSimpleLock.java,0,17,2,9,0,28
 shardingsphere-master\shardingsphere-master\shardingsphere-features\shardingsphere-sharding\shardingsphere-sharding-core\src\test\java\org\apache\shardingsphere\sharding\fixture\HintShardingAlgorithmFixture.java,0,6,2,5,0,13
 shardingsphere-master\shardingsphere-master\shardingsphere-features\shardingsphere-shadow\shardingsphere-shadow-api\src\main\java\org\apache\shardingsphere\shadow\api\shadow\ShadowValue.java,0,0,0,1,0,1
 shardingsphere-master\shardingsphere-master\shardingsphere-test\shardingsphere-parser-test\src\main\java\org\apache\shardingsphere\test\sql\parser\parameterized\jaxb\cases\domain\statement\distsql\rql\ShowRulesUsedResourceStatementTestCase.java,0,5,0,5,0,10
 shardingsphere-master\shardingsphere-master\shardingsphere-infra\shardingsphere-infra-route\src\test\java\org\apache\shardingsphere\infra\route\fixture\router\SQLRouterFailureFixture.java,0,8,0,5,0,13
 shardingsphere-master\shardingsphere-master\shardingsphere-sql-parser\shardingsphere-sql-parser-statement\src\main\java\org\apache\shardingsphere\sql\parser\sql\dialect\statement\postgresql\ddl\PostgreSQLDropEventTriggerStatement.java,0,1,0,5,0,6
 shardingsphere-master\shardingsphere-master\shardingsphere-features\shardingsphere-sharding\shardingsphere-sharding-distsql\shardingsphere-sharding-distsql-statement\src\main\java\org\apache\shardingsphere\sharding\distsql\parser\statement\DropShardingAlgorithmStatement.java,0,2,0,2,0,4
 shardingsphere-master\shardingsphere-master\shardingsphere-test\shardingsphere-parser-test\src\main\java\org\apache\shardingsphere\test\sql\parser\parameterized\jaxb\cases\domain\statement\ddl\DropFunctionStatementTestCase.java,0,0,0,3,0,3
 shardingsphere-master\shardingsphere-master\shardingsphere-features\shardingsphere-db-discovery\shardingsphere-db-discovery-provider\shardingsphere-db-discovery-opengauss\src\main\java\org\apache\shardingsphere\dbdiscovery\opengauss\OpenGaussDatabaseDiscoveryType.java,0,26,5,15,0,46
 shardingsphere-master\shardingsphere-master\shardingsphere-sql-parser\shardingsphere-sql-parser-statement\src\main\java\org\apache\shardingsphere\sql\parser\sql\common\statement\tcl\SetAutoCommitStatement.java,5,2,1,3,0,6
 shardingsphere-master\shardingsphere-master\shardingsphere-sql-parser\shardingsphere-sql-parser-statement\src\main\java\org\apache\shardingsphere\sql\parser\sql\dialect\statement\mysql\segment\PartitionSegment.java,0,6,0,3,0,9
 shardingsphere-master\shardingsphere-master\shardingsphere-features\shardingsphere-readwrite-splitting\shardingsphere-readwrite-splitting-distsql\shardingsphere-readwrite-splitting-distsql-handler\src\test\java\org\apache\shardingsphere\readwritesplitting\distsql\handler\converter\ReadwriteSplittingRuleStatementConverterTest.java,0,59,0,54,0,113
 shardingsphere-master\shardingsphere-master\shardingsphere-sql-parser\shardingsphere-sql-parser-statement\src\main\java\org\apache\shardingsphere\sql\parser\sql\dialect\statement\opengauss\tcl\OpenGaussSavepointStatement.java,0,1,0,5,0,6
 shardingsphere-master\shardingsphere-master\shardingsphere-sql-parser\shardingsphere-sql-parser-dialect\shardingsphere-sql-parser-mysql\src\main\java\org\apache\shardingsphere\sql\parser\mysql\visitor\format\impl\MySQLDMLFormatSQLVisitor.java,0,3,0,3,0,6
 shardingsphere-master\shardingsphere-master\examples\shardingsphere-jdbc-example\single-feature-example\readwrite-splitting-example\readwrite-splitting-raw-jdbc-example\src\main\java\org\apache\shardingsphere\example\readwrite\splitting\raw\jdbc\ReadwriteSplittingHintRawExample.java,0,20,1,10,0,31
 shardingsphere-master\shardingsphere-master\examples\shardingsphere-example-generator\src\main\java\org\apache\shardingsphere\example\generator\scenario\feature\type\ShadowExampleScenario.java,0,5,0,2,0,7
 shardingsphere-master\shardingsphere-master\examples\example-core\config-utility\src\main\java\org\apache\shardingsphere\example\type\ShardingType.java,0,25,0,1,0,26
 shardingsphere-master\shardingsphere-master\shardingsphere-proxy\shardingsphere-proxy-backend\src\main\java\org\apache\shardingsphere\proxy\backend\text\distsql\ral\QueryableRALBackendHandler.java,0,26,0,14,0,40
 shardingsphere-master\shardingsphere-master\shardingsphere-mode\shardingsphere-mode-type\shardingsphere-cluster-mode\shardingsphere-cluster-mode-core\src\main\java\org\apache\shardingsphere\mode\manager\cluster\coordinator\registry\status\compute\event\ComputeNodeStatusChangedEvent.java,0,7,0,3,0,10
 shardingsphere-master\shardingsphere-master\shardingsphere-spi\src\test\java\org\apache\shardingsphere\spi\fixture\singleton\SingletonSPIFixtureImpl.java,0,1,0,1,0,2
 shardingsphere-master\shardingsphere-master\examples\example-core\example-spring-mybatis\src\main\java\org\apache\shardingsphere\example\core\mybatis\repository\MybatisAddressRepository.java,0,1,0,1,0,2
 shardingsphere-master\shardingsphere-master\shardingsphere-features\shardingsphere-sharding\shardingsphere-sharding-core\src\main\java\org\apache\shardingsphere\sharding\route\engine\validator\dml\impl\ShardingDeleteStatementValidator.java,0,12,0,11,0,23
 shardingsphere-master\shardingsphere-master\shardingsphere-infra\shardingsphere-infra-federation\shardingsphere-infra-federation-optimizer\src\main\java\org\apache\shardingsphere\infra\federation\optimizer\converter\segment\limit\PaginationValueSQLConverter.java,0,18,0,19,0,37
 shardingsphere-master\shardingsphere-master\shardingsphere-sql-parser\shardingsphere-sql-parser-statement\src\main\java\org\apache\shardingsphere\sql\parser\sql\common\segment\ddl\index\DropIndexDefinitionSegment.java,0,5,0,3,2,10
 shardingsphere-master\shardingsphere-master\shardingsphere-proxy\shardingsphere-proxy-backend\src\main\java\org\apache\shardingsphere\proxy\backend\communication\jdbc\recognizer\impl\SQLServerRecognizer.java,0,3,0,3,0,6
 shardingsphere-master\shardingsphere-master\shardingsphere-test\shardingsphere-pipeline-test\src\test\java\org\apache\shardingsphere\data\pipeline\core\importer\AbstractImporterTest.java,0,83,0,32,0,115
 shardingsphere-master\shardingsphere-master\shardingsphere-features\shardingsphere-sharding\shardingsphere-sharding-distsql\shardingsphere-sharding-distsql-handler\src\test\java\org\apache\shardingsphere\scaling\distsql\handler\CreateShardingScalingRuleStatementUpdaterTest.java,0,97,0,64,0,161
 shardingsphere-master\shardingsphere-master\shardingsphere-infra\shardingsphere-infra-binder\src\test\java\org\apache\shardingsphere\infra\binder\segment\select\projection\engine\ProjectionEngineTest.java,0,70,0,59,0,129
 shardingsphere-master\shardingsphere-master\shardingsphere-db-protocol\shardingsphere-db-protocol-mysql\src\test\java\org\apache\shardingsphere\db\protocol\mysql\packet\command\query\binary\execute\protocol\MySQLDoubleBinaryProtocolValueTest.java,0,8,0,4,0,12
 shardingsphere-master\shardingsphere-master\shardingsphere-infra\shardingsphere-infra-datetime\shardingsphere-infra-datetime-spi\src\main\java\org\apache\shardingsphere\infra\datetime\DatetimeService.java,0,3,0,1,0,4
 shardingsphere-master\shardingsphere-master\shardingsphere-features\shardingsphere-sharding\shardingsphere-sharding-core\src\main\java\org\apache\shardingsphere\sharding\route\engine\validator\ShardingStatementValidator.java,0,9,0,4,0,13
 shardingsphere-master\shardingsphere-master\shardingsphere-db-protocol\shardingsphere-db-protocol-mysql\src\test\java\org\apache\shardingsphere\db\protocol\mysql\packet\handshake\MySQLHandshakePacketTest.java,0,68,0,41,0,109
 shardingsphere-master\shardingsphere-master\shardingsphere-jdbc\shardingsphere-jdbc-core\src\main\java\org\apache\shardingsphere\driver\state\lock\LockDriverState.java,0,4,0,2,0,6
 shardingsphere-master\shardingsphere-master\shardingsphere-test\shardingsphere-parser-test\src\main\java\org\apache\shardingsphere\test\sql\parser\parameterized\asserts\statement\dcl\impl\sqlserver\SQLServerSetUserStatementAssert.java,0,6,0,10,0,16
 shardingsphere-master\shardingsphere-master\shardingsphere-db-protocol\shardingsphere-db-protocol-mysql\src\test\java\org\apache\shardingsphere\db\protocol\mysql\packet\binlog\row\column\value\time\MySQLYearBinlogProtocolValueTest.java,0,10,0,5,0,15
 shardingsphere-master\shardingsphere-master\shardingsphere-kernel\shardingsphere-data-pipeline\shardingsphere-data-pipeline-core\src\main\java\org\apache\shardingsphere\data\pipeline\core\prepare\datasource\PrepareTargetTablesParameter.java,0,6,0,3,0,9
 shardingsphere-master\shardingsphere-master\shardingsphere-test\shardingsphere-parser-test\src\main\java\org\apache\shardingsphere\test\sql\parser\parameterized\jaxb\cases\domain\statement\dal\CloneStatementTestCase.java,0,4,0,5,0,9
 shardingsphere-master\shardingsphere-master\shardingsphere-infra\shardingsphere-infra-common\src\main\java\org\apache\shardingsphere\infra\database\metadata\dialect\H2DataSourceMetaData.java,0,40,0,15,0,55
 shardingsphere-master\shardingsphere-master\shardingsphere-jdbc\shardingsphere-jdbc-spring\shardingsphere-jdbc-spring-infra\shardingsphere-jdbc-spring-boot-starter-infra\src\main\java\org\apache\shardingsphere\spring\boot\converter\StringToNoneShardingStrategyConfigurationConverter.java,0,3,0,4,0,7
 shardingsphere-master\shardingsphere-master\shardingsphere-infra\shardingsphere-infra-executor\src\main\java\org\apache\shardingsphere\infra\executor\sql\context\ExecutionContextBuilder.java,0,23,0,18,0,41
 shardingsphere-master\shardingsphere-master\examples\shardingsphere-jdbc-example\single-feature-example\sharding-example\sharding-raw-jdbc-example\src\main\java\org\apache\shardingsphere\example\sharding\raw\jdbc\ShardingRawJavaRangeConfigurationExample.java,0,10,1,10,0,21
 shardingsphere-master\shardingsphere-master\examples\shardingsphere-jdbc-example\single-feature-example\sharding-example\sharding-raw-jdbc-example\src\main\java\org\apache\shardingsphere\example\sharding\raw\jdbc\config\ShardingTablesConfigurationPrecise.java,0,16,0,16,0,32
 shardingsphere-master\shardingsphere-master\examples\shardingsphere-jdbc-example\single-feature-example\sharding-example\sharding-raw-jdbc-example\src\main\java\org\apache\shardingsphere\example\sharding\raw\jdbc\factory\YamlRangeDataSourceFactory.java,0,9,1,7,0,17
 shardingsphere-master\shardingsphere-master\shardingsphere-test\shardingsphere-parser-test\src\main\java\org\apache\shardingsphere\test\sql\parser\parameterized\jaxb\cases\domain\statement\dal\ShowProcedureStatusStatementTestCase.java,0,3,0,5,0,8
 shardingsphere-master\shardingsphere-master\shardingsphere-sql-parser\shardingsphere-sql-parser-statement\src\main\java\org\apache\shardingsphere\sql\parser\sql\dialect\statement\mysql\dal\MySQLShowCreateFunctionStatement.java,0,3,0,5,0,8
 shardingsphere-master\shardingsphere-master\shardingsphere-infra\shardingsphere-infra-executor\src\main\java\org\apache\shardingsphere\infra\executor\sql\process\model\ExecuteProcessConstants.java,0,5,0,1,0,6
 shardingsphere-master\shardingsphere-master\shardingsphere-kernel\shardingsphere-authority\shardingsphere-authority-core\src\main\java\org\apache\shardingsphere\authority\provider\simple\AllPrivilegesPermittedAuthorityProviderAlgorithm.java,0,20,3,9,0,32
 shardingsphere-master\shardingsphere-master\shardingsphere-test\shardingsphere-parser-test\src\main\java\org\apache\shardingsphere\test\sql\parser\parameterized\asserts\statement\distsql\rql\impl\rule\ShowUnusedShardingAlgorithmsStatementAssert.java,0,8,0,12,0,20
 shardingsphere-master\shardingsphere-master\shardingsphere-infra\shardingsphere-infra-common\src\test\java\org\apache\shardingsphere\infra\datasource\pool\destroyer\detector\type\HikariDataSourcePoolActiveDetectorTest.java,0,10,0,4,0,14
 shardingsphere-master\shardingsphere-master\shardingsphere-infra\shardingsphere-infra-federation\shardingsphere-infra-federation-optimizer\src\main\java\org\apache\shardingsphere\infra\federation\optimizer\converter\segment\expression\ExpressionConverter.java,0,34,0,54,0,88
 shardingsphere-master\shardingsphere-master\shardingsphere-test\shardingsphere-parser-test\src\main\java\org\apache\shardingsphere\test\sql\parser\parameterized\jaxb\cases\domain\statement\tcl\RollbackStatementTestCase.java,0,1,0,3,0,4
 shardingsphere-master\shardingsphere-master\shardingsphere-features\shardingsphere-sharding\shardingsphere-sharding-core\src\main\java\org\apache\shardingsphere\sharding\rewrite\token\generator\impl\keygen\GeneratedKeyInsertColumnTokenGenerator.java,0,11,0,14,0,25
 shardingsphere-master\shardingsphere-master\shardingsphere-sql-parser\shardingsphere-sql-parser-statement\src\main\java\org\apache\shardingsphere\sql\parser\sql\dialect\statement\sqlserver\ddl\SQLServerCreateDatabaseStatement.java,0,1,0,5,0,6
 shardingsphere-master\shardingsphere-master\shardingsphere-proxy\shardingsphere-proxy-backend\src\main\java\org\apache\shardingsphere\proxy\backend\communication\jdbc\executor\ProxyJDBCExecutor.java,0,19,0,16,0,35
 shardingsphere-master\shardingsphere-master\shardingsphere-features\shardingsphere-readwrite-splitting\shardingsphere-readwrite-splitting-spring\shardingsphere-readwrite-splitting-spring-namespace\src\main\java\org\apache\shardingsphere\readwritesplitting\spring\namespace\parser\ReadwriteSplittingRuleBeanDefinitionParser.java,0,22,0,23,0,45
 shardingsphere-master\shardingsphere-master\shardingsphere-kernel\shardingsphere-transaction\shardingsphere-transaction-core\src\main\java\org\apache\shardingsphere\transaction\yaml\config\YamlTransactionRuleConfiguration.java,0,9,0,3,0,12
 shardingsphere-master\shardingsphere-master\shardingsphere-features\shardingsphere-readwrite-splitting\shardingsphere-readwrite-splitting-distsql\shardingsphere-readwrite-splitting-distsql-parser\src\main\java\org\apache\shardingsphere\readwritesplitting\distsql\parser\core\ReadwriteSplittingDistSQLLexer.java,0,4,0,3,0,7
 shardingsphere-master\shardingsphere-master\shardingsphere-test\shardingsphere-integration-test\shardingsphere-integration-test-suite\src\test\java\org\apache\shardingsphere\test\integration\cases\IntegrationTestCaseContext.java,0,5,0,2,0,7
 shardingsphere-master\shardingsphere-master\shardingsphere-kernel\shardingsphere-traffic\shardingsphere-traffic-core\src\main\java\org\apache\shardingsphere\traffic\constant\TrafficOrder.java,0,3,0,1,0,4
 shardingsphere-master\shardingsphere-master\shardingsphere-test\shardingsphere-parser-test\src\main\java\org\apache\shardingsphere\test\sql\parser\parameterized\loader\TestCaseFileLoader.java,0,11,0,5,0,16
 shardingsphere-master\shardingsphere-master\shardingsphere-distsql\shardingsphere-distsql-statement\src\main\java\org\apache\shardingsphere\distsql\parser\statement\ral\common\updatable\ImportSchemaConfigurationStatement.java,0,3,0,3,0,6
 shardingsphere-master\shardingsphere-master\shardingsphere-sql-parser\shardingsphere-sql-parser-statement\src\main\java\org\apache\shardingsphere\sql\parser\sql\dialect\statement\opengauss\dcl\OpenGaussDropUserStatement.java,0,1,0,5,0,6
 shardingsphere-master\shardingsphere-master\shardingsphere-features\shardingsphere-sharding\shardingsphere-sharding-core\src\test\java\org\apache\shardingsphere\sharding\merge\dql\groupby\aggregation\AggregationUnitFactoryTest.java,0,23,0,10,0,33
 shardingsphere-master\shardingsphere-master\shardingsphere-test\shardingsphere-parser-test\src\main\java\org\apache\shardingsphere\test\sql\parser\parameterized\jaxb\cases\domain\statement\tcl\CommitStatementTestCase.java,0,0,0,3,0,3
 shardingsphere-master\shardingsphere-master\shardingsphere-mode\shardingsphere-mode-core\src\test\java\org\apache\shardingsphere\mode\metadata\persist\node\ComputeNodeTest.java,0,38,0,16,0,54
 shardingsphere-master\shardingsphere-master\examples\shardingsphere-jdbc-example\single-feature-example\transaction-example\transaction-2pc-xa-atomikos-raw-jdbc-example\src\test\java\org\apache\shardingsphere\example\transaction\xa\atomikos\raw\jdbc\XAOrderServiceTest.java,0,13,1,2,0,16
 shardingsphere-master\shardingsphere-master\shardingsphere-agent\shardingsphere-agent-api\src\main\java\org\apache\shardingsphere\agent\api\point\ClassStaticMethodPoint.java,0,7,0,1,0,8
 shardingsphere-master\shardingsphere-master\shardingsphere-sql-parser\shardingsphere-sql-parser-statement\src\main\java\org\apache\shardingsphere\sql\parser\sql\dialect\statement\opengauss\ddl\OpenGaussAlterExtensionStatement.java,0,1,0,5,0,6
 shardingsphere-master\shardingsphere-master\shardingsphere-test\shardingsphere-parser-test\src\main\java\org\apache\shardingsphere\test\sql\parser\parameterized\jaxb\sql\SQLCases.java,0,4,0,1,0,5
 shardingsphere-master\shardingsphere-master\shardingsphere-infra\shardingsphere-infra-common\src\main\java\org\apache\shardingsphere\infra\datasource\props\synonym\ConnectionPropertySynonyms.java,0,8,0,3,0,11
 shardingsphere-master\shardingsphere-master\shardingsphere-sql-parser\shardingsphere-sql-parser-statement\src\main\java\org\apache\shardingsphere\sql\parser\sql\common\statement\ddl\CreateProcedureStatement.java,3,1,1,3,0,5
 shardingsphere-master\shardingsphere-master\shardingsphere-infra\shardingsphere-infra-merge\src\main\java\org\apache\shardingsphere\infra\merge\result\MergedResult.java,0,10,0,3,0,13
 shardingsphere-master\shardingsphere-master\shardingsphere-features\shardingsphere-sharding\shardingsphere-sharding-spring\shardingsphere-sharding-spring-namespace\src\main\java\org\apache\shardingsphere\sharding\spring\namespace\handler\ShardingNamespaceHandler.java,0,10,0,20,0,30
 shardingsphere-master\shardingsphere-master\shardingsphere-agent\shardingsphere-agent-plugins\shardingsphere-agent-plugin-metrics\shardingsphere-agent-metrics-prometheus\src\main\java\org\apache\shardingsphere\agent\metrics\prometheus\service\PrometheusPluginBootService.java,0,16,1,12,0,29
 shardingsphere-master\shardingsphere-master\shardingsphere-sql-parser\shardingsphere-sql-parser-statement\src\main\java\org\apache\shardingsphere\sql\parser\sql\common\statement\ddl\DropOperatorStatement.java,3,1,1,3,0,5
 shardingsphere-master\shardingsphere-master\shardingsphere-proxy\shardingsphere-proxy-backend\src\main\java\org\apache\shardingsphere\proxy\backend\text\distsql\ral\common\updatable\ApplyDistSQLHandler.java,0,3,0,6,0,9
 shardingsphere-master\shardingsphere-master\shardingsphere-kernel\shardingsphere-transaction\shardingsphere-transaction-type\shardingsphere-transaction-xa\shardingsphere-transaction-xa-core\src\main\java\org\apache\shardingsphere\transaction\xa\jta\datasource\XADataSourceFactory.java,0,5,0,5,0,10
 shardingsphere-master\shardingsphere-master\shardingsphere-sql-parser\shardingsphere-sql-parser-dialect\shardingsphere-sql-parser-sql92\src\main\java\org\apache\shardingsphere\sql\parser\sql92\visitor\statement\impl\SQL92DCLStatementSQLVisitor.java,0,10,0,13,0,23
 shardingsphere-master\shardingsphere-master\shardingsphere-jdbc\shardingsphere-jdbc-core\src\main\java\org\apache\shardingsphere\driver\jdbc\unsupported\AbstractUnsupportedDatabaseMetaDataResultSet.java,128,48,0,23,0,71
 shardingsphere-master\shardingsphere-master\shardingsphere-kernel\shardingsphere-data-pipeline\shardingsphere-data-pipeline-core\src\main\java\org\apache\shardingsphere\data\pipeline\core\api\impl\GovernanceRepositoryAPIImpl.java,0,46,0,35,0,81
 shardingsphere-master\shardingsphere-master\shardingsphere-infra\shardingsphere-infra-binder\src\test\java\org\apache\shardingsphere\infra\binder\segment\insert\values\OnDuplicateUpdateContextTest.java,0,61,2,48,0,111
 shardingsphere-master\shardingsphere-master\shardingsphere-test\shardingsphere-parser-test\src\main\java\org\apache\shardingsphere\test\sql\parser\parameterized\jaxb\cases\domain\statement\distsql\rdl\create\CreateShardingTableRuleStatementTestCase.java,0,3,0,5,0,8
 shardingsphere-master\shardingsphere-master\shardingsphere-infra\shardingsphere-infra-common\src\main\java\org\apache\shardingsphere\infra\database\metadata\dialect\SQL92DataSourceMetaData.java,0,17,0,3,0,20
 shardingsphere-master\shardingsphere-master\shardingsphere-test\shardingsphere-pipeline-test\src\test\java\org\apache\shardingsphere\data\pipeline\core\fixture\FixturePositionInitializer.java,0,3,0,3,0,6
 shardingsphere-master\shardingsphere-master\shardingsphere-proxy\shardingsphere-proxy-frontend\shardingsphere-proxy-frontend-spi\src\main\java\org\apache\shardingsphere\proxy\frontend\spi\DatabaseProtocolFrontendEngine.java,0,13,1,2,0,16
 shardingsphere-master\shardingsphere-master\shardingsphere-infra\shardingsphere-infra-executor\src\main\java\org\apache\shardingsphere\infra\executor\sql\execute\result\query\impl\driver\jdbc\metadata\JDBCQueryResultMetaData.java,0,15,0,4,0,19
 shardingsphere-master\shardingsphere-master\shardingsphere-test\shardingsphere-parser-test\src\main\java\org\apache\shardingsphere\test\sql\parser\parameterized\asserts\statement\distsql\rdl\create\impl\CreateShardingKeyGeneratorStatementAssert.java,0,13,0,18,0,31
 shardingsphere-master\shardingsphere-master\shardingsphere-proxy\shardingsphere-proxy-backend\src\main\java\org\apache\shardingsphere\proxy\backend\session\transaction\TransactionStatus.java,0,21,4,4,0,29
 shardingsphere-master\shardingsphere-master\shardingsphere-features\shardingsphere-sharding\shardingsphere-sharding-distsql\shardingsphere-sharding-distsql-handler\src\test\java\org\apache\shardingsphere\sharding\distsql\update\AlterDefaultShardingStrategyStatementUpdaterTest.java,0,59,0,45,0,104
 shardingsphere-master\shardingsphere-master\examples\other-example\shardingsphere-parser-example\src\main\java\org\apache\shardingsphere\example\parser\opengauss\statement\OpenGaussParserStatementExample.java,0,32,1,10,0,43
 shardingsphere-master\shardingsphere-master\shardingsphere-test\shardingsphere-parser-test\src\main\java\org\apache\shardingsphere\test\sql\parser\parameterized\jaxb\cases\domain\segment\impl\assignment\ExpectedVariable.java,0,4,0,3,0,7
 shardingsphere-master\shardingsphere-master\shardingsphere-sql-parser\shardingsphere-sql-parser-statement\src\main\java\org\apache\shardingsphere\sql\parser\sql\common\segment\dml\expr\simple\ParameterMarkerExpressionSegment.java,0,19,0,9,0,28
 shardingsphere-master\shardingsphere-master\shardingsphere-infra\shardingsphere-infra-common\src\main\java\org\apache\shardingsphere\infra\datanode\DataNode.java,0,20,6,9,0,35
 shardingsphere-master\shardingsphere-master\shardingsphere-db-protocol\shardingsphere-db-protocol-postgresql\src\test\java\org\apache\shardingsphere\db\protocol\postgresql\packet\command\query\extended\bind\protocol\PostgreSQLInt4ArrayBinaryProtocolValueTest.java,0,13,0,5,0,18
 shardingsphere-master\shardingsphere-master\shardingsphere-infra\shardingsphere-infra-binder\src\test\java\org\apache\shardingsphere\infra\binder\segment\select\groupby\engine\GroupByContextEngineTest.java,0,31,0,29,0,60
 shardingsphere-master\shardingsphere-master\shardingsphere-sql-parser\shardingsphere-sql-parser-spi\src\main\java\org\apache\shardingsphere\sql\parser\api\visitor\type\RLSQLVisitor.java,0,0,0,1,0,1
 shardingsphere-master\shardingsphere-master\shardingsphere-test\shardingsphere-parser-test\src\main\java\org\apache\shardingsphere\test\sql\parser\parameterized\asserts\statement\dcl\impl\mysql\MySQLRevokeStatementAssert.java,0,5,0,9,0,14
 shardingsphere-master\shardingsphere-master\shardingsphere-test\shardingsphere-parser-test\src\main\java\org\apache\shardingsphere\test\sql\parser\parameterized\asserts\statement\distsql\rdl\create\impl\CreateShardingBroadcastTableRulesStatementAssert.java,0,8,0,11,0,19
 shardingsphere-master\shardingsphere-master\shardingsphere-agent\shardingsphere-agent-core\src\main\java\org\apache\shardingsphere\agent\core\plugin\interceptor\InstanceMethodInterceptorArgsOverride.java,64,12,7,10,0,29
 shardingsphere-master\shardingsphere-master\shardingsphere-kernel\shardingsphere-transaction\shardingsphere-transaction-core\src\test\java\org\apache\shardingsphere\transaction\core\ResourceIDGeneratorTest.java,0,3,0,2,0,5
 shardingsphere-master\shardingsphere-master\shardingsphere-features\shardingsphere-encrypt\shardingsphere-encrypt-core\src\test\java\org\apache\shardingsphere\encrypt\checker\EncryptRuleConfigurationCheckerTest.java,0,11,0,6,0,17
 shardingsphere-master\shardingsphere-master\shardingsphere-test\shardingsphere-parser-test\src\main\java\org\apache\shardingsphere\test\sql\parser\parameterized\asserts\statement\distsql\ral\impl\scaling\update\ResetScalingStatementAssert.java,0,11,1,13,0,25
 shardingsphere-master\shardingsphere-master\shardingsphere-db-protocol\shardingsphere-db-protocol-postgresql\src\main\java\org\apache\shardingsphere\db\protocol\postgresql\packet\command\query\PostgreSQLColumnDescription.java,0,21,2,5,0,28
 shardingsphere-master\shardingsphere-master\shardingsphere-test\shardingsphere-integration-scaling-test\shardingsphere-integration-scaling-test-mysql\src\test\java\org\apache\shardingsphere\integration\scaling\test\mysql\env\config\SourceConfiguration.java,0,30,1,26,0,57
 shardingsphere-master\shardingsphere-master\shardingsphere-test\shardingsphere-parser-test\src\main\java\org\apache\shardingsphere\test\sql\parser\parameterized\jaxb\cases\domain\segment\impl\model\ExpectedModelClause.java,0,13,0,10,0,23
 shardingsphere-master\shardingsphere-master\shardingsphere-db-protocol\shardingsphere-db-protocol-mysql\src\test\java\org\apache\shardingsphere\db\protocol\mysql\packet\command\query\text\MySQLTextResultSetRowPacketTest.java,0,24,0,8,0,32
 shardingsphere-master\shardingsphere-master\shardingsphere-infra\shardingsphere-infra-common\src\main\java\org\apache\shardingsphere\infra\properties\TypedPropertyValue.java,0,9,2,3,0,14
 shardingsphere-master\shardingsphere-master\shardingsphere-distsql\shardingsphere-distsql-statement\src\main\java\org\apache\shardingsphere\distsql\parser\segment\DataSourceSegment.java,0,16,0,1,0,17
 shardingsphere-master\shardingsphere-master\shardingsphere-sql-parser\shardingsphere-sql-parser-statement\src\main\java\org\apache\shardingsphere\sql\parser\sql\dialect\statement\mysql\segment\LoadTableIndexSegment.java,0,7,0,5,2,14
 shardingsphere-master\shardingsphere-master\shardingsphere-sql-parser\shardingsphere-sql-parser-statement\src\test\java\org\apache\shardingsphere\sql\parser\sql\common\util\SubqueryExtractUtilTest.java,0,177,0,79,0,256
 shardingsphere-master\shardingsphere-master\shardingsphere-features\shardingsphere-sharding\shardingsphere-sharding-distsql\shardingsphere-sharding-distsql-handler\src\test\java\org\apache\shardingsphere\sharding\distsql\update\AlterShardingAlgorithmStatementUpdaterTest.java,0,25,0,20,0,45
 shardingsphere-master\shardingsphere-master\shardingsphere-infra\shardingsphere-infra-merge\src\test\java\org\apache\shardingsphere\infra\merge\result\impl\memory\MemoryMergedResultTest.java,0,29,0,4,0,33
 shardingsphere-master\shardingsphere-master\shardingsphere-features\shardingsphere-sharding\shardingsphere-sharding-core\src\main\java\org\apache\shardingsphere\sharding\rule\aware\ShardingRuleAware.java,0,3,0,1,0,4
 shardingsphere-master\shardingsphere-master\shardingsphere-proxy\shardingsphere-proxy-backend\src\main\java\org\apache\shardingsphere\proxy\backend\config\ProxyConfigurationLoader.java,0,30,0,23,0,53
 shardingsphere-master\shardingsphere-master\shardingsphere-mode\shardingsphere-mode-type\shardingsphere-standalone-mode\shardingsphere-standalone-mode-repository\shardingsphere-standalone-mode-repository-provider\shardingsphere-standalone-mode-repository-h2\src\main\java\org\apache\shardingsphere\mode\repository\standalone\h2\H2Repository.java,0,43,0,17,0,60
 shardingsphere-master\shardingsphere-master\shardingsphere-sql-parser\shardingsphere-sql-parser-statement\src\main\java\org\apache\shardingsphere\sql\parser\sql\common\segment\dml\predicate\WhereSegment.java,0,6,0,2,0,8
 shardingsphere-master\shardingsphere-master\examples\shardingsphere-jdbc-example\single-feature-example\transaction-example\transaction-2pc-xa-spring-boot-example\src\main\java\org\apache\shardingsphere\example\transaction\xa\spring\boot\XAOrderService.java,71,16,0,7,0,23
 shardingsphere-master\shardingsphere-master\shardingsphere-proxy\shardingsphere-proxy-frontend\shardingsphere-proxy-frontend-reactive-mysql\src\main\java\org\apache\shardingsphere\proxy\frontend\reactive\mysql\command\ReactiveMySQLCommandExecutorFactory.java,0,9,0,17,0,26
 shardingsphere-master\shardingsphere-master\shardingsphere-kernel\shardingsphere-traffic\shardingsphere-traffic-core\src\test\java\org\apache\shardingsphere\traffic\algorithm\loadbalance\RandomTrafficLoadBalanceAlgorithmTest.java,0,14,0,6,0,20
 shardingsphere-master\shardingsphere-master\shardingsphere-sql-parser\shardingsphere-sql-parser-statement\src\main\java\org\apache\shardingsphere\sql\parser\sql\common\statement\ddl\AlterIndexStatement.java,14,4,0,4,1,9
 shardingsphere-master\shardingsphere-master\shardingsphere-sql-parser\shardingsphere-sql-parser-statement\src\main\java\org\apache\shardingsphere\sql\parser\sql\dialect\statement\oracle\ddl\OracleAlterDimensionStatement.java,0,1,0,5,0,6
 shardingsphere-master\shardingsphere-master\shardingsphere-sql-parser\shardingsphere-sql-parser-statement\src\main\java\org\apache\shardingsphere\sql\parser\sql\common\statement\ddl\DropForeignTableStatement.java,3,1,1,3,0,5
 shardingsphere-master\shardingsphere-master\shardingsphere-db-protocol\shardingsphere-db-protocol-opengauss\src\main\java\org\apache\shardingsphere\db\protocol\opengauss\packet\command\OpenGaussCommandPacketType.java,0,10,0,7,0,17
 shardingsphere-master\shardingsphere-master\shardingsphere-jdbc\shardingsphere-jdbc-core\src\test\java\org\apache\shardingsphere\driver\jdbc\unsupported\UnsupportedOperationPreparedStatementTest.java,0,35,0,14,0,49
 shardingsphere-master\shardingsphere-master\shardingsphere-db-protocol\shardingsphere-db-protocol-core\src\test\java\org\apache\shardingsphere\db\protocol\netty\ChannelAttrInitializerTest.java,0,5,0,3,0,8
 shardingsphere-master\shardingsphere-master\shardingsphere-features\shardingsphere-encrypt\shardingsphere-encrypt-core\src\main\java\org\apache\shardingsphere\encrypt\rewrite\aware\SchemaNameAware.java,0,2,0,1,0,3
 shardingsphere-master\shardingsphere-master\shardingsphere-kernel\shardingsphere-authority\shardingsphere-authority-core\src\test\java\org\apache\shardingsphere\authority\provider\natived\builder\StoragePrivilegeBuilderTest.java,0,60,6,52,0,118
 shardingsphere-master\shardingsphere-master\shardingsphere-agent\shardingsphere-agent-plugins\shardingsphere-agent-plugin-tracing\shardingsphere-agent-tracing-opentracing\src\main\java\org\apache\shardingsphere\agent\plugin\tracing\opentracing\advice\JDBCExecutorCallbackAdvice.java,0,15,0,14,0,29
 shardingsphere-master\shardingsphere-master\shardingsphere-jdbc\shardingsphere-jdbc-core\src\test\java\org\apache\shardingsphere\driver\jdbc\core\resultset\EncryptResultSetTest.java,0,32,0,18,0,50
 shardingsphere-master\shardingsphere-master\shardingsphere-features\shardingsphere-encrypt\shardingsphere-encrypt-distsql\shardingsphere-encrypt-distsql-statement\src\main\java\org\apache\shardingsphere\encrypt\distsql\parser\segment\EncryptRuleSegment.java,0,6,0,1,0,7
 shardingsphere-master\shardingsphere-master\shardingsphere-features\shardingsphere-sharding\shardingsphere-sharding-core\src\test\java\org\apache\shardingsphere\sharding\rewrite\parameter\ShardingParameterRewriterBuilderTest.java,0,14,0,13,0,27
 shardingsphere-master\shardingsphere-master\shardingsphere-features\shardingsphere-readwrite-splitting\shardingsphere-readwrite-splitting-core\src\test\java\org\apache\shardingsphere\readwritesplitting\checker\ReadwriteSplittingRuleConfigurationCheckerTest.java,0,19,0,14,0,33
 shardingsphere-master\shardingsphere-master\examples\shardingsphere-jdbc-example\single-feature-example\sharding-example\sharding-raw-jdbc-example\src\main\java\org\apache\shardingsphere\example\sharding\raw\jdbc\ShardingRawYamlConfigurationExample.java,0,10,1,7,0,18
 shardingsphere-master\shardingsphere-master\shardingsphere-kernel\shardingsphere-data-pipeline\shardingsphere-data-pipeline-core\src\main\java\org\apache\shardingsphere\data\pipeline\core\ingest\channel\EmptyAckCallback.java,0,2,1,1,0,4
 shardingsphere-master\shardingsphere-master\shardingsphere-infra\shardingsphere-infra-common\src\main\java\org\apache\shardingsphere\infra\metadata\schema\model\IndexMetaData.java,0,2,0,1,0,3
 shardingsphere-master\shardingsphere-master\examples\shardingsphere-jdbc-example\mixed-feature-example\sharding-readwrite-splitting-example\sharding-readwrite-splitting-raw-jdbc-example\src\main\java\org\apache\shardingsphere\example\sharding\readwrite\splitting\raw\factory\YamlRangeDataSourceFactory.java,0,7,1,6,0,14
 shardingsphere-master\shardingsphere-master\shardingsphere-test\shardingsphere-parser-test\src\main\java\org\apache\shardingsphere\test\sql\parser\parameterized\jaxb\cases\domain\statement\dal\UninstallComponentStatementTestCase.java,0,3,0,5,0,8
 shardingsphere-master\shardingsphere-master\shardingsphere-test\shardingsphere-pipeline-test\src\test\java\org\apache\shardingsphere\data\pipeline\core\ingest\channel\memory\MultiplexMemoryPipelineChannelTest.java,0,26,0,11,0,37
 shardingsphere-master\shardingsphere-master\shardingsphere-test\shardingsphere-parser-test\src\main\java\org\apache\shardingsphere\test\sql\parser\parameterized\asserts\statement\dal\impl\ShowSlaveStatusStatementAssert.java,0,4,0,8,0,12
 shardingsphere-master\shardingsphere-master\shardingsphere-mode\shardingsphere-mode-type\shardingsphere-cluster-mode\shardingsphere-cluster-mode-core\src\test\java\org\apache\shardingsphere\mode\manager\cluster\coordinator\lock\service\LockRegistryServiceTest.java,0,15,1,5,0,21
 shardingsphere-master\shardingsphere-master\shardingsphere-infra\shardingsphere-infra-common\src\main\java\org\apache\shardingsphere\infra\database\metadata\dialect\OracleDataSourceMetaData.java,0,34,0,9,0,43
 shardingsphere-master\shardingsphere-master\shardingsphere-jdbc\shardingsphere-jdbc-core\src\main\java\org\apache\shardingsphere\driver\jdbc\adapter\AbstractPreparedStatementAdapter.java,259,78,0,27,0,105
 shardingsphere-master\shardingsphere-master\shardingsphere-proxy\shardingsphere-proxy-backend\src\main\java\org\apache\shardingsphere\proxy\backend\response\header\update\UpdateResponseHeader.java,0,18,0,4,0,22
 shardingsphere-master\shardingsphere-master\shardingsphere-infra\shardingsphere-infra-rewrite\src\main\java\org\apache\shardingsphere\infra\rewrite\engine\GenericSQLRewriteEngine.java,0,4,0,4,0,8
 shardingsphere-master\shardingsphere-master\shardingsphere-features\shardingsphere-sharding\shardingsphere-sharding-distsql\shardingsphere-sharding-distsql-handler\src\test\java\org\apache\shardingsphere\sharding\distsql\fixture\StandardShardingAlgorithmFixture.java,0,7,1,7,0,15
 shardingsphere-master\shardingsphere-master\shardingsphere-test\shardingsphere-parser-test\src\main\java\org\apache\shardingsphere\test\sql\parser\parameterized\asserts\statement\distsql\rdl\alter\AlterRuleStatementAssert.java,0,22,1,67,0,90
 shardingsphere-master\shardingsphere-master\shardingsphere-sql-parser\shardingsphere-sql-parser-statement\src\main\java\org\apache\shardingsphere\sql\parser\sql\common\statement\ddl\AlterDomainStatement.java,3,1,1,3,0,5
 shardingsphere-master\shardingsphere-master\shardingsphere-infra\shardingsphere-infra-binder\src\test\java\org\apache\shardingsphere\infra\binder\statement\dal\ExplainStatementContextTest.java,0,5,0,8,0,13
 shardingsphere-master\shardingsphere-master\shardingsphere-test\shardingsphere-parser-test\src\main\java\org\apache\shardingsphere\test\sql\parser\parameterized\jaxb\cases\domain\statement\ddl\AlterSystemStatementTestCase.java,0,0,0,3,0,3
 shardingsphere-master\shardingsphere-master\shardingsphere-sql-parser\shardingsphere-sql-parser-statement\src\main\java\org\apache\shardingsphere\sql\parser\sql\dialect\statement\mysql\dal\MySQLInstallComponentStatement.java,0,3,0,5,1,9
 shardingsphere-master\shardingsphere-master\shardingsphere-sql-parser\shardingsphere-sql-parser-statement\src\main\java\org\apache\shardingsphere\sql\parser\sql\dialect\statement\sqlserver\ddl\SQLServerAlterSchemaStatement.java,0,1,0,6,0,7
 shardingsphere-master\shardingsphere-master\shardingsphere-infra\shardingsphere-infra-executor\src\main\java\org\apache\shardingsphere\infra\executor\sql\execute\result\query\type\memory\row\MemoryQueryResultDataRow.java,0,3,0,2,0,5
 shardingsphere-master\shardingsphere-master\shardingsphere-features\shardingsphere-sharding\shardingsphere-sharding-distsql\shardingsphere-sharding-distsql-statement\src\main\java\org\apache\shardingsphere\sharding\distsql\parser\statement\AlterShardingAlgorithmStatement.java,0,2,0,3,0,5
 shardingsphere-master\shardingsphere-master\shardingsphere-agent\shardingsphere-agent-plugins\shardingsphere-agent-plugin-metrics\shardingsphere-agent-metrics-prometheus\src\test\java\org\apache\shardingsphere\agent\metrics\prometheus\wrapper\HistogramWrapperTest.java,0,3,0,2,0,5
 shardingsphere-master\shardingsphere-master\shardingsphere-distsql\shardingsphere-distsql-statement\src\main\java\org\apache\shardingsphere\distsql\parser\statement\ral\common\queryable\ExportSchemaConfigurationStatement.java,0,6,0,5,0,11
 shardingsphere-master\shardingsphere-master\shardingsphere-infra\shardingsphere-infra-context\src\main\java\org\apache\shardingsphere\infra\context\refresher\type\AlterIndexStatementSchemaRefresher.java,0,19,0,19,0,38
 shardingsphere-master\shardingsphere-master\shardingsphere-sql-parser\shardingsphere-sql-parser-statement\src\main\java\org\apache\shardingsphere\sql\parser\sql\dialect\statement\oracle\ddl\OracleFlashbackDatabaseStatement.java,0,1,0,5,0,6
 shardingsphere-master\shardingsphere-master\shardingsphere-distsql\shardingsphere-distsql-statement\src\main\java\org\apache\shardingsphere\distsql\parser\statement\ral\common\queryable\ShowAuthorityRuleStatement.java,0,0,0,2,0,2
 shardingsphere-master\shardingsphere-master\shardingsphere-sql-parser\shardingsphere-sql-parser-dialect\shardingsphere-sql-parser-opengauss\src\main\java\org\apache\shardingsphere\sql\parser\opengauss\visitor\statement\impl\OpenGaussDMLStatementSQLVisitor.java,0,6,0,9,0,15
 shardingsphere-master\shardingsphere-master\shardingsphere-features\shardingsphere-sharding\shardingsphere-sharding-core\src\test\java\org\apache\shardingsphere\sharding\merge\dql\groupby\aggregation\AverageAggregationUnitTest.java,0,16,1,4,0,21
 shardingsphere-master\shardingsphere-master\examples\shardingsphere-jdbc-example\single-feature-example\readwrite-splitting-example\readwrite-splitting-raw-jdbc-example\src\main\java\org\apache\shardingsphere\example\readwrite\splitting\raw\jdbc\factory\DataSourceFactory.java,0,5,1,3,0,9
 shardingsphere-master\shardingsphere-master\examples\shardingsphere-jdbc-example\single-feature-example\transaction-example\transaction-2pc-xa-bitronix-raw-jdbc-example\src\main\java\org\apache\shardingsphere\example\transaction\xa\bitronix\raw\jdbc\TransactionXaBitronixRawExample.java,0,9,1,6,0,16
 shardingsphere-master\shardingsphere-master\shardingsphere-infra\shardingsphere-infra-common\src\main\java\org\apache\shardingsphere\infra\database\type\DatabaseTypeRecognizer.java,0,8,0,5,0,13
 shardingsphere-master\shardingsphere-master\shardingsphere-test\shardingsphere-parser-test\src\main\java\org\apache\shardingsphere\test\sql\parser\parameterized\jaxb\cases\domain\segment\impl\expr\ExpectedExistsSubquery.java,0,5,0,5,0,10
 shardingsphere-master\shardingsphere-master\shardingsphere-proxy\shardingsphere-proxy-backend\src\test\java\org\apache\shardingsphere\proxy\backend\text\data\impl\SchemaAssignedDatabaseBackendHandlerTest.java,0,44,2,26,0,72
 shardingsphere-master\shardingsphere-master\shardingsphere-features\shardingsphere-shadow\shardingsphere-shadow-core\src\main\java\org\apache\shardingsphere\shadow\algorithm\shadow\ShadowAlgorithmException.java,0,5,0,2,0,7
 shardingsphere-master\shardingsphere-master\shardingsphere-infra\shardingsphere-infra-common\src\main\java\org\apache\shardingsphere\infra\rule\builder\schema\DefaultSchemaRuleConfigurationBuilder.java,0,3,0,3,0,6
 shardingsphere-master\shardingsphere-master\shardingsphere-test\shardingsphere-parser-test\src\main\java\org\apache\shardingsphere\test\sql\parser\parameterized\asserts\statement\distsql\rdl\create\impl\CreateShardingTableRuleStatementAssert.java,0,23,0,32,0,55
 shardingsphere-master\shardingsphere-master\shardingsphere-test\shardingsphere-parser-test\src\main\java\org\apache\shardingsphere\test\sql\parser\parameterized\asserts\statement\dal\impl\ShowEventsStatementAssert.java,0,6,0,12,0,18
 shardingsphere-master\shardingsphere-master\shardingsphere-sql-parser\shardingsphere-sql-parser-statement\src\main\java\org\apache\shardingsphere\sql\parser\sql\dialect\statement\postgresql\ddl\PostgreSQLAlterLanguageStatement.java,0,1,0,5,0,6
 shardingsphere-master\shardingsphere-master\shardingsphere-test\shardingsphere-integration-test\shardingsphere-integration-test-suite\src\test\java\org\apache\shardingsphere\test\integration\framework\param\RunnerParameters.java,0,6,2,3,0,11
 shardingsphere-master\shardingsphere-master\shardingsphere-features\shardingsphere-sharding\shardingsphere-sharding-core\src\test\java\org\apache\shardingsphere\sharding\rewrite\token\ShardingInsertValuesTokenGeneratorTest.java,0,24,2,30,0,56
 shardingsphere-master\shardingsphere-master\shardingsphere-infra\shardingsphere-infra-common\src\test\java\org\apache\shardingsphere\infra\metadata\resource\ShardingSphereResourceTest.java,0,5,0,3,0,8
 shardingsphere-master\shardingsphere-master\shardingsphere-features\shardingsphere-encrypt\shardingsphere-encrypt-distsql\shardingsphere-encrypt-distsql-parser\src\main\java\org\apache\shardingsphere\encrypt\distsql\parser\core\EncryptDistSQLStatementVisitor.java,0,34,0,44,0,78
 shardingsphere-master\shardingsphere-master\shardingsphere-sql-parser\shardingsphere-sql-parser-statement\src\main\java\org\apache\shardingsphere\sql\parser\sql\dialect\statement\mysql\dcl\MySQLSetPasswordStatement.java,0,1,0,5,0,6
 shardingsphere-master\shardingsphere-master\shardingsphere-mode\shardingsphere-mode-type\shardingsphere-cluster-mode\shardingsphere-cluster-mode-core\src\test\java\org\apache\shardingsphere\mode\manager\cluster\coordinator\fixture\RuleConfigurationFixture.java,0,3,0,3,0,6
 shardingsphere-master\shardingsphere-master\shardingsphere-proxy\shardingsphere-proxy-backend\src\main\java\org\apache\shardingsphere\proxy\backend\text\admin\mysql\executor\UnicastResourceShowExecutor.java,0,30,0,28,0,58
 shardingsphere-master\shardingsphere-master\shardingsphere-db-protocol\shardingsphere-db-protocol-postgresql\src\main\java\org\apache\shardingsphere\db\protocol\postgresql\packet\identifier\PostgreSQLIdentifierPacket.java,0,2,0,1,0,3
 shardingsphere-master\shardingsphere-master\shardingsphere-sql-parser\shardingsphere-sql-parser-statement\src\main\java\org\apache\shardingsphere\sql\parser\sql\common\segment\dml\item\ColumnProjectionSegment.java,0,11,0,6,2,19
 shardingsphere-master\shardingsphere-master\shardingsphere-infra\shardingsphere-infra-binder\src\test\java\org\apache\shardingsphere\infra\binder\statement\dml\CallStatementContextTest.java,0,7,0,6,0,13
 shardingsphere-master\shardingsphere-master\shardingsphere-proxy\shardingsphere-proxy-frontend\shardingsphere-proxy-frontend-postgresql\src\main\java\org\apache\shardingsphere\proxy\frontend\postgresql\authentication\authenticator\PostgreSQLPasswordAuthenticator.java,0,5,0,6,0,11
 shardingsphere-master\shardingsphere-master\shardingsphere-features\shardingsphere-sharding\shardingsphere-sharding-distsql\shardingsphere-sharding-distsql-handler\src\main\java\org\apache\shardingsphere\sharding\distsql\handler\update\DropShardingKeyGeneratorStatementUpdater.java,0,38,0,33,0,71
 shardingsphere-master\shardingsphere-master\shardingsphere-spi\src\main\java\org\apache\shardingsphere\spi\singleton\SingletonSPIRegistry.java,0,8,0,6,0,14
 shardingsphere-master\shardingsphere-master\shardingsphere-distsql\shardingsphere-distsql-parser\src\main\java\org\apache\shardingsphere\distsql\parser\core\advanced\AdvancedDistSQLStatementParserEngine.java,0,8,1,6,0,15
 shardingsphere-master\shardingsphere-master\shardingsphere-proxy\shardingsphere-proxy-backend\src\main\java\org\apache\shardingsphere\proxy\backend\communication\jdbc\statement\JDBCBackendStatement.java,0,19,0,15,0,34
 shardingsphere-master\shardingsphere-master\shardingsphere-proxy\shardingsphere-proxy-frontend\shardingsphere-proxy-frontend-reactive-core\src\test\java\org\apache\shardingsphere\proxy\frontend\reactive\protocol\fixture\DummyReactiveDatabaseProtocolFrontendEngine.java,0,9,2,5,0,16
 shardingsphere-master\shardingsphere-master\shardingsphere-proxy\shardingsphere-proxy-backend\src\main\java\org\apache\shardingsphere\proxy\backend\text\distsql\ral\RALBackendHandlerFactory.java,0,53,1,110,0,164
 shardingsphere-master\shardingsphere-master\shardingsphere-db-protocol\shardingsphere-db-protocol-mysql\src\test\java\org\apache\shardingsphere\db\protocol\mysql\packet\binlog\row\column\value\time\MySQLTimeValueUtilTest.java,0,4,0,3,0,7
 shardingsphere-master\shardingsphere-master\shardingsphere-test\shardingsphere-parser-test\src\main\java\org\apache\shardingsphere\test\sql\parser\parameterized\jaxb\cases\domain\statement\distsql\rql\ShowReadwriteSplittingRulesStatementTestCase.java,0,3,0,5,0,8
 shardingsphere-master\shardingsphere-master\shardingsphere-sql-parser\shardingsphere-sql-parser-statement\src\main\java\org\apache\shardingsphere\sql\parser\sql\dialect\statement\sqlserver\dcl\SQLServerCreateUserStatement.java,0,1,0,5,0,6
 shardingsphere-master\shardingsphere-master\shardingsphere-kernel\shardingsphere-transaction\shardingsphere-transaction-type\shardingsphere-transaction-xa\shardingsphere-transaction-xa-spi\src\main\java\org\apache\shardingsphere\transaction\xa\spi\SingleXAResource.java,0,16,0,2,0,18
 shardingsphere-master\shardingsphere-master\shardingsphere-features\shardingsphere-sharding\shardingsphere-sharding-core\src\main\java\org\apache\shardingsphere\sharding\merge\dql\groupby\aggregation\DistinctSumAggregationUnit.java,0,7,1,1,0,9
 shardingsphere-master\shardingsphere-master\shardingsphere-features\shardingsphere-encrypt\shardingsphere-encrypt-core\src\main\java\org\apache\shardingsphere\encrypt\merge\dal\impl\DecoratedEncryptColumnsMergedResult.java,0,12,0,4,0,16
 shardingsphere-master\shardingsphere-master\shardingsphere-sql-parser\shardingsphere-sql-parser-statement\src\main\java\org\apache\shardingsphere\sql\parser\sql\common\statement\ddl\DropProcedureStatement.java,3,1,1,3,0,5
 shardingsphere-master\shardingsphere-master\shardingsphere-test\shardingsphere-pipeline-test\src\test\java\org\apache\shardingsphere\data\pipeline\core\check\datasource\AbstractDataSourceCheckerTest.java,0,34,2,8,0,44
 shardingsphere-master\shardingsphere-master\shardingsphere-distsql\shardingsphere-distsql-statement\src\main\java\org\apache\shardingsphere\distsql\parser\statement\rdl\RDLStatement.java,3,1,1,1,0,3
 shardingsphere-master\shardingsphere-master\shardingsphere-features\shardingsphere-sharding\shardingsphere-sharding-core\src\test\java\org\apache\shardingsphere\sharding\fixture\ClassBasedStandardShardingAlgorithmFixture.java,0,4,1,7,0,12
 shardingsphere-master\shardingsphere-master\shardingsphere-features\shardingsphere-sharding\shardingsphere-sharding-api\src\main\java\org\apache\shardingsphere\sharding\api\sharding\standard\StandardShardingAlgorithm.java,0,11,0,6,0,17
 shardingsphere-master\shardingsphere-master\shardingsphere-db-protocol\shardingsphere-db-protocol-mysql\src\test\java\org\apache\shardingsphere\db\protocol\mysql\constant\MySQLBinaryColumnTypeTest.java,0,31,0,23,0,54
 shardingsphere-master\shardingsphere-master\shardingsphere-infra\shardingsphere-infra-datetime\shardingsphere-infra-datetime-type\shardingsphere-system-datetime\src\main\java\org\apache\shardingsphere\datetime\system\SystemDatetimeService.java,0,3,0,1,0,4
 shardingsphere-master\shardingsphere-master\shardingsphere-sql-parser\shardingsphere-sql-parser-statement\src\main\java\org\apache\shardingsphere\sql\parser\sql\dialect\statement\opengauss\ddl\OpenGaussCreateTableStatement.java,0,2,0,5,0,7
 shardingsphere-master\shardingsphere-master\shardingsphere-mode\shardingsphere-mode-type\shardingsphere-cluster-mode\shardingsphere-cluster-mode-core\src\main\java\org\apache\shardingsphere\mode\manager\cluster\coordinator\registry\process\subscriber\ProcessRegistrySubscriber.java,0,27,0,31,0,58
 shardingsphere-master\shardingsphere-master\shardingsphere-jdbc\shardingsphere-jdbc-spring\shardingsphere-jdbc-transaction-spring\src\main\java\org\apache\shardingsphere\spring\transaction\TransactionTypeInterceptor.java,0,13,0,12,0,25
 shardingsphere-master\shardingsphere-master\shardingsphere-features\shardingsphere-sharding\shardingsphere-sharding-core\src\test\java\org\apache\shardingsphere\sharding\route\engine\type\standard\SQLRouteTest.java,0,13,0,4,0,17
 shardingsphere-master\shardingsphere-master\shardingsphere-proxy\shardingsphere-proxy-frontend\shardingsphere-proxy-frontend-reactive-core\src\main\java\org\apache\shardingsphere\proxy\frontend\reactive\command\ReactiveCommandExecuteTask.java,0,36,2,20,0,58
 shardingsphere-master\shardingsphere-master\shardingsphere-infra\shardingsphere-infra-common\src\main\java\org\apache\shardingsphere\infra\lock\ShardingSphereLock.java,0,9,0,1,0,10
 shardingsphere-master\shardingsphere-master\shardingsphere-kernel\shardingsphere-data-pipeline\shardingsphere-data-pipeline-core\src\main\java\org\apache\shardingsphere\data\pipeline\core\task\IncrementalTask.java,0,44,1,29,0,74
 shardingsphere-master\shardingsphere-master\shardingsphere-features\shardingsphere-shadow\shardingsphere-shadow-spring\shardingsphere-shadow-spring-boot-starter\src\test\java\org\apache\shardingsphere\shadow\spring\boot\YmlShadowSpringBootStarterTest.java,49,29,0,29,0,58
 shardingsphere-master\shardingsphere-master\shardingsphere-test\shardingsphere-integration-test\shardingsphere-integration-test-suite\src\test\java\org\apache\shardingsphere\test\integration\engine\dql\GeneralDQLIT.java,0,43,0,36,0,79
 shardingsphere-master\shardingsphere-master\shardingsphere-test\shardingsphere-parser-test\src\main\java\org\apache\shardingsphere\test\sql\parser\parameterized\jaxb\cases\domain\statement\distsql\rdl\alter\AlterShardingBroadcastTableRulesStatementTestCase.java,0,3,0,4,0,7
 shardingsphere-master\shardingsphere-master\shardingsphere-test\shardingsphere-parser-test\src\main\java\org\apache\shardingsphere\test\sql\parser\parameterized\jaxb\cases\domain\statement\dal\ShowCreateTriggerStatementTestCase.java,0,3,0,5,0,8
 shardingsphere-master\shardingsphere-master\shardingsphere-test\shardingsphere-parser-test\src\main\java\org\apache\shardingsphere\test\sql\parser\parameterized\asserts\statement\dal\impl\UninstallComponentStatementAssert.java,0,9,0,12,0,21
 shardingsphere-master\shardingsphere-master\shardingsphere-sql-parser\shardingsphere-sql-parser-statement\src\main\java\org\apache\shardingsphere\sql\parser\sql\dialect\statement\opengauss\dal\OpenGaussAnalyzeTableStatement.java,0,2,0,5,0,7
 shardingsphere-master\shardingsphere-master\shardingsphere-sql-parser\shardingsphere-sql-parser-statement\src\main\java\org\apache\shardingsphere\sql\parser\sql\dialect\statement\mysql\dal\MySQLShowPluginsStatement.java,0,1,0,5,0,6
 shardingsphere-master\shardingsphere-master\shardingsphere-proxy\shardingsphere-proxy-backend\src\main\java\org\apache\shardingsphere\proxy\backend\text\data\impl\SchemaAssignedDatabaseBackendHandler.java,0,27,0,17,0,44
 shardingsphere-master\shardingsphere-master\shardingsphere-infra\shardingsphere-infra-common\src\main\java\org\apache\shardingsphere\infra\aware\DataSourceNameAwareFactory.java,0,9,2,2,0,13
 shardingsphere-master\shardingsphere-master\shardingsphere-db-protocol\shardingsphere-db-protocol-mysql\src\main\java\org\apache\shardingsphere\db\protocol\mysql\packet\command\binlog\MySQLComBinlogDumpCommandPacket.java,0,21,0,6,0,27
 shardingsphere-master\shardingsphere-master\shardingsphere-db-protocol\shardingsphere-db-protocol-mysql\src\test\java\org\apache\shardingsphere\db\protocol\mysql\packet\binlog\row\column\value\time\MySQLTimestamp2BinlogProtocolValueTest.java,0,25,3,10,0,38
 shardingsphere-master\shardingsphere-master\shardingsphere-infra\shardingsphere-infra-binder\src\test\java\org\apache\shardingsphere\infra\binder\statement\ddl\DropIndexStatementContextTest.java,0,9,0,14,0,23
 shardingsphere-master\shardingsphere-master\shardingsphere-features\shardingsphere-sharding\shardingsphere-sharding-core\src\test\java\org\apache\shardingsphere\sharding\merge\dql\groupby\GroupByMemoryMergedResultTest.java,0,107,0,43,0,150
 shardingsphere-master\shardingsphere-master\shardingsphere-sql-parser\shardingsphere-sql-parser-statement\src\main\java\org\apache\shardingsphere\sql\parser\sql\dialect\statement\mysql\dal\MySQLShowBinlogEventsStatement.java,0,5,0,6,0,11
 shardingsphere-master\shardingsphere-master\shardingsphere-features\shardingsphere-encrypt\shardingsphere-encrypt-core\src\main\java\org\apache\shardingsphere\encrypt\rewrite\token\generator\EncryptOrderByItemTokenGenerator.java,0,38,0,37,0,75
 shardingsphere-master\shardingsphere-master\examples\example-core\example-api\src\main\java\org\apache\shardingsphere\example\core\api\repository\OrderRepository.java,0,0,0,1,0,1
 shardingsphere-master\shardingsphere-master\shardingsphere-features\shardingsphere-shadow\shardingsphere-shadow-distsql\shardingsphere-shadow-distsql-handler\src\main\java\org\apache\shardingsphere\shadow\distsql\handler\update\CreateShadowRuleStatementUpdater.java,0,35,0,34,0,69
 shardingsphere-master\shardingsphere-master\shardingsphere-infra\shardingsphere-infra-route\src\test\java\org\apache\shardingsphere\infra\route\engine\SQLRouteEngineTest.java,0,14,0,11,0,25
 shardingsphere-master\shardingsphere-master\shardingsphere-mode\shardingsphere-mode-type\shardingsphere-cluster-mode\shardingsphere-cluster-mode-repository\shardingsphere-cluster-mode-repository-api\src\main\java\org\apache\shardingsphere\mode\repository\cluster\ClusterPersistRepositoryFactory.java,0,7,0,4,0,11
 shardingsphere-master\shardingsphere-master\shardingsphere-test\shardingsphere-parser-test\src\main\java\org\apache\shardingsphere\test\sql\parser\parameterized\jaxb\cases\domain\statement\dal\ShowCharacterSetStatementTestCase.java,0,2,0,4,0,6
 shardingsphere-master\shardingsphere-master\shardingsphere-features\shardingsphere-shadow\shardingsphere-shadow-api\src\main\java\org\apache\shardingsphere\shadow\spi\ShadowAlgorithm.java,0,2,0,3,0,5
 shardingsphere-master\shardingsphere-master\shardingsphere-proxy\shardingsphere-proxy-backend\src\main\java\org\apache\shardingsphere\proxy\backend\text\distsql\ral\advanced\PreviewDistSQLBackendHandler.java,0,52,0,54,0,106
 shardingsphere-master\shardingsphere-master\shardingsphere-test\shardingsphere-parser-test\src\main\java\org\apache\shardingsphere\test\sql\parser\parameterized\jaxb\cases\domain\statement\ddl\TruncateStatementTestCase.java,0,2,0,4,0,6
 shardingsphere-master\shardingsphere-master\shardingsphere-mode\shardingsphere-mode-core\src\main\java\org\apache\shardingsphere\mode\manager\ContextManager.java,0,278,3,210,0,491
 shardingsphere-master\shardingsphere-master\shardingsphere-features\shardingsphere-sharding\shardingsphere-sharding-core\src\main\java\org\apache\shardingsphere\sharding\route\engine\type\standard\ShardingStandardRoutingEngine.java,0,112,0,79,0,191
 shardingsphere-master\shardingsphere-master\shardingsphere-test\shardingsphere-parser-test\src\main\java\org\apache\shardingsphere\test\sql\parser\parameterized\asserts\statement\dcl\impl\SetPasswordStatementAssert.java,0,4,1,6,0,11
 shardingsphere-master\shardingsphere-master\shardingsphere-proxy\shardingsphere-proxy-frontend\shardingsphere-proxy-frontend-mysql\src\main\java\org\apache\shardingsphere\proxy\frontend\mysql\command\MySQLCommandExecutorFactory.java,0,12,0,32,0,44
 shardingsphere-master\shardingsphere-master\shardingsphere-features\shardingsphere-sharding\shardingsphere-sharding-core\src\test\java\org\apache\shardingsphere\sharding\route\strategy\fixture\ComplexKeysShardingAlgorithmFixture.java,0,6,1,5,0,12
 shardingsphere-master\shardingsphere-master\shardingsphere-kernel\shardingsphere-transaction\shardingsphere-transaction-type\shardingsphere-transaction-xa\shardingsphere-transaction-xa-core\src\main\java\org\apache\shardingsphere\transaction\xa\jta\datasource\properties\XADataSourceDefinition.java,0,3,0,1,0,4
 shardingsphere-master\shardingsphere-master\shardingsphere-features\shardingsphere-shadow\shardingsphere-shadow-core\src\test\java\org\apache\shardingsphere\shadow\route\engine\dml\ShadowUpdateStatementRoutingEngineTest.java,0,34,1,35,0,70
 shardingsphere-master\shardingsphere-master\shardingsphere-features\shardingsphere-shadow\shardingsphere-shadow-core\src\test\java\org\apache\shardingsphere\shadow\algorithm\shadow\column\ColumnValueMatchShadowAlgorithmTest.java,0,16,0,6,0,22
 shardingsphere-master\shardingsphere-master\shardingsphere-test\shardingsphere-parser-test\src\main\java\org\apache\shardingsphere\test\sql\parser\parameterized\jaxb\cases\domain\segment\impl\plugin\ExpectedPlugin.java,0,1,0,3,0,4
 shardingsphere-master\shardingsphere-master\examples\shardingsphere-jdbc-example\single-feature-example\shadow-example\shadow-raw-jdbc-example\src\main\java\org\apache\shardingsphere\example\shadow\raw\jdbc\ShadowRawYamlConfigurationExample.java,0,10,1,8,0,19
 shardingsphere-master\shardingsphere-master\shardingsphere-kernel\shardingsphere-authority\shardingsphere-authority-core\src\main\java\org\apache\shardingsphere\authority\provider\natived\builder\dialect\OraclePrivilegeHandler.java,0,68,1,49,0,118
 shardingsphere-master\shardingsphere-master\shardingsphere-infra\shardingsphere-infra-common\src\main\java\org\apache\shardingsphere\infra\distsql\exception\resource\DuplicateResourceException.java,0,7,0,3,0,10
 shardingsphere-master\shardingsphere-master\shardingsphere-db-protocol\shardingsphere-db-protocol-postgresql\src\main\java\org\apache\shardingsphere\db\protocol\postgresql\packet\command\query\extended\bind\protocol\PostgreSQLUnspecifiedBinaryProtocolValue.java,0,6,0,7,0,13
 shardingsphere-master\shardingsphere-master\shardingsphere-infra\shardingsphere-infra-datetime\shardingsphere-infra-datetime-type\shardingsphere-database-datetime\src\main\java\org\apache\shardingsphere\datetime\database\provider\DatetimeLoadingSQLProvider.java,0,2,0,1,0,3
 shardingsphere-master\shardingsphere-master\shardingsphere-db-protocol\shardingsphere-db-protocol-postgresql\src\main\java\org\apache\shardingsphere\db\protocol\postgresql\packet\command\query\extended\bind\protocol\PostgreSQLByteConverter.java,0,101,0,21,0,122
 shardingsphere-master\shardingsphere-master\shardingsphere-proxy\shardingsphere-proxy-backend\src\main\java\org\apache\shardingsphere\proxy\backend\response\header\query\QueryHeaderBuilder.java,48,23,0,23,0,46
 shardingsphere-master\shardingsphere-master\shardingsphere-features\shardingsphere-db-discovery\shardingsphere-db-discovery-spring\shardingsphere-db-discovery-spring-namespace\src\main\java\org\apache\shardingsphere\dbdiscovery\spring\namespace\tag\DatabaseDiscoveryTypeBeanDefinitionTag.java,0,3,0,1,0,4
 shardingsphere-master\shardingsphere-master\shardingsphere-test\shardingsphere-parser-test\src\main\java\org\apache\shardingsphere\test\sql\parser\parameterized\asserts\statement\distsql\ral\impl\common\queryable\ExportSchemaConfigurationStatementAssert.java,0,8,1,11,0,20
 shardingsphere-master\shardingsphere-master\shardingsphere-kernel\shardingsphere-data-pipeline\shardingsphere-data-pipeline-dialect\shardingsphere-data-pipeline-mysql\src\test\java\org\apache\shardingsphere\data\pipeline\mysql\ingest\column\value\UnsignedBigintHandlerTest.java,0,5,0,1,0,6
 shardingsphere-master\shardingsphere-master\shardingsphere-sql-parser\shardingsphere-sql-parser-statement\src\main\java\org\apache\shardingsphere\sql\parser\sql\dialect\statement\mysql\dcl\MySQLRevokeStatement.java,0,14,0,9,4,27
 shardingsphere-master\shardingsphere-master\shardingsphere-test\shardingsphere-parser-test\src\main\java\org\apache\shardingsphere\test\sql\parser\parameterized\jaxb\cases\domain\statement\ddl\DiscardStatementTestCase.java,0,0,0,3,0,3
 shardingsphere-master\shardingsphere-master\shardingsphere-infra\shardingsphere-infra-common\src\main\java\org\apache\shardingsphere\infra\lock\ShardingSphereGlobalLock.java,0,4,0,1,0,5
 shardingsphere-master\shardingsphere-master\shardingsphere-infra\shardingsphere-infra-federation\shardingsphere-infra-federation-optimizer\src\main\java\org\apache\shardingsphere\infra\federation\optimizer\metadata\FederationTableMetaData.java,0,20,0,7,0,27
 shardingsphere-master\shardingsphere-master\shardingsphere-test\shardingsphere-parser-test\src\main\java\org\apache\shardingsphere\test\sql\parser\parameterized\jaxb\cases\domain\segment\AbstractExpectedSQLSegment.java,15,8,1,2,0,11
 shardingsphere-master\shardingsphere-master\shardingsphere-proxy\shardingsphere-proxy-backend\src\test\java\org\apache\shardingsphere\proxy\backend\text\distsql\ral\common\hint\HintStatementExecutorFactoryTest.java,0,43,0,42,0,85
 shardingsphere-master\shardingsphere-master\shardingsphere-sql-parser\shardingsphere-sql-parser-statement\src\main\java\org\apache\shardingsphere\sql\parser\sql\dialect\statement\sql92\dml\SQL92SelectStatement.java,0,3,0,5,0,8
 shardingsphere-master\shardingsphere-master\shardingsphere-features\shardingsphere-encrypt\shardingsphere-encrypt-core\src\test\java\org\apache\shardingsphere\encrypt\algorithm\MD5EncryptAlgorithmTest.java,0,17,0,7,0,24
 shardingsphere-master\shardingsphere-master\shardingsphere-infra\shardingsphere-infra-federation\shardingsphere-infra-federation-optimizer\src\main\java\org\apache\shardingsphere\infra\federation\optimizer\converter\segment\expression\impl\SubqueryExpressionConverter.java,0,9,0,14,0,23
 shardingsphere-master\shardingsphere-master\shardingsphere-distsql\shardingsphere-distsql-parser\src\main\java\org\apache\shardingsphere\distsql\parser\core\common\CommonDistSQLStatementParserEngine.java,0,5,0,4,0,9
 shardingsphere-master\shardingsphere-master\shardingsphere-sql-parser\shardingsphere-sql-parser-statement\src\main\java\org\apache\shardingsphere\sql\parser\sql\common\statement\dal\DALStatement.java,0,0,0,1,0,1
 shardingsphere-master\shardingsphere-master\shardingsphere-features\shardingsphere-sharding\shardingsphere-sharding-core\src\main\java\org\apache\shardingsphere\sharding\algorithm\keygen\CosIdKeyGenerateAlgorithm.java,0,16,3,4,0,23
 shardingsphere-master\shardingsphere-master\shardingsphere-infra\shardingsphere-infra-common\src\test\java\org\apache\shardingsphere\infra\instance\fixture\WorkerIdGeneratorFixture.java,0,2,0,1,0,3
 shardingsphere-master\shardingsphere-master\shardingsphere-kernel\shardingsphere-transaction\shardingsphere-transaction-type\shardingsphere-transaction-xa\shardingsphere-transaction-xa-core\src\test\java\org\apache\shardingsphere\transaction\xa\jta\datasource\properties\dialect\MySQLXADataSourceDefinitionTest.java,0,3,0,3,0,6
 shardingsphere-master\shardingsphere-master\shardingsphere-features\shardingsphere-sharding\shardingsphere-sharding-api\src\main\java\org\apache\shardingsphere\sharding\api\config\strategy\sharding\HintShardingStrategyConfiguration.java,0,8,0,4,0,12
 shardingsphere-master\shardingsphere-master\shardingsphere-sql-parser\shardingsphere-sql-parser-statement\src\main\java\org\apache\shardingsphere\sql\parser\sql\dialect\handler\dal\ExplainStatementHandler.java,0,4,0,7,1,12
 shardingsphere-master\shardingsphere-master\shardingsphere-features\shardingsphere-sharding\shardingsphere-sharding-api\src\main\java\org\apache\shardingsphere\sharding\api\sharding\standard\PreciseShardingValue.java,0,11,0,2,0,13
 shardingsphere-master\shardingsphere-master\shardingsphere-sql-parser\shardingsphere-sql-parser-statement\src\main\java\org\apache\shardingsphere\sql\parser\sql\dialect\statement\postgresql\ddl\PostgreSQLDropAggregateStatement.java,0,1,0,5,0,6
 shardingsphere-master\shardingsphere-master\shardingsphere-kernel\shardingsphere-data-pipeline\shardingsphere-data-pipeline-spi\src\main\java\org\apache\shardingsphere\data\pipeline\api\datasource\config\PipelineDataSourceConfiguration.java,0,6,0,1,0,7
 shardingsphere-master\shardingsphere-master\shardingsphere-infra\shardingsphere-infra-rewrite\src\main\java\org\apache\shardingsphere\infra\rewrite\sql\token\generator\builder\DefaultTokenGeneratorBuilder.java,0,8,0,6,0,14
 shardingsphere-master\shardingsphere-master\shardingsphere-mode\shardingsphere-mode-type\shardingsphere-cluster-mode\shardingsphere-cluster-mode-core\src\main\java\org\apache\shardingsphere\mode\manager\cluster\coordinator\lock\service\GlobalLockNode.java,0,24,0,10,0,34
 shardingsphere-master\shardingsphere-master\shardingsphere-test\shardingsphere-parser-test\src\main\java\org\apache\shardingsphere\test\sql\parser\parameterized\jaxb\cases\domain\statement\ddl\AlterSessionStatementTestCase.java,0,0,0,3,0,3
 shardingsphere-master\shardingsphere-master\shardingsphere-mode\shardingsphere-mode-type\shardingsphere-cluster-mode\shardingsphere-cluster-mode-core\src\main\java\org\apache\shardingsphere\mode\manager\cluster\coordinator\registry\status\compute\ComputeNodeStatus.java,0,4,0,2,0,6
 shardingsphere-master\shardingsphere-master\examples\shardingsphere-jdbc-example\mixed-feature-example\sharding-readwrite-splitting-example\sharding-readwrite-splitting-spring-namespace-jpa-example\src\main\java\org\apache\shardingsphere\example\sharding\readwrite\splitting\spring\namespace\jpa\ShardingReadwriteSplittingSpringNamespaceJpaExample.java,0,9,1,5,0,15
 shardingsphere-master\shardingsphere-master\shardingsphere-infra\shardingsphere-infra-common\src\test\java\org\apache\shardingsphere\infra\yaml\config\swapper\fixture\YamlRuleConfigurationFixture.java,0,4,0,2,0,6
 shardingsphere-master\shardingsphere-master\shardingsphere-mode\shardingsphere-mode-type\shardingsphere-cluster-mode\shardingsphere-cluster-mode-core\src\main\java\org\apache\shardingsphere\mode\manager\cluster\coordinator\registry\config\watcher\GlobalRuleChangedWatcher.java,0,12,0,14,0,26
 shardingsphere-master\shardingsphere-master\shardingsphere-test\shardingsphere-parser-test\src\main\java\org\apache\shardingsphere\test\sql\parser\parameterized\jaxb\cases\domain\segment\impl\distsql\rdl\ExpectedShardingKeyGenerator.java,0,5,0,5,0,10
 shardingsphere-master\shardingsphere-master\shardingsphere-sql-parser\shardingsphere-sql-parser-dialect\shardingsphere-sql-parser-sqlserver\src\main\java\org\apache\shardingsphere\sql\parser\sqlserver\visitor\statement\impl\SQLServerDCLStatementSQLVisitor.java,0,97,1,119,0,217
 shardingsphere-master\shardingsphere-master\shardingsphere-kernel\shardingsphere-transaction\shardingsphere-transaction-type\shardingsphere-transaction-xa\shardingsphere-transaction-xa-provider\shardingsphere-transaction-xa-bitronix\src\main\java\org\apache\shardingsphere\transaction\xa\bitronix\manager\BitronixRecoveryResource.java,0,21,3,5,0,29
 shardingsphere-master\shardingsphere-master\shardingsphere-test\shardingsphere-parser-test\src\main\java\org\apache\shardingsphere\test\sql\parser\parameterized\jaxb\cases\domain\statement\dal\ShowTriggersStatementTestCase.java,0,4,0,5,0,9
 shardingsphere-master\shardingsphere-master\shardingsphere-test\shardingsphere-parser-test\src\main\java\org\apache\shardingsphere\test\sql\parser\parameterized\jaxb\cases\domain\statement\distsql\rdl\create\CreateShardingScalingRuleStatementTestCase.java,0,4,0,6,0,10
 shardingsphere-master\shardingsphere-master\shardingsphere-sql-parser\shardingsphere-sql-parser-statement\src\main\java\org\apache\shardingsphere\sql\parser\sql\dialect\statement\sql92\ddl\SQL92CreateTableStatement.java,0,1,0,4,0,5
 shardingsphere-master\shardingsphere-master\shardingsphere-proxy\shardingsphere-proxy-backend\src\main\java\org\apache\shardingsphere\proxy\backend\response\header\query\QueryHeaderBuilderFactory.java,0,12,0,7,0,19
 shardingsphere-master\shardingsphere-master\shardingsphere-features\shardingsphere-encrypt\shardingsphere-encrypt-core\src\test\java\org\apache\shardingsphere\encrypt\context\EncryptContextBuilderTest.java,0,26,0,19,0,45
 shardingsphere-master\shardingsphere-master\shardingsphere-test\shardingsphere-pipeline-test\src\test\java\org\apache\shardingsphere\data\pipeline\core\util\JobConfigurationBuilder.java,0,8,0,14,0,22
 shardingsphere-master\shardingsphere-master\shardingsphere-proxy\shardingsphere-proxy-backend\src\test\java\org\apache\shardingsphere\proxy\backend\text\distsql\rql\SingleTableRulesQueryResultSetTest.java,0,9,0,7,0,16
 shardingsphere-master\shardingsphere-master\shardingsphere-infra\shardingsphere-infra-common\src\test\java\org\apache\shardingsphere\infra\fixture\TestShardingSphereRule.java,0,1,0,1,0,2
 shardingsphere-master\shardingsphere-master\shardingsphere-distsql\shardingsphere-distsql-parser\src\main\java\org\apache\shardingsphere\distsql\parser\core\common\CommonDistSQLStatementVisitor.java,0,131,3,176,0,310
 shardingsphere-master\shardingsphere-master\shardingsphere-distsql\shardingsphere-distsql-statement\src\main\java\org\apache\shardingsphere\distsql\parser\statement\rql\show\ShowResourcesStatement.java,0,4,0,4,0,8
 shardingsphere-master\shardingsphere-master\examples\shardingsphere-proxy-example\shardingsphere-proxy-distsql-example\src\main\java\org\apache\shardingsphere\example\proxy\distsql\hint\HintType.java,0,11,0,4,0,15
 shardingsphere-master\shardingsphere-master\shardingsphere-test\shardingsphere-parser-test\src\main\java\org\apache\shardingsphere\test\sql\parser\parameterized\jaxb\cases\domain\statement\ddl\AssociateStatisticsStatementTestCase.java,0,15,0,11,0,26
 shardingsphere-master\shardingsphere-master\shardingsphere-agent\shardingsphere-agent-plugins\shardingsphere-agent-plugin-metrics\shardingsphere-agent-metrics-prometheus\src\test\java\org\apache\shardingsphere\agent\metrics\prometheus\wrapper\CounterWrapperTest.java,0,4,0,2,0,6
 shardingsphere-master\shardingsphere-master\shardingsphere-infra\shardingsphere-infra-executor\src\test\java\org\apache\shardingsphere\infra\executor\sql\hook\fixture\SQLExecutionHookFixture.java,0,12,0,3,0,15
 shardingsphere-master\shardingsphere-master\shardingsphere-kernel\shardingsphere-data-pipeline\shardingsphere-data-pipeline-dialect\shardingsphere-data-pipeline-postgresql\src\test\java\org\apache\shardingsphere\data\pipeline\postgresql\check\datasource\PostgreSQLDataSourceCheckerTest.java,0,29,1,9,0,39
 shardingsphere-master\shardingsphere-master\shardingsphere-kernel\shardingsphere-data-pipeline\shardingsphere-data-pipeline-spi\src\main\java\org\apache\shardingsphere\data\pipeline\spi\rulealtered\RuleAlteredDetector.java,0,8,0,5,0,13
 shardingsphere-master\shardingsphere-master\shardingsphere-proxy\shardingsphere-proxy-backend\src\main\java\org\apache\shardingsphere\proxy\backend\text\admin\mysql\executor\ShowConnectionIdExecutor.java,0,10,0,9,0,19
 shardingsphere-master\shardingsphere-master\shardingsphere-kernel\shardingsphere-data-pipeline\shardingsphere-data-pipeline-spi\src\main\java\org\apache\shardingsphere\data\pipeline\api\config\ingest\DumperConfiguration.java,14,8,0,3,0,11
 shardingsphere-master\shardingsphere-master\shardingsphere-features\shardingsphere-encrypt\shardingsphere-encrypt-core\src\main\java\org\apache\shardingsphere\encrypt\algorithm\SM4EncryptAlgorithm.java,0,57,3,19,0,79
 shardingsphere-master\shardingsphere-master\shardingsphere-db-protocol\shardingsphere-db-protocol-mysql\src\main\java\org\apache\shardingsphere\db\protocol\mysql\packet\binlog\MySQLBinlogEventPacket.java,0,2,0,2,0,4
 shardingsphere-master\shardingsphere-master\shardingsphere-test\shardingsphere-pipeline-test\src\test\java\org\apache\shardingsphere\data\pipeline\core\task\InventoryTaskTest.java,0,33,0,31,0,64
 shardingsphere-master\shardingsphere-master\shardingsphere-sql-parser\shardingsphere-sql-parser-statement\src\main\java\org\apache\shardingsphere\sql\parser\sql\common\statement\ddl\AlterFunctionStatement.java,3,1,1,3,0,5
 shardingsphere-master\shardingsphere-master\shardingsphere-features\shardingsphere-sharding\shardingsphere-sharding-core\src\main\java\org\apache\shardingsphere\sharding\algorithm\sharding\range\AbstractRangeShardingAlgorithm.java,0,26,1,16,0,43
 shardingsphere-master\shardingsphere-master\shardingsphere-sql-parser\shardingsphere-sql-parser-statement\src\main\java\org\apache\shardingsphere\sql\parser\sql\common\segment\ddl\CreateDefinitionSegment.java,0,0,0,1,0,1
 shardingsphere-master\shardingsphere-master\shardingsphere-infra\shardingsphere-infra-common\src\main\java\org\apache\shardingsphere\infra\datasource\props\DataSourceProperties.java,0,33,0,20,0,53
 shardingsphere-master\shardingsphere-master\shardingsphere-sql-parser\shardingsphere-sql-parser-statement\src\main\java\org\apache\shardingsphere\sql\parser\sql\dialect\statement\opengauss\tcl\OpenGaussBeginTransactionStatement.java,0,2,0,5,0,7
 shardingsphere-master\shardingsphere-master\shardingsphere-mode\shardingsphere-mode-core\src\main\java\org\apache\shardingsphere\mode\manager\ContextManagerBuilder.java,0,2,0,2,0,4
 shardingsphere-master\shardingsphere-master\shardingsphere-features\shardingsphere-sharding\shardingsphere-sharding-api\src\main\java\org\apache\shardingsphere\sharding\api\sharding\hint\HintShardingAlgorithm.java,0,6,0,3,0,9
 shardingsphere-master\shardingsphere-master\shardingsphere-features\shardingsphere-sharding\shardingsphere-sharding-core\src\main\java\org\apache\shardingsphere\sharding\rewrite\token\generator\impl\RowCountTokenGenerator.java,0,9,0,13,0,22
 shardingsphere-master\shardingsphere-master\shardingsphere-sql-parser\shardingsphere-sql-parser-statement\src\main\java\org\apache\shardingsphere\sql\parser\sql\dialect\statement\postgresql\ddl\PostgreSQLDropSchemaStatement.java,0,1,0,6,0,7
 shardingsphere-master\shardingsphere-master\shardingsphere-mode\shardingsphere-mode-type\shardingsphere-cluster-mode\shardingsphere-cluster-mode-core\src\test\java\org\apache\shardingsphere\mode\manager\cluster\coordinator\fixture\ClusterPersistRepositoryFixture.java,0,18,8,8,0,34
 shardingsphere-master\shardingsphere-master\shardingsphere-mode\shardingsphere-mode-type\shardingsphere-standalone-mode\shardingsphere-standalone-mode-repository\shardingsphere-standalone-mode-repository-provider\shardingsphere-standalone-mode-repository-h2\src\test\java\org\apache\shardingsphere\mode\repository\standalone\h2\H2RepositoryTest.java,0,9,0,1,0,10
 shardingsphere-master\shardingsphere-master\shardingsphere-features\shardingsphere-sharding\shardingsphere-sharding-core\src\main\java\org\apache\shardingsphere\sharding\rewrite\token\generator\impl\keygen\GeneratedKeyAssignmentTokenGenerator.java,0,14,0,19,0,33
 shardingsphere-master\shardingsphere-master\shardingsphere-sql-parser\shardingsphere-sql-parser-statement\src\main\java\org\apache\shardingsphere\sql\parser\sql\dialect\statement\postgresql\ddl\PostgreSQLAlterDefaultPrivilegesStatement.java,0,1,0,5,0,6
 shardingsphere-master\shardingsphere-master\shardingsphere-sql-parser\shardingsphere-sql-parser-statement\src\main\java\org\apache\shardingsphere\sql\parser\sql\common\statement\ddl\AlterTablespaceStatement.java,3,1,1,3,0,5
 shardingsphere-master\shardingsphere-master\shardingsphere-agent\shardingsphere-agent-plugins\shardingsphere-agent-plugin-metrics\shardingsphere-agent-metrics-prometheus\src\main\java\org\apache\shardingsphere\agent\metrics\prometheus\wrapper\GaugeWrapper.java,0,6,0,1,0,7
 shardingsphere-master\shardingsphere-master\shardingsphere-db-protocol\shardingsphere-db-protocol-mysql\src\test\java\org\apache\shardingsphere\db\protocol\mysql\packet\command\MySQLCommandPacketTypeLoaderTest.java,0,7,0,3,0,10
 shardingsphere-master\shardingsphere-master\shardingsphere-test\shardingsphere-rewrite-test\src\test\java\org\apache\shardingsphere\sharding\rewrite\parameterized\scenario\MixSQLRewriterParameterizedTest.java,0,28,7,20,0,55
 shardingsphere-master\shardingsphere-master\shardingsphere-kernel\shardingsphere-data-pipeline\shardingsphere-data-pipeline-dialect\shardingsphere-data-pipeline-postgresql\src\main\java\org\apache\shardingsphere\data\pipeline\postgresql\ingest\wal\decode\BaseLogSequenceNumber.java,0,2,0,1,0,3
 shardingsphere-master\shardingsphere-master\shardingsphere-mode\shardingsphere-mode-core\src\main\java\org\apache\shardingsphere\mode\manager\ContextManagerBuilderParameter.java,0,15,0,2,0,17
 shardingsphere-master\shardingsphere-master\shardingsphere-infra\shardingsphere-infra-common\src\test\java\org\apache\shardingsphere\infra\yaml\config\swapper\YamlDataSourcePropertiesSwapperTest.java,0,21,0,8,0,29
 shardingsphere-master\shardingsphere-master\shardingsphere-sql-parser\shardingsphere-sql-parser-statement\src\main\java\org\apache\shardingsphere\sql\parser\sql\common\value\literal\impl\BooleanLiteralValue.java,0,7,0,2,0,9
 shardingsphere-master\shardingsphere-master\shardingsphere-features\shardingsphere-db-discovery\shardingsphere-db-discovery-distsql\shardingsphere-db-discovery-distsql-handler\src\main\java\org\apache\shardingsphere\dbdiscovery\distsql\handler\query\DatabaseDiscoveryRuleQueryResultSet.java,0,48,1,27,0,76
 shardingsphere-master\shardingsphere-master\shardingsphere-test\shardingsphere-integration-test\shardingsphere-integration-test-suite\src\test\java\org\apache\shardingsphere\test\integration\engine\dal\GeneralDALIT.java,0,7,0,6,0,13
 shardingsphere-master\shardingsphere-master\shardingsphere-db-protocol\shardingsphere-db-protocol-postgresql\src\main\java\org\apache\shardingsphere\db\protocol\postgresql\packet\command\PostgreSQLCommandPacketType.java,0,35,0,9,0,44
 shardingsphere-master\shardingsphere-master\shardingsphere-test\shardingsphere-parser-test\src\main\java\org\apache\shardingsphere\test\sql\parser\parameterized\asserts\segment\show\ShowFilterAssert.java,0,8,0,12,0,20
 shardingsphere-master\shardingsphere-master\shardingsphere-kernel\shardingsphere-data-pipeline\shardingsphere-data-pipeline-dialect\shardingsphere-data-pipeline-postgresql\src\test\java\org\apache\shardingsphere\data\pipeline\postgresql\ingest\wal\LogicalReplicationTest.java,0,33,1,15,0,49
 shardingsphere-master\shardingsphere-master\shardingsphere-test\shardingsphere-integration-test\shardingsphere-integration-test-suite\src\test\java\org\apache\shardingsphere\test\integration\engine\SingleITCase.java,30,16,0,7,0,23
 shardingsphere-master\shardingsphere-master\shardingsphere-infra\shardingsphere-infra-common\src\test\java\org\apache\shardingsphere\infra\metadata\schema\loader\dialect\PostgreSQLTableMetaDataLoaderTest.java,0,51,14,30,0,95
 shardingsphere-master\shardingsphere-master\shardingsphere-kernel\shardingsphere-parser\shardingsphere-parser-api\src\main\java\org\apache\shardingsphere\parser\config\SQLParserRuleConfiguration.java,9,7,0,1,0,8
 shardingsphere-master\shardingsphere-master\shardingsphere-jdbc\shardingsphere-jdbc-core\src\test\java\org\apache\shardingsphere\driver\jdbc\core\statement\EncryptStatementTest.java,0,78,10,26,0,114
 shardingsphere-master\shardingsphere-master\shardingsphere-infra\shardingsphere-infra-common\src\main\java\org\apache\shardingsphere\infra\distsql\exception\resource\RequiredResourceMissedException.java,0,11,0,5,0,16
 shardingsphere-master\shardingsphere-master\shardingsphere-test\shardingsphere-parser-test\src\main\java\org\apache\shardingsphere\test\sql\parser\parameterized\jaxb\sql\loader\SQLCasesLoader.java,0,36,0,25,0,61
 shardingsphere-master\shardingsphere-master\shardingsphere-infra\shardingsphere-infra-rewrite\src\main\java\org\apache\shardingsphere\infra\rewrite\parameter\builder\impl\StandardParameterBuilder.java,0,17,0,7,0,24
 shardingsphere-master\shardingsphere-master\shardingsphere-test\shardingsphere-integration-scaling-test\shardingsphere-integration-scaling-test-mysql\src\test\java\org\apache\shardingsphere\integration\scaling\test\mysql\ScalingIT.java,0,18,0,8,0,26
 shardingsphere-master\shardingsphere-master\shardingsphere-mode\shardingsphere-mode-core\src\test\java\org\apache\shardingsphere\mode\metadata\fixture\FixtureRuleBuilder.java,0,7,0,4,0,11
 shardingsphere-master\shardingsphere-master\shardingsphere-sql-parser\shardingsphere-sql-parser-statement\src\main\java\org\apache\shardingsphere\sql\parser\sql\common\segment\dml\expr\FunctionSegment.java,0,12,0,3,3,18
 shardingsphere-master\shardingsphere-master\shardingsphere-jdbc\shardingsphere-jdbc-core\src\test\java\org\apache\shardingsphere\driver\jdbc\adapter\AbstractDataSourceAdapterTest.java,0,16,0,9,0,25
 shardingsphere-master\shardingsphere-master\shardingsphere-agent\shardingsphere-agent-plugins\shardingsphere-agent-plugin-tracing\shardingsphere-agent-tracing-zipkin\src\test\java\org\apache\shardingsphere\agent\plugin\tracing\zipkin\advice\SQLParserEngineAdviceTest.java,0,24,0,14,0,38
 shardingsphere-master\shardingsphere-master\shardingsphere-test\shardingsphere-parser-test\src\main\java\org\apache\shardingsphere\test\sql\parser\parameterized\jaxb\cases\domain\statement\distsql\rdl\create\CreateReadwriteSplittingRuleStatementTestCase.java,0,3,0,5,0,8
 shardingsphere-master\shardingsphere-master\shardingsphere-test\shardingsphere-parser-test\src\main\java\org\apache\shardingsphere\test\sql\parser\parameterized\asserts\segment\orderby\OrderByItemAssert.java,0,30,0,40,0,70
 shardingsphere-master\shardingsphere-master\shardingsphere-kernel\shardingsphere-transaction\shardingsphere-transaction-type\shardingsphere-transaction-xa\shardingsphere-transaction-xa-core\src\test\java\org\apache\shardingsphere\transaction\xa\jta\datasource\swapper\DataSourceSwapperTest.java,0,9,0,4,0,13
 shardingsphere-master\shardingsphere-master\shardingsphere-agent\shardingsphere-agent-plugins\shardingsphere-agent-plugin-tracing\shardingsphere-agent-tracing-opentracing\src\main\java\org\apache\shardingsphere\agent\plugin\tracing\opentracing\span\OpenTracingErrorSpan.java,0,7,0,3,0,10
 shardingsphere-master\shardingsphere-master\shardingsphere-sql-parser\shardingsphere-sql-parser-statement\src\main\java\org\apache\shardingsphere\sql\parser\sql\dialect\statement\postgresql\ddl\PostgreSQLDropMaterializedViewStatement.java,0,1,0,5,0,6
 shardingsphere-master\shardingsphere-master\shardingsphere-features\shardingsphere-sharding\shardingsphere-sharding-core\src\main\java\org\apache\shardingsphere\sharding\merge\dql\groupby\aggregation\DistinctAverageAggregationUnit.java,0,11,2,1,0,14
 shardingsphere-master\shardingsphere-master\shardingsphere-features\shardingsphere-sharding\shardingsphere-sharding-core\src\main\java\org\apache\shardingsphere\sharding\route\engine\condition\ShardingConditions.java,0,79,1,58,0,138
 shardingsphere-master\shardingsphere-master\shardingsphere-infra\shardingsphere-infra-rewrite\src\main\java\org\apache\shardingsphere\infra\rewrite\sql\token\pojo\SQLToken.java,10,3,0,1,0,4
 shardingsphere-master\shardingsphere-master\shardingsphere-db-protocol\shardingsphere-db-protocol-mysql\src\main\java\org\apache\shardingsphere\db\protocol\mysql\packet\binlog\MySQLBinlogEventHeader.java,0,18,0,2,0,20
 shardingsphere-master\shardingsphere-master\shardingsphere-kernel\shardingsphere-data-pipeline\shardingsphere-data-pipeline-core\src\main\java\org\apache\shardingsphere\data\pipeline\core\job\progress\yaml\JobProgressYamlSwapper.java,0,34,0,30,0,64
 shardingsphere-master\shardingsphere-master\shardingsphere-kernel\shardingsphere-transaction\shardingsphere-transaction-type\shardingsphere-transaction-xa\shardingsphere-transaction-xa-core\src\test\java\org\apache\shardingsphere\transaction\xa\jta\datasource\swapper\impl\HikariCPPropertyProviderTest.java,0,12,0,5,0,17
 shardingsphere-master\shardingsphere-master\shardingsphere-sql-parser\shardingsphere-sql-parser-statement\src\main\java\org\apache\shardingsphere\sql\parser\sql\common\constant\ParameterMarkerType.java,0,5,0,1,0,6
 shardingsphere-master\shardingsphere-master\shardingsphere-sql-parser\shardingsphere-sql-parser-statement\src\main\java\org\apache\shardingsphere\sql\parser\sql\dialect\statement\postgresql\ddl\PostgreSQLPrepareStatement.java,0,1,0,5,0,6
 shardingsphere-master\shardingsphere-master\shardingsphere-sql-parser\shardingsphere-sql-parser-dialect\shardingsphere-sql-parser-postgresql\src\main\java\org\apache\shardingsphere\sql\parser\postgresql\visitor\statement\impl\PostgreSQLDALStatementSQLVisitor.java,0,23,0,36,0,59
 shardingsphere-master\shardingsphere-master\shardingsphere-jdbc\shardingsphere-jdbc-core\src\test\java\org\apache\shardingsphere\driver\state\circuit\connection\CircuitBreakerConnectionTest.java,0,51,0,18,0,69
 shardingsphere-master\shardingsphere-master\shardingsphere-features\shardingsphere-shadow\shardingsphere-shadow-distsql\shardingsphere-shadow-distsql-statement\src\main\java\org\apache\shardingsphere\shadow\distsql\parser\segment\ShadowRuleSegment.java,0,9,0,2,0,11
 shardingsphere-master\shardingsphere-master\examples\shardingsphere-proxy-example\shardingsphere-proxy-distsql-example\src\main\java\org\apache\shardingsphere\example\proxy\distsql\hint\impl\SetShardingExecutor.java,0,12,3,4,0,19
 shardingsphere-master\shardingsphere-master\shardingsphere-features\shardingsphere-sharding\shardingsphere-sharding-core\src\test\java\org\apache\shardingsphere\sharding\rewrite\token\ProjectionsTokenGeneratorTest.java,0,54,0,55,0,109
 shardingsphere-master\shardingsphere-master\shardingsphere-infra\shardingsphere-infra-federation\shardingsphere-infra-federation-optimizer\src\main\java\org\apache\shardingsphere\infra\federation\optimizer\converter\segment\orderby\item\ColumnOrderByItemConverter.java,0,16,0,19,0,35
 shardingsphere-master\shardingsphere-master\shardingsphere-test\shardingsphere-parser-test\src\main\java\org\apache\shardingsphere\test\sql\parser\parameterized\asserts\segment\assignment\AssignmentValueAssert.java,0,11,0,22,0,33
 shardingsphere-master\shardingsphere-master\shardingsphere-features\shardingsphere-shadow\shardingsphere-shadow-core\src\test\java\org\apache\shardingsphere\shadow\yaml\swapper\table\ShadowTableConfigurationYamlSwapperTest.java,0,16,0,15,0,31
 shardingsphere-master\shardingsphere-master\shardingsphere-infra\shardingsphere-infra-executor\src\main\java\org\apache\shardingsphere\infra\executor\sql\context\ExecutionUnit.java,0,4,0,1,0,5
 shardingsphere-master\shardingsphere-master\shardingsphere-infra\shardingsphere-infra-binder\src\main\java\org\apache\shardingsphere\infra\binder\segment\select\pagination\PaginationContext.java,0,43,0,20,0,63
 shardingsphere-master\shardingsphere-master\shardingsphere-kernel\shardingsphere-data-pipeline\shardingsphere-data-pipeline-core\src\main\java\org\apache\shardingsphere\data\pipeline\core\metadata\model\PipelineColumnMetaData.java,0,15,0,2,0,17
 shardingsphere-master\shardingsphere-master\shardingsphere-proxy\shardingsphere-proxy-backend\src\main\java\org\apache\shardingsphere\proxy\backend\communication\vertx\transaction\VertxLocalTransactionManager.java,0,18,0,10,0,28
 shardingsphere-master\shardingsphere-master\shardingsphere-infra\shardingsphere-infra-common\src\main\java\org\apache\shardingsphere\infra\database\metadata\dialect\SQLServerDataSourceMetaData.java,0,21,0,4,0,25
 shardingsphere-master\shardingsphere-master\shardingsphere-features\shardingsphere-encrypt\shardingsphere-encrypt-core\src\test\java\org\apache\shardingsphere\encrypt\merge\dal\impl\DecoratedEncryptColumnsMergedResultTest.java,0,7,0,9,0,16
 shardingsphere-master\shardingsphere-master\shardingsphere-kernel\shardingsphere-single-table\shardingsphere-single-table-core\src\test\java\org\apache\shardingsphere\singletable\rule\SingleTableDataNodeLoaderTest.java,0,52,3,32,0,87
 shardingsphere-master\shardingsphere-master\shardingsphere-features\shardingsphere-shadow\shardingsphere-shadow-core\src\main\java\org\apache\shardingsphere\shadow\algorithm\shadow\column\AbstractColumnMatchShadowAlgorithm.java,0,30,0,14,0,44
 shardingsphere-master\shardingsphere-master\shardingsphere-features\shardingsphere-sharding\shardingsphere-sharding-core\src\test\java\org\apache\shardingsphere\sharding\route\engine\condition\generator\impl\ConditionValueBetweenOperatorGeneratorTest.java,0,66,0,56,0,122
 shardingsphere-master\shardingsphere-master\shardingsphere-infra\shardingsphere-infra-binder\src\main\java\org\apache\shardingsphere\infra\binder\LogicSQL.java,0,7,0,1,0,8
 shardingsphere-master\shardingsphere-master\shardingsphere-sql-parser\shardingsphere-sql-parser-statement\src\main\java\org\apache\shardingsphere\sql\parser\sql\dialect\statement\sql92\tcl\SQL92SetTransactionStatement.java,0,1,0,4,0,5
 shardingsphere-master\shardingsphere-master\shardingsphere-kernel\shardingsphere-data-pipeline\shardingsphere-data-pipeline-spi\src\main\java\org\apache\shardingsphere\data\pipeline\spi\importer\Importer.java,0,1,0,1,0,2
 shardingsphere-master\shardingsphere-master\shardingsphere-infra\shardingsphere-infra-common\src\main\java\org\apache\shardingsphere\infra\rule\builder\schema\SchemaRulesBuilder.java,0,33,0,27,0,60
 shardingsphere-master\shardingsphere-master\shardingsphere-sql-parser\shardingsphere-sql-parser-statement\src\main\java\org\apache\shardingsphere\sql\parser\sql\common\segment\ddl\index\IndextypeSegment.java,0,4,0,4,1,9
 shardingsphere-master\shardingsphere-master\shardingsphere-agent\shardingsphere-agent-plugins\shardingsphere-agent-plugin-tracing\shardingsphere-agent-tracing-zipkin\src\test\java\org\apache\shardingsphere\agent\plugin\tracing\zipkin\advice\JDBCExecutorCallbackAdviceTest.java,0,24,2,18,0,44
 shardingsphere-master\shardingsphere-master\shardingsphere-agent\shardingsphere-agent-core\src\test\java\org\apache\shardingsphere\agent\core\plugin\interceptor\ClassStaticMethodAroundInterceptorTest.java,0,30,0,11,0,41
 shardingsphere-master\shardingsphere-master\shardingsphere-features\shardingsphere-shadow\shardingsphere-shadow-distsql\shardingsphere-shadow-distsql-handler\src\main\java\org\apache\shardingsphere\shadow\distsql\handler\update\CreateShadowAlgorithmStatementUpdater.java,0,31,0,28,0,59
 shardingsphere-master\shardingsphere-master\shardingsphere-distsql\shardingsphere-distsql-statement\src\main\java\org\apache\shardingsphere\distsql\parser\statement\ral\common\updatable\AlterTransactionRuleStatement.java,0,4,0,3,0,7
 shardingsphere-master\shardingsphere-master\shardingsphere-features\shardingsphere-sharding\shardingsphere-sharding-distsql\shardingsphere-sharding-distsql-handler\src\test\java\org\apache\shardingsphere\sharding\distsql\query\ShowShardingTableRulesUsedAlgorithmQueryResultSetTest.java,0,26,0,31,0,57
 shardingsphere-master\shardingsphere-master\shardingsphere-db-protocol\shardingsphere-db-protocol-postgresql\src\main\java\org\apache\shardingsphere\db\protocol\postgresql\packet\command\query\extended\bind\protocol\PostgreSQLInt4BinaryProtocolValue.java,0,7,0,6,0,13
 shardingsphere-master\shardingsphere-master\shardingsphere-infra\shardingsphere-infra-federation\shardingsphere-infra-federation-optimizer\src\main\java\org\apache\shardingsphere\infra\federation\optimizer\context\parser\dialect\impl\OpenGaussOptimizerBuilder.java,0,6,0,7,0,13
 shardingsphere-master\shardingsphere-master\examples\example-core\example-api\src\main\java\org\apache\shardingsphere\example\core\api\entity\Order.java,50,40,0,2,0,42
 shardingsphere-master\shardingsphere-master\shardingsphere-infra\shardingsphere-infra-common\src\main\java\org\apache\shardingsphere\infra\metadata\schema\loader\dialect\MySQLTableMetaDataLoader.java,0,59,0,39,0,98
 shardingsphere-master\shardingsphere-master\shardingsphere-kernel\shardingsphere-traffic\shardingsphere-traffic-core\src\test\java\org\apache\shardingsphere\traffic\algorithm\traffic\hint\SQLHintTrafficAlgorithmTest.java,0,13,0,3,0,16
 shardingsphere-master\shardingsphere-master\shardingsphere-test\shardingsphere-parser-test\src\main\java\org\apache\shardingsphere\test\sql\parser\parameterized\asserts\statement\distsql\rdl\create\impl\CreateShardingScalingRuleStatementAssert.java,0,34,0,39,0,73
 shardingsphere-master\shardingsphere-master\shardingsphere-kernel\shardingsphere-traffic\shardingsphere-traffic-core\src\main\java\org\apache\shardingsphere\traffic\rule\builder\DefaultTrafficRuleConfigurationBuilder.java,0,5,0,3,0,8
 shardingsphere-master\shardingsphere-master\shardingsphere-infra\shardingsphere-infra-common\src\test\java\org\apache\shardingsphere\infra\metadata\schema\loader\common\IndexMetaDataLoaderTest.java,0,6,2,3,0,11
 shardingsphere-master\shardingsphere-master\shardingsphere-proxy\shardingsphere-proxy-bootstrap\src\main\java\org\apache\shardingsphere\proxy\database\DatabaseServerInfo.java,0,10,0,3,0,13
 shardingsphere-master\shardingsphere-master\examples\shardingsphere-jdbc-example\single-feature-example\cluster-mode-example\cluster-mode-raw-jdbc-example\src\main\java\org\apache\shardingsphere\example\cluster\mode\raw\jdbc\config\local\LocalShardingTablesConfiguration.java,0,21,0,15,0,36
 shardingsphere-master\shardingsphere-master\shardingsphere-kernel\shardingsphere-transaction\shardingsphere-transaction-type\shardingsphere-transaction-xa\shardingsphere-transaction-xa-provider\shardingsphere-transaction-xa-atomikos\src\test\java\org\apache\shardingsphere\transaction\xa\atomikos\manager\fixture\ReflectiveUtil.java,0,6,1,2,0,9
 shardingsphere-master\shardingsphere-master\shardingsphere-proxy\shardingsphere-proxy-frontend\shardingsphere-proxy-frontend-core\src\test\java\org\apache\shardingsphere\proxy\frontend\connection\ConnectionLimitContextTest.java,0,14,0,5,0,19
 shardingsphere-master\shardingsphere-master\shardingsphere-infra\shardingsphere-infra-common\src\main\java\org\apache\shardingsphere\infra\distsql\exception\rule\RequiredRuleMissedException.java,0,25,0,10,0,35
 shardingsphere-master\shardingsphere-master\shardingsphere-sql-parser\shardingsphere-sql-parser-statement\src\main\java\org\apache\shardingsphere\sql\parser\sql\dialect\statement\opengauss\tcl\OpenGaussSetTransactionStatement.java,0,1,0,5,0,6
 shardingsphere-master\shardingsphere-master\shardingsphere-agent\shardingsphere-agent-plugins\shardingsphere-agent-plugin-metrics\shardingsphere-agent-metrics-prometheus\src\test\java\org\apache\shardingsphere\agent\metrics\prometheus\collector\BuildInfoCollectorTest.java,0,3,0,1,0,4
 shardingsphere-master\shardingsphere-master\shardingsphere-sql-parser\shardingsphere-sql-parser-statement\src\main\java\org\apache\shardingsphere\sql\parser\sql\common\statement\ddl\DropEventTriggerStatement.java,3,1,1,3,0,5
 shardingsphere-master\shardingsphere-master\shardingsphere-infra\shardingsphere-infra-parser\src\main\java\org\apache\shardingsphere\infra\parser\sql\SQLStatementParserEngineFactory.java,0,9,0,5,0,14
 shardingsphere-master\shardingsphere-master\shardingsphere-agent\shardingsphere-agent-api\src\main\java\org\apache\shardingsphere\agent\spi\definition\AbstractPluginDefinitionService.java,29,11,0,6,0,17
 shardingsphere-master\shardingsphere-master\shardingsphere-test\shardingsphere-parser-test\src\test\java\org\apache\shardingsphere\test\sql\parser\parameterized\DistSQLParserParameterizedTest.java,0,21,0,15,0,36
 shardingsphere-master\shardingsphere-master\shardingsphere-agent\shardingsphere-agent-plugins\shardingsphere-agent-plugin-metrics\shardingsphere-agent-metrics-prometheus\src\test\java\org\apache\shardingsphere\agent\metrics\prometheus\util\ReflectiveUtil.java,0,8,1,5,0,14
 shardingsphere-master\shardingsphere-master\shardingsphere-sql-parser\shardingsphere-sql-parser-statement\src\main\java\org\apache\shardingsphere\sql\parser\sql\common\segment\dal\ShowLikeSegment.java,0,6,0,1,0,7
 shardingsphere-master\shardingsphere-master\shardingsphere-jdbc\shardingsphere-jdbc-core\src\main\java\org\apache\shardingsphere\driver\state\DriverState.java,0,2,0,1,0,3
 shardingsphere-master\shardingsphere-master\shardingsphere-db-protocol\shardingsphere-db-protocol-mysql\src\test\java\org\apache\shardingsphere\db\protocol\mysql\packet\binlog\MySQLBinlogEventHeaderTest.java,0,30,0,10,0,40
 shardingsphere-master\shardingsphere-master\shardingsphere-test\shardingsphere-parser-test\src\main\java\org\apache\shardingsphere\test\sql\parser\parameterized\jaxb\cases\domain\statement\ddl\DropGroupStatementTestCase.java,0,0,0,3,0,3
 shardingsphere-master\shardingsphere-master\shardingsphere-kernel\shardingsphere-transaction\shardingsphere-transaction-type\shardingsphere-transaction-xa\shardingsphere-transaction-xa-core\src\main\java\org\apache\shardingsphere\transaction\xa\jta\datasource\properties\dialect\OracleXADataSourceDefinition.java,0,4,0,5,0,9
 shardingsphere-master\shardingsphere-master\shardingsphere-test\shardingsphere-parser-test\src\main\java\org\apache\shardingsphere\test\sql\parser\parameterized\asserts\statement\distsql\rdl\alter\impl\EnableShardingScalingRuleStatementAssert.java,0,8,0,10,0,18
 shardingsphere-master\shardingsphere-master\shardingsphere-infra\shardingsphere-infra-binder\src\test\java\org\apache\shardingsphere\infra\binder\statement\SQLStatementContextFactoryTest.java,0,38,0,40,0,78
 shardingsphere-master\shardingsphere-master\shardingsphere-sql-parser\shardingsphere-sql-parser-statement\src\main\java\org\apache\shardingsphere\sql\parser\sql\dialect\statement\postgresql\dml\PostgreSQLDeleteStatement.java,0,1,0,5,0,6
 shardingsphere-master\shardingsphere-master\shardingsphere-test\shardingsphere-parser-test\src\main\java\org\apache\shardingsphere\test\sql\parser\parameterized\asserts\statement\tcl\impl\SetTransactionStatementAssert.java,0,4,1,6,0,11
 shardingsphere-master\shardingsphere-master\shardingsphere-sql-parser\shardingsphere-sql-parser-engine\src\main\java\org\apache\shardingsphere\sql\parser\api\SQLVisitorEngine.java,0,15,0,10,1,26
 shardingsphere-master\shardingsphere-master\shardingsphere-sql-parser\shardingsphere-sql-parser-statement\src\main\java\org\apache\shardingsphere\sql\parser\sql\common\constant\LogicalOperator.java,0,8,0,2,0,10
 shardingsphere-master\shardingsphere-master\shardingsphere-infra\shardingsphere-infra-rewrite\src\main\java\org\apache\shardingsphere\infra\rewrite\sql\token\generator\OptionalSQLTokenGenerator.java,0,4,0,2,0,6
 shardingsphere-master\shardingsphere-master\shardingsphere-db-protocol\shardingsphere-db-protocol-mysql\src\test\java\org\apache\shardingsphere\db\protocol\mysql\packet\command\query\binary\execute\MySQLNullBitmapTest.java,0,25,0,3,0,28
 shardingsphere-master\shardingsphere-master\shardingsphere-features\shardingsphere-db-discovery\shardingsphere-db-discovery-distsql\shardingsphere-db-discovery-distsql-handler\src\test\java\org\apache\shardingsphere\dbdiscovery\distsql\handler\update\DropDatabaseDiscoveryRuleStatementUpdaterTest.java,0,54,0,40,0,94
 shardingsphere-master\shardingsphere-master\shardingsphere-test\shardingsphere-parser-test\src\main\java\org\apache\shardingsphere\test\sql\parser\parameterized\jaxb\cases\domain\statement\distsql\ral\ClearReadwriteSplittingHintStatementTestCase.java,0,1,0,4,0,5
 shardingsphere-master\shardingsphere-master\shardingsphere-infra\shardingsphere-infra-common\src\main\java\org\apache\shardingsphere\infra\metadata\schema\model\TableMetaData.java,0,30,3,10,0,43
 shardingsphere-master\shardingsphere-master\shardingsphere-agent\shardingsphere-agent-plugins\shardingsphere-agent-plugin-metrics\shardingsphere-agent-metrics-api\src\main\java\org\apache\shardingsphere\agent\metrics\api\util\MetricsUtil.java,0,3,0,1,0,4
 shardingsphere-master\shardingsphere-master\shardingsphere-features\shardingsphere-shadow\shardingsphere-shadow-spring\shardingsphere-shadow-spring-boot-starter\src\main\java\org\apache\shardingsphere\shadow\spring\boot\condition\ShadowSpringBootCondition.java,0,8,0,5,0,13
 shardingsphere-master\shardingsphere-master\shardingsphere-infra\shardingsphere-infra-common\src\test\java\org\apache\shardingsphere\infra\hint\SQLHintExtractorTest.java,0,14,0,9,0,23
 shardingsphere-master\shardingsphere-master\shardingsphere-test\shardingsphere-parser-test\src\main\java\org\apache\shardingsphere\test\sql\parser\parameterized\asserts\segment\generic\DataTypeAssert.java,0,7,0,9,0,16
 shardingsphere-master\shardingsphere-master\shardingsphere-sql-parser\shardingsphere-sql-parser-dialect\shardingsphere-sql-parser-postgresql\src\main\java\org\apache\shardingsphere\sql\parser\postgresql\parser\PostgreSQLParserFacade.java,0,4,0,2,0,6
 shardingsphere-master\shardingsphere-master\shardingsphere-db-protocol\shardingsphere-db-protocol-postgresql\src\test\java\org\apache\shardingsphere\db\protocol\postgresql\packet\command\query\extended\bind\PostgreSQLTypeUnspecifiedSQLParameterTest.java,0,3,0,3,0,6
 shardingsphere-master\shardingsphere-master\shardingsphere-proxy\shardingsphere-proxy-frontend\shardingsphere-proxy-frontend-spi\src\main\java\org\apache\shardingsphere\proxy\frontend\authentication\AuthenticationResult.java,0,8,0,1,0,9
 shardingsphere-master\shardingsphere-master\shardingsphere-test\shardingsphere-integration-test\shardingsphere-integration-test-suite\src\test\java\org\apache\shardingsphere\test\integration\cases\dataset\metadata\DataSetIndex.java,0,6,0,1,0,7
 shardingsphere-master\shardingsphere-master\shardingsphere-infra\shardingsphere-infra-federation\shardingsphere-infra-federation-optimizer\src\main\java\org\apache\shardingsphere\infra\federation\optimizer\metadata\FederationSchemaMetaData.java,0,14,3,4,0,21
 shardingsphere-master\shardingsphere-master\shardingsphere-infra\shardingsphere-infra-common\src\main\java\org\apache\shardingsphere\infra\metadata\schema\util\IndexMetaDataUtil.java,44,16,0,7,0,23
 shardingsphere-master\shardingsphere-master\shardingsphere-jdbc\shardingsphere-jdbc-core\src\main\java\org\apache\shardingsphere\driver\executor\batch\BatchExecutionUnit.java,0,15,0,6,0,21
 shardingsphere-master\shardingsphere-master\shardingsphere-test\shardingsphere-parser-test\src\main\java\org\apache\shardingsphere\test\sql\parser\parameterized\jaxb\cases\domain\statement\distsql\rdl\create\CreateShardingAutoTableRuleStatementTestCase.java,0,3,0,5,0,8
 shardingsphere-master\shardingsphere-master\shardingsphere-sql-parser\shardingsphere-sql-parser-statement\src\main\java\org\apache\shardingsphere\sql\parser\sql\common\constant\Paren.java,0,14,0,3,0,17
 shardingsphere-master\shardingsphere-master\shardingsphere-test\shardingsphere-parser-test\src\main\java\org\apache\shardingsphere\test\sql\parser\parameterized\jaxb\cases\domain\statement\dal\ResetStatementTestCase.java,0,2,0,4,0,6
 shardingsphere-master\shardingsphere-master\shardingsphere-features\shardingsphere-sharding\shardingsphere-sharding-core\src\test\java\org\apache\shardingsphere\sharding\swapper\rule\TableRuleConfigurationYamlSwapperTest.java,0,47,1,40,0,88
 shardingsphere-master\shardingsphere-master\shardingsphere-mode\shardingsphere-mode-type\shardingsphere-cluster-mode\shardingsphere-cluster-mode-core\src\test\java\org\apache\shardingsphere\mode\manager\cluster\coordinator\registry\config\watcher\PropertiesChangedWatcherTest.java,0,11,0,10,0,21
 shardingsphere-master\shardingsphere-master\shardingsphere-sql-parser\shardingsphere-sql-parser-statement\src\main\java\org\apache\shardingsphere\sql\parser\sql\common\segment\ddl\column\alter\DropColumnDefinitionSegment.java,0,7,0,5,2,14
 shardingsphere-master\shardingsphere-master\shardingsphere-infra\shardingsphere-infra-merge\src\test\java\org\apache\shardingsphere\infra\merge\result\impl\decorator\DecoratorMergedResultTest.java,0,18,0,5,0,23
 shardingsphere-master\shardingsphere-master\shardingsphere-sql-parser\shardingsphere-sql-parser-dialect\shardingsphere-sql-parser-opengauss\src\main\java\org\apache\shardingsphere\sql\parser\opengauss\visitor\statement\impl\OpenGaussTCLStatementSQLVisitor.java,0,16,0,24,0,40
 shardingsphere-master\shardingsphere-master\shardingsphere-proxy\shardingsphere-proxy-frontend\shardingsphere-proxy-frontend-postgresql\src\main\java\org\apache\shardingsphere\proxy\frontend\postgresql\authentication\exception\PostgreSQLProtocolViolationException.java,0,6,0,3,0,9
 shardingsphere-master\shardingsphere-master\shardingsphere-features\shardingsphere-shadow\shardingsphere-shadow-api\src\main\java\org\apache\shardingsphere\shadow\api\shadow\column\ColumnShadowAlgorithm.java,0,4,0,2,0,6
 shardingsphere-master\shardingsphere-master\shardingsphere-infra\shardingsphere-infra-federation\shardingsphere-infra-federation-optimizer\src\main\java\org\apache\shardingsphere\infra\federation\optimizer\converter\statement\SQLStatementConverter.java,0,6,0,3,0,9
 shardingsphere-master\shardingsphere-master\shardingsphere-infra\shardingsphere-infra-common\src\main\java\org\apache\shardingsphere\infra\config\scope\SchemaRuleConfiguration.java,0,0,0,1,0,1
 shardingsphere-master\shardingsphere-master\shardingsphere-sql-parser\shardingsphere-sql-parser-spi\src\main\java\org\apache\shardingsphere\sql\parser\api\parser\SQLParser.java,0,2,0,1,0,3
 shardingsphere-master\shardingsphere-master\shardingsphere-sql-parser\shardingsphere-sql-parser-statement\src\main\java\org\apache\shardingsphere\sql\parser\sql\dialect\statement\mysql\ddl\MySQLAlterProcedureStatement.java,0,1,0,4,0,5
 shardingsphere-master\shardingsphere-master\shardingsphere-test\shardingsphere-parser-test\src\main\java\org\apache\shardingsphere\test\sql\parser\parameterized\jaxb\cases\domain\segment\impl\index\ExpectedPartition.java,0,1,0,4,0,5
 shardingsphere-master\shardingsphere-master\shardingsphere-agent\shardingsphere-agent-plugins\shardingsphere-agent-plugin-tracing\shardingsphere-agent-tracing-opentracing\src\test\java\org\apache\shardingsphere\agent\plugin\tracing\opentracing\advice\CommandExecutorTaskAdviceTest.java,0,24,0,10,0,34
 shardingsphere-master\shardingsphere-master\shardingsphere-test\shardingsphere-parser-test\src\main\java\org\apache\shardingsphere\test\sql\parser\parameterized\asserts\statement\distsql\rql\impl\rule\ShowShardingBindingTableRulesStatementAssert.java,0,8,0,12,0,20
 shardingsphere-master\shardingsphere-master\shardingsphere-features\shardingsphere-sharding\shardingsphere-sharding-core\src\main\java\org\apache\shardingsphere\sharding\rewrite\token\generator\impl\IndexTokenGenerator.java,0,12,0,10,0,22
 shardingsphere-master\shardingsphere-master\shardingsphere-proxy\shardingsphere-proxy-backend\src\main\java\org\apache\shardingsphere\proxy\backend\response\header\query\impl\PostgreSQLQueryHeaderBuilder.java,0,13,0,10,0,23
 shardingsphere-master\shardingsphere-master\shardingsphere-sql-parser\shardingsphere-sql-parser-statement\src\main\java\org\apache\shardingsphere\sql\parser\sql\dialect\statement\opengauss\dml\OpenGaussUpdateStatement.java,0,1,0,5,0,6
 shardingsphere-master\shardingsphere-master\shardingsphere-test\shardingsphere-parser-test\src\main\java\org\apache\shardingsphere\test\sql\parser\parameterized\jaxb\cases\domain\statement\ddl\AlterExtensionStatementTestCase.java,0,0,0,3,0,3
 shardingsphere-master\shardingsphere-master\shardingsphere-mode\shardingsphere-mode-type\shardingsphere-cluster-mode\shardingsphere-cluster-mode-core\src\main\java\org\apache\shardingsphere\mode\manager\cluster\coordinator\lock\event\GlobalLockReleasedEvent.java,0,4,0,2,0,6
 shardingsphere-master\shardingsphere-master\shardingsphere-infra\shardingsphere-infra-executor\src\main\java\org\apache\shardingsphere\infra\executor\sql\execute\engine\driver\jdbc\sane\opengauss\OpenGaussSaneQueryResultEngine.java,0,5,0,6,0,11
 shardingsphere-master\shardingsphere-master\shardingsphere-sql-parser\shardingsphere-sql-parser-statement\src\main\java\org\apache\shardingsphere\sql\parser\sql\common\statement\ddl\DropAggregateStatement.java,3,1,1,3,0,5
 shardingsphere-master\shardingsphere-master\shardingsphere-test\shardingsphere-parser-test\src\main\java\org\apache\shardingsphere\test\sql\parser\parameterized\asserts\statement\dal\impl\CloneStatementAssert.java,0,11,0,15,0,26
 shardingsphere-master\shardingsphere-master\shardingsphere-features\shardingsphere-sharding\shardingsphere-sharding-core\src\main\java\org\apache\shardingsphere\sharding\route\engine\validator\dml\impl\ShardingUpdateStatementValidator.java,0,18,0,19,0,37
 shardingsphere-master\shardingsphere-master\shardingsphere-test\shardingsphere-parser-test\src\main\java\org\apache\shardingsphere\test\sql\parser\parameterized\asserts\statement\ddl\impl\DisassociateStatisticsStatementAssert.java,0,26,0,34,0,60
 shardingsphere-master\shardingsphere-master\examples\example-core\example-api\src\main\java\org\apache\shardingsphere\example\core\api\entity\User.java,40,31,0,2,0,33
 shardingsphere-master\shardingsphere-master\shardingsphere-test\shardingsphere-parser-test\src\main\java\org\apache\shardingsphere\test\sql\parser\parameterized\jaxb\cases\domain\statement\distsql\rql\CountSchemaRulesStatementTestCase.java,0,3,0,4,0,7
 shardingsphere-master\shardingsphere-master\shardingsphere-infra\shardingsphere-infra-common\src\main\java\org\apache\shardingsphere\infra\datasource\props\DataSourcePropertiesCreator.java,0,21,0,19,0,40
 shardingsphere-master\shardingsphere-master\shardingsphere-features\shardingsphere-sharding\shardingsphere-sharding-core\src\main\java\org\apache\shardingsphere\sharding\merge\dql\groupby\GroupByValue.java,0,7,0,5,0,12
 shardingsphere-master\shardingsphere-master\shardingsphere-test\shardingsphere-parser-test\src\main\java\org\apache\shardingsphere\test\sql\parser\parameterized\asserts\segment\with\WithClauseAssert.java,0,17,0,22,0,39
 shardingsphere-master\shardingsphere-master\shardingsphere-proxy\shardingsphere-proxy-backend\src\main\java\org\apache\shardingsphere\proxy\backend\text\admin\mysql\executor\UseDatabaseExecutor.java,0,7,0,7,0,14
 shardingsphere-master\shardingsphere-master\shardingsphere-proxy\shardingsphere-proxy-backend\src\test\java\org\apache\shardingsphere\proxy\backend\communication\jdbc\recognizer\impl\MySQLRecognizerTest.java,0,8,0,5,0,13
 shardingsphere-master\shardingsphere-master\shardingsphere-test\shardingsphere-parser-test\src\main\java\org\apache\shardingsphere\test\sql\parser\parameterized\jaxb\cases\domain\segment\impl\distsql\rdl\ExpectedDatabaseDiscoveryType.java,0,5,0,5,0,10
 shardingsphere-master\shardingsphere-master\shardingsphere-infra\shardingsphere-infra-executor\src\main\java\org\apache\shardingsphere\infra\executor\sql\execute\engine\raw\RawSQLExecutionUnit.java,0,6,0,3,0,9
 shardingsphere-master\shardingsphere-master\shardingsphere-agent\shardingsphere-agent-plugins\shardingsphere-agent-plugin-tracing\shardingsphere-agent-tracing-opentelemetry\src\test\java\org\apache\shardingsphere\agent\plugin\tracing\opentelemetry\definition\OpenTelemetryTracingPluginDefinitionServiceTest.java,0,10,0,3,0,13
 shardingsphere-master\shardingsphere-master\shardingsphere-proxy\shardingsphere-proxy-backend\src\test\java\org\apache\shardingsphere\proxy\backend\text\distsql\fixture\TestReplicaLoadBalanceAlgorithm.java,0,6,0,4,0,10
 shardingsphere-master\shardingsphere-master\shardingsphere-features\shardingsphere-encrypt\shardingsphere-encrypt-core\src\test\java\org\apache\shardingsphere\encrypt\rewrite\impl\EncryptOrderByItemTokenGeneratorTest.java,0,20,0,29,0,49
 shardingsphere-master\shardingsphere-master\shardingsphere-kernel\shardingsphere-authority\shardingsphere-authority-core\src\test\java\org\apache\shardingsphere\authority\provider\natived\builder\dialect\OraclePrivilegeHandlerTest.java,0,53,8,36,0,97
 shardingsphere-master\shardingsphere-master\shardingsphere-sql-parser\shardingsphere-sql-parser-statement\src\main\java\org\apache\shardingsphere\sql\parser\sql\dialect\statement\opengauss\ddl\OpenGaussDropConversionStatement.java,0,1,0,5,0,6
 shardingsphere-master\shardingsphere-master\shardingsphere-infra\shardingsphere-infra-common\src\main\java\org\apache\shardingsphere\infra\distsql\update\RuleDefinitionCreateUpdater.java,0,7,0,3,0,10
 shardingsphere-master\shardingsphere-master\shardingsphere-proxy\shardingsphere-proxy-backend\src\main\java\org\apache\shardingsphere\proxy\backend\communication\jdbc\datasource\JDBCBackendDataSource.java,0,28,1,25,0,54
 shardingsphere-master\shardingsphere-master\shardingsphere-features\shardingsphere-sharding\shardingsphere-sharding-distsql\shardingsphere-sharding-distsql-handler\src\main\java\org\apache\shardingsphere\scaling\distsql\handler\StartScalingUpdater.java,0,6,0,4,0,10
 shardingsphere-master\shardingsphere-master\shardingsphere-proxy\shardingsphere-proxy-backend\src\main\java\org\apache\shardingsphere\proxy\backend\config\ProxyGlobalConfiguration.java,0,6,0,1,0,7
 shardingsphere-master\shardingsphere-master\shardingsphere-kernel\shardingsphere-traffic\shardingsphere-traffic-core\src\test\java\org\apache\shardingsphere\traffic\rule\TrafficRuleTest.java,0,40,0,33,0,73
 shardingsphere-master\shardingsphere-master\shardingsphere-sql-parser\shardingsphere-sql-parser-statement\src\main\java\org\apache\shardingsphere\sql\parser\sql\dialect\statement\mysql\dal\MySQLShowIndexStatement.java,0,7,0,7,2,16
 shardingsphere-master\shardingsphere-master\shardingsphere-sql-parser\shardingsphere-sql-parser-dialect\shardingsphere-sql-parser-mysql\src\main\java\org\apache\shardingsphere\sql\parser\mysql\visitor\format\facade\MySQLFormatSQLVisitorFacade.java,0,9,0,7,0,16
 shardingsphere-master\shardingsphere-master\shardingsphere-test\shardingsphere-parser-test\src\main\java\org\apache\shardingsphere\test\sql\parser\parameterized\asserts\statement\ddl\impl\AssociateStatisticsStatementAssert.java,0,26,0,34,0,60
 shardingsphere-master\shardingsphere-master\shardingsphere-kernel\shardingsphere-data-pipeline\shardingsphere-data-pipeline-core\src\main\java\org\apache\shardingsphere\scaling\core\job\check\EnvironmentChecker.java,0,2,0,2,0,4
 shardingsphere-master\shardingsphere-master\shardingsphere-test\shardingsphere-parser-test\src\main\java\org\apache\shardingsphere\test\sql\parser\parameterized\asserts\statement\ddl\impl\AlterSystemStatementAssert.java,0,3,1,6,0,10
 shardingsphere-master\shardingsphere-master\shardingsphere-jdbc\shardingsphere-jdbc-spring\shardingsphere-jdbc-transaction-spring\src\main\java\org\apache\shardingsphere\spring\transaction\TransactionTypeScanner.java,0,4,0,2,0,6
 shardingsphere-master\shardingsphere-master\shardingsphere-kernel\shardingsphere-data-pipeline\shardingsphere-data-pipeline-spi\src\main\java\org\apache\shardingsphere\data\pipeline\api\ingest\record\DataRecord.java,0,22,0,2,0,24
 shardingsphere-master\shardingsphere-master\shardingsphere-features\shardingsphere-sharding\shardingsphere-sharding-distsql\shardingsphere-sharding-distsql-statement\src\main\java\org\apache\shardingsphere\sharding\distsql\parser\segment\BindingTableRuleSegment.java,0,5,0,2,0,7
 shardingsphere-master\shardingsphere-master\shardingsphere-sql-parser\shardingsphere-sql-parser-statement\src\main\java\org\apache\shardingsphere\sql\parser\sql\common\segment\dml\pagination\limit\NumberLiteralLimitValueSegment.java,0,7,0,5,0,12
 shardingsphere-master\shardingsphere-master\shardingsphere-proxy\shardingsphere-proxy-frontend\shardingsphere-proxy-frontend-core\src\test\java\org\apache\shardingsphere\proxy\frontend\command\CommandExecutorTaskTest.java,0,64,0,35,0,99
 shardingsphere-master\shardingsphere-master\shardingsphere-sql-parser\shardingsphere-sql-parser-statement\src\main\java\org\apache\shardingsphere\sql\parser\sql\common\statement\dml\TableStatement.java,3,1,1,3,0,5
 shardingsphere-master\shardingsphere-master\shardingsphere-features\shardingsphere-encrypt\shardingsphere-encrypt-spring\shardingsphere-encrypt-spring-boot-starter\src\main\java\org\apache\shardingsphere\encrypt\spring\boot\algorithm\EncryptAlgorithmProvidedBeanRegistry.java,0,8,0,5,0,13
 shardingsphere-master\shardingsphere-master\shardingsphere-sql-parser\shardingsphere-sql-parser-statement\src\main\java\org\apache\shardingsphere\sql\parser\sql\dialect\statement\mysql\dal\MySQLResetPersistStatement.java,0,4,0,6,0,10
 shardingsphere-master\shardingsphere-master\shardingsphere-sql-parser\shardingsphere-sql-parser-statement\src\main\java\org\apache\shardingsphere\sql\parser\sql\dialect\statement\mysql\dal\MySQLLoadIndexInfoStatement.java,0,4,0,7,1,12
 shardingsphere-master\shardingsphere-master\shardingsphere-test\shardingsphere-parser-test\src\main\java\org\apache\shardingsphere\test\sql\parser\parameterized\asserts\statement\distsql\rdl\create\impl\CreateDatabaseDiscoveryRuleStatementAssert.java,0,39,1,48,0,88
 shardingsphere-master\shardingsphere-master\shardingsphere-test\shardingsphere-parser-test\src\main\java\org\apache\shardingsphere\test\sql\parser\parameterized\jaxb\cases\domain\statement\distsql\rdl\create\CreateEncryptRuleStatementTestCase.java,0,3,0,5,0,8
 shardingsphere-master\shardingsphere-master\shardingsphere-proxy\shardingsphere-proxy-backend\src\main\java\org\apache\shardingsphere\proxy\backend\text\distsql\rdl\resource\DropResourceBackendHandler.java,0,37,0,35,0,72
 shardingsphere-master\shardingsphere-master\shardingsphere-features\shardingsphere-encrypt\shardingsphere-encrypt-core\src\main\java\org\apache\shardingsphere\encrypt\rewrite\token\pojo\EncryptInsertValuesToken.java,0,3,0,3,0,6
 shardingsphere-master\shardingsphere-master\examples\shardingsphere-example-generator\src\main\java\org\apache\shardingsphere\example\generator\scenario\feature\FeatureExampleScenario.java,0,1,0,1,0,2
 shardingsphere-master\shardingsphere-master\shardingsphere-features\shardingsphere-sharding\shardingsphere-sharding-core\src\test\java\org\apache\shardingsphere\sharding\algorithm\sharding\datetime\AutoIntervalShardingAlgorithmTest.java,0,84,0,41,0,125
 shardingsphere-master\shardingsphere-master\shardingsphere-infra\shardingsphere-infra-common\src\test\java\org\apache\shardingsphere\infra\yaml\config\swapper\fixture\YamlRuleConfigurationSwapperFixture.java,0,10,0,6,0,16
 shardingsphere-master\shardingsphere-master\shardingsphere-infra\shardingsphere-infra-parser\src\main\java\org\apache\shardingsphere\infra\parser\cache\SQLStatementCacheBuilder.java,0,7,0,5,0,12
 shardingsphere-master\shardingsphere-master\shardingsphere-test\shardingsphere-parser-test\src\main\java\org\apache\shardingsphere\test\sql\parser\parameterized\asserts\statement\distsql\ral\impl\scaling\update\RestoreScalingSourceWritingStatementAssert.java,0,13,1,15,0,29
 shardingsphere-master\shardingsphere-master\shardingsphere-jdbc\shardingsphere-jdbc-spring\shardingsphere-jdbc-spring-infra\shardingsphere-jdbc-spring-boot-starter-infra\src\test\java\org\apache\shardingsphere\spring\boot\datasource\DataSourceMapSetterTest.java,0,17,0,15,0,32
 shardingsphere-master\shardingsphere-master\shardingsphere-test\shardingsphere-integration-agent-test\shardingsphere-integration-agent-test-plugins\shardingsphere-integration-agent-test-metrics\src\test\java\org\apache\shardingsphere\integration\agent\test\metrics\result\MetricResult.java,17,12,0,1,0,13
 shardingsphere-master\shardingsphere-master\shardingsphere-features\shardingsphere-sharding\shardingsphere-sharding-core\src\main\java\org\apache\shardingsphere\sharding\rewrite\token\pojo\ShardingTokenGenerateBuilder.java,0,19,0,31,0,50
 shardingsphere-master\shardingsphere-master\shardingsphere-db-protocol\shardingsphere-db-protocol-postgresql\src\test\java\org\apache\shardingsphere\db\protocol\postgresql\packet\command\query\extended\bind\protocol\PostgreSQLBinaryProtocolValueFactoryTest.java,0,43,0,24,0,67
 shardingsphere-master\shardingsphere-master\shardingsphere-test\shardingsphere-parser-test\src\main\java\org\apache\shardingsphere\test\sql\parser\parameterized\jaxb\cases\domain\statement\distsql\ral\ClearShardingHintStatementTestCase.java,0,1,0,4,0,5
 shardingsphere-master\shardingsphere-master\shardingsphere-kernel\shardingsphere-transaction\shardingsphere-transaction-type\shardingsphere-transaction-xa\shardingsphere-transaction-xa-core\src\test\java\org\apache\shardingsphere\transaction\xa\jta\connection\XAConnectionWrapperFactoryTest.java,0,4,0,3,0,7
 shardingsphere-master\shardingsphere-master\shardingsphere-proxy\shardingsphere-proxy-frontend\shardingsphere-proxy-frontend-postgresql\src\main\java\org\apache\shardingsphere\proxy\frontend\postgresql\command\query\extended\parse\PostgreSQLComParseExecutor.java,0,23,0,24,0,47
 shardingsphere-master\shardingsphere-master\shardingsphere-proxy\shardingsphere-proxy-backend\src\main\java\org\apache\shardingsphere\proxy\backend\text\distsql\ral\common\exception\UnsupportedVariableException.java,0,3,0,2,0,5
 shardingsphere-master\shardingsphere-master\shardingsphere-kernel\shardingsphere-data-pipeline\shardingsphere-data-pipeline-dialect\shardingsphere-data-pipeline-postgresql\src\main\java\org\apache\shardingsphere\data\pipeline\postgresql\ingest\PostgreSQLPositionInitializer.java,0,35,0,20,0,55
 shardingsphere-master\shardingsphere-master\shardingsphere-infra\shardingsphere-infra-common\src\main\java\org\apache\shardingsphere\infra\datasource\props\synonym\PropertySynonyms.java,46,25,0,12,0,37
 shardingsphere-master\shardingsphere-master\shardingsphere-agent\shardingsphere-agent-plugins\shardingsphere-agent-plugin-tracing\shardingsphere-agent-tracing-opentracing\src\main\java\org\apache\shardingsphere\agent\plugin\tracing\opentracing\advice\SQLParserEngineAdvice.java,0,10,0,8,0,18
 shardingsphere-master\shardingsphere-master\examples\shardingsphere-jdbc-example\single-feature-example\shadow-example\shadow-raw-jdbc-example\src\main\java\org\apache\shardingsphere\example\shadow\raw\jdbc\config\ShadowConfiguration.java,0,12,0,9,0,21
 shardingsphere-master\shardingsphere-master\shardingsphere-features\shardingsphere-shadow\shardingsphere-shadow-core\src\main\java\org\apache\shardingsphere\shadow\yaml\config\YamlShadowRuleConfiguration.java,0,14,0,8,0,22
 shardingsphere-master\shardingsphere-master\shardingsphere-test\shardingsphere-parser-test\src\main\java\org\apache\shardingsphere\test\sql\parser\parameterized\jaxb\cases\domain\statement\ddl\DropMaterializedViewStatementTestCase.java,0,1,0,4,0,5
 shardingsphere-master\shardingsphere-master\shardingsphere-test\shardingsphere-parser-test\src\main\java\org\apache\shardingsphere\test\sql\parser\parameterized\jaxb\cases\domain\statement\distsql\rdl\create\CreateDatabaseDiscoveryTypeStatementTestCase.java,0,4,0,6,0,10
 shardingsphere-master\shardingsphere-master\shardingsphere-proxy\shardingsphere-proxy-backend\src\main\java\org\apache\shardingsphere\proxy\backend\communication\jdbc\connection\JDBCBackendConnection.java,0,70,6,39,0,115
 shardingsphere-master\shardingsphere-master\shardingsphere-test\shardingsphere-parser-test\src\main\java\org\apache\shardingsphere\test\sql\parser\parameterized\jaxb\cases\domain\statement\dal\ShowBinlogEventsStatementTestCase.java,0,4,0,4,0,8
 shardingsphere-master\shardingsphere-master\shardingsphere-sql-parser\shardingsphere-sql-parser-engine\src\main\java\org\apache\shardingsphere\sql\parser\core\database\visitor\SQLVisitorRule.java,0,434,0,7,0,441
 shardingsphere-master\shardingsphere-master\shardingsphere-features\shardingsphere-db-discovery\shardingsphere-db-discovery-core\src\main\java\org\apache\shardingsphere\dbdiscovery\yaml\swapper\DatabaseDiscoveryRuleAlgorithmProviderConfigurationYamlSwapper.java,0,34,0,33,0,67
 shardingsphere-master\shardingsphere-master\shardingsphere-features\shardingsphere-encrypt\shardingsphere-encrypt-core\src\main\java\org\apache\shardingsphere\encrypt\yaml\config\YamlEncryptRuleConfiguration.java,0,16,0,8,0,24
 shardingsphere-master\shardingsphere-master\shardingsphere-proxy\shardingsphere-proxy-backend\src\test\java\org\apache\shardingsphere\proxy\backend\response\data\QueryResponseRowTest.java,0,22,0,20,0,42
 shardingsphere-master\shardingsphere-master\shardingsphere-features\shardingsphere-sharding\shardingsphere-sharding-distsql\shardingsphere-sharding-distsql-handler\src\main\java\org\apache\shardingsphere\sharding\distsql\handler\update\AlterShardingTableRuleStatementUpdater.java,0,28,0,27,0,55
 shardingsphere-master\shardingsphere-master\shardingsphere-test\shardingsphere-parser-test\src\main\java\org\apache\shardingsphere\test\sql\parser\parameterized\asserts\statement\dal\impl\ShowProcedureCodeStatementAssert.java,0,5,0,9,0,14
 shardingsphere-master\shardingsphere-master\shardingsphere-agent\shardingsphere-agent-plugins\shardingsphere-agent-plugin-metrics\shardingsphere-agent-metrics-api\src\test\java\org\apache\shardingsphere\agent\metrics\api\MetricsWrapperTest.java,0,25,0,15,0,40
 shardingsphere-master\shardingsphere-master\shardingsphere-proxy\shardingsphere-proxy-frontend\shardingsphere-proxy-frontend-postgresql\src\main\java\org\apache\shardingsphere\proxy\frontend\postgresql\authentication\exception\PostgreSQLAuthenticationException.java,0,5,0,3,0,8
 shardingsphere-master\shardingsphere-master\shardingsphere-test\shardingsphere-parser-test\src\main\java\org\apache\shardingsphere\test\sql\parser\parameterized\jaxb\cases\domain\statement\distsql\rdl\alter\AlterShadowRuleStatementTestCase.java,0,2,0,4,0,6
 shardingsphere-master\shardingsphere-master\shardingsphere-sql-parser\shardingsphere-sql-parser-statement\src\main\java\org\apache\shardingsphere\sql\parser\sql\common\segment\dml\assignment\SetAssignmentSegment.java,0,6,0,1,2,9
 shardingsphere-master\shardingsphere-master\examples\shardingsphere-jdbc-example\mixed-feature-example\sharding-readwrite-splitting-example\sharding-readwrite-splitting-raw-jdbc-example\src\main\java\org\apache\shardingsphere\example\sharding\readwrite\splitting\raw\config\ShardingReadwriteSplittingConfigurationRange.java,0,30,0,32,0,62
 shardingsphere-master\shardingsphere-master\shardingsphere-proxy\shardingsphere-proxy-frontend\shardingsphere-proxy-frontend-core\src\main\java\org\apache\shardingsphere\proxy\frontend\exception\FrontendException.java,5,1,1,1,0,3
 shardingsphere-master\shardingsphere-master\shardingsphere-kernel\shardingsphere-data-pipeline\shardingsphere-data-pipeline-spi\src\test\java\org\apache\shardingsphere\data\pipeline\api\datasource\PipelineDataSourceWrapperTest.java,0,21,0,8,0,29
 shardingsphere-master\shardingsphere-master\shardingsphere-features\shardingsphere-readwrite-splitting\shardingsphere-readwrite-splitting-spring\shardingsphere-readwrite-splitting-spring-namespace\src\main\java\org\apache\shardingsphere\readwritesplitting\spring\namespace\factorybean\ReplicaLoadBalanceAlgorithmFactoryBean.java,0,6,0,6,0,12
 shardingsphere-master\shardingsphere-master\shardingsphere-infra\shardingsphere-infra-common\src\test\java\org\apache\shardingsphere\infra\yaml\config\swapper\algorithm\ShardingSphereAlgorithmConfigurationYamlSwapperTest.java,0,10,0,7,0,17
 shardingsphere-master\shardingsphere-master\shardingsphere-kernel\shardingsphere-authority\shardingsphere-authority-core\src\main\java\org\apache\shardingsphere\authority\rule\builder\AuthorityRuleBuilder.java,0,6,0,3,0,9
 shardingsphere-master\shardingsphere-master\shardingsphere-distsql\shardingsphere-distsql-statement\src\main\java\org\apache\shardingsphere\distsql\parser\statement\ral\common\queryable\ShowTrafficRulesStatement.java,0,2,0,2,0,4
 shardingsphere-master\shardingsphere-master\shardingsphere-features\shardingsphere-sharding\shardingsphere-sharding-core\src\test\java\org\apache\shardingsphere\sharding\rewrite\token\GeneratedKeyForUseDefaultInsertColumnsTokenGeneratorTest.java,0,9,0,13,0,22
 shardingsphere-master\shardingsphere-master\shardingsphere-sql-parser\shardingsphere-sql-parser-statement\src\main\java\org\apache\shardingsphere\sql\parser\sql\dialect\handler\dml\InsertStatementHandler.java,0,22,0,33,9,64
 shardingsphere-master\shardingsphere-master\shardingsphere-mode\shardingsphere-mode-type\shardingsphere-cluster-mode\shardingsphere-cluster-mode-core\src\main\java\org\apache\shardingsphere\mode\manager\cluster\coordinator\registry\status\compute\event\InstanceOfflineEvent.java,0,2,0,3,0,5
 shardingsphere-master\shardingsphere-master\shardingsphere-agent\shardingsphere-agent-core\src\main\java\org\apache\shardingsphere\agent\core\entity\Interceptors.java,0,2,0,1,0,3
 shardingsphere-master\shardingsphere-master\shardingsphere-sql-parser\shardingsphere-sql-parser-statement\src\main\java\org\apache\shardingsphere\sql\parser\sql\common\statement\rl\RLStatement.java,0,1,0,1,0,2
 shardingsphere-master\shardingsphere-master\shardingsphere-db-protocol\shardingsphere-db-protocol-postgresql\src\main\java\org\apache\shardingsphere\db\protocol\postgresql\packet\generic\PostgreSQLErrorResponsePacket.java,0,82,0,23,0,105
 shardingsphere-master\shardingsphere-master\shardingsphere-kernel\shardingsphere-data-pipeline\shardingsphere-data-pipeline-spi\src\main\java\org\apache\shardingsphere\data\pipeline\api\task\progress\InventoryTaskProgress.java,0,2,0,2,0,4
 shardingsphere-master\shardingsphere-master\shardingsphere-infra\shardingsphere-infra-rewrite\src\main\java\org\apache\shardingsphere\infra\rewrite\sql\token\pojo\generic\UseDefaultInsertColumnsToken.java,0,9,0,4,0,13
 shardingsphere-master\shardingsphere-master\shardingsphere-jdbc\shardingsphere-jdbc-core\src\main\java\org\apache\shardingsphere\driver\executor\callback\impl\PreparedStatementExecuteQueryCallback.java,0,7,0,4,0,11
 shardingsphere-master\shardingsphere-master\shardingsphere-proxy\shardingsphere-proxy-backend\src\test\java\org\apache\shardingsphere\proxy\backend\communication\jdbc\datasource\JDBCBackendDataSourceTest.java,0,45,1,22,0,68
 shardingsphere-master\shardingsphere-master\shardingsphere-kernel\shardingsphere-data-pipeline\shardingsphere-data-pipeline-core\src\main\java\org\apache\shardingsphere\data\pipeline\core\metadata\loader\PipelineTableMetaDataLoader.java,0,27,0,21,0,48
 shardingsphere-master\shardingsphere-master\shardingsphere-sql-parser\shardingsphere-sql-parser-engine\src\test\java\org\apache\shardingsphere\sql\parser\core\SQLParserFactoryTest.java,0,5,0,2,0,7
 shardingsphere-master\shardingsphere-master\shardingsphere-sql-parser\shardingsphere-sql-parser-dialect\shardingsphere-sql-parser-postgresql\src\main\java\org\apache\shardingsphere\sql\parser\postgresql\parser\PostgreSQLLexer.java,0,4,0,2,0,6
 shardingsphere-master\shardingsphere-master\shardingsphere-features\shardingsphere-encrypt\shardingsphere-encrypt-core\src\main\java\org\apache\shardingsphere\encrypt\rewrite\token\generator\EncryptForUseDefaultInsertColumnsTokenGenerator.java,0,35,0,28,0,63
 shardingsphere-master\shardingsphere-master\shardingsphere-db-protocol\shardingsphere-db-protocol-mysql\src\main\java\org\apache\shardingsphere\db\protocol\mysql\packet\binlog\row\column\value\time\MySQLDatetimeBinlogProtocolValue.java,0,19,0,10,0,29
 shardingsphere-master\shardingsphere-master\shardingsphere-features\shardingsphere-sharding\shardingsphere-sharding-core\src\main\java\org\apache\shardingsphere\sharding\route\engine\condition\generator\ConditionValueGeneratorFactory.java,0,6,0,13,0,19
 shardingsphere-master\shardingsphere-master\shardingsphere-sql-parser\shardingsphere-sql-parser-statement\src\main\java\org\apache\shardingsphere\sql\parser\sql\common\statement\ddl\AlterGroupStatement.java,3,1,1,3,0,5
 shardingsphere-master\shardingsphere-master\examples\shardingsphere-jdbc-example\mixed-feature-example\sharding-readwrite-splitting-example\sharding-readwrite-splitting-raw-jdbc-example\src\main\java\org\apache\shardingsphere\example\sharding\readwrite\splitting\raw\ShardingReadwriteSplittingRawJavaRangeConfigurationExample.java,0,11,1,10,0,22
 shardingsphere-master\shardingsphere-master\shardingsphere-test\shardingsphere-parser-test\src\main\java\org\apache\shardingsphere\test\sql\parser\parameterized\jaxb\cases\domain\statement\distsql\rql\ShowUnusedShardingKeyGeneratorsStatementTestCase.java,0,3,0,5,0,8
 shardingsphere-master\shardingsphere-master\shardingsphere-test\shardingsphere-parser-test\src\main\java\org\apache\shardingsphere\test\sql\parser\parameterized\jaxb\cases\domain\segment\impl\set\ExpectedSetClause.java,0,3,0,4,0,7
 shardingsphere-master\shardingsphere-master\shardingsphere-infra\shardingsphere-infra-federation\shardingsphere-infra-federation-optimizer\src\main\java\org\apache\shardingsphere\infra\federation\optimizer\context\parser\OptimizerParserContext.java,0,5,0,1,0,6
 shardingsphere-master\shardingsphere-master\shardingsphere-kernel\shardingsphere-data-pipeline\shardingsphere-data-pipeline-core\src\main\java\org\apache\shardingsphere\scaling\core\spi\ScalingEntryFactory.java,0,8,0,4,0,12
 shardingsphere-master\shardingsphere-master\shardingsphere-db-protocol\shardingsphere-db-protocol-core\src\main\java\org\apache\shardingsphere\db\protocol\error\CommonErrorCode.java,0,27,0,2,0,29
 shardingsphere-master\shardingsphere-master\shardingsphere-infra\shardingsphere-infra-executor\src\test\java\org\apache\shardingsphere\infra\executor\sql\process\ExecuteProcessEngineTest.java,0,25,0,19,0,44
 shardingsphere-master\shardingsphere-master\shardingsphere-test\shardingsphere-parser-test\src\main\java\org\apache\shardingsphere\test\sql\parser\parameterized\asserts\segment\set\SetClauseAssert.java,0,9,0,13,0,22
 shardingsphere-master\shardingsphere-master\shardingsphere-features\shardingsphere-sharding\shardingsphere-sharding-core\src\test\java\org\apache\shardingsphere\sharding\route\engine\type\standard\ShardingStandardRoutingEngineTest.java,0,101,0,74,0,175
 shardingsphere-master\shardingsphere-master\shardingsphere-kernel\shardingsphere-data-pipeline\shardingsphere-data-pipeline-dialect\shardingsphere-data-pipeline-mysql\src\main\java\org\apache\shardingsphere\data\pipeline\mysql\ingest\client\netty\MySQLBinlogEventPacketDecoder.java,0,46,1,40,0,87
 shardingsphere-master\shardingsphere-master\shardingsphere-features\shardingsphere-sharding\shardingsphere-sharding-core\src\test\java\org\apache\shardingsphere\sharding\route\strategy\type\hint\HintShardingStrategyTest.java,0,6,0,6,0,12
 shardingsphere-master\shardingsphere-master\shardingsphere-proxy\shardingsphere-proxy-backend\src\main\java\org\apache\shardingsphere\proxy\backend\communication\jdbc\statement\impl\MySQLStatementMemoryStrictlyFetchSizeSetter.java,0,6,0,6,0,12
 shardingsphere-master\shardingsphere-master\shardingsphere-mode\shardingsphere-mode-type\shardingsphere-cluster-mode\shardingsphere-cluster-mode-core\src\main\java\org\apache\shardingsphere\mode\manager\cluster\coordinator\registry\process\node\ProcessNode.java,0,6,0,2,0,8
 shardingsphere-master\shardingsphere-master\shardingsphere-test\shardingsphere-parser-test\src\main\java\org\apache\shardingsphere\test\sql\parser\parameterized\jaxb\cases\domain\segment\impl\assignment\ExpectedAssignmentValue.java,0,12,0,9,0,21
 shardingsphere-master\shardingsphere-master\shardingsphere-kernel\shardingsphere-data-pipeline\shardingsphere-data-pipeline-spi\src\main\java\org\apache\shardingsphere\data\pipeline\spi\lock\RuleBasedJobLockAlgorithm.java,0,0,0,1,0,1
 shardingsphere-master\shardingsphere-master\shardingsphere-proxy\shardingsphere-proxy-backend\src\test\java\org\apache\shardingsphere\proxy\backend\text\distsql\ral\common\queryable\ShowInstanceModeHandlerTest.java,0,14,0,10,0,24
 shardingsphere-master\shardingsphere-master\shardingsphere-features\shardingsphere-shadow\shardingsphere-shadow-core\src\main\java\org\apache\shardingsphere\shadow\rule\ShadowDataSourceRule.java,0,5,0,1,0,6
 shardingsphere-master\shardingsphere-master\shardingsphere-db-protocol\shardingsphere-db-protocol-mysql\src\test\java\org\apache\shardingsphere\db\protocol\mysql\packet\binlog\row\column\value\decimal\MySQLDoubleBinlogProtocolValueTest.java,0,11,0,4,0,15
 shardingsphere-master\shardingsphere-master\shardingsphere-mode\shardingsphere-mode-core\src\main\java\org\apache\shardingsphere\mode\persist\PersistRepository.java,0,7,0,1,0,8
 shardingsphere-master\shardingsphere-master\shardingsphere-features\shardingsphere-sharding\shardingsphere-sharding-core\src\main\java\org\apache\shardingsphere\sharding\algorithm\sharding\cosid\CosIdIntervalShardingAlgorithm.java,0,25,2,12,0,39
 shardingsphere-master\shardingsphere-master\shardingsphere-db-protocol\shardingsphere-db-protocol-mysql\src\main\java\org\apache\shardingsphere\db\protocol\mysql\packet\command\MySQLCommandPacketType.java,0,105,0,36,0,141
 shardingsphere-master\shardingsphere-master\shardingsphere-test\shardingsphere-pipeline-test\src\test\java\org\apache\shardingsphere\data\pipeline\api\datanode\JobDataNodeLineTest.java,0,3,0,2,0,5
 shardingsphere-master\shardingsphere-master\shardingsphere-jdbc\shardingsphere-jdbc-spring\shardingsphere-jdbc-core-spring\shardingsphere-jdbc-core-spring-namespace\src\main\java\org\apache\shardingsphere\spring\namespace\tag\mode\StandalonePersistRepositoryBeanDefinitionTag.java,0,7,0,1,0,8
 shardingsphere-master\shardingsphere-master\shardingsphere-test\shardingsphere-parser-test\src\main\java\org\apache\shardingsphere\test\sql\parser\parameterized\jaxb\cases\domain\statement\dcl\AlterRoleStatementTestCase.java,0,0,0,3,0,3
 shardingsphere-master\shardingsphere-master\shardingsphere-sql-parser\shardingsphere-sql-parser-statement\src\main\java\org\apache\shardingsphere\sql\parser\sql\common\statement\ddl\CreateIndexStatement.java,9,7,1,6,6,20
 shardingsphere-master\shardingsphere-master\shardingsphere-features\shardingsphere-sharding\shardingsphere-sharding-core\src\test\java\org\apache\shardingsphere\sharding\algorithm\sharding\complex\ComplexInlineShardingAlgorithmTest.java,0,33,0,20,0,53
 shardingsphere-master\shardingsphere-master\shardingsphere-features\shardingsphere-readwrite-splitting\shardingsphere-readwrite-splitting-core\src\test\java\org\apache\shardingsphere\readwritesplitting\swapper\YamlRootRuleConfigurationsForYamlReadwriteSplittingRuleConfigurationTest.java,0,21,0,16,0,37
 shardingsphere-master\shardingsphere-master\shardingsphere-features\shardingsphere-encrypt\shardingsphere-encrypt-core\src\main\java\org\apache\shardingsphere\encrypt\rewrite\token\pojo\EncryptAssignmentToken.java,10,6,0,3,0,9
 shardingsphere-master\shardingsphere-master\shardingsphere-kernel\shardingsphere-single-table\shardingsphere-single-table-core\src\main\java\org\apache\shardingsphere\singletable\constant\SingleTableOrder.java,0,3,0,1,0,4
 shardingsphere-master\shardingsphere-master\shardingsphere-sql-parser\shardingsphere-sql-parser-statement\src\main\java\org\apache\shardingsphere\sql\parser\sql\dialect\statement\postgresql\dcl\PostgreSQLAlterUserStatement.java,0,1,0,5,0,6
 shardingsphere-master\shardingsphere-master\examples\shardingsphere-jdbc-example\single-feature-example\cluster-mode-example\cluster-mode-raw-jdbc-example\src\main\java\org\apache\shardingsphere\example\cluster\mode\raw\jdbc\config\cloud\CloudEncryptConfiguration.java,14,8,0,1,0,9
 shardingsphere-master\shardingsphere-master\shardingsphere-sql-parser\shardingsphere-sql-parser-statement\src\main\java\org\apache\shardingsphere\sql\parser\sql\dialect\statement\mysql\tcl\MySQLBeginTransactionStatement.java,0,2,0,4,0,6
 shardingsphere-master\shardingsphere-master\shardingsphere-kernel\shardingsphere-transaction\shardingsphere-transaction-core\src\main\java\org\apache\shardingsphere\transaction\TransactionHolder.java,0,9,0,2,0,11
 shardingsphere-master\shardingsphere-master\shardingsphere-infra\shardingsphere-infra-rewrite\src\main\java\org\apache\shardingsphere\infra\rewrite\context\SQLRewriteContextDecorator.java,0,3,0,3,0,6
 shardingsphere-master\shardingsphere-master\shardingsphere-features\shardingsphere-db-discovery\shardingsphere-db-discovery-distsql\shardingsphere-db-discovery-distsql-statement\src\main\java\org\apache\shardingsphere\dbdiscovery\distsql\parser\segment\DatabaseDiscoveryRuleSegment.java,0,8,0,1,0,9
 shardingsphere-master\shardingsphere-master\shardingsphere-features\shardingsphere-sharding\shardingsphere-sharding-distsql\shardingsphere-sharding-distsql-handler\src\test\java\org\apache\shardingsphere\sharding\distsql\query\ShowShardingTableRulesUsedKeyGeneratorQueryResultSetTest.java,0,34,0,32,0,66
 shardingsphere-master\shardingsphere-master\shardingsphere-sql-parser\shardingsphere-sql-parser-statement\src\main\java\org\apache\shardingsphere\sql\parser\sql\dialect\statement\opengauss\ddl\OpenGaussDropSequenceStatement.java,0,1,0,5,0,6
 shardingsphere-master\shardingsphere-master\shardingsphere-features\shardingsphere-sharding\shardingsphere-sharding-core\src\main\java\org\apache\shardingsphere\sharding\yaml\swapper\ShardingRuleAlgorithmProviderConfigurationYamlSwapper.java,0,44,0,38,0,82
 shardingsphere-master\shardingsphere-master\shardingsphere-sql-parser\shardingsphere-sql-parser-statement\src\main\java\org\apache\shardingsphere\sql\parser\sql\common\segment\generic\InsertMultiTableElementSegment.java,0,7,0,3,1,11
 shardingsphere-master\shardingsphere-master\shardingsphere-infra\shardingsphere-infra-common\src\test\java\org\apache\shardingsphere\infra\metadata\schema\fixture\rule\CommonFixtureRule.java,0,3,0,1,0,4
 shardingsphere-master\shardingsphere-master\shardingsphere-features\shardingsphere-encrypt\shardingsphere-encrypt-core\src\main\java\org\apache\shardingsphere\encrypt\rewrite\parameter\EncryptParameterRewriterBuilder.java,0,22,0,16,0,38
 shardingsphere-master\shardingsphere-master\shardingsphere-test\shardingsphere-parser-test\src\main\java\org\apache\shardingsphere\test\sql\parser\parameterized\asserts\statement\ddl\impl\PurgeStatementAssert.java,0,10,0,12,0,22
 shardingsphere-master\shardingsphere-master\shardingsphere-kernel\shardingsphere-single-table\shardingsphere-single-table-core\src\test\java\org\apache\shardingsphere\singletable\metadata\SingleTableMetaDataBuilderTest.java,0,64,11,38,0,113
 shardingsphere-master\shardingsphere-master\shardingsphere-test\shardingsphere-integration-test\shardingsphere-integration-test-suite\src\test\java\org\apache\shardingsphere\test\integration\engine\rql\BaseRQLIT.java,53,17,2,12,0,31
 shardingsphere-master\shardingsphere-master\shardingsphere-proxy\shardingsphere-proxy-backend\src\test\java\org\apache\shardingsphere\proxy\backend\text\distsql\fixture\CreateFixtureRuleStatement.java,0,1,0,2,0,3
 shardingsphere-master\shardingsphere-master\examples\example-core\example-spring-jpa\src\main\java\org\apache\shardingsphere\example\core\jpa\service\UserServiceImpl.java,63,21,2,8,0,31
 shardingsphere-master\shardingsphere-master\shardingsphere-mode\shardingsphere-mode-type\shardingsphere-standalone-mode\shardingsphere-standalone-mode-repository\shardingsphere-standalone-mode-repository-provider\shardingsphere-standalone-mode-repository-h2\src\main\java\org\apache\shardingsphere\mode\repository\standalone\h2\H2RepositoryPropertyKey.java,0,12,0,1,0,13
 shardingsphere-master\shardingsphere-master\shardingsphere-proxy\shardingsphere-proxy-backend\src\main\java\org\apache\shardingsphere\proxy\backend\text\admin\executor\DatabaseAdminQueryExecutor.java,0,4,0,2,0,6
 shardingsphere-master\shardingsphere-master\shardingsphere-infra\shardingsphere-infra-merge\src\main\java\org\apache\shardingsphere\infra\merge\result\impl\decorator\DecoratorMergedResult.java,25,10,0,4,0,14
 shardingsphere-master\shardingsphere-master\shardingsphere-infra\shardingsphere-infra-common\src\test\java\org\apache\shardingsphere\infra\properties\TypedPropertyValueTest.java,0,27,0,10,0,37
 shardingsphere-master\shardingsphere-master\shardingsphere-sql-parser\shardingsphere-sql-parser-engine\src\test\java\org\apache\shardingsphere\sql\parser\core\SQLParserEngineTest.java,0,8,0,4,1,13
 shardingsphere-master\shardingsphere-master\shardingsphere-db-protocol\shardingsphere-db-protocol-postgresql\src\test\java\org\apache\shardingsphere\db\protocol\postgresql\packet\command\query\extended\execute\PostgreSQLComExecutePacketTest.java,0,7,0,6,0,13
 shardingsphere-master\shardingsphere-master\shardingsphere-test\shardingsphere-parser-test\src\main\java\org\apache\shardingsphere\test\sql\parser\parameterized\asserts\segment\distsql\TableRuleAssert.java,0,21,0,24,0,45
 shardingsphere-master\shardingsphere-master\shardingsphere-proxy\shardingsphere-proxy-frontend\shardingsphere-proxy-frontend-opengauss\src\main\java\org\apache\shardingsphere\proxy\frontend\opengauss\authentication\OpenGaussAuthenticationHandler.java,0,52,0,31,0,83
 shardingsphere-master\shardingsphere-master\shardingsphere-test\shardingsphere-parser-test\src\main\java\org\apache\shardingsphere\test\sql\parser\parameterized\jaxb\cases\domain\statement\distsql\rql\ShowDefaultShardingStrategyStatementTestCase.java,0,3,0,5,0,8
 shardingsphere-master\shardingsphere-master\shardingsphere-infra\shardingsphere-infra-common\src\main\java\org\apache\shardingsphere\infra\metadata\user\yaml\config\YamlUsersConfigurationConverter.java,0,21,0,16,0,37
 shardingsphere-master\shardingsphere-master\shardingsphere-infra\shardingsphere-infra-datetime\shardingsphere-infra-datetime-type\shardingsphere-database-datetime\src\main\java\org\apache\shardingsphere\datetime\database\provider\dialect\PostgreSQLDatetimeLoadingSQLProvider.java,0,3,0,3,0,6
 shardingsphere-master\shardingsphere-master\shardingsphere-test\shardingsphere-parser-test\src\main\java\org\apache\shardingsphere\test\sql\parser\parameterized\jaxb\cases\domain\statement\dml\MergeStatementTestCase.java,0,10,0,5,0,15
 shardingsphere-master\shardingsphere-master\shardingsphere-features\shardingsphere-encrypt\shardingsphere-encrypt-distsql\shardingsphere-encrypt-distsql-handler\src\test\java\org\apache\shardingsphere\encrypt\distsql\handler\converter\EncryptRuleStatementConverterTest.java,0,12,0,11,0,23
 shardingsphere-master\shardingsphere-master\shardingsphere-kernel\shardingsphere-data-pipeline\shardingsphere-data-pipeline-spi\src\main\java\org\apache\shardingsphere\data\pipeline\spi\lock\RowBasedJobLockAlgorithm.java,0,0,0,1,0,1
 shardingsphere-master\shardingsphere-master\shardingsphere-infra\shardingsphere-infra-binder\src\test\java\org\apache\shardingsphere\infra\binder\statement\ddl\TruncateStatementContextTest.java,0,10,0,15,0,25
 shardingsphere-master\shardingsphere-master\shardingsphere-kernel\shardingsphere-data-pipeline\shardingsphere-data-pipeline-core\src\main\java\org\apache\shardingsphere\data\pipeline\core\sqlbuilder\PipelineSQLBuilderFactory.java,0,6,0,4,0,10
 shardingsphere-master\shardingsphere-master\shardingsphere-kernel\shardingsphere-parser\shardingsphere-parser-core\src\main\java\org\apache\shardingsphere\parser\yaml\swapper\SQLParserCacheOptionConfigurationYamlSwapper.java,0,8,0,8,0,16
 shardingsphere-master\shardingsphere-master\shardingsphere-sql-parser\shardingsphere-sql-parser-dialect\shardingsphere-sql-parser-mysql\src\main\java\org\apache\shardingsphere\sql\parser\mysql\visitor\statement\impl\MySQLRLStatementSQLVisitor.java,0,7,0,10,0,17
 shardingsphere-master\shardingsphere-master\shardingsphere-proxy\shardingsphere-proxy-backend\src\main\java\org\apache\shardingsphere\proxy\backend\response\data\impl\BinaryQueryResponseCell.java,0,5,0,1,0,6
 shardingsphere-master\shardingsphere-master\shardingsphere-db-protocol\shardingsphere-db-protocol-postgresql\src\main\java\org\apache\shardingsphere\db\protocol\postgresql\packet\command\query\extended\parse\PostgreSQLParseCompletePacket.java,0,8,0,6,0,14
 shardingsphere-master\shardingsphere-master\shardingsphere-sql-parser\shardingsphere-sql-parser-statement\src\main\java\org\apache\shardingsphere\sql\parser\sql\dialect\statement\mysql\dal\MySQLShowGrantsStatement.java,0,1,0,5,0,6
 shardingsphere-master\shardingsphere-master\shardingsphere-infra\shardingsphere-infra-common\src\test\java\org\apache\shardingsphere\infra\datasource\pool\destroyer\detector\type\DefaultDataSourcePoolActiveDetectorTest.java,0,4,0,2,0,6
 shardingsphere-master\shardingsphere-master\shardingsphere-agent\shardingsphere-agent-core\src\main\java\org\apache\shardingsphere\agent\core\spi\AgentServiceLoader.java,0,18,0,6,0,24
 shardingsphere-master\shardingsphere-master\shardingsphere-agent\shardingsphere-agent-plugins\shardingsphere-agent-plugin-tracing\shardingsphere-agent-tracing-test\src\main\java\org\apache\shardingsphere\agent\plugin\tracing\advice\AbstractCommandExecutorTaskAdviceTest.java,14,7,0,4,0,11
 shardingsphere-master\shardingsphere-master\shardingsphere-sql-parser\shardingsphere-sql-parser-dialect\shardingsphere-sql-parser-postgresql\src\main\java\org\apache\shardingsphere\sql\parser\postgresql\parser\PostgreSQLParser.java,0,5,0,3,0,8
 shardingsphere-master\shardingsphere-master\shardingsphere-test\shardingsphere-parser-test\src\main\java\org\apache\shardingsphere\test\sql\parser\parameterized\jaxb\cases\domain\statement\distsql\ral\AlterTrafficRuleStatementTestCase.java,0,2,0,4,0,6
 shardingsphere-master\shardingsphere-master\shardingsphere-infra\shardingsphere-infra-binder\src\main\java\org\apache\shardingsphere\infra\binder\statement\ddl\CreateDatabaseStatementContext.java,0,4,0,5,0,9
 shardingsphere-master\shardingsphere-master\shardingsphere-infra\shardingsphere-infra-common\src\main\java\org\apache\shardingsphere\infra\yaml\engine\representer\ShardingSphereYamlRepresenter.java,0,15,0,13,0,28
 shardingsphere-master\shardingsphere-master\shardingsphere-sql-parser\shardingsphere-sql-parser-statement\src\main\java\org\apache\shardingsphere\sql\parser\sql\dialect\statement\oracle\ddl\OracleCreateDimensionStatement.java,0,1,0,5,0,6
 shardingsphere-master\shardingsphere-master\shardingsphere-features\shardingsphere-shadow\shardingsphere-shadow-distsql\shardingsphere-shadow-distsql-handler\src\test\java\org\apache\shardingsphere\shadow\distsql\update\CreateShadowRuleStatementUpdaterTest.java,0,47,0,33,0,80
 shardingsphere-master\shardingsphere-master\shardingsphere-test\shardingsphere-parser-test\src\main\java\org\apache\shardingsphere\test\sql\parser\parameterized\jaxb\cases\domain\statement\ddl\CreateTablespaceStatementTestCase.java,0,0,0,3,0,3
 shardingsphere-master\shardingsphere-master\shardingsphere-mode\shardingsphere-mode-type\shardingsphere-cluster-mode\shardingsphere-cluster-mode-core\src\main\java\org\apache\shardingsphere\mode\manager\cluster\coordinator\lock\ShardingSphereDistributeGlobalLock.java,0,59,1,23,0,83
 shardingsphere-master\shardingsphere-master\shardingsphere-db-protocol\shardingsphere-db-protocol-opengauss\src\test\java\org\apache\shardingsphere\db\protocol\opengauss\codec\OpenGaussPacketCodecEngineTest.java,0,37,0,10,0,47
 shardingsphere-master\shardingsphere-master\shardingsphere-kernel\shardingsphere-data-pipeline\shardingsphere-data-pipeline-dialect\shardingsphere-data-pipeline-postgresql\src\test\java\org\apache\shardingsphere\data\pipeline\postgresql\sqlbuilder\PostgreSQLPipelineSQLBuilderTest.java,0,8,0,7,0,15
 shardingsphere-master\shardingsphere-master\shardingsphere-infra\shardingsphere-infra-common\src\test\java\org\apache\shardingsphere\infra\database\type\dialect\MySQLDatabaseTypeTest.java,0,24,1,10,0,35
 shardingsphere-master\shardingsphere-master\shardingsphere-infra\shardingsphere-infra-common\src\test\java\org\apache\shardingsphere\infra\properties\TypedPropertyValueExceptionTest.java,0,3,0,2,0,5
 shardingsphere-master\shardingsphere-master\shardingsphere-infra\shardingsphere-infra-executor\src\main\java\org\apache\shardingsphere\infra\executor\sql\execute\result\update\UpdateResult.java,0,5,0,2,0,7
 shardingsphere-master\shardingsphere-master\shardingsphere-infra\shardingsphere-infra-common\src\main\java\org\apache\shardingsphere\infra\datasource\pool\metadata\type\dbcp\DBCPDataSourcePoolFieldMetaData.java,0,6,0,3,0,9
 shardingsphere-master\shardingsphere-master\shardingsphere-infra\shardingsphere-infra-binder\src\main\java\org\apache\shardingsphere\infra\binder\statement\ddl\CreateViewStatementContext.java,0,7,0,8,0,15
 shardingsphere-master\shardingsphere-master\shardingsphere-sql-parser\shardingsphere-sql-parser-statement\src\main\java\org\apache\shardingsphere\sql\parser\sql\dialect\statement\postgresql\ddl\PostgreSQLCreateTablespaceStatement.java,0,1,0,5,0,6
 shardingsphere-master\shardingsphere-master\shardingsphere-sql-parser\shardingsphere-sql-parser-statement\src\main\java\org\apache\shardingsphere\sql\parser\sql\dialect\statement\opengauss\dcl\OpenGaussGrantStatement.java,0,1,0,5,0,6
 shardingsphere-master\shardingsphere-master\shardingsphere-test\shardingsphere-parser-test\src\main\java\org\apache\shardingsphere\test\sql\parser\parameterized\jaxb\cases\domain\statement\ddl\PurgeStatementTestCase.java,0,4,0,5,0,9
 shardingsphere-master\shardingsphere-master\shardingsphere-mode\shardingsphere-mode-type\shardingsphere-cluster-mode\shardingsphere-cluster-mode-core\src\main\java\org\apache\shardingsphere\mode\manager\cluster\coordinator\registry\GovernanceEvent.java,0,1,0,1,0,2
 shardingsphere-master\shardingsphere-master\shardingsphere-features\shardingsphere-sharding\shardingsphere-sharding-spring\shardingsphere-sharding-spring-namespace\src\main\java\org\apache\shardingsphere\sharding\spring\namespace\tag\rule\ShardingRuleBeanDefinitionTag.java,0,58,0,13,0,71
 shardingsphere-master\shardingsphere-master\shardingsphere-proxy\shardingsphere-proxy-backend\src\main\java\org\apache\shardingsphere\proxy\backend\context\BackendExecutorContext.java,0,10,0,3,0,13
 shardingsphere-master\shardingsphere-master\shardingsphere-proxy\shardingsphere-proxy-frontend\shardingsphere-proxy-frontend-mysql\src\test\java\org\apache\shardingsphere\proxy\frontend\mysql\command\query\binary\prepare\MySQLComStmtPrepareExecutorTest.java,0,10,0,8,0,18
 shardingsphere-master\shardingsphere-master\shardingsphere-test\shardingsphere-parser-test\src\main\java\org\apache\shardingsphere\test\sql\parser\parameterized\asserts\statement\dal\impl\MySQLResetPersistStatementAssert.java,0,6,0,9,0,15
 shardingsphere-master\shardingsphere-master\shardingsphere-sql-parser\shardingsphere-sql-parser-statement\src\test\java\org\apache\shardingsphere\sql\parser\sql\common\util\WhereExtractUtilTest.java,0,32,0,23,0,55
 shardingsphere-master\shardingsphere-master\shardingsphere-infra\shardingsphere-infra-common\src\test\java\org\apache\shardingsphere\infra\config\props\ConfigurationPropertiesTest.java,0,27,0,19,0,46
 shardingsphere-master\shardingsphere-master\shardingsphere-proxy\shardingsphere-proxy-backend\src\main\java\org\apache\shardingsphere\proxy\backend\text\distsql\ral\scaling\update\UpdatableScalingRALBackendHandlerFactory.java,0,6,0,4,0,10
 shardingsphere-master\shardingsphere-master\shardingsphere-test\shardingsphere-parser-test\src\main\java\org\apache\shardingsphere\test\sql\parser\parameterized\jaxb\cases\domain\statement\tcl\SetConstraintsStatementTestCase.java,0,0,0,3,0,3
 shardingsphere-master\shardingsphere-master\shardingsphere-test\shardingsphere-integration-test\shardingsphere-integration-test-suite\src\test\java\org\apache\shardingsphere\test\integration\cases\assertion\IntegrationTestCaseAssertionSQL.java,0,4,0,1,0,5
 shardingsphere-master\shardingsphere-master\shardingsphere-test\shardingsphere-parser-test\src\main\java\org\apache\shardingsphere\test\sql\parser\parameterized\jaxb\cases\domain\statement\ddl\CreateExtensionStatementTestCase.java,0,0,0,3,0,3
 shardingsphere-master\shardingsphere-master\shardingsphere-sql-parser\shardingsphere-sql-parser-statement\src\main\java\org\apache\shardingsphere\sql\parser\sql\dialect\statement\opengauss\ddl\OpenGaussPrepareStatement.java,0,1,0,5,0,6
 shardingsphere-master\shardingsphere-master\shardingsphere-features\shardingsphere-sharding\shardingsphere-sharding-distsql\shardingsphere-sharding-distsql-statement\src\main\java\org\apache\shardingsphere\sharding\distsql\parser\statement\ShowShardingBroadcastTableRulesStatement.java,0,4,0,5,0,9
 shardingsphere-master\shardingsphere-master\shardingsphere-sql-parser\shardingsphere-sql-parser-statement\src\main\java\org\apache\shardingsphere\sql\parser\sql\dialect\statement\postgresql\tcl\PostgreSQLCommitStatement.java,0,1,0,5,0,6
 shardingsphere-master\shardingsphere-master\shardingsphere-mode\shardingsphere-mode-type\shardingsphere-cluster-mode\shardingsphere-cluster-mode-core\src\main\java\org\apache\shardingsphere\mode\manager\cluster\coordinator\lock\event\GlobalLockedEvent.java,0,4,0,2,0,6
 shardingsphere-master\shardingsphere-master\shardingsphere-proxy\shardingsphere-proxy-frontend\shardingsphere-proxy-frontend-postgresql\src\main\java\org\apache\shardingsphere\proxy\frontend\postgresql\command\query\PostgreSQLCommand.java,0,66,1,52,0,119
 shardingsphere-master\shardingsphere-master\shardingsphere-kernel\shardingsphere-data-pipeline\shardingsphere-data-pipeline-dialect\shardingsphere-data-pipeline-mysql\src\test\java\org\apache\shardingsphere\data\pipeline\mysql\prepare\datasource\MySQLDataSourcePreparerTest.java,0,49,0,34,0,83
 shardingsphere-master\shardingsphere-master\shardingsphere-mode\shardingsphere-mode-core\src\main\java\org\apache\shardingsphere\mode\metadata\persist\service\impl\PropertiesPersistService.java,0,9,0,6,0,15
 shardingsphere-master\shardingsphere-master\shardingsphere-infra\shardingsphere-infra-executor\src\main\java\org\apache\shardingsphere\infra\executor\sql\execute\engine\driver\jdbc\sane\postgresql\PostgreSQLSaneQueryResultEngine.java,0,5,0,6,0,11
 shardingsphere-master\shardingsphere-master\shardingsphere-infra\shardingsphere-infra-common\src\main\java\org\apache\shardingsphere\infra\distsql\exception\rule\InvalidRuleConfigurationException.java,0,7,0,4,0,11
 shardingsphere-master\shardingsphere-master\examples\shardingsphere-jdbc-example\single-feature-example\sharding-example\sharding-raw-jdbc-example\src\main\java\org\apache\shardingsphere\example\sharding\raw\jdbc\config\ShardingDatabasesAndTablesConfigurationRange.java,0,18,0,18,0,36
 shardingsphere-master\shardingsphere-master\shardingsphere-kernel\shardingsphere-data-pipeline\shardingsphere-data-pipeline-spi\src\main\java\org\apache\shardingsphere\data\pipeline\api\datasource\config\PipelineDataSourceConfigurationFactory.java,0,5,0,6,0,11
 shardingsphere-master\shardingsphere-master\shardingsphere-sql-parser\shardingsphere-sql-parser-statement\src\main\java\org\apache\shardingsphere\sql\parser\sql\dialect\statement\mysql\dal\MySQLDropResourceGroupStatement.java,0,3,0,5,0,8
 shardingsphere-master\shardingsphere-master\shardingsphere-infra\shardingsphere-infra-executor\src\main\java\org\apache\shardingsphere\infra\executor\sql\execute\engine\driver\jdbc\JDBCExecutorCallback.java,0,31,0,22,0,53
 shardingsphere-master\shardingsphere-master\shardingsphere-features\shardingsphere-sharding\shardingsphere-sharding-core\src\main\java\org\apache\shardingsphere\sharding\rewrite\parameter\impl\ShardingGeneratedKeyInsertValueParameterRewriter.java,0,15,0,17,0,32
 shardingsphere-master\shardingsphere-master\shardingsphere-test\shardingsphere-parser-test\src\main\java\org\apache\shardingsphere\test\sql\parser\parameterized\jaxb\cases\domain\statement\ddl\CreateDomainStatementTestCase.java,0,0,0,3,0,3
 shardingsphere-master\shardingsphere-master\shardingsphere-db-protocol\shardingsphere-db-protocol-mysql\src\test\java\org\apache\shardingsphere\db\protocol\mysql\packet\binlog\row\column\value\decimal\MySQLDecimalBinlogProtocolValueTest.java,0,28,0,13,0,41
 shardingsphere-master\shardingsphere-master\shardingsphere-sql-parser\shardingsphere-sql-parser-statement\src\main\java\org\apache\shardingsphere\sql\parser\sql\dialect\statement\sql92\tcl\SQL92CommitStatement.java,0,2,0,4,0,6
 shardingsphere-master\shardingsphere-master\shardingsphere-db-protocol\shardingsphere-db-protocol-postgresql\src\main\java\org\apache\shardingsphere\db\protocol\postgresql\packet\identifier\PostgreSQLIdentifierTag.java,0,2,0,1,0,3
 shardingsphere-master\shardingsphere-master\shardingsphere-mode\shardingsphere-mode-core\src\test\java\org\apache\shardingsphere\mode\metadata\MetaDataContextsTest.java,0,10,0,5,0,15
 shardingsphere-master\shardingsphere-master\shardingsphere-db-protocol\shardingsphere-db-protocol-mysql\src\test\java\org\apache\shardingsphere\db\protocol\mysql\constant\MySQLServerInfoTest.java,0,6,0,3,0,9
 shardingsphere-master\shardingsphere-master\shardingsphere-sql-parser\shardingsphere-sql-parser-statement\src\main\java\org\apache\shardingsphere\sql\parser\sql\dialect\statement\postgresql\ddl\PostgreSQLDeallocateStatement.java,0,1,0,5,0,6
 shardingsphere-master\shardingsphere-master\shardingsphere-kernel\shardingsphere-transaction\shardingsphere-transaction-type\shardingsphere-transaction-xa\shardingsphere-transaction-xa-core\src\main\java\org\apache\shardingsphere\transaction\xa\jta\datasource\swapper\DataSourcePropertyProviderLoader.java,0,9,0,6,0,15
 shardingsphere-master\shardingsphere-master\shardingsphere-test\shardingsphere-parser-test\src\main\java\org\apache\shardingsphere\test\sql\parser\parameterized\asserts\statement\distsql\rdl\create\impl\CreateShadowRuleStatementAssert.java,0,10,0,17,0,27
 shardingsphere-master\shardingsphere-master\shardingsphere-spi\src\test\java\org\apache\shardingsphere\spi\fixture\required\RequiredSingletonSPIFixtureImpl.java,0,1,0,2,0,3
 shardingsphere-master\shardingsphere-master\shardingsphere-kernel\shardingsphere-data-pipeline\shardingsphere-data-pipeline-spi\src\main\java\org\apache\shardingsphere\data\pipeline\api\PipelineJobAPI.java,0,4,0,1,0,5
 shardingsphere-master\shardingsphere-master\shardingsphere-test\shardingsphere-parser-test\src\main\java\org\apache\shardingsphere\test\sql\parser\parameterized\jaxb\cases\domain\statement\dal\ShutdownStatementTestCase.java,0,0,0,3,0,3
 shardingsphere-master\shardingsphere-master\shardingsphere-sql-parser\shardingsphere-sql-parser-statement\src\main\java\org\apache\shardingsphere\sql\parser\sql\common\util\SQLUtil.java,0,67,0,59,0,126
 shardingsphere-master\shardingsphere-master\shardingsphere-sql-parser\shardingsphere-sql-parser-statement\src\main\java\org\apache\shardingsphere\sql\parser\sql\common\segment\dml\expr\simple\SimpleExpressionSegment.java,0,0,0,2,0,2
 shardingsphere-master\shardingsphere-master\shardingsphere-sql-parser\shardingsphere-sql-parser-statement\src\main\java\org\apache\shardingsphere\sql\parser\sql\dialect\statement\opengauss\ddl\OpenGaussDropDatabaseStatement.java,0,1,0,5,0,6
 shardingsphere-master\shardingsphere-master\shardingsphere-kernel\shardingsphere-data-pipeline\shardingsphere-data-pipeline-dialect\shardingsphere-data-pipeline-postgresql\src\main\java\org\apache\shardingsphere\data\pipeline\postgresql\check\datasource\PostgreSQLDataSourceChecker.java,0,15,1,10,0,26
 shardingsphere-master\shardingsphere-master\shardingsphere-infra\shardingsphere-infra-common\src\main\java\org\apache\shardingsphere\infra\metadata\resource\DataSourcesMetaData.java,0,16,0,10,0,26
 shardingsphere-master\shardingsphere-master\shardingsphere-test\shardingsphere-parser-test\src\main\java\org\apache\shardingsphere\test\sql\parser\parameterized\jaxb\cases\domain\statement\distsql\ral\PreviewStatementTestCase.java,0,0,0,3,0,3
 shardingsphere-master\shardingsphere-master\shardingsphere-test\shardingsphere-parser-test\src\main\java\org\apache\shardingsphere\test\sql\parser\parameterized\asserts\statement\tcl\impl\SavepointStatementAssert.java,0,5,0,7,0,12
 shardingsphere-master\shardingsphere-master\shardingsphere-test\shardingsphere-parser-test\src\main\java\org\apache\shardingsphere\test\sql\parser\parameterized\jaxb\cases\domain\statement\dal\ShowReplicasStatementTestCase.java,0,0,0,3,0,3
 shardingsphere-master\shardingsphere-master\shardingsphere-test\shardingsphere-parser-test\src\main\java\org\apache\shardingsphere\test\sql\parser\parameterized\jaxb\cases\domain\segment\impl\trigger\ExpectedTrigger.java,0,2,0,5,0,7
 shardingsphere-master\shardingsphere-master\shardingsphere-jdbc\shardingsphere-jdbc-spring\shardingsphere-jdbc-spring-infra\shardingsphere-jdbc-spring-boot-starter-infra\src\main\java\org\apache\shardingsphere\spring\boot\registry\AbstractAlgorithmProvidedBeanRegistry.java,0,33,1,21,0,55
 shardingsphere-master\shardingsphere-master\examples\shardingsphere-jdbc-example\single-feature-example\sharding-example\sharding-raw-jdbc-example\src\main\java\org\apache\shardingsphere\example\sharding\raw\jdbc\config\ShardingDatabasesAndTablesConfigurationPrecise.java,0,19,0,18,0,37
 shardingsphere-master\shardingsphere-master\shardingsphere-features\shardingsphere-shadow\shardingsphere-shadow-core\src\test\java\org\apache\shardingsphere\shadow\route\engine\determiner\ColumnShadowAlgorithmDeterminerTest.java,0,10,0,6,0,16
 shardingsphere-master\shardingsphere-master\shardingsphere-proxy\shardingsphere-proxy-frontend\shardingsphere-proxy-frontend-core\src\main\java\org\apache\shardingsphere\proxy\frontend\state\impl\JDBCOKProxyState.java,0,18,0,16,0,34
 shardingsphere-master\shardingsphere-master\shardingsphere-sql-parser\shardingsphere-sql-parser-statement\src\main\java\org\apache\shardingsphere\sql\parser\sql\dialect\statement\mysql\dal\MySQLShowEngineStatement.java,0,3,0,5,0,8
 shardingsphere-master\shardingsphere-master\shardingsphere-sql-parser\shardingsphere-sql-parser-statement\src\main\java\org\apache\shardingsphere\sql\parser\sql\dialect\statement\opengauss\ddl\OpenGaussDropIndexStatement.java,0,3,0,5,0,8
 shardingsphere-master\shardingsphere-master\shardingsphere-sql-parser\shardingsphere-sql-parser-statement\src\main\java\org\apache\shardingsphere\sql\parser\sql\dialect\statement\mysql\MySQLStatement.java,0,1,0,1,0,2
 shardingsphere-master\shardingsphere-master\shardingsphere-test\shardingsphere-parser-test\src\main\java\org\apache\shardingsphere\test\sql\parser\parameterized\jaxb\cases\domain\segment\impl\distsql\rdl\ExpectedShadowRule.java,0,15,0,5,0,20
 shardingsphere-master\shardingsphere-master\shardingsphere-test\shardingsphere-parser-test\src\main\java\org\apache\shardingsphere\test\sql\parser\parameterized\jaxb\cases\domain\statement\ddl\DeclareStatementTestCase.java,0,0,0,3,0,3
 shardingsphere-master\shardingsphere-master\shardingsphere-infra\shardingsphere-infra-merge\src\main\java\org\apache\shardingsphere\infra\merge\engine\merger\ResultMerger.java,0,4,0,3,0,7
 shardingsphere-master\shardingsphere-master\shardingsphere-kernel\shardingsphere-transaction\shardingsphere-transaction-type\shardingsphere-transaction-xa\shardingsphere-transaction-xa-provider\shardingsphere-transaction-xa-atomikos\src\main\java\org\apache\shardingsphere\transaction\xa\atomikos\manager\AtomikosXARecoverableResource.java,0,7,0,4,0,11
 shardingsphere-master\shardingsphere-master\shardingsphere-infra\shardingsphere-infra-federation\shardingsphere-infra-federation-executor\src\main\java\org\apache\shardingsphere\infra\federation\executor\FederationContext.java,0,9,0,1,0,10
 shardingsphere-master\shardingsphere-master\shardingsphere-infra\shardingsphere-infra-rewrite\src\main\java\org\apache\shardingsphere\infra\rewrite\engine\result\SQLRewriteUnit.java,0,4,0,1,0,5
 shardingsphere-master\shardingsphere-master\shardingsphere-features\shardingsphere-sharding\shardingsphere-sharding-core\src\main\java\org\apache\shardingsphere\sharding\merge\dql\orderby\OrderByValue.java,0,33,0,24,0,57
 shardingsphere-master\shardingsphere-master\shardingsphere-features\shardingsphere-shadow\shardingsphere-shadow-distsql\shardingsphere-shadow-distsql-parser\src\main\java\org\apache\shardingsphere\shadow\distsql\parser\core\ShadowDistSQLStatementVisitor.java,0,57,1,71,0,129
 shardingsphere-master\shardingsphere-master\shardingsphere-proxy\shardingsphere-proxy-backend\src\main\java\org\apache\shardingsphere\proxy\backend\text\distsql\ral\common\updatable\LabelInstanceHandler.java,0,10,0,14,0,24
 shardingsphere-master\shardingsphere-master\shardingsphere-test\shardingsphere-parser-test\src\main\java\org\apache\shardingsphere\test\sql\parser\parameterized\asserts\statement\distsql\ral\impl\QueryableRALStatementAssert.java,0,17,0,52,0,69
 shardingsphere-master\shardingsphere-master\shardingsphere-test\shardingsphere-parser-test\src\main\java\org\apache\shardingsphere\test\sql\parser\parameterized\jaxb\cases\domain\segment\impl\group\ExpectedGroup.java,0,1,0,3,0,4
 shardingsphere-master\shardingsphere-master\shardingsphere-features\shardingsphere-sharding\shardingsphere-sharding-core\src\test\java\org\apache\shardingsphere\sharding\route\engine\condition\ColumnTest.java,0,9,0,1,0,10
 shardingsphere-master\shardingsphere-master\shardingsphere-proxy\shardingsphere-proxy-frontend\shardingsphere-proxy-frontend-mysql\src\test\java\org\apache\shardingsphere\proxy\frontend\mysql\command\query\binary\prepare\MySQLComStmtPrepareCheckerTest.java,0,19,0,63,0,82
 shardingsphere-master\shardingsphere-master\shardingsphere-jdbc\shardingsphere-jdbc-core\src\test\java\org\apache\shardingsphere\driver\jdbc\core\statement\ReadwriteSplittingPreparedStatementTest.java,0,17,3,11,0,31
 shardingsphere-master\shardingsphere-master\shardingsphere-infra\shardingsphere-infra-binder\src\test\java\org\apache\shardingsphere\infra\binder\segment\select\orderby\engine\OrderByContextEngineTest.java,0,66,0,47,0,113
 shardingsphere-master\shardingsphere-master\shardingsphere-sql-parser\shardingsphere-sql-parser-statement\src\main\java\org\apache\shardingsphere\sql\parser\sql\common\statement\ddl\AlterDefaultPrivilegesStatement.java,3,1,1,3,0,5
 shardingsphere-master\shardingsphere-master\shardingsphere-sql-parser\shardingsphere-sql-parser-statement\src\main\java\org\apache\shardingsphere\sql\parser\sql\common\segment\dml\pagination\ParameterMarkerPaginationValueSegment.java,0,3,0,3,0,6
 shardingsphere-master\shardingsphere-master\shardingsphere-test\shardingsphere-parser-test\src\main\java\org\apache\shardingsphere\test\sql\parser\parameterized\jaxb\cases\domain\segment\impl\distsql\ExpectedAutoTableRule.java,0,11,0,4,0,15
 shardingsphere-master\shardingsphere-master\shardingsphere-features\shardingsphere-sharding\shardingsphere-sharding-core\src\test\java\org\apache\shardingsphere\sharding\route\engine\condition\generator\ConditionValueTest.java,0,5,0,5,0,10
 shardingsphere-master\shardingsphere-master\shardingsphere-proxy\shardingsphere-proxy-backend\src\main\java\org\apache\shardingsphere\proxy\backend\text\distsql\ral\common\hint\executor\AbstractHintQueryExecutor.java,32,13,0,9,0,22
 shardingsphere-master\shardingsphere-master\shardingsphere-kernel\shardingsphere-transaction\shardingsphere-transaction-type\shardingsphere-transaction-xa\shardingsphere-transaction-xa-core\src\main\java\org\apache\shardingsphere\transaction\xa\jta\connection\dialect\MySQLXAConnectionWrapper.java,0,22,4,11,0,37
 shardingsphere-master\shardingsphere-master\shardingsphere-sql-parser\shardingsphere-sql-parser-statement\src\main\java\org\apache\shardingsphere\sql\parser\sql\dialect\statement\sql92\dml\SQL92UpdateStatement.java,0,1,0,4,0,5
 shardingsphere-master\shardingsphere-master\shardingsphere-mode\shardingsphere-mode-type\shardingsphere-cluster-mode\shardingsphere-cluster-mode-core\src\main\java\org\apache\shardingsphere\mode\manager\cluster\process\GovernanceExecuteProcessReporter.java,0,13,0,19,0,32
 shardingsphere-master\shardingsphere-master\shardingsphere-proxy\shardingsphere-proxy-backend\src\main\java\org\apache\shardingsphere\proxy\backend\text\transaction\TransactionBackendHandler.java,0,44,1,41,0,86
 shardingsphere-master\shardingsphere-master\shardingsphere-sql-parser\shardingsphere-sql-parser-statement\src\main\java\org\apache\shardingsphere\sql\parser\sql\dialect\statement\mysql\ddl\MySQLDropEventStatement.java,0,1,0,5,0,6
 shardingsphere-master\shardingsphere-master\shardingsphere-infra\shardingsphere-infra-executor\src\main\java\org\apache\shardingsphere\infra\executor\sql\execute\engine\driver\vertx\VertxExecutorCallback.java,0,10,0,13,0,23
 shardingsphere-master\shardingsphere-master\shardingsphere-sql-parser\shardingsphere-sql-parser-statement\src\main\java\org\apache\shardingsphere\sql\parser\sql\common\segment\generic\OwnerAvailable.java,0,2,0,1,0,3
 shardingsphere-master\shardingsphere-master\shardingsphere-db-protocol\shardingsphere-db-protocol-mysql\src\main\java\org\apache\shardingsphere\db\protocol\mysql\packet\command\MySQLCommandPacket.java,0,6,1,1,0,8
 shardingsphere-master\shardingsphere-master\shardingsphere-features\shardingsphere-sharding\shardingsphere-sharding-core\src\main\java\org\apache\shardingsphere\sharding\rewrite\token\pojo\ShardingInsertValuesToken.java,0,10,0,8,0,18
 shardingsphere-master\shardingsphere-master\shardingsphere-sql-parser\shardingsphere-sql-parser-dialect\shardingsphere-sql-parser-mysql\src\main\java\org\apache\shardingsphere\sql\parser\mysql\visitor\MySQLSQLStatVisitor.java,0,26,0,28,0,54
 shardingsphere-master\shardingsphere-master\shardingsphere-kernel\shardingsphere-data-pipeline\shardingsphere-data-pipeline-dialect\shardingsphere-data-pipeline-opengauss\src\main\java\org\apache\shardingsphere\data\pipeline\opengauss\ingest\wal\decode\OpenGaussLogSequenceNumber.java,0,4,0,2,0,6
 shardingsphere-master\shardingsphere-master\shardingsphere-kernel\shardingsphere-data-pipeline\shardingsphere-data-pipeline-dialect\shardingsphere-data-pipeline-postgresql\src\main\java\org\apache\shardingsphere\data\pipeline\postgresql\ingest\wal\event\UpdateRowEvent.java,0,2,0,1,0,3
 shardingsphere-master\shardingsphere-master\shardingsphere-sql-parser\shardingsphere-sql-parser-statement\src\test\java\org\apache\shardingsphere\sql\parser\sql\dialect\handler\ddl\CreateProcedureStatementHandlerTest.java,0,8,0,7,0,15
 shardingsphere-master\shardingsphere-master\examples\shardingsphere-proxy-example\shardingsphere-proxy-distsql-example\src\main\java\org\apache\shardingsphere\example\proxy\distsql\feature\shadow\ShadowExecutor.java,0,47,6,11,0,64
 shardingsphere-master\shardingsphere-master\shardingsphere-spi\src\test\java\org\apache\shardingsphere\spi\fixture\ordered\OrderedSPIFixture.java,0,2,0,2,0,4
 shardingsphere-master\shardingsphere-master\shardingsphere-test\shardingsphere-parser-test\src\main\java\org\apache\shardingsphere\test\sql\parser\parameterized\asserts\statement\distsql\ral\impl\scaling\update\StartScalingStatementAssert.java,0,11,1,13,0,25
 shardingsphere-master\shardingsphere-master\shardingsphere-infra\shardingsphere-infra-common\src\main\java\org\apache\shardingsphere\infra\metadata\schema\model\ConstraintMetaData.java,0,4,0,1,0,5
 shardingsphere-master\shardingsphere-master\shardingsphere-sql-parser\shardingsphere-sql-parser-statement\src\main\java\org\apache\shardingsphere\sql\parser\sql\dialect\statement\opengauss\ddl\OpenGaussCreateSchemaStatement.java,0,1,0,6,0,7
 shardingsphere-master\shardingsphere-master\shardingsphere-agent\shardingsphere-agent-plugins\shardingsphere-agent-plugin-metrics\shardingsphere-agent-metrics-prometheus\src\main\java\org\apache\shardingsphere\agent\metrics\prometheus\definition\PrometheusPluginDefinitionService.java,0,12,4,11,0,27
 shardingsphere-master\shardingsphere-master\shardingsphere-kernel\shardingsphere-data-pipeline\shardingsphere-data-pipeline-core\src\main\java\org\apache\shardingsphere\data\pipeline\core\datasource\PipelineDataSourceFactory.java,0,5,0,7,0,12
 shardingsphere-master\shardingsphere-master\shardingsphere-test\shardingsphere-integration-agent-test\shardingsphere-integration-agent-test-plugins\shardingsphere-integration-agent-test-common\src\test\java\org\apache\shardingsphere\integration\agent\test\common\BasePluginIT.java,26,11,0,6,0,17
 shardingsphere-master\shardingsphere-master\shardingsphere-kernel\shardingsphere-authority\shardingsphere-authority-core\src\main\java\org\apache\shardingsphere\authority\provider\natived\model\privilege\admin\AdministrativePrivileges.java,0,7,0,4,0,11
 shardingsphere-master\shardingsphere-master\shardingsphere-kernel\shardingsphere-authority\shardingsphere-authority-core\src\main\java\org\apache\shardingsphere\authority\provider\natived\model\privilege\database\DatabasePrivileges.java,0,24,0,15,0,39
 shardingsphere-master\shardingsphere-master\shardingsphere-infra\shardingsphere-infra-common\src\main\java\org\apache\shardingsphere\infra\rule\builder\global\DefaultGlobalRuleConfigurationBuilder.java,0,3,0,3,0,6
 shardingsphere-master\shardingsphere-master\shardingsphere-features\shardingsphere-db-discovery\shardingsphere-db-discovery-core\src\main\java\org\apache\shardingsphere\dbdiscovery\yaml\config\rule\YamlDatabaseDiscoveryDataSourceRuleConfiguration.java,0,7,0,2,0,9
 shardingsphere-master\shardingsphere-master\shardingsphere-spi\src\test\java\org\apache\shardingsphere\spi\fixture\typed\TypedSPIFixture.java,0,0,0,1,0,1
 shardingsphere-master\shardingsphere-master\shardingsphere-jdbc\shardingsphere-jdbc-core\src\test\java\org\apache\shardingsphere\driver\jdbc\unsupported\UnsupportedOperationStatementTest.java,0,19,0,7,0,26
 shardingsphere-master\shardingsphere-master\shardingsphere-test\shardingsphere-parser-test\src\main\java\org\apache\shardingsphere\test\sql\parser\parameterized\jaxb\cases\domain\segment\impl\charset\ExpectedCharsetName.java,0,3,0,3,0,6
 shardingsphere-master\shardingsphere-master\shardingsphere-proxy\shardingsphere-proxy-frontend\shardingsphere-proxy-frontend-mysql\src\test\java\org\apache\shardingsphere\proxy\frontend\mysql\command\admin\MySQLComSetOptionExecutorTest.java,0,14,0,5,0,19
 shardingsphere-master\shardingsphere-master\shardingsphere-test\shardingsphere-integration-test\shardingsphere-integration-test-suite\src\test\java\org\apache\shardingsphere\test\integration\engine\BaseITCase.java,51,35,0,10,0,45
 shardingsphere-master\shardingsphere-master\shardingsphere-test\shardingsphere-integration-test\shardingsphere-integration-test-suite\src\test\java\org\apache\shardingsphere\test\integration\engine\ral\BaseRALIT.java,93,33,2,22,0,57
 shardingsphere-master\shardingsphere-master\shardingsphere-sql-parser\shardingsphere-sql-parser-statement\src\test\java\org\apache\shardingsphere\sql\parser\sql\common\statement\dml\EmptyStatementTest.java,0,3,0,1,0,4
 shardingsphere-master\shardingsphere-master\shardingsphere-infra\shardingsphere-infra-binder\src\main\java\org\apache\shardingsphere\infra\binder\segment\select\projection\impl\SubqueryProjection.java,0,6,0,2,0,8
 shardingsphere-master\shardingsphere-master\shardingsphere-db-protocol\shardingsphere-db-protocol-mysql\src\test\java\org\apache\shardingsphere\db\protocol\mysql\packet\command\binlog\MySQLComBinlogDumpCommandPacketTest.java,0,18,0,5,0,23
 shardingsphere-master\shardingsphere-master\shardingsphere-test\shardingsphere-parser-test\src\main\java\org\apache\shardingsphere\test\sql\parser\parameterized\asserts\statement\distsql\rdl\drop\impl\DropShardingKeyGeneratorStatementAssert.java,0,7,0,10,0,17
 shardingsphere-master\shardingsphere-master\shardingsphere-mode\shardingsphere-mode-type\shardingsphere-cluster-mode\shardingsphere-cluster-mode-core\src\main\java\org\apache\shardingsphere\mode\manager\cluster\yaml\ClusterPersistRepositoryConfigurationYamlSwapper.java,0,10,0,10,0,20
 shardingsphere-master\shardingsphere-master\shardingsphere-sql-parser\shardingsphere-sql-parser-statement\src\main\java\org\apache\shardingsphere\sql\parser\sql\common\segment\dml\expr\BetweenExpression.java,0,13,0,1,0,14
 shardingsphere-master\shardingsphere-master\shardingsphere-kernel\shardingsphere-data-pipeline\shardingsphere-data-pipeline-dialect\shardingsphere-data-pipeline-postgresql\src\main\java\org\apache\shardingsphere\data\pipeline\postgresql\ingest\PostgreSQLInventoryDumper.java,0,20,0,14,0,34
 shardingsphere-master\shardingsphere-master\shardingsphere-test\shardingsphere-parser-test\src\main\java\org\apache\shardingsphere\test\sql\parser\parameterized\jaxb\cases\domain\segment\impl\assignment\ExpectedValueAssign.java,0,4,0,3,0,7
 shardingsphere-master\shardingsphere-master\shardingsphere-features\shardingsphere-sharding\shardingsphere-sharding-core\src\test\java\org\apache\shardingsphere\sharding\route\strategy\fixture\HintShardingAlgorithmFixture.java,0,6,2,5,0,13
 shardingsphere-master\shardingsphere-master\shardingsphere-proxy\shardingsphere-proxy-backend\src\test\java\org\apache\shardingsphere\proxy\backend\response\header\query\impl\OpenGaussQueryHeaderBuilderTest.java,0,13,0,11,0,24
 shardingsphere-master\shardingsphere-master\shardingsphere-features\shardingsphere-sharding\shardingsphere-sharding-distsql\shardingsphere-sharding-distsql-handler\src\test\java\org\apache\shardingsphere\sharding\distsql\update\AlterShardingBroadcastTableRuleStatementUpdaterTest.java,0,9,0,9,0,18
 shardingsphere-master\shardingsphere-master\shardingsphere-features\shardingsphere-sharding\shardingsphere-sharding-distsql\shardingsphere-sharding-distsql-statement\src\main\java\org\apache\shardingsphere\sharding\distsql\parser\statement\hint\AddShardingHintTableValueStatement.java,0,5,0,3,0,8
 shardingsphere-master\shardingsphere-master\shardingsphere-mode\shardingsphere-mode-type\shardingsphere-cluster-mode\shardingsphere-cluster-mode-repository\shardingsphere-cluster-mode-repository-provider\shardingsphere-cluster-mode-repository-etcd\src\main\java\org\apache\shardingsphere\mode\repository\cluster\etcd\props\EtcdPropertyKey.java,0,7,0,1,0,8
 shardingsphere-master\shardingsphere-master\shardingsphere-features\shardingsphere-sharding\shardingsphere-sharding-core\src\test\java\org\apache\shardingsphere\sharding\route\engine\condition\ExpressionConditionUtilsTest.java,0,4,0,6,0,10
 shardingsphere-master\shardingsphere-master\shardingsphere-test\shardingsphere-integration-test\shardingsphere-integration-test-suite\src\test\java\org\apache\shardingsphere\test\integration\framework\param\model\CaseParameterizedArray.java,0,10,0,3,0,13
 shardingsphere-master\shardingsphere-master\shardingsphere-features\shardingsphere-sharding\shardingsphere-sharding-spring\shardingsphere-sharding-spring-namespace\src\main\java\org\apache\shardingsphere\sharding\spring\namespace\parser\rule\ShardingRuleBeanDefinitionParser.java,0,77,0,66,0,143
 shardingsphere-master\shardingsphere-master\shardingsphere-features\shardingsphere-sharding\shardingsphere-sharding-distsql\shardingsphere-sharding-distsql-handler\src\main\java\org\apache\shardingsphere\sharding\distsql\handler\update\CreateShardingTableRuleStatementUpdater.java,0,16,0,15,0,31
 shardingsphere-master\shardingsphere-master\shardingsphere-kernel\shardingsphere-data-pipeline\shardingsphere-data-pipeline-spi\src\main\java\org\apache\shardingsphere\data\pipeline\api\PipelineJobAPIFactory.java,0,5,1,2,0,8
 shardingsphere-master\shardingsphere-master\shardingsphere-infra\shardingsphere-infra-executor\src\main\java\org\apache\shardingsphere\infra\executor\sql\prepare\ExecutionPrepareDecorator.java,0,5,0,3,0,8
 shardingsphere-master\shardingsphere-master\shardingsphere-kernel\shardingsphere-data-pipeline\shardingsphere-data-pipeline-dialect\shardingsphere-data-pipeline-mysql\src\test\java\org\apache\shardingsphere\data\pipeline\mysql\ingest\MySQLJdbcDumperTest.java,0,22,3,18,0,43
 shardingsphere-master\shardingsphere-master\shardingsphere-db-protocol\shardingsphere-db-protocol-mysql\src\test\java\org\apache\shardingsphere\db\protocol\mysql\packet\binlog\row\column\value\decimal\MySQLFloatBinlogProtocolValueTest.java,0,11,0,4,0,15
 shardingsphere-master\shardingsphere-master\shardingsphere-jdbc\shardingsphere-jdbc-core\src\main\java\org\apache\shardingsphere\driver\state\circuit\CircuitBreakDriverState.java,0,4,0,3,0,7
 shardingsphere-master\shardingsphere-master\shardingsphere-sql-parser\shardingsphere-sql-parser-statement\src\main\java\org\apache\shardingsphere\sql\parser\sql\dialect\statement\postgresql\ddl\PostgreSQLCreateDatabaseStatement.java,0,1,0,5,0,6
 shardingsphere-master\shardingsphere-master\shardingsphere-sql-parser\shardingsphere-sql-parser-statement\src\main\java\org\apache\shardingsphere\sql\parser\sql\dialect\statement\opengauss\ddl\OpenGaussAlterProcedureStatement.java,0,1,0,5,0,6
 shardingsphere-master\shardingsphere-master\shardingsphere-sql-parser\shardingsphere-sql-parser-statement\src\main\java\org\apache\shardingsphere\sql\parser\sql\common\statement\ddl\DropLanguageStatement.java,3,1,1,3,0,5
 shardingsphere-master\shardingsphere-master\shardingsphere-sql-parser\shardingsphere-sql-parser-statement\src\main\java\org\apache\shardingsphere\sql\parser\sql\common\segment\dml\order\item\IndexOrderByItemSegment.java,0,10,0,3,0,13
 shardingsphere-master\shardingsphere-master\shardingsphere-kernel\shardingsphere-data-pipeline\shardingsphere-data-pipeline-dialect\shardingsphere-data-pipeline-mysql\src\main\java\org\apache\shardingsphere\data\pipeline\mysql\ingest\client\PasswordEncryption.java,0,20,0,12,0,32
 shardingsphere-master\shardingsphere-master\shardingsphere-test\shardingsphere-parser-test\src\main\java\org\apache\shardingsphere\test\sql\parser\parameterized\jaxb\cases\domain\segment\impl\table\ExpectedSubqueryTable.java,0,5,0,5,0,10
 shardingsphere-master\shardingsphere-master\shardingsphere-infra\shardingsphere-infra-executor\src\main\java\org\apache\shardingsphere\infra\executor\sql\process\model\ExecuteProcessUnit.java,0,8,0,2,0,10
 shardingsphere-master\shardingsphere-master\shardingsphere-mode\shardingsphere-mode-type\shardingsphere-cluster-mode\shardingsphere-cluster-mode-core\src\test\java\org\apache\shardingsphere\mode\manager\cluster\coordinator\registry\status\storage\service\StorageNodeStatusServiceTest.java,0,7,0,5,0,12
 shardingsphere-master\shardingsphere-master\examples\example-core\example-spring-mybatis\src\main\java\org\apache\shardingsphere\example\core\mybatis\service\UserServiceImpl.java,64,23,0,8,0,31
 shardingsphere-master\shardingsphere-master\shardingsphere-features\shardingsphere-readwrite-splitting\shardingsphere-readwrite-splitting-distsql\shardingsphere-readwrite-splitting-distsql-statement\src\main\java\org\apache\shardingsphere\readwritesplitting\distsql\parser\statement\hint\SetReadwriteSplittingHintStatement.java,0,3,0,4,0,7
 shardingsphere-master\shardingsphere-master\shardingsphere-kernel\shardingsphere-transaction\shardingsphere-transaction-type\shardingsphere-transaction-xa\shardingsphere-transaction-xa-provider\shardingsphere-transaction-xa-bitronix\src\test\java\org\apache\shardingsphere\transaction\xa\bitronix\manager\fixture\ReflectiveUtil.java,0,6,1,2,0,9
 shardingsphere-master\shardingsphere-master\shardingsphere-infra\shardingsphere-infra-executor\src\main\java\org\apache\shardingsphere\infra\executor\sql\log\SQLLogger.java,0,14,0,8,0,22
 shardingsphere-master\shardingsphere-master\shardingsphere-db-protocol\shardingsphere-db-protocol-postgresql\src\test\java\org\apache\shardingsphere\db\protocol\postgresql\packet\generic\PostgreSQLParameterStatusPacketTest.java,0,5,0,7,0,12
 shardingsphere-master\shardingsphere-master\shardingsphere-infra\shardingsphere-infra-common\src\test\java\org\apache\shardingsphere\infra\datasource\pool\destroyer\DataSourcePoolDestroyerTest.java,0,9,0,2,0,11
 shardingsphere-master\shardingsphere-master\shardingsphere-distsql\shardingsphere-distsql-statement\src\main\java\org\apache\shardingsphere\distsql\parser\statement\ral\common\updatable\UnlabelInstanceStatement.java,9,6,0,2,0,8
 shardingsphere-master\shardingsphere-master\shardingsphere-proxy\shardingsphere-proxy-frontend\shardingsphere-proxy-frontend-reactive-core\src\test\java\org\apache\shardingsphere\proxy\frontend\reactive\protocol\ReactiveDatabaseProtocolFrontendEngineFactoryTest.java,0,6,0,3,0,9
 shardingsphere-master\shardingsphere-master\shardingsphere-features\shardingsphere-sharding\shardingsphere-sharding-distsql\shardingsphere-sharding-distsql-handler\src\main\java\org\apache\shardingsphere\sharding\distsql\handler\checker\ShardingTableRuleStatementChecker.java,0,105,1,93,0,199
 shardingsphere-master\shardingsphere-master\shardingsphere-infra\shardingsphere-infra-rewrite\src\main\java\org\apache\shardingsphere\infra\rewrite\engine\result\RouteSQLRewriteResult.java,0,2,0,1,0,3
 shardingsphere-master\shardingsphere-master\shardingsphere-test\shardingsphere-parser-test\src\main\java\org\apache\shardingsphere\test\sql\parser\parameterized\asserts\segment\distsql\rdl\EncryptRuleAssert.java,0,15,0,19,0,34
 shardingsphere-master\shardingsphere-master\shardingsphere-features\shardingsphere-shadow\shardingsphere-shadow-distsql\shardingsphere-shadow-distsql-handler\src\main\java\org\apache\shardingsphere\shadow\distsql\handler\query\ShadowTableRuleQueryResultSet.java,0,23,0,10,0,33
 shardingsphere-master\shardingsphere-master\shardingsphere-features\shardingsphere-sharding\shardingsphere-sharding-distsql\shardingsphere-sharding-distsql-statement\src\main\java\org\apache\shardingsphere\sharding\distsql\parser\statement\ShowShardingKeyGeneratorsStatement.java,0,3,0,4,0,7
 shardingsphere-master\shardingsphere-master\shardingsphere-features\shardingsphere-sharding\shardingsphere-sharding-distsql\shardingsphere-sharding-distsql-statement\src\main\java\org\apache\shardingsphere\scaling\distsql\statement\StopScalingStatement.java,0,2,0,2,0,4
 shardingsphere-master\shardingsphere-master\shardingsphere-test\shardingsphere-parser-test\src\main\java\org\apache\shardingsphere\test\sql\parser\parameterized\jaxb\cases\domain\statement\distsql\ral\ShowInstanceStatementTestCase.java,0,0,0,3,0,3
 shardingsphere-master\shardingsphere-master\shardingsphere-sql-parser\shardingsphere-sql-parser-statement\src\main\java\org\apache\shardingsphere\sql\parser\sql\dialect\statement\postgresql\dal\PostgreSQLVacuumStatement.java,0,1,0,5,0,6
 shardingsphere-master\shardingsphere-master\shardingsphere-features\shardingsphere-sharding\shardingsphere-sharding-distsql\shardingsphere-sharding-distsql-handler\src\main\java\org\apache\shardingsphere\sharding\distsql\handler\update\AlterShardingBindingTableRulesStatementUpdater.java,0,34,0,30,0,64
 shardingsphere-master\shardingsphere-master\shardingsphere-infra\shardingsphere-infra-common\src\test\java\org\apache\shardingsphere\infra\database\metadata\url\StandardJdbcUrlParserTest.java,0,25,4,11,0,40
 shardingsphere-master\shardingsphere-master\shardingsphere-infra\shardingsphere-infra-common\src\test\java\org\apache\shardingsphere\infra\datasource\props\DataSourcePropertiesTest.java,0,48,2,25,0,75
 shardingsphere-master\shardingsphere-master\shardingsphere-proxy\shardingsphere-proxy-frontend\shardingsphere-proxy-frontend-core\src\test\java\org\apache\shardingsphere\proxy\frontend\connection\ConnectionIdGeneratorTest.java,0,8,1,1,0,10
 shardingsphere-master\shardingsphere-master\shardingsphere-test\shardingsphere-parser-test\src\main\java\org\apache\shardingsphere\test\sql\parser\parameterized\asserts\statement\distsql\rdl\create\impl\CreateReadwriteSplittingRuleStatementAssert.java,0,18,0,23,0,41
 shardingsphere-master\shardingsphere-master\shardingsphere-test\shardingsphere-parser-test\src\main\java\org\apache\shardingsphere\test\sql\parser\parameterized\asserts\statement\dal\impl\ShowStatusStatementAssert.java,0,4,0,8,0,12
 shardingsphere-master\shardingsphere-master\shardingsphere-infra\shardingsphere-infra-common\src\main\java\org\apache\shardingsphere\infra\database\type\dialect\OracleDatabaseType.java,0,12,2,5,0,19
 shardingsphere-master\shardingsphere-master\shardingsphere-mode\shardingsphere-mode-type\shardingsphere-cluster-mode\shardingsphere-cluster-mode-core\src\main\java\org\apache\shardingsphere\mode\manager\cluster\coordinator\registry\status\storage\event\DisabledStateChangedEvent.java,0,5,0,3,0,8
 shardingsphere-master\shardingsphere-master\shardingsphere-mode\shardingsphere-mode-type\shardingsphere-cluster-mode\shardingsphere-cluster-mode-core\src\main\java\org\apache\shardingsphere\mode\manager\cluster\coordinator\registry\config\event\rule\ScalingReleaseSchemaNameLockEvent.java,0,1,0,2,0,3
 shardingsphere-master\shardingsphere-master\shardingsphere-jdbc\shardingsphere-jdbc-core\src\test\java\org\apache\shardingsphere\driver\state\ok\OKDriverStateTest.java,0,6,1,5,0,12
 shardingsphere-master\shardingsphere-master\shardingsphere-test\shardingsphere-integration-driver-test\src\test\java\org\apache\shardingsphere\driver\mix\YamlShardingWithReadwriteSplittingIntegrateTest.java,0,21,0,14,0,35
 shardingsphere-master\shardingsphere-master\shardingsphere-sql-parser\shardingsphere-sql-parser-statement\src\main\java\org\apache\shardingsphere\sql\parser\sql\dialect\statement\sqlserver\tcl\SQLServerCommitStatement.java,0,1,0,5,0,6
 shardingsphere-master\shardingsphere-master\shardingsphere-infra\shardingsphere-infra-binder\src\main\java\org\apache\shardingsphere\infra\binder\statement\dcl\DenyUserStatementContext.java,0,10,0,8,0,18
 shardingsphere-master\shardingsphere-master\shardingsphere-test\shardingsphere-parser-test\src\main\java\org\apache\shardingsphere\test\sql\parser\parameterized\jaxb\sql\SQLCaseType.java,0,3,0,1,0,4
 shardingsphere-master\shardingsphere-master\shardingsphere-infra\shardingsphere-infra-common\src\main\java\org\apache\shardingsphere\infra\datasource\pool\metadata\DataSourcePoolMetaDataReflection.java,0,14,1,4,0,19
 shardingsphere-master\shardingsphere-master\shardingsphere-agent\shardingsphere-agent-plugins\shardingsphere-agent-plugin-tracing\shardingsphere-agent-tracing-opentracing\src\test\java\org\apache\shardingsphere\agent\plugin\tracing\opentracing\definition\OpenTracingPluginDefinitionServiceTest.java,0,11,0,4,0,15
 shardingsphere-master\shardingsphere-master\shardingsphere-mode\shardingsphere-mode-core\src\test\java\org\apache\shardingsphere\mode\metadata\persist\service\impl\SchemaRulePersistServiceTest.java,0,18,0,10,0,28
 shardingsphere-master\shardingsphere-master\shardingsphere-features\shardingsphere-sharding\shardingsphere-sharding-distsql\shardingsphere-sharding-distsql-statement\src\main\java\org\apache\shardingsphere\sharding\distsql\parser\segment\AbstractTableRuleSegment.java,19,9,1,1,0,11
 shardingsphere-master\shardingsphere-master\shardingsphere-sql-parser\shardingsphere-sql-parser-statement\src\main\java\org\apache\shardingsphere\sql\parser\sql\common\segment\ddl\constraint\ConstraintSegment.java,0,6,0,2,0,8
 shardingsphere-master\shardingsphere-master\shardingsphere-infra\shardingsphere-infra-common\src\main\java\org\apache\shardingsphere\infra\properties\TypedProperties.java,0,12,0,5,0,17
 shardingsphere-master\shardingsphere-master\shardingsphere-infra\shardingsphere-infra-common\src\test\java\org\apache\shardingsphere\infra\database\type\dialect\SQL92DatabaseTypeTest.java,0,20,1,10,0,31
 shardingsphere-master\shardingsphere-master\shardingsphere-test\shardingsphere-parser-test\src\main\java\org\apache\shardingsphere\test\sql\parser\parameterized\jaxb\cases\domain\segment\impl\generic\ExpectedDataType.java,0,3,0,3,0,6
 shardingsphere-master\shardingsphere-master\shardingsphere-sql-parser\shardingsphere-sql-parser-statement\src\main\java\org\apache\shardingsphere\sql\parser\sql\common\segment\generic\OutputSegment.java,0,11,0,5,2,18
 shardingsphere-master\shardingsphere-master\shardingsphere-features\shardingsphere-sharding\shardingsphere-sharding-distsql\shardingsphere-sharding-distsql-handler\src\main\java\org\apache\shardingsphere\sharding\distsql\handler\update\DropShardingAlgorithmStatementUpdater.java,0,39,0,34,0,73
 shardingsphere-master\shardingsphere-master\shardingsphere-test\shardingsphere-parser-test\src\main\java\org\apache\shardingsphere\test\sql\parser\parameterized\jaxb\cases\domain\statement\ddl\DropDomainStatementTestCase.java,0,0,0,3,0,3
 shardingsphere-master\shardingsphere-master\shardingsphere-mode\shardingsphere-mode-type\shardingsphere-cluster-mode\shardingsphere-cluster-mode-core\src\main\java\org\apache\shardingsphere\mode\manager\cluster\coordinator\lock\watcher\LockChangedWatcher.java,0,8,0,13,0,21
 shardingsphere-master\shardingsphere-master\shardingsphere-mode\shardingsphere-mode-type\shardingsphere-cluster-mode\shardingsphere-cluster-mode-core\src\main\java\org\apache\shardingsphere\mode\manager\cluster\coordinator\lock\service\LockState.java,0,3,0,1,0,4
 shardingsphere-master\shardingsphere-master\shardingsphere-infra\shardingsphere-infra-merge\src\main\java\org\apache\shardingsphere\infra\merge\MergeEngine.java,0,40,0,22,0,62
 shardingsphere-master\shardingsphere-master\shardingsphere-features\shardingsphere-sharding\shardingsphere-sharding-spring\shardingsphere-sharding-spring-boot-starter\src\main\java\org\apache\shardingsphere\sharding\spring\boot\algorithm\KeyGenerateAlgorithmProvidedBeanRegistry.java,0,10,0,6,0,16
 shardingsphere-master\shardingsphere-master\shardingsphere-features\shardingsphere-sharding\shardingsphere-sharding-distsql\shardingsphere-sharding-distsql-handler\src\main\java\org\apache\shardingsphere\scaling\distsql\handler\CheckScalingQueryResultSet.java,0,15,0,9,0,24
 shardingsphere-master\shardingsphere-master\shardingsphere-features\shardingsphere-sharding\shardingsphere-sharding-core\src\main\java\org\apache\shardingsphere\sharding\yaml\swapper\ShardingRuleConfigurationConverter.java,0,6,1,6,0,13
 shardingsphere-master\shardingsphere-master\shardingsphere-test\shardingsphere-parser-test\src\main\java\org\apache\shardingsphere\test\sql\parser\parameterized\jaxb\cases\domain\statement\distsql\rdl\drop\DropEncryptRuleStatementTestCase.java,0,4,0,3,0,7
 shardingsphere-master\shardingsphere-master\shardingsphere-proxy\shardingsphere-proxy-backend\src\main\java\org\apache\shardingsphere\proxy\backend\text\distsql\ral\common\updatable\AlterTrafficRuleHandler.java,0,34,0,37,0,71
 shardingsphere-master\shardingsphere-master\shardingsphere-infra\shardingsphere-infra-common\src\main\java\org\apache\shardingsphere\infra\database\type\dialect\MySQLDatabaseType.java,0,15,0,7,0,22
 shardingsphere-master\shardingsphere-master\shardingsphere-test\shardingsphere-parser-test\src\main\java\org\apache\shardingsphere\test\sql\parser\parameterized\jaxb\cases\domain\statement\distsql\rdl\create\CreateDatabaseDiscoveryConstructionRuleStatementTestCase.java,0,4,0,6,0,10
 shardingsphere-master\shardingsphere-master\shardingsphere-test\shardingsphere-parser-test\src\main\java\org\apache\shardingsphere\test\sql\parser\parameterized\jaxb\cases\domain\statement\ddl\DropServiceStatementTestCase.java,0,0,0,3,0,3
 shardingsphere-master\shardingsphere-master\shardingsphere-proxy\shardingsphere-proxy-backend\src\main\java\org\apache\shardingsphere\proxy\backend\text\distsql\ral\common\hint\executor\ShowShardingHintStatusExecutor.java,0,34,1,29,0,64
 shardingsphere-master\shardingsphere-master\shardingsphere-kernel\shardingsphere-data-pipeline\shardingsphere-data-pipeline-spi\src\main\java\org\apache\shardingsphere\data\pipeline\api\datanode\JobDataNodeLine.java,0,9,0,5,0,14
 shardingsphere-master\shardingsphere-master\shardingsphere-jdbc\shardingsphere-jdbc-core\src\test\java\org\apache\shardingsphere\driver\jdbc\core\statement\EncryptPreparedStatementTest.java,0,98,10,35,0,143
 shardingsphere-master\shardingsphere-master\shardingsphere-sql-parser\shardingsphere-sql-parser-statement\src\main\java\org\apache\shardingsphere\sql\parser\sql\dialect\statement\sql92\ddl\SQL92AlterTableStatement.java,0,2,0,4,0,6
 shardingsphere-master\shardingsphere-master\shardingsphere-sql-parser\shardingsphere-sql-parser-statement\src\main\java\org\apache\shardingsphere\sql\parser\sql\dialect\statement\opengauss\ddl\OpenGaussAlterTablespaceStatement.java,0,1,0,5,0,6
 shardingsphere-master\shardingsphere-master\shardingsphere-spi\src\main\java\org\apache\shardingsphere\spi\typed\TypedSPI.java,0,8,1,1,0,10
 shardingsphere-master\shardingsphere-master\shardingsphere-sql-parser\shardingsphere-sql-parser-statement\src\main\java\org\apache\shardingsphere\sql\parser\sql\dialect\statement\mysql\ddl\MySQLDeallocateStatement.java,0,1,0,4,0,5
 shardingsphere-master\shardingsphere-master\shardingsphere-spi\src\test\java\org\apache\shardingsphere\spi\fixture\singleton\SingletonSPIFixture.java,0,1,0,1,0,2
 shardingsphere-master\shardingsphere-master\shardingsphere-test\shardingsphere-parser-test\src\main\java\org\apache\shardingsphere\test\sql\parser\parameterized\jaxb\cases\domain\statement\dal\ShowCreateTableStatementTestCase.java,0,2,0,4,0,6
 shardingsphere-master\shardingsphere-master\shardingsphere-features\shardingsphere-shadow\shardingsphere-shadow-core\src\main\java\org\apache\shardingsphere\shadow\algorithm\config\AlgorithmProvidedShadowRuleConfiguration.java,0,13,0,8,0,21
 shardingsphere-master\shardingsphere-master\examples\shardingsphere-jdbc-example\mixed-feature-example\sharding-readwrite-splitting-example\sharding-readwrite-splitting-spring-boot-jpa-example\src\main\java\org\apache\shardingsphere\example\sharding\readwrite\splitting\spring\boot\jpa\ShardingReadwriteSplittingSpringBootJpaExample.java,9,6,1,5,0,12
 shardingsphere-master\shardingsphere-master\shardingsphere-infra\shardingsphere-infra-rewrite\src\test\java\org\apache\shardingsphere\infra\rewrite\parameter\builder\impl\GroupedParameterBuilderTest.java,0,50,0,12,0,62
 shardingsphere-master\shardingsphere-master\shardingsphere-kernel\shardingsphere-data-pipeline\shardingsphere-data-pipeline-core\src\main\java\org\apache\shardingsphere\data\pipeline\core\ingest\channel\memory\SimpleMemoryPipelineChannel.java,0,21,0,7,0,28
 shardingsphere-master\shardingsphere-master\shardingsphere-infra\shardingsphere-infra-executor\src\main\java\org\apache\shardingsphere\infra\executor\sql\execute\engine\driver\jdbc\sane\mysql\MySQLDefaultVariable.java,0,8,0,2,0,10
 shardingsphere-master\shardingsphere-master\shardingsphere-kernel\shardingsphere-transaction\shardingsphere-transaction-type\shardingsphere-transaction-xa\shardingsphere-transaction-xa-core\src\main\java\org\apache\shardingsphere\transaction\xa\jta\datasource\properties\dialect\MySQLXADataSourceDefinition.java,0,4,0,5,0,9
 shardingsphere-master\shardingsphere-master\shardingsphere-mode\shardingsphere-mode-type\shardingsphere-standalone-mode\shardingsphere-standalone-mode-core\src\main\java\org\apache\shardingsphere\mode\manager\standalone\StandaloneContextManagerBuilder.java,0,38,0,36,0,74
 shardingsphere-master\shardingsphere-master\shardingsphere-features\shardingsphere-sharding\shardingsphere-sharding-core\src\test\java\org\apache\shardingsphere\sharding\route\engine\type\broadcast\ShardingInstanceBroadcastRoutingEngineTest.java,0,18,0,7,0,25
 shardingsphere-master\shardingsphere-master\shardingsphere-infra\shardingsphere-infra-binder\src\main\java\org\apache\shardingsphere\infra\binder\segment\select\orderby\OrderByContext.java,0,5,0,1,0,6
 shardingsphere-master\shardingsphere-master\shardingsphere-kernel\shardingsphere-data-pipeline\shardingsphere-data-pipeline-core\src\main\java\org\apache\shardingsphere\data\pipeline\core\exception\PipelineVerifyFailedException.java,0,13,1,3,0,17
 shardingsphere-master\shardingsphere-master\shardingsphere-infra\shardingsphere-infra-common\src\main\java\org\apache\shardingsphere\infra\config\algorithm\ShardingSphereAlgorithm.java,0,1,0,1,0,2
 shardingsphere-master\shardingsphere-master\examples\shardingsphere-proxy-example\shardingsphere-proxy-distsql-example\src\main\java\org\apache\shardingsphere\example\proxy\distsql\feature\AbstractFeatureExecutor.java,21,10,0,2,0,12
 shardingsphere-master\shardingsphere-master\shardingsphere-infra\shardingsphere-infra-federation\shardingsphere-infra-federation-optimizer\src\main\java\org\apache\shardingsphere\infra\federation\optimizer\planner\QueryOptimizePlannerFactory.java,0,5,0,1,0,6
 shardingsphere-master\shardingsphere-master\shardingsphere-infra\shardingsphere-infra-binder\src\test\java\org\apache\shardingsphere\infra\binder\segment\insert\values\expression\DerivedLiteralExpressionSegmentTest.java,0,4,0,2,0,6
 shardingsphere-master\shardingsphere-master\shardingsphere-infra\shardingsphere-infra-binder\src\main\java\org\apache\shardingsphere\infra\binder\segment\insert\values\InsertSelectContext.java,0,17,0,6,0,23
 shardingsphere-master\shardingsphere-master\shardingsphere-kernel\shardingsphere-data-pipeline\shardingsphere-data-pipeline-spi\src\main\java\org\apache\shardingsphere\data\pipeline\api\config\ingest\InventoryDumperConfiguration.java,0,14,0,3,0,17
 shardingsphere-master\shardingsphere-master\shardingsphere-kernel\shardingsphere-data-pipeline\shardingsphere-data-pipeline-dialect\shardingsphere-data-pipeline-mysql\src\main\java\org\apache\shardingsphere\data\pipeline\mysql\ingest\binlog\BinlogPosition.java,0,12,0,3,0,15
 shardingsphere-master\shardingsphere-master\shardingsphere-agent\shardingsphere-agent-plugins\shardingsphere-agent-plugin-metrics\shardingsphere-agent-metrics-api\src\test\java\org\apache\shardingsphere\agent\metrics\api\constant\MetricIdsTest.java,0,3,0,1,0,4
 shardingsphere-master\shardingsphere-master\shardingsphere-sql-parser\shardingsphere-sql-parser-statement\src\main\java\org\apache\shardingsphere\sql\parser\sql\dialect\statement\postgresql\ddl\PostgreSQLAlterForeignDataWrapperStatement.java,0,1,0,6,0,7
 shardingsphere-master\shardingsphere-master\shardingsphere-infra\shardingsphere-infra-common\src\main\java\org\apache\shardingsphere\infra\metadata\schema\loader\spi\DialectTableMetaDataLoader.java,0,4,0,3,0,7
 shardingsphere-master\shardingsphere-master\shardingsphere-sql-parser\shardingsphere-sql-parser-statement\src\main\java\org\apache\shardingsphere\sql\parser\sql\dialect\statement\mysql\dal\MySQLKillStatement.java,0,2,0,5,0,7
 shardingsphere-master\shardingsphere-master\shardingsphere-infra\shardingsphere-infra-binder\src\main\java\org\apache\shardingsphere\infra\binder\type\TableAvailable.java,0,4,0,2,0,6
 shardingsphere-master\shardingsphere-master\shardingsphere-kernel\shardingsphere-transaction\shardingsphere-transaction-type\shardingsphere-transaction-xa\shardingsphere-transaction-xa-core\src\main\java\org\apache\shardingsphere\transaction\xa\jta\datasource\swapper\DataSourceSwapper.java,0,34,5,21,0,60
 shardingsphere-master\shardingsphere-master\shardingsphere-features\shardingsphere-encrypt\shardingsphere-encrypt-spring\shardingsphere-encrypt-spring-boot-starter\src\main\java\org\apache\shardingsphere\encrypt\spring\boot\rule\YamlEncryptRuleSpringBootConfiguration.java,0,3,0,2,0,5
 shardingsphere-master\shardingsphere-master\shardingsphere-test\shardingsphere-pipeline-test\src\test\java\org\apache\shardingsphere\data\pipeline\core\check\consistency\SingleTableDataCalculatorRegistryTest.java,0,9,0,5,0,14
 shardingsphere-master\shardingsphere-master\shardingsphere-sql-parser\shardingsphere-sql-parser-dialect\shardingsphere-sql-parser-oracle\src\main\java\org\apache\shardingsphere\sql\parser\oracle\visitor\format\facade\OracleFormatSQLVisitorFacade.java,0,9,0,1,0,10
 shardingsphere-master\shardingsphere-master\shardingsphere-features\shardingsphere-sharding\shardingsphere-sharding-core\src\main\java\org\apache\shardingsphere\sharding\route\engine\type\unicast\ShardingUnicastRoutingEngine.java,0,22,0,19,0,41
 shardingsphere-master\shardingsphere-master\shardingsphere-db-protocol\shardingsphere-db-protocol-mysql\src\test\java\org\apache\shardingsphere\db\protocol\mysql\packet\command\query\binary\execute\protocol\MySQLInt1BinaryProtocolValueTest.java,0,6,0,2,0,8
 shardingsphere-master\shardingsphere-master\shardingsphere-features\shardingsphere-encrypt\shardingsphere-encrypt-core\src\main\java\org\apache\shardingsphere\encrypt\rewrite\aware\EncryptConditionsAware.java,0,3,0,1,0,4
 shardingsphere-master\shardingsphere-master\shardingsphere-infra\shardingsphere-infra-binder\src\main\java\org\apache\shardingsphere\infra\binder\segment\select\projection\Projection.java,0,5,0,1,0,6
 shardingsphere-master\shardingsphere-master\shardingsphere-kernel\shardingsphere-traffic\shardingsphere-traffic-core\src\test\java\org\apache\shardingsphere\traffic\yaml\swapper\TrafficStrategyConfigurationYamlSwapperTest.java,0,20,0,14,0,34
 shardingsphere-master\shardingsphere-master\shardingsphere-test\shardingsphere-parser-test\src\main\java\org\apache\shardingsphere\test\sql\parser\parameterized\jaxb\cases\domain\statement\ddl\DropOwnedStatementTestCase.java,0,0,0,3,0,3
 shardingsphere-master\shardingsphere-master\shardingsphere-proxy\shardingsphere-proxy-backend\src\test\java\org\apache\shardingsphere\proxy\backend\communication\jdbc\transaction\JDBCBackendTransactionManagerTest.java,0,48,2,18,0,68
 shardingsphere-master\shardingsphere-master\shardingsphere-sql-parser\shardingsphere-sql-parser-statement\src\main\java\org\apache\shardingsphere\sql\parser\sql\dialect\statement\postgresql\ddl\PostgreSQLCreateDomainStatement.java,0,1,0,5,0,6
 shardingsphere-master\shardingsphere-master\shardingsphere-kernel\shardingsphere-transaction\shardingsphere-transaction-type\shardingsphere-transaction-xa\shardingsphere-transaction-xa-provider\shardingsphere-transaction-xa-atomikos\src\test\java\org\apache\shardingsphere\transaction\xa\atomikos\manager\AtomikosXARecoverableResourceTest.java,0,10,0,3,0,13
 shardingsphere-master\shardingsphere-master\shardingsphere-agent\shardingsphere-agent-core\src\main\java\org\apache\shardingsphere\agent\core\entity\TargetPoint.java,0,4,0,1,0,5
 shardingsphere-master\shardingsphere-master\shardingsphere-test\shardingsphere-pipeline-test\src\test\java\org\apache\shardingsphere\data\pipeline\core\record\RecordUtilTest.java,0,13,0,8,0,21
 shardingsphere-master\shardingsphere-master\shardingsphere-features\shardingsphere-sharding\shardingsphere-sharding-core\src\test\java\org\apache\shardingsphere\sharding\route\engine\validator\ddl\ShardingCreateProcedureStatementValidatorTest.java,0,34,0,38,0,72
 shardingsphere-master\shardingsphere-master\shardingsphere-sql-parser\shardingsphere-sql-parser-statement\src\test\java\org\apache\shardingsphere\sql\parser\sql\dialect\handler\dml\InsertStatementHandlerTest.java,0,47,0,35,0,82
 shardingsphere-master\shardingsphere-master\shardingsphere-infra\shardingsphere-infra-common\src\main\java\org\apache\shardingsphere\infra\distsql\exception\rule\AlgorithmInUsedException.java,0,8,0,4,0,12
 shardingsphere-master\shardingsphere-master\shardingsphere-sql-parser\shardingsphere-sql-parser-statement\src\main\java\org\apache\shardingsphere\sql\parser\sql\common\segment\SQLSegment.java,0,3,0,1,0,4
 shardingsphere-master\shardingsphere-master\shardingsphere-db-protocol\shardingsphere-db-protocol-postgresql\src\test\java\org\apache\shardingsphere\db\protocol\postgresql\packet\command\admin\PostgreSQLUnsupportedCommandPacketTest.java,0,11,0,7,0,18
 shardingsphere-master\shardingsphere-master\shardingsphere-features\shardingsphere-readwrite-splitting\shardingsphere-readwrite-splitting-distsql\shardingsphere-readwrite-splitting-distsql-statement\src\main\java\org\apache\shardingsphere\readwritesplitting\distsql\parser\statement\status\SetReadwriteSplittingStatusStatement.java,14,10,0,6,0,16
 shardingsphere-master\shardingsphere-master\shardingsphere-agent\shardingsphere-agent-api\src\main\java\org\apache\shardingsphere\agent\config\PluginConfiguration.java,0,8,0,1,0,9
 shardingsphere-master\shardingsphere-master\shardingsphere-infra\shardingsphere-infra-binder\src\main\java\org\apache\shardingsphere\infra\binder\statement\dal\ExplainStatementContext.java,0,12,0,11,0,23
 shardingsphere-master\shardingsphere-master\shardingsphere-test\shardingsphere-integration-test\shardingsphere-integration-test-suite\src\test\java\org\apache\shardingsphere\test\integration\framework\container\atomic\storage\StorageContainerFactory.java,0,5,0,7,0,12
 shardingsphere-master\shardingsphere-master\shardingsphere-proxy\shardingsphere-proxy-backend\src\main\java\org\apache\shardingsphere\proxy\backend\communication\BackendDataSource.java,0,0,0,1,0,1
 shardingsphere-master\shardingsphere-master\shardingsphere-proxy\shardingsphere-proxy-backend\src\test\java\org\apache\shardingsphere\proxy\backend\text\admin\mysql\executor\ShowProcessListExecutorTest.java,0,23,2,12,0,37
 shardingsphere-master\shardingsphere-master\shardingsphere-infra\shardingsphere-infra-common\src\main\java\org\apache\shardingsphere\infra\distsql\exception\rule\KeyGeneratorInUsedException.java,0,7,0,4,0,11
 shardingsphere-master\shardingsphere-master\shardingsphere-features\shardingsphere-encrypt\shardingsphere-encrypt-core\src\test\java\org\apache\shardingsphere\encrypt\merge\dal\MergedEncryptColumnsMergedResultTest.java,0,35,0,22,0,57
 shardingsphere-master\shardingsphere-master\shardingsphere-mode\shardingsphere-mode-type\shardingsphere-cluster-mode\shardingsphere-cluster-mode-core\src\main\java\org\apache\shardingsphere\mode\manager\cluster\coordinator\registry\config\event\datasource\DataSourceChangedEvent.java,0,7,0,3,0,10
 shardingsphere-master\shardingsphere-master\shardingsphere-db-protocol\shardingsphere-db-protocol-postgresql\src\main\java\org\apache\shardingsphere\db\protocol\postgresql\packet\command\query\extended\bind\protocol\PostgreSQLInt2ArrayBinaryProtocolValue.java,0,11,0,9,0,20
 shardingsphere-master\shardingsphere-master\shardingsphere-features\shardingsphere-sharding\shardingsphere-sharding-distsql\shardingsphere-sharding-distsql-handler\src\test\java\org\apache\shardingsphere\sharding\distsql\update\DropDefaultShardingStrategyStatementUpdaterTest.java,0,25,0,16,0,41
 shardingsphere-master\shardingsphere-master\examples\shardingsphere-proxy-example\shardingsphere-proxy-distsql-example\src\main\java\org\apache\shardingsphere\example\proxy\distsql\feature\encrypt\EncryptExecutor.java,0,34,2,7,0,43
 shardingsphere-master\shardingsphere-master\shardingsphere-sql-parser\shardingsphere-sql-parser-dialect\shardingsphere-sql-parser-sql92\src\test\java\org\apache\shardingsphere\sql\parser\sql92\UnsupportedSQL92ParserParameterizedTest.java,0,6,0,5,0,11
 shardingsphere-master\shardingsphere-master\shardingsphere-test\shardingsphere-parser-test\src\main\java\org\apache\shardingsphere\test\sql\parser\parameterized\jaxb\cases\domain\statement\distsql\ral\ShowSQLParserRuleStatementTestCase.java,0,1,0,4,0,5
 shardingsphere-master\shardingsphere-master\shardingsphere-features\shardingsphere-sharding\shardingsphere-sharding-core\src\main\java\org\apache\shardingsphere\sharding\rewrite\token\generator\impl\DistinctProjectionPrefixTokenGenerator.java,0,7,0,10,0,17
 shardingsphere-master\shardingsphere-master\shardingsphere-test\shardingsphere-integration-test\shardingsphere-integration-test-suite\src\test\java\org\apache\shardingsphere\test\integration\engine\dcl\GeneralDCLIT.java,0,11,0,8,0,19
 shardingsphere-master\shardingsphere-master\shardingsphere-infra\shardingsphere-infra-binder\src\test\java\org\apache\shardingsphere\infra\binder\statement\ddl\CreateDatabaseStatementContextTest.java,0,5,0,8,0,13
 shardingsphere-master\shardingsphere-master\shardingsphere-infra\shardingsphere-infra-executor\src\main\java\org\apache\shardingsphere\infra\executor\sql\prepare\raw\RawExecutionPrepareEngine.java,0,11,0,10,0,21
 shardingsphere-master\shardingsphere-master\shardingsphere-proxy\shardingsphere-proxy-backend\src\main\java\org\apache\shardingsphere\proxy\backend\text\TextProtocolBackendHandlerFactory.java,0,40,0,47,0,87
 shardingsphere-master\shardingsphere-master\shardingsphere-test\shardingsphere-parser-test\src\main\java\org\apache\shardingsphere\test\sql\parser\parameterized\jaxb\cases\domain\statement\ddl\AlterSchemaStatementTestCase.java,0,0,0,3,0,3
 shardingsphere-master\shardingsphere-master\shardingsphere-infra\shardingsphere-infra-common\src\main\java\org\apache\shardingsphere\infra\datasource\pool\destroyer\DataSourcePoolDestroyer.java,0,10,0,5,0,15
 shardingsphere-master\shardingsphere-master\shardingsphere-infra\shardingsphere-infra-executor\src\main\java\org\apache\shardingsphere\infra\executor\sql\process\model\yaml\YamlExecuteProcessContext.java,0,19,0,4,0,23
 shardingsphere-master\shardingsphere-master\shardingsphere-test\shardingsphere-pipeline-test\src\test\java\org\apache\shardingsphere\data\pipeline\api\impl\GovernanceRepositoryAPIImplTest.java,0,51,0,39,0,90
 shardingsphere-master\shardingsphere-master\shardingsphere-proxy\shardingsphere-proxy-frontend\shardingsphere-proxy-frontend-opengauss\src\test\java\org\apache\shardingsphere\proxy\frontend\opengauss\authentication\fixture\OpenGaussAuthenticationAlgorithm.java,0,28,7,17,0,52
 shardingsphere-master\shardingsphere-master\shardingsphere-kernel\shardingsphere-single-table\shardingsphere-single-table-core\src\main\java\org\apache\shardingsphere\singletable\rule\builder\SingleTableRuleBuilder.java,0,7,0,6,0,13
 shardingsphere-master\shardingsphere-master\shardingsphere-features\shardingsphere-sharding\shardingsphere-sharding-core\src\main\java\org\apache\shardingsphere\sharding\route\strategy\ShardingStrategy.java,0,6,0,3,0,9
 shardingsphere-master\shardingsphere-master\shardingsphere-proxy\shardingsphere-proxy-backend\src\main\java\org\apache\shardingsphere\proxy\backend\text\extra\ExtraTextProtocolBackendHandler.java,0,4,0,2,0,6
 shardingsphere-master\shardingsphere-master\shardingsphere-db-protocol\shardingsphere-db-protocol-mysql\src\main\java\org\apache\shardingsphere\db\protocol\mysql\packet\binlog\row\column\value\time\MySQLYearBinlogProtocolValue.java,0,6,0,8,0,14
 shardingsphere-master\shardingsphere-master\shardingsphere-kernel\shardingsphere-data-pipeline\shardingsphere-data-pipeline-dialect\shardingsphere-data-pipeline-opengauss\src\main\java\org\apache\shardingsphere\data\pipeline\opengauss\ingest\wal\OpenGaussLogicalReplication.java,0,28,0,18,0,46
 shardingsphere-master\shardingsphere-master\shardingsphere-features\shardingsphere-sharding\shardingsphere-sharding-distsql\shardingsphere-sharding-distsql-handler\src\main\java\org\apache\shardingsphere\sharding\distsql\handler\query\ShardingBindingTableRuleQueryResultSet.java,0,12,0,7,0,19
 shardingsphere-master\shardingsphere-master\shardingsphere-test\shardingsphere-parser-test\src\main\java\org\apache\shardingsphere\test\sql\parser\parameterized\asserts\segment\output\OutputClauseAssert.java,0,26,0,27,0,53
 shardingsphere-master\shardingsphere-master\shardingsphere-sql-parser\shardingsphere-sql-parser-statement\src\main\java\org\apache\shardingsphere\sql\parser\sql\dialect\statement\mysql\ddl\MySQLCreateTriggerStatement.java,0,1,0,5,0,6
 shardingsphere-master\shardingsphere-master\shardingsphere-proxy\shardingsphere-proxy-backend\src\test\java\org\apache\shardingsphere\proxy\backend\text\admin\mysql\executor\ShowCurrentUserExecutorTest.java,0,16,1,10,0,27
 shardingsphere-master\shardingsphere-master\shardingsphere-features\shardingsphere-sharding\shardingsphere-sharding-distsql\shardingsphere-sharding-distsql-handler\src\main\java\org\apache\shardingsphere\sharding\distsql\handler\query\ShardingTableRulesUsedAlgorithmQueryResultSet.java,0,13,2,14,0,29
 shardingsphere-master\shardingsphere-master\shardingsphere-infra\shardingsphere-infra-binder\src\main\java\org\apache\shardingsphere\infra\binder\segment\select\projection\impl\ParameterMarkerProjection.java,0,4,0,3,0,7
 shardingsphere-master\shardingsphere-master\shardingsphere-db-protocol\shardingsphere-db-protocol-core\src\main\java\org\apache\shardingsphere\db\protocol\binary\BinaryRow.java,0,2,0,1,0,3
 shardingsphere-master\shardingsphere-master\shardingsphere-infra\shardingsphere-infra-common\src\main\java\org\apache\shardingsphere\infra\rule\identifier\type\InstanceAwareRule.java,0,2,0,1,0,3
 shardingsphere-master\shardingsphere-master\shardingsphere-kernel\shardingsphere-parser\shardingsphere-parser-spring\shardingsphere-parser-spring-namespace\src\main\java\org\apache\shardingsphere\parser\spring\namespace\parser\CacheOptionBeanDefinitionParser.java,0,8,0,8,0,16
 shardingsphere-master\shardingsphere-master\shardingsphere-proxy\shardingsphere-proxy-frontend\shardingsphere-proxy-frontend-postgresql\src\main\java\org\apache\shardingsphere\proxy\frontend\postgresql\authentication\exception\InvalidAuthorizationSpecificationException.java,0,5,0,3,0,8
 shardingsphere-master\shardingsphere-master\shardingsphere-features\shardingsphere-sharding\shardingsphere-sharding-distsql\shardingsphere-sharding-distsql-statement\src\main\java\org\apache\shardingsphere\scaling\distsql\statement\DisableShardingScalingRuleStatement.java,0,3,0,3,0,6
 shardingsphere-master\shardingsphere-master\shardingsphere-kernel\shardingsphere-data-pipeline\shardingsphere-data-pipeline-spi\src\main\java\org\apache\shardingsphere\data\pipeline\api\job\JobSubType.java,0,8,0,2,0,10
 shardingsphere-master\shardingsphere-master\shardingsphere-test\shardingsphere-integration-test\shardingsphere-integration-test-suite\src\test\java\org\apache\shardingsphere\test\integration\framework\runner\parallel\impl\CaseParallelRunnerExecutor.java,0,10,0,9,0,19
 shardingsphere-master\shardingsphere-master\shardingsphere-features\shardingsphere-sharding\shardingsphere-sharding-distsql\shardingsphere-sharding-distsql-statement\src\main\java\org\apache\shardingsphere\sharding\distsql\parser\statement\ShowShardingTableRulesStatement.java,0,6,0,4,0,10
 shardingsphere-master\shardingsphere-master\shardingsphere-kernel\shardingsphere-transaction\shardingsphere-transaction-type\shardingsphere-transaction-xa\shardingsphere-transaction-xa-core\src\main\java\org\apache\shardingsphere\transaction\xa\jta\datasource\XATransactionDataSource.java,0,38,2,15,0,55
 shardingsphere-master\shardingsphere-master\shardingsphere-test\shardingsphere-parser-test\src\main\java\org\apache\shardingsphere\test\sql\parser\parameterized\asserts\statement\distsql\rql\impl\rule\ShowReadwriteSplittingRulesStatementAssert.java,0,8,0,12,0,20
 shardingsphere-master\shardingsphere-master\shardingsphere-sql-parser\shardingsphere-sql-parser-statement\src\main\java\org\apache\shardingsphere\sql\parser\sql\dialect\statement\mysql\ddl\MySQLCreateProcedureStatement.java,0,4,0,5,0,9
 shardingsphere-master\shardingsphere-master\shardingsphere-test\shardingsphere-integration-test\shardingsphere-integration-test-suite\src\test\java\org\apache\shardingsphere\test\integration\env\scenario\authority\AuthorityEnvironmentManager.java,0,20,0,6,0,26
 shardingsphere-master\shardingsphere-master\shardingsphere-kernel\shardingsphere-data-pipeline\shardingsphere-data-pipeline-dialect\shardingsphere-data-pipeline-mysql\src\main\java\org\apache\shardingsphere\data\pipeline\mysql\ingest\client\ConnectInfo.java,0,6,0,1,0,7
 shardingsphere-master\shardingsphere-master\examples\shardingsphere-jdbc-example\single-feature-example\readwrite-splitting-example\readwrite-splitting-raw-jdbc-example\src\main\java\org\apache\shardingsphere\example\readwrite\splitting\raw\jdbc\ReadwriteSplittingRawYamlConfigurationExample.java,0,7,1,4,0,12
 shardingsphere-master\shardingsphere-master\shardingsphere-features\shardingsphere-encrypt\shardingsphere-encrypt-spring\shardingsphere-encrypt-spring-boot-starter\src\main\java\org\apache\shardingsphere\encrypt\spring\boot\EncryptRuleSpringBootConfiguration.java,0,13,0,14,0,27
 shardingsphere-master\shardingsphere-master\shardingsphere-test\shardingsphere-integration-test\shardingsphere-integration-test-suite\src\test\java\org\apache\shardingsphere\test\integration\env\cluster\ClusterEnvironment.java,0,18,0,3,0,21
 shardingsphere-master\shardingsphere-master\shardingsphere-features\shardingsphere-db-discovery\shardingsphere-db-discovery-distsql\shardingsphere-db-discovery-distsql-statement\src\main\java\org\apache\shardingsphere\dbdiscovery\distsql\parser\statement\CreateDatabaseDiscoveryTypeStatement.java,0,3,0,4,0,7
 shardingsphere-master\shardingsphere-master\shardingsphere-proxy\shardingsphere-proxy-frontend\shardingsphere-proxy-frontend-mysql\src\main\java\org\apache\shardingsphere\proxy\frontend\mysql\command\query\text\query\MySQLMultiStatementsHandler.java,0,76,1,56,0,133
 shardingsphere-master\shardingsphere-master\shardingsphere-sql-parser\shardingsphere-sql-parser-statement\src\main\java\org\apache\shardingsphere\sql\parser\sql\dialect\statement\mysql\ddl\MySQLAlterEventStatement.java,0,1,0,5,0,6
 shardingsphere-master\shardingsphere-master\shardingsphere-db-protocol\shardingsphere-db-protocol-postgresql\src\main\java\org\apache\shardingsphere\db\protocol\postgresql\constant\PostgreSQLServerInfo.java,0,14,1,5,0,20
 shardingsphere-master\shardingsphere-master\shardingsphere-infra\shardingsphere-infra-common\src\test\java\org\apache\shardingsphere\infra\metadata\rule\ShardingSphereRuleFixture.java,7,2,0,1,0,3
 shardingsphere-master\shardingsphere-master\shardingsphere-features\shardingsphere-shadow\shardingsphere-shadow-distsql\shardingsphere-shadow-distsql-statement\src\main\java\org\apache\shardingsphere\shadow\distsql\parser\statement\CreateShadowRuleStatement.java,0,1,0,3,0,4
 shardingsphere-master\shardingsphere-master\shardingsphere-db-protocol\shardingsphere-db-protocol-postgresql\src\main\java\org\apache\shardingsphere\db\protocol\postgresql\packet\command\admin\PostgreSQLUnsupportedCommandPacket.java,0,5,1,5,0,11
 shardingsphere-master\shardingsphere-master\shardingsphere-features\shardingsphere-sharding\shardingsphere-sharding-distsql\shardingsphere-sharding-distsql-statement\src\main\java\org\apache\shardingsphere\sharding\distsql\parser\segment\AutoTableRuleSegment.java,0,13,0,4,0,17
 shardingsphere-master\shardingsphere-master\shardingsphere-infra\shardingsphere-infra-parser\src\main\java\org\apache\shardingsphere\infra\parser\cache\SQLStatementCacheLoader.java,0,8,0,4,0,12
 shardingsphere-master\shardingsphere-master\shardingsphere-mode\shardingsphere-mode-core\src\main\java\org\apache\shardingsphere\mode\metadata\persist\service\ComputeNodePersistService.java,0,51,0,30,0,81
 shardingsphere-master\shardingsphere-master\shardingsphere-infra\shardingsphere-infra-common\src\main\java\org\apache\shardingsphere\infra\state\StateContext.java,0,9,0,2,0,11
 shardingsphere-master\shardingsphere-master\shardingsphere-kernel\shardingsphere-authority\shardingsphere-authority-core\src\main\java\org\apache\shardingsphere\authority\provider\natived\builder\StoragePrivilegeMerger.java,0,33,0,29,0,62
 shardingsphere-master\shardingsphere-master\examples\shardingsphere-jdbc-example\single-feature-example\readwrite-splitting-example\readwrite-splitting-spring-namespace-jpa-example\src\main\java\org\apache\shardingsphere\example\readwrite\splitting\spring\namespace\jpa\ReadwriteSplittingSpringNamespaceJpaExample.java,0,9,1,5,0,15
 shardingsphere-master\shardingsphere-master\shardingsphere-test\shardingsphere-parser-test\src\main\java\org\apache\shardingsphere\test\sql\parser\parameterized\asserts\segment\distsql\rdl\ShardingKeyGeneratorAssert.java,0,6,0,10,0,16
 shardingsphere-master\shardingsphere-master\shardingsphere-sql-parser\shardingsphere-sql-parser-statement\src\main\java\org\apache\shardingsphere\sql\parser\sql\dialect\statement\mysql\dal\MySQLShowReplicaStatusStatement.java,0,3,0,5,0,8
 shardingsphere-master\shardingsphere-master\shardingsphere-features\shardingsphere-db-discovery\shardingsphere-db-discovery-distsql\shardingsphere-db-discovery-distsql-parser\src\main\java\org\apache\shardingsphere\dbdiscovery\distsql\parser\core\DatabaseDiscoveryDistSQLLexer.java,0,4,0,3,0,7
 shardingsphere-master\shardingsphere-master\shardingsphere-kernel\shardingsphere-parser\shardingsphere-parser-spring\shardingsphere-parser-spring-namespace\src\main\java\org\apache\shardingsphere\parser\spring\namespace\handler\SQLParserNamespaceHandler.java,0,4,0,6,0,10
 shardingsphere-master\shardingsphere-master\shardingsphere-distsql\shardingsphere-distsql-statement\src\main\java\org\apache\shardingsphere\distsql\parser\segment\CacheOptionSegment.java,0,6,0,1,0,7
 shardingsphere-master\shardingsphere-master\shardingsphere-test\shardingsphere-parser-test\src\main\java\org\apache\shardingsphere\test\sql\parser\parameterized\jaxb\cases\domain\statement\distsql\ral\ShowAuthorityRuleStatementTestCase.java,0,1,0,4,0,5
 shardingsphere-master\shardingsphere-master\shardingsphere-kernel\shardingsphere-transaction\shardingsphere-transaction-core\src\test\java\org\apache\shardingsphere\transaction\rule\TransactionRuleTest.java,0,5,0,4,0,9
 shardingsphere-master\shardingsphere-master\shardingsphere-features\shardingsphere-sharding\shardingsphere-sharding-core\src\main\java\org\apache\shardingsphere\sharding\route\engine\validator\dml\impl\ShardingSelectStatementValidator.java,0,9,2,8,0,19
 shardingsphere-master\shardingsphere-master\shardingsphere-sql-parser\shardingsphere-sql-parser-statement\src\main\java\org\apache\shardingsphere\sql\parser\sql\dialect\statement\opengauss\dcl\OpenGaussCreateRoleStatement.java,0,1,0,5,0,6
 shardingsphere-master\shardingsphere-master\shardingsphere-sql-parser\shardingsphere-sql-parser-statement\src\main\java\org\apache\shardingsphere\sql\parser\sql\dialect\statement\opengauss\ddl\OpenGaussAlterTableStatement.java,0,1,0,5,0,6
 shardingsphere-master\shardingsphere-master\shardingsphere-agent\shardingsphere-agent-core\src\main\java\org\apache\shardingsphere\agent\core\config\loader\AgentConfigurationLoader.java,0,10,0,6,0,16
 shardingsphere-master\shardingsphere-master\shardingsphere-proxy\shardingsphere-proxy-backend\src\test\java\org\apache\shardingsphere\proxy\backend\text\distsql\ral\common\queryable\ShowTransactionRuleHandlerTest.java,0,18,1,12,0,31
 shardingsphere-master\shardingsphere-master\shardingsphere-features\shardingsphere-sharding\shardingsphere-sharding-core\src\test\java\org\apache\shardingsphere\sharding\route\strategy\type\standard\StandardShardingStrategyTest.java,0,22,0,10,0,32
 shardingsphere-master\shardingsphere-master\shardingsphere-mode\shardingsphere-mode-core\src\main\java\org\apache\shardingsphere\mode\metadata\persist\service\GlobalPersistService.java,0,3,0,1,0,4
 shardingsphere-master\shardingsphere-master\shardingsphere-proxy\shardingsphere-proxy-backend\src\test\java\org\apache\shardingsphere\proxy\backend\text\distsql\ral\common\queryable\ShowVariableBackendHandlerTest.java,0,42,0,29,0,71
 shardingsphere-master\shardingsphere-master\shardingsphere-sql-parser\shardingsphere-sql-parser-statement\src\main\java\org\apache\shardingsphere\sql\parser\sql\dialect\statement\mysql\dal\MySQLShowOpenTablesStatement.java,0,7,0,7,1,15
 shardingsphere-master\shardingsphere-master\shardingsphere-test\shardingsphere-parser-test\src\main\java\org\apache\shardingsphere\test\sql\parser\parameterized\asserts\statement\distsql\rql\impl\rule\ShowShardingTableRulesUsedKeyGeneratorStatementAssert.java,0,13,0,17,0,30
 shardingsphere-master\shardingsphere-master\shardingsphere-kernel\shardingsphere-data-pipeline\shardingsphere-data-pipeline-spi\src\main\java\org\apache\shardingsphere\data\pipeline\spi\detect\JobCompletionDetectAlgorithm.java,0,3,0,3,0,6
 shardingsphere-master\shardingsphere-master\shardingsphere-mode\shardingsphere-mode-type\shardingsphere-cluster-mode\shardingsphere-cluster-mode-core\src\main\java\org\apache\shardingsphere\mode\manager\cluster\coordinator\registry\workerid\node\WorkerIdNode.java,0,6,1,2,0,9
 shardingsphere-master\shardingsphere-master\shardingsphere-agent\shardingsphere-agent-plugins\shardingsphere-agent-plugin-tracing\shardingsphere-agent-tracing-jaeger\src\test\java\org\apache\shardingsphere\agent\plugin\tracing\jaeger\collector\JaegerCollector.java,28,9,0,2,0,11
 shardingsphere-master\shardingsphere-master\shardingsphere-test\shardingsphere-parser-test\src\main\java\org\apache\shardingsphere\test\sql\parser\parameterized\jaxb\cases\domain\segment\impl\definition\ExpectedColumnDefinition.java,0,9,0,6,0,15
 shardingsphere-master\shardingsphere-master\shardingsphere-features\shardingsphere-encrypt\shardingsphere-encrypt-core\src\main\java\org\apache\shardingsphere\encrypt\rewrite\token\generator\EncryptInsertValuesTokenGenerator.java,0,67,0,63,0,130
 shardingsphere-master\shardingsphere-master\shardingsphere-infra\shardingsphere-infra-federation\shardingsphere-infra-federation-optimizer\src\main\java\org\apache\shardingsphere\infra\federation\optimizer\converter\segment\groupby\GroupByConverter.java,0,10,0,12,0,22
 shardingsphere-master\shardingsphere-master\shardingsphere-jdbc\shardingsphere-jdbc-core\src\test\java\org\apache\shardingsphere\driver\fixture\ResetIncrementKeyGenerateAlgorithm.java,0,6,1,2,0,9
 shardingsphere-master\shardingsphere-master\shardingsphere-proxy\shardingsphere-proxy-backend\src\main\java\org\apache\shardingsphere\proxy\backend\communication\jdbc\transaction\LocalTransactionManager.java,0,17,2,8,0,27
 shardingsphere-master\shardingsphere-master\shardingsphere-sql-parser\shardingsphere-sql-parser-statement\src\test\java\org\apache\shardingsphere\sql\parser\sql\dialect\handler\ddl\DropTableStatementHandlerTest.java,0,32,0,22,0,54
 shardingsphere-master\shardingsphere-master\shardingsphere-test\shardingsphere-parser-test\src\main\java\org\apache\shardingsphere\test\sql\parser\parameterized\jaxb\cases\domain\segment\impl\insert\ExpectedInsertMultiTableElement.java,0,3,0,5,0,8
 shardingsphere-master\shardingsphere-master\shardingsphere-proxy\shardingsphere-proxy-backend\src\test\java\org\apache\shardingsphere\proxy\backend\communication\jdbc\recognizer\impl\P6SpyDriverRecognizerTest.java,0,10,0,5,0,15
 shardingsphere-master\shardingsphere-master\shardingsphere-features\shardingsphere-sharding\shardingsphere-sharding-distsql\shardingsphere-sharding-distsql-handler\src\main\java\org\apache\shardingsphere\scaling\distsql\handler\RestoreScalingSourceWritingUpdater.java,0,7,0,5,0,12
 shardingsphere-master\shardingsphere-master\shardingsphere-kernel\shardingsphere-data-pipeline\shardingsphere-data-pipeline-dialect\shardingsphere-data-pipeline-mysql\src\test\java\org\apache\shardingsphere\data\pipeline\mysql\ingest\client\MySQLClientTest.java,0,44,0,22,0,66
 shardingsphere-master\shardingsphere-master\shardingsphere-proxy\shardingsphere-proxy-backend\src\main\java\org\apache\shardingsphere\proxy\backend\communication\BackendConnection.java,0,6,0,2,0,8
 shardingsphere-master\shardingsphere-master\shardingsphere-sql-parser\shardingsphere-sql-parser-dialect\shardingsphere-sql-parser-sql92\src\main\java\org\apache\shardingsphere\sql\parser\sql92\parser\SQL92ParserFacade.java,0,3,0,1,0,4
 shardingsphere-master\shardingsphere-master\shardingsphere-kernel\shardingsphere-transaction\shardingsphere-transaction-type\shardingsphere-transaction-xa\shardingsphere-transaction-xa-core\src\main\java\org\apache\shardingsphere\transaction\xa\jta\datasource\properties\dialect\SQLServerXADataSourceDefinition.java,0,4,0,5,0,9
 shardingsphere-master\shardingsphere-master\shardingsphere-test\shardingsphere-integration-test\shardingsphere-integration-test-suite\src\test\java\org\apache\shardingsphere\test\integration\framework\container\atomic\governance\GovernanceContainer.java,14,5,0,4,0,9
 shardingsphere-master\shardingsphere-master\shardingsphere-jdbc\shardingsphere-jdbc-core\src\test\java\org\apache\shardingsphere\driver\jdbc\core\resultset\ResultSetUtilTest.java,0,90,8,44,0,142
 shardingsphere-master\shardingsphere-master\shardingsphere-infra\shardingsphere-infra-federation\shardingsphere-infra-federation-executor\src\main\java\org\apache\shardingsphere\infra\federation\executor\original\FilterableDatabase.java,0,11,0,8,0,19
 shardingsphere-master\shardingsphere-master\shardingsphere-jdbc\shardingsphere-jdbc-spring\shardingsphere-jdbc-core-spring\shardingsphere-jdbc-core-spring-namespace\src\test\java\org\apache\shardingsphere\spring\namespace\fixture\FixtureClusterPersistRepository.java,0,21,4,9,0,34
 shardingsphere-master\shardingsphere-master\shardingsphere-kernel\shardingsphere-authority\shardingsphere-authority-core\src\main\java\org\apache\shardingsphere\authority\provider\natived\NativeAuthorityProviderAlgorithm.java,0,16,0,10,0,26
 shardingsphere-master\shardingsphere-master\shardingsphere-distsql\shardingsphere-distsql-statement\src\main\java\org\apache\shardingsphere\distsql\parser\statement\ral\common\updatable\DropTrafficRuleStatement.java,0,4,0,2,0,6
 shardingsphere-master\shardingsphere-master\shardingsphere-features\shardingsphere-sharding\shardingsphere-sharding-core\src\main\java\org\apache\shardingsphere\sharding\algorithm\sharding\mod\ModShardingAlgorithm.java,0,31,0,20,0,51
 shardingsphere-master\shardingsphere-master\shardingsphere-test\shardingsphere-integration-test\shardingsphere-integration-test-suite\src\test\java\org\apache\shardingsphere\test\integration\framework\container\atomic\EmbeddedITContainer.java,0,0,0,1,0,1
 shardingsphere-master\shardingsphere-master\shardingsphere-proxy\shardingsphere-proxy-frontend\shardingsphere-proxy-frontend-opengauss\src\test\java\org\apache\shardingsphere\proxy\frontend\opengauss\command\query\simple\OpenGaussComQueryExecutorTest.java,0,35,1,23,0,59
 shardingsphere-master\shardingsphere-master\shardingsphere-sql-parser\shardingsphere-sql-parser-statement\src\main\java\org\apache\shardingsphere\sql\parser\sql\common\util\SafeNumberOperationUtil.java,0,45,0,36,0,81
 shardingsphere-master\shardingsphere-master\shardingsphere-test\shardingsphere-parser-test\src\main\java\org\apache\shardingsphere\test\sql\parser\parameterized\jaxb\cases\domain\statement\distsql\rdl\create\CreateShardingBroadcastTableRulesStatementTestCase.java,0,3,0,4,0,7
 shardingsphere-master\shardingsphere-master\shardingsphere-sql-parser\shardingsphere-sql-parser-statement\src\main\java\org\apache\shardingsphere\sql\parser\sql\dialect\statement\sql92\ddl\SQL92DropTableStatement.java,0,1,0,4,0,5
 shardingsphere-master\shardingsphere-master\shardingsphere-test\shardingsphere-parser-test\src\main\java\org\apache\shardingsphere\test\sql\parser\parameterized\asserts\statement\ddl\impl\AlterTableStatementAssert.java,0,63,0,76,0,139
 shardingsphere-master\shardingsphere-master\shardingsphere-infra\shardingsphere-infra-federation\shardingsphere-infra-federation-optimizer\src\main\java\org\apache\shardingsphere\infra\federation\optimizer\context\parser\dialect\OptimizerSQLDialectBuilderFactory.java,0,7,1,5,0,13
 shardingsphere-master\shardingsphere-master\shardingsphere-features\shardingsphere-sharding\shardingsphere-sharding-distsql\shardingsphere-sharding-distsql-parser\src\main\java\org\apache\shardingsphere\scaling\distsql\parser\core\ScalingLexer.java,0,4,0,2,0,6
 shardingsphere-master\shardingsphere-master\shardingsphere-infra\shardingsphere-infra-common\src\test\java\org\apache\shardingsphere\infra\metadata\schema\model\TableMetaDataTest.java,0,11,0,3,0,14
 shardingsphere-master\shardingsphere-master\shardingsphere-sql-parser\shardingsphere-sql-parser-statement\src\main\java\org\apache\shardingsphere\sql\parser\sql\dialect\statement\oracle\dml\OracleDeleteStatement.java,0,2,0,4,0,6
 shardingsphere-master\shardingsphere-master\shardingsphere-db-protocol\shardingsphere-db-protocol-mysql\src\test\java\org\apache\shardingsphere\db\protocol\mysql\codec\MySQLPacketCodecEngineTest.java,0,35,0,3,0,38
 shardingsphere-master\shardingsphere-master\shardingsphere-test\shardingsphere-parser-test\src\main\java\org\apache\shardingsphere\test\sql\parser\parameterized\asserts\statement\ddl\impl\CommentStatementAssert.java,0,13,0,15,0,28
 shardingsphere-master\shardingsphere-master\shardingsphere-agent\shardingsphere-agent-plugins\shardingsphere-agent-plugin-tracing\shardingsphere-agent-tracing-opentelemetry\src\main\java\org\apache\shardingsphere\agent\plugin\tracing\opentelemetry\advice\JDBCExecutorCallbackAdvice.java,39,18,1,18,0,37
 shardingsphere-master\shardingsphere-master\shardingsphere-sql-parser\shardingsphere-sql-parser-statement\src\main\java\org\apache\shardingsphere\sql\parser\sql\dialect\statement\mysql\tcl\MySQLUnlockStatement.java,0,1,0,4,0,5
 shardingsphere-master\shardingsphere-master\shardingsphere-test\shardingsphere-parser-test\src\main\java\org\apache\shardingsphere\test\sql\parser\parameterized\asserts\statement\dal\impl\MySQLCreateResourceGroupStatementAssert.java,0,5,0,8,0,13
 shardingsphere-master\shardingsphere-master\shardingsphere-test\shardingsphere-parser-test\src\main\java\org\apache\shardingsphere\test\sql\parser\parameterized\jaxb\cases\domain\statement\distsql\ral\CreateTrafficRuleStatementTestCase.java,0,3,0,5,0,8
 shardingsphere-master\shardingsphere-master\shardingsphere-sql-parser\shardingsphere-sql-parser-engine\src\test\java\org\apache\shardingsphere\sql\parser\core\database\visitor\SelectContext.java,0,1,0,1,0,2
 shardingsphere-master\shardingsphere-master\shardingsphere-infra\shardingsphere-infra-rewrite\src\main\java\org\apache\shardingsphere\infra\rewrite\engine\RouteSQLRewriteEngine.java,0,40,0,37,0,77
 shardingsphere-master\shardingsphere-master\shardingsphere-proxy\shardingsphere-proxy-frontend\shardingsphere-proxy-frontend-core\src\test\java\org\apache\shardingsphere\proxy\frontend\protocol\FrontDatabaseProtocolTypeFactoryTest.java,0,32,1,24,0,57
 shardingsphere-master\shardingsphere-master\shardingsphere-test\shardingsphere-pipeline-test\src\test\java\org\apache\shardingsphere\data\pipeline\core\job\FinishedCheckJobTest.java,0,18,0,7,0,25
 shardingsphere-master\shardingsphere-master\shardingsphere-db-protocol\shardingsphere-db-protocol-postgresql\src\main\java\org\apache\shardingsphere\db\protocol\postgresql\packet\identifier\PostgreSQLMessagePacketType.java,0,67,0,3,0,70
 shardingsphere-master\shardingsphere-master\shardingsphere-infra\shardingsphere-infra-common\src\main\java\org\apache\shardingsphere\infra\metadata\schema\QualifiedSchema.java,0,12,0,1,0,13
 shardingsphere-master\shardingsphere-master\shardingsphere-kernel\shardingsphere-data-pipeline\shardingsphere-data-pipeline-dialect\shardingsphere-data-pipeline-mysql\src\main\java\org\apache\shardingsphere\data\pipeline\mysql\ingest\client\netty\MySQLNegotiateHandler.java,0,47,1,30,0,78
 shardingsphere-master\shardingsphere-master\shardingsphere-proxy\shardingsphere-proxy-backend\src\main\java\org\apache\shardingsphere\proxy\backend\text\distsql\ral\common\enums\VariableEnum.java,0,10,2,2,0,14
 shardingsphere-master\shardingsphere-master\shardingsphere-features\shardingsphere-sharding\shardingsphere-sharding-spring\shardingsphere-sharding-spring-boot-starter\src\test\java\org\apache\shardingsphere\sharding\spring\boot\ShardingSpringBootStarterTest.java,93,59,0,46,0,105
 shardingsphere-master\shardingsphere-master\shardingsphere-sql-parser\shardingsphere-sql-parser-statement\src\main\java\org\apache\shardingsphere\sql\parser\sql\common\value\collection\CollectionValue.java,0,6,0,1,1,8
 shardingsphere-master\shardingsphere-master\shardingsphere-jdbc\shardingsphere-jdbc-core\src\main\java\org\apache\shardingsphere\driver\state\circuit\resultset\CircuitBreakerResultSet.java,0,73,4,4,0,81
 shardingsphere-master\shardingsphere-master\shardingsphere-agent\shardingsphere-agent-plugins\shardingsphere-agent-plugin-metrics\shardingsphere-agent-metrics-api\src\test\java\org\apache\shardingsphere\agent\metrics\api\advice\MockAdviceTargetObject.java,0,4,0,1,0,5
 shardingsphere-master\shardingsphere-master\shardingsphere-test\shardingsphere-parser-test\src\main\java\org\apache\shardingsphere\test\sql\parser\parameterized\jaxb\cases\domain\statement\distsql\rql\ShowShadowAlgorithmsStatementTestCase.java,0,3,0,5,0,8
 shardingsphere-master\shardingsphere-master\shardingsphere-mode\shardingsphere-mode-type\shardingsphere-cluster-mode\shardingsphere-cluster-mode-core\src\test\java\org\apache\shardingsphere\mode\manager\cluster\coordinator\lock\watcher\LockChangedWatcherTest.java,0,4,0,5,0,9
 shardingsphere-master\shardingsphere-master\shardingsphere-distsql\shardingsphere-distsql-parser\src\main\java\org\apache\shardingsphere\distsql\parser\core\featured\FeaturedDistSQLParseASTNode.java,0,5,0,1,0,6
 shardingsphere-master\shardingsphere-master\shardingsphere-test\shardingsphere-parser-test\src\main\java\org\apache\shardingsphere\test\sql\parser\parameterized\asserts\segment\distsql\rdl\ReadwriteSplittingRuleAssert.java,0,16,0,20,0,36
 shardingsphere-master\shardingsphere-master\shardingsphere-kernel\shardingsphere-data-pipeline\shardingsphere-data-pipeline-dialect\shardingsphere-data-pipeline-mysql\src\test\java\org\apache\shardingsphere\data\pipeline\mysql\ingest\binlog\BinlogPositionTest.java,0,18,0,9,0,27
 shardingsphere-master\shardingsphere-master\shardingsphere-proxy\shardingsphere-proxy-frontend\shardingsphere-proxy-frontend-spi\src\main\java\org\apache\shardingsphere\proxy\frontend\command\executor\ResponseType.java,0,3,0,1,0,4
 shardingsphere-master\shardingsphere-master\shardingsphere-kernel\shardingsphere-data-pipeline\shardingsphere-data-pipeline-spi\src\main\java\org\apache\shardingsphere\data\pipeline\api\datasource\config\impl\StandardPipelineDataSourceConfiguration.java,0,39,0,17,0,56
 shardingsphere-master\shardingsphere-master\shardingsphere-proxy\shardingsphere-proxy-frontend\shardingsphere-proxy-frontend-postgresql\src\test\java\org\apache\shardingsphere\proxy\frontend\postgresql\command\generic\PostgreSQLComTerminationExecutorTest.java,0,4,0,2,0,6
 shardingsphere-master\shardingsphere-master\shardingsphere-db-protocol\shardingsphere-db-protocol-mysql\src\test\java\org\apache\shardingsphere\db\protocol\mysql\packet\command\query\binary\prepare\MySQLComStmtPreparePacketTest.java,0,10,0,6,0,16
 shardingsphere-master\shardingsphere-master\shardingsphere-sql-parser\shardingsphere-sql-parser-dialect\shardingsphere-sql-parser-oracle\src\main\java\org\apache\shardingsphere\sql\parser\oracle\parser\OracleParserFacade.java,0,3,0,1,0,4
 shardingsphere-master\shardingsphere-master\shardingsphere-features\shardingsphere-sharding\shardingsphere-sharding-distsql\shardingsphere-sharding-distsql-statement\src\main\java\org\apache\shardingsphere\sharding\distsql\parser\statement\DropDefaultShardingStrategyStatement.java,0,7,0,4,0,11
 shardingsphere-master\shardingsphere-master\shardingsphere-test\shardingsphere-parser-test\src\main\java\org\apache\shardingsphere\test\sql\parser\parameterized\jaxb\cases\domain\segment\AbstractExpectedDelimiterSQLSegment.java,9,5,1,3,0,9
 shardingsphere-master\shardingsphere-master\shardingsphere-test\shardingsphere-parser-test\src\main\java\org\apache\shardingsphere\test\sql\parser\parameterized\jaxb\cases\domain\statement\distsql\ral\ShowAllVariablesStatementTestCase.java,0,0,0,3,0,3
 shardingsphere-master\shardingsphere-master\examples\shardingsphere-proxy-example\shardingsphere-proxy-distsql-example\src\main\java\org\apache\shardingsphere\example\proxy\distsql\feature\sharding\ShardingExecutor.java,0,37,4,7,0,48
 shardingsphere-master\shardingsphere-master\shardingsphere-features\shardingsphere-sharding\shardingsphere-sharding-core\src\test\java\org\apache\shardingsphere\sharding\route\engine\validator\ddl\ShardingCreateViewStatementValidatorTest.java,0,12,0,15,0,27
 shardingsphere-master\shardingsphere-master\shardingsphere-sql-parser\shardingsphere-sql-parser-statement\src\main\java\org\apache\shardingsphere\sql\parser\sql\common\statement\dal\ResetParameterStatement.java,3,1,1,3,0,5
 shardingsphere-master\shardingsphere-master\shardingsphere-infra\shardingsphere-infra-common\src\main\java\org\apache\shardingsphere\infra\database\type\DatabaseType.java,0,15,1,2,0,18
 shardingsphere-master\shardingsphere-master\shardingsphere-mode\shardingsphere-mode-type\shardingsphere-cluster-mode\shardingsphere-cluster-mode-core\src\test\java\org\apache\shardingsphere\mode\manager\cluster\coordinator\registry\config\watcher\GlobalRuleChangedWatcherTest.java,0,7,1,8,0,16
 shardingsphere-master\shardingsphere-master\shardingsphere-sql-parser\shardingsphere-sql-parser-statement\src\main\java\org\apache\shardingsphere\sql\parser\sql\dialect\statement\postgresql\ddl\PostgreSQLDropFunctionStatement.java,0,1,0,5,0,6
 shardingsphere-master\shardingsphere-master\shardingsphere-sql-parser\shardingsphere-sql-parser-statement\src\main\java\org\apache\shardingsphere\sql\parser\sql\dialect\statement\postgresql\ddl\PostgreSQLDropCollationStatement.java,0,1,0,5,0,6
 shardingsphere-master\shardingsphere-master\shardingsphere-sql-parser\shardingsphere-sql-parser-statement\src\main\java\org\apache\shardingsphere\sql\parser\sql\dialect\statement\oracle\ddl\OraclePurgeStatement.java,0,4,0,7,4,15
 shardingsphere-master\shardingsphere-master\shardingsphere-test\shardingsphere-integration-test\shardingsphere-integration-test-suite\src\test\java\org\apache\shardingsphere\test\integration\engine\dml\GeneralDMLIT.java,0,21,0,14,0,35
 shardingsphere-master\shardingsphere-master\shardingsphere-features\shardingsphere-shadow\shardingsphere-shadow-distsql\shardingsphere-shadow-distsql-statement\src\main\java\org\apache\shardingsphere\shadow\distsql\parser\statement\ShowShadowTableRulesStatement.java,0,2,0,3,0,5
 shardingsphere-master\shardingsphere-master\shardingsphere-agent\shardingsphere-agent-api\src\main\java\org\apache\shardingsphere\agent\spi\definition\PluginDefinitionService.java,0,0,0,1,0,1
 shardingsphere-master\shardingsphere-master\shardingsphere-proxy\shardingsphere-proxy-backend\src\main\java\org\apache\shardingsphere\proxy\backend\communication\jdbc\statement\impl\PostgreSQLStatementMemoryStrictlyFetchSizeSetter.java,0,5,0,6,0,11
 shardingsphere-master\shardingsphere-master\shardingsphere-infra\shardingsphere-infra-common\src\main\java\org\apache\shardingsphere\infra\metadata\user\ShardingSphereUsers.java,0,4,0,2,0,6
 shardingsphere-master\shardingsphere-master\shardingsphere-mode\shardingsphere-mode-type\shardingsphere-cluster-mode\shardingsphere-cluster-mode-core\src\main\java\org\apache\shardingsphere\mode\manager\cluster\coordinator\lock\event\LockReleasedEvent.java,0,2,0,2,0,4
 shardingsphere-master\shardingsphere-master\shardingsphere-features\shardingsphere-sharding\shardingsphere-sharding-core\src\test\java\org\apache\shardingsphere\sharding\merge\dql\groupby\GroupByStreamMergedResultTest.java,0,148,3,42,0,193
 shardingsphere-master\shardingsphere-master\examples\example-core\example-api\src\main\java\org\apache\shardingsphere\example\core\api\repository\UserRepository.java,0,0,0,1,0,1
 shardingsphere-master\shardingsphere-master\shardingsphere-test\shardingsphere-parser-test\src\main\java\org\apache\shardingsphere\test\sql\parser\parameterized\asserts\statement\distsql\ral\impl\UpdatableRALStatementAssert.java,0,13,0,46,0,59
 shardingsphere-master\shardingsphere-master\shardingsphere-db-protocol\shardingsphere-db-protocol-postgresql\src\test\java\org\apache\shardingsphere\db\protocol\postgresql\packet\command\query\extended\bind\protocol\PostgreSQLInt4BinaryProtocolValueTest.java,0,7,0,4,0,11
 shardingsphere-master\shardingsphere-master\shardingsphere-agent\shardingsphere-agent-plugins\shardingsphere-agent-plugin-tracing\shardingsphere-agent-tracing-opentracing\src\test\java\org\apache\shardingsphere\agent\plugin\tracing\opentracing\advice\SQLParserEngineAdviceTest.java,0,25,0,13,0,38
 shardingsphere-master\shardingsphere-master\shardingsphere-proxy\shardingsphere-proxy-backend\src\main\java\org\apache\shardingsphere\proxy\backend\text\admin\executor\DatabaseSetCharsetExecutor.java,0,1,0,1,0,2
 shardingsphere-master\shardingsphere-master\shardingsphere-infra\shardingsphere-infra-common\src\test\java\org\apache\shardingsphere\infra\yaml\config\swapper\mode\ModeConfigurationYamlSwapperTest.java,0,16,0,5,0,21
 shardingsphere-master\shardingsphere-master\shardingsphere-db-protocol\shardingsphere-db-protocol-mysql\src\main\java\org\apache\shardingsphere\db\protocol\mysql\packet\command\query\binary\execute\protocol\MySQLInt1BinaryProtocolValue.java,0,3,0,3,0,6
 shardingsphere-master\shardingsphere-master\examples\shardingsphere-jdbc-example\single-feature-example\transaction-example\transaction-2pc-xa-atomikos-raw-jdbc-example\src\main\java\org\apache\shardingsphere\example\transaction\xa\atomikos\raw\jdbc\TransactionXaAtomikosRawExample.java,0,6,1,3,0,10
 shardingsphere-master\shardingsphere-master\shardingsphere-sql-parser\shardingsphere-sql-parser-statement\src\main\java\org\apache\shardingsphere\sql\parser\sql\dialect\statement\mysql\dal\MySQLShowProfileStatement.java,0,3,0,6,0,9
 shardingsphere-master\shardingsphere-master\shardingsphere-db-protocol\shardingsphere-db-protocol-mysql\src\test\java\org\apache\shardingsphere\db\protocol\mysql\packet\generic\MySQLOKPacketTest.java,0,27,0,6,0,33
 shardingsphere-master\shardingsphere-master\shardingsphere-sql-parser\shardingsphere-sql-parser-statement\src\main\java\org\apache\shardingsphere\sql\parser\sql\dialect\statement\oracle\dml\OracleSelectStatement.java,0,6,0,6,0,12
 shardingsphere-master\shardingsphere-master\shardingsphere-features\shardingsphere-sharding\shardingsphere-sharding-api\src\main\java\org\apache\shardingsphere\sharding\support\InlineExpressionParser.java,0,29,0,8,0,37
 shardingsphere-master\shardingsphere-master\shardingsphere-test\shardingsphere-parser-test\src\main\java\org\apache\shardingsphere\test\sql\parser\parameterized\asserts\statement\distsql\rdl\drop\DropResourceStatementAssert.java,0,8,0,10,0,18
 shardingsphere-master\shardingsphere-master\shardingsphere-infra\shardingsphere-infra-common\src\main\java\org\apache\shardingsphere\infra\config\TypedSPIConfiguration.java,13,8,0,2,0,10
 shardingsphere-master\shardingsphere-master\shardingsphere-infra\shardingsphere-infra-binder\src\main\java\org\apache\shardingsphere\infra\binder\segment\select\groupby\engine\GroupByContextEngine.java,0,5,0,9,0,14
 shardingsphere-master\shardingsphere-master\shardingsphere-proxy\shardingsphere-proxy-backend\src\test\java\org\apache\shardingsphere\proxy\backend\response\header\update\UpdateResponseHeaderTest.java,0,9,0,4,0,13
 shardingsphere-master\shardingsphere-master\shardingsphere-features\shardingsphere-sharding\shardingsphere-sharding-distsql\shardingsphere-sharding-distsql-parser\src\main\java\org\apache\shardingsphere\scaling\distsql\parser\facade\ScalingDistSQLStatementParserFacade.java,0,6,0,4,0,10
 shardingsphere-master\shardingsphere-master\shardingsphere-proxy\shardingsphere-proxy-backend\src\main\java\org\apache\shardingsphere\proxy\backend\communication\vertx\VertxBackendConnection.java,0,45,0,31,0,76
 shardingsphere-master\shardingsphere-master\shardingsphere-kernel\shardingsphere-data-pipeline\shardingsphere-data-pipeline-dialect\shardingsphere-data-pipeline-mysql\src\main\java\org\apache\shardingsphere\data\pipeline\mysql\ingest\binlog\event\WriteRowsEvent.java,0,2,0,1,0,3
 shardingsphere-master\shardingsphere-master\shardingsphere-kernel\shardingsphere-data-pipeline\shardingsphere-data-pipeline-core\src\main\java\org\apache\shardingsphere\data\pipeline\scenario\rulealtered\RuleAlteredJobPreparer.java,0,53,2,56,0,111
 shardingsphere-master\shardingsphere-master\shardingsphere-proxy\shardingsphere-proxy-backend\src\main\java\org\apache\shardingsphere\proxy\backend\text\distsql\rdl\RDLBackendHandlerFactory.java,0,12,0,16,0,28
 shardingsphere-master\shardingsphere-master\shardingsphere-infra\shardingsphere-infra-executor\src\main\java\org\apache\shardingsphere\infra\executor\sql\execute\engine\driver\jdbc\JDBCExecutor.java,0,10,0,7,0,17
 shardingsphere-master\shardingsphere-master\shardingsphere-kernel\shardingsphere-parser\shardingsphere-parser-spring\shardingsphere-parser-spring-namespace\src\test\java\org\apache\shardingsphere\parser\spring\namespace\SQLParserSpringNamespaceTest.java,0,11,0,4,0,15
 shardingsphere-master\shardingsphere-master\shardingsphere-test\shardingsphere-parser-test\src\main\java\org\apache\shardingsphere\test\sql\parser\parameterized\asserts\segment\index\IndextypeAssert.java,0,8,0,14,0,22
 shardingsphere-master\shardingsphere-master\shardingsphere-features\shardingsphere-sharding\shardingsphere-sharding-core\src\main\java\org\apache\shardingsphere\sharding\rewrite\token\generator\impl\OrderByTokenGenerator.java,0,16,0,23,0,39
 shardingsphere-master\shardingsphere-master\shardingsphere-proxy\shardingsphere-proxy-frontend\shardingsphere-proxy-frontend-opengauss\src\test\java\org\apache\shardingsphere\proxy\frontend\opengauss\OpenGaussFrontendEngineTest.java,0,24,1,9,0,34
 shardingsphere-master\shardingsphere-master\shardingsphere-infra\shardingsphere-infra-binder\src\test\java\org\apache\shardingsphere\infra\binder\statement\ddl\CreateProcedureStatementContextTest.java,0,4,0,7,0,11
 shardingsphere-master\shardingsphere-master\shardingsphere-infra\shardingsphere-infra-common\src\main\java\org\apache\shardingsphere\infra\metadata\schema\util\SystemSchemaUtil.java,21,4,1,2,0,7
 shardingsphere-master\shardingsphere-master\shardingsphere-kernel\shardingsphere-parser\shardingsphere-parser-core\src\main\java\org\apache\shardingsphere\parser\yaml\config\YamlSQLParserCacheOptionRuleConfiguration.java,0,8,0,2,0,10
 shardingsphere-master\shardingsphere-master\shardingsphere-kernel\shardingsphere-data-pipeline\shardingsphere-data-pipeline-dialect\shardingsphere-data-pipeline-postgresql\src\main\java\org\apache\shardingsphere\data\pipeline\postgresql\ingest\PostgreSQLWalDumper.java,0,30,1,28,0,59
 shardingsphere-master\shardingsphere-master\shardingsphere-kernel\shardingsphere-data-pipeline\shardingsphere-data-pipeline-core\src\main\java\org\apache\shardingsphere\data\pipeline\core\prepare\datasource\DataSourcePreparer.java,0,1,0,1,0,2
 shardingsphere-master\shardingsphere-master\shardingsphere-features\shardingsphere-shadow\shardingsphere-shadow-spring\shardingsphere-shadow-spring-namespace\src\main\java\org\apache\shardingsphere\shadow\spring\namespace\parser\ShadowRuleBeanDefinitionParser.java,0,38,0,36,0,74
 shardingsphere-master\shardingsphere-master\shardingsphere-infra\shardingsphere-infra-common\src\test\java\org\apache\shardingsphere\infra\metadata\schema\builder\SchemaBuilderTest.java,0,19,0,12,0,31
 shardingsphere-master\shardingsphere-master\shardingsphere-sql-parser\shardingsphere-sql-parser-spi\src\main\java\org\apache\shardingsphere\sql\parser\api\parser\SQLLexer.java,0,1,0,1,0,2
 shardingsphere-master\shardingsphere-master\shardingsphere-features\shardingsphere-sharding\shardingsphere-sharding-core\src\main\java\org\apache\shardingsphere\sharding\route\engine\condition\AlwaysFalseShardingCondition.java,0,1,0,1,0,2
 shardingsphere-master\shardingsphere-master\shardingsphere-kernel\shardingsphere-data-pipeline\shardingsphere-data-pipeline-spi\src\main\java\org\apache\shardingsphere\data\pipeline\spi\sqlbuilder\PipelineSQLBuilder.java,0,16,0,7,0,23
 shardingsphere-master\shardingsphere-master\shardingsphere-proxy\shardingsphere-proxy-frontend\shardingsphere-proxy-frontend-opengauss\src\main\java\org\apache\shardingsphere\proxy\frontend\opengauss\command\query\simple\OpenGaussComQueryExecutor.java,0,38,1,40,0,79
 shardingsphere-master\shardingsphere-master\shardingsphere-proxy\shardingsphere-proxy-frontend\shardingsphere-proxy-frontend-mysql\src\main\java\org\apache\shardingsphere\proxy\frontend\mysql\command\admin\initdb\MySQLComInitDbExecutor.java,0,10,0,7,0,17
 shardingsphere-master\shardingsphere-master\shardingsphere-test\shardingsphere-integration-test\shardingsphere-integration-test-suite\src\test\java\org\apache\shardingsphere\test\integration\framework\container\atomic\storage\impl\H2Container.java,0,15,0,11,0,26
 shardingsphere-master\shardingsphere-master\shardingsphere-infra\shardingsphere-infra-common\src\test\java\org\apache\shardingsphere\infra\yaml\config\swapper\YamlRuleConfigurationSwapperEngineTest.java,0,12,0,9,0,21
 shardingsphere-master\shardingsphere-master\shardingsphere-test\shardingsphere-parser-test\src\main\java\org\apache\shardingsphere\test\sql\parser\parameterized\asserts\segment\lock\LockClauseAssert.java,0,6,0,16,0,22
 shardingsphere-master\shardingsphere-master\shardingsphere-features\shardingsphere-readwrite-splitting\shardingsphere-readwrite-splitting-core\src\main\java\org\apache\shardingsphere\readwritesplitting\rule\ReadwriteSplittingRule.java,0,51,0,38,0,89
 shardingsphere-master\shardingsphere-master\shardingsphere-kernel\shardingsphere-data-pipeline\shardingsphere-data-pipeline-dialect\shardingsphere-data-pipeline-postgresql\src\main\java\org\apache\shardingsphere\data\pipeline\postgresql\ingest\wal\decode\DecodingException.java,0,3,0,1,0,4
 shardingsphere-master\shardingsphere-master\shardingsphere-sql-parser\shardingsphere-sql-parser-statement\src\main\java\org\apache\shardingsphere\sql\parser\sql\dialect\statement\opengauss\ddl\OpenGaussAlterIndexStatement.java,0,4,0,6,1,11
 shardingsphere-master\shardingsphere-master\shardingsphere-kernel\shardingsphere-data-pipeline\shardingsphere-data-pipeline-dialect\shardingsphere-data-pipeline-mysql\src\main\java\org\apache\shardingsphere\data\pipeline\mysql\MySQLEnvironmentChecker.java,0,2,0,3,0,5
 shardingsphere-master\shardingsphere-master\shardingsphere-proxy\shardingsphere-proxy-frontend\shardingsphere-proxy-frontend-postgresql\src\test\java\org\apache\shardingsphere\proxy\frontend\postgresql\command\query\extended\bind\PostgreSQLComBindExecutorTest.java,0,29,0,19,0,48
 shardingsphere-master\shardingsphere-master\shardingsphere-infra\shardingsphere-infra-federation\shardingsphere-infra-federation-optimizer\src\main\java\org\apache\shardingsphere\infra\federation\optimizer\converter\segment\where\WhereConverter.java,0,9,0,9,0,18
 shardingsphere-master\shardingsphere-master\shardingsphere-proxy\shardingsphere-proxy-backend\src\main\java\org\apache\shardingsphere\proxy\backend\communication\jdbc\recognizer\impl\H2Recognizer.java,0,4,0,3,0,7
 shardingsphere-master\shardingsphere-master\shardingsphere-infra\shardingsphere-infra-executor\src\main\java\org\apache\shardingsphere\infra\executor\sql\prepare\driver\jdbc\ExecutorJDBCConnectionManager.java,0,2,0,3,0,5
 shardingsphere-master\shardingsphere-master\shardingsphere-kernel\shardingsphere-data-pipeline\shardingsphere-data-pipeline-core\src\main\java\org\apache\shardingsphere\data\pipeline\scenario\rulealtered\spi\IdleRuleAlteredJobCompletionDetectAlgorithm.java,0,41,0,25,0,66
 shardingsphere-master\shardingsphere-master\shardingsphere-infra\shardingsphere-infra-federation\shardingsphere-infra-federation-optimizer\src\test\java\org\apache\shardingsphere\infra\federation\optimizer\metadata\fixture\CommonFixtureRule.java,0,3,0,1,0,4
 shardingsphere-master\shardingsphere-master\shardingsphere-infra\shardingsphere-infra-rewrite\src\main\java\org\apache\shardingsphere\infra\rewrite\sql\impl\AbstractSQLBuilder.java,45,13,0,8,0,21
 shardingsphere-master\shardingsphere-master\shardingsphere-test\shardingsphere-parser-test\src\main\java\org\apache\shardingsphere\test\sql\parser\parameterized\jaxb\cases\domain\statement\dml\UpdateStatementTestCase.java,0,10,0,8,0,18
 shardingsphere-master\shardingsphere-master\shardingsphere-db-protocol\shardingsphere-db-protocol-postgresql\src\test\java\org\apache\shardingsphere\db\protocol\postgresql\packet\command\query\extended\PostgreSQLPreparedStatementRegistryTest.java,0,17,0,13,0,30
 shardingsphere-master\shardingsphere-master\shardingsphere-test\shardingsphere-parser-test\src\main\java\org\apache\shardingsphere\test\sql\parser\parameterized\jaxb\cases\domain\segment\impl\expr\ExpectedBetweenExpression.java,0,10,0,4,0,14
 shardingsphere-master\shardingsphere-master\shardingsphere-jdbc\shardingsphere-jdbc-core\src\test\java\org\apache\shardingsphere\driver\fixture\TestQueryAssistedEncryptAlgorithm.java,0,9,1,5,0,15
 shardingsphere-master\shardingsphere-master\shardingsphere-agent\shardingsphere-agent-plugins\shardingsphere-agent-plugin-metrics\shardingsphere-agent-metrics-api\src\test\java\org\apache\shardingsphere\agent\metrics\api\BaseTest.java,20,8,0,5,0,13
 shardingsphere-master\shardingsphere-master\shardingsphere-kernel\shardingsphere-data-pipeline\shardingsphere-data-pipeline-spi\src\main\java\org\apache\shardingsphere\data\pipeline\api\datasource\config\yaml\YamlJdbcConfiguration.java,0,7,0,1,0,8
 shardingsphere-master\shardingsphere-master\shardingsphere-kernel\shardingsphere-data-pipeline\shardingsphere-data-pipeline-core\src\main\java\org\apache\shardingsphere\data\pipeline\core\ingest\channel\memory\MultiplexMemoryPipelineChannel.java,0,31,0,9,0,40
 shardingsphere-master\shardingsphere-master\shardingsphere-test\shardingsphere-parser-test\src\main\java\org\apache\shardingsphere\test\sql\parser\parameterized\jaxb\cases\domain\statement\distsql\ral\scaling\ShowScalingCheckAlgorithmsStatementTestCase.java,0,1,0,4,0,5
 shardingsphere-master\shardingsphere-master\shardingsphere-infra\shardingsphere-infra-rewrite\src\main\java\org\apache\shardingsphere\infra\rewrite\sql\token\pojo\generic\RemoveToken.java,0,6,0,1,0,7
 shardingsphere-master\shardingsphere-master\shardingsphere-proxy\shardingsphere-proxy-backend\src\test\java\org\apache\shardingsphere\proxy\backend\text\distsql\rql\RulesUsedResourceQueryResultSetTest.java,0,36,0,28,0,64
 shardingsphere-master\shardingsphere-master\shardingsphere-proxy\shardingsphere-proxy-frontend\shardingsphere-proxy-frontend-postgresql\src\test\java\org\apache\shardingsphere\proxy\frontend\postgresql\command\query\extended\execute\PostgreSQLComExecuteExecutorTest.java,0,24,0,12,0,36
 shardingsphere-master\shardingsphere-master\shardingsphere-infra\shardingsphere-infra-merge\src\main\java\org\apache\shardingsphere\infra\merge\engine\ResultProcessEngine.java,0,3,0,2,0,5
 shardingsphere-master\shardingsphere-master\shardingsphere-sql-parser\shardingsphere-sql-parser-statement\src\main\java\org\apache\shardingsphere\sql\parser\sql\dialect\statement\mysql\dal\MySQLRepairTableStatement.java,0,3,0,6,1,10
 shardingsphere-master\shardingsphere-master\shardingsphere-infra\shardingsphere-infra-common\src\main\java\org\apache\shardingsphere\infra\metadata\schema\loader\common\SchemaMetaDataLoader.java,0,14,0,6,0,20
 shardingsphere-master\shardingsphere-master\shardingsphere-test\shardingsphere-parser-test\src\main\java\org\apache\shardingsphere\test\sql\parser\parameterized\asserts\statement\distsql\rdl\alter\impl\AlterDatabaseDiscoveryRuleStatementAssert.java,0,37,0,44,0,81
 shardingsphere-master\shardingsphere-master\shardingsphere-sql-parser\shardingsphere-sql-parser-dialect\shardingsphere-sql-parser-mysql\src\test\java\org\apache\shardingsphere\sql\parser\mysql\UnsupportedMySQLParserParameterizedTest.java,0,6,0,5,0,11
 shardingsphere-master\shardingsphere-master\shardingsphere-distsql\shardingsphere-distsql-statement\src\main\java\org\apache\shardingsphere\distsql\parser\statement\ral\advanced\FormatStatement.java,0,3,0,2,0,5
 shardingsphere-master\shardingsphere-master\shardingsphere-infra\shardingsphere-infra-common\src\main\java\org\apache\shardingsphere\infra\aware\DataSourceNameAware.java,0,6,0,1,0,7
 shardingsphere-master\shardingsphere-master\shardingsphere-kernel\shardingsphere-data-pipeline\shardingsphere-data-pipeline-dialect\shardingsphere-data-pipeline-opengauss\src\main\java\org\apache\shardingsphere\data\pipeline\opengauss\sqlbuilder\OpenGaussPipelineSQLBuilder.java,0,17,0,9,0,26
 shardingsphere-master\shardingsphere-master\shardingsphere-db-protocol\shardingsphere-db-protocol-mysql\src\main\java\org\apache\shardingsphere\db\protocol\mysql\packet\command\query\MySQLColumnDefinition41Packet.java,0,77,0,15,0,92
 shardingsphere-master\shardingsphere-master\shardingsphere-mode\shardingsphere-mode-type\shardingsphere-cluster-mode\shardingsphere-cluster-mode-core\src\main\java\org\apache\shardingsphere\mode\manager\cluster\coordinator\registry\cache\event\StartScalingEvent.java,0,16,0,3,0,19
 shardingsphere-master\shardingsphere-master\shardingsphere-test\shardingsphere-test-common\src\main\java\org\apache\shardingsphere\test\mock\MockedDriver.java,0,8,0,2,0,10
 shardingsphere-master\shardingsphere-master\shardingsphere-distsql\shardingsphere-distsql-statement\src\main\java\org\apache\shardingsphere\distsql\parser\statement\ral\common\updatable\SetVariableStatement.java,7,4,0,2,0,6
 shardingsphere-master\shardingsphere-master\shardingsphere-infra\shardingsphere-infra-merge\src\main\java\org\apache\shardingsphere\infra\merge\result\impl\memory\MemoryQueryResultRow.java,0,11,0,5,0,16
 shardingsphere-master\shardingsphere-master\shardingsphere-kernel\shardingsphere-traffic\shardingsphere-traffic-api\src\main\java\org\apache\shardingsphere\traffic\api\config\TrafficStrategyConfiguration.java,0,8,0,1,0,9
 shardingsphere-master\shardingsphere-master\shardingsphere-test\shardingsphere-parser-test\src\main\java\org\apache\shardingsphere\test\sql\parser\parameterized\jaxb\cases\domain\statement\distsql\rdl\create\CreateShadowRuleStatementTestCase.java,0,2,0,4,0,6
 shardingsphere-master\shardingsphere-master\shardingsphere-proxy\shardingsphere-proxy-frontend\shardingsphere-proxy-frontend-opengauss\src\test\java\org\apache\shardingsphere\proxy\frontend\opengauss\authentication\OpenGaussAuthenticationEngineTest.java,0,81,6,45,0,132
 shardingsphere-master\shardingsphere-master\shardingsphere-kernel\shardingsphere-transaction\shardingsphere-transaction-core\src\main\java\org\apache\shardingsphere\transaction\spi\TransactionConfigurationFileGeneratorFactory.java,0,6,1,4,0,11
 shardingsphere-master\shardingsphere-master\shardingsphere-test\shardingsphere-parser-test\src\main\java\org\apache\shardingsphere\test\sql\parser\parameterized\asserts\statement\distsql\ral\impl\common\updatable\AlterSQLParserRuleStatementAssert.java,0,14,1,17,0,32
 shardingsphere-master\shardingsphere-master\shardingsphere-db-protocol\shardingsphere-db-protocol-postgresql\src\test\java\org\apache\shardingsphere\db\protocol\postgresql\packet\generic\PostgreSQLMD5PasswordAuthenticationPacketTest.java,0,8,0,7,0,15
 shardingsphere-master\shardingsphere-master\shardingsphere-proxy\shardingsphere-proxy-backend\src\main\java\org\apache\shardingsphere\proxy\backend\communication\jdbc\connection\ConnectionPostProcessor.java,0,3,0,1,0,4
 shardingsphere-master\shardingsphere-master\shardingsphere-features\shardingsphere-readwrite-splitting\shardingsphere-readwrite-splitting-core\src\main\java\org\apache\shardingsphere\readwritesplitting\checker\AbstractReadwriteSplittingRuleConfigurationChecker.java,17,10,0,7,0,17
 shardingsphere-master\shardingsphere-master\shardingsphere-db-protocol\shardingsphere-db-protocol-core\src\main\java\org\apache\shardingsphere\db\protocol\error\SQLErrorCode.java,0,6,0,1,0,7
 shardingsphere-master\shardingsphere-master\shardingsphere-infra\shardingsphere-infra-merge\src\main\java\org\apache\shardingsphere\infra\merge\result\impl\stream\StreamMergedResult.java,40,18,0,8,0,26
 shardingsphere-master\shardingsphere-master\shardingsphere-kernel\shardingsphere-data-pipeline\shardingsphere-data-pipeline-spi\src\main\java\org\apache\shardingsphere\data\pipeline\api\ingest\record\GroupedDataRecord.java,0,8,0,1,0,9
 shardingsphere-master\shardingsphere-master\shardingsphere-infra\shardingsphere-infra-route\src\test\java\org\apache\shardingsphere\infra\route\fixture\rule\RouteFailureRuleFixture.java,0,2,0,1,0,3
 shardingsphere-master\shardingsphere-master\shardingsphere-infra\shardingsphere-infra-merge\src\test\java\org\apache\shardingsphere\infra\merge\fixture\rule\IndependentRuleFixture.java,0,1,0,1,0,2
 shardingsphere-master\shardingsphere-master\shardingsphere-jdbc\shardingsphere-jdbc-spring\shardingsphere-jdbc-spring-infra\shardingsphere-jdbc-spring-boot-starter-infra\src\test\java\org\apache\shardingsphere\spring\boot\util\PropertyUtilTest.java,0,10,0,4,0,14
 shardingsphere-master\shardingsphere-master\shardingsphere-infra\shardingsphere-infra-federation\shardingsphere-infra-federation-optimizer\src\main\java\org\apache\shardingsphere\infra\federation\optimizer\context\parser\dialect\impl\SQL92OptimizerBuilder.java,0,5,0,6,0,11
 shardingsphere-master\shardingsphere-master\shardingsphere-infra\shardingsphere-infra-binder\src\test\java\org\apache\shardingsphere\infra\binder\statement\ddl\CreateTableStatementContextTest.java,0,19,0,29,0,48
 shardingsphere-master\shardingsphere-master\shardingsphere-infra\shardingsphere-infra-binder\src\main\java\org\apache\shardingsphere\infra\binder\segment\insert\values\expression\DerivedParameterMarkerExpressionSegment.java,0,4,0,4,0,8
 shardingsphere-master\shardingsphere-master\shardingsphere-proxy\shardingsphere-proxy-bootstrap\src\main\java\org\apache\shardingsphere\proxy\initializer\BootstrapInitializer.java,0,17,2,17,0,36
 shardingsphere-master\shardingsphere-master\shardingsphere-infra\shardingsphere-infra-binder\src\test\java\org\apache\shardingsphere\infra\binder\segment\select\projection\DerivedColumnTest.java,0,17,0,7,0,24
 shardingsphere-master\shardingsphere-master\shardingsphere-db-protocol\shardingsphere-db-protocol-postgresql\src\main\java\org\apache\shardingsphere\db\protocol\postgresql\packet\command\query\PostgreSQLDataRowPacket.java,0,14,1,13,0,28
 shardingsphere-master\shardingsphere-master\shardingsphere-features\shardingsphere-db-discovery\shardingsphere-db-discovery-core\src\main\java\org\apache\shardingsphere\dbdiscovery\rule\builder\DatabaseDiscoveryRuleBuilder.java,0,8,0,8,0,16
 shardingsphere-master\shardingsphere-master\shardingsphere-kernel\shardingsphere-data-pipeline\shardingsphere-data-pipeline-dialect\shardingsphere-data-pipeline-mysql\src\test\java\org\apache\shardingsphere\data\pipeline\mysql\MySQLScalingEntryTest.java,0,7,0,7,0,14
 shardingsphere-master\shardingsphere-master\shardingsphere-test\shardingsphere-parser-test\src\main\java\org\apache\shardingsphere\test\sql\parser\parameterized\asserts\statement\dal\impl\ShowSlaveHostsStatementAssert.java,0,3,1,7,0,11
 shardingsphere-master\shardingsphere-master\shardingsphere-sql-parser\shardingsphere-sql-parser-statement\src\main\java\org\apache\shardingsphere\sql\parser\sql\dialect\statement\sqlserver\dcl\SQLServerGrantStatement.java,0,3,0,6,1,10
 shardingsphere-master\shardingsphere-master\shardingsphere-features\shardingsphere-sharding\shardingsphere-sharding-api\src\main\java\org\apache\shardingsphere\sharding\api\sharding\complex\ComplexKeysShardingAlgorithm.java,0,6,0,3,0,9
 shardingsphere-master\shardingsphere-master\shardingsphere-test\shardingsphere-parser-test\src\main\java\org\apache\shardingsphere\test\sql\parser\parameterized\jaxb\cases\domain\statement\dml\SelectStatementTestCase.java,0,23,0,15,0,38
 shardingsphere-master\shardingsphere-master\shardingsphere-jdbc\shardingsphere-jdbc-core\src\main\java\org\apache\shardingsphere\driver\jdbc\core\resultset\GeneratedKeysResultSetMetaData.java,0,24,0,2,0,26
 shardingsphere-master\shardingsphere-master\shardingsphere-proxy\shardingsphere-proxy-backend\src\test\java\org\apache\shardingsphere\proxy\backend\text\admin\mysql\executor\information\SelectInformationExecutorTest.java,0,83,3,61,0,147
 shardingsphere-master\shardingsphere-master\shardingsphere-sql-parser\shardingsphere-sql-parser-statement\src\main\java\org\apache\shardingsphere\sql\parser\sql\common\statement\ddl\CreateRuleStatement.java,3,1,1,3,0,5
 shardingsphere-master\shardingsphere-master\shardingsphere-test\shardingsphere-parser-test\src\main\java\org\apache\shardingsphere\test\sql\parser\parameterized\jaxb\cases\domain\statement\distsql\ral\scaling\DropScalingStatementTestCase.java,0,2,0,3,0,5
 shardingsphere-master\shardingsphere-master\shardingsphere-test\shardingsphere-parser-test\src\main\java\org\apache\shardingsphere\test\sql\parser\parameterized\asserts\statement\dcl\impl\RenameUserStatementAssert.java,0,4,1,6,0,11
 shardingsphere-master\shardingsphere-master\shardingsphere-db-protocol\shardingsphere-db-protocol-postgresql\src\test\java\org\apache\shardingsphere\db\protocol\postgresql\packet\command\PostgreSQLCommandPacketTypeTest.java,0,11,0,8,0,19
 shardingsphere-master\shardingsphere-master\shardingsphere-kernel\shardingsphere-data-pipeline\shardingsphere-data-pipeline-core\src\main\java\org\apache\shardingsphere\data\pipeline\core\spi\check\consistency\CRC32MatchDataConsistencyCheckAlgorithm.java,0,9,0,3,0,12
 shardingsphere-master\shardingsphere-master\shardingsphere-mode\shardingsphere-mode-type\shardingsphere-cluster-mode\shardingsphere-cluster-mode-core\src\main\java\org\apache\shardingsphere\mode\manager\cluster\coordinator\registry\metadata\event\SchemaAddedEvent.java,0,3,0,3,0,6
 shardingsphere-master\shardingsphere-master\examples\shardingsphere-jdbc-example\single-feature-example\shadow-example\shadow-raw-jdbc-example\src\main\java\org\apache\shardingsphere\example\shadow\raw\jdbc\ShadowRawJavaConfigurationExample.java,0,11,1,8,0,20
 shardingsphere-master\shardingsphere-master\shardingsphere-jdbc\shardingsphere-jdbc-core\src\test\java\org\apache\shardingsphere\driver\executor\AbstractBaseExecutorTest.java,60,22,0,12,0,34
 shardingsphere-master\shardingsphere-master\shardingsphere-jdbc\shardingsphere-jdbc-core\src\main\java\org\apache\shardingsphere\driver\jdbc\core\statement\ShardingSpherePreparedStatement.java,0,229,8,143,0,380
 shardingsphere-master\shardingsphere-master\shardingsphere-kernel\shardingsphere-authority\shardingsphere-authority-core\src\main\java\org\apache\shardingsphere\authority\rule\AuthorityRule.java,0,18,0,7,0,25
 shardingsphere-master\shardingsphere-master\examples\shardingsphere-jdbc-example\single-feature-example\sharding-example\sharding-spring-boot-mybatis-example\src\main\java\org\apache\shardingsphere\example\sharding\spring\boot\mybatis\ShardingSpringBootMybatisExample.java,9,7,1,5,0,13
 shardingsphere-master\shardingsphere-master\shardingsphere-db-protocol\shardingsphere-db-protocol-postgresql\src\main\java\org\apache\shardingsphere\db\protocol\postgresql\packet\command\query\PostgreSQLEmptyQueryResponsePacket.java,0,3,1,6,0,10
 shardingsphere-master\shardingsphere-master\examples\shardingsphere-jdbc-example\mixed-feature-example\sharding-readwrite-splitting-example\sharding-readwrite-splitting-raw-jdbc-example\src\main\java\org\apache\shardingsphere\example\sharding\readwrite\splitting\raw\ShardingReadwriteSplittingRawYamlConfigurationExample.java,0,8,1,5,0,14
 shardingsphere-master\shardingsphere-master\shardingsphere-distsql\shardingsphere-distsql-statement\src\main\java\org\apache\shardingsphere\distsql\parser\statement\rdl\create\AddResourceStatement.java,0,3,0,2,0,5
 shardingsphere-master\shardingsphere-master\shardingsphere-infra\shardingsphere-infra-binder\src\test\java\org\apache\shardingsphere\infra\binder\statement\ddl\CreateViewStatementContextTest.java,0,5,0,11,0,16
 shardingsphere-master\shardingsphere-master\shardingsphere-sql-parser\shardingsphere-sql-parser-statement\src\main\java\org\apache\shardingsphere\sql\parser\sql\dialect\statement\mysql\ddl\MySQLAlterTablespaceStatement.java,0,1,0,4,0,5
 shardingsphere-master\shardingsphere-master\shardingsphere-proxy\shardingsphere-proxy-backend\src\main\java\org\apache\shardingsphere\proxy\backend\config\yaml\YamlProxySchemaConfiguration.java,0,7,0,2,0,9
 shardingsphere-master\shardingsphere-master\shardingsphere-infra\shardingsphere-infra-executor\src\main\java\org\apache\shardingsphere\infra\executor\sql\hook\SQLExecutionHook.java,0,5,0,2,0,7
 shardingsphere-master\shardingsphere-master\shardingsphere-agent\shardingsphere-agent-api\src\main\java\org\apache\shardingsphere\agent\api\advice\AdviceTargetObject.java,0,4,0,2,0,6
 shardingsphere-master\shardingsphere-master\shardingsphere-test\shardingsphere-parser-test\src\main\java\org\apache\shardingsphere\test\sql\parser\parameterized\jaxb\cases\domain\statement\ddl\CreateRuleStatementTestCase.java,0,0,0,3,0,3
 shardingsphere-master\shardingsphere-master\shardingsphere-infra\shardingsphere-infra-rewrite\src\test\java\org\apache\shardingsphere\infra\rewrite\sql\impl\RouteSQLBuilderTest.java,0,14,0,7,0,21
 shardingsphere-master\shardingsphere-master\shardingsphere-infra\shardingsphere-infra-common\src\test\java\org\apache\shardingsphere\infra\metadata\user\yaml\swapper\UserYamlSwapperTest.java,0,11,4,6,0,21
 shardingsphere-master\shardingsphere-master\shardingsphere-features\shardingsphere-sharding\shardingsphere-sharding-core\src\test\java\org\apache\shardingsphere\sharding\algorithm\sharding\cosid\Arguments.java,0,4,1,1,0,6
 shardingsphere-master\shardingsphere-master\shardingsphere-proxy\shardingsphere-proxy-backend\src\test\java\org\apache\shardingsphere\proxy\backend\text\distsql\rql\RuleDefinitionBackendHandlerTest.java,0,10,0,9,0,19
 shardingsphere-master\shardingsphere-master\shardingsphere-features\shardingsphere-sharding\shardingsphere-sharding-core\src\test\java\org\apache\shardingsphere\sharding\route\engine\condition\ShardingConditionsTest.java,0,27,0,17,0,44
 shardingsphere-master\shardingsphere-master\shardingsphere-infra\shardingsphere-infra-federation\shardingsphere-infra-federation-optimizer\src\main\java\org\apache\shardingsphere\infra\federation\optimizer\converter\segment\projection\impl\ColumnProjectionConverter.java,0,14,0,19,0,33
 shardingsphere-master\shardingsphere-master\shardingsphere-sql-parser\shardingsphere-sql-parser-statement\src\main\java\org\apache\shardingsphere\sql\parser\sql\common\statement\ddl\CreateTypeStatement.java,3,1,1,3,0,5
 shardingsphere-master\shardingsphere-master\shardingsphere-agent\shardingsphere-agent-plugins\shardingsphere-agent-plugin-tracing\shardingsphere-agent-tracing-zipkin\src\test\java\org\apache\shardingsphere\agent\plugin\tracing\zipkin\service\ZipkinTracingPluginBootServiceTest.java,0,13,1,4,0,18
 shardingsphere-master\shardingsphere-master\shardingsphere-proxy\shardingsphere-proxy-frontend\shardingsphere-proxy-frontend-postgresql\src\main\java\org\apache\shardingsphere\proxy\frontend\postgresql\command\query\exception\InvalidParameterValueException.java,0,4,0,2,0,6
 shardingsphere-master\shardingsphere-master\shardingsphere-features\shardingsphere-encrypt\shardingsphere-encrypt-distsql\shardingsphere-encrypt-distsql-parser\src\main\java\org\apache\shardingsphere\encrypt\distsql\parser\core\EncryptDistSQLLexer.java,0,4,0,3,0,7
 shardingsphere-master\shardingsphere-master\shardingsphere-infra\shardingsphere-infra-federation\shardingsphere-infra-federation-optimizer\src\main\java\org\apache\shardingsphere\infra\federation\optimizer\converter\segment\expression\impl\InExpressionConverter.java,0,18,0,17,0,35
 shardingsphere-master\shardingsphere-master\shardingsphere-test\shardingsphere-integration-test\shardingsphere-integration-test-suite\src\test\java\org\apache\shardingsphere\test\integration\framework\container\atomic\storage\impl\PostgreSQLContainer.java,0,14,0,10,0,24
 shardingsphere-master\shardingsphere-master\shardingsphere-kernel\shardingsphere-single-table\shardingsphere-single-table-core\src\main\java\org\apache\shardingsphere\singletable\yaml\config\pojo\YamlSingleTableRuleConfiguration.java,0,5,0,3,0,8
 shardingsphere-master\shardingsphere-master\shardingsphere-proxy\shardingsphere-proxy-frontend\shardingsphere-proxy-frontend-mysql\src\main\java\org\apache\shardingsphere\proxy\frontend\mysql\command\admin\quit\MySQLComQuitExecutor.java,0,2,0,2,0,4
 shardingsphere-master\shardingsphere-master\shardingsphere-proxy\shardingsphere-proxy-backend\src\main\java\org\apache\shardingsphere\proxy\backend\communication\vertx\executor\ProxyReactiveExecutor.java,0,10,0,13,0,23
 shardingsphere-master\shardingsphere-master\examples\shardingsphere-jdbc-example\single-feature-example\cluster-mode-example\cluster-mode-raw-jdbc-example\src\main\java\org\apache\shardingsphere\example\cluster\mode\raw\jdbc\config\local\LocalShardingReadwriteSplittingConfiguration.java,0,39,0,32,0,71
 shardingsphere-master\shardingsphere-master\shardingsphere-sql-parser\shardingsphere-sql-parser-dialect\shardingsphere-sql-parser-sqlserver\src\main\java\org\apache\shardingsphere\sql\parser\sqlserver\visitor\statement\impl\SQLServerDALStatementSQLVisitor.java,0,7,0,7,0,14
 shardingsphere-master\shardingsphere-master\shardingsphere-proxy\shardingsphere-proxy-frontend\shardingsphere-proxy-frontend-core\src\test\java\org\apache\shardingsphere\proxy\frontend\netty\ServerHandlerInitializerTest.java,0,4,0,3,0,7
 shardingsphere-master\shardingsphere-master\shardingsphere-infra\shardingsphere-infra-binder\src\main\java\org\apache\shardingsphere\infra\binder\statement\ddl\PrepareStatementContext.java,0,13,0,11,0,24
 shardingsphere-master\shardingsphere-master\shardingsphere-infra\shardingsphere-infra-executor\src\test\java\org\apache\shardingsphere\infra\executor\sql\execute\engine\jdbc\JDBCExecutorCallbackTest.java,0,22,1,12,0,35
 shardingsphere-master\shardingsphere-master\examples\shardingsphere-jdbc-example\single-feature-example\extension-example\custom-sharding-algortihm-example\class-based-sharding-algorithm-example\class-based-sharding-spring-namespace-mybatis-example\src\main\java\org\apache\shardingsphere\example\extension\classbased\sharding\spring\namespace\mybatis\fixture\ClassBasedOrderStandardShardingAlgorithmFixture.java,0,16,0,11,0,27
 shardingsphere-master\shardingsphere-master\shardingsphere-test\shardingsphere-parser-test\src\main\java\org\apache\shardingsphere\test\sql\parser\parameterized\jaxb\cases\domain\statement\tcl\SetAutoCommitStatementTestCase.java,0,2,0,3,0,5
 shardingsphere-master\shardingsphere-master\shardingsphere-sql-parser\shardingsphere-sql-parser-statement\src\main\java\org\apache\shardingsphere\sql\parser\sql\dialect\statement\mysql\ddl\MySQLDropProcedureStatement.java,0,1,0,4,0,5
 shardingsphere-master\shardingsphere-master\shardingsphere-infra\shardingsphere-infra-common\src\test\java\org\apache\shardingsphere\infra\metadata\schema\loader\dialect\H2TableMetaDataLoaderTest.java,0,29,14,23,0,66
 shardingsphere-master\shardingsphere-master\shardingsphere-infra\shardingsphere-infra-executor\src\main\java\org\apache\shardingsphere\infra\executor\sql\execute\result\ExecuteResult.java,0,1,0,1,0,2
 shardingsphere-master\shardingsphere-master\examples\shardingsphere-jdbc-example\single-feature-example\cluster-mode-example\cluster-mode-raw-jdbc-example\src\main\java\org\apache\shardingsphere\example\cluster\mode\raw\jdbc\ClusterModeRawYamlConfigurationExample.java,0,35,5,22,0,62
 shardingsphere-master\shardingsphere-master\shardingsphere-sql-parser\shardingsphere-sql-parser-statement\src\main\java\org\apache\shardingsphere\sql\parser\sql\dialect\statement\sqlserver\dcl\SQLServerDropUserStatement.java,0,1,0,5,0,6
 shardingsphere-master\shardingsphere-master\shardingsphere-kernel\shardingsphere-schedule\shardingsphere-schedule-core\src\main\java\org\apache\shardingsphere\schedule\core\api\ModeScheduleContextFactory.java,0,14,0,6,0,20
 shardingsphere-master\shardingsphere-master\shardingsphere-jdbc\shardingsphere-jdbc-core\src\test\java\org\apache\shardingsphere\driver\fixture\IncrementKeyGenerateAlgorithm.java,0,7,1,2,0,10
 shardingsphere-master\shardingsphere-master\shardingsphere-sql-parser\shardingsphere-sql-parser-statement\src\main\java\org\apache\shardingsphere\sql\parser\sql\dialect\statement\sqlserver\ddl\SQLServerCreateViewStatement.java,0,2,0,6,1,9
 shardingsphere-master\shardingsphere-master\shardingsphere-test\shardingsphere-parser-test\src\main\java\org\apache\shardingsphere\test\sql\parser\parameterized\jaxb\cases\domain\statement\ddl\CreateDatabaseLinkStatementTestCase.java,0,1,0,4,0,5
 shardingsphere-master\shardingsphere-master\shardingsphere-proxy\shardingsphere-proxy-backend\src\main\java\org\apache\shardingsphere\proxy\backend\text\distsql\rdl\rule\RuleDefinitionBackendHandler.java,0,73,0,68,0,141
 shardingsphere-master\shardingsphere-master\shardingsphere-proxy\shardingsphere-proxy-frontend\shardingsphere-proxy-frontend-postgresql\src\test\java\org\apache\shardingsphere\proxy\frontend\postgresql\command\generic\PostgreSQLUnsupportedCommandExecutorTest.java,0,4,0,4,0,8
 shardingsphere-master\shardingsphere-master\shardingsphere-infra\shardingsphere-infra-common\src\main\java\org\apache\shardingsphere\infra\datasource\props\synonym\PoolPropertySynonyms.java,0,7,0,3,0,10
 shardingsphere-master\shardingsphere-master\shardingsphere-features\shardingsphere-sharding\shardingsphere-sharding-core\src\test\java\org\apache\shardingsphere\sharding\merge\dal\show\ShowIndexMergedResultTest.java,0,14,0,5,0,19
 shardingsphere-master\shardingsphere-master\examples\shardingsphere-proxy-example\shardingsphere-proxy-distsql-example\src\main\java\org\apache\shardingsphere\example\proxy\distsql\DistSQLExecutor.java,0,5,0,1,0,6
 shardingsphere-master\shardingsphere-master\shardingsphere-infra\shardingsphere-infra-parser\src\main\java\org\apache\shardingsphere\infra\parser\ParserConfiguration.java,0,7,0,1,0,8
 shardingsphere-master\shardingsphere-master\shardingsphere-mode\shardingsphere-mode-core\src\main\java\org\apache\shardingsphere\mode\metadata\persist\service\impl\DataSourcePersistService.java,0,42,0,26,0,68
 shardingsphere-master\shardingsphere-master\shardingsphere-kernel\shardingsphere-data-pipeline\shardingsphere-data-pipeline-spi\src\main\java\org\apache\shardingsphere\data\pipeline\api\ingest\position\IngestPosition.java,0,1,0,1,0,2
 shardingsphere-master\shardingsphere-master\shardingsphere-infra\shardingsphere-infra-common\src\test\java\org\apache\shardingsphere\infra\yaml\engine\fixture\YamlTupleProcessorFixture.java,0,4,0,4,0,8
 shardingsphere-master\shardingsphere-master\shardingsphere-proxy\shardingsphere-proxy-backend\src\test\java\org\apache\shardingsphere\proxy\backend\text\admin\mysql\executor\ShowCreateDatabaseExecutorTest.java,0,21,1,14,0,36
 shardingsphere-master\shardingsphere-master\shardingsphere-sql-parser\shardingsphere-sql-parser-spi\src\main\java\org\apache\shardingsphere\sql\parser\api\visitor\type\DCLSQLVisitor.java,0,0,0,1,0,1
 shardingsphere-master\shardingsphere-master\shardingsphere-kernel\shardingsphere-data-pipeline\shardingsphere-data-pipeline-dialect\shardingsphere-data-pipeline-postgresql\src\main\java\org\apache\shardingsphere\data\pipeline\postgresql\sqlbuilder\PostgreSQLPipelineSQLBuilder.java,0,12,1,4,0,17
 shardingsphere-master\shardingsphere-master\shardingsphere-kernel\shardingsphere-data-pipeline\shardingsphere-data-pipeline-spi\src\main\java\org\apache\shardingsphere\data\pipeline\api\config\rulealtered\WorkflowConfiguration.java,0,19,0,3,0,22
 shardingsphere-master\shardingsphere-master\shardingsphere-infra\shardingsphere-infra-common\src\main\java\org\apache\shardingsphere\infra\datasource\pool\metadata\DataSourcePoolMetaData.java,0,8,0,1,0,9
 shardingsphere-master\shardingsphere-master\examples\shardingsphere-example-generator\src\main\java\org\apache\shardingsphere\example\generator\ExampleGeneratorMain.java,0,7,0,3,0,10
 shardingsphere-master\shardingsphere-master\shardingsphere-features\shardingsphere-shadow\shardingsphere-shadow-core\src\test\java\org\apache\shardingsphere\shadow\algorithm\shadow\column\ColumnRegexMatchShadowAlgorithmTest.java,0,16,0,6,0,22
 shardingsphere-master\shardingsphere-master\shardingsphere-features\shardingsphere-encrypt\shardingsphere-encrypt-core\src\test\java\org\apache\shardingsphere\encrypt\rewrite\impl\EncryptCreateTableTokenGeneratorTest.java,0,42,0,30,0,72
 shardingsphere-master\shardingsphere-master\shardingsphere-features\shardingsphere-sharding\shardingsphere-sharding-core\src\test\java\org\apache\shardingsphere\sharding\route\engine\validator\ddl\ShardingRenameTableStatementValidatorTest.java,0,25,0,28,0,53
 shardingsphere-master\shardingsphere-master\shardingsphere-test\shardingsphere-parser-test\src\main\java\org\apache\shardingsphere\test\sql\parser\parameterized\jaxb\cases\domain\statement\ddl\AlterDatabaseStatementTestCase.java,0,0,0,3,0,3
 shardingsphere-master\shardingsphere-master\shardingsphere-test\shardingsphere-parser-test\src\main\java\org\apache\shardingsphere\test\sql\parser\parameterized\asserts\statement\dal\impl\FlushStatementAssert.java,0,7,0,10,0,17
 shardingsphere-master\shardingsphere-master\shardingsphere-sql-parser\shardingsphere-sql-parser-statement\src\main\java\org\apache\shardingsphere\sql\parser\sql\dialect\statement\mysql\dcl\MySQLSetRoleStatement.java,0,1,0,5,0,6
 shardingsphere-master\shardingsphere-master\shardingsphere-sql-parser\shardingsphere-sql-parser-dialect\shardingsphere-sql-parser-sql92\src\main\java\org\apache\shardingsphere\sql\parser\sql92\visitor\statement\impl\SQL92DALStatementSQLVisitor.java,0,4,0,3,0,7
 shardingsphere-master\shardingsphere-master\shardingsphere-features\shardingsphere-sharding\shardingsphere-sharding-spring\shardingsphere-sharding-spring-namespace\src\test\java\org\apache\shardingsphere\sharding\spring\namespace\ShardingSpringNamespaceTest.java,0,121,0,51,0,172
 shardingsphere-master\shardingsphere-master\shardingsphere-infra\shardingsphere-infra-common\src\test\java\org\apache\shardingsphere\infra\rule\builder\schema\SchemaRulesBuilderTest.java,0,5,0,4,0,9
 shardingsphere-master\shardingsphere-master\shardingsphere-distsql\shardingsphere-distsql-statement\src\main\java\org\apache\shardingsphere\distsql\parser\statement\rdl\drop\DropResourceStatement.java,0,11,0,3,0,14
 shardingsphere-master\shardingsphere-master\shardingsphere-sql-parser\shardingsphere-sql-parser-statement\src\main\java\org\apache\shardingsphere\sql\parser\sql\common\statement\ddl\DropGroupStatement.java,3,1,1,3,0,5
 shardingsphere-master\shardingsphere-master\shardingsphere-infra\shardingsphere-infra-common\src\test\java\org\apache\shardingsphere\infra\metadata\schema\fixture\loader\CommonFixtureTableMetaDataBuilder.java,0,8,0,7,0,15
 shardingsphere-master\shardingsphere-master\shardingsphere-test\shardingsphere-parser-test\src\main\java\org\apache\shardingsphere\test\sql\parser\parameterized\asserts\statement\distsql\rdl\create\CreateRuleStatementAssert.java,0,22,0,71,0,93
 shardingsphere-master\shardingsphere-master\shardingsphere-kernel\shardingsphere-data-pipeline\shardingsphere-data-pipeline-core\src\main\java\org\apache\shardingsphere\data\pipeline\scenario\rulealtered\spi\ContextManagerLifecycleListenerImpl.java,0,8,1,8,0,17
 shardingsphere-master\shardingsphere-master\shardingsphere-features\shardingsphere-sharding\shardingsphere-sharding-distsql\shardingsphere-sharding-distsql-statement\src\main\java\org\apache\shardingsphere\sharding\distsql\parser\statement\CreateShardingTableRuleStatement.java,0,3,0,4,0,7
 shardingsphere-master\shardingsphere-master\shardingsphere-features\shardingsphere-sharding\shardingsphere-sharding-api\src\main\java\org\apache\shardingsphere\sharding\api\sharding\ShardingAutoTableAlgorithm.java,0,3,0,3,0,6
 shardingsphere-master\shardingsphere-master\shardingsphere-sql-parser\shardingsphere-sql-parser-statement\src\main\java\org\apache\shardingsphere\sql\parser\sql\common\statement\dal\FlushStatement.java,3,1,1,3,0,5
 shardingsphere-master\shardingsphere-master\shardingsphere-sql-parser\shardingsphere-sql-parser-spi\src\main\java\org\apache\shardingsphere\sql\parser\api\visitor\operation\SQLOperationVisitor.java,0,0,0,1,0,1
 shardingsphere-master\shardingsphere-master\shardingsphere-features\shardingsphere-db-discovery\shardingsphere-db-discovery-core\src\test\java\org\apache\shardingsphere\dbdiscovery\rule\builder\AlgorithmProvidedDatabaseDiscoveryRuleBuilderTest.java,0,11,0,9,0,20
 shardingsphere-master\shardingsphere-master\shardingsphere-features\shardingsphere-sharding\shardingsphere-sharding-core\src\test\java\org\apache\shardingsphere\sharding\route\engine\validator\ddl\ShardingCreateIndexStatementValidatorTest.java,0,49,4,40,0,93
 shardingsphere-master\shardingsphere-master\shardingsphere-infra\shardingsphere-infra-common\src\main\java\org\apache\shardingsphere\infra\properties\PropertiesConverter.java,0,5,0,2,0,7
 shardingsphere-master\shardingsphere-master\shardingsphere-proxy\shardingsphere-proxy-frontend\shardingsphere-proxy-frontend-mysql\src\main\java\org\apache\shardingsphere\proxy\frontend\mysql\command\query\builder\ResponsePacketBuilder.java,0,15,0,16,0,31
 shardingsphere-master\shardingsphere-master\shardingsphere-proxy\shardingsphere-proxy-backend\src\main\java\org\apache\shardingsphere\proxy\backend\text\distsql\ral\common\queryable\ShowTrafficRulesHandler.java,0,29,0,20,0,49
 shardingsphere-master\shardingsphere-master\shardingsphere-jdbc\shardingsphere-jdbc-core\src\main\java\org\apache\shardingsphere\driver\jdbc\adapter\invocation\MethodInvocationRecorder.java,0,7,0,4,0,11
 shardingsphere-master\shardingsphere-master\shardingsphere-test\shardingsphere-parser-test\src\main\java\org\apache\shardingsphere\test\sql\parser\parameterized\asserts\statement\ddl\impl\NoAuditStatementAssert.java,0,3,1,6,0,10
 shardingsphere-master\shardingsphere-master\shardingsphere-agent\shardingsphere-agent-plugins\shardingsphere-agent-plugin-tracing\shardingsphere-agent-tracing-test\src\main\java\org\apache\shardingsphere\agent\plugin\tracing\rule\CollectorRule.java,0,2,0,1,0,3
 shardingsphere-master\shardingsphere-master\shardingsphere-features\shardingsphere-sharding\shardingsphere-sharding-distsql\shardingsphere-sharding-distsql-statement\src\main\java\org\apache\shardingsphere\sharding\distsql\parser\statement\DropShardingTableRuleStatement.java,0,6,0,4,0,10
 shardingsphere-master\shardingsphere-master\shardingsphere-sql-parser\shardingsphere-sql-parser-statement\src\main\java\org\apache\shardingsphere\sql\parser\sql\common\statement\ddl\AlterTextSearchStatement.java,3,1,1,3,0,5
 shardingsphere-master\shardingsphere-master\shardingsphere-test\shardingsphere-parser-test\src\main\java\org\apache\shardingsphere\test\sql\parser\parameterized\jaxb\cases\domain\segment\impl\output\ExpectedOutputClause.java,0,7,0,4,0,11
 shardingsphere-master\shardingsphere-master\shardingsphere-sql-parser\shardingsphere-sql-parser-statement\src\main\java\org\apache\shardingsphere\sql\parser\sql\common\segment\dml\pagination\limit\LimitValueSegment.java,12,5,0,3,0,8
 shardingsphere-master\shardingsphere-master\examples\shardingsphere-jdbc-example\single-feature-example\sharding-example\sharding-raw-jdbc-example\src\main\java\org\apache\shardingsphere\example\sharding\raw\jdbc\hint\ModuloHintShardingAlgorithm.java,0,6,1,4,0,11
 shardingsphere-master\shardingsphere-master\shardingsphere-features\shardingsphere-shadow\shardingsphere-shadow-core\src\main\java\org\apache\shardingsphere\shadow\algorithm\shadow\column\ColumnValueMatchShadowAlgorithm.java,0,8,0,4,0,12
 shardingsphere-master\shardingsphere-master\shardingsphere-infra\shardingsphere-infra-binder\src\main\java\org\apache\shardingsphere\infra\binder\segment\select\projection\impl\DerivedProjection.java,0,8,0,2,0,10
 shardingsphere-master\shardingsphere-master\shardingsphere-sql-parser\shardingsphere-sql-parser-statement\src\main\java\org\apache\shardingsphere\sql\parser\sql\dialect\statement\opengauss\ddl\OpenGaussAlterLanguageStatement.java,0,1,0,5,0,6
 shardingsphere-master\shardingsphere-master\shardingsphere-spi\src\test\java\org\apache\shardingsphere\spi\singleton\SingletonSPIRegistryTest.java,0,7,0,3,0,10
 shardingsphere-master\shardingsphere-master\shardingsphere-features\shardingsphere-sharding\shardingsphere-sharding-core\src\main\java\org\apache\shardingsphere\sharding\route\engine\condition\generator\impl\ConditionValueCompareOperatorGenerator.java,0,27,0,23,0,50
 shardingsphere-master\shardingsphere-master\shardingsphere-agent\shardingsphere-agent-plugins\shardingsphere-agent-plugin-logging\shardingsphere-agent-logging-base\src\main\java\org\apache\shardingsphere\agent\plugin\logging\base\advice\SchemaMetaDataLoaderAdvice.java,0,8,0,7,0,15
 shardingsphere-master\shardingsphere-master\shardingsphere-sql-parser\shardingsphere-sql-parser-statement\src\main\java\org\apache\shardingsphere\sql\parser\sql\dialect\statement\mysql\ddl\MySQLDropTriggerStatement.java,0,1,0,5,0,6
 shardingsphere-master\shardingsphere-master\shardingsphere-mode\shardingsphere-mode-core\src\test\java\org\apache\shardingsphere\mode\metadata\MetaDataContextsBuilderTest.java,0,33,4,25,0,62
 shardingsphere-master\shardingsphere-master\shardingsphere-sql-parser\shardingsphere-sql-parser-dialect\shardingsphere-sql-parser-postgresql\src\main\java\org\apache\shardingsphere\sql\parser\postgresql\parser\PostgreSQLLexerBase.java,31,5,0,1,0,6
 shardingsphere-master\shardingsphere-master\shardingsphere-test\shardingsphere-integration-scaling-test\shardingsphere-integration-scaling-test-mysql\src\test\java\org\apache\shardingsphere\integration\scaling\test\mysql\env\ITEnvironmentContext.java,0,30,0,21,0,51
 shardingsphere-master\shardingsphere-master\shardingsphere-mode\shardingsphere-mode-type\shardingsphere-cluster-mode\shardingsphere-cluster-mode-core\src\main\java\org\apache\shardingsphere\mode\manager\cluster\coordinator\registry\metadata\watcher\MetaDataChangedWatcher.java,0,46,0,50,0,96
 shardingsphere-master\shardingsphere-master\shardingsphere-sql-parser\shardingsphere-sql-parser-dialect\shardingsphere-sql-parser-sqlserver\src\main\java\org\apache\shardingsphere\sql\parser\sqlserver\visitor\statement\impl\SQLServerStatementSQLVisitor.java,1049,311,6,347,0,664
 shardingsphere-master\shardingsphere-master\shardingsphere-sql-parser\shardingsphere-sql-parser-statement\src\main\java\org\apache\shardingsphere\sql\parser\sql\dialect\statement\postgresql\ddl\PostgreSQLDropOperatorStatement.java,0,1,0,5,0,6
 shardingsphere-master\shardingsphere-master\shardingsphere-test\shardingsphere-parser-test\src\main\java\org\apache\shardingsphere\test\sql\parser\parameterized\jaxb\cases\domain\statement\distsql\ral\ImportSchemaConfigurationStatementTestCase.java,0,3,0,4,0,7
 shardingsphere-master\shardingsphere-master\shardingsphere-features\shardingsphere-readwrite-splitting\shardingsphere-readwrite-splitting-core\src\main\java\org\apache\shardingsphere\readwritesplitting\yaml\config\rule\YamlReadwriteSplittingDataSourceRuleConfiguration.java,0,8,0,2,0,10
 shardingsphere-master\shardingsphere-master\shardingsphere-mode\shardingsphere-mode-core\src\main\java\org\apache\shardingsphere\mode\metadata\persist\service\impl\SchemaRulePersistService.java,0,30,0,19,0,49
 shardingsphere-master\shardingsphere-master\shardingsphere-sql-parser\shardingsphere-sql-parser-dialect\shardingsphere-sql-parser-opengauss\src\test\java\org\apache\shardingsphere\sql\parser\opengauss\OpenGaussParserParameterizedTest.java,0,7,0,5,0,12
 shardingsphere-master\shardingsphere-master\shardingsphere-infra\shardingsphere-infra-common\src\main\java\org\apache\shardingsphere\infra\properties\TypedPropertyKey.java,0,6,0,1,0,7
 shardingsphere-master\shardingsphere-master\shardingsphere-mode\shardingsphere-mode-type\shardingsphere-standalone-mode\shardingsphere-standalone-mode-repository\shardingsphere-standalone-mode-repository-provider\shardingsphere-standalone-mode-repository-h2\src\main\java\org\apache\shardingsphere\mode\repository\standalone\h2\H2RepositoryProperties.java,0,3,0,2,0,5
 shardingsphere-master\shardingsphere-master\shardingsphere-infra\shardingsphere-infra-federation\shardingsphere-infra-federation-optimizer\src\main\java\org\apache\shardingsphere\infra\federation\optimizer\converter\segment\expression\impl\FunctionConverter.java,0,25,1,27,0,53
 shardingsphere-master\shardingsphere-master\shardingsphere-features\shardingsphere-db-discovery\shardingsphere-db-discovery-provider\shardingsphere-db-discovery-mysql\src\main\java\org\apache\shardingsphere\dbdiscovery\mysql\type\ShowSlaveStatusDatabaseDiscoveryType.java,0,29,0,19,0,48
 shardingsphere-master\shardingsphere-master\shardingsphere-sql-parser\shardingsphere-sql-parser-statement\src\main\java\org\apache\shardingsphere\sql\parser\sql\dialect\statement\postgresql\ddl\PostgreSQLCreateTextSearchStatement.java,0,1,0,5,0,6
 shardingsphere-master\shardingsphere-master\shardingsphere-sql-parser\shardingsphere-sql-parser-statement\src\main\java\org\apache\shardingsphere\sql\parser\sql\dialect\statement\postgresql\ddl\PostgreSQLDropPolicyStatement.java,0,1,0,5,0,6
 shardingsphere-master\shardingsphere-master\shardingsphere-sql-parser\shardingsphere-sql-parser-statement\src\main\java\org\apache\shardingsphere\sql\parser\sql\dialect\statement\postgresql\ddl\PostgreSQLAlterDomainStatement.java,0,1,0,5,0,6
 shardingsphere-master\shardingsphere-master\shardingsphere-test\shardingsphere-parser-test\src\main\java\org\apache\shardingsphere\test\sql\parser\parameterized\asserts\statement\dal\impl\ShowReplicaStatusStatementAssert.java,0,4,0,8,0,12
 shardingsphere-master\shardingsphere-master\shardingsphere-kernel\shardingsphere-authority\shardingsphere-authority-core\src\main\java\org\apache\shardingsphere\authority\yaml\swapper\AuthorityRuleConfigurationYamlSwapper.java,0,18,0,17,0,35
 shardingsphere-master\shardingsphere-master\shardingsphere-jdbc\shardingsphere-jdbc-core\src\test\java\org\apache\shardingsphere\driver\state\DriverStateContextTest.java,0,15,1,9,0,25
 shardingsphere-master\shardingsphere-master\shardingsphere-kernel\shardingsphere-data-pipeline\shardingsphere-data-pipeline-core\src\main\java\org\apache\shardingsphere\data\pipeline\scenario\rulealtered\RuleAlteredContext.java,0,57,0,46,0,103
 shardingsphere-master\shardingsphere-master\shardingsphere-kernel\shardingsphere-data-pipeline\shardingsphere-data-pipeline-core\src\main\java\org\apache\shardingsphere\data\pipeline\core\execute\ExecuteCallback.java,0,3,0,1,0,4
 shardingsphere-master\shardingsphere-master\shardingsphere-infra\shardingsphere-infra-executor\src\main\java\org\apache\shardingsphere\infra\executor\sql\prepare\driver\StorageResourceOption.java,0,0,0,1,0,1
 shardingsphere-master\shardingsphere-master\shardingsphere-proxy\shardingsphere-proxy-frontend\shardingsphere-proxy-frontend-postgresql\src\main\java\org\apache\shardingsphere\proxy\frontend\postgresql\authentication\PostgreSQLLoginResult.java,0,4,0,2,0,6
 shardingsphere-master\shardingsphere-master\shardingsphere-proxy\shardingsphere-proxy-backend\src\main\java\org\apache\shardingsphere\proxy\backend\exception\CircuitBreakException.java,0,1,0,1,0,2
 shardingsphere-master\shardingsphere-master\shardingsphere-features\shardingsphere-sharding\shardingsphere-sharding-distsql\shardingsphere-sharding-distsql-parser\src\main\java\org\apache\shardingsphere\sharding\distsql\parser\facade\ShardingDistSQLStatementParserFacade.java,0,6,0,6,0,12
 shardingsphere-master\shardingsphere-master\shardingsphere-infra\shardingsphere-infra-executor\src\test\java\org\apache\shardingsphere\infra\executor\kernel\fixture\ExecutorCallbackFixture.java,0,6,1,3,0,10
 shardingsphere-master\shardingsphere-master\shardingsphere-db-protocol\shardingsphere-db-protocol-mysql\src\test\java\org\apache\shardingsphere\db\protocol\mysql\packet\binlog\row\MySQLBinlogRowsEventPacketTest.java,0,43,0,20,0,63
 shardingsphere-master\shardingsphere-master\shardingsphere-features\shardingsphere-shadow\shardingsphere-shadow-core\src\test\java\org\apache\shardingsphere\shadow\yaml\swapper\ShadowRuleAlgorithmProviderConfigurationYamlSwapperTest.java,0,40,0,37,0,77
 shardingsphere-master\shardingsphere-master\shardingsphere-features\shardingsphere-sharding\shardingsphere-sharding-core\src\test\java\org\apache\shardingsphere\sharding\rewrite\parameter\ShardingGeneratedKeyInsertValueParameterRewriterTest.java,0,38,0,34,0,72
 shardingsphere-master\shardingsphere-master\shardingsphere-db-protocol\shardingsphere-db-protocol-opengauss\src\main\java\org\apache\shardingsphere\db\protocol\opengauss\codec\OpenGaussPacketCodecEngine.java,0,45,0,28,0,73
 shardingsphere-master\shardingsphere-master\shardingsphere-features\shardingsphere-encrypt\shardingsphere-encrypt-core\src\main\java\org\apache\shardingsphere\encrypt\rewrite\condition\impl\EncryptInCondition.java,0,24,0,9,0,33
 shardingsphere-master\shardingsphere-master\shardingsphere-proxy\shardingsphere-proxy-frontend\shardingsphere-proxy-frontend-postgresql\src\main\java\org\apache\shardingsphere\proxy\frontend\postgresql\command\PostgreSQLConnectionContextRegistry.java,0,10,0,4,0,14
 shardingsphere-master\shardingsphere-master\shardingsphere-infra\shardingsphere-infra-common\src\test\java\org\apache\shardingsphere\infra\metadata\schema\util\SystemSchemaUtilTest.java,0,8,0,6,0,14
 shardingsphere-master\shardingsphere-master\shardingsphere-test\shardingsphere-parser-test\src\main\java\org\apache\shardingsphere\test\sql\parser\parameterized\jaxb\cases\domain\statement\ddl\DropEventTriggerStatementTestCase.java,3,0,0,3,0,3
 shardingsphere-master\shardingsphere-master\shardingsphere-proxy\shardingsphere-proxy-backend\src\main\java\org\apache\shardingsphere\proxy\backend\text\distsql\rdl\rule\AlterDefaultSingleTableRuleStatementUpdater.java,0,24,0,21,0,45
 shardingsphere-master\shardingsphere-master\shardingsphere-features\shardingsphere-shadow\shardingsphere-shadow-core\src\main\java\org\apache\shardingsphere\shadow\route\engine\determiner\HintShadowAlgorithmDeterminer.java,0,9,0,7,0,16
 shardingsphere-master\shardingsphere-master\shardingsphere-test\shardingsphere-parser-test\src\main\java\org\apache\shardingsphere\test\sql\parser\parameterized\jaxb\cases\domain\segment\impl\limit\ExpectedLimitClause.java,0,5,0,3,0,8
 shardingsphere-master\shardingsphere-master\shardingsphere-features\shardingsphere-encrypt\shardingsphere-encrypt-core\src\main\java\org\apache\shardingsphere\encrypt\merge\dql\EncryptMergedResult.java,0,16,0,8,0,24
 shardingsphere-master\shardingsphere-master\shardingsphere-test\shardingsphere-parser-test\src\main\java\org\apache\shardingsphere\test\sql\parser\parameterized\asserts\statement\dal\impl\ExplainStatementAssert.java,0,23,0,28,0,51
 shardingsphere-master\shardingsphere-master\shardingsphere-features\shardingsphere-encrypt\shardingsphere-encrypt-core\src\main\java\org\apache\shardingsphere\encrypt\rewrite\token\pojo\EncryptLiteralAssignmentToken.java,0,18,0,5,0,23
 shardingsphere-master\shardingsphere-master\examples\example-core\example-spring-mybatis\src\main\java\org\apache\shardingsphere\example\core\mybatis\repository\MybatisUserRepository.java,0,0,0,1,0,1
 shardingsphere-master\shardingsphere-master\shardingsphere-db-protocol\shardingsphere-db-protocol-mysql\src\test\java\org\apache\shardingsphere\db\protocol\mysql\packet\command\admin\MySQLComSetOptionPacketTest.java,0,9,0,5,0,14
 shardingsphere-master\shardingsphere-master\shardingsphere-kernel\shardingsphere-traffic\shardingsphere-traffic-api\src\main\java\org\apache\shardingsphere\traffic\api\traffic\transaction\TransactionTrafficValue.java,0,2,0,1,0,3
 shardingsphere-master\shardingsphere-master\shardingsphere-features\shardingsphere-sharding\shardingsphere-sharding-core\src\main\java\org\apache\shardingsphere\sharding\merge\dal\common\MultipleLocalDataMergedResult.java,0,15,0,3,0,18
 shardingsphere-master\shardingsphere-master\shardingsphere-proxy\shardingsphere-proxy-backend\src\main\java\org\apache\shardingsphere\proxy\backend\communication\vertx\VertxDatabaseCommunicationEngine.java,0,17,0,18,0,35
 shardingsphere-master\shardingsphere-master\shardingsphere-proxy\shardingsphere-proxy-backend\src\main\java\org\apache\shardingsphere\proxy\backend\text\distsql\ral\common\hint\executor\ShowReadwriteSplittingHintStatusExecutor.java,0,8,0,10,0,18
 shardingsphere-master\shardingsphere-master\shardingsphere-sql-parser\shardingsphere-sql-parser-dialect\shardingsphere-sql-parser-opengauss\src\main\java\org\apache\shardingsphere\sql\parser\opengauss\parser\OpenGaussParser.java,0,5,0,3,0,8
 shardingsphere-master\shardingsphere-master\shardingsphere-test\shardingsphere-parser-test\src\main\java\org\apache\shardingsphere\test\sql\parser\parameterized\asserts\segment\where\WhereClauseAssert.java,0,6,0,9,0,15
 shardingsphere-master\shardingsphere-master\shardingsphere-proxy\shardingsphere-proxy-frontend\shardingsphere-proxy-frontend-postgresql\src\test\java\org\apache\shardingsphere\proxy\frontend\postgresql\command\query\extended\PostgreSQLAggregatedBatchedStatementsCommandExecutorTest.java,0,48,2,39,0,89
 shardingsphere-master\shardingsphere-master\examples\shardingsphere-proxy-example\shardingsphere-proxy-distsql-example\src\main\java\org\apache\shardingsphere\example\proxy\distsql\feature\resource\ResourceExecutor.java,0,38,2,8,0,48
 shardingsphere-master\shardingsphere-master\shardingsphere-kernel\shardingsphere-transaction\shardingsphere-transaction-core\src\test\java\org\apache\shardingsphere\transaction\core\ResourceDataSourceTest.java,0,4,0,2,0,6
 shardingsphere-master\shardingsphere-master\shardingsphere-proxy\shardingsphere-proxy-backend\src\test\java\org\apache\shardingsphere\proxy\backend\text\admin\opengauss\OpenGaussSelectDatabaseExecutorTest.java,0,10,0,7,0,17
 shardingsphere-master\shardingsphere-master\shardingsphere-mode\shardingsphere-mode-type\shardingsphere-cluster-mode\shardingsphere-cluster-mode-core\src\main\java\org\apache\shardingsphere\mode\manager\cluster\coordinator\registry\status\compute\subscriber\ComputeNodeStatusSubscriber.java,0,10,0,8,0,18
 shardingsphere-master\shardingsphere-master\shardingsphere-test\shardingsphere-integration-agent-test\shardingsphere-integration-agent-test-plugins\shardingsphere-integration-agent-test-jaeger\src\test\java\org\apache\shardingsphere\integration\agent\test\jaeger\JaegerPluginIT.java,0,3,0,1,0,4
 shardingsphere-master\shardingsphere-master\shardingsphere-mode\shardingsphere-mode-type\shardingsphere-cluster-mode\shardingsphere-cluster-mode-repository\shardingsphere-cluster-mode-repository-api\src\main\java\org\apache\shardingsphere\mode\repository\cluster\listener\DataChangedEventListener.java,0,2,0,1,0,3
 shardingsphere-master\shardingsphere-master\shardingsphere-jdbc\shardingsphere-jdbc-spring\shardingsphere-jdbc-spring-infra\shardingsphere-jdbc-spring-namespace-infra\src\test\java\org\apache\shardingsphere\spring\namespace\ShardingSphereAlgorithmSpringNamespaceTest.java,0,14,0,8,0,22
 shardingsphere-master\shardingsphere-master\shardingsphere-features\shardingsphere-sharding\shardingsphere-sharding-core\src\test\java\org\apache\shardingsphere\sharding\route\engine\fixture\AbstractRoutingEngineTest.java,0,99,0,87,0,186
 shardingsphere-master\shardingsphere-master\shardingsphere-sql-parser\shardingsphere-sql-parser-statement\src\main\java\org\apache\shardingsphere\sql\parser\sql\dialect\statement\postgresql\ddl\PostgreSQLDropLanguageStatement.java,0,1,0,5,0,6
 shardingsphere-master\shardingsphere-master\examples\shardingsphere-jdbc-example\single-feature-example\shadow-example\shadow-spring-boot-jpa-example\src\main\java\org\apache\shardingsphere\example\shadow\spring\boot\jpa\ShadowSpringBootJpaExample.java,9,6,1,4,0,11
 shardingsphere-master\shardingsphere-master\shardingsphere-kernel\shardingsphere-transaction\shardingsphere-transaction-core\src\main\java\org\apache\shardingsphere\transaction\rule\builder\DefaultTransactionRuleConfigurationBuilder.java,0,6,0,5,0,11
 shardingsphere-master\shardingsphere-master\shardingsphere-features\shardingsphere-shadow\shardingsphere-shadow-core\src\test\java\org\apache\shardingsphere\shadow\algorithm\shadow\column\AbstractColumnShadowAlgorithmTest.java,46,39,3,28,0,70
 shardingsphere-master\shardingsphere-master\shardingsphere-db-protocol\shardingsphere-db-protocol-postgresql\src\test\java\org\apache\shardingsphere\db\protocol\postgresql\packet\generic\PostgreSQLComTerminationPacketTest.java,0,8,0,6,0,14
 shardingsphere-master\shardingsphere-master\shardingsphere-infra\shardingsphere-infra-binder\src\main\java\org\apache\shardingsphere\infra\binder\segment\select\pagination\engine\TopPaginationContextEngine.java,0,25,1,31,0,57
 shardingsphere-master\shardingsphere-master\shardingsphere-features\shardingsphere-sharding\shardingsphere-sharding-core\src\main\java\org\apache\shardingsphere\sharding\merge\dql\groupby\GroupByRowComparator.java,0,15,0,13,0,28
 shardingsphere-master\shardingsphere-master\examples\example-core\example-raw-jdbc\src\main\java\org\apache\shardingsphere\example\core\jdbc\service\UserServiceImpl.java,0,21,0,8,0,29
 shardingsphere-master\shardingsphere-master\shardingsphere-infra\shardingsphere-infra-common\src\main\java\org\apache\shardingsphere\infra\yaml\config\pojo\mode\YamlModeConfiguration.java,0,7,0,1,0,8
 shardingsphere-master\shardingsphere-master\shardingsphere-test\shardingsphere-parser-test\src\main\java\org\apache\shardingsphere\test\sql\parser\parameterized\jaxb\cases\domain\segment\impl\projection\impl\top\ExpectedTopValue.java,0,4,0,3,0,7
 shardingsphere-master\shardingsphere-master\shardingsphere-sql-parser\shardingsphere-sql-parser-statement\src\main\java\org\apache\shardingsphere\sql\parser\sql\dialect\statement\opengauss\ddl\OpenGaussAlterDomainStatement.java,0,1,0,5,0,6
 shardingsphere-master\shardingsphere-master\shardingsphere-infra\shardingsphere-infra-federation\shardingsphere-infra-federation-optimizer\src\main\java\org\apache\shardingsphere\infra\federation\optimizer\converter\segment\expression\impl\LiteralExpressionConverter.java,0,8,0,10,0,18
 shardingsphere-master\shardingsphere-master\shardingsphere-sql-parser\shardingsphere-sql-parser-statement\src\main\java\org\apache\shardingsphere\sql\parser\sql\dialect\statement\sql92\dcl\SQL92RevokeStatement.java,0,1,0,4,0,5
 shardingsphere-master\shardingsphere-master\shardingsphere-sql-parser\shardingsphere-sql-parser-statement\src\main\java\org\apache\shardingsphere\sql\parser\sql\dialect\statement\mysql\ddl\MySQLAlterFunctionStatement.java,0,1,0,4,0,5
 shardingsphere-master\shardingsphere-master\shardingsphere-proxy\shardingsphere-proxy-backend\src\main\java\org\apache\shardingsphere\proxy\backend\text\distsql\ral\advanced\ParseDistSQLBackendHandler.java,0,23,1,14,0,38
 shardingsphere-master\shardingsphere-master\shardingsphere-distsql\shardingsphere-distsql-statement\src\main\java\org\apache\shardingsphere\distsql\parser\statement\ral\UpdatableRALStatement.java,3,0,1,1,0,2
 shardingsphere-master\shardingsphere-master\shardingsphere-spi\src\test\java\org\apache\shardingsphere\spi\optional\OptionalSPIRegistryTest.java,0,5,0,2,0,7
 shardingsphere-master\shardingsphere-master\shardingsphere-kernel\shardingsphere-data-pipeline\shardingsphere-data-pipeline-spi\src\main\java\org\apache\shardingsphere\data\pipeline\api\ingest\record\FinishedRecord.java,0,2,0,2,0,4
 shardingsphere-master\shardingsphere-master\shardingsphere-kernel\shardingsphere-transaction\shardingsphere-transaction-type\shardingsphere-transaction-xa\shardingsphere-transaction-xa-provider\shardingsphere-transaction-xa-narayana\src\main\java\org\apache\shardingsphere\transaction\xa\narayana\config\NarayanaConfigurationFileGenerator.java,0,76,0,73,0,149
 shardingsphere-master\shardingsphere-master\shardingsphere-features\shardingsphere-sharding\shardingsphere-sharding-spring\shardingsphere-sharding-spring-namespace\src\test\java\org\apache\shardingsphere\sharding\spring\namespace\fixture\keygen\IncrementKeyGenerateAlgorithm.java,0,7,1,2,0,10
 shardingsphere-master\shardingsphere-master\shardingsphere-agent\shardingsphere-agent-plugins\shardingsphere-agent-plugin-logging\shardingsphere-agent-logging-base\src\main\java\org\apache\shardingsphere\agent\plugin\logging\base\service\BaseLoggingPluginBootService.java,0,4,2,1,0,7
 shardingsphere-master\shardingsphere-master\examples\example-core\example-spring-jpa\src\main\java\org\apache\shardingsphere\example\core\jpa\service\OrderServiceImpl.java,85,25,1,10,0,36
 shardingsphere-master\shardingsphere-master\shardingsphere-mode\shardingsphere-mode-type\shardingsphere-cluster-mode\shardingsphere-cluster-mode-core\src\main\java\org\apache\shardingsphere\mode\manager\cluster\ClusterContextManagerBuilder.java,0,73,0,74,0,147
 shardingsphere-master\shardingsphere-master\shardingsphere-sql-parser\shardingsphere-sql-parser-statement\src\main\java\org\apache\shardingsphere\sql\parser\sql\dialect\statement\sqlserver\dcl\SQLServerDropLoginStatement.java,0,1,0,6,0,7
 shardingsphere-master\shardingsphere-master\shardingsphere-features\shardingsphere-sharding\shardingsphere-sharding-distsql\shardingsphere-sharding-distsql-handler\src\test\java\org\apache\shardingsphere\scaling\distsql\handler\ShowScalingCheckAlgorithmsQueryResultSetTest.java,0,12,0,5,0,17
 shardingsphere-master\shardingsphere-master\shardingsphere-infra\shardingsphere-infra-binder\src\main\java\org\apache\shardingsphere\infra\binder\segment\insert\keygen\GeneratedKeyContext.java,0,8,0,2,0,10
 shardingsphere-master\shardingsphere-master\shardingsphere-db-protocol\shardingsphere-db-protocol-mysql\src\main\java\org\apache\shardingsphere\db\protocol\mysql\packet\command\query\binary\execute\protocol\MySQLBinaryProtocolValueFactory.java,0,53,0,40,0,93
 shardingsphere-master\shardingsphere-master\shardingsphere-sql-parser\shardingsphere-sql-parser-statement\src\main\java\org\apache\shardingsphere\sql\parser\sql\common\constant\OperationScope.java,0,3,0,1,0,4
 shardingsphere-master\shardingsphere-master\shardingsphere-sql-parser\shardingsphere-sql-parser-statement\src\main\java\org\apache\shardingsphere\sql\parser\sql\common\statement\ddl\DeclareStatement.java,3,1,1,3,0,5
 shardingsphere-master\shardingsphere-master\shardingsphere-sql-parser\shardingsphere-sql-parser-statement\src\main\java\org\apache\shardingsphere\sql\parser\sql\dialect\handler\ddl\DropTableStatementHandler.java,0,7,0,16,4,27
 shardingsphere-master\shardingsphere-master\shardingsphere-infra\shardingsphere-infra-merge\src\main\java\org\apache\shardingsphere\infra\merge\engine\merger\ResultMergerEngine.java,0,3,0,3,0,6
 shardingsphere-master\shardingsphere-master\shardingsphere-spi\src\main\java\org\apache\shardingsphere\spi\exception\ServiceProviderNotFoundException.java,0,9,0,5,0,14
 shardingsphere-master\shardingsphere-master\shardingsphere-features\shardingsphere-db-discovery\shardingsphere-db-discovery-provider\shardingsphere-db-discovery-mysql\src\test\java\org\apache\shardingsphere\dbdiscovery\mysql\type\MGRDatabaseDiscoveryTypeTest.java,0,70,8,39,0,117
 shardingsphere-master\shardingsphere-master\shardingsphere-db-protocol\shardingsphere-db-protocol-mysql\src\main\java\org\apache\shardingsphere\db\protocol\mysql\packet\binlog\row\column\value\time\MySQLTimeValueUtil.java,0,13,0,3,0,16
 shardingsphere-master\shardingsphere-master\shardingsphere-sql-parser\shardingsphere-sql-parser-statement\src\main\java\org\apache\shardingsphere\sql\parser\sql\common\statement\AbstractSQLStatement.java,10,9,1,5,2,17
 shardingsphere-master\shardingsphere-master\shardingsphere-infra\shardingsphere-infra-merge\src\test\java\org\apache\shardingsphere\infra\merge\engine\merger\impl\TransparentResultMergerTest.java,0,4,0,3,0,7
 shardingsphere-master\shardingsphere-master\shardingsphere-kernel\shardingsphere-data-pipeline\shardingsphere-data-pipeline-spi\src\main\java\org\apache\shardingsphere\data\pipeline\api\task\progress\IncrementalTaskDelay.java,0,5,0,1,0,6
 shardingsphere-master\shardingsphere-master\shardingsphere-infra\shardingsphere-infra-common\src\main\java\org\apache\shardingsphere\infra\datasource\config\DataSourceConfiguration.java,0,4,0,1,0,5
 shardingsphere-master\shardingsphere-master\shardingsphere-infra\shardingsphere-infra-common\src\main\java\org\apache\shardingsphere\infra\hint\SQLHintExtractor.java,0,13,0,7,0,20
 shardingsphere-master\shardingsphere-master\shardingsphere-kernel\shardingsphere-data-pipeline\shardingsphere-data-pipeline-spi\src\main\java\org\apache\shardingsphere\data\pipeline\api\pojo\DataConsistencyCheckAlgorithmInfo.java,0,9,0,1,0,10
 shardingsphere-master\shardingsphere-master\shardingsphere-proxy\shardingsphere-proxy-frontend\shardingsphere-proxy-frontend-core\src\main\java\org\apache\shardingsphere\proxy\frontend\netty\ServerHandlerInitializer.java,0,8,0,8,0,16
 shardingsphere-master\shardingsphere-master\shardingsphere-mode\shardingsphere-mode-type\shardingsphere-cluster-mode\shardingsphere-cluster-mode-core\src\main\java\org\apache\shardingsphere\mode\manager\cluster\coordinator\registry\metadata\subscriber\SchemaMetaDataRegistrySubscriber.java,0,9,0,7,0,16
 shardingsphere-master\shardingsphere-master\shardingsphere-sql-parser\shardingsphere-sql-parser-statement\src\main\java\org\apache\shardingsphere\sql\parser\sql\dialect\statement\postgresql\ddl\PostgreSQLCreateTypeStatement.java,0,1,0,5,0,6
 shardingsphere-master\shardingsphere-master\shardingsphere-proxy\shardingsphere-proxy-backend\src\main\java\org\apache\shardingsphere\proxy\backend\text\admin\DatabaseAdminUpdateBackendHandler.java,0,8,0,4,0,12
 shardingsphere-master\shardingsphere-master\shardingsphere-test\shardingsphere-pipeline-test\src\test\java\org\apache\shardingsphere\data\pipeline\core\prepare\datasource\AbstractDataSourcePreparerTest.java,0,23,1,13,0,37
 shardingsphere-master\shardingsphere-master\shardingsphere-db-protocol\shardingsphere-db-protocol-mysql\src\test\java\org\apache\shardingsphere\db\protocol\mysql\packet\binlog\row\column\value\time\MySQLDatetimeBinlogProtocolValueTest.java,0,11,0,5,0,16
 shardingsphere-master\shardingsphere-master\shardingsphere-proxy\shardingsphere-proxy-frontend\shardingsphere-proxy-frontend-reactive-mysql\src\main\java\org\apache\shardingsphere\proxy\frontend\reactive\mysql\command\ReactiveMySQLFrontendEngine.java,0,14,1,7,0,22
 shardingsphere-master\shardingsphere-master\shardingsphere-jdbc\shardingsphere-jdbc-core\src\test\java\org\apache\shardingsphere\driver\jdbc\core\statement\ReadwriteSplittingStatementTest.java,0,13,3,9,0,25
 shardingsphere-master\shardingsphere-master\shardingsphere-infra\shardingsphere-infra-binder\src\test\java\org\apache\shardingsphere\infra\binder\statement\ddl\AlterTableStatementContextTest.java,0,40,0,56,0,96
 shardingsphere-master\shardingsphere-master\shardingsphere-infra\shardingsphere-infra-common\src\main\java\org\apache\shardingsphere\infra\yaml\config\pojo\YamlConfiguration.java,0,1,0,1,0,2
 shardingsphere-master\shardingsphere-master\examples\example-core\example-spring-jpa\src\main\java\org\apache\shardingsphere\example\core\jpa\entity\ShadowUserEntity.java,0,5,0,1,0,6
 shardingsphere-master\shardingsphere-master\shardingsphere-features\shardingsphere-sharding\shardingsphere-sharding-spring\shardingsphere-sharding-spring-namespace\src\main\java\org\apache\shardingsphere\sharding\spring\namespace\parser\strategy\KeyGenerateStrategyBeanDefinitionParser.java,0,7,0,8,0,15
 shardingsphere-master\shardingsphere-master\shardingsphere-distsql\shardingsphere-distsql-statement\src\main\java\org\apache\shardingsphere\distsql\parser\statement\rql\show\CountSchemaRulesStatement.java,0,3,0,2,0,5
 shardingsphere-master\shardingsphere-master\shardingsphere-jdbc\shardingsphere-jdbc-spring\shardingsphere-jdbc-core-spring\shardingsphere-jdbc-core-spring-boot-starter\src\main\java\org\apache\shardingsphere\spring\boot\ShardingSphereAutoConfiguration.java,65,20,0,13,0,33
 shardingsphere-master\shardingsphere-master\shardingsphere-agent\shardingsphere-agent-plugins\shardingsphere-agent-plugin-tracing\shardingsphere-agent-tracing-jaeger\src\test\java\org\apache\shardingsphere\agent\plugin\tracing\jaeger\advice\JDBCExecutorCallbackAdviceTest.java,0,18,0,13,0,31
 shardingsphere-master\shardingsphere-master\shardingsphere-infra\shardingsphere-infra-executor\src\main\java\org\apache\shardingsphere\infra\executor\sql\execute\engine\raw\callback\RawExecutorCallback.java,0,3,0,3,0,6
 shardingsphere-master\shardingsphere-master\shardingsphere-infra\shardingsphere-infra-common\src\test\java\org\apache\shardingsphere\infra\instance\util\IpUtilsTest.java,0,3,0,1,0,4
 shardingsphere-master\shardingsphere-master\examples\example-core\example-api\src\main\java\org\apache\shardingsphere\example\core\api\repository\OrderItemRepository.java,0,0,0,1,0,1
 shardingsphere-master\shardingsphere-master\shardingsphere-features\shardingsphere-shadow\shardingsphere-shadow-core\src\main\java\org\apache\shardingsphere\shadow\route\engine\dml\ShadowUpdateStatementRoutingEngine.java,0,27,0,16,0,43
 shardingsphere-master\shardingsphere-master\shardingsphere-infra\shardingsphere-infra-common\src\main\java\org\apache\shardingsphere\infra\rule\identifier\type\RawExecutionRule.java,0,0,0,1,0,1
 shardingsphere-master\shardingsphere-master\shardingsphere-sql-parser\shardingsphere-sql-parser-dialect\shardingsphere-sql-parser-opengauss\src\main\java\org\apache\shardingsphere\sql\parser\opengauss\visitor\format\facade\OpenGaussFormatSQLVisitorFacade.java,0,9,0,1,0,10
 shardingsphere-master\shardingsphere-master\shardingsphere-db-protocol\shardingsphere-db-protocol-mysql\src\main\java\org\apache\shardingsphere\db\protocol\mysql\constant\MySQLServerInfo.java,0,18,1,6,0,25
 shardingsphere-master\shardingsphere-master\shardingsphere-infra\shardingsphere-infra-merge\src\test\java\org\apache\shardingsphere\infra\merge\engine\decorator\impl\TransparentRuleTest.java,0,3,0,2,0,5
 shardingsphere-master\shardingsphere-master\shardingsphere-features\shardingsphere-sharding\shardingsphere-sharding-core\src\test\java\org\apache\shardingsphere\sharding\rule\builder\AlgorithmProvidedShardingRuleBuilderTest.java,0,19,0,6,0,25
 shardingsphere-master\shardingsphere-master\shardingsphere-db-protocol\shardingsphere-db-protocol-postgresql\src\main\java\org\apache\shardingsphere\db\protocol\postgresql\packet\command\query\extended\bind\protocol\PostgreSQLBinaryProtocolValue.java,0,3,0,3,0,6
 shardingsphere-master\shardingsphere-master\shardingsphere-test\shardingsphere-parser-test\src\main\java\org\apache\shardingsphere\test\sql\parser\parameterized\jaxb\cases\domain\statement\ddl\AlterSequenceStatementTestCase.java,0,0,0,3,0,3
 shardingsphere-master\shardingsphere-master\shardingsphere-proxy\shardingsphere-proxy-frontend\shardingsphere-proxy-frontend-core\src\test\java\org\apache\shardingsphere\proxy\frontend\executor\ConnectionThreadExecutorGroupTest.java,0,9,0,5,0,14
 shardingsphere-master\shardingsphere-master\shardingsphere-kernel\shardingsphere-transaction\shardingsphere-transaction-type\shardingsphere-transaction-xa\shardingsphere-transaction-xa-core\src\main\java\org\apache\shardingsphere\transaction\xa\jta\connection\XAConnectionWrapperFactory.java,0,5,0,3,0,8
 shardingsphere-master\shardingsphere-master\shardingsphere-proxy\shardingsphere-proxy-backend\src\main\java\org\apache\shardingsphere\proxy\backend\communication\vertx\VertxBackendDataSource.java,0,31,2,21,0,54
 shardingsphere-master\shardingsphere-master\shardingsphere-kernel\shardingsphere-data-pipeline\shardingsphere-data-pipeline-dialect\shardingsphere-data-pipeline-mysql\src\test\java\org\apache\shardingsphere\data\pipeline\mysql\ingest\client\PasswordEncryptionTest.java,0,73,0,11,0,84
 shardingsphere-master\shardingsphere-master\shardingsphere-features\shardingsphere-sharding\shardingsphere-sharding-core\src\main\java\org\apache\shardingsphere\sharding\rewrite\token\pojo\ParameterMarkerGeneratedKeyAssignmentToken.java,0,5,0,3,0,8
 shardingsphere-master\shardingsphere-master\shardingsphere-test\shardingsphere-pipeline-test\src\test\java\org\apache\shardingsphere\data\pipeline\core\fixture\FixtureInventoryDumper.java,0,6,0,8,0,14
 shardingsphere-master\shardingsphere-master\shardingsphere-infra\shardingsphere-infra-binder\src\main\java\org\apache\shardingsphere\infra\binder\statement\dml\InsertStatementContext.java,0,94,2,62,0,158
 shardingsphere-master\shardingsphere-master\shardingsphere-features\shardingsphere-sharding\shardingsphere-sharding-core\src\main\java\org\apache\shardingsphere\sharding\rewrite\parameter\ShardingParameterRewriterBuilder.java,0,17,0,13,0,30
 shardingsphere-master\shardingsphere-master\shardingsphere-kernel\shardingsphere-data-pipeline\shardingsphere-data-pipeline-dialect\shardingsphere-data-pipeline-postgresql\src\main\java\org\apache\shardingsphere\data\pipeline\postgresql\ingest\wal\WalEventConverter.java,0,34,0,28,0,62
 shardingsphere-master\shardingsphere-master\shardingsphere-db-protocol\shardingsphere-db-protocol-mysql\src\main\java\org\apache\shardingsphere\db\protocol\mysql\packet\binlog\row\column\value\integer\MySQLTinyBinlogProtocolValue.java,0,3,0,6,0,9
 shardingsphere-master\shardingsphere-master\shardingsphere-infra\shardingsphere-infra-executor\src\main\java\org\apache\shardingsphere\infra\executor\sql\execute\engine\driver\jdbc\JDBCExecutionUnit.java,0,7,0,3,0,10
 shardingsphere-master\shardingsphere-master\shardingsphere-agent\shardingsphere-agent-core\src\main\java\org\apache\shardingsphere\agent\core\plugin\interceptor\compose\ComposeInstanceMethodAroundInterceptor.java,0,5,0,6,0,11
 shardingsphere-master\shardingsphere-master\shardingsphere-infra\shardingsphere-infra-executor\src\test\java\org\apache\shardingsphere\infra\executor\sql\execute\engine\driver\vertx\VertxExecutorCallbackTest.java,0,23,0,11,0,34
 shardingsphere-master\shardingsphere-master\shardingsphere-proxy\shardingsphere-proxy-frontend\shardingsphere-proxy-frontend-postgresql\src\main\java\org\apache\shardingsphere\proxy\frontend\postgresql\command\generic\PostgreSQLComTerminationExecutor.java,0,2,0,2,0,4
 shardingsphere-master\shardingsphere-master\shardingsphere-test\shardingsphere-parser-test\src\main\java\org\apache\shardingsphere\test\sql\parser\parameterized\jaxb\cases\domain\segment\impl\distsql\ExpectedTableRule.java,0,11,0,5,0,16
 shardingsphere-master\shardingsphere-master\shardingsphere-sql-parser\shardingsphere-sql-parser-statement\src\main\java\org\apache\shardingsphere\sql\parser\sql\dialect\statement\mysql\rl\MySQLChangeMasterStatement.java,0,2,0,4,0,6
 shardingsphere-master\shardingsphere-master\shardingsphere-sql-parser\shardingsphere-sql-parser-statement\src\main\java\org\apache\shardingsphere\sql\parser\sql\dialect\statement\sqlserver\ddl\SQLServerDropViewStatement.java,0,1,0,5,0,6
 shardingsphere-master\shardingsphere-master\examples\shardingsphere-jdbc-example\single-feature-example\extension-example\custom-sharding-algortihm-example\class-based-sharding-algorithm-example\class-based-sharding-raw-jdbc-example\src\main\java\org\apache\shardingsphere\example\extension\classbased\sharding\raw\jdbc\factory\YamlDataSourceFactory.java,0,8,1,6,0,15
 shardingsphere-master\shardingsphere-master\shardingsphere-kernel\shardingsphere-transaction\shardingsphere-transaction-type\shardingsphere-transaction-xa\shardingsphere-transaction-xa-core\src\test\java\org\apache\shardingsphere\transaction\xa\jta\datasource\properties\dialect\OpenGaussXADataSourceDefinitionTest.java,0,3,0,3,0,6
 shardingsphere-master\shardingsphere-master\shardingsphere-features\shardingsphere-encrypt\shardingsphere-encrypt-api\src\main\java\org\apache\shardingsphere\encrypt\api\config\rule\EncryptTableRuleConfiguration.java,0,6,0,1,0,7
 shardingsphere-master\shardingsphere-master\shardingsphere-test\shardingsphere-parser-test\src\main\java\org\apache\shardingsphere\test\sql\parser\parameterized\asserts\statement\dcl\impl\RevokeStatementAssert.java,0,6,0,12,0,18
 shardingsphere-master\shardingsphere-master\shardingsphere-features\shardingsphere-sharding\shardingsphere-sharding-core\src\main\java\org\apache\shardingsphere\sharding\algorithm\config\AlgorithmProvidedShardingRuleConfiguration.java,0,25,0,11,0,36
 shardingsphere-master\shardingsphere-master\shardingsphere-db-protocol\shardingsphere-db-protocol-postgresql\src\main\java\org\apache\shardingsphere\db\protocol\postgresql\constant\PostgreSQLValueFormat.java,0,8,0,2,0,10
 shardingsphere-master\shardingsphere-master\examples\shardingsphere-jdbc-example\single-feature-example\extension-example\custom-sharding-algortihm-example\spi-based-sharding-algorithm-example\spi-based-sharding-raw-jdbc-example\src\main\java\org\apache\shardingsphere\example\extension\spibased\sharding\raw\jdbc\factory\YamlDataSourceFactory.java,0,8,1,6,0,15
 shardingsphere-master\shardingsphere-master\shardingsphere-features\shardingsphere-sharding\shardingsphere-sharding-distsql\shardingsphere-sharding-distsql-handler\src\test\java\org\apache\shardingsphere\sharding\distsql\fixture\ModShardingAlgorithmFixture.java,0,9,2,8,0,19
 shardingsphere-master\shardingsphere-master\shardingsphere-test\shardingsphere-integration-test\shardingsphere-integration-test-suite\src\test\java\org\apache\shardingsphere\test\integration\framework\container\compose\ComposedContainer.java,0,5,0,1,0,6
 shardingsphere-master\shardingsphere-master\shardingsphere-jdbc\shardingsphere-jdbc-core\src\main\java\org\apache\shardingsphere\driver\jdbc\core\statement\ShardingSphereStatement.java,0,206,6,151,0,363
 shardingsphere-master\shardingsphere-master\shardingsphere-sql-parser\shardingsphere-sql-parser-dialect\shardingsphere-sql-parser-mysql\src\test\java\org\apache\shardingsphere\sql\parser\mysql\MySQLParserParameterizedTest.java,0,6,0,5,0,11
 shardingsphere-master\shardingsphere-master\shardingsphere-features\shardingsphere-sharding\shardingsphere-sharding-core\src\main\java\org\apache\shardingsphere\sharding\algorithm\sharding\hint\HintInlineShardingAlgorithm.java,0,24,0,10,0,34
 shardingsphere-master\shardingsphere-master\shardingsphere-features\shardingsphere-sharding\shardingsphere-sharding-core\src\main\java\org\apache\shardingsphere\sharding\route\engine\condition\generator\ConditionValue.java,0,17,0,11,0,28
 shardingsphere-master\shardingsphere-master\shardingsphere-kernel\shardingsphere-authority\shardingsphere-authority-core\src\main\java\org\apache\shardingsphere\authority\provider\natived\builder\dialect\SQLServerPrivilegeHandler.java,0,100,0,66,0,166
 shardingsphere-master\shardingsphere-master\shardingsphere-infra\shardingsphere-infra-merge\src\test\java\org\apache\shardingsphere\infra\merge\result\impl\stream\fixture\TestStreamMergedResult.java,0,2,0,2,0,4
 shardingsphere-master\shardingsphere-master\shardingsphere-infra\shardingsphere-infra-common\src\test\java\org\apache\shardingsphere\infra\properties\TypedPropertiesTest.java,0,28,0,16,0,44
 shardingsphere-master\shardingsphere-master\shardingsphere-features\shardingsphere-sharding\shardingsphere-sharding-core\src\test\java\org\apache\shardingsphere\sharding\merge\dal\common\MultipleLocalDataMergedResultTest.java,0,17,0,7,0,24
 shardingsphere-master\shardingsphere-master\shardingsphere-test\shardingsphere-parser-test\src\main\java\org\apache\shardingsphere\test\sql\parser\parameterized\asserts\segment\insert\InsertMultiTableElementAssert.java,0,6,0,12,0,18
 shardingsphere-master\shardingsphere-master\shardingsphere-jdbc\shardingsphere-jdbc-spring\shardingsphere-jdbc-core-spring\shardingsphere-jdbc-core-spring-namespace\src\main\java\org\apache\shardingsphere\spring\namespace\parser\TransactionTypeScannerBeanDefinitionParser.java,0,5,0,4,0,9
 shardingsphere-master\shardingsphere-master\shardingsphere-db-protocol\shardingsphere-db-protocol-mysql\src\main\java\org\apache\shardingsphere\db\protocol\mysql\packet\handshake\MySQLHandshakeResponse41Packet.java,0,42,0,13,0,55
 shardingsphere-master\shardingsphere-master\shardingsphere-sql-parser\shardingsphere-sql-parser-statement\src\main\java\org\apache\shardingsphere\sql\parser\sql\dialect\statement\oracle\ddl\OracleAlterSynonymStatement.java,0,1,0,5,0,6
 shardingsphere-master\shardingsphere-master\shardingsphere-db-protocol\shardingsphere-db-protocol-mysql\src\test\java\org\apache\shardingsphere\db\protocol\mysql\packet\handshake\MySQLRandomGeneratorTest.java,0,8,0,3,0,11
 shardingsphere-master\shardingsphere-master\shardingsphere-test\shardingsphere-parser-test\src\main\java\org\apache\shardingsphere\test\sql\parser\parameterized\asserts\statement\distsql\rql\impl\rule\ShowShardingTableRulesUsedAlgorithmStatementAssert.java,0,12,0,16,0,28
 shardingsphere-master\shardingsphere-master\shardingsphere-db-protocol\shardingsphere-db-protocol-postgresql\src\main\java\org\apache\shardingsphere\db\protocol\postgresql\packet\command\query\extended\bind\protocol\PostgreSQLInt2BinaryProtocolValue.java,0,6,0,6,0,12
 shardingsphere-master\shardingsphere-master\shardingsphere-proxy\shardingsphere-proxy-backend\src\main\java\org\apache\shardingsphere\proxy\backend\communication\jdbc\transaction\JDBCBackendTransactionManager.java,0,45,3,31,0,79
 shardingsphere-master\shardingsphere-master\shardingsphere-test\shardingsphere-parser-test\src\main\java\org\apache\shardingsphere\test\sql\parser\parameterized\jaxb\cases\domain\statement\distsql\ral\AlterSQLParserRuleStatementTestCase.java,0,4,0,6,0,10
 shardingsphere-master\shardingsphere-master\shardingsphere-sql-parser\shardingsphere-sql-parser-dialect\shardingsphere-sql-parser-mysql\src\main\java\org\apache\shardingsphere\sql\parser\mysql\visitor\statement\impl\MySQLDALStatementSQLVisitor.java,0,199,1,308,0,508
 shardingsphere-master\shardingsphere-master\examples\shardingsphere-example-generator\src\main\java\org\apache\shardingsphere\example\generator\scenario\framework\type\SpringNamespaceJpaExampleScenario.java,0,11,0,7,0,18
 shardingsphere-master\shardingsphere-master\shardingsphere-infra\shardingsphere-infra-common\src\test\java\org\apache\shardingsphere\infra\rule\builder\global\GlobalRulesBuilderTest.java,0,5,0,2,0,7
 shardingsphere-master\shardingsphere-master\shardingsphere-features\shardingsphere-encrypt\shardingsphere-encrypt-core\src\test\java\org\apache\shardingsphere\encrypt\rule\EncryptTableTest.java,0,50,0,16,0,66
 shardingsphere-master\shardingsphere-master\shardingsphere-proxy\shardingsphere-proxy-backend\src\test\java\org\apache\shardingsphere\proxy\backend\text\admin\mysql\MySQLAdminExecutorFactoryTest.java,0,22,0,22,0,44
 shardingsphere-master\shardingsphere-master\shardingsphere-test\shardingsphere-parser-test\src\main\java\org\apache\shardingsphere\test\sql\parser\parameterized\asserts\statement\tcl\impl\SetConstraintsStatementAssert.java,0,4,1,6,0,11
 shardingsphere-master\shardingsphere-master\shardingsphere-agent\shardingsphere-agent-api\src\main\java\org\apache\shardingsphere\agent\api\advice\ClassStaticMethodAroundAdvice.java,0,12,3,9,0,24
 shardingsphere-master\shardingsphere-master\shardingsphere-db-protocol\shardingsphere-db-protocol-mysql\src\test\java\org\apache\shardingsphere\db\protocol\mysql\packet\command\admin\MySQLUnsupportedCommandPacketTest.java,0,5,0,3,0,8
 shardingsphere-master\shardingsphere-master\shardingsphere-jdbc\shardingsphere-jdbc-core\src\main\java\org\apache\shardingsphere\driver\api\yaml\YamlShardingSphereDataSourceFactory.java,0,36,0,26,0,62
 shardingsphere-master\shardingsphere-master\shardingsphere-sql-parser\shardingsphere-sql-parser-dialect\shardingsphere-sql-parser-oracle\src\main\java\org\apache\shardingsphere\sql\parser\oracle\visitor\statement\facade\OracleStatementSQLVisitorFacade.java,0,9,0,6,0,15
 shardingsphere-master\shardingsphere-master\shardingsphere-sql-parser\shardingsphere-sql-parser-statement\src\main\java\org\apache\shardingsphere\sql\parser\sql\common\value\literal\impl\NumberLiteralValue.java,0,10,0,4,0,14
 shardingsphere-master\shardingsphere-master\shardingsphere-features\shardingsphere-encrypt\shardingsphere-encrypt-core\src\main\java\org\apache\shardingsphere\encrypt\rule\builder\EncryptRuleBuilder.java,0,6,0,4,0,10
 shardingsphere-master\shardingsphere-master\shardingsphere-proxy\shardingsphere-proxy-frontend\shardingsphere-proxy-frontend-mysql\src\main\java\org\apache\shardingsphere\proxy\frontend\mysql\command\query\binary\reset\MySQLComStmtResetExecutor.java,0,5,0,5,0,10
 shardingsphere-master\shardingsphere-master\shardingsphere-proxy\shardingsphere-proxy-backend\src\test\java\org\apache\shardingsphere\proxy\backend\text\distsql\rdl\rule\DropDefaultSingleTableRuleUpdaterTest.java,0,25,0,15,0,40
 shardingsphere-master\shardingsphere-master\shardingsphere-infra\shardingsphere-infra-binder\src\main\java\org\apache\shardingsphere\infra\binder\statement\dal\ShowTableStatusStatementContext.java,0,5,0,5,0,10
 shardingsphere-master\shardingsphere-master\shardingsphere-agent\shardingsphere-agent-core\src\test\java\org\apache\shardingsphere\agent\core\mock\advice\MockInstanceMethodAroundAdvice.java,0,11,0,5,0,16
 shardingsphere-master\shardingsphere-master\shardingsphere-test\shardingsphere-integration-test\shardingsphere-integration-test-suite\src\test\java\org\apache\shardingsphere\test\integration\engine\ddl\BaseDDLIT.java,147,53,1,39,0,93
 shardingsphere-master\shardingsphere-master\shardingsphere-test\shardingsphere-parser-test\src\main\java\org\apache\shardingsphere\test\sql\parser\parameterized\jaxb\cases\domain\statement\dal\ShowStatusStatementTestCase.java,0,2,0,4,0,6
 shardingsphere-master\shardingsphere-master\shardingsphere-features\shardingsphere-sharding\shardingsphere-sharding-core\src\main\java\org\apache\shardingsphere\sharding\rewrite\parameter\impl\ShardingPaginationParameterRewriter.java,0,18,0,18,0,36
 shardingsphere-master\shardingsphere-master\shardingsphere-features\shardingsphere-sharding\shardingsphere-sharding-distsql\shardingsphere-sharding-distsql-handler\src\main\java\org\apache\shardingsphere\sharding\distsql\handler\update\DropDefaultStrategyStatementUpdater.java,0,26,1,23,0,50
 shardingsphere-master\shardingsphere-master\shardingsphere-features\shardingsphere-sharding\shardingsphere-sharding-distsql\shardingsphere-sharding-distsql-statement\src\main\java\org\apache\shardingsphere\scaling\distsql\statement\ApplyScalingStatement.java,0,3,0,2,0,5
 shardingsphere-master\shardingsphere-master\shardingsphere-infra\shardingsphere-infra-binder\src\main\java\org\apache\shardingsphere\infra\binder\statement\dal\ShowColumnsStatementContext.java,0,10,0,8,0,18
 shardingsphere-master\shardingsphere-master\shardingsphere-features\shardingsphere-sharding\shardingsphere-sharding-core\src\test\java\org\apache\shardingsphere\sharding\merge\dql\iterator\IteratorStreamMergedResultTest.java,0,40,0,25,0,65
 shardingsphere-master\shardingsphere-master\shardingsphere-kernel\shardingsphere-data-pipeline\shardingsphere-data-pipeline-spi\src\main\java\org\apache\shardingsphere\data\pipeline\api\datasource\config\impl\ShardingSpherePipelineDataSourceConfiguration.java,0,43,0,18,0,61
 shardingsphere-master\shardingsphere-master\shardingsphere-kernel\shardingsphere-transaction\shardingsphere-transaction-core\src\test\java\org\apache\shardingsphere\transaction\core\TransactionTypeTest.java,0,7,0,4,0,11
 shardingsphere-master\shardingsphere-master\shardingsphere-sql-parser\shardingsphere-sql-parser-statement\src\main\java\org\apache\shardingsphere\sql\parser\sql\dialect\statement\postgresql\ddl\PostgreSQLDropForeignTableStatement.java,0,1,0,5,0,6
 shardingsphere-master\shardingsphere-master\shardingsphere-features\shardingsphere-sharding\shardingsphere-sharding-core\src\main\java\org\apache\shardingsphere\sharding\route\engine\condition\value\ShardingConditionValue.java,0,4,0,1,0,5
 shardingsphere-master\shardingsphere-master\shardingsphere-infra\shardingsphere-infra-executor\src\main\java\org\apache\shardingsphere\infra\executor\sql\process\ExecuteProcessEngine.java,0,19,0,15,0,34
 shardingsphere-master\shardingsphere-master\shardingsphere-sql-parser\shardingsphere-sql-parser-statement\src\test\java\org\apache\shardingsphere\sql\parser\sql\dialect\handler\dml\SelectStatementHandlerTest.java,0,62,0,35,0,97
 shardingsphere-master\shardingsphere-master\shardingsphere-test\shardingsphere-parser-test\src\main\java\org\apache\shardingsphere\test\sql\parser\parameterized\jaxb\cases\domain\statement\ddl\AlterTableStatementTestCase.java,0,20,0,14,0,34
 shardingsphere-master\shardingsphere-master\shardingsphere-mode\shardingsphere-mode-type\shardingsphere-cluster-mode\shardingsphere-cluster-mode-core\src\main\java\org\apache\shardingsphere\mode\manager\cluster\coordinator\registry\config\event\schema\SchemaChangedEvent.java,0,6,0,3,0,9
 shardingsphere-master\shardingsphere-master\shardingsphere-infra\shardingsphere-infra-common\src\main\java\org\apache\shardingsphere\infra\yaml\config\swapper\YamlDataSourceConfigurationSwapper.java,0,25,0,16,0,41
 shardingsphere-master\shardingsphere-master\shardingsphere-test\shardingsphere-parser-test\src\main\java\org\apache\shardingsphere\test\sql\parser\parameterized\jaxb\cases\domain\statement\ddl\FlashbackTableStatementTestCase.java,0,3,0,4,0,7
 shardingsphere-master\shardingsphere-master\shardingsphere-sql-parser\shardingsphere-sql-parser-statement\src\main\java\org\apache\shardingsphere\sql\parser\sql\common\segment\ddl\charset\CharsetNameSegment.java,0,7,0,1,0,8
 shardingsphere-master\shardingsphere-master\shardingsphere-test\shardingsphere-parser-test\src\main\java\org\apache\shardingsphere\test\sql\parser\parameterized\jaxb\cases\domain\statement\tcl\SetTransactionStatementTestCase.java,0,0,0,3,0,3
 shardingsphere-master\shardingsphere-master\shardingsphere-kernel\shardingsphere-data-pipeline\shardingsphere-data-pipeline-core\src\main\java\org\apache\shardingsphere\data\pipeline\scenario\rulealtered\RuleAlteredJobWorker.java,0,111,2,102,0,215
 shardingsphere-master\shardingsphere-master\shardingsphere-db-protocol\shardingsphere-db-protocol-postgresql\src\test\java\org\apache\shardingsphere\db\protocol\postgresql\packet\command\query\extended\bind\PostgreSQLBindCompletePacketTest.java,0,5,0,4,0,9
 shardingsphere-master\shardingsphere-master\examples\example-core\example-spring-jpa\src\main\java\org\apache\shardingsphere\example\core\jpa\entity\UserEntity.java,0,5,0,1,0,6
 shardingsphere-master\shardingsphere-master\shardingsphere-sql-parser\shardingsphere-sql-parser-statement\src\main\java\org\apache\shardingsphere\sql\parser\sql\dialect\statement\sql92\dcl\SQL92GrantStatement.java,0,2,0,4,0,6
 shardingsphere-master\shardingsphere-master\shardingsphere-test\shardingsphere-parser-test\src\main\java\org\apache\shardingsphere\test\sql\parser\parameterized\asserts\statement\tcl\impl\SetAutoCommitStatementAssert.java,0,5,0,7,0,12
 shardingsphere-master\shardingsphere-master\shardingsphere-db-protocol\shardingsphere-db-protocol-mysql\src\main\java\org\apache\shardingsphere\db\protocol\mysql\packet\handshake\MySQLAuthPluginData.java,0,14,0,4,0,18
 shardingsphere-master\shardingsphere-master\shardingsphere-test\shardingsphere-integration-test\shardingsphere-integration-test-suite\src\test\java\org\apache\shardingsphere\test\integration\framework\container\atomic\adapter\AdapterContainerFactory.java,0,5,0,8,0,13
 shardingsphere-master\shardingsphere-master\shardingsphere-mode\shardingsphere-mode-core\src\main\java\org\apache\shardingsphere\mode\metadata\persist\node\SchemaMetaDataNode.java,0,62,0,27,0,89
 shardingsphere-master\shardingsphere-master\shardingsphere-sql-parser\shardingsphere-sql-parser-statement\src\main\java\org\apache\shardingsphere\sql\parser\sql\dialect\statement\sqlserver\ddl\SQLServerAlterDatabaseStatement.java,0,2,0,5,0,7
 shardingsphere-master\shardingsphere-master\shardingsphere-features\shardingsphere-sharding\shardingsphere-sharding-core\src\test\java\org\apache\shardingsphere\sharding\merge\ShardingResultMergerEngineTest.java,0,33,0,41,0,74
 shardingsphere-master\shardingsphere-master\shardingsphere-test\shardingsphere-integration-test\shardingsphere-integration-test-suite\src\test\java\org\apache\shardingsphere\test\integration\env\scenario\database\DatabaseNameEnvironment.java,0,2,0,1,0,3
 shardingsphere-master\shardingsphere-master\shardingsphere-features\shardingsphere-db-discovery\shardingsphere-db-discovery-distsql\shardingsphere-db-discovery-distsql-statement\src\main\java\org\apache\shardingsphere\dbdiscovery\distsql\parser\statement\AlterDatabaseDiscoveryRuleStatement.java,0,3,0,4,0,7
 shardingsphere-master\shardingsphere-master\shardingsphere-proxy\shardingsphere-proxy-frontend\shardingsphere-proxy-frontend-opengauss\src\main\java\org\apache\shardingsphere\proxy\frontend\opengauss\command\OpenGaussCommandExecutorFactory.java,0,31,0,53,0,84
 shardingsphere-master\shardingsphere-master\shardingsphere-sql-parser\shardingsphere-sql-parser-statement\src\main\java\org\apache\shardingsphere\sql\parser\sql\dialect\statement\mysql\tcl\MySQLCommitStatement.java,0,1,0,4,0,5
 shardingsphere-master\shardingsphere-master\shardingsphere-sql-parser\shardingsphere-sql-parser-dialect\shardingsphere-sql-parser-mysql\src\main\java\org\apache\shardingsphere\sql\parser\mysql\parser\MySQLLexer.java,0,3,0,1,0,4
 shardingsphere-master\shardingsphere-master\shardingsphere-db-protocol\shardingsphere-db-protocol-mysql\src\main\java\org\apache\shardingsphere\db\protocol\mysql\packet\command\query\binary\MySQLPreparedStatement.java,0,7,0,1,0,8
 shardingsphere-master\shardingsphere-master\shardingsphere-kernel\shardingsphere-transaction\shardingsphere-transaction-type\shardingsphere-transaction-xa\shardingsphere-transaction-xa-core\src\test\java\org\apache\shardingsphere\transaction\xa\XAShardingSphereTransactionManagerTest.java,0,46,5,21,0,72
 shardingsphere-master\shardingsphere-master\shardingsphere-proxy\shardingsphere-proxy-backend\src\main\java\org\apache\shardingsphere\proxy\backend\text\distsql\rdl\resource\AddResourceBackendHandler.java,0,20,1,17,0,38
 shardingsphere-master\shardingsphere-master\shardingsphere-proxy\shardingsphere-proxy-backend\src\main\java\org\apache\shardingsphere\proxy\backend\text\distsql\ral\scaling\query\QueryableScalingRALBackendHandlerFactory.java,0,7,0,5,0,12
 shardingsphere-master\shardingsphere-master\shardingsphere-test\shardingsphere-parser-test\src\main\java\org\apache\shardingsphere\test\sql\parser\parameterized\jaxb\cases\domain\statement\dal\InstallPluginStatementTestCase.java,0,2,0,4,0,6
 shardingsphere-master\shardingsphere-master\shardingsphere-infra\shardingsphere-infra-executor\src\main\java\org\apache\shardingsphere\infra\executor\sql\prepare\driver\ExecutorConnectionManager.java,0,3,0,3,0,6
 shardingsphere-master\shardingsphere-master\shardingsphere-features\shardingsphere-sharding\shardingsphere-sharding-distsql\shardingsphere-sharding-distsql-handler\src\test\java\org\apache\shardingsphere\sharding\distsql\query\ShardingKeyGeneratorsQueryResultSetTest.java,0,10,0,9,0,19
 shardingsphere-master\shardingsphere-master\shardingsphere-proxy\shardingsphere-proxy-backend\src\test\java\org\apache\shardingsphere\proxy\backend\text\admin\postgresql\PostgreSQLAdminExecutorFactoryTest.java,0,33,0,29,0,62
 shardingsphere-master\shardingsphere-master\shardingsphere-mode\shardingsphere-mode-type\shardingsphere-cluster-mode\shardingsphere-cluster-mode-repository\shardingsphere-cluster-mode-repository-provider\shardingsphere-cluster-mode-repository-etcd\src\main\java\org\apache\shardingsphere\mode\repository\cluster\etcd\EtcdRepository.java,0,45,1,34,0,80
 shardingsphere-master\shardingsphere-master\shardingsphere-proxy\shardingsphere-proxy-frontend\shardingsphere-proxy-frontend-mysql\src\main\java\org\apache\shardingsphere\proxy\frontend\mysql\authentication\MySQLAuthenticationHandler.java,0,9,0,11,0,20
 shardingsphere-master\shardingsphere-master\shardingsphere-db-protocol\shardingsphere-db-protocol-mysql\src\test\java\org\apache\shardingsphere\db\protocol\mysql\packet\command\query\binary\prepare\MySQLComStmtPrepareMySQLOKPacketTest.java,0,6,0,3,0,9
 shardingsphere-master\shardingsphere-master\shardingsphere-features\shardingsphere-sharding\shardingsphere-sharding-core\src\test\java\org\apache\shardingsphere\sharding\merge\dal\show\ShowCreateTableMergedResultTest.java,0,32,0,18,0,50
 shardingsphere-master\shardingsphere-master\shardingsphere-db-protocol\shardingsphere-db-protocol-mysql\src\test\java\org\apache\shardingsphere\db\protocol\mysql\constant\MySQLNewParametersBoundFlagTest.java,0,5,0,2,0,7
 shardingsphere-master\shardingsphere-master\shardingsphere-test\shardingsphere-parser-test\src\main\java\org\apache\shardingsphere\test\sql\parser\parameterized\asserts\statement\dml\DMLStatementAssert.java,0,11,0,34,0,45
 shardingsphere-master\shardingsphere-master\shardingsphere-infra\shardingsphere-infra-rewrite\src\test\java\org\apache\shardingsphere\infra\rewrite\sql\token\pojo\generic\UseDefaultInsertColumnsTokenTest.java,0,6,0,3,0,9
 shardingsphere-master\shardingsphere-master\shardingsphere-db-protocol\shardingsphere-db-protocol-mysql\src\test\java\org\apache\shardingsphere\db\protocol\mysql\packet\binlog\row\column\value\blob\MySQLBlobBinlogProtocolValueTest.java,0,42,0,10,0,52
 shardingsphere-master\shardingsphere-master\shardingsphere-sql-parser\shardingsphere-sql-parser-statement\src\main\java\org\apache\shardingsphere\sql\parser\sql\common\util\ColumnExtractor.java,0,16,0,19,0,35
 shardingsphere-master\shardingsphere-master\shardingsphere-db-protocol\shardingsphere-db-protocol-core\src\test\java\org\apache\shardingsphere\db\protocol\error\CommonErrorCodeTest.java,0,17,0,8,0,25
 shardingsphere-master\shardingsphere-master\shardingsphere-test\shardingsphere-parser-test\src\main\java\org\apache\shardingsphere\test\sql\parser\parameterized\jaxb\cases\domain\segment\impl\distsql\rdl\ExpectedShardingAlgorithm.java,0,5,0,5,0,10
 shardingsphere-master\shardingsphere-master\shardingsphere-proxy\shardingsphere-proxy-backend\src\main\java\org\apache\shardingsphere\proxy\backend\text\admin\mysql\executor\MySQLSetCharsetExecutor.java,0,14,0,9,0,23
 shardingsphere-master\shardingsphere-master\shardingsphere-kernel\shardingsphere-transaction\shardingsphere-transaction-type\shardingsphere-transaction-xa\shardingsphere-transaction-xa-core\src\main\java\org\apache\shardingsphere\transaction\xa\jta\datasource\properties\dialect\MariaDBXADataSourceDefinition.java,0,1,0,4,0,5
 shardingsphere-master\shardingsphere-master\shardingsphere-sql-parser\shardingsphere-sql-parser-statement\src\main\java\org\apache\shardingsphere\sql\parser\sql\dialect\statement\opengauss\ddl\OpenGaussDropTablespaceStatement.java,0,1,0,5,0,6
 shardingsphere-master\shardingsphere-master\shardingsphere-features\shardingsphere-encrypt\shardingsphere-encrypt-spring\shardingsphere-encrypt-spring-namespace\src\main\java\org\apache\shardingsphere\encrypt\spring\namespace\tag\EncryptAlgorithmBeanDefinitionTag.java,0,4,0,1,0,5
 shardingsphere-master\shardingsphere-master\shardingsphere-db-protocol\shardingsphere-db-protocol-core\src\test\java\org\apache\shardingsphere\db\protocol\codec\PacketCodecTest.java,0,20,0,4,0,24
 shardingsphere-master\shardingsphere-master\shardingsphere-test\shardingsphere-parser-test\src\main\java\org\apache\shardingsphere\test\sql\parser\parameterized\jaxb\cases\domain\statement\distsql\ral\SetShardingHintDatabaseValueStatementTestCase.java,0,1,0,4,0,5
 shardingsphere-master\shardingsphere-master\shardingsphere-features\shardingsphere-sharding\shardingsphere-sharding-core\src\test\java\org\apache\shardingsphere\sharding\fixture\ClassBasedComplexKeysShardingAlgorithmFixture.java,0,3,1,5,0,9
 shardingsphere-master\shardingsphere-master\shardingsphere-infra\shardingsphere-infra-common\src\main\java\org\apache\shardingsphere\infra\rule\identifier\type\StatusContainedRule.java,0,1,0,1,0,2
 shardingsphere-master\shardingsphere-master\shardingsphere-sql-parser\shardingsphere-sql-parser-statement\src\main\java\org\apache\shardingsphere\sql\parser\sql\common\segment\dal\VariableAssignSegment.java,0,8,0,1,2,11
 shardingsphere-master\shardingsphere-master\shardingsphere-sql-parser\shardingsphere-sql-parser-statement\src\main\java\org\apache\shardingsphere\sql\parser\sql\dialect\statement\sqlserver\SQLServerStatement.java,0,1,0,1,0,2
 shardingsphere-master\shardingsphere-master\shardingsphere-sql-parser\shardingsphere-sql-parser-statement\src\main\java\org\apache\shardingsphere\sql\parser\sql\dialect\statement\postgresql\dal\PostgreSQLExplainStatement.java,0,1,0,5,0,6
 shardingsphere-master\shardingsphere-master\shardingsphere-infra\shardingsphere-infra-binder\src\main\java\org\apache\shardingsphere\infra\binder\segment\select\projection\impl\ColumnProjection.java,0,11,0,2,0,13
 shardingsphere-master\shardingsphere-master\shardingsphere-test\shardingsphere-parser-test\src\main\java\org\apache\shardingsphere\test\sql\parser\parameterized\asserts\statement\distsql\rql\RQLStatementAssert.java,0,5,0,8,0,13
 shardingsphere-master\shardingsphere-master\shardingsphere-test\shardingsphere-parser-test\src\main\java\org\apache\shardingsphere\test\sql\parser\parameterized\asserts\statement\dcl\impl\sqlserver\SQLServerRevokeStatementAssert.java,0,5,0,10,0,15
 shardingsphere-master\shardingsphere-master\shardingsphere-sql-parser\shardingsphere-sql-parser-statement\src\main\java\org\apache\shardingsphere\sql\parser\sql\dialect\statement\opengauss\ddl\OpenGaussAlterViewStatement.java,3,1,0,5,0,6
 shardingsphere-master\shardingsphere-master\shardingsphere-mode\shardingsphere-mode-core\src\test\java\org\apache\shardingsphere\mode\manager\fixture\FixtureContextManagerBuilder.java,0,6,0,3,0,9
 shardingsphere-master\shardingsphere-master\shardingsphere-infra\shardingsphere-infra-common\src\main\java\org\apache\shardingsphere\infra\metadata\schema\loader\dialect\SQLServerTableMetaDataLoader.java,0,43,0,29,0,72
 shardingsphere-master\shardingsphere-master\shardingsphere-infra\shardingsphere-infra-common\src\test\java\org\apache\shardingsphere\infra\metadata\resource\DataSourcesMetaDataTest.java,0,29,0,21,0,50
 shardingsphere-master\shardingsphere-master\shardingsphere-sql-parser\shardingsphere-sql-parser-statement\src\main\java\org\apache\shardingsphere\sql\parser\sql\dialect\statement\sqlserver\dcl\SQLServerAlterLoginStatement.java,0,4,0,6,0,10
 shardingsphere-master\shardingsphere-master\shardingsphere-kernel\shardingsphere-transaction\shardingsphere-transaction-core\src\main\java\org\apache\shardingsphere\transaction\context\TransactionContextsBuilder.java,0,13,0,9,0,22
 shardingsphere-master\shardingsphere-master\shardingsphere-infra\shardingsphere-infra-context\src\test\java\org\apache\shardingsphere\infra\context\refresher\MetaDataRefreshEngineTest.java,0,13,1,8,0,22
 shardingsphere-master\shardingsphere-master\shardingsphere-sql-parser\shardingsphere-sql-parser-statement\src\main\java\org\apache\shardingsphere\sql\parser\sql\dialect\statement\mysql\ddl\MySQLExecuteStatement.java,0,1,0,4,0,5
 shardingsphere-master\shardingsphere-master\shardingsphere-proxy\shardingsphere-proxy-frontend\shardingsphere-proxy-frontend-spi\src\main\java\org\apache\shardingsphere\proxy\frontend\command\executor\CommandExecutor.java,0,3,1,1,0,5
 shardingsphere-master\shardingsphere-master\shardingsphere-agent\shardingsphere-agent-plugins\shardingsphere-agent-plugin-metrics\shardingsphere-agent-metrics-prometheus\src\test\java\org\apache\shardingsphere\agent\metrics\prometheus\wrapper\GaugeWrapperTest.java,0,2,0,1,0,3
 shardingsphere-master\shardingsphere-master\shardingsphere-proxy\shardingsphere-proxy-frontend\shardingsphere-proxy-frontend-core\src\main\java\org\apache\shardingsphere\proxy\frontend\exception\FrontendTooManyConnectionsException.java,0,1,0,2,0,3
 shardingsphere-master\shardingsphere-master\shardingsphere-db-protocol\shardingsphere-db-protocol-postgresql\src\main\java\org\apache\shardingsphere\db\protocol\postgresql\packet\handshake\PostgreSQLAuthenticationOKPacket.java,0,4,0,6,0,10
 shardingsphere-master\shardingsphere-master\shardingsphere-proxy\shardingsphere-proxy-frontend\shardingsphere-proxy-frontend-spi\src\main\java\org\apache\shardingsphere\proxy\frontend\context\FrontendContext.java,0,3,0,1,0,4
 shardingsphere-master\shardingsphere-master\shardingsphere-db-protocol\shardingsphere-db-protocol-mysql\src\test\java\org\apache\shardingsphere\db\protocol\mysql\constant\MySQLAuthenticationMethodTest.java,0,4,0,2,0,6
 shardingsphere-master\shardingsphere-master\shardingsphere-jdbc\shardingsphere-jdbc-core\src\test\java\org\apache\shardingsphere\driver\jdbc\unsupported\UnsupportedUpdateOperationResultSetTest.java,0,215,2,43,0,260
 shardingsphere-master\shardingsphere-master\shardingsphere-sql-parser\shardingsphere-sql-parser-statement\src\main\java\org\apache\shardingsphere\sql\parser\sql\dialect\statement\oracle\dcl\OracleDropRoleStatement.java,0,1,0,4,0,5
 shardingsphere-master\shardingsphere-master\examples\shardingsphere-jdbc-example\single-feature-example\transaction-example\transaction-2pc-xa-narayana-raw-jdbc-example\src\main\java\org\apache\shardingsphere\example\transaction\xa\narayana\raw\jdbc\TransactionXaNarayanaRawExample.java,0,9,1,6,0,16
 shardingsphere-master\shardingsphere-master\shardingsphere-test\shardingsphere-pipeline-test\src\test\java\org\apache\shardingsphere\scaling\core\spi\ScalingEntryFactoryTest.java,0,5,0,1,0,6
 shardingsphere-master\shardingsphere-master\shardingsphere-jdbc\shardingsphere-jdbc-spring\shardingsphere-jdbc-spring-infra\shardingsphere-jdbc-spring-namespace-infra\src\test\java\org\apache\shardingsphere\spring\namespace\fixture\factorybean\ShardingSphereAlgorithmFixtureFactoryBean.java,0,7,0,6,0,13
 shardingsphere-master\shardingsphere-master\shardingsphere-features\shardingsphere-sharding\shardingsphere-sharding-distsql\shardingsphere-sharding-distsql-statement\src\main\java\org\apache\shardingsphere\sharding\distsql\parser\segment\ShardingKeyGeneratorSegment.java,0,4,0,1,0,5
 shardingsphere-master\shardingsphere-master\shardingsphere-db-protocol\shardingsphere-db-protocol-postgresql\src\main\java\org\apache\shardingsphere\db\protocol\postgresql\packet\PostgreSQLPacket.java,0,2,0,3,0,5
 shardingsphere-master\shardingsphere-master\shardingsphere-test\shardingsphere-integration-test\shardingsphere-integration-test-suite\src\test\java\org\apache\shardingsphere\test\integration\framework\container\atomic\governance\GovernanceContainerFactory.java,0,4,0,4,0,8
 shardingsphere-master\shardingsphere-master\shardingsphere-infra\shardingsphere-infra-common\src\test\java\org\apache\shardingsphere\infra\properties\PropertiesConverterTest.java,0,6,0,2,0,8
 shardingsphere-master\shardingsphere-master\shardingsphere-jdbc\shardingsphere-jdbc-core\src\main\java\org\apache\shardingsphere\driver\jdbc\adapter\WrapperAdapter.java,19,6,0,4,0,10
 shardingsphere-master\shardingsphere-master\shardingsphere-test\shardingsphere-parser-test\src\main\java\org\apache\shardingsphere\test\sql\parser\parameterized\asserts\statement\distsql\rdl\alter\impl\AlterShadowAlgorithmStatementAssert.java,0,10,0,16,0,26
 shardingsphere-master\shardingsphere-master\shardingsphere-features\shardingsphere-sharding\shardingsphere-sharding-core\src\test\java\org\apache\shardingsphere\sharding\rewrite\token\AggregationDistinctTokenGeneratorTest.java,0,23,0,26,0,49
 shardingsphere-master\shardingsphere-master\shardingsphere-sql-parser\shardingsphere-sql-parser-dialect\shardingsphere-sql-parser-mysql\src\test\java\org\apache\shardingsphere\sql\parser\mysql\MySQLXAVisitorTest.java,0,17,0,13,0,30
 shardingsphere-master\shardingsphere-master\shardingsphere-infra\shardingsphere-infra-federation\shardingsphere-infra-federation-optimizer\src\main\java\org\apache\shardingsphere\infra\federation\optimizer\context\OptimizerContext.java,0,9,0,4,0,13
 shardingsphere-master\shardingsphere-master\shardingsphere-features\shardingsphere-sharding\shardingsphere-sharding-core\src\main\java\org\apache\shardingsphere\sharding\algorithm\sharding\classbased\ClassBasedShardingAlgorithmFactory.java,0,8,0,5,0,13
 shardingsphere-master\shardingsphere-master\shardingsphere-test\shardingsphere-parser-test\src\main\java\org\apache\shardingsphere\test\sql\parser\parameterized\asserts\segment\column\ColumnAssert.java,0,11,0,15,0,26
 shardingsphere-master\shardingsphere-master\shardingsphere-db-protocol\shardingsphere-db-protocol-postgresql\src\main\java\org\apache\shardingsphere\db\protocol\postgresql\packet\command\query\extended\execute\PostgreSQLComExecutePacket.java,0,9,1,6,0,16
 shardingsphere-master\shardingsphere-master\shardingsphere-sql-parser\shardingsphere-sql-parser-statement\src\main\java\org\apache\shardingsphere\sql\parser\sql\dialect\statement\postgresql\ddl\PostgreSQLCreateProcedureStatement.java,0,1,0,5,0,6
 shardingsphere-master\shardingsphere-master\shardingsphere-sql-parser\shardingsphere-sql-parser-statement\src\main\java\org\apache\shardingsphere\sql\parser\sql\common\segment\dml\expr\InExpression.java,0,11,0,1,0,12
 shardingsphere-master\shardingsphere-master\shardingsphere-test\shardingsphere-parser-test\src\main\java\org\apache\shardingsphere\test\sql\parser\parameterized\jaxb\cases\domain\segment\impl\distsql\rdl\ExpectedShadowAlgorithm.java,0,5,0,5,0,10
 shardingsphere-master\shardingsphere-master\shardingsphere-jdbc\shardingsphere-jdbc-core\src\main\java\org\apache\shardingsphere\driver\state\circuit\metadata\CircuitBreakerDatabaseMetaData.java,0,201,0,24,0,225
 shardingsphere-master\shardingsphere-master\shardingsphere-test\shardingsphere-parser-test\src\main\java\org\apache\shardingsphere\test\sql\parser\parameterized\jaxb\cases\domain\segment\impl\distsql\rdl\sharding\scaling\ExpectedShardingScalingRuleConfigurationSegment.java,0,11,0,5,0,16
 shardingsphere-master\shardingsphere-master\shardingsphere-infra\shardingsphere-infra-binder\src\test\java\org\apache\shardingsphere\infra\binder\statement\ddl\CreateIndexStatementContextTest.java,0,9,0,14,0,23
 shardingsphere-master\shardingsphere-master\shardingsphere-kernel\shardingsphere-transaction\shardingsphere-transaction-core\src\test\java\org\apache\shardingsphere\transaction\context\TransactionContextsBuilderTest.java,0,14,0,11,0,25
 shardingsphere-master\shardingsphere-master\examples\shardingsphere-jdbc-example\single-feature-example\shadow-example\shadow-raw-jdbc-example\src\main\java\org\apache\shardingsphere\example\shadow\raw\jdbc\factory\YamlDataSourceFactory.java,0,9,1,7,0,17
 shardingsphere-master\shardingsphere-master\shardingsphere-test\shardingsphere-parser-test\src\main\java\org\apache\shardingsphere\test\sql\parser\parameterized\asserts\statement\tcl\impl\RollbackStatementAssert.java,0,7,0,9,0,16
 shardingsphere-master\shardingsphere-master\shardingsphere-proxy\shardingsphere-proxy-backend\src\main\java\org\apache\shardingsphere\proxy\backend\exception\TableLockedException.java,0,5,0,1,0,6
 shardingsphere-master\shardingsphere-master\shardingsphere-infra\shardingsphere-infra-common\src\main\java\org\apache\shardingsphere\infra\rule\event\impl\DataSourceNameDisabledEvent.java,0,5,0,2,0,7
 shardingsphere-master\shardingsphere-master\shardingsphere-sql-parser\shardingsphere-sql-parser-statement\src\main\java\org\apache\shardingsphere\sql\parser\sql\dialect\statement\mysql\dal\MySQLHelpStatement.java,0,3,0,5,0,8
 shardingsphere-master\shardingsphere-master\shardingsphere-distsql\shardingsphere-distsql-statement\src\main\java\org\apache\shardingsphere\distsql\parser\segment\AlgorithmSegment.java,0,5,0,1,0,6
 shardingsphere-master\shardingsphere-master\shardingsphere-features\shardingsphere-sharding\shardingsphere-sharding-core\src\test\java\org\apache\shardingsphere\sharding\route\strategy\ShardingStrategyFactoryTest.java,0,28,0,24,0,52
 shardingsphere-master\shardingsphere-master\shardingsphere-sql-parser\shardingsphere-sql-parser-dialect\shardingsphere-sql-parser-opengauss\src\main\java\org\apache\shardingsphere\sql\parser\opengauss\visitor\statement\facade\OpenGaussStatementSQLVisitorFacade.java,0,10,0,7,0,17
 shardingsphere-master\shardingsphere-master\shardingsphere-features\shardingsphere-sharding\shardingsphere-sharding-distsql\shardingsphere-sharding-distsql-statement\src\main\java\org\apache\shardingsphere\sharding\distsql\parser\statement\ShowDefaultShardingStrategyStatement.java,0,3,0,4,0,7
 shardingsphere-master\shardingsphere-master\shardingsphere-test\shardingsphere-parser-test\src\main\java\org\apache\shardingsphere\test\sql\parser\parameterized\jaxb\cases\domain\statement\distsql\ral\ExportSchemaConfigurationStatementTestCase.java,0,2,0,5,0,7
 shardingsphere-master\shardingsphere-master\shardingsphere-infra\shardingsphere-infra-common\src\main\java\org\apache\shardingsphere\infra\distsql\exception\rule\RequiredKeyGeneratorMissedException.java,9,7,0,4,0,11
 shardingsphere-master\shardingsphere-master\shardingsphere-sql-parser\shardingsphere-sql-parser-statement\src\main\java\org\apache\shardingsphere\sql\parser\sql\common\statement\dcl\DropUserStatement.java,5,3,1,3,1,8
 shardingsphere-master\shardingsphere-master\shardingsphere-features\shardingsphere-shadow\shardingsphere-shadow-distsql\shardingsphere-shadow-distsql-handler\src\main\java\org\apache\shardingsphere\shadow\distsql\handler\query\ShadowAlgorithmQueryResultSet.java,0,27,0,9,0,36
 shardingsphere-master\shardingsphere-master\shardingsphere-sql-parser\shardingsphere-sql-parser-statement\src\main\java\org\apache\shardingsphere\sql\parser\sql\dialect\statement\postgresql\dml\PostgreSQLCallStatement.java,0,2,0,5,0,7
 shardingsphere-master\shardingsphere-master\shardingsphere-features\shardingsphere-sharding\shardingsphere-sharding-distsql\shardingsphere-sharding-distsql-handler\src\test\java\org\apache\shardingsphere\sharding\distsql\query\UnusedShardingAlgorithmsQueryResultSetTest.java,0,18,0,16,0,34
 shardingsphere-master\shardingsphere-master\shardingsphere-features\shardingsphere-sharding\shardingsphere-sharding-core\src\main\java\org\apache\shardingsphere\sharding\algorithm\sharding\ShardingAlgorithmException.java,0,5,0,2,0,7
 shardingsphere-master\shardingsphere-master\shardingsphere-kernel\shardingsphere-data-pipeline\shardingsphere-data-pipeline-dialect\shardingsphere-data-pipeline-mysql\src\test\java\org\apache\shardingsphere\data\pipeline\mysql\ingest\binlog\BinlogContextTest.java,0,22,0,6,0,28
 shardingsphere-master\shardingsphere-master\shardingsphere-proxy\shardingsphere-proxy-backend\src\main\java\org\apache\shardingsphere\proxy\backend\text\distsql\ral\common\hint\HintManagerHolder.java,0,8,0,3,0,11
 shardingsphere-master\shardingsphere-master\examples\shardingsphere-jdbc-example\single-feature-example\cluster-mode-example\cluster-mode-raw-jdbc-example\src\main\java\org\apache\shardingsphere\example\cluster\mode\raw\jdbc\config\local\LocalReadwriteSplittingConfiguration.java,0,19,0,13,0,32
 shardingsphere-master\shardingsphere-master\shardingsphere-proxy\shardingsphere-proxy-backend\src\test\java\org\apache\shardingsphere\proxy\backend\text\skip\SkipBackendHandlerTest.java,0,3,0,2,0,5
 shardingsphere-master\shardingsphere-master\shardingsphere-kernel\shardingsphere-transaction\shardingsphere-transaction-type\shardingsphere-transaction-xa\shardingsphere-transaction-xa-provider\shardingsphere-transaction-xa-bitronix\src\test\java\org\apache\shardingsphere\transaction\xa\bitronix\manager\BitronixXATransactionManagerProviderTest.java,0,21,0,7,0,28
 shardingsphere-master\shardingsphere-master\shardingsphere-infra\shardingsphere-infra-common\src\main\java\org\apache\shardingsphere\infra\distsql\query\DistSQLResultSet.java,0,9,0,1,0,10
 shardingsphere-master\shardingsphere-master\shardingsphere-infra\shardingsphere-infra-common\src\main\java\org\apache\shardingsphere\infra\database\type\DatabaseTypeFactory.java,0,12,0,8,0,20
 shardingsphere-master\shardingsphere-master\shardingsphere-db-protocol\shardingsphere-db-protocol-mysql\src\main\java\org\apache\shardingsphere\db\protocol\mysql\packet\binlog\row\column\value\time\MySQLTimestamp2BinlogProtocolValue.java,0,7,0,9,0,16
 shardingsphere-master\shardingsphere-master\shardingsphere-sql-parser\shardingsphere-sql-parser-statement\src\main\java\org\apache\shardingsphere\sql\parser\sql\common\segment\dml\predicate\OrPredicateSegment.java,0,6,2,1,3,12
 shardingsphere-master\shardingsphere-master\shardingsphere-kernel\shardingsphere-parser\shardingsphere-parser-spring\shardingsphere-parser-spring-namespace\src\main\java\org\apache\shardingsphere\parser\spring\namespace\tag\SQLParserRuleBeanDefinitionTag.java,0,20,0,3,0,23
 shardingsphere-master\shardingsphere-master\shardingsphere-proxy\shardingsphere-proxy-frontend\shardingsphere-proxy-frontend-postgresql\src\test\java\org\apache\shardingsphere\proxy\frontend\postgresql\command\PostgreSQLCommandExecuteEngineTest.java,0,47,0,34,0,81
 shardingsphere-master\shardingsphere-master\shardingsphere-infra\shardingsphere-infra-common\src\main\java\org\apache\shardingsphere\infra\yaml\config\swapper\algorithm\ShardingSphereAlgorithmConfigurationYamlSwapper.java,0,8,0,9,0,17
 shardingsphere-master\shardingsphere-master\shardingsphere-features\shardingsphere-sharding\shardingsphere-sharding-core\src\main\java\org\apache\shardingsphere\sharding\route\engine\condition\engine\impl\InsertClauseShardingConditionEngine.java,0,52,0,51,0,103
 shardingsphere-master\shardingsphere-master\shardingsphere-proxy\shardingsphere-proxy-backend\src\main\java\org\apache\shardingsphere\proxy\backend\text\data\DatabaseBackendHandlerFactory.java,0,9,1,14,0,24
 shardingsphere-master\shardingsphere-master\shardingsphere-features\shardingsphere-sharding\shardingsphere-sharding-core\src\test\java\org\apache\shardingsphere\sharding\swapper\YamlRootRuleConfigurationsForYamlShardingRuleConfigurationTest.java,0,46,0,33,0,79
 shardingsphere-master\shardingsphere-master\shardingsphere-infra\shardingsphere-infra-datetime\shardingsphere-infra-datetime-type\shardingsphere-database-datetime\src\main\java\org\apache\shardingsphere\datetime\database\provider\dialect\SQLServerDatetimeLoadingSQLProvider.java,0,3,0,3,0,6
 shardingsphere-master\shardingsphere-master\shardingsphere-agent\shardingsphere-agent-core\src\test\java\org\apache\shardingsphere\agent\core\mock\advice\MockClassStaticMethodAroundAdvice.java,0,13,0,5,0,18
 shardingsphere-master\shardingsphere-master\shardingsphere-proxy\shardingsphere-proxy-backend\src\main\java\org\apache\shardingsphere\proxy\backend\text\transaction\TransactionAutoCommitHandler.java,0,4,0,4,0,8
 shardingsphere-master\shardingsphere-master\shardingsphere-test\shardingsphere-parser-test\src\main\java\org\apache\shardingsphere\test\sql\parser\parameterized\asserts\statement\dml\impl\MergeStatementAssert.java,0,27,0,28,0,55
 shardingsphere-master\shardingsphere-master\shardingsphere-features\shardingsphere-db-discovery\shardingsphere-db-discovery-distsql\shardingsphere-db-discovery-distsql-handler\src\main\java\org\apache\shardingsphere\dbdiscovery\distsql\handler\update\AlterDatabaseDiscoveryHeartbeatStatementUpdater.java,0,34,0,30,0,64
 shardingsphere-master\shardingsphere-master\shardingsphere-jdbc\shardingsphere-jdbc-spring\shardingsphere-jdbc-core-spring\shardingsphere-jdbc-core-spring-namespace\src\main\java\org\apache\shardingsphere\spring\namespace\tag\DataSourceBeanDefinitionTag.java,0,13,0,2,0,15
 shardingsphere-master\shardingsphere-master\shardingsphere-agent\shardingsphere-agent-api\src\main\java\org\apache\shardingsphere\agent\api\advice\ConstructorAdvice.java,0,4,0,3,0,7
 shardingsphere-master\shardingsphere-master\shardingsphere-test\shardingsphere-parser-test\src\main\java\org\apache\shardingsphere\test\sql\parser\parameterized\jaxb\cases\domain\segment\impl\assignment\ExpectedAssignment.java,0,7,0,4,0,11
 shardingsphere-master\shardingsphere-master\shardingsphere-proxy\shardingsphere-proxy-backend\src\main\java\org\apache\shardingsphere\proxy\backend\config\ProxyConfiguration.java,0,6,0,3,0,9
 shardingsphere-master\shardingsphere-master\shardingsphere-features\shardingsphere-sharding\shardingsphere-sharding-core\src\main\java\org\apache\shardingsphere\sharding\rewrite\token\pojo\LiteralGeneratedKeyAssignmentToken.java,0,8,0,3,0,11
 shardingsphere-master\shardingsphere-master\shardingsphere-kernel\shardingsphere-data-pipeline\shardingsphere-data-pipeline-dialect\shardingsphere-data-pipeline-mysql\src\test\java\org\apache\shardingsphere\data\pipeline\mysql\ingest\client\netty\MySQLBinlogEventPacketDecoderTest.java,0,53,0,26,0,79
 shardingsphere-master\shardingsphere-master\shardingsphere-proxy\shardingsphere-proxy-backend\src\main\java\org\apache\shardingsphere\proxy\backend\communication\jdbc\recognizer\impl\MySQLRecognizer.java,0,3,0,3,0,6
 shardingsphere-master\shardingsphere-master\shardingsphere-sql-parser\shardingsphere-sql-parser-statement\src\main\java\org\apache\shardingsphere\sql\parser\sql\dialect\statement\opengauss\dal\OpenGaussVacuumStatement.java,0,1,0,5,0,6
 shardingsphere-master\shardingsphere-master\shardingsphere-test\shardingsphere-integration-test\shardingsphere-integration-test-suite\src\test\java\org\apache\shardingsphere\test\integration\env\scenario\dataset\DataSetEnvironmentManager.java,0,58,2,30,0,90
 shardingsphere-master\shardingsphere-master\shardingsphere-test\shardingsphere-rewrite-test\src\test\java\org\apache\shardingsphere\sharding\rewrite\fixture\KeyGenerateAlgorithmFixture.java,0,3,1,1,0,5
 shardingsphere-master\shardingsphere-master\shardingsphere-db-protocol\shardingsphere-db-protocol-mysql\src\main\java\org\apache\shardingsphere\db\protocol\mysql\packet\binlog\row\column\value\time\MySQLTimestampBinlogProtocolValue.java,0,6,0,8,0,14
 shardingsphere-master\shardingsphere-master\shardingsphere-features\shardingsphere-sharding\shardingsphere-sharding-core\src\main\java\org\apache\shardingsphere\sharding\rewrite\token\generator\impl\OffsetTokenGenerator.java,0,9,0,13,0,22
 shardingsphere-master\shardingsphere-master\shardingsphere-sql-parser\shardingsphere-sql-parser-dialect\shardingsphere-sql-parser-oracle\src\main\java\org\apache\shardingsphere\sql\parser\oracle\parser\OracleParser.java,0,5,0,3,0,8
 shardingsphere-master\shardingsphere-master\examples\shardingsphere-jdbc-example\single-feature-example\readwrite-splitting-example\readwrite-splitting-raw-jdbc-example\src\main\java\org\apache\shardingsphere\example\readwrite\splitting\raw\jdbc\ReadwriteSplittingRawJavaConfigurationExample.java,0,8,1,4,0,13
 shardingsphere-master\shardingsphere-master\shardingsphere-proxy\shardingsphere-proxy-backend\src\main\java\org\apache\shardingsphere\proxy\backend\communication\DatabaseCommunicationEngine.java,175,99,0,55,0,154
 shardingsphere-master\shardingsphere-master\shardingsphere-features\shardingsphere-encrypt\shardingsphere-encrypt-core\src\test\java\org\apache\shardingsphere\encrypt\metadata\EncryptTableMetaDataBuilderTest.java,0,144,19,89,0,252
 shardingsphere-master\shardingsphere-master\examples\shardingsphere-jdbc-example\single-feature-example\readwrite-splitting-example\readwrite-splitting-spring-boot-jpa-example\src\main\java\org\apache\shardingsphere\example\readwrite\splitting\spring\boot\jpa\ReadwriteSplittingSpringBootJpaExample.java,9,6,1,4,0,11
 shardingsphere-master\shardingsphere-master\shardingsphere-spi\src\test\java\org\apache\shardingsphere\spi\fixture\typed\NoImplTypedSPIFixture.java,0,1,0,1,0,2
 shardingsphere-master\shardingsphere-master\shardingsphere-features\shardingsphere-readwrite-splitting\shardingsphere-readwrite-splitting-core\src\main\java\org\apache\shardingsphere\readwritesplitting\constant\ReadwriteSplittingOrder.java,0,4,0,1,0,5
 shardingsphere-master\shardingsphere-master\shardingsphere-test\shardingsphere-parser-test\src\main\java\org\apache\shardingsphere\test\sql\parser\parameterized\jaxb\cases\domain\statement\ddl\DisassociateStatisticsStatementTestCase.java,0,15,0,11,0,26
 shardingsphere-master\shardingsphere-master\shardingsphere-features\shardingsphere-sharding\shardingsphere-sharding-core\src\main\java\org\apache\shardingsphere\sharding\merge\dql\pagination\LimitDecoratorMergedResult.java,0,14,0,5,0,19
 shardingsphere-master\shardingsphere-master\shardingsphere-proxy\shardingsphere-proxy-frontend\shardingsphere-proxy-frontend-postgresql\src\main\java\org\apache\shardingsphere\proxy\frontend\postgresql\command\PostgreSQLConnectionContext.java,0,7,0,3,0,10
 shardingsphere-master\shardingsphere-master\shardingsphere-features\shardingsphere-readwrite-splitting\shardingsphere-readwrite-splitting-distsql\shardingsphere-readwrite-splitting-distsql-statement\src\main\java\org\apache\shardingsphere\readwritesplitting\distsql\parser\statement\DropReadwriteSplittingRuleStatement.java,0,7,0,4,0,11
 shardingsphere-master\shardingsphere-master\shardingsphere-test\shardingsphere-parser-test\src\main\java\org\apache\shardingsphere\test\sql\parser\parameterized\asserts\statement\distsql\rql\impl\rule\ShowUnusedShardingKeyGeneratorsStatementAssert.java,0,8,0,11,0,19
 shardingsphere-master\shardingsphere-master\shardingsphere-infra\shardingsphere-infra-common\src\test\java\org\apache\shardingsphere\infra\fixture\TestRuleConfiguration.java,0,1,0,3,0,4
 shardingsphere-master\shardingsphere-master\shardingsphere-features\shardingsphere-shadow\shardingsphere-shadow-core\src\main\java\org\apache\shardingsphere\shadow\algorithm\shadow\validator\ShadowValueValidator.java,0,2,0,1,0,3
 shardingsphere-master\shardingsphere-master\shardingsphere-features\shardingsphere-shadow\shardingsphere-shadow-core\src\main\java\org\apache\shardingsphere\shadow\rule\ShadowTableRule.java,0,29,0,14,0,43
 shardingsphere-master\shardingsphere-master\shardingsphere-sql-parser\shardingsphere-sql-parser-statement\src\test\java\org\apache\shardingsphere\sql\parser\sql\common\constant\AggregationTypeTest.java,0,3,0,1,0,4
 shardingsphere-master\shardingsphere-master\shardingsphere-agent\shardingsphere-agent-plugins\shardingsphere-agent-plugin-tracing\shardingsphere-agent-tracing-opentelemetry\src\main\java\org\apache\shardingsphere\agent\plugin\tracing\opentelemetry\service\OpenTelemetryTracingPluginBootService.java,19,5,1,3,0,9
 shardingsphere-master\shardingsphere-master\shardingsphere-test\shardingsphere-parser-test\src\main\java\org\apache\shardingsphere\test\sql\parser\parameterized\asserts\statement\dal\impl\LoadIndexInfoStatementAssert.java,0,15,0,24,0,39
 shardingsphere-master\shardingsphere-master\shardingsphere-kernel\shardingsphere-transaction\shardingsphere-transaction-type\shardingsphere-transaction-xa\shardingsphere-transaction-xa-core\src\test\java\org\apache\shardingsphere\transaction\xa\jta\datasource\properties\dialect\SQLServerXADataSourceDefinitionTest.java,0,3,0,3,0,6
 shardingsphere-master\shardingsphere-master\shardingsphere-test\shardingsphere-parser-test\src\main\java\org\apache\shardingsphere\test\sql\parser\parameterized\jaxb\cases\domain\statement\distsql\rql\ShowShardingTableNodesStatementTestCase.java,0,5,0,5,0,10
 shardingsphere-master\shardingsphere-master\shardingsphere-db-protocol\shardingsphere-db-protocol-mysql\src\test\java\org\apache\shardingsphere\db\protocol\mysql\packet\binlog\row\column\value\time\MySQLDateBinlogProtocolValueTest.java,0,18,0,6,0,24
 shardingsphere-master\shardingsphere-master\shardingsphere-distsql\shardingsphere-distsql-statement\src\main\java\org\apache\shardingsphere\distsql\parser\statement\ral\scaling\UpdatableScalingRALStatement.java,3,0,1,1,0,2
 shardingsphere-master\shardingsphere-master\shardingsphere-proxy\shardingsphere-proxy-backend\src\test\java\org\apache\shardingsphere\proxy\backend\text\admin\opengauss\OpenGaussAdminExecutorFactoryTest.java,0,27,1,15,0,43
 shardingsphere-master\shardingsphere-master\shardingsphere-features\shardingsphere-shadow\shardingsphere-shadow-core\src\main\java\org\apache\shardingsphere\shadow\route\engine\util\ShadowExtractor.java,0,24,0,25,0,49
 shardingsphere-master\shardingsphere-master\shardingsphere-features\shardingsphere-sharding\shardingsphere-sharding-distsql\shardingsphere-sharding-distsql-handler\src\main\java\org\apache\shardingsphere\scaling\distsql\handler\ApplyScalingUpdater.java,0,8,0,5,0,13
 shardingsphere-master\shardingsphere-master\shardingsphere-test\shardingsphere-parser-test\src\main\java\org\apache\shardingsphere\test\sql\parser\parameterized\jaxb\cases\domain\statement\distsql\rdl\drop\DropShardingBroadcastTableRulesStatementTestCase.java,0,3,0,4,0,7
 shardingsphere-master\shardingsphere-master\shardingsphere-sql-parser\shardingsphere-sql-parser-statement\src\main\java\org\apache\shardingsphere\sql\parser\sql\common\segment\dml\assignment\AssignmentSegment.java,17,5,0,3,0,8
 shardingsphere-master\shardingsphere-master\shardingsphere-test\shardingsphere-parser-test\src\main\java\org\apache\shardingsphere\test\sql\parser\parameterized\asserts\statement\dcl\impl\DropRoleStatementAssert.java,0,4,1,6,0,11
 shardingsphere-master\shardingsphere-master\shardingsphere-sql-parser\shardingsphere-sql-parser-statement\src\main\java\org\apache\shardingsphere\sql\parser\sql\dialect\statement\mysql\dal\MySQLFlushStatement.java,0,6,0,5,1,12
 shardingsphere-master\shardingsphere-master\shardingsphere-agent\shardingsphere-agent-core\src\main\java\org\apache\shardingsphere\agent\core\bytebuddy\transformer\ShardingSphereTransformationPoint.java,7,6,0,1,0,7
 shardingsphere-master\shardingsphere-master\shardingsphere-infra\shardingsphere-infra-common\src\test\java\org\apache\shardingsphere\infra\hint\HintManagerTest.java,0,58,0,16,0,74
 shardingsphere-master\shardingsphere-master\shardingsphere-features\shardingsphere-sharding\shardingsphere-sharding-distsql\shardingsphere-sharding-distsql-statement\src\main\java\org\apache\shardingsphere\scaling\distsql\statement\DropShardingScalingRuleStatement.java,0,6,0,3,0,9
 shardingsphere-master\shardingsphere-master\shardingsphere-test\shardingsphere-parser-test\src\main\java\org\apache\shardingsphere\test\sql\parser\parameterized\engine\UnsupportedSQLParserParameterizedTest.java,24,22,1,11,0,34
 shardingsphere-master\shardingsphere-master\shardingsphere-proxy\shardingsphere-proxy-frontend\shardingsphere-proxy-frontend-opengauss\src\test\java\org\apache\shardingsphere\proxy\frontend\opengauss\authentication\OpenGaussAuthenticationHandlerTest.java,0,68,5,35,0,108
 shardingsphere-master\shardingsphere-master\shardingsphere-infra\shardingsphere-infra-route\src\main\java\org\apache\shardingsphere\infra\route\context\RawGroup.java,0,1,0,1,0,2
 shardingsphere-master\shardingsphere-master\shardingsphere-sql-parser\shardingsphere-sql-parser-statement\src\main\java\org\apache\shardingsphere\sql\parser\sql\dialect\statement\mysql\dal\MySQLRestartStatement.java,0,1,0,5,0,6
 shardingsphere-master\shardingsphere-master\shardingsphere-infra\shardingsphere-infra-federation\shardingsphere-infra-federation-optimizer\src\test\java\org\apache\shardingsphere\infra\federation\optimizer\ShardingSphereOptimizerTest.java,0,158,2,98,0,258
 shardingsphere-master\shardingsphere-master\shardingsphere-features\shardingsphere-db-discovery\shardingsphere-db-discovery-distsql\shardingsphere-db-discovery-distsql-handler\src\test\java\org\apache\shardingsphere\dbdiscovery\distsql\handler\update\DropDatabaseDiscoveryTypeStatementUpdaterTest.java,0,43,0,33,0,76
 shardingsphere-master\shardingsphere-master\shardingsphere-infra\shardingsphere-infra-executor\src\main\java\org\apache\shardingsphere\infra\executor\kernel\ExecutorEngine.java,0,32,0,20,0,52
 shardingsphere-master\shardingsphere-master\shardingsphere-proxy\shardingsphere-proxy-backend\src\main\java\org\apache\shardingsphere\proxy\backend\text\distsql\ral\common\updatable\AlterInstanceHandler.java,0,17,0,15,0,32
 shardingsphere-master\shardingsphere-master\shardingsphere-proxy\shardingsphere-proxy-frontend\shardingsphere-proxy-frontend-core\src\main\java\org\apache\shardingsphere\proxy\frontend\protocol\DatabaseProtocolFrontendEngineFactory.java,0,9,0,7,0,16
 shardingsphere-master\shardingsphere-master\shardingsphere-proxy\shardingsphere-proxy-backend\src\main\java\org\apache\shardingsphere\proxy\backend\text\distsql\ral\common\updatable\SetReadwriteSplittingStatusHandler.java,0,93,0,77,0,170
 shardingsphere-master\shardingsphere-master\shardingsphere-sql-parser\shardingsphere-sql-parser-statement\src\main\java\org\apache\shardingsphere\sql\parser\sql\dialect\statement\sqlserver\tcl\SQLServerSetTransactionStatement.java,0,1,0,5,0,6
 shardingsphere-master\shardingsphere-master\shardingsphere-sql-parser\shardingsphere-sql-parser-statement\src\main\java\org\apache\shardingsphere\sql\parser\sql\common\statement\ddl\DropTablespaceStatement.java,3,1,1,3,0,5
 shardingsphere-master\shardingsphere-master\shardingsphere-test\shardingsphere-pipeline-test\src\test\java\org\apache\shardingsphere\data\pipeline\core\fixture\FixtureDataSourcePreparer.java,0,2,1,4,0,7
 shardingsphere-master\shardingsphere-master\shardingsphere-sql-parser\shardingsphere-sql-parser-statement\src\main\java\org\apache\shardingsphere\sql\parser\sql\dialect\statement\opengauss\ddl\OpenGaussAlterDefaultPrivilegesStatement.java,0,1,0,5,0,6
 shardingsphere-master\shardingsphere-master\shardingsphere-sql-parser\shardingsphere-sql-parser-statement\src\main\java\org\apache\shardingsphere\sql\parser\sql\dialect\statement\sql92\SQL92Statement.java,0,1,0,1,0,2
 shardingsphere-master\shardingsphere-master\shardingsphere-proxy\shardingsphere-proxy-backend\src\main\java\org\apache\shardingsphere\proxy\backend\exception\DatabaseNotExistedException.java,0,1,0,1,0,2
 shardingsphere-master\shardingsphere-master\shardingsphere-test\shardingsphere-parser-test\src\main\java\org\apache\shardingsphere\test\sql\parser\parameterized\asserts\statement\dml\impl\DeleteStatementAssert.java,0,44,0,56,0,100
 shardingsphere-master\shardingsphere-master\shardingsphere-kernel\shardingsphere-traffic\shardingsphere-traffic-core\src\test\java\org\apache\shardingsphere\traffic\algorithm\traffic\transaction\FirstSQLTrafficAlgorithmTest.java,0,13,0,4,0,17
 shardingsphere-master\shardingsphere-master\shardingsphere-db-protocol\shardingsphere-db-protocol-mysql\src\test\java\org\apache\shardingsphere\db\protocol\mysql\packet\generic\MySQLErrPacketTest.java,0,21,0,13,0,34
 shardingsphere-master\shardingsphere-master\shardingsphere-sql-parser\shardingsphere-sql-parser-statement\src\main\java\org\apache\shardingsphere\sql\parser\sql\dialect\statement\mysql\segment\ResetMasterOptionSegment.java,0,3,0,3,0,6
 shardingsphere-master\shardingsphere-master\shardingsphere-kernel\shardingsphere-single-table\shardingsphere-single-table-core\src\test\java\org\apache\shardingsphere\singletable\route\SingleTableRouteEngineTest.java,0,42,0,32,0,74
 shardingsphere-master\shardingsphere-master\shardingsphere-features\shardingsphere-encrypt\shardingsphere-encrypt-core\src\test\java\org\apache\shardingsphere\encrypt\merge\dql\EncryptDQLResultDecoratorTest.java,0,8,0,6,0,14
 shardingsphere-master\shardingsphere-master\shardingsphere-infra\shardingsphere-infra-executor\src\main\java\org\apache\shardingsphere\infra\executor\sql\execute\engine\ConnectionMode.java,0,4,0,1,0,5
 shardingsphere-master\shardingsphere-master\examples\shardingsphere-jdbc-example\single-feature-example\extension-example\custom-sharding-algortihm-example\class-based-sharding-algorithm-example\class-based-sharding-spring-namespace-mybatis-example\src\main\java\org\apache\shardingsphere\example\extension\classbased\sharding\spring\namespace\mybatis\ClassBasedShardingSpringNamespaceExample.java,0,9,1,7,0,17
 shardingsphere-master\shardingsphere-master\shardingsphere-infra\shardingsphere-infra-common\src\main\java\org\apache\shardingsphere\infra\rule\ShardingSphereRule.java,0,2,0,1,0,3
 shardingsphere-master\shardingsphere-master\shardingsphere-infra\shardingsphere-infra-context\src\main\java\org\apache\shardingsphere\infra\context\refresher\type\CreateViewStatementSchemaRefresher.java,0,13,0,13,0,26
 shardingsphere-master\shardingsphere-master\shardingsphere-db-protocol\shardingsphere-db-protocol-postgresql\src\main\java\org\apache\shardingsphere\db\protocol\postgresql\packet\command\PostgreSQLCommandPacket.java,0,2,1,3,0,6
 shardingsphere-master\shardingsphere-master\shardingsphere-sql-parser\shardingsphere-sql-parser-statement\src\main\java\org\apache\shardingsphere\sql\parser\sql\common\segment\ddl\table\ConvertTableDefinitionSegment.java,0,10,0,5,0,15
 shardingsphere-master\shardingsphere-master\shardingsphere-features\shardingsphere-sharding\shardingsphere-sharding-distsql\shardingsphere-sharding-distsql-handler\src\test\java\org\apache\shardingsphere\sharding\distsql\query\ShardingTableNodesQueryResultSetTest.java,0,24,0,23,0,47
 shardingsphere-master\shardingsphere-master\shardingsphere-infra\shardingsphere-infra-route\src\main\java\org\apache\shardingsphere\infra\route\context\RouteContext.java,0,36,0,18,0,54
 shardingsphere-master\shardingsphere-master\shardingsphere-test\shardingsphere-parser-test\src\main\java\org\apache\shardingsphere\test\sql\parser\parameterized\jaxb\cases\domain\statement\distsql\rdl\drop\DropReadwriteSplittingRuleStatementTestCase.java,0,3,0,4,0,7
 shardingsphere-master\shardingsphere-master\shardingsphere-sql-parser\shardingsphere-sql-parser-statement\src\main\java\org\apache\shardingsphere\sql\parser\sql\dialect\statement\postgresql\dml\PostgreSQLUpdateStatement.java,0,1,0,5,0,6
 shardingsphere-master\shardingsphere-master\shardingsphere-kernel\shardingsphere-data-pipeline\shardingsphere-data-pipeline-spi\src\main\java\org\apache\shardingsphere\data\pipeline\api\ingest\position\FinishedPosition.java,0,3,0,2,0,5
 shardingsphere-master\shardingsphere-master\shardingsphere-sql-parser\shardingsphere-sql-parser-statement\src\main\java\org\apache\shardingsphere\sql\parser\sql\common\segment\generic\AliasAvailable.java,0,2,0,1,0,3
 shardingsphere-master\shardingsphere-master\shardingsphere-features\shardingsphere-sharding\shardingsphere-sharding-core\src\main\java\org\apache\shardingsphere\sharding\merge\dql\groupby\aggregation\BitXorAggregationUnit.java,0,4,0,1,0,5
 shardingsphere-master\shardingsphere-master\shardingsphere-agent\shardingsphere-agent-core\src\main\java\org\apache\shardingsphere\agent\core\spi\PluginServiceLoader.java,0,4,0,3,0,7
 shardingsphere-master\shardingsphere-master\shardingsphere-infra\shardingsphere-infra-executor\src\main\java\org\apache\shardingsphere\infra\executor\sql\prepare\driver\jdbc\ExecutorJDBCStatementManager.java,0,1,0,3,0,4
 shardingsphere-master\shardingsphere-master\shardingsphere-kernel\shardingsphere-single-table\shardingsphere-single-table-api\src\main\java\org\apache\shardingsphere\singletable\config\SingleTableRuleConfiguration.java,0,5,0,3,0,8
 shardingsphere-master\shardingsphere-master\shardingsphere-sql-parser\shardingsphere-sql-parser-statement\src\main\java\org\apache\shardingsphere\sql\parser\sql\dialect\statement\mysql\dcl\MySQLCreateUserStatement.java,0,9,0,7,8,24
 shardingsphere-master\shardingsphere-master\shardingsphere-sql-parser\shardingsphere-sql-parser-statement\src\main\java\org\apache\shardingsphere\sql\parser\sql\dialect\statement\mysql\dal\MySQLChecksumTableStatement.java,0,3,0,6,1,10
 shardingsphere-master\shardingsphere-master\shardingsphere-test\shardingsphere-parser-test\src\main\java\org\apache\shardingsphere\test\sql\parser\parameterized\asserts\statement\distsql\rql\impl\rule\ShowShardingTableNodesStatementAssert.java,0,9,0,13,0,22
 shardingsphere-master\shardingsphere-master\shardingsphere-distsql\shardingsphere-distsql-statement\src\main\java\org\apache\shardingsphere\distsql\parser\statement\ral\common\queryable\ShowSQLParserRuleStatement.java,0,0,0,2,0,2
 shardingsphere-master\shardingsphere-master\shardingsphere-features\shardingsphere-sharding\shardingsphere-sharding-core\src\main\java\org\apache\shardingsphere\sharding\route\engine\type\broadcast\ShardingTableBroadcastRoutingEngine.java,0,38,0,26,0,64
 shardingsphere-master\shardingsphere-master\shardingsphere-db-protocol\shardingsphere-db-protocol-postgresql\src\test\java\org\apache\shardingsphere\db\protocol\postgresql\packet\command\query\extended\bind\protocol\PostgreSQLTextTimestampUtilsTest.java,0,27,0,21,0,48
 shardingsphere-master\shardingsphere-master\shardingsphere-kernel\shardingsphere-data-pipeline\shardingsphere-data-pipeline-core\src\main\java\org\apache\shardingsphere\data\pipeline\core\spi\check\consistency\AbstractDataConsistencyCheckAlgorithm.java,32,15,1,7,0,23
 shardingsphere-master\shardingsphere-master\shardingsphere-test\shardingsphere-integration-test\shardingsphere-integration-test-suite\src\test\java\org\apache\shardingsphere\test\integration\cases\dataset\DataSet.java,0,19,0,9,0,28
 shardingsphere-master\shardingsphere-master\shardingsphere-features\shardingsphere-db-discovery\shardingsphere-db-discovery-distsql\shardingsphere-db-discovery-distsql-parser\src\main\java\org\apache\shardingsphere\dbdiscovery\distsql\parser\core\DatabaseDiscoveryDistSQLStatementVisitor.java,0,65,0,84,0,149
 shardingsphere-master\shardingsphere-master\shardingsphere-proxy\shardingsphere-proxy-backend\src\test\java\org\apache\shardingsphere\proxy\backend\response\header\query\impl\MySQLQueryHeaderBuilderTest.java,0,74,0,39,0,113
 shardingsphere-master\shardingsphere-master\examples\shardingsphere-example-generator\src\main\java\org\apache\shardingsphere\example\generator\scenario\framework\type\SpringBootStarterJpaExampleScenario.java,0,12,0,8,0,20
 shardingsphere-master\shardingsphere-master\shardingsphere-test\shardingsphere-parser-test\src\main\java\org\apache\shardingsphere\test\sql\parser\parameterized\asserts\statement\distsql\ral\impl\scaling\update\ApplyScalingStatementAssert.java,0,12,1,13,0,26
 shardingsphere-master\shardingsphere-master\shardingsphere-proxy\shardingsphere-proxy-frontend\shardingsphere-proxy-frontend-core\src\main\java\org\apache\shardingsphere\proxy\frontend\state\ProxyStateContext.java,0,13,0,9,0,22
 shardingsphere-master\shardingsphere-master\shardingsphere-features\shardingsphere-sharding\shardingsphere-sharding-core\src\test\java\org\apache\shardingsphere\sharding\checker\AlgorithmProvidedShardingRuleConfigurationCheckerTest.java,0,18,0,17,0,35
 shardingsphere-master\shardingsphere-master\shardingsphere-mode\shardingsphere-mode-type\shardingsphere-standalone-mode\shardingsphere-standalone-mode-core\src\main\java\org\apache\shardingsphere\mode\manager\standalone\lock\ShardingSphereNonReentrantLock.java,0,15,1,3,0,19
 shardingsphere-master\shardingsphere-master\shardingsphere-kernel\shardingsphere-parser\shardingsphere-parser-spring\shardingsphere-parser-spring-boot-starter\src\main\java\org\apache\shardingsphere\parser\spring\boot\rule\YamlSQLParserRuleSpringBootConfiguration.java,0,3,0,2,0,5
 shardingsphere-master\shardingsphere-master\shardingsphere-jdbc\shardingsphere-jdbc-core\src\test\java\org\apache\shardingsphere\driver\jdbc\unsupported\UnsupportedOperationResultSetTest.java,0,73,0,3,0,76
 shardingsphere-master\shardingsphere-master\shardingsphere-test\shardingsphere-parser-test\src\main\java\org\apache\shardingsphere\test\sql\parser\parameterized\jaxb\cases\domain\statement\ddl\DropDimensionStatementTestCase.java,0,0,0,3,0,3
 shardingsphere-master\shardingsphere-master\shardingsphere-db-protocol\shardingsphere-db-protocol-postgresql\src\test\java\org\apache\shardingsphere\db\protocol\postgresql\packet\command\query\extended\bind\protocol\PostgreSQLBinaryTimestampUtilsTest.java,0,15,0,6,0,21
 shardingsphere-master\shardingsphere-master\shardingsphere-db-protocol\shardingsphere-db-protocol-mysql\src\test\java\org\apache\shardingsphere\db\protocol\mysql\packet\binlog\row\column\value\string\MySQLJsonValueDecoderTest.java,0,158,0,68,0,226
 shardingsphere-master\shardingsphere-master\shardingsphere-features\shardingsphere-sharding\shardingsphere-sharding-core\src\test\java\org\apache\shardingsphere\sharding\rewrite\token\pojo\ShardingTokenGenerateBuilderTest.java,0,21,1,18,0,40
 shardingsphere-master\shardingsphere-master\shardingsphere-infra\shardingsphere-infra-common\src\main\java\org\apache\shardingsphere\infra\yaml\engine\representer\processor\DefaultYamlTupleProcessor.java,0,12,0,4,0,16
 shardingsphere-master\shardingsphere-master\shardingsphere-features\shardingsphere-sharding\shardingsphere-sharding-core\src\test\java\org\apache\shardingsphere\sharding\merge\dal\common\SingleLocalDataMergedResultTest.java,0,16,0,7,0,23
 shardingsphere-master\shardingsphere-master\shardingsphere-agent\shardingsphere-agent-core\src\main\java\org\apache\shardingsphere\agent\core\plugin\PluginContext.java,0,5,1,2,0,8
 shardingsphere-master\shardingsphere-master\shardingsphere-proxy\shardingsphere-proxy-backend\src\main\java\org\apache\shardingsphere\proxy\backend\text\distsql\ral\common\hint\HintSourceType.java,0,8,0,2,0,10
 shardingsphere-master\shardingsphere-master\shardingsphere-test\shardingsphere-parser-test\src\main\java\org\apache\shardingsphere\test\sql\parser\parameterized\asserts\statement\distsql\rdl\alter\impl\DisableShardingScalingRuleStatementAssert.java,0,9,0,11,0,20
 shardingsphere-master\shardingsphere-master\shardingsphere-proxy\shardingsphere-proxy-backend\src\main\java\org\apache\shardingsphere\proxy\backend\util\TransactionUtil.java,0,3,0,4,0,7
 shardingsphere-master\shardingsphere-master\shardingsphere-sql-parser\shardingsphere-sql-parser-statement\src\main\java\org\apache\shardingsphere\sql\parser\sql\common\segment\dml\order\GroupBySegment.java,0,7,0,2,2,11
 shardingsphere-master\shardingsphere-master\shardingsphere-features\shardingsphere-sharding\shardingsphere-sharding-spring\shardingsphere-sharding-spring-namespace\src\test\java\org\apache\shardingsphere\sharding\spring\namespace\fixture\sharding\ComplexKeysShardingAlgorithmFixture.java,0,6,1,5,0,12
 shardingsphere-master\shardingsphere-master\shardingsphere-features\shardingsphere-sharding\shardingsphere-sharding-core\src\main\java\org\apache\shardingsphere\sharding\route\engine\exception\NoSuchTableException.java,0,7,0,1,0,8
 shardingsphere-master\shardingsphere-master\shardingsphere-sql-parser\shardingsphere-sql-parser-statement\src\main\java\org\apache\shardingsphere\sql\parser\sql\dialect\statement\postgresql\ddl\PostgreSQLAlterCollationStatement.java,0,1,0,6,0,7
 shardingsphere-master\shardingsphere-master\shardingsphere-kernel\shardingsphere-data-pipeline\shardingsphere-data-pipeline-spi\src\main\java\org\apache\shardingsphere\data\pipeline\api\job\RuleAlteredJobId.java,0,17,0,9,0,26
 shardingsphere-master\shardingsphere-master\shardingsphere-test\shardingsphere-parser-test\src\main\java\org\apache\shardingsphere\test\sql\parser\parameterized\jaxb\cases\domain\segment\impl\distsql\rdl\sharding\scaling\ExpectedInputOrOutputSegment.java,0,5,0,5,0,10
 shardingsphere-master\shardingsphere-master\shardingsphere-test\shardingsphere-parser-test\src\main\java\org\apache\shardingsphere\test\sql\parser\parameterized\jaxb\cases\domain\segment\impl\expr\ExpectedListExpression.java,0,3,0,4,0,7
 shardingsphere-master\shardingsphere-master\shardingsphere-spi\src\test\java\org\apache\shardingsphere\spi\fixture\required\RequiredSPIImpl.java,0,0,0,1,0,1
 shardingsphere-master\shardingsphere-master\shardingsphere-db-protocol\shardingsphere-db-protocol-mysql\src\test\java\org\apache\shardingsphere\db\protocol\mysql\packet\command\query\binary\close\MySQLComStmtClosePacketTest.java,0,7,0,2,0,9
 shardingsphere-master\shardingsphere-master\shardingsphere-kernel\shardingsphere-data-pipeline\shardingsphere-data-pipeline-dialect\shardingsphere-data-pipeline-mysql\src\test\java\org\apache\shardingsphere\data\pipeline\mysql\ingest\client\netty\MySQLNegotiatePackageDecoderTest.java,0,46,0,25,0,71
 shardingsphere-master\shardingsphere-master\shardingsphere-infra\shardingsphere-infra-binder\src\main\java\org\apache\shardingsphere\infra\binder\segment\select\pagination\engine\PaginationContextEngine.java,0,18,0,26,0,44
 shardingsphere-master\shardingsphere-master\shardingsphere-sql-parser\shardingsphere-sql-parser-statement\src\main\java\org\apache\shardingsphere\sql\parser\sql\common\value\parametermarker\ParameterMarkerValue.java,0,5,0,2,0,7
 shardingsphere-master\shardingsphere-master\shardingsphere-test\shardingsphere-parser-test\src\main\java\org\apache\shardingsphere\test\sql\parser\parameterized\jaxb\cases\domain\SQLParserTestCases.java,0,893,0,602,0,1495
 shardingsphere-master\shardingsphere-master\shardingsphere-test\shardingsphere-parser-test\src\main\java\org\apache\shardingsphere\test\sql\parser\parameterized\jaxb\cases\domain\segment\impl\distsql\rdl\ExpectedDatabaseDiscoveryHeartbeat.java,0,5,0,5,0,10
 shardingsphere-master\shardingsphere-master\shardingsphere-proxy\shardingsphere-proxy-backend\src\test\java\org\apache\shardingsphere\proxy\backend\text\distsql\ral\common\updatable\AlterTrafficRuleHandlerTest.java,0,42,0,36,0,78
 shardingsphere-master\shardingsphere-master\shardingsphere-features\shardingsphere-readwrite-splitting\shardingsphere-readwrite-splitting-spring\shardingsphere-readwrite-splitting-spring-boot-starter\src\test\java\org\apache\shardingsphere\readwritesplitting\spring\boot\ReadwriteSplittingSpringBootStarterTest.java,30,12,0,7,0,19
 shardingsphere-master\shardingsphere-master\shardingsphere-jdbc\shardingsphere-jdbc-core\src\main\java\org\apache\shardingsphere\driver\executor\DriverExecutor.java,0,17,0,10,0,27
 shardingsphere-master\shardingsphere-master\shardingsphere-features\shardingsphere-readwrite-splitting\shardingsphere-readwrite-splitting-core\src\main\java\org\apache\shardingsphere\readwritesplitting\yaml\swapper\ReadwriteSplittingRuleAlgorithmProviderConfigurationYamlSwapper.java,0,23,0,23,0,46
 shardingsphere-master\shardingsphere-master\shardingsphere-test\shardingsphere-parser-test\src\main\java\org\apache\shardingsphere\test\sql\parser\parameterized\jaxb\cases\domain\statement\distsql\rdl\alter\AlterShardingKeyGeneratorStatementTestCase.java,0,4,0,6,0,10
 shardingsphere-master\shardingsphere-master\shardingsphere-features\shardingsphere-sharding\shardingsphere-sharding-distsql\shardingsphere-sharding-distsql-handler\src\test\java\org\apache\shardingsphere\sharding\distsql\query\ShardingBroadcastTableRuleQueryResultSetTest.java,0,8,0,8,0,16
 shardingsphere-master\shardingsphere-master\shardingsphere-proxy\shardingsphere-proxy-frontend\shardingsphere-proxy-frontend-postgresql\src\test\java\org\apache\shardingsphere\proxy\frontend\postgresql\command\query\extended\parse\PostgreSQLComParseExecutorTest.java,0,41,1,28,0,70
 shardingsphere-master\shardingsphere-master\shardingsphere-features\shardingsphere-encrypt\shardingsphere-encrypt-core\src\main\java\org\apache\shardingsphere\encrypt\rewrite\token\generator\EncryptProjectionTokenGenerator.java,0,95,1,86,0,182
 shardingsphere-master\shardingsphere-master\shardingsphere-sql-parser\shardingsphere-sql-parser-statement\src\main\java\org\apache\shardingsphere\sql\parser\sql\dialect\statement\postgresql\ddl\PostgreSQLDropSequenceStatement.java,0,1,0,5,0,6
 shardingsphere-master\shardingsphere-master\shardingsphere-kernel\shardingsphere-data-pipeline\shardingsphere-data-pipeline-dialect\shardingsphere-data-pipeline-opengauss\src\test\java\org\apache\shardingsphere\data\pipeline\opengauss\ingest\wal\decode\MppdbDecodingPluginTest.java,0,71,0,49,0,120
 shardingsphere-master\shardingsphere-master\shardingsphere-test\shardingsphere-parser-test\src\main\java\org\apache\shardingsphere\test\sql\parser\parameterized\jaxb\cases\domain\statement\dal\ShowReplicaStatusStatementTestCase.java,0,3,0,4,0,7
 shardingsphere-master\shardingsphere-master\shardingsphere-kernel\shardingsphere-traffic\shardingsphere-traffic-core\src\main\java\org\apache\shardingsphere\traffic\rule\TrafficRule.java,0,62,0,48,0,110
 shardingsphere-master\shardingsphere-master\examples\shardingsphere-proxy-example\shardingsphere-proxy-hint-example\src\main\java\org\apache\shardingsphere\example\proxy\hint\ModuloHintShardingAlgorithm.java,0,5,1,4,0,10
 shardingsphere-master\shardingsphere-master\shardingsphere-features\shardingsphere-encrypt\shardingsphere-encrypt-distsql\shardingsphere-encrypt-distsql-handler\src\main\java\org\apache\shardingsphere\encrypt\distsql\handler\update\CreateEncryptRuleStatementUpdater.java,0,31,0,31,0,62
 shardingsphere-master\shardingsphere-master\shardingsphere-sql-parser\shardingsphere-sql-parser-statement\src\main\java\org\apache\shardingsphere\sql\parser\sql\common\statement\ddl\AlterAggregateStatement.java,3,2,1,3,0,6
 shardingsphere-master\shardingsphere-master\shardingsphere-proxy\shardingsphere-proxy-backend\src\main\java\org\apache\shardingsphere\proxy\backend\text\admin\postgresql\PostgreSQLAdminExecutorFactory.java,0,37,1,31,0,69
 shardingsphere-master\shardingsphere-master\shardingsphere-proxy\shardingsphere-proxy-frontend\shardingsphere-proxy-frontend-mysql\src\main\java\org\apache\shardingsphere\proxy\frontend\mysql\command\query\exception\UnknownCharacterSetException.java,0,4,0,1,0,5
 shardingsphere-master\shardingsphere-master\shardingsphere-proxy\shardingsphere-proxy-frontend\shardingsphere-proxy-frontend-postgresql\src\test\java\org\apache\shardingsphere\proxy\frontend\postgresql\command\query\extended\PostgreSQLAggregatedCommandExecutorTest.java,0,7,0,8,0,15
 shardingsphere-master\shardingsphere-master\shardingsphere-sql-parser\shardingsphere-sql-parser-statement\src\main\java\org\apache\shardingsphere\sql\parser\sql\dialect\statement\opengauss\ddl\OpenGaussAlterMaterializedViewStatement.java,0,1,0,5,0,6
 shardingsphere-master\shardingsphere-master\shardingsphere-features\shardingsphere-readwrite-splitting\shardingsphere-readwrite-splitting-core\src\main\java\org\apache\shardingsphere\readwritesplitting\yaml\swapper\ReadwriteSplittingRuleConfigurationYamlSwapper.java,0,26,0,25,0,51
 shardingsphere-master\shardingsphere-master\shardingsphere-test\shardingsphere-parser-test\src\main\java\org\apache\shardingsphere\test\sql\parser\parameterized\jaxb\cases\domain\segment\impl\output\ExpectedOutputTableColumn.java,0,3,0,5,0,8
 shardingsphere-master\shardingsphere-master\shardingsphere-sql-parser\shardingsphere-sql-parser-statement\src\main\java\org\apache\shardingsphere\sql\parser\sql\dialect\statement\mysql\dcl\MySQLGrantStatement.java,0,12,0,9,2,23
 shardingsphere-master\shardingsphere-master\shardingsphere-proxy\shardingsphere-proxy-backend\src\main\java\org\apache\shardingsphere\proxy\backend\text\admin\mysql\MySQLInformationSchemaExecutorFactory.java,0,10,2,10,0,22
 shardingsphere-master\shardingsphere-master\shardingsphere-proxy\shardingsphere-proxy-frontend\shardingsphere-proxy-frontend-postgresql\src\main\java\org\apache\shardingsphere\proxy\frontend\postgresql\authentication\authenticator\PostgreSQLAuthenticator.java,0,4,0,3,0,7
 shardingsphere-master\shardingsphere-master\shardingsphere-features\shardingsphere-encrypt\shardingsphere-encrypt-core\src\main\java\org\apache\shardingsphere\encrypt\rewrite\parameter\rewriter\EncryptPredicateParameterRewriter.java,0,24,0,16,0,40
 shardingsphere-master\shardingsphere-master\shardingsphere-distsql\shardingsphere-distsql-statement\src\main\java\org\apache\shardingsphere\distsql\parser\statement\ral\common\queryable\ShowInstanceStatement.java,0,0,0,2,0,2
 shardingsphere-master\shardingsphere-master\examples\shardingsphere-proxy-example\shardingsphere-proxy-distsql-example\src\main\java\org\apache\shardingsphere\example\proxy\distsql\hint\AbstractHintExecutor.java,17,8,0,2,0,10
 shardingsphere-master\shardingsphere-master\shardingsphere-features\shardingsphere-db-discovery\shardingsphere-db-discovery-core\src\test\java\org\apache\shardingsphere\dbdiscovery\yaml\swapper\YamlRootRuleConfigurationsForYamlDatabaseDiscoveryRuleConfigurationTest.java,0,19,0,14,0,33
 shardingsphere-master\shardingsphere-master\shardingsphere-db-protocol\shardingsphere-db-protocol-postgresql\src\main\java\org\apache\shardingsphere\db\protocol\postgresql\constant\PostgreSQLArrayColumnType.java,0,90,0,3,0,93
 shardingsphere-master\shardingsphere-master\shardingsphere-spi\src\test\java\org\apache\shardingsphere\spi\fixture\required\RequiredSingletonSPIFixture.java,0,1,0,2,0,3
 shardingsphere-master\shardingsphere-master\shardingsphere-proxy\shardingsphere-proxy-backend\src\main\java\org\apache\shardingsphere\proxy\backend\text\distsql\rql\rule\RulesUsedResourceQueryResultSet.java,0,55,1,28,0,84
 shardingsphere-master\shardingsphere-master\shardingsphere-proxy\shardingsphere-proxy-backend\src\test\java\org\apache\shardingsphere\proxy\backend\text\database\CreateDatabaseBackendHandlerTest.java,0,16,0,7,0,23
 shardingsphere-master\shardingsphere-master\shardingsphere-test\shardingsphere-rewrite-test\src\test\java\org\apache\shardingsphere\sharding\rewrite\fixture\StandardShardingAlgorithmFixture.java,0,8,1,8,0,17
 shardingsphere-master\shardingsphere-master\shardingsphere-infra\shardingsphere-infra-binder\src\main\java\org\apache\shardingsphere\infra\binder\segment\select\projection\ProjectionsContext.java,0,39,2,16,0,57
 shardingsphere-master\shardingsphere-master\examples\shardingsphere-jdbc-example\mixed-feature-example\sharding-readwrite-splitting-example\sharding-readwrite-splitting-raw-jdbc-example\src\main\java\org\apache\shardingsphere\example\sharding\readwrite\splitting\raw\ShardingReadwriteSplittingRawJavaConfigurationExample.java,0,10,1,5,0,16
 shardingsphere-master\shardingsphere-master\shardingsphere-features\shardingsphere-sharding\shardingsphere-sharding-distsql\shardingsphere-sharding-distsql-handler\src\main\java\org\apache\shardingsphere\sharding\distsql\handler\query\ShardingTableRulesUsedKeyGeneratorQueryResultSet.java,0,19,0,13,0,32
 shardingsphere-master\shardingsphere-master\shardingsphere-features\shardingsphere-sharding\shardingsphere-sharding-distsql\shardingsphere-sharding-distsql-statement\src\main\java\org\apache\shardingsphere\scaling\distsql\statement\CheckScalingStatement.java,0,4,0,2,0,6
 shardingsphere-master\shardingsphere-master\shardingsphere-infra\shardingsphere-infra-executor\src\main\java\org\apache\shardingsphere\infra\executor\sql\prepare\driver\vertx\ExecutorVertxConnectionManager.java,0,2,0,3,0,5
 shardingsphere-master\shardingsphere-master\shardingsphere-db-protocol\shardingsphere-db-protocol-mysql\src\test\java\org\apache\shardingsphere\db\protocol\mysql\packet\binlog\management\MySQLBinlogRotateEventPacketTest.java,0,14,0,4,0,18
 shardingsphere-master\shardingsphere-master\shardingsphere-kernel\shardingsphere-data-pipeline\shardingsphere-data-pipeline-core\src\main\java\org\apache\shardingsphere\data\pipeline\core\metadata\model\PipelineTableMetaData.java,0,24,0,8,0,32
 shardingsphere-master\shardingsphere-master\shardingsphere-agent\shardingsphere-agent-plugins\shardingsphere-agent-plugin-tracing\shardingsphere-agent-tracing-opentelemetry\src\main\java\org\apache\shardingsphere\agent\plugin\tracing\opentelemetry\definition\OpenTelemetryTracingPluginDefinitionService.java,46,24,0,13,0,37
 shardingsphere-master\shardingsphere-master\shardingsphere-sql-parser\shardingsphere-sql-parser-statement\src\main\java\org\apache\shardingsphere\sql\parser\sql\dialect\statement\postgresql\dml\PostgreSQLCopyStatement.java,0,1,0,5,0,6
 shardingsphere-master\shardingsphere-master\shardingsphere-test\shardingsphere-parser-test\src\main\java\org\apache\shardingsphere\test\sql\parser\parameterized\jaxb\cases\domain\statement\ddl\AlterMaterializedViewStatementTestCase.java,0,1,0,4,0,5
 shardingsphere-master\shardingsphere-master\shardingsphere-sql-parser\shardingsphere-sql-parser-statement\src\main\java\org\apache\shardingsphere\sql\parser\sql\dialect\statement\mysql\ddl\MySQLCreateDatabaseStatement.java,0,1,0,4,0,5
 shardingsphere-master\shardingsphere-master\shardingsphere-sql-parser\shardingsphere-sql-parser-engine\src\test\java\org\apache\shardingsphere\sql\parser\fixture\LexerFixture.java,0,5,0,1,0,6
 shardingsphere-master\shardingsphere-master\shardingsphere-test\shardingsphere-parser-test\src\main\java\org\apache\shardingsphere\test\sql\parser\parameterized\asserts\statement\dcl\impl\AlterUserStatementAssert.java,0,4,1,6,0,11
 shardingsphere-master\shardingsphere-master\shardingsphere-kernel\shardingsphere-data-pipeline\shardingsphere-data-pipeline-core\src\main\java\org\apache\shardingsphere\data\pipeline\core\ingest\position\PositionInitializerFactory.java,0,8,0,5,0,13
 shardingsphere-master\shardingsphere-master\shardingsphere-test\shardingsphere-parser-test\src\main\java\org\apache\shardingsphere\test\sql\parser\parameterized\jaxb\cases\domain\statement\distsql\rql\ShowShardingBroadcastTableRulesStatementTestCase.java,0,3,0,5,0,8
 shardingsphere-master\shardingsphere-master\shardingsphere-db-protocol\shardingsphere-db-protocol-opengauss\src\test\java\org\apache\shardingsphere\db\protocol\opengauss\packet\command\OpenGaussCommandPacketFactoryTest.java,0,9,0,7,0,16
 shardingsphere-master\shardingsphere-master\shardingsphere-agent\shardingsphere-agent-plugins\shardingsphere-agent-plugin-metrics\shardingsphere-agent-metrics-prometheus\src\main\java\org\apache\shardingsphere\agent\metrics\prometheus\wrapper\HistogramWrapper.java,0,4,0,1,0,5
 shardingsphere-master\shardingsphere-master\shardingsphere-features\shardingsphere-sharding\shardingsphere-sharding-distsql\shardingsphere-sharding-distsql-handler\src\main\java\org\apache\shardingsphere\sharding\distsql\handler\update\DropShardingBroadcastTableRuleStatementUpdater.java,0,23,0,19,0,42
 shardingsphere-master\shardingsphere-master\examples\shardingsphere-jdbc-example\single-feature-example\extension-example\custom-sharding-algortihm-example\spi-based-sharding-algorithm-example\spi-based-sharding-raw-jdbc-example\src\main\java\org\apache\shardingsphere\example\extension\spibased\sharding\raw\jdbc\SPIBasedShardingRawYamlConfigurationExample.java,0,9,1,4,0,14
 shardingsphere-master\shardingsphere-master\shardingsphere-kernel\shardingsphere-transaction\shardingsphere-transaction-core\src\main\java\org\apache\shardingsphere\transaction\yaml\swapper\TransactionRuleConfigurationYamlSwapper.java,0,11,0,9,0,20
 shardingsphere-master\shardingsphere-master\shardingsphere-jdbc\shardingsphere-jdbc-spring\shardingsphere-jdbc-spring-infra\shardingsphere-jdbc-spring-boot-starter-infra\src\test\java\org\apache\shardingsphere\spring\boot\schema\SchemaNameSetterTest.java,0,4,0,2,0,6
 shardingsphere-master\shardingsphere-master\shardingsphere-test\shardingsphere-pipeline-test\src\test\java\org\apache\shardingsphere\data\pipeline\core\fixture\FixtureDataSourceChecker.java,0,9,4,6,0,19
 shardingsphere-master\shardingsphere-master\shardingsphere-test\shardingsphere-integration-test\shardingsphere-integration-test-suite\src\test\java\org\apache\shardingsphere\test\integration\framework\param\model\AssertionParameterizedArray.java,0,15,0,4,0,19
 shardingsphere-master\shardingsphere-master\shardingsphere-jdbc\shardingsphere-jdbc-spring\shardingsphere-jdbc-core-spring\shardingsphere-jdbc-core-spring-namespace\src\test\java\org\apache\shardingsphere\spring\namespace\StandaloneModeSpringNamespaceTest.java,0,2,0,3,0,5
 shardingsphere-master\shardingsphere-master\shardingsphere-infra\shardingsphere-infra-common\src\test\java\org\apache\shardingsphere\infra\metadata\ShardingSphereMetaDataTest.java,0,16,0,10,0,26
 shardingsphere-master\shardingsphere-master\shardingsphere-agent\shardingsphere-agent-plugins\shardingsphere-agent-plugin-tracing\shardingsphere-agent-tracing-opentracing\src\main\java\org\apache\shardingsphere\agent\plugin\tracing\opentracing\service\OpenTracingPluginBootService.java,0,9,1,5,0,15
 shardingsphere-master\shardingsphere-master\shardingsphere-sql-parser\shardingsphere-sql-parser-statement\src\main\java\org\apache\shardingsphere\sql\parser\sql\common\segment\dal\VariableSegment.java,0,8,0,1,0,9
 shardingsphere-master\shardingsphere-master\shardingsphere-db-protocol\shardingsphere-db-protocol-mysql\src\test\java\org\apache\shardingsphere\db\protocol\mysql\packet\command\query\text\query\MySQLComQueryPacketTest.java,0,7,0,3,0,10
 shardingsphere-master\shardingsphere-master\shardingsphere-features\shardingsphere-shadow\shardingsphere-shadow-api\src\main\java\org\apache\shardingsphere\shadow\api\shadow\ShadowOperationType.java,0,8,0,2,0,10
 shardingsphere-master\shardingsphere-master\shardingsphere-db-protocol\shardingsphere-db-protocol-opengauss\src\main\java\org\apache\shardingsphere\db\protocol\opengauss\packet\command\OpenGaussCommandPacket.java,3,1,1,2,0,4
 shardingsphere-master\shardingsphere-master\shardingsphere-test\shardingsphere-parser-test\src\main\java\org\apache\shardingsphere\test\sql\parser\parameterized\jaxb\cases\domain\statement\tcl\XATestCase.java,0,0,0,3,0,3
 shardingsphere-master\shardingsphere-master\shardingsphere-infra\shardingsphere-infra-executor\src\main\java\org\apache\shardingsphere\infra\executor\kernel\model\ExecutorDataMap.java,0,5,0,2,0,7
 shardingsphere-master\shardingsphere-master\shardingsphere-test\shardingsphere-rewrite-test\src\test\java\org\apache\shardingsphere\sharding\rewrite\parameterized\engine\parameter\SQLRewriteEngineTestParametersBuilder.java,0,36,2,29,0,67
 shardingsphere-master\shardingsphere-master\shardingsphere-test\shardingsphere-optimize-test\src\test\java\org\apache\shardingsphere\infra\federation\converter\parameterized\engine\SQLNodeConvertEngineParameterizedTest.java,0,66,1,40,0,107
 shardingsphere-master\shardingsphere-master\shardingsphere-sql-parser\shardingsphere-sql-parser-dialect\shardingsphere-sql-parser-oracle\src\main\java\org\apache\shardingsphere\sql\parser\oracle\visitor\statement\impl\OracleDALStatementSQLVisitor.java,0,4,0,3,0,7
 shardingsphere-master\shardingsphere-master\shardingsphere-kernel\shardingsphere-transaction\shardingsphere-transaction-core\src\main\java\org\apache\shardingsphere\transaction\ConnectionTransaction.java,0,38,3,11,0,52
 shardingsphere-master\shardingsphere-master\shardingsphere-proxy\shardingsphere-proxy-backend\src\test\java\org\apache\shardingsphere\proxy\backend\exception\fixture\TestSQLStatementContextInstanceOfTableAvailable.java,0,7,0,3,0,10
 shardingsphere-master\shardingsphere-master\shardingsphere-features\shardingsphere-sharding\shardingsphere-sharding-core\src\test\java\org\apache\shardingsphere\sharding\rule\ShardingRuleTest.java,0,348,0,233,0,581
 shardingsphere-master\shardingsphere-master\shardingsphere-sql-parser\shardingsphere-sql-parser-statement\src\main\java\org\apache\shardingsphere\sql\parser\sql\dialect\statement\postgresql\ddl\PostgreSQLAlterProcedureStatement.java,0,1,0,5,0,6
 shardingsphere-master\shardingsphere-master\shardingsphere-test\shardingsphere-integration-test\shardingsphere-integration-test-suite\src\test\java\org\apache\shardingsphere\test\integration\framework\container\atomic\adapter\impl\ShardingSphereJDBCContainer.java,0,26,1,21,0,48
 shardingsphere-master\shardingsphere-master\shardingsphere-sql-parser\shardingsphere-sql-parser-dialect\shardingsphere-sql-parser-postgresql\src\main\java\org\apache\shardingsphere\sql\parser\postgresql\visitor\statement\impl\PostgreSQLStatementSQLVisitor.java,975,330,3,338,0,671
 shardingsphere-master\shardingsphere-master\shardingsphere-sql-parser\shardingsphere-sql-parser-statement\src\main\java\org\apache\shardingsphere\sql\parser\sql\dialect\statement\opengauss\ddl\OpenGaussDropViewStatement.java,0,1,0,5,0,6
 shardingsphere-master\shardingsphere-master\shardingsphere-sql-parser\shardingsphere-sql-parser-statement\src\main\java\org\apache\shardingsphere\sql\parser\sql\dialect\statement\opengauss\ddl\OpenGaussCreateSequenceStatement.java,0,1,0,5,0,6
 shardingsphere-master\shardingsphere-master\shardingsphere-agent\shardingsphere-agent-core\src\test\java\org\apache\shardingsphere\agent\core\mock\material\RepeatedAdviceMaterial.java,14,1,0,1,0,2
 shardingsphere-master\shardingsphere-master\shardingsphere-sql-parser\shardingsphere-sql-parser-statement\src\main\java\org\apache\shardingsphere\sql\parser\sql\dialect\statement\mysql\dal\MySQLShowFunctionCodeStatement.java,0,3,0,5,0,8
 shardingsphere-master\shardingsphere-master\examples\example-core\config-utility\src\main\java\org\apache\shardingsphere\example\algorithm\StandardModuloShardingDatabaseAlgorithm.java,0,14,1,9,0,24
 shardingsphere-master\shardingsphere-master\shardingsphere-kernel\shardingsphere-data-pipeline\shardingsphere-data-pipeline-dialect\shardingsphere-data-pipeline-mysql\src\test\java\org\apache\shardingsphere\data\pipeline\mysql\ingest\MySQLIncrementalDumperTest.java,0,37,0,25,0,62
 shardingsphere-master\shardingsphere-master\shardingsphere-sql-parser\shardingsphere-sql-parser-statement\src\main\java\org\apache\shardingsphere\sql\parser\sql\dialect\statement\mysql\dal\MySQLShowErrorsStatement.java,0,3,0,6,0,9
 shardingsphere-master\shardingsphere-master\shardingsphere-infra\shardingsphere-infra-binder\src\test\java\org\apache\shardingsphere\infra\binder\statement\ddl\DropTableStatementContextTest.java,0,11,0,17,0,28
 shardingsphere-master\shardingsphere-master\shardingsphere-infra\shardingsphere-infra-federation\shardingsphere-infra-federation-executor\src\main\java\org\apache\shardingsphere\infra\federation\executor\customized\CustomizedFilterableExecutor.java,0,27,1,15,0,43
 shardingsphere-master\shardingsphere-master\shardingsphere-test\shardingsphere-pipeline-test\src\test\java\org\apache\shardingsphere\data\pipeline\core\ingest\record\DataRecordTest.java,0,9,0,2,0,11
 shardingsphere-master\shardingsphere-master\examples\shardingsphere-jdbc-example\single-feature-example\extension-example\custom-sharding-algortihm-example\class-based-sharding-algorithm-example\class-based-sharding-raw-jdbc-example\src\main\java\org\apache\shardingsphere\example\extension\classbased\sharding\raw\jdbc\ClassBasedShardingRawYamlConfigurationExample.java,0,9,1,5,0,15
 shardingsphere-master\shardingsphere-master\shardingsphere-features\shardingsphere-sharding\shardingsphere-sharding-core\src\test\java\org\apache\shardingsphere\sharding\checker\ShardingRuleConfigurationCheckerTest.java,0,17,0,14,0,31
 shardingsphere-master\shardingsphere-master\shardingsphere-test\shardingsphere-parser-test\src\main\java\org\apache\shardingsphere\test\sql\parser\parameterized\asserts\statement\distsql\rdl\drop\DropRuleStatementAssert.java,0,17,0,62,0,79
 shardingsphere-master\shardingsphere-master\shardingsphere-kernel\shardingsphere-transaction\shardingsphere-transaction-type\shardingsphere-transaction-xa\shardingsphere-transaction-xa-core\src\main\java\org\apache\shardingsphere\transaction\xa\jta\datasource\properties\dialect\OpenGaussXADataSourceDefinition.java,0,3,0,4,0,7
 shardingsphere-master\shardingsphere-master\shardingsphere-features\shardingsphere-sharding\shardingsphere-sharding-core\src\main\java\org\apache\shardingsphere\sharding\algorithm\sharding\range\BoundaryBasedRangeShardingAlgorithm.java,0,12,0,8,0,20
 shardingsphere-master\shardingsphere-master\shardingsphere-infra\shardingsphere-infra-rewrite\src\main\java\org\apache\shardingsphere\infra\rewrite\sql\impl\RouteSQLBuilder.java,0,7,0,2,0,9
 shardingsphere-master\shardingsphere-master\shardingsphere-sql-parser\shardingsphere-sql-parser-statement\src\main\java\org\apache\shardingsphere\sql\parser\sql\common\statement\dml\UpdateStatement.java,18,9,0,6,0,15
 shardingsphere-master\shardingsphere-master\shardingsphere-features\shardingsphere-encrypt\shardingsphere-encrypt-core\src\main\java\org\apache\shardingsphere\encrypt\checker\EncryptRuleConfigurationChecker.java,0,4,0,2,0,6
 shardingsphere-master\shardingsphere-master\shardingsphere-features\shardingsphere-sharding\shardingsphere-sharding-core\src\main\java\org\apache\shardingsphere\sharding\rewrite\token\generator\impl\keygen\GeneratedKeyForUseDefaultInsertColumnsTokenGenerator.java,0,11,0,13,0,24
 shardingsphere-master\shardingsphere-master\shardingsphere-sql-parser\shardingsphere-sql-parser-statement\src\main\java\org\apache\shardingsphere\sql\parser\sql\dialect\statement\sqlserver\ddl\SQLServerAlterServiceStatement.java,0,1,0,6,0,7
 shardingsphere-master\shardingsphere-master\shardingsphere-features\shardingsphere-sharding\shardingsphere-sharding-core\src\test\java\org\apache\shardingsphere\sharding\merge\dql\groupby\GroupByValueTest.java,0,36,0,19,0,55
 shardingsphere-master\shardingsphere-master\shardingsphere-features\shardingsphere-readwrite-splitting\shardingsphere-readwrite-splitting-core\src\main\java\org\apache\shardingsphere\readwritesplitting\route\ReadwriteSplittingSQLRouter.java,0,14,0,13,0,27
 shardingsphere-master\shardingsphere-master\shardingsphere-spi\src\test\java\org\apache\shardingsphere\spi\fixture\optinal\OptionalSPIFixtureImpl.java,3,0,0,1,0,1
 shardingsphere-master\shardingsphere-master\shardingsphere-test\shardingsphere-integration-test\shardingsphere-integration-test-suite\src\test\java\org\apache\shardingsphere\test\integration\framework\runner\parallel\impl\ScenarioParallelRunnerExecutor.java,0,25,0,14,0,39
 shardingsphere-master\shardingsphere-master\shardingsphere-test\shardingsphere-parser-test\src\main\java\org\apache\shardingsphere\test\sql\parser\parameterized\asserts\statement\distsql\rdl\create\impl\CreateShardingAlgorithmStatementAssert.java,0,16,0,21,0,37
 shardingsphere-master\shardingsphere-master\shardingsphere-test\shardingsphere-pipeline-test\src\test\java\org\apache\shardingsphere\data\pipeline\core\spi\check\consistency\CRC32MatchDataConsistencyCheckAlgorithmTest.java,0,10,0,6,0,16
 shardingsphere-master\shardingsphere-master\shardingsphere-features\shardingsphere-readwrite-splitting\shardingsphere-readwrite-splitting-core\src\test\java\org\apache\shardingsphere\readwritesplitting\rule\builder\AlgorithmProvidedReadwriteSplittingRuleBuilderTest.java,0,9,0,7,0,16
 shardingsphere-master\shardingsphere-master\shardingsphere-infra\shardingsphere-infra-merge\src\main\java\org\apache\shardingsphere\infra\merge\engine\decorator\ResultDecoratorEngine.java,0,4,0,3,0,7
 shardingsphere-master\shardingsphere-master\shardingsphere-jdbc\shardingsphere-jdbc-core\src\main\java\org\apache\shardingsphere\driver\jdbc\adapter\AbstractResultSetAdapter.java,90,37,0,17,0,54
 shardingsphere-master\shardingsphere-master\shardingsphere-mode\shardingsphere-mode-core\src\test\java\org\apache\shardingsphere\mode\manager\ContextManagerBuilderFactoryTest.java,0,7,0,4,0,11
 shardingsphere-master\shardingsphere-master\shardingsphere-features\shardingsphere-sharding\shardingsphere-sharding-distsql\shardingsphere-sharding-distsql-statement\src\main\java\org\apache\shardingsphere\sharding\distsql\parser\statement\AlterShardingTableRuleStatement.java,0,2,0,3,0,5
 shardingsphere-master\shardingsphere-master\shardingsphere-infra\shardingsphere-infra-common\src\test\java\org\apache\shardingsphere\infra\metadata\schema\loader\adapter\MetaDataLoaderConnectionAdapterTest.java,0,34,1,12,0,47
 shardingsphere-master\shardingsphere-master\examples\example-core\example-api\src\main\java\org\apache\shardingsphere\example\core\api\repository\AccountRepository.java,0,1,0,1,0,2
 shardingsphere-master\shardingsphere-master\shardingsphere-agent\shardingsphere-agent-core\src\main\java\org\apache\shardingsphere\agent\core\plugin\interceptor\compose\ComposeClassStaticMethodAroundInterceptor.java,0,6,0,6,0,12
 shardingsphere-master\shardingsphere-master\shardingsphere-infra\shardingsphere-infra-parser\src\test\java\org\apache\shardingsphere\infra\parser\cache\SQLStatementCacheBuilderTest.java,0,10,0,2,0,12
 shardingsphere-master\shardingsphere-master\shardingsphere-features\shardingsphere-encrypt\shardingsphere-encrypt-core\src\main\java\org\apache\shardingsphere\encrypt\algorithm\AESEncryptAlgorithm.java,0,21,0,8,0,29
 shardingsphere-master\shardingsphere-master\shardingsphere-sql-parser\shardingsphere-sql-parser-statement\src\main\java\org\apache\shardingsphere\sql\parser\sql\dialect\statement\mysql\tcl\MySQLSetAutoCommitStatement.java,0,1,0,4,0,5
 shardingsphere-master\shardingsphere-master\shardingsphere-sql-parser\shardingsphere-sql-parser-statement\src\main\java\org\apache\shardingsphere\sql\parser\sql\common\statement\dal\LoadStatement.java,3,1,1,3,0,5
 shardingsphere-master\shardingsphere-master\shardingsphere-infra\shardingsphere-infra-executor\src\test\java\org\apache\shardingsphere\infra\executor\sql\execute\result\query\impl\driver\jdbc\type\stream\JDBCStreamQueryResultTest.java,0,83,28,29,0,140
 shardingsphere-master\shardingsphere-master\shardingsphere-proxy\shardingsphere-proxy-frontend\shardingsphere-proxy-frontend-core\src\main\java\org\apache\shardingsphere\proxy\frontend\connection\ConnectionIdGenerator.java,0,10,0,2,0,12
 shardingsphere-master\shardingsphere-master\shardingsphere-infra\shardingsphere-infra-route\src\main\java\org\apache\shardingsphere\infra\route\context\RouteUnit.java,0,11,0,5,0,16
 shardingsphere-master\shardingsphere-master\shardingsphere-kernel\shardingsphere-traffic\shardingsphere-traffic-api\src\main\java\org\apache\shardingsphere\traffic\api\traffic\hint\HintTrafficValue.java,0,2,0,1,0,3
 shardingsphere-master\shardingsphere-master\shardingsphere-db-protocol\shardingsphere-db-protocol-mysql\src\main\java\org\apache\shardingsphere\db\protocol\mysql\packet\binlog\row\column\value\MySQLBinlogProtocolValueFactory.java,0,35,0,49,0,84
 shardingsphere-master\shardingsphere-master\shardingsphere-sql-parser\shardingsphere-sql-parser-statement\src\main\java\org\apache\shardingsphere\sql\parser\sql\dialect\statement\mysql\dal\MySQLShowFunctionStatusStatement.java,0,4,0,6,1,11
 shardingsphere-master\shardingsphere-master\shardingsphere-kernel\shardingsphere-data-pipeline\shardingsphere-data-pipeline-core\src\main\java\org\apache\shardingsphere\scaling\core\spi\ScalingEntry.java,0,5,0,3,0,8
 shardingsphere-master\shardingsphere-master\shardingsphere-proxy\shardingsphere-proxy-backend\src\main\java\org\apache\shardingsphere\proxy\backend\text\admin\opengauss\OpenGaussAdminExecutorFactory.java,0,13,0,9,0,22
 shardingsphere-master\shardingsphere-master\shardingsphere-proxy\shardingsphere-proxy-backend\src\test\java\org\apache\shardingsphere\proxy\backend\text\transaction\TransactionBackendHandlerTest.java,0,15,1,13,0,29
 shardingsphere-master\shardingsphere-master\shardingsphere-mode\shardingsphere-mode-core\src\test\java\org\apache\shardingsphere\mode\metadata\persist\node\GlobalNodeTest.java,0,4,0,1,0,5
 shardingsphere-master\shardingsphere-master\examples\example-core\example-spring-jpa\src\main\java\org\apache\shardingsphere\example\core\jpa\entity\AccountEntity.java,0,5,0,1,0,6
 shardingsphere-master\shardingsphere-master\shardingsphere-sql-parser\shardingsphere-sql-parser-statement\src\main\java\org\apache\shardingsphere\sql\parser\sql\common\statement\ddl\AlterDatabaseStatement.java,3,1,1,3,0,5
 shardingsphere-master\shardingsphere-master\shardingsphere-infra\shardingsphere-infra-binder\src\main\java\org\apache\shardingsphere\infra\binder\statement\ddl\CreateFunctionStatementContext.java,0,9,0,10,0,19
 shardingsphere-master\shardingsphere-master\shardingsphere-kernel\shardingsphere-data-pipeline\shardingsphere-data-pipeline-spi\src\main\java\org\apache\shardingsphere\data\pipeline\api\job\AbstractJobId.java,15,9,1,1,0,11
 shardingsphere-master\shardingsphere-master\shardingsphere-features\shardingsphere-sharding\shardingsphere-sharding-distsql\shardingsphere-sharding-distsql-statement\src\main\java\org\apache\shardingsphere\sharding\distsql\parser\statement\hint\SetShardingHintDatabaseValueStatement.java,0,3,0,3,0,6
 shardingsphere-master\shardingsphere-master\shardingsphere-mode\shardingsphere-mode-core\src\main\java\org\apache\shardingsphere\mode\metadata\persist\node\ComputeNode.java,0,48,3,15,0,66
 shardingsphere-master\shardingsphere-master\shardingsphere-features\shardingsphere-sharding\shardingsphere-sharding-distsql\shardingsphere-sharding-distsql-statement\src\main\java\org\apache\shardingsphere\scaling\distsql\statement\segment\InputOrOutputSegment.java,0,5,0,1,0,6
 shardingsphere-master\shardingsphere-master\shardingsphere-db-protocol\shardingsphere-db-protocol-mysql\src\main\java\org\apache\shardingsphere\db\protocol\mysql\packet\command\admin\initdb\MySQLComInitDbPacket.java,0,7,0,4,0,11
 shardingsphere-master\shardingsphere-master\shardingsphere-db-protocol\shardingsphere-db-protocol-postgresql\src\test\java\org\apache\shardingsphere\db\protocol\postgresql\packet\command\query\extended\bind\protocol\PostgreSQLInt2BinaryProtocolValueTest.java,0,5,0,4,0,9
 shardingsphere-master\shardingsphere-master\shardingsphere-kernel\shardingsphere-data-pipeline\shardingsphere-data-pipeline-dialect\shardingsphere-data-pipeline-opengauss\src\main\java\org\apache\shardingsphere\data\pipeline\opengauss\OpenGaussScalingEntry.java,0,5,0,4,0,9
 shardingsphere-master\shardingsphere-master\shardingsphere-infra\shardingsphere-infra-executor\src\main\java\org\apache\shardingsphere\infra\executor\sql\prepare\driver\jdbc\JDBCDriverType.java,0,5,0,1,0,6
 shardingsphere-master\shardingsphere-master\shardingsphere-features\shardingsphere-sharding\shardingsphere-sharding-core\src\main\java\org\apache\shardingsphere\sharding\route\engine\validator\dml\impl\ShardingInsertStatementValidator.java,0,39,0,41,0,80
 shardingsphere-master\shardingsphere-master\shardingsphere-sql-parser\shardingsphere-sql-parser-dialect\shardingsphere-sql-parser-oracle\src\test\java\org\apache\shardingsphere\sql\parser\oracle\UnsupportedOracleParserParameterizedTest.java,0,7,0,6,0,13
 shardingsphere-master\shardingsphere-master\shardingsphere-test\shardingsphere-parser-test\src\main\java\org\apache\shardingsphere\test\sql\parser\parameterized\asserts\statement\dal\impl\ShowStatementAssert.java,0,4,1,6,0,11
 shardingsphere-master\shardingsphere-master\shardingsphere-test\shardingsphere-parser-test\src\main\java\org\apache\shardingsphere\test\sql\parser\parameterized\asserts\statement\distsql\rdl\alter\impl\AlterShardingBindingTableRulesStatementAssert.java,0,17,0,22,0,39
 shardingsphere-master\shardingsphere-master\shardingsphere-mode\shardingsphere-mode-type\shardingsphere-cluster-mode\shardingsphere-cluster-mode-repository\shardingsphere-cluster-mode-repository-provider\shardingsphere-cluster-mode-repository-zookeeper-curator\src\main\java\org\apache\shardingsphere\mode\repository\cluster\zookeeper\handler\CuratorZookeeperExceptionHandler.java,0,8,1,4,0,13
 shardingsphere-master\shardingsphere-master\shardingsphere-features\shardingsphere-encrypt\shardingsphere-encrypt-api\src\main\java\org\apache\shardingsphere\encrypt\spi\context\EncryptContext.java,0,19,0,1,0,20
 shardingsphere-master\shardingsphere-master\shardingsphere-test\shardingsphere-integration-test\shardingsphere-integration-test-suite\src\test\java\org\apache\shardingsphere\test\integration\framework\container\compose\mode\MemoryComposedContainer.java,0,18,0,15,0,33
 shardingsphere-master\shardingsphere-master\shardingsphere-sql-parser\shardingsphere-sql-parser-statement\src\test\java\org\apache\shardingsphere\sql\parser\sql\common\constant\ParenTest.java,0,16,0,1,0,17
 shardingsphere-master\shardingsphere-master\shardingsphere-test\shardingsphere-parser-test\src\main\java\org\apache\shardingsphere\test\sql\parser\parameterized\asserts\statement\distsql\rdl\drop\impl\DropShardingTableRuleStatementAssert.java,0,8,0,11,0,19
 shardingsphere-master\shardingsphere-master\shardingsphere-db-protocol\shardingsphere-db-protocol-mysql\src\main\java\org\apache\shardingsphere\db\protocol\mysql\constant\MySQLBinlogEventFlag.java,0,23,0,2,0,25
 shardingsphere-master\shardingsphere-master\examples\shardingsphere-jdbc-example\single-feature-example\readwrite-splitting-example\readwrite-splitting-raw-jdbc-example\src\main\java\org\apache\shardingsphere\example\readwrite\splitting\raw\jdbc\config\ReadwriteSplittingConfiguration.java,0,17,0,16,0,33
 shardingsphere-master\shardingsphere-master\shardingsphere-features\shardingsphere-readwrite-splitting\shardingsphere-readwrite-splitting-core\src\test\java\org\apache\shardingsphere\readwritesplitting\rule\ReadwriteSplittingRuleTest.java,0,42,0,29,0,71
 shardingsphere-master\shardingsphere-master\shardingsphere-kernel\shardingsphere-data-pipeline\shardingsphere-data-pipeline-spi\src\main\java\org\apache\shardingsphere\data\pipeline\api\ingest\channel\PipelineChannel.java,0,5,0,2,0,7
 shardingsphere-master\shardingsphere-master\shardingsphere-kernel\shardingsphere-transaction\shardingsphere-transaction-type\shardingsphere-transaction-xa\shardingsphere-transaction-xa-core\src\test\java\org\apache\shardingsphere\transaction\xa\jta\connection\dialect\MySQLXAConnectionWrapperTest.java,0,11,0,8,0,19
 shardingsphere-master\shardingsphere-master\shardingsphere-jdbc\shardingsphere-jdbc-core\src\test\java\org\apache\shardingsphere\driver\jdbc\unsupported\UnsupportedGeneratedKeysResultSetTest.java,0,76,0,2,0,78
 shardingsphere-master\shardingsphere-master\shardingsphere-proxy\shardingsphere-proxy-frontend\shardingsphere-proxy-frontend-postgresql\src\test\java\org\apache\shardingsphere\proxy\frontend\postgresql\authentication\authenticator\PostgreSQLMD5PasswordAuthenticatorTest.java,0,24,3,13,0,40
 shardingsphere-master\shardingsphere-master\shardingsphere-kernel\shardingsphere-traffic\shardingsphere-traffic-api\src\main\java\org\apache\shardingsphere\traffic\api\traffic\transaction\TransactionTrafficAlgorithm.java,0,3,0,1,0,4
 shardingsphere-master\shardingsphere-master\shardingsphere-test\shardingsphere-parser-test\src\main\java\org\apache\shardingsphere\test\sql\parser\parameterized\jaxb\cases\domain\segment\impl\distsql\rdl\ExpectedEncryptColumn.java,0,8,0,5,0,13
 shardingsphere-master\shardingsphere-master\shardingsphere-proxy\shardingsphere-proxy-backend\src\test\java\org\apache\shardingsphere\proxy\backend\text\distsql\fixture\TestTrafficAlgorithm.java,0,4,1,1,0,6
 shardingsphere-master\shardingsphere-master\examples\shardingsphere-proxy-example\shardingsphere-proxy-distsql-example\src\main\java\org\apache\shardingsphere\example\proxy\distsql\DistSQLFeatureExample.java,0,7,4,3,0,14
 shardingsphere-master\shardingsphere-master\shardingsphere-sql-parser\shardingsphere-sql-parser-statement\src\main\java\org\apache\shardingsphere\sql\parser\sql\dialect\statement\opengauss\dal\OpenGaussShowStatement.java,0,1,0,5,0,6
 shardingsphere-master\shardingsphere-master\shardingsphere-infra\shardingsphere-infra-context\src\main\java\org\apache\shardingsphere\infra\context\refresher\type\DropViewStatementSchemaRefresher.java,0,12,0,13,0,25
 shardingsphere-master\shardingsphere-master\shardingsphere-test\shardingsphere-parser-test\src\main\java\org\apache\shardingsphere\test\sql\parser\parameterized\jaxb\cases\domain\segment\impl\orderby\item\impl\ExpectedExpressionOrderByItem.java,0,3,0,4,0,7
 shardingsphere-master\shardingsphere-master\shardingsphere-sql-parser\shardingsphere-sql-parser-statement\src\main\java\org\apache\shardingsphere\sql\parser\sql\common\statement\dcl\AlterUserStatement.java,3,1,1,3,0,5
 shardingsphere-master\shardingsphere-master\shardingsphere-test\shardingsphere-parser-test\src\main\java\org\apache\shardingsphere\test\sql\parser\parameterized\asserts\statement\dal\impl\InstallComponentStatementAssert.java,0,9,0,12,0,21
 shardingsphere-master\shardingsphere-master\examples\example-core\example-api\src\main\java\org\apache\shardingsphere\example\core\api\entity\OrderItem.java,50,40,0,2,0,42
 shardingsphere-master\shardingsphere-master\shardingsphere-agent\shardingsphere-agent-core\src\test\java\org\apache\shardingsphere\agent\core\config\AgentConfigurationLoaderTest.java,0,8,0,4,0,12
 shardingsphere-master\shardingsphere-master\shardingsphere-infra\shardingsphere-infra-common\src\test\java\org\apache\shardingsphere\infra\database\type\dialect\H2DatabaseTypeTest.java,0,20,1,7,0,28
 shardingsphere-master\shardingsphere-master\shardingsphere-jdbc\shardingsphere-jdbc-core\src\test\java\org\apache\shardingsphere\driver\jdbc\adapter\invocation\MethodInvocationRecorderTest.java,0,7,0,3,0,10
 shardingsphere-master\shardingsphere-master\shardingsphere-test\shardingsphere-integration-driver-test\src\test\java\org\apache\shardingsphere\driver\readwrite\YamlReadwriteSplittingIntegrateTest.java,0,22,0,14,0,36
 shardingsphere-master\shardingsphere-master\shardingsphere-sql-parser\shardingsphere-sql-parser-statement\src\main\java\org\apache\shardingsphere\sql\parser\sql\dialect\statement\oracle\tcl\OracleSavepointStatement.java,0,1,0,4,0,5
 shardingsphere-master\shardingsphere-master\shardingsphere-mode\shardingsphere-mode-type\shardingsphere-cluster-mode\shardingsphere-cluster-mode-core\src\test\java\org\apache\shardingsphere\mode\manager\cluster\coordinator\registry\metadata\subscriber\SchemaMetaDataRegistrySubscriberTest.java,0,11,1,6,0,18
 shardingsphere-master\shardingsphere-master\shardingsphere-db-protocol\shardingsphere-db-protocol-mysql\src\main\java\org\apache\shardingsphere\db\protocol\mysql\packet\binlog\row\column\value\integer\MySQLLongBinlogProtocolValue.java,0,3,0,6,0,9
 shardingsphere-master\shardingsphere-master\shardingsphere-jdbc\shardingsphere-jdbc-core\src\main\java\org\apache\shardingsphere\driver\jdbc\core\resultset\DatabaseMetaDataResultSet.java,0,124,1,41,0,166
 shardingsphere-master\shardingsphere-master\shardingsphere-features\shardingsphere-sharding\shardingsphere-sharding-core\src\test\java\org\apache\shardingsphere\sharding\route\strategy\ShardingStrategyTest.java,0,23,0,19,0,42
 shardingsphere-master\shardingsphere-master\shardingsphere-features\shardingsphere-readwrite-splitting\shardingsphere-readwrite-splitting-core\src\test\java\org\apache\shardingsphere\readwritesplitting\swapper\ReadwriteSplittingRuleConfigurationYamlSwapperTest.java,0,52,0,42,0,94
 shardingsphere-master\shardingsphere-master\shardingsphere-db-protocol\shardingsphere-db-protocol-mysql\src\test\java\org\apache\shardingsphere\db\protocol\mysql\constant\MySQLCharacterSetTest.java,0,8,0,1,0,9
 shardingsphere-master\shardingsphere-master\shardingsphere-features\shardingsphere-sharding\shardingsphere-sharding-distsql\shardingsphere-sharding-distsql-statement\src\main\java\org\apache\shardingsphere\scaling\distsql\statement\ShowScalingCheckAlgorithmsStatement.java,0,1,0,3,0,4
 shardingsphere-master\shardingsphere-master\shardingsphere-test\shardingsphere-parser-test\src\main\java\org\apache\shardingsphere\test\sql\parser\parameterized\asserts\statement\distsql\ral\impl\common\queryable\ShowVariableStatementAssert.java,0,5,1,8,0,14
 shardingsphere-master\shardingsphere-master\shardingsphere-features\shardingsphere-encrypt\shardingsphere-encrypt-core\src\test\java\org\apache\shardingsphere\encrypt\fixture\CustomizedEncryptAlgorithm.java,0,34,1,5,0,40
 shardingsphere-master\shardingsphere-master\shardingsphere-infra\shardingsphere-infra-binder\src\main\java\org\apache\shardingsphere\infra\binder\segment\select\projection\impl\ShorthandProjection.java,0,15,1,5,0,21
 shardingsphere-master\shardingsphere-master\examples\shardingsphere-jdbc-example\single-feature-example\shadow-example\shadow-raw-jdbc-example\src\main\java\org\apache\shardingsphere\example\shadow\raw\jdbc\config\ShadowEncryptConfiguration.java,0,22,0,20,0,42
 shardingsphere-master\shardingsphere-master\shardingsphere-features\shardingsphere-sharding\shardingsphere-sharding-core\src\main\java\org\apache\shardingsphere\sharding\rewrite\token\pojo\DistinctProjectionPrefixToken.java,0,4,0,2,0,6
 shardingsphere-master\shardingsphere-master\shardingsphere-features\shardingsphere-sharding\shardingsphere-sharding-core\src\test\java\org\apache\shardingsphere\sharding\fixture\ComplexKeysShardingAlgorithmFixture.java,0,5,1,5,0,11
 shardingsphere-master\shardingsphere-master\shardingsphere-db-protocol\shardingsphere-db-protocol-postgresql\src\main\java\org\apache\shardingsphere\db\protocol\postgresql\packet\command\query\extended\bind\protocol\PostgreSQLFloat4ArrayBinaryProtocolValue.java,0,12,0,10,0,22
 shardingsphere-master\shardingsphere-master\shardingsphere-infra\shardingsphere-infra-federation\shardingsphere-infra-federation-optimizer\src\main\java\org\apache\shardingsphere\infra\federation\optimizer\converter\context\ConverterContextHolder.java,0,7,0,2,0,9
 shardingsphere-master\shardingsphere-master\examples\shardingsphere-jdbc-example\single-feature-example\sharding-example\sharding-raw-jdbc-example\src\main\java\org\apache\shardingsphere\example\sharding\raw\jdbc\config\ShardingDatabasesConfigurationRange.java,0,17,0,17,0,34
 shardingsphere-master\shardingsphere-master\shardingsphere-test\shardingsphere-parser-test\src\main\java\org\apache\shardingsphere\test\sql\parser\parameterized\jaxb\cases\domain\segment\impl\expr\simple\ExpectedSimpleExpressionSegment.java,0,1,0,4,0,5
 shardingsphere-master\shardingsphere-master\shardingsphere-kernel\shardingsphere-data-pipeline\shardingsphere-data-pipeline-dialect\shardingsphere-data-pipeline-mysql\src\main\java\org\apache\shardingsphere\data\pipeline\mysql\ingest\binlog\BinlogContext.java,0,14,0,5,0,19
 shardingsphere-master\shardingsphere-master\shardingsphere-agent\shardingsphere-agent-plugins\shardingsphere-agent-plugin-metrics\shardingsphere-agent-metrics-api\src\main\java\org\apache\shardingsphere\agent\metrics\api\advice\CommandExecutorTaskAdvice.java,0,12,0,8,0,20
 shardingsphere-master\shardingsphere-master\shardingsphere-features\shardingsphere-shadow\shardingsphere-shadow-core\src\main\java\org\apache\shardingsphere\shadow\yaml\swapper\datasource\ShadowDataSourceConfigurationYamlSwapper.java,0,8,0,9,0,17
 shardingsphere-master\shardingsphere-master\shardingsphere-infra\shardingsphere-infra-common\src\main\java\org\apache\shardingsphere\infra\storage\StorageNodeRole.java,0,3,0,1,0,4
 shardingsphere-master\shardingsphere-master\shardingsphere-kernel\shardingsphere-data-pipeline\shardingsphere-data-pipeline-spi\src\main\java\org\apache\shardingsphere\data\pipeline\api\task\progress\IncrementalTaskProgress.java,0,8,1,3,0,12
 shardingsphere-master\shardingsphere-master\shardingsphere-features\shardingsphere-sharding\shardingsphere-sharding-api\src\main\java\org\apache\shardingsphere\sharding\api\config\ShardingRuleConfiguration.java,0,35,0,19,0,54
 shardingsphere-master\shardingsphere-master\shardingsphere-test\shardingsphere-integration-test\shardingsphere-integration-test-suite\src\test\java\org\apache\shardingsphere\test\integration\env\scenario\authority\AuthoritySQLSet.java,0,13,0,5,0,18
 shardingsphere-master\shardingsphere-master\shardingsphere-agent\shardingsphere-agent-plugins\shardingsphere-agent-plugin-metrics\shardingsphere-agent-metrics-api\src\test\java\org\apache\shardingsphere\agent\metrics\api\advice\CommandExecutorTaskAdviceTest.java,0,20,0,10,0,30
 shardingsphere-master\shardingsphere-master\shardingsphere-sql-parser\shardingsphere-sql-parser-statement\src\main\java\org\apache\shardingsphere\sql\parser\sql\common\statement\ddl\AlterMaterializedViewStatement.java,3,1,1,3,0,5
 shardingsphere-master\shardingsphere-master\shardingsphere-proxy\shardingsphere-proxy-frontend\shardingsphere-proxy-frontend-core\src\test\java\org\apache\shardingsphere\proxy\frontend\exception\ExpectedExceptionsTest.java,0,10,0,9,0,19
 shardingsphere-master\shardingsphere-master\shardingsphere-sql-parser\shardingsphere-sql-parser-statement\src\main\java\org\apache\shardingsphere\sql\parser\sql\dialect\statement\oracle\ddl\OracleAlterIndexStatement.java,0,1,0,4,0,5
 shardingsphere-master\shardingsphere-master\shardingsphere-sql-parser\shardingsphere-sql-parser-statement\src\main\java\org\apache\shardingsphere\sql\parser\sql\dialect\statement\postgresql\ddl\PostgreSQLAlterConversionStatement.java,0,1,0,5,0,6
 shardingsphere-master\shardingsphere-master\shardingsphere-sql-parser\shardingsphere-sql-parser-statement\src\main\java\org\apache\shardingsphere\sql\parser\sql\dialect\statement\mysql\segment\PartitionDefinitionSegment.java,0,8,0,3,3,14
 shardingsphere-master\shardingsphere-master\shardingsphere-infra\shardingsphere-infra-executor\src\test\java\org\apache\shardingsphere\infra\executor\kernel\ExecutorEngineTest.java,0,37,0,11,0,48
 shardingsphere-master\shardingsphere-master\shardingsphere-proxy\shardingsphere-proxy-frontend\shardingsphere-proxy-frontend-postgresql\src\main\java\org\apache\shardingsphere\proxy\frontend\postgresql\authentication\authenticator\PostgreSQLMD5PasswordAuthenticator.java,0,8,0,8,0,16
 shardingsphere-master\shardingsphere-master\shardingsphere-infra\shardingsphere-infra-executor\src\main\java\org\apache\shardingsphere\infra\executor\sql\execute\result\query\impl\driver\vertx\VertxQueryResult.java,0,17,1,8,0,26
 shardingsphere-master\shardingsphere-master\shardingsphere-kernel\shardingsphere-data-pipeline\shardingsphere-data-pipeline-dialect\shardingsphere-data-pipeline-mysql\src\test\java\org\apache\shardingsphere\data\pipeline\mysql\ingest\client\ServerVersionTest.java,0,22,0,1,0,23
 shardingsphere-master\shardingsphere-master\shardingsphere-proxy\shardingsphere-proxy-backend\src\test\java\org\apache\shardingsphere\proxy\backend\text\admin\mysql\executor\ShowProcedureStatusExecutorTest.java,0,22,1,12,0,35
 shardingsphere-master\shardingsphere-master\shardingsphere-test\shardingsphere-parser-test\src\main\java\org\apache\shardingsphere\test\sql\parser\parameterized\asserts\statement\tcl\impl\BeginTransactionStatementAssert.java,0,6,1,7,0,14
 shardingsphere-master\shardingsphere-master\shardingsphere-features\shardingsphere-sharding\shardingsphere-sharding-core\src\main\java\org\apache\shardingsphere\sharding\route\engine\condition\value\ListShardingConditionValue.java,0,10,0,3,0,13
 shardingsphere-master\shardingsphere-master\shardingsphere-proxy\shardingsphere-proxy-backend\src\main\java\org\apache\shardingsphere\proxy\backend\communication\jdbc\recognizer\impl\PostgreSQLRecognizer.java,0,3,0,3,0,6
 shardingsphere-master\shardingsphere-master\shardingsphere-test\shardingsphere-parser-test\src\main\java\org\apache\shardingsphere\test\sql\parser\parameterized\jaxb\cases\domain\statement\ddl\CreateServiceStatementTestCase.java,0,0,0,3,0,3
 shardingsphere-master\shardingsphere-master\shardingsphere-kernel\shardingsphere-transaction\shardingsphere-transaction-type\shardingsphere-transaction-xa\shardingsphere-transaction-xa-core\src\main\java\org\apache\shardingsphere\transaction\xa\jta\datasource\swapper\impl\HikariCPPropertyProvider.java,0,5,0,3,0,8
 shardingsphere-master\shardingsphere-master\shardingsphere-jdbc\shardingsphere-jdbc-core\src\main\java\org\apache\shardingsphere\driver\jdbc\unsupported\AbstractUnsupportedOperationParameterMetaData.java,43,11,0,4,0,15
 shardingsphere-master\shardingsphere-master\shardingsphere-sql-parser\shardingsphere-sql-parser-statement\src\main\java\org\apache\shardingsphere\sql\parser\sql\dialect\statement\mysql\ddl\MySQLDropViewStatement.java,0,1,0,4,0,5
 shardingsphere-master\shardingsphere-master\shardingsphere-features\shardingsphere-readwrite-splitting\shardingsphere-readwrite-splitting-api\src\main\java\org\apache\shardingsphere\readwritesplitting\spi\ReplicaLoadBalanceAlgorithm.java,0,4,0,3,0,7
 shardingsphere-master\shardingsphere-master\shardingsphere-kernel\shardingsphere-data-pipeline\shardingsphere-data-pipeline-dialect\shardingsphere-data-pipeline-postgresql\src\main\java\org\apache\shardingsphere\data\pipeline\postgresql\ingest\wal\decode\PostgreSQLLogSequenceNumber.java,0,3,0,2,0,5
 shardingsphere-master\shardingsphere-master\shardingsphere-infra\shardingsphere-infra-binder\src\test\java\org\apache\shardingsphere\infra\binder\statement\dal\ShowColumnsStatementContextTest.java,0,8,0,15,0,23
 shardingsphere-master\shardingsphere-master\shardingsphere-sql-parser\shardingsphere-sql-parser-statement\src\main\java\org\apache\shardingsphere\sql\parser\sql\dialect\statement\mysql\ddl\MySQLAlterLogfileGroupStatement.java,0,1,0,5,0,6
 shardingsphere-master\shardingsphere-master\shardingsphere-test\shardingsphere-parser-test\src\main\java\org\apache\shardingsphere\test\sql\parser\parameterized\jaxb\cases\domain\statement\ddl\DropForeignTableStatementTestCase.java,0,0,0,3,0,3
 shardingsphere-master\shardingsphere-master\shardingsphere-features\shardingsphere-encrypt\shardingsphere-encrypt-distsql\shardingsphere-encrypt-distsql-handler\src\test\java\org\apache\shardingsphere\encrypt\distsql\handler\query\EncryptRuleQueryResultSetTest.java,0,11,0,11,0,22
 shardingsphere-master\shardingsphere-master\shardingsphere-features\shardingsphere-db-discovery\shardingsphere-db-discovery-distsql\shardingsphere-db-discovery-distsql-statement\src\main\java\org\apache\shardingsphere\dbdiscovery\distsql\parser\statement\AlterDatabaseDiscoveryTypeStatement.java,0,3,0,4,0,7
 shardingsphere-master\shardingsphere-master\shardingsphere-sql-parser\shardingsphere-sql-parser-statement\src\test\java\org\apache\shardingsphere\sql\parser\sql\common\segment\dml\column\ColumnSegmentTest.java,0,19,0,9,0,28
 shardingsphere-master\shardingsphere-master\shardingsphere-features\shardingsphere-sharding\shardingsphere-sharding-core\src\main\java\org\apache\shardingsphere\sharding\merge\dql\groupby\aggregation\AggregationUnitFactory.java,0,7,0,5,0,12
 shardingsphere-master\shardingsphere-master\shardingsphere-agent\shardingsphere-agent-plugins\shardingsphere-agent-plugin-tracing\shardingsphere-agent-tracing-zipkin\src\test\java\org\apache\shardingsphere\agent\plugin\tracing\zipkin\collector\ZipkinCollector.java,31,12,0,3,0,15
 shardingsphere-master\shardingsphere-master\shardingsphere-features\shardingsphere-sharding\shardingsphere-sharding-core\src\main\java\org\apache\shardingsphere\sharding\rewrite\token\pojo\ProjectionsToken.java,0,8,0,3,0,11
 shardingsphere-master\shardingsphere-master\shardingsphere-kernel\shardingsphere-transaction\shardingsphere-transaction-type\shardingsphere-transaction-xa\shardingsphere-transaction-xa-provider\shardingsphere-transaction-xa-bitronix\src\main\java\org\apache\shardingsphere\transaction\xa\bitronix\manager\SingleXAResourceHolder.java,0,10,2,1,0,13
 shardingsphere-master\shardingsphere-master\shardingsphere-db-protocol\shardingsphere-db-protocol-postgresql\src\main\java\org\apache\shardingsphere\db\protocol\postgresql\constant\PostgreSQLErrorCode.java,0,33,0,6,0,39
 shardingsphere-master\shardingsphere-master\shardingsphere-infra\shardingsphere-infra-common\src\main\java\org\apache\shardingsphere\infra\rule\identifier\type\TableContainedRule.java,0,1,0,1,0,2
 shardingsphere-master\shardingsphere-master\shardingsphere-infra\shardingsphere-infra-binder\src\main\java\org\apache\shardingsphere\infra\binder\segment\select\projection\engine\ProjectionEngine.java,0,81,0,80,0,161
 shardingsphere-master\shardingsphere-master\shardingsphere-kernel\shardingsphere-data-pipeline\shardingsphere-data-pipeline-dialect\shardingsphere-data-pipeline-mysql\src\main\java\org\apache\shardingsphere\data\pipeline\mysql\sqlbuilder\MySQLPipelineSQLBuilder.java,0,19,1,9,0,29
 shardingsphere-master\shardingsphere-master\shardingsphere-sql-parser\shardingsphere-sql-parser-statement\src\main\java\org\apache\shardingsphere\sql\parser\sql\dialect\statement\opengauss\dml\OpenGaussDoStatement.java,0,1,0,5,0,6
 shardingsphere-master\shardingsphere-master\shardingsphere-kernel\shardingsphere-data-pipeline\shardingsphere-data-pipeline-dialect\shardingsphere-data-pipeline-mysql\src\test\java\org\apache\shardingsphere\data\pipeline\mysql\ingest\column\value\UnsignedSmallintHandlerTest.java,0,6,0,2,0,8
 shardingsphere-master\shardingsphere-master\shardingsphere-mode\shardingsphere-mode-type\shardingsphere-cluster-mode\shardingsphere-cluster-mode-core\src\main\java\org\apache\shardingsphere\mode\manager\cluster\coordinator\registry\process\event\ExecuteProcessSummaryReportEvent.java,0,2,0,3,0,5
 shardingsphere-master\shardingsphere-master\examples\shardingsphere-jdbc-example\single-feature-example\encrypt-example\encrypt-spring-namespace-mybatis-example\src\main\java\org\apache\shardingsphere\example\encrypt\spring\namespace\mybatis\EncryptSpringNamespaceMybatisExample.java,0,9,1,4,0,14
 shardingsphere-master\shardingsphere-master\shardingsphere-features\shardingsphere-shadow\shardingsphere-shadow-spring\shardingsphere-shadow-spring-boot-starter\src\test\java\org\apache\shardingsphere\shadow\spring\boot\condition\ShadowSpringBootConditionTest.java,0,9,0,5,0,14
 shardingsphere-master\shardingsphere-master\shardingsphere-proxy\shardingsphere-proxy-backend\src\main\java\org\apache\shardingsphere\proxy\backend\text\distsql\ral\common\hint\result\ShowShardingHintStatusResult.java,0,8,0,3,0,11
 shardingsphere-master\shardingsphere-master\shardingsphere-agent\shardingsphere-agent-plugins\shardingsphere-agent-plugin-tracing\shardingsphere-agent-tracing-jaeger\src\test\java\org\apache\shardingsphere\agent\plugin\tracing\jaeger\advice\SQLParserEngineAdviceTest.java,0,17,0,14,0,31
 shardingsphere-master\shardingsphere-master\shardingsphere-mode\shardingsphere-mode-core\src\test\java\org\apache\shardingsphere\mode\metadata\fixture\FixtureRule.java,0,2,0,1,0,3
 shardingsphere-master\shardingsphere-master\shardingsphere-features\shardingsphere-sharding\shardingsphere-sharding-core\src\test\java\org\apache\shardingsphere\sharding\metadata\ShardingTableMetaDataBuilderTest.java,329,146,36,99,0,281
 shardingsphere-master\shardingsphere-master\shardingsphere-features\shardingsphere-shadow\shardingsphere-shadow-distsql\shardingsphere-shadow-distsql-handler\src\test\java\org\apache\shardingsphere\shadow\distsql\update\AlterShadowAlgorithmStatementUpdaterTest.java,0,24,0,18,0,42
 shardingsphere-master\shardingsphere-master\shardingsphere-sql-parser\shardingsphere-sql-parser-statement\src\main\java\org\apache\shardingsphere\sql\parser\sql\dialect\handler\SQLStatementHandler.java,0,1,0,1,0,2
 shardingsphere-master\shardingsphere-master\shardingsphere-features\shardingsphere-sharding\shardingsphere-sharding-core\src\test\java\org\apache\shardingsphere\sharding\route\engine\validator\ddl\ShardingCreateFunctionStatementValidatorTest.java,0,34,0,38,0,72
 shardingsphere-master\shardingsphere-master\shardingsphere-features\shardingsphere-sharding\shardingsphere-sharding-core\src\main\java\org\apache\shardingsphere\sharding\rule\TableRule.java,0,108,0,61,0,169
 shardingsphere-master\shardingsphere-master\shardingsphere-proxy\shardingsphere-proxy-backend\src\main\java\org\apache\shardingsphere\proxy\backend\text\distsql\rdl\resource\ResourceSegmentsConverter.java,0,10,0,7,0,17
 shardingsphere-master\shardingsphere-master\shardingsphere-test\shardingsphere-integration-test\shardingsphere-integration-test-suite\src\test\java\org\apache\shardingsphere\test\integration\framework\runner\parallel\ParallelRunnerExecutor.java,0,5,0,4,0,9
 shardingsphere-master\shardingsphere-master\shardingsphere-db-protocol\shardingsphere-db-protocol-mysql\src\main\java\org\apache\shardingsphere\db\protocol\mysql\packet\command\query\binary\execute\protocol\MySQLDateBinaryProtocolValue.java,0,22,0,10,0,32
 shardingsphere-master\shardingsphere-master\shardingsphere-test\shardingsphere-parser-test\src\main\java\org\apache\shardingsphere\test\sql\parser\parameterized\jaxb\cases\domain\statement\dal\ResetPersistStatementTestCase.java,0,4,0,3,0,7
 shardingsphere-master\shardingsphere-master\shardingsphere-kernel\shardingsphere-data-pipeline\shardingsphere-data-pipeline-dialect\shardingsphere-data-pipeline-mysql\src\main\java\org\apache\shardingsphere\data\pipeline\mysql\ingest\column\value\UnsignedIntHandler.java,0,4,0,1,0,5
 shardingsphere-master\shardingsphere-master\shardingsphere-kernel\shardingsphere-traffic\shardingsphere-traffic-core\src\test\java\org\apache\shardingsphere\traffic\algorithm\context\TrafficContextTest.java,0,5,0,1,0,6
 shardingsphere-master\shardingsphere-master\shardingsphere-features\shardingsphere-readwrite-splitting\shardingsphere-readwrite-splitting-api\src\main\java\org\apache\shardingsphere\readwritesplitting\api\ReadwriteSplittingRuleConfiguration.java,0,8,0,7,0,15
 shardingsphere-master\shardingsphere-master\shardingsphere-features\shardingsphere-db-discovery\shardingsphere-db-discovery-core\src\main\java\org\apache\shardingsphere\dbdiscovery\constant\DatabaseDiscoveryOrder.java,0,4,0,1,0,5
 shardingsphere-master\shardingsphere-master\shardingsphere-test\shardingsphere-parser-test\src\main\java\org\apache\shardingsphere\test\sql\parser\parameterized\jaxb\cases\domain\statement\distsql\rdl\alter\AlterDefaultShardingStrategyStatementTestCase.java,0,3,0,5,0,8
 shardingsphere-master\shardingsphere-master\shardingsphere-features\shardingsphere-sharding\shardingsphere-sharding-core\src\main\java\org\apache\shardingsphere\sharding\rewrite\token\generator\impl\keygen\BaseGeneratedKeyTokenGenerator.java,11,8,0,8,0,16
 shardingsphere-master\shardingsphere-master\shardingsphere-features\shardingsphere-sharding\shardingsphere-sharding-distsql\shardingsphere-sharding-distsql-handler\src\test\java\org\apache\shardingsphere\sharding\distsql\query\ShardingDefaultShardingStrategyQueryResultSetTest.java,0,33,0,21,0,54
 shardingsphere-master\shardingsphere-master\shardingsphere-sql-parser\shardingsphere-sql-parser-dialect\shardingsphere-sql-parser-mysql\src\main\java\org\apache\shardingsphere\sql\parser\mysql\visitor\statement\impl\MySQLDMLStatementSQLVisitor.java,0,6,0,9,0,15
 shardingsphere-master\shardingsphere-master\shardingsphere-infra\shardingsphere-infra-common\src\test\java\org\apache\shardingsphere\infra\instance\definition\InstanceIdTest.java,0,15,3,1,0,19
 shardingsphere-master\shardingsphere-master\shardingsphere-proxy\shardingsphere-proxy-frontend\shardingsphere-proxy-frontend-postgresql\src\main\java\org\apache\shardingsphere\proxy\frontend\postgresql\err\PostgreSQLErrPacketFactory.java,0,30,0,31,0,61
 shardingsphere-master\shardingsphere-master\shardingsphere-db-protocol\shardingsphere-db-protocol-mysql\src\main\java\org\apache\shardingsphere\db\protocol\mysql\packet\binlog\row\column\value\integer\MySQLInt24BinlogProtocolValue.java,0,3,0,6,0,9
 shardingsphere-master\shardingsphere-master\shardingsphere-proxy\shardingsphere-proxy-backend\src\main\java\org\apache\shardingsphere\proxy\backend\text\database\CreateDatabaseBackendHandler.java,0,9,0,7,0,16
 shardingsphere-master\shardingsphere-master\shardingsphere-kernel\shardingsphere-authority\shardingsphere-authority-core\src\test\java\org\apache\shardingsphere\authority\provider\database\DatabasePrivilegesTest.java,0,39,0,31,0,70
 shardingsphere-master\shardingsphere-master\shardingsphere-test\shardingsphere-parser-test\src\main\java\org\apache\shardingsphere\test\sql\parser\parameterized\jaxb\cases\domain\statement\ddl\DropCastStatementTestCase.java,0,0,0,3,0,3
 shardingsphere-master\shardingsphere-master\shardingsphere-features\shardingsphere-sharding\shardingsphere-sharding-distsql\shardingsphere-sharding-distsql-handler\src\test\java\org\apache\shardingsphere\sharding\distsql\update\CreateShardingAlgorithmStatementUpdaterTest.java,0,31,0,23,0,54
 shardingsphere-master\shardingsphere-master\shardingsphere-proxy\shardingsphere-proxy-frontend\shardingsphere-proxy-frontend-core\src\main\java\org\apache\shardingsphere\proxy\frontend\executor\UserExecutorGroup.java,0,9,0,3,0,12
 shardingsphere-master\shardingsphere-master\shardingsphere-infra\shardingsphere-infra-common\src\test\java\org\apache\shardingsphere\infra\state\StateContextTest.java,0,9,0,1,0,10
 shardingsphere-master\shardingsphere-master\shardingsphere-test\shardingsphere-parser-test\src\main\java\org\apache\shardingsphere\test\sql\parser\parameterized\asserts\segment\projection\ProjectionAssert.java,0,66,0,81,0,147
 shardingsphere-master\shardingsphere-master\shardingsphere-test\shardingsphere-parser-test\src\main\java\org\apache\shardingsphere\test\sql\parser\parameterized\asserts\statement\distsql\ral\impl\scaling\update\StopScalingStatementAssert.java,0,11,1,12,0,24
 shardingsphere-master\shardingsphere-master\shardingsphere-features\shardingsphere-sharding\shardingsphere-sharding-distsql\shardingsphere-sharding-distsql-handler\src\main\java\org\apache\shardingsphere\sharding\distsql\handler\query\ShardingTableNodesQueryResultSet.java,0,45,0,34,0,79
 shardingsphere-master\shardingsphere-master\shardingsphere-proxy\shardingsphere-proxy-frontend\shardingsphere-proxy-frontend-postgresql\src\test\java\org\apache\shardingsphere\proxy\frontend\postgresql\command\query\simple\PostgreSQLComQueryExecutorTest.java,0,34,1,24,0,59
 shardingsphere-master\shardingsphere-master\shardingsphere-db-protocol\shardingsphere-db-protocol-postgresql\src\test\java\org\apache\shardingsphere\db\protocol\postgresql\packet\command\query\extended\bind\protocol\PostgreSQLByteConverterTest.java,0,24,1,8,0,33
 shardingsphere-master\shardingsphere-master\shardingsphere-sql-parser\shardingsphere-sql-parser-statement\src\main\java\org\apache\shardingsphere\sql\parser\sql\common\statement\ddl\DeallocateStatement.java,3,1,1,3,0,5
 shardingsphere-master\shardingsphere-master\shardingsphere-proxy\shardingsphere-proxy-frontend\shardingsphere-proxy-frontend-mysql\src\test\java\org\apache\shardingsphere\proxy\frontend\mysql\command\query\binary\execute\MySQLComStmtExecuteExecutorTest.java,0,50,1,43,0,94
 shardingsphere-master\shardingsphere-master\shardingsphere-features\shardingsphere-sharding\shardingsphere-sharding-spring\shardingsphere-sharding-spring-boot-starter\src\main\java\org\apache\shardingsphere\sharding\spring\boot\ShardingRuleSpringBootConfiguration.java,47,17,0,17,0,34
 shardingsphere-master\shardingsphere-master\shardingsphere-kernel\shardingsphere-parser\shardingsphere-parser-core\src\main\java\org\apache\shardingsphere\parser\yaml\config\YamlSQLParserRuleConfiguration.java,0,8,0,2,0,10
 shardingsphere-master\shardingsphere-master\shardingsphere-features\shardingsphere-sharding\shardingsphere-sharding-core\src\main\java\org\apache\shardingsphere\sharding\rewrite\token\generator\impl\keygen\GeneratedKeyInsertValuesTokenGenerator.java,0,19,0,23,0,42
 shardingsphere-master\shardingsphere-master\shardingsphere-kernel\shardingsphere-traffic\shardingsphere-traffic-core\src\main\java\org\apache\shardingsphere\traffic\yaml\swapper\TrafficRuleConfigurationYamlSwapper.java,0,27,0,20,0,47
 shardingsphere-master\shardingsphere-master\shardingsphere-agent\shardingsphere-agent-plugins\shardingsphere-agent-plugin-tracing\shardingsphere-agent-tracing-jaeger\src\test\java\org\apache\shardingsphere\agent\plugin\tracing\jaeger\service\JaegerTracingPluginBootServiceTest.java,0,12,1,3,0,16
 shardingsphere-master\shardingsphere-master\shardingsphere-proxy\shardingsphere-proxy-backend\src\test\java\org\apache\shardingsphere\proxy\backend\text\admin\mysql\executor\ShowFunctionStatusExecutorTest.java,0,22,1,12,0,35
 shardingsphere-master\shardingsphere-master\examples\example-core\example-raw-jdbc\src\main\java\org\apache\shardingsphere\example\core\jdbc\service\AccountServiceImpl.java,0,25,0,9,0,34
 shardingsphere-master\shardingsphere-master\shardingsphere-kernel\shardingsphere-data-pipeline\shardingsphere-data-pipeline-dialect\shardingsphere-data-pipeline-mysql\src\main\java\org\apache\shardingsphere\data\pipeline\mysql\ingest\MySQLInventoryDumper.java,0,16,0,13,0,29
 shardingsphere-master\shardingsphere-master\shardingsphere-test\shardingsphere-integration-test\shardingsphere-integration-test-suite\src\test\java\org\apache\shardingsphere\test\integration\engine\ral\GeneralRALIT.java,0,7,0,6,0,13
 shardingsphere-master\shardingsphere-master\shardingsphere-proxy\shardingsphere-proxy-frontend\shardingsphere-proxy-frontend-reactive-core\src\main\java\org\apache\shardingsphere\proxy\frontend\reactive\protocol\ReactiveDatabaseProtocolFrontendEngineFactory.java,0,9,0,7,0,16
 shardingsphere-master\shardingsphere-master\shardingsphere-features\shardingsphere-sharding\shardingsphere-sharding-core\src\main\java\org\apache\shardingsphere\sharding\yaml\config\strategy\sharding\YamlNoneShardingStrategyConfiguration.java,0,1,0,2,0,3
 shardingsphere-master\shardingsphere-master\shardingsphere-features\shardingsphere-sharding\shardingsphere-sharding-core\src\main\java\org\apache\shardingsphere\sharding\route\engine\condition\ExpressionConditionUtils.java,0,3,0,6,0,9
 shardingsphere-master\shardingsphere-master\shardingsphere-infra\shardingsphere-infra-common\src\test\java\org\apache\shardingsphere\infra\properties\fixture\TestTypedPropertyKey.java,0,21,0,2,0,23
 shardingsphere-master\shardingsphere-master\shardingsphere-mode\shardingsphere-mode-type\shardingsphere-cluster-mode\shardingsphere-cluster-mode-core\src\main\java\org\apache\shardingsphere\mode\manager\cluster\coordinator\registry\status\compute\event\InstanceOnlineEvent.java,0,2,0,3,0,5
 shardingsphere-master\shardingsphere-master\shardingsphere-test\shardingsphere-parser-test\src\main\java\org\apache\shardingsphere\test\sql\parser\parameterized\jaxb\cases\domain\segment\impl\projection\ExpectedProjection.java,0,1,0,3,0,4
 shardingsphere-master\shardingsphere-master\shardingsphere-sql-parser\shardingsphere-sql-parser-statement\src\main\java\org\apache\shardingsphere\sql\parser\sql\common\segment\generic\table\TableSegment.java,0,0,0,2,0,2
 shardingsphere-master\shardingsphere-master\shardingsphere-proxy\shardingsphere-proxy-backend\src\test\java\org\apache\shardingsphere\proxy\backend\text\data\impl\UnicastDatabaseBackendHandlerTest.java,0,39,2,21,0,62
 shardingsphere-master\shardingsphere-master\shardingsphere-sql-parser\shardingsphere-sql-parser-statement\src\main\java\org\apache\shardingsphere\sql\parser\sql\dialect\statement\sqlserver\ddl\SQLServerAlterViewStatement.java,0,1,0,5,0,6
 shardingsphere-master\shardingsphere-master\shardingsphere-db-protocol\shardingsphere-db-protocol-opengauss\src\main\java\org\apache\shardingsphere\db\protocol\opengauss\packet\authentication\OpenGaussAuthenticationSCRAMSha256Packet.java,0,14,0,6,0,20
 shardingsphere-master\shardingsphere-master\shardingsphere-test\shardingsphere-parser-test\src\main\java\org\apache\shardingsphere\test\sql\parser\parameterized\jaxb\cases\domain\segment\impl\definition\ExpectedColumnPosition.java,0,2,0,4,0,6
 shardingsphere-master\shardingsphere-master\shardingsphere-proxy\shardingsphere-proxy-backend\src\test\java\org\apache\shardingsphere\proxy\backend\communication\jdbc\recognizer\JDBCDriverURLRecognizerEngineTest.java,0,23,0,15,0,38
 shardingsphere-master\shardingsphere-master\shardingsphere-infra\shardingsphere-infra-executor\src\main\java\org\apache\shardingsphere\infra\executor\sql\execute\engine\driver\jdbc\sane\mysql\MySQLSaneQueryResultEngine.java,0,22,1,31,0,54
 shardingsphere-master\shardingsphere-master\shardingsphere-features\shardingsphere-db-discovery\shardingsphere-db-discovery-distsql\shardingsphere-db-discovery-distsql-statement\src\main\java\org\apache\shardingsphere\dbdiscovery\distsql\parser\segment\AbstractDatabaseDiscoverySegment.java,7,5,1,1,0,7
 shardingsphere-master\shardingsphere-master\shardingsphere-features\shardingsphere-encrypt\shardingsphere-encrypt-core\src\main\java\org\apache\shardingsphere\encrypt\rewrite\token\pojo\EncryptParameterAssignmentToken.java,0,10,0,4,0,14
 shardingsphere-master\shardingsphere-master\shardingsphere-proxy\shardingsphere-proxy-backend\src\main\java\org\apache\shardingsphere\proxy\backend\text\distsql\ral\common\hint\executor\ClearReadwriteSplittingHintExecutor.java,0,2,0,7,0,9
 shardingsphere-master\shardingsphere-master\shardingsphere-sql-parser\shardingsphere-sql-parser-statement\src\main\java\org\apache\shardingsphere\sql\parser\sql\dialect\statement\mysql\segment\TLSOptionSegment.java,0,12,0,2,0,14
 shardingsphere-master\shardingsphere-master\shardingsphere-test\shardingsphere-parser-test\src\main\java\org\apache\shardingsphere\test\sql\parser\parameterized\jaxb\cases\domain\statement\distsql\rdl\create\CreateShadowAlgorithmStatementTestCase.java,0,4,0,6,0,10
 shardingsphere-master\shardingsphere-master\examples\shardingsphere-jdbc-example\single-feature-example\transaction-example\transaction-base-seata-spring-boot-example\src\test\java\org\apache\shardingsphere\example\transaction\base\seata\spring\boot\SeataATOrderServiceTest.java,33,14,1,1,0,16
 shardingsphere-master\shardingsphere-master\shardingsphere-features\shardingsphere-encrypt\shardingsphere-encrypt-core\src\test\java\org\apache\shardingsphere\encrypt\rewrite\pojo\EncryptParameterAssignmentTokenTest.java,0,3,0,3,0,6
 shardingsphere-master\shardingsphere-master\shardingsphere-features\shardingsphere-sharding\shardingsphere-sharding-core\src\test\java\org\apache\shardingsphere\sharding\route\engine\validator\dml\ShardingUpdateStatementValidatorTest.java,0,51,0,48,0,99
 shardingsphere-master\shardingsphere-master\shardingsphere-sql-parser\shardingsphere-sql-parser-statement\src\main\java\org\apache\shardingsphere\sql\parser\sql\common\statement\ddl\AlterProcedureStatement.java,3,1,1,3,0,5
 shardingsphere-master\shardingsphere-master\shardingsphere-infra\shardingsphere-infra-common\src\main\java\org\apache\shardingsphere\infra\metadata\schema\loader\adapter\MetaDataLoaderConnectionAdapter.java,0,80,0,22,0,102
 shardingsphere-master\shardingsphere-master\shardingsphere-proxy\shardingsphere-proxy-frontend\shardingsphere-proxy-frontend-mysql\src\test\java\org\apache\shardingsphere\proxy\frontend\mysql\authentication\MySQLAuthenticationEngineTest.java,0,72,7,47,0,126
 shardingsphere-master\shardingsphere-master\shardingsphere-test\shardingsphere-parser-test\src\main\java\org\apache\shardingsphere\test\sql\parser\parameterized\jaxb\cases\domain\segment\impl\expr\ExpectedInExpression.java,0,7,0,4,0,11
 shardingsphere-master\shardingsphere-master\shardingsphere-infra\shardingsphere-infra-context\src\main\java\org\apache\shardingsphere\infra\context\kernel\KernelProcessor.java,0,18,0,14,0,32
 shardingsphere-master\shardingsphere-master\shardingsphere-sql-parser\shardingsphere-sql-parser-statement\src\main\java\org\apache\shardingsphere\sql\parser\sql\dialect\statement\mysql\dal\MySQLShowCreateTriggerStatement.java,0,2,0,5,0,7
 shardingsphere-master\shardingsphere-master\examples\shardingsphere-jdbc-example\single-feature-example\encrypt-example\encrypt-spring-boot-mybatis-example\src\main\java\org\apache\shardingsphere\example\encrypt\spring\boot\mybatis\EncryptSpringBootMybatisExample.java,9,7,1,5,0,13
 shardingsphere-master\shardingsphere-master\shardingsphere-kernel\shardingsphere-data-pipeline\shardingsphere-data-pipeline-dialect\shardingsphere-data-pipeline-mysql\src\main\java\org\apache\shardingsphere\data\pipeline\mysql\ingest\column\value\UnsignedSmallintHandler.java,0,4,0,1,0,5
 shardingsphere-master\shardingsphere-master\shardingsphere-kernel\shardingsphere-data-pipeline\shardingsphere-data-pipeline-core\src\main\java\org\apache\shardingsphere\data\pipeline\core\ingest\IngestDataChangeType.java,0,5,0,1,0,6
 shardingsphere-master\shardingsphere-master\shardingsphere-sql-parser\shardingsphere-sql-parser-statement\src\main\java\org\apache\shardingsphere\sql\parser\sql\dialect\statement\mysql\dal\MySQLShowCreateEventStatement.java,0,3,0,5,0,8
 shardingsphere-master\shardingsphere-master\shardingsphere-infra\shardingsphere-infra-common\src\main\java\org\apache\shardingsphere\infra\hint\SQLHintProperties.java,0,3,0,2,0,5
 shardingsphere-master\shardingsphere-master\shardingsphere-sql-parser\shardingsphere-sql-parser-statement\src\main\java\org\apache\shardingsphere\sql\parser\sql\dialect\statement\postgresql\ddl\PostgreSQLDropIndexStatement.java,0,3,0,5,0,8
 shardingsphere-master\shardingsphere-master\shardingsphere-proxy\shardingsphere-proxy-backend\src\test\java\org\apache\shardingsphere\proxy\backend\text\distsql\ral\common\updatable\SetVariableExecutorTest.java,0,23,0,19,0,42
 shardingsphere-master\shardingsphere-master\shardingsphere-proxy\shardingsphere-proxy-frontend\shardingsphere-proxy-frontend-core\src\main\java\org\apache\shardingsphere\proxy\frontend\state\impl\LockProxyState.java,0,2,0,3,0,5
 shardingsphere-master\shardingsphere-master\shardingsphere-distsql\shardingsphere-distsql-statement\src\main\java\org\apache\shardingsphere\distsql\parser\statement\rdl\drop\DropRuleStatement.java,7,2,1,2,0,5
 shardingsphere-master\shardingsphere-master\shardingsphere-infra\shardingsphere-infra-common\src\main\java\org\apache\shardingsphere\infra\datasource\pool\creator\DataSourceReflection.java,0,51,0,26,0,77
 shardingsphere-master\shardingsphere-master\shardingsphere-sql-parser\shardingsphere-sql-parser-statement\src\main\java\org\apache\shardingsphere\sql\parser\sql\dialect\statement\postgresql\ddl\PostgreSQLAlterForeignTableStatement.java,0,1,0,5,0,6
 shardingsphere-master\shardingsphere-master\shardingsphere-sql-parser\shardingsphere-sql-parser-statement\src\main\java\org\apache\shardingsphere\sql\parser\sql\dialect\statement\postgresql\ddl\PostgreSQLDiscardStatement.java,0,1,0,6,0,7
 shardingsphere-master\shardingsphere-master\examples\shardingsphere-jdbc-example\single-feature-example\sharding-example\sharding-raw-jdbc-example\src\main\java\org\apache\shardingsphere\example\sharding\raw\jdbc\factory\YamlDataSourceFactory.java,0,10,1,8,0,19
 shardingsphere-master\shardingsphere-master\shardingsphere-agent\shardingsphere-agent-plugins\shardingsphere-agent-plugin-metrics\shardingsphere-agent-metrics-api\src\main\java\org\apache\shardingsphere\agent\metrics\api\threadlocal\ElapsedTimeThreadLocal.java,0,7,0,1,0,8
 shardingsphere-master\shardingsphere-master\shardingsphere-test\shardingsphere-pipeline-test\src\test\java\org\apache\shardingsphere\data\pipeline\scenario\rulealtered\RuleAlteredJobTest.java,0,12,0,14,0,26
 shardingsphere-master\shardingsphere-master\shardingsphere-sql-parser\shardingsphere-sql-parser-statement\src\main\java\org\apache\shardingsphere\sql\parser\sql\common\statement\ddl\ExecuteStatement.java,3,1,1,3,0,5
 shardingsphere-master\shardingsphere-master\shardingsphere-db-protocol\shardingsphere-db-protocol-postgresql\src\test\java\org\apache\shardingsphere\db\protocol\postgresql\codec\PostgreSQLPacketCodecEngineTest.java,0,37,0,10,0,47
 shardingsphere-master\shardingsphere-master\shardingsphere-sql-parser\shardingsphere-sql-parser-statement\src\main\java\org\apache\shardingsphere\sql\parser\sql\dialect\statement\postgresql\ddl\PostgreSQLCreateLanguageStatement.java,0,1,0,5,0,6
 shardingsphere-master\shardingsphere-master\shardingsphere-kernel\shardingsphere-traffic\shardingsphere-traffic-core\src\main\java\org\apache\shardingsphere\traffic\algorithm\traffic\hint\SQLHintTrafficAlgorithm.java,0,5,1,2,0,8
 shardingsphere-master\shardingsphere-master\shardingsphere-sql-parser\shardingsphere-sql-parser-statement\src\main\java\org\apache\shardingsphere\sql\parser\sql\dialect\statement\sql92\dml\SQL92InsertStatement.java,0,1,0,4,0,5
 shardingsphere-master\shardingsphere-master\shardingsphere-db-protocol\shardingsphere-db-protocol-mysql\src\main\java\org\apache\shardingsphere\db\protocol\mysql\packet\command\query\binary\execute\protocol\MySQLTimeBinaryProtocolValue.java,0,13,0,6,0,19
 shardingsphere-master\shardingsphere-master\shardingsphere-test\shardingsphere-integration-scaling-test\shardingsphere-integration-scaling-test-mysql\src\test\java\org\apache\shardingsphere\integration\scaling\test\mysql\fixture\DataImporter.java,0,24,1,12,0,37
 shardingsphere-master\shardingsphere-master\shardingsphere-infra\shardingsphere-infra-parser\src\test\java\org\apache\shardingsphere\infra\parser\cache\SQLStatementCacheLoaderTest.java,0,10,1,4,0,15
 shardingsphere-master\shardingsphere-master\shardingsphere-test\shardingsphere-parser-test\src\main\java\org\apache\shardingsphere\test\sql\parser\parameterized\jaxb\cases\domain\statement\distsql\rdl\drop\DropShardingKeyGeneratorStatementTestCase.java,0,3,0,4,0,7
 shardingsphere-master\shardingsphere-master\shardingsphere-infra\shardingsphere-infra-binder\src\main\java\org\apache\shardingsphere\infra\binder\statement\dml\SelectStatementContext.java,0,99,1,83,0,183
 shardingsphere-master\shardingsphere-master\shardingsphere-kernel\shardingsphere-transaction\shardingsphere-transaction-type\shardingsphere-transaction-xa\shardingsphere-transaction-xa-provider\shardingsphere-transaction-xa-narayana\src\test\java\org\apache\shardingsphere\transaction\xa\narayana\manager\DataSourceXAResourceRecoveryHelperTest.java,0,38,0,3,0,41
 shardingsphere-master\shardingsphere-master\shardingsphere-infra\shardingsphere-infra-binder\src\main\java\org\apache\shardingsphere\infra\binder\type\WhereAvailable.java,0,3,0,3,0,6
 shardingsphere-master\shardingsphere-master\shardingsphere-infra\shardingsphere-infra-common\src\test\java\org\apache\shardingsphere\infra\yaml\engine\fixture\YamlConstructFixture.java,0,3,1,2,0,6
 shardingsphere-master\shardingsphere-master\shardingsphere-mode\shardingsphere-mode-type\shardingsphere-cluster-mode\shardingsphere-cluster-mode-core\src\main\java\org\apache\shardingsphere\mode\manager\cluster\coordinator\lock\event\InnerLockReleasedEvent.java,0,2,0,1,0,3
 shardingsphere-master\shardingsphere-master\shardingsphere-features\shardingsphere-sharding\shardingsphere-sharding-distsql\shardingsphere-sharding-distsql-handler\src\main\java\org\apache\shardingsphere\sharding\distsql\handler\query\ShardingAlgorithmsQueryResultSet.java,0,16,0,9,0,25
 shardingsphere-master\shardingsphere-master\shardingsphere-agent\shardingsphere-agent-plugins\shardingsphere-agent-plugin-metrics\shardingsphere-agent-metrics-api\src\main\java\org\apache\shardingsphere\agent\metrics\api\advice\TransactionAdvice.java,0,9,0,4,0,13
 shardingsphere-master\shardingsphere-master\shardingsphere-infra\shardingsphere-infra-common\src\main\java\org\apache\shardingsphere\infra\metadata\user\ShardingSphereUser.java,0,8,0,2,0,10
 shardingsphere-master\shardingsphere-master\shardingsphere-test\shardingsphere-integration-test\shardingsphere-integration-test-suite\src\test\java\org\apache\shardingsphere\test\integration\env\IntegrationTestEnvironment.java,0,19,0,8,0,27
 shardingsphere-master\shardingsphere-master\shardingsphere-test\shardingsphere-parser-test\src\main\java\org\apache\shardingsphere\test\sql\parser\parameterized\asserts\statement\ddl\impl\DropIndexStatementAssert.java,0,14,0,20,0,34
 shardingsphere-master\shardingsphere-master\shardingsphere-proxy\shardingsphere-proxy-backend\src\main\java\org\apache\shardingsphere\proxy\backend\communication\jdbc\recognizer\impl\OracleRecognizer.java,0,3,0,3,0,6
 shardingsphere-master\shardingsphere-master\shardingsphere-jdbc\shardingsphere-jdbc-core\src\test\java\org\apache\shardingsphere\driver\jdbc\core\statement\ShardingSpherePreparedStatementTest.java,0,336,33,91,0,460
 shardingsphere-master\shardingsphere-master\shardingsphere-infra\shardingsphere-infra-federation\shardingsphere-infra-federation-optimizer\src\main\java\org\apache\shardingsphere\infra\federation\optimizer\context\parser\dialect\impl\SQLServerOptimizerBuilder.java,0,6,0,7,0,13
 shardingsphere-master\shardingsphere-master\shardingsphere-sql-parser\shardingsphere-sql-parser-statement\src\main\java\org\apache\shardingsphere\sql\parser\sql\common\statement\tcl\BeginTransactionStatement.java,3,1,1,3,0,5
 shardingsphere-master\shardingsphere-master\shardingsphere-infra\shardingsphere-infra-rewrite\src\main\java\org\apache\shardingsphere\infra\rewrite\sql\token\pojo\generic\ComposableSQLToken.java,0,11,0,2,0,13
 shardingsphere-master\shardingsphere-master\shardingsphere-mode\shardingsphere-mode-type\shardingsphere-standalone-mode\shardingsphere-standalone-mode-repository\shardingsphere-standalone-mode-repository-provider\shardingsphere-standalone-mode-repository-file\src\test\java\org\apache\shardingsphere\mode\repository\standalone\file\FileRepositoryTest.java,0,11,1,2,0,14
 shardingsphere-master\shardingsphere-master\shardingsphere-db-protocol\shardingsphere-db-protocol-postgresql\src\test\java\org\apache\shardingsphere\db\protocol\postgresql\packet\generic\PostgreSQLErrorResponsePacketTest.java,0,33,0,29,0,62
 shardingsphere-master\shardingsphere-master\shardingsphere-sql-parser\shardingsphere-sql-parser-statement\src\main\java\org\apache\shardingsphere\sql\parser\sql\common\statement\ddl\CreateLanguageStatement.java,3,1,1,3,0,5
 shardingsphere-master\shardingsphere-master\shardingsphere-db-protocol\shardingsphere-db-protocol-mysql\src\main\java\org\apache\shardingsphere\db\protocol\mysql\constant\MySQLServerErrorCode.java,0,49,0,11,0,60
 shardingsphere-master\shardingsphere-master\shardingsphere-kernel\shardingsphere-data-pipeline\shardingsphere-data-pipeline-dialect\shardingsphere-data-pipeline-postgresql\src\main\java\org\apache\shardingsphere\data\pipeline\postgresql\ingest\wal\decode\BaseTimestampUtils.java,0,1,0,1,0,2
 shardingsphere-master\shardingsphere-master\shardingsphere-sql-parser\shardingsphere-sql-parser-statement\src\main\java\org\apache\shardingsphere\sql\parser\sql\common\segment\dml\expr\subquery\SubqueryExpressionSegment.java,0,6,0,4,2,12
 shardingsphere-master\shardingsphere-master\shardingsphere-sql-parser\shardingsphere-sql-parser-dialect\shardingsphere-sql-parser-mysql\src\main\java\org\apache\shardingsphere\sql\parser\mysql\parser\MySQLParserFacade.java,0,3,0,1,0,4
 shardingsphere-master\shardingsphere-master\shardingsphere-infra\shardingsphere-infra-common\src\main\java\org\apache\shardingsphere\infra\yaml\config\pojo\algorithm\YamlShardingSphereAlgorithmConfiguration.java,0,6,0,2,0,8
 shardingsphere-master\shardingsphere-master\shardingsphere-features\shardingsphere-sharding\shardingsphere-sharding-api\src\main\java\org\apache\shardingsphere\sharding\api\config\strategy\sharding\NoneShardingStrategyConfiguration.java,0,2,0,2,0,4
 shardingsphere-master\shardingsphere-master\shardingsphere-infra\shardingsphere-infra-common\src\test\java\org\apache\shardingsphere\infra\yaml\config\swapper\rulealtered\OnRuleAlteredActionConfigurationYamlSwapperTest.java,0,26,0,19,0,45
 shardingsphere-master\shardingsphere-master\shardingsphere-features\shardingsphere-sharding\shardingsphere-sharding-core\src\main\java\org\apache\shardingsphere\sharding\route\engine\condition\ShardingCondition.java,8,4,0,2,0,6
 shardingsphere-master\shardingsphere-master\shardingsphere-test\shardingsphere-integration-test\shardingsphere-integration-test-suite\src\test\java\org\apache\shardingsphere\test\integration\cases\IntegrationTestCases.java,0,3,0,3,0,6
 shardingsphere-master\shardingsphere-master\shardingsphere-test\shardingsphere-integration-driver-test\src\test\java\org\apache\shardingsphere\driver\fixture\algorithm\DecrementKeyGenerateAlgorithm.java,0,7,1,2,0,10
 shardingsphere-master\shardingsphere-master\shardingsphere-infra\shardingsphere-infra-common\src\main\java\org\apache\shardingsphere\infra\datanode\DataNodeInfo.java,0,6,0,1,0,7
 shardingsphere-master\shardingsphere-master\shardingsphere-jdbc\shardingsphere-jdbc-core\src\main\java\org\apache\shardingsphere\driver\jdbc\core\datasource\metadata\ShardingSphereDatabaseMetaData.java,0,116,0,66,0,182
 shardingsphere-master\shardingsphere-master\shardingsphere-test\shardingsphere-parser-test\src\main\java\org\apache\shardingsphere\test\sql\parser\parameterized\asserts\statement\distsql\rdl\drop\impl\DropDefaultShardingStrategyStatementAssert.java,0,9,0,12,0,21
 shardingsphere-master\shardingsphere-master\shardingsphere-sql-parser\shardingsphere-sql-parser-statement\src\main\java\org\apache\shardingsphere\sql\parser\sql\dialect\statement\opengauss\ddl\OpenGaussCreateExtensionStatement.java,0,1,0,5,0,6
 shardingsphere-master\shardingsphere-master\shardingsphere-sql-parser\shardingsphere-sql-parser-statement\src\main\java\org\apache\shardingsphere\sql\parser\sql\dialect\statement\postgresql\dcl\PostgreSQLCreateUserStatement.java,0,1,0,5,0,6
 shardingsphere-master\shardingsphere-master\shardingsphere-features\shardingsphere-encrypt\shardingsphere-encrypt-core\src\test\java\org\apache\shardingsphere\encrypt\merge\dal\EncryptDALResultDecoratorTest.java,0,30,0,27,0,57
 shardingsphere-master\shardingsphere-master\shardingsphere-sql-parser\shardingsphere-sql-parser-dialect\shardingsphere-sql-parser-oracle\src\main\java\org\apache\shardingsphere\sql\parser\oracle\visitor\statement\impl\OracleDDLStatementSQLVisitor.java,0,103,0,176,0,279
 shardingsphere-master\shardingsphere-master\shardingsphere-kernel\shardingsphere-data-pipeline\shardingsphere-data-pipeline-spi\src\main\java\org\apache\shardingsphere\data\pipeline\api\task\progress\TaskProgress.java,0,0,0,1,0,1
 shardingsphere-master\shardingsphere-master\shardingsphere-test\shardingsphere-parser-test\src\main\java\org\apache\shardingsphere\test\sql\parser\parameterized\jaxb\cases\domain\segment\impl\index\ExpectedCacheTableIndex.java,0,6,0,5,0,11
 shardingsphere-master\shardingsphere-master\shardingsphere-spi\src\test\java\org\apache\shardingsphere\spi\typed\TypedSPIRegistryTest.java,0,15,0,5,0,20
 shardingsphere-master\shardingsphere-master\shardingsphere-infra\shardingsphere-infra-common\src\main\java\org\apache\shardingsphere\infra\yaml\config\pojo\YamlRootConfiguration.java,0,10,0,2,0,12
 shardingsphere-master\shardingsphere-master\shardingsphere-kernel\shardingsphere-data-pipeline\shardingsphere-data-pipeline-dialect\shardingsphere-data-pipeline-mysql\src\test\java\org\apache\shardingsphere\data\pipeline\mysql\check\datasource\MySQLDataSourceCheckerTest.java,0,28,0,6,0,34
 shardingsphere-master\shardingsphere-master\shardingsphere-mode\shardingsphere-mode-type\shardingsphere-cluster-mode\shardingsphere-cluster-mode-core\src\main\java\org\apache\shardingsphere\mode\manager\cluster\coordinator\lock\event\LockNotificationEvent.java,0,2,0,2,0,4
 shardingsphere-master\shardingsphere-master\shardingsphere-kernel\shardingsphere-transaction\shardingsphere-transaction-type\shardingsphere-transaction-xa\shardingsphere-transaction-xa-provider\shardingsphere-transaction-xa-atomikos\src\main\java\org\apache\shardingsphere\transaction\xa\atomikos\manager\AtomikosTransactionManagerProvider.java,0,17,0,7,0,24
 shardingsphere-master\shardingsphere-master\shardingsphere-distsql\shardingsphere-distsql-statement\src\main\java\org\apache\shardingsphere\distsql\parser\statement\ral\common\updatable\AlterInstanceStatement.java,0,7,0,2,0,9
 shardingsphere-master\shardingsphere-master\shardingsphere-proxy\shardingsphere-proxy-frontend\shardingsphere-proxy-frontend-core\src\main\java\org\apache\shardingsphere\proxy\frontend\command\CommandExecutorTask.java,0,34,0,23,0,57
 shardingsphere-master\shardingsphere-master\shardingsphere-agent\shardingsphere-agent-api\src\main\java\org\apache\shardingsphere\agent\config\AgentConfiguration.java,0,7,0,1,0,8
 shardingsphere-master\shardingsphere-master\shardingsphere-sql-parser\shardingsphere-sql-parser-statement\src\main\java\org\apache\shardingsphere\sql\parser\sql\dialect\statement\sqlserver\dcl\SQLServerCreateLoginStatement.java,0,3,0,6,0,9
 shardingsphere-master\shardingsphere-master\shardingsphere-test\shardingsphere-parser-test\src\main\java\org\apache\shardingsphere\test\sql\parser\parameterized\jaxb\cases\domain\statement\dal\HelpStatementTestCase.java,0,2,0,3,0,5
 shardingsphere-master\shardingsphere-master\shardingsphere-test\shardingsphere-parser-test\src\main\java\org\apache\shardingsphere\test\sql\parser\parameterized\asserts\statement\dcl\impl\DenyUserStatementAssert.java,0,13,0,15,0,28
 shardingsphere-master\shardingsphere-master\shardingsphere-features\shardingsphere-db-discovery\shardingsphere-db-discovery-distsql\shardingsphere-db-discovery-distsql-statement\src\main\java\org\apache\shardingsphere\dbdiscovery\distsql\parser\statement\CreateDatabaseDiscoveryHeartbeatStatement.java,0,3,0,4,0,7
 shardingsphere-master\shardingsphere-master\shardingsphere-db-protocol\shardingsphere-db-protocol-postgresql\src\test\java\org\apache\shardingsphere\db\protocol\postgresql\packet\command\query\simple\PostgreSQLComQueryPacketTest.java,0,6,0,5,0,11
 shardingsphere-master\shardingsphere-master\shardingsphere-sql-parser\shardingsphere-sql-parser-statement\src\main\java\org\apache\shardingsphere\sql\parser\sql\dialect\statement\opengauss\ddl\OpenGaussDropLanguageStatement.java,0,1,0,5,0,6
 shardingsphere-master\shardingsphere-master\shardingsphere-mode\shardingsphere-mode-type\shardingsphere-cluster-mode\shardingsphere-cluster-mode-core\src\main\java\org\apache\shardingsphere\mode\manager\cluster\coordinator\registry\metadata\event\SchemaDeletedEvent.java,0,2,0,3,0,5
 shardingsphere-master\shardingsphere-master\shardingsphere-features\shardingsphere-encrypt\shardingsphere-encrypt-core\src\test\java\org\apache\shardingsphere\encrypt\merge\dql\EncryptMergedResultTest.java,0,45,1,24,0,70
 shardingsphere-master\shardingsphere-master\shardingsphere-proxy\shardingsphere-proxy-backend\src\test\java\org\apache\shardingsphere\proxy\backend\exception\TableModifyInTransactionExceptionTest.java,38,24,0,24,0,48
 shardingsphere-master\shardingsphere-master\shardingsphere-features\shardingsphere-db-discovery\shardingsphere-db-discovery-core\src\test\java\org\apache\shardingsphere\dbdiscovery\rule\builder\DatabaseDiscoveryRuleBuilderTest.java,0,11,0,11,0,22
 shardingsphere-master\shardingsphere-master\shardingsphere-test\shardingsphere-parser-test\src\main\java\org\apache\shardingsphere\test\sql\parser\parameterized\jaxb\cases\domain\segment\impl\distsql\rdl\ExpectedDatabaseDiscoveryDefinitionRule.java,0,9,0,6,0,15
 shardingsphere-master\shardingsphere-master\shardingsphere-infra\shardingsphere-infra-datetime\shardingsphere-infra-datetime-type\shardingsphere-database-datetime\src\main\java\org\apache\shardingsphere\datetime\database\provider\DatetimeLoadingSQLProviderFactory.java,0,6,0,3,0,9
 shardingsphere-master\shardingsphere-master\shardingsphere-features\shardingsphere-sharding\shardingsphere-sharding-distsql\shardingsphere-sharding-distsql-statement\src\main\java\org\apache\shardingsphere\sharding\distsql\parser\statement\DropShardingBindingTableRulesStatement.java,0,8,0,5,0,13
 shardingsphere-master\shardingsphere-master\shardingsphere-mode\shardingsphere-mode-type\shardingsphere-cluster-mode\shardingsphere-cluster-mode-core\src\main\java\org\apache\shardingsphere\mode\manager\cluster\coordinator\registry\config\event\rule\GlobalRuleConfigurationsChangedEvent.java,0,4,0,4,0,8
 shardingsphere-master\shardingsphere-master\shardingsphere-sql-parser\shardingsphere-sql-parser-statement\src\main\java\org\apache\shardingsphere\sql\parser\sql\common\segment\dal\FromTableSegment.java,0,6,0,2,2,10
 shardingsphere-master\shardingsphere-master\shardingsphere-infra\shardingsphere-infra-common\src\main\java\org\apache\shardingsphere\infra\datasource\pool\metadata\type\dbcp\DBCPDataSourcePoolMetaData.java,0,13,0,4,0,17
 shardingsphere-master\shardingsphere-master\shardingsphere-test\shardingsphere-parser-test\src\main\java\org\apache\shardingsphere\test\sql\parser\parameterized\asserts\statement\dal\impl\MySQLAlterResourceGroupStatementAssert.java,0,5,0,8,0,13
 shardingsphere-master\shardingsphere-master\shardingsphere-features\shardingsphere-sharding\shardingsphere-sharding-distsql\shardingsphere-sharding-distsql-statement\src\main\java\org\apache\shardingsphere\scaling\distsql\statement\StopScalingSourceWritingStatement.java,0,3,0,3,0,6
 shardingsphere-master\shardingsphere-master\shardingsphere-infra\shardingsphere-infra-binder\src\main\java\org\apache\shardingsphere\infra\binder\statement\dal\ShowTablesStatementContext.java,0,5,0,5,0,10
 shardingsphere-master\shardingsphere-master\shardingsphere-agent\shardingsphere-agent-core\src\test\java\org\apache\shardingsphere\agent\core\mock\material\StaticMaterial.java,24,4,1,2,0,7
 shardingsphere-master\shardingsphere-master\examples\shardingsphere-jdbc-example\single-feature-example\encrypt-example\encrypt-raw-jdbc-example\src\main\java\org\apache\shardingsphere\example\encrypt\raw\jdbc\config\EncryptDatabasesConfiguration.java,0,11,0,13,0,24
 shardingsphere-master\shardingsphere-master\shardingsphere-infra\shardingsphere-infra-rewrite\src\main\java\org\apache\shardingsphere\infra\rewrite\sql\impl\DefaultSQLBuilder.java,0,3,0,1,0,4
 shardingsphere-master\shardingsphere-master\shardingsphere-features\shardingsphere-encrypt\shardingsphere-encrypt-core\src\main\java\org\apache\shardingsphere\encrypt\rule\EncryptTable.java,0,41,0,19,0,60
 shardingsphere-master\shardingsphere-master\shardingsphere-features\shardingsphere-sharding\shardingsphere-sharding-core\src\main\java\org\apache\shardingsphere\sharding\merge\dql\ShardingDQLResultMerger.java,0,47,0,47,0,94
 shardingsphere-master\shardingsphere-master\shardingsphere-mode\shardingsphere-mode-type\shardingsphere-cluster-mode\shardingsphere-cluster-mode-repository\shardingsphere-cluster-mode-repository-provider\shardingsphere-cluster-mode-repository-zookeeper-curator\src\main\java\org\apache\shardingsphere\mode\repository\cluster\zookeeper\props\ZookeeperProperties.java,0,4,0,2,0,6
 shardingsphere-master\shardingsphere-master\shardingsphere-features\shardingsphere-sharding\shardingsphere-sharding-core\src\main\java\org\apache\shardingsphere\sharding\algorithm\keygen\SnowflakeKeyGenerateAlgorithm.java,0,73,1,18,0,92
 shardingsphere-master\shardingsphere-master\shardingsphere-jdbc\shardingsphere-jdbc-core\src\main\java\org\apache\shardingsphere\driver\executor\callback\ExecuteUpdateCallback.java,0,2,0,1,0,3
 shardingsphere-master\shardingsphere-master\shardingsphere-infra\shardingsphere-infra-binder\src\test\java\org\apache\shardingsphere\infra\binder\statement\dal\ShowCreateTableStatementContextTest.java,0,5,0,10,0,15
 shardingsphere-master\shardingsphere-master\shardingsphere-kernel\shardingsphere-parser\shardingsphere-parser-core\src\main\java\org\apache\shardingsphere\parser\yaml\swapper\SQLParserRuleConfigurationYamlSwapper.java,0,19,0,16,0,35
 shardingsphere-master\shardingsphere-master\shardingsphere-distsql\shardingsphere-distsql-statement\src\main\java\org\apache\shardingsphere\distsql\parser\statement\ral\common\hint\ClearHintStatement.java,0,1,0,2,0,3
 shardingsphere-master\shardingsphere-master\shardingsphere-mode\shardingsphere-mode-type\shardingsphere-cluster-mode\shardingsphere-cluster-mode-core\src\main\java\org\apache\shardingsphere\mode\manager\cluster\coordinator\registry\process\event\ExecuteProcessUnitReportEvent.java,0,4,0,3,0,7
 shardingsphere-master\shardingsphere-master\shardingsphere-features\shardingsphere-sharding\shardingsphere-sharding-distsql\shardingsphere-sharding-distsql-handler\src\test\java\org\apache\shardingsphere\sharding\distsql\update\CreateShardingKeyGeneratorStatementUpdaterTest.java,0,32,0,23,0,55
 shardingsphere-master\shardingsphere-master\shardingsphere-sql-parser\shardingsphere-sql-parser-statement\src\main\java\org\apache\shardingsphere\sql\parser\sql\dialect\statement\sqlserver\dcl\SQLServerCreateRoleStatement.java,0,1,0,5,0,6
 shardingsphere-master\shardingsphere-master\shardingsphere-proxy\shardingsphere-proxy-backend\src\main\java\org\apache\shardingsphere\proxy\backend\communication\vertx\VertxBackendStatement.java,0,9,0,10,0,19
 shardingsphere-master\shardingsphere-master\shardingsphere-test\shardingsphere-parser-test\src\main\java\org\apache\shardingsphere\test\sql\parser\parameterized\asserts\statement\distsql\rdl\alter\impl\AlterReadwriteSplittingRuleStatementAssert.java,0,16,0,21,0,37
 shardingsphere-master\shardingsphere-master\shardingsphere-features\shardingsphere-shadow\shardingsphere-shadow-core\src\main\java\org\apache\shardingsphere\shadow\algorithm\shadow\column\ColumnRegexMatchShadowAlgorithm.java,0,10,0,4,0,14
 shardingsphere-master\shardingsphere-master\examples\shardingsphere-jdbc-example\single-feature-example\extension-example\custom-sharding-algortihm-example\spi-based-sharding-algorithm-example\spi-based-sharding-spring-boot-jpa-example\src\main\java\org\apache\shardingsphere\example\sharding\spring\boot\jpa\SPIBasedShardingSpringBootJpaExample.java,9,6,1,4,0,11
 shardingsphere-master\shardingsphere-master\shardingsphere-proxy\shardingsphere-proxy-backend\src\test\java\org\apache\shardingsphere\proxy\backend\communication\jdbc\recognizer\impl\PostgreSQLRecognizerTest.java,0,9,0,6,0,15
 shardingsphere-master\shardingsphere-master\shardingsphere-infra\shardingsphere-infra-binder\src\main\java\org\apache\shardingsphere\infra\binder\statement\dal\AnalyzeTableStatementContext.java,0,9,0,7,0,16
 shardingsphere-master\shardingsphere-master\shardingsphere-sql-parser\shardingsphere-sql-parser-statement\src\main\java\org\apache\shardingsphere\sql\parser\sql\dialect\statement\oracle\dcl\OracleCreateUserStatement.java,0,1,0,4,0,5
 shardingsphere-master\shardingsphere-master\shardingsphere-proxy\shardingsphere-proxy-backend\src\test\java\org\apache\shardingsphere\proxy\backend\text\admin\mysql\executor\UseDatabaseExecutorTest.java,0,31,1,20,0,52
 shardingsphere-master\shardingsphere-master\shardingsphere-features\shardingsphere-sharding\shardingsphere-sharding-core\src\test\java\org\apache\shardingsphere\sharding\route\engine\type\unicast\ShardingUnicastRoutingEngineTest.java,0,26,1,13,0,40
 shardingsphere-master\shardingsphere-master\shardingsphere-features\shardingsphere-sharding\shardingsphere-sharding-core\src\test\java\org\apache\shardingsphere\sharding\route\engine\condition\engine\InsertClauseShardingConditionEngineTest.java,0,70,0,52,0,122
 shardingsphere-master\shardingsphere-master\shardingsphere-db-protocol\shardingsphere-db-protocol-postgresql\src\main\java\org\apache\shardingsphere\db\protocol\postgresql\packet\command\query\simple\PostgreSQLComQueryPacket.java,0,7,1,6,0,14
 shardingsphere-master\shardingsphere-master\shardingsphere-jdbc\shardingsphere-jdbc-spring\shardingsphere-jdbc-core-spring\shardingsphere-jdbc-core-spring-namespace\src\main\java\org\apache\shardingsphere\spring\namespace\handler\mode\StandalonePersistRepositoryNamespaceHandler.java,0,3,0,5,0,8
 shardingsphere-master\shardingsphere-master\shardingsphere-sql-parser\shardingsphere-sql-parser-dialect\shardingsphere-sql-parser-mysql\src\main\java\org\apache\shardingsphere\sql\parser\mysql\visitor\format\impl\MySQLTCLFormatSQLVisitor.java,0,3,0,3,0,6
 shardingsphere-master\shardingsphere-master\examples\shardingsphere-proxy-example\shardingsphere-proxy-distsql-example\src\main\java\org\apache\shardingsphere\example\proxy\distsql\DistSQLHintExample.java,0,11,4,6,0,21
 shardingsphere-master\shardingsphere-master\shardingsphere-mode\shardingsphere-mode-type\shardingsphere-cluster-mode\shardingsphere-cluster-mode-core\src\main\java\org\apache\shardingsphere\mode\manager\cluster\coordinator\registry\process\event\ShowProcessListResponseEvent.java,0,2,0,2,0,4
 shardingsphere-master\shardingsphere-master\examples\shardingsphere-jdbc-example\single-feature-example\readwrite-splitting-example\readwrite-splitting-spring-namespace-mybatis-example\src\main\java\org\apache\shardingsphere\example\readwrite\splitting\spring\boot\mybatis\ReadwriteSplittingSpringNamespaceMybatisExample.java,0,9,1,5,0,15
 shardingsphere-master\shardingsphere-master\shardingsphere-test\shardingsphere-integration-scaling-test\shardingsphere-integration-scaling-test-mysql\src\test\java\org\apache\shardingsphere\integration\scaling\test\mysql\util\ExecuteUtil.java,0,8,0,1,0,9
 shardingsphere-master\shardingsphere-master\shardingsphere-sql-parser\shardingsphere-sql-parser-statement\src\main\java\org\apache\shardingsphere\sql\parser\sql\common\segment\generic\table\DeleteMultiTableSegment.java,0,11,1,2,2,16
 shardingsphere-master\shardingsphere-master\shardingsphere-proxy\shardingsphere-proxy-backend\src\main\java\org\apache\shardingsphere\proxy\backend\text\distsql\ral\common\hint\executor\AddShardingHintTableValueExecutor.java,0,5,0,8,0,13
 shardingsphere-master\shardingsphere-master\shardingsphere-agent\shardingsphere-agent-plugins\shardingsphere-agent-plugin-tracing\shardingsphere-agent-tracing-opentelemetry\src\main\java\org\apache\shardingsphere\agent\plugin\tracing\opentelemetry\advice\SQLParserEngineAdvice.java,29,12,0,10,0,22
 shardingsphere-master\shardingsphere-master\shardingsphere-infra\shardingsphere-infra-common\src\main\java\org\apache\shardingsphere\infra\yaml\schema\pojo\YamlColumnMetaData.java,0,11,0,1,0,12
 shardingsphere-master\shardingsphere-master\shardingsphere-infra\shardingsphere-infra-common\src\main\java\org\apache\shardingsphere\infra\distsql\update\RALUpdater.java,0,4,0,1,0,5
 shardingsphere-master\shardingsphere-master\shardingsphere-features\shardingsphere-sharding\shardingsphere-sharding-core\src\main\java\org\apache\shardingsphere\sharding\route\engine\type\ShardingRouteEngine.java,0,4,0,1,0,5
 shardingsphere-master\shardingsphere-master\examples\shardingsphere-jdbc-example\single-feature-example\transaction-example\transaction-2pc-xa-spring-namespace-example\src\main\java\org\apache\shardingsphere\example\transaction\xa\spring\namspace\XAOrderService.java,71,16,0,7,0,23
 shardingsphere-master\shardingsphere-master\shardingsphere-kernel\shardingsphere-traffic\shardingsphere-traffic-core\src\test\java\org\apache\shardingsphere\traffic\algorithm\traffic\transaction\ProxyTrafficAlgorithmTest.java,0,12,0,4,0,16
 shardingsphere-master\shardingsphere-master\shardingsphere-db-protocol\shardingsphere-db-protocol-opengauss\src\test\java\org\apache\shardingsphere\db\protocol\opengauss\packet\authentication\OpenGaussAuthenticationSCRAMSha256PacketTest.java,0,18,0,5,0,23
 shardingsphere-master\shardingsphere-master\shardingsphere-infra\shardingsphere-infra-common\src\test\java\org\apache\shardingsphere\infra\config\checker\RuleConfigurationCheckerFixture.java,0,3,1,3,0,7
 shardingsphere-master\shardingsphere-master\shardingsphere-test\shardingsphere-integration-test\shardingsphere-integration-test-suite\src\test\java\org\apache\shardingsphere\test\integration\engine\TotalSuitesCountCalculator.java,0,19,0,4,0,23
 shardingsphere-master\shardingsphere-master\shardingsphere-mode\shardingsphere-mode-type\shardingsphere-cluster-mode\shardingsphere-cluster-mode-core\src\main\java\org\apache\shardingsphere\mode\manager\cluster\coordinator\registry\config\event\rule\ScalingTaskFinishedEvent.java,0,6,0,2,0,8
 shardingsphere-master\shardingsphere-master\shardingsphere-infra\shardingsphere-infra-rewrite\src\main\java\org\apache\shardingsphere\infra\rewrite\sql\token\pojo\generic\OwnerToken.java,0,19,1,8,0,28
 shardingsphere-master\shardingsphere-master\shardingsphere-test\shardingsphere-parser-test\src\main\java\org\apache\shardingsphere\test\sql\parser\parameterized\jaxb\cases\domain\segment\impl\distsql\ExpectedProperty.java,0,5,0,4,0,9
 shardingsphere-master\shardingsphere-master\shardingsphere-features\shardingsphere-sharding\shardingsphere-sharding-distsql\shardingsphere-sharding-distsql-handler\src\main\java\org\apache\shardingsphere\sharding\distsql\handler\preprocess\AlterShardingTableRuleStatementPreprocessor.java,0,9,0,9,0,18
 shardingsphere-master\shardingsphere-master\shardingsphere-features\shardingsphere-sharding\shardingsphere-sharding-core\src\test\java\org\apache\shardingsphere\sharding\merge\dql\groupby\aggregation\AccumulationAggregationUnitTest.java,0,7,0,3,0,10
 shardingsphere-master\shardingsphere-master\shardingsphere-sql-parser\shardingsphere-sql-parser-statement\src\main\java\org\apache\shardingsphere\sql\parser\sql\dialect\statement\postgresql\tcl\PostgreSQLSetTransactionStatement.java,0,1,0,5,0,6
 shardingsphere-master\shardingsphere-master\shardingsphere-infra\shardingsphere-infra-binder\src\main\java\org\apache\shardingsphere\infra\binder\segment\select\subquery\SubqueryTableContext.java,0,7,0,1,0,8
 shardingsphere-master\shardingsphere-master\shardingsphere-kernel\shardingsphere-transaction\shardingsphere-transaction-type\shardingsphere-transaction-xa\shardingsphere-transaction-xa-core\src\test\java\org\apache\shardingsphere\transaction\xa\jta\datasource\properties\XADataSourceDefinitionFactoryTest.java,0,18,0,13,0,31
 shardingsphere-master\shardingsphere-master\shardingsphere-kernel\shardingsphere-transaction\shardingsphere-transaction-core\src\test\java\org\apache\shardingsphere\transaction\TransactionHolderTest.java,0,4,0,1,0,5
 shardingsphere-master\shardingsphere-master\shardingsphere-kernel\shardingsphere-data-pipeline\shardingsphere-data-pipeline-dialect\shardingsphere-data-pipeline-postgresql\src\main\java\org\apache\shardingsphere\data\pipeline\postgresql\ingest\wal\LogicalReplication.java,0,6,0,7,0,13
 shardingsphere-master\shardingsphere-master\shardingsphere-sql-parser\shardingsphere-sql-parser-statement\src\main\java\org\apache\shardingsphere\sql\parser\sql\common\statement\ddl\DropSequenceStatement.java,5,2,1,3,0,6
 shardingsphere-master\shardingsphere-master\shardingsphere-test\shardingsphere-integration-test\shardingsphere-integration-test-suite\src\test\java\org\apache\shardingsphere\test\integration\framework\database\DatabaseAssertionMetaData.java,0,3,0,2,0,5
 shardingsphere-master\shardingsphere-master\shardingsphere-jdbc\shardingsphere-jdbc-core\src\main\java\org\apache\shardingsphere\driver\state\DriverStateContext.java,0,8,0,4,0,12
 shardingsphere-master\shardingsphere-master\shardingsphere-features\shardingsphere-shadow\shardingsphere-shadow-distsql\shardingsphere-shadow-distsql-statement\src\main\java\org\apache\shardingsphere\shadow\distsql\parser\statement\ShowShadowAlgorithmsStatement.java,0,2,0,3,0,5
 shardingsphere-master\shardingsphere-master\shardingsphere-test\shardingsphere-parser-test\src\main\java\org\apache\shardingsphere\test\sql\parser\parameterized\jaxb\cases\domain\segment\impl\from\ExpectedFromSchema.java,0,3,0,4,0,7
 shardingsphere-master\shardingsphere-master\shardingsphere-sql-parser\shardingsphere-sql-parser-spi\src\main\java\org\apache\shardingsphere\sql\parser\api\visitor\SQLVisitor.java,0,0,0,1,0,1
 shardingsphere-master\shardingsphere-master\shardingsphere-sql-parser\shardingsphere-sql-parser-statement\src\main\java\org\apache\shardingsphere\sql\parser\sql\dialect\handler\ddl\CreateTableStatementHandler.java,0,12,0,21,5,38
 shardingsphere-master\shardingsphere-master\shardingsphere-kernel\shardingsphere-traffic\shardingsphere-traffic-core\src\main\java\org\apache\shardingsphere\traffic\algorithm\traffic\transaction\FirstSQLTrafficAlgorithm.java,0,6,1,6,0,13
 shardingsphere-master\shardingsphere-master\shardingsphere-infra\shardingsphere-infra-common\src\main\java\org\apache\shardingsphere\infra\metadata\schema\builder\SystemSchemaBuilder.java,0,18,2,16,0,36
 shardingsphere-master\shardingsphere-master\shardingsphere-features\shardingsphere-shadow\shardingsphere-shadow-core\src\main\java\org\apache\shardingsphere\shadow\route\engine\dml\AbstractShadowDMLStatementRouteEngine.java,143,49,2,35,0,86
 shardingsphere-master\shardingsphere-master\shardingsphere-agent\shardingsphere-agent-core\src\main\java\org\apache\shardingsphere\agent\core\plugin\interceptor\ClassStaticMethodInterceptorArgsOverride.java,63,12,7,10,0,29
 shardingsphere-master\shardingsphere-master\shardingsphere-mode\shardingsphere-mode-type\shardingsphere-cluster-mode\shardingsphere-cluster-mode-core\src\test\java\org\apache\shardingsphere\mode\manager\cluster\coordinator\fixture\YamlRuleConfigurationFixture.java,0,4,0,2,0,6
 shardingsphere-master\shardingsphere-master\shardingsphere-kernel\shardingsphere-data-pipeline\shardingsphere-data-pipeline-dialect\shardingsphere-data-pipeline-mysql\src\main\java\org\apache\shardingsphere\data\pipeline\mysql\importer\MySQLImporter.java,0,8,0,10,0,18
 shardingsphere-master\shardingsphere-master\shardingsphere-db-protocol\shardingsphere-db-protocol-mysql\src\main\java\org\apache\shardingsphere\db\protocol\mysql\packet\binlog\row\column\value\string\MySQLVarcharBinlogProtocolValue.java,0,6,0,7,0,13
 shardingsphere-master\shardingsphere-master\shardingsphere-proxy\shardingsphere-proxy-backend\src\main\java\org\apache\shardingsphere\proxy\backend\text\distsql\ral\common\hint\executor\ClearHintExecutor.java,0,2,0,7,0,9
 shardingsphere-master\shardingsphere-master\shardingsphere-infra\shardingsphere-infra-rewrite\src\main\java\org\apache\shardingsphere\infra\rewrite\sql\token\pojo\generic\InsertValue.java,27,6,0,8,0,14
 shardingsphere-master\shardingsphere-master\shardingsphere-mode\shardingsphere-mode-type\shardingsphere-cluster-mode\shardingsphere-cluster-mode-repository\shardingsphere-cluster-mode-repository-provider\shardingsphere-cluster-mode-repository-zookeeper-curator\src\test\java\org\apache\shardingsphere\mode\repository\cluster\zookeeper\CuratorZookeeperRepositoryTest.java,0,118,3,52,0,173
 shardingsphere-master\shardingsphere-master\shardingsphere-test\shardingsphere-parser-test\src\main\java\org\apache\shardingsphere\test\sql\parser\parameterized\jaxb\cases\domain\segment\impl\expr\simple\ExpectedParameterMarkerExpression.java,0,3,0,3,0,6
 shardingsphere-master\shardingsphere-master\shardingsphere-infra\shardingsphere-infra-common\src\main\java\org\apache\shardingsphere\infra\metadata\schema\loader\dialect\OracleTableMetaDataLoader.java,0,69,0,38,0,107
 shardingsphere-master\shardingsphere-master\shardingsphere-mode\shardingsphere-mode-core\src\main\java\org\apache\shardingsphere\mode\metadata\persist\MetaDataPersistService.java,0,58,0,42,0,100
 shardingsphere-master\shardingsphere-master\shardingsphere-features\shardingsphere-sharding\shardingsphere-sharding-core\src\test\java\org\apache\shardingsphere\sharding\fixture\StandardShardingAlgorithmFixture.java,0,8,1,8,0,17
 shardingsphere-master\shardingsphere-master\shardingsphere-test\shardingsphere-parser-test\src\main\java\org\apache\shardingsphere\test\sql\parser\parameterized\jaxb\cases\domain\statement\distsql\rdl\drop\DropShadowAlgorithmStatementTestCase.java,0,5,0,4,0,9
 shardingsphere-master\shardingsphere-master\shardingsphere-test\shardingsphere-parser-test\src\main\java\org\apache\shardingsphere\test\sql\parser\parameterized\jaxb\cases\domain\statement\distsql\rdl\alter\AlterDefaultSingleTableRuleStatementTestCase.java,0,3,0,4,0,7
 shardingsphere-master\shardingsphere-master\shardingsphere-sql-parser\shardingsphere-sql-parser-statement\src\main\java\org\apache\shardingsphere\sql\parser\sql\dialect\statement\opengauss\ddl\OpenGaussDropExtensionStatement.java,0,1,0,5,0,6
 shardingsphere-master\shardingsphere-master\shardingsphere-sql-parser\shardingsphere-sql-parser-statement\src\test\java\org\apache\shardingsphere\sql\parser\sql\dialect\handler\ddl\CreateTableStatementHandlerTest.java,0,28,0,20,0,48
 shardingsphere-master\shardingsphere-master\shardingsphere-sql-parser\shardingsphere-sql-parser-statement\src\main\java\org\apache\shardingsphere\sql\parser\sql\common\segment\dml\assignment\ColumnAssignmentSegment.java,0,8,0,3,2,13
 shardingsphere-master\shardingsphere-master\shardingsphere-infra\shardingsphere-infra-common\src\main\java\org\apache\shardingsphere\infra\database\metadata\url\JdbcUrlAppender.java,0,11,0,8,0,19
 shardingsphere-master\shardingsphere-master\shardingsphere-test\shardingsphere-parser-test\src\main\java\org\apache\shardingsphere\test\sql\parser\parameterized\asserts\statement\distsql\ral\impl\common\queryable\ShowTrafficRulesStatementAssert.java,0,7,0,10,0,17
 shardingsphere-master\shardingsphere-master\shardingsphere-test\shardingsphere-parser-test\src\main\java\org\apache\shardingsphere\test\sql\parser\parameterized\jaxb\cases\domain\statement\distsql\ral\AlterInstanceStatementTestCase.java,0,6,0,3,0,9
 shardingsphere-master\shardingsphere-master\shardingsphere-features\shardingsphere-encrypt\shardingsphere-encrypt-distsql\shardingsphere-encrypt-distsql-parser\src\main\java\org\apache\shardingsphere\encrypt\distsql\parser\facade\EncryptDistSQLStatementParserFacade.java,0,6,0,6,0,12
 shardingsphere-master\shardingsphere-master\shardingsphere-test\shardingsphere-parser-test\src\main\java\org\apache\shardingsphere\test\sql\parser\parameterized\asserts\segment\definition\ColumnDefinitionAssert.java,0,12,0,14,0,26
 shardingsphere-master\shardingsphere-master\shardingsphere-sql-parser\shardingsphere-sql-parser-statement\src\main\java\org\apache\shardingsphere\sql\parser\sql\dialect\statement\mysql\ddl\MySQLDropFunctionStatement.java,0,1,0,4,0,5
 shardingsphere-master\shardingsphere-master\shardingsphere-features\shardingsphere-sharding\shardingsphere-sharding-core\src\main\java\org\apache\shardingsphere\sharding\rule\BindingTableRule.java,0,23,4,15,0,42
 shardingsphere-master\shardingsphere-master\shardingsphere-agent\shardingsphere-agent-plugins\shardingsphere-agent-plugin-tracing\shardingsphere-agent-tracing-zipkin\src\main\java\org\apache\shardingsphere\agent\plugin\tracing\zipkin\advice\SQLParserEngineAdvice.java,0,11,0,8,0,19
 shardingsphere-master\shardingsphere-master\examples\shardingsphere-jdbc-example\single-feature-example\extension-example\custom-sharding-algortihm-example\spi-based-sharding-algorithm-example\spi-based-sharding-raw-jdbc-example\src\main\java\org\apache\shardingsphere\example\extension\spibased\sharding\raw\jdbc\fixture\SPIBasedStandardShardingAlgorithmFixture.java,0,4,1,8,0,13
 shardingsphere-master\shardingsphere-master\shardingsphere-kernel\shardingsphere-data-pipeline\shardingsphere-data-pipeline-spi\src\main\java\org\apache\shardingsphere\data\pipeline\api\detect\RuleAlteredJobAlmostCompletedParameter.java,0,5,0,1,0,6
 shardingsphere-master\shardingsphere-master\shardingsphere-proxy\shardingsphere-proxy-backend\src\main\java\org\apache\shardingsphere\proxy\backend\response\header\query\impl\MySQLQueryHeaderBuilder.java,0,12,1,12,0,25
 shardingsphere-master\shardingsphere-master\shardingsphere-test\shardingsphere-parser-test\src\main\java\org\apache\shardingsphere\test\sql\parser\parameterized\asserts\statement\dcl\impl\AlterRoleStatementAssert.java,0,4,1,6,0,11
 shardingsphere-master\shardingsphere-master\shardingsphere-proxy\shardingsphere-proxy-backend\src\main\java\org\apache\shardingsphere\proxy\backend\communication\jdbc\statement\StatementMemoryStrictlyFetchSizeSetter.java,0,3,0,2,0,5
 shardingsphere-master\shardingsphere-master\shardingsphere-test\shardingsphere-parser-test\src\main\java\org\apache\shardingsphere\test\sql\parser\parameterized\asserts\statement\dal\impl\MySQLBinlogStatementAssert.java,0,4,0,7,0,11
 shardingsphere-master\shardingsphere-master\shardingsphere-test\shardingsphere-rewrite-test\src\test\java\org\apache\shardingsphere\sharding\rewrite\parameterized\engine\AbstractSQLRewriterParameterizedTest.java,62,38,1,31,0,70
 shardingsphere-master\shardingsphere-master\shardingsphere-test\shardingsphere-parser-test\src\main\java\org\apache\shardingsphere\test\sql\parser\parameterized\jaxb\cases\domain\statement\distsql\rdl\alter\DisableShardingScalingRuleStatementTestCase.java,0,2,0,4,0,6
 shardingsphere-master\shardingsphere-master\shardingsphere-sql-parser\shardingsphere-sql-parser-statement\src\main\java\org\apache\shardingsphere\sql\parser\sql\dialect\statement\mysql\dcl\MySQLSetDefaultRoleStatement.java,0,1,0,5,0,6
 shardingsphere-master\shardingsphere-master\shardingsphere-test\shardingsphere-parser-test\src\main\java\org\apache\shardingsphere\test\sql\parser\parameterized\jaxb\cases\domain\segment\impl\union\ExpectedUnion.java,0,5,0,4,0,9
 shardingsphere-master\shardingsphere-master\shardingsphere-db-protocol\shardingsphere-db-protocol-mysql\src\main\java\org\apache\shardingsphere\db\protocol\mysql\packet\handshake\MySQLAuthSwitchResponsePacket.java,0,8,0,2,0,10
 shardingsphere-master\shardingsphere-master\shardingsphere-sql-parser\shardingsphere-sql-parser-statement\src\main\java\org\apache\shardingsphere\sql\parser\sql\dialect\statement\postgresql\ddl\PostgreSQLAlterGroupStatement.java,0,1,0,5,0,6
 shardingsphere-master\shardingsphere-master\shardingsphere-proxy\shardingsphere-proxy-backend\src\main\java\org\apache\shardingsphere\proxy\backend\text\distsql\ral\UpdatableRALBackendHandler.java,0,7,0,5,0,12
 shardingsphere-master\shardingsphere-master\shardingsphere-db-protocol\shardingsphere-db-protocol-mysql\src\test\java\org\apache\shardingsphere\db\protocol\mysql\packet\binlog\row\column\value\integer\MySQLInt24BinlogProtocolValueTest.java,0,9,0,4,0,13
 shardingsphere-master\shardingsphere-master\shardingsphere-proxy\shardingsphere-proxy-frontend\shardingsphere-proxy-frontend-core\src\test\java\org\apache\shardingsphere\proxy\frontend\state\impl\LockProxyStateTest.java,0,2,0,1,0,3
 shardingsphere-master\shardingsphere-master\shardingsphere-jdbc\shardingsphere-jdbc-core\src\test\java\org\apache\shardingsphere\driver\jdbc\base\AbstractShardingSphereDataSourceForEncryptTest.java,63,33,0,16,0,49
 shardingsphere-master\shardingsphere-master\shardingsphere-db-protocol\shardingsphere-db-protocol-postgresql\src\main\java\org\apache\shardingsphere\db\protocol\postgresql\packet\command\PostgreSQLCommandPacketTypeLoader.java,0,4,0,4,0,8
 shardingsphere-master\shardingsphere-master\shardingsphere-infra\shardingsphere-infra-executor\src\main\java\org\apache\shardingsphere\infra\executor\sql\execute\result\query\impl\raw\type\RawMemoryQueryResult.java,0,4,0,6,0,10
 shardingsphere-master\shardingsphere-master\shardingsphere-sql-parser\shardingsphere-sql-parser-statement\src\main\java\org\apache\shardingsphere\sql\parser\sql\common\segment\ddl\column\alter\ChangeColumnDefinitionSegment.java,0,12,0,7,4,23
 shardingsphere-master\shardingsphere-master\shardingsphere-infra\shardingsphere-infra-common\src\test\java\org\apache\shardingsphere\infra\database\metadata\dialect\OracleDataSourceMetaDataTest.java,0,44,3,17,0,64
 shardingsphere-master\shardingsphere-master\shardingsphere-sql-parser\shardingsphere-sql-parser-statement\src\main\java\org\apache\shardingsphere\sql\parser\sql\dialect\statement\mysql\dal\MySQLUseStatement.java,0,1,0,4,0,5
 shardingsphere-master\shardingsphere-master\examples\example-core\example-spring-mybatis\src\main\java\org\apache\shardingsphere\example\core\mybatis\repository\MybatisShadowUserRepository.java,0,21,0,2,0,23
 shardingsphere-master\shardingsphere-master\shardingsphere-sql-parser\shardingsphere-sql-parser-statement\src\main\java\org\apache\shardingsphere\sql\parser\sql\dialect\statement\opengauss\dml\OpenGaussInsertStatement.java,0,6,0,7,0,13
 shardingsphere-master\shardingsphere-master\shardingsphere-proxy\shardingsphere-proxy-backend\src\test\java\org\apache\shardingsphere\proxy\backend\text\database\DropDatabaseBackendHandlerTest.java,0,25,0,9,0,34
 shardingsphere-master\shardingsphere-master\shardingsphere-kernel\shardingsphere-data-pipeline\shardingsphere-data-pipeline-core\src\main\java\org\apache\shardingsphere\data\pipeline\core\task\InventoryTask.java,0,37,3,24,0,64
 shardingsphere-master\shardingsphere-master\examples\shardingsphere-example-generator\src\main\java\org\apache\shardingsphere\example\generator\scenario\framework\FrameworkExampleScenario.java,0,1,0,1,0,2
 shardingsphere-master\shardingsphere-master\shardingsphere-features\shardingsphere-shadow\shardingsphere-shadow-core\src\main\java\org\apache\shardingsphere\shadow\route\engine\impl\ShadowNonDMLStatementRoutingEngine.java,0,19,0,15,0,34
 shardingsphere-master\shardingsphere-master\shardingsphere-infra\shardingsphere-infra-merge\src\test\java\org\apache\shardingsphere\infra\merge\fixture\rule\DecoratorRuleFixture.java,0,2,0,1,0,3
 shardingsphere-master\shardingsphere-master\shardingsphere-features\shardingsphere-sharding\shardingsphere-sharding-core\src\test\java\org\apache\shardingsphere\sharding\rewrite\token\ConstraintTokenGeneratorTest.java,0,17,1,21,0,39
 shardingsphere-master\shardingsphere-master\shardingsphere-infra\shardingsphere-infra-rewrite\src\main\java\org\apache\shardingsphere\infra\rewrite\engine\result\SQLRewriteResult.java,0,0,0,1,0,1
 shardingsphere-master\shardingsphere-master\shardingsphere-kernel\shardingsphere-transaction\shardingsphere-transaction-core\src\main\java\org\apache\shardingsphere\transaction\ShardingSphereTransactionManagerEngine.java,0,24,1,15,0,40
 shardingsphere-master\shardingsphere-master\shardingsphere-distsql\shardingsphere-distsql-statement\src\main\java\org\apache\shardingsphere\distsql\parser\statement\rql\show\ShowRulesUsedResourceStatement.java,0,6,0,3,0,9
 shardingsphere-master\shardingsphere-master\shardingsphere-sql-parser\shardingsphere-sql-parser-statement\src\main\java\org\apache\shardingsphere\sql\parser\sql\common\segment\dml\pagination\rownum\NumberLiteralRowNumberValueSegment.java,0,8,0,5,0,13
 shardingsphere-master\shardingsphere-master\shardingsphere-features\shardingsphere-encrypt\shardingsphere-encrypt-core\src\main\java\org\apache\shardingsphere\encrypt\yaml\config\rule\YamlEncryptColumnRuleConfiguration.java,0,12,0,2,0,14
 shardingsphere-master\shardingsphere-master\shardingsphere-test\shardingsphere-parser-test\src\main\java\org\apache\shardingsphere\test\sql\parser\parameterized\jaxb\cases\domain\statement\distsql\rdl\alter\AlterShardingTableRuleStatementTestCase.java,0,3,0,5,0,8
 shardingsphere-master\shardingsphere-master\shardingsphere-kernel\shardingsphere-transaction\shardingsphere-transaction-core\src\main\java\org\apache\shardingsphere\transaction\core\TransactionTypeHolder.java,0,7,0,2,0,9
 shardingsphere-master\shardingsphere-master\shardingsphere-infra\shardingsphere-infra-common\src\main\java\org\apache\shardingsphere\infra\config\props\ConfigurationProperties.java,0,4,0,2,0,6
 shardingsphere-master\shardingsphere-master\shardingsphere-test\shardingsphere-parser-test\src\main\java\org\apache\shardingsphere\test\sql\parser\parameterized\jaxb\cases\domain\statement\distsql\rdl\alter\AlterDatabaseDiscoveryHeartbeatStatementTestCase.java,0,4,0,6,0,10
 shardingsphere-master\shardingsphere-master\shardingsphere-proxy\shardingsphere-proxy-frontend\shardingsphere-proxy-frontend-mysql\src\main\java\org\apache\shardingsphere\proxy\frontend\mysql\command\admin\ping\MySQLComPingExecutor.java,0,2,0,2,0,4
 shardingsphere-master\shardingsphere-master\shardingsphere-features\shardingsphere-sharding\shardingsphere-sharding-distsql\shardingsphere-sharding-distsql-handler\src\main\java\org\apache\shardingsphere\scaling\distsql\handler\DropShardingScalingRuleStatementUpdater.java,0,21,0,16,0,37
 shardingsphere-master\shardingsphere-master\shardingsphere-db-protocol\shardingsphere-db-protocol-core\src\main\java\org\apache\shardingsphere\db\protocol\codec\PacketCodec.java,0,8,0,5,0,13
 shardingsphere-master\shardingsphere-master\shardingsphere-features\shardingsphere-sharding\shardingsphere-sharding-distsql\shardingsphere-sharding-distsql-handler\src\test\java\org\apache\shardingsphere\data\pipeline\spi\ratelimit\FixtureInputJobRateLimitAlgorithm.java,0,5,2,2,0,9
 shardingsphere-master\shardingsphere-master\shardingsphere-features\shardingsphere-encrypt\shardingsphere-encrypt-core\src\main\java\org\apache\shardingsphere\encrypt\rewrite\parameter\rewriter\EncryptInsertValueParameterRewriter.java,0,41,1,40,0,82
 shardingsphere-master\shardingsphere-master\shardingsphere-db-protocol\shardingsphere-db-protocol-postgresql\src\main\java\org\apache\shardingsphere\db\protocol\postgresql\packet\handshake\authentication\PostgreSQLPasswordAuthenticationPacket.java,0,5,0,7,0,12
 shardingsphere-master\shardingsphere-master\shardingsphere-features\shardingsphere-shadow\shardingsphere-shadow-distsql\shardingsphere-shadow-distsql-handler\src\test\java\org\apache\shardingsphere\shadow\distsql\update\DropShadowAlgorithmStatementUpdaterTest.java,0,19,0,13,0,32
 shardingsphere-master\shardingsphere-master\shardingsphere-proxy\shardingsphere-proxy-backend\src\main\java\org\apache\shardingsphere\proxy\backend\text\distsql\ral\common\queryable\CountInstanceRulesHandler.java,0,71,0,40,0,111
 shardingsphere-master\shardingsphere-master\examples\shardingsphere-jdbc-example\single-feature-example\cluster-mode-example\cluster-mode-raw-jdbc-example\src\main\java\org\apache\shardingsphere\example\cluster\mode\raw\jdbc\ClusterModeRawJavaConfigurationExample.java,0,30,1,25,0,56
 shardingsphere-master\shardingsphere-master\shardingsphere-sql-parser\shardingsphere-sql-parser-statement\src\main\java\org\apache\shardingsphere\sql\parser\sql\common\statement\tcl\TCLStatement.java,0,0,0,1,0,1
 shardingsphere-master\shardingsphere-master\shardingsphere-sql-parser\shardingsphere-sql-parser-statement\src\test\java\org\apache\shardingsphere\sql\parser\sql\dialect\handler\ddl\AlterViewStatementHandlerTest.java,0,8,0,8,0,16
 shardingsphere-master\shardingsphere-master\shardingsphere-infra\shardingsphere-infra-binder\src\test\java\org\apache\shardingsphere\infra\binder\statement\ddl\AlterViewStatementContextTest.java,0,10,0,16,0,26
 shardingsphere-master\shardingsphere-master\shardingsphere-infra\shardingsphere-infra-binder\src\main\java\org\apache\shardingsphere\infra\binder\segment\select\projection\impl\AggregationDistinctProjection.java,0,16,0,3,0,19
 shardingsphere-master\shardingsphere-master\shardingsphere-test\shardingsphere-parser-test\src\main\java\org\apache\shardingsphere\test\sql\parser\parameterized\asserts\statement\distsql\ral\impl\common\updatable\ImportSchemaConfigurationStatementAssert.java,0,8,0,11,0,19
 shardingsphere-master\shardingsphere-master\shardingsphere-db-protocol\shardingsphere-db-protocol-postgresql\src\main\java\org\apache\shardingsphere\db\protocol\postgresql\packet\command\query\extended\PostgreSQLAggregatedCommandPacket.java,0,31,3,19,0,53
 shardingsphere-master\shardingsphere-master\shardingsphere-mode\shardingsphere-mode-core\src\test\java\org\apache\shardingsphere\mode\metadata\persist\service\SchemaMetaDataPersistServiceTest.java,0,33,0,20,0,53
 shardingsphere-master\shardingsphere-master\shardingsphere-sql-parser\shardingsphere-sql-parser-statement\src\main\java\org\apache\shardingsphere\sql\parser\sql\dialect\statement\sqlserver\ddl\SQLServerCreateServiceStatement.java,0,1,0,6,0,7
 shardingsphere-master\shardingsphere-master\shardingsphere-infra\shardingsphere-infra-common\src\main\java\org\apache\shardingsphere\infra\distsql\exception\resource\ImportResourceNotExistedException.java,0,6,0,3,0,9
 shardingsphere-master\shardingsphere-master\shardingsphere-sql-parser\shardingsphere-sql-parser-statement\src\main\java\org\apache\shardingsphere\sql\parser\sql\common\segment\generic\WithSegment.java,0,7,0,3,2,12
 shardingsphere-master\shardingsphere-master\shardingsphere-db-protocol\shardingsphere-db-protocol-mysql\src\main\java\org\apache\shardingsphere\db\protocol\mysql\packet\command\admin\ping\MySQLComPingPacket.java,0,5,0,4,0,9
 shardingsphere-master\shardingsphere-master\shardingsphere-features\shardingsphere-sharding\shardingsphere-sharding-core\src\main\java\org\apache\shardingsphere\sharding\yaml\config\strategy\keygen\YamlKeyGenerateStrategyConfiguration.java,0,6,0,2,0,8
 shardingsphere-master\shardingsphere-master\shardingsphere-jdbc\shardingsphere-jdbc-core\src\main\java\org\apache\shardingsphere\driver\jdbc\adapter\AbstractDataSourceAdapter.java,10,4,0,2,0,6
 shardingsphere-master\shardingsphere-master\shardingsphere-features\shardingsphere-encrypt\shardingsphere-encrypt-core\src\main\java\org\apache\shardingsphere\encrypt\yaml\swapper\rule\EncryptColumnRuleConfigurationYamlSwapper.java,0,8,0,9,0,17
 shardingsphere-master\shardingsphere-master\shardingsphere-jdbc\shardingsphere-jdbc-core\src\test\java\org\apache\shardingsphere\driver\jdbc\adapter\ConnectionAdapterTest.java,0,20,2,7,0,29
 shardingsphere-master\shardingsphere-master\shardingsphere-test\shardingsphere-parser-test\src\main\java\org\apache\shardingsphere\test\sql\parser\parameterized\jaxb\cases\domain\statement\dml\DeleteStatementTestCase.java,0,14,0,10,0,24
 shardingsphere-master\shardingsphere-master\shardingsphere-test\shardingsphere-integration-driver-test\src\test\java\org\apache\shardingsphere\driver\fixture\TestClusterPersistRepository.java,0,21,4,9,0,34
 shardingsphere-master\shardingsphere-master\shardingsphere-test\shardingsphere-parser-test\src\main\java\org\apache\shardingsphere\test\sql\parser\parameterized\jaxb\cases\domain\statement\dal\ShowFunctionStatusStatementTestCase.java,0,3,0,5,0,8
 shardingsphere-master\shardingsphere-master\shardingsphere-features\shardingsphere-encrypt\shardingsphere-encrypt-core\src\test\java\org\apache\shardingsphere\encrypt\merge\dql\fixture\EncryptColumnsMergedResultFixture.java,0,8,0,4,0,12
 shardingsphere-master\shardingsphere-master\shardingsphere-infra\shardingsphere-infra-rewrite\src\main\java\org\apache\shardingsphere\infra\rewrite\sql\token\pojo\generic\InsertValuesToken.java,13,7,0,2,0,9
 shardingsphere-master\shardingsphere-master\examples\shardingsphere-jdbc-example\single-feature-example\transaction-example\transaction-2pc-xa-spring-boot-example\src\test\java\org\apache\shardingsphere\example\transaction\xa\spring\boot\XAOrderServiceTest.java,33,14,1,1,0,16
 shardingsphere-master\shardingsphere-master\shardingsphere-jdbc\shardingsphere-jdbc-core\src\test\java\org\apache\shardingsphere\driver\jdbc\core\resultset\GeneratedKeysResultSetMetaDataTest.java,0,57,0,6,0,63
 shardingsphere-master\shardingsphere-master\shardingsphere-infra\shardingsphere-infra-binder\src\main\java\org\apache\shardingsphere\infra\binder\statement\dal\FlushStatementContext.java,0,7,0,7,0,14
 shardingsphere-master\shardingsphere-master\shardingsphere-proxy\shardingsphere-proxy-frontend\shardingsphere-proxy-frontend-core\src\test\java\org\apache\shardingsphere\proxy\frontend\protocol\DatabaseProtocolFrontendEngineFactoryTest.java,0,8,0,6,0,14
 shardingsphere-master\shardingsphere-master\shardingsphere-jdbc\shardingsphere-jdbc-spring\shardingsphere-jdbc-transaction-spring\src\main\java\org\apache\shardingsphere\spring\transaction\TransactionTypeAdvisor.java,0,12,0,5,0,17
 shardingsphere-master\shardingsphere-master\shardingsphere-kernel\shardingsphere-data-pipeline\shardingsphere-data-pipeline-dialect\shardingsphere-data-pipeline-postgresql\src\main\java\org\apache\shardingsphere\data\pipeline\postgresql\ingest\wal\decode\DecodingPlugin.java,0,2,0,3,0,5
 shardingsphere-master\shardingsphere-master\shardingsphere-jdbc\shardingsphere-jdbc-spring\shardingsphere-jdbc-spring-infra\shardingsphere-jdbc-spring-boot-starter-infra\src\main\java\org\apache\shardingsphere\spring\boot\datasource\AopProxyUtils.java,0,14,5,7,0,26
 shardingsphere-master\shardingsphere-master\shardingsphere-proxy\shardingsphere-proxy-frontend\shardingsphere-proxy-frontend-postgresql\src\test\java\org\apache\shardingsphere\proxy\frontend\postgresql\command\query\extended\describe\PostgreSQLComDescribeExecutorTest.java,0,114,2,71,0,187
 shardingsphere-master\shardingsphere-master\shardingsphere-sql-parser\shardingsphere-sql-parser-statement\src\main\java\org\apache\shardingsphere\sql\parser\sql\common\segment\generic\PrivilegeTypeEnum.java,0,66,0,1,0,67
 shardingsphere-master\shardingsphere-master\shardingsphere-test\shardingsphere-integration-test\shardingsphere-integration-test-suite\src\test\java\org\apache\shardingsphere\test\integration\framework\param\array\MemoryParameterizedArrayGenerator.java,0,16,0,11,0,27
 shardingsphere-master\shardingsphere-master\shardingsphere-sql-parser\shardingsphere-sql-parser-statement\src\main\java\org\apache\shardingsphere\sql\parser\sql\dialect\statement\postgresql\tcl\PostgreSQLSavepointStatement.java,0,1,0,5,0,6
 shardingsphere-master\shardingsphere-master\shardingsphere-features\shardingsphere-shadow\shardingsphere-shadow-api\src\main\java\org\apache\shardingsphere\shadow\api\config\datasource\ShadowDataSourceConfiguration.java,0,5,0,1,0,6
 shardingsphere-master\shardingsphere-master\shardingsphere-infra\shardingsphere-infra-common\src\main\java\org\apache\shardingsphere\infra\metadata\schema\loader\dialect\PostgreSQLTableMetaDataLoader.java,0,58,0,40,0,98
 shardingsphere-master\shardingsphere-master\shardingsphere-kernel\shardingsphere-data-pipeline\shardingsphere-data-pipeline-core\src\main\java\org\apache\shardingsphere\data\pipeline\core\check\datasource\AbstractDataSourceChecker.java,49,15,0,12,0,27
 shardingsphere-master\shardingsphere-master\shardingsphere-features\shardingsphere-readwrite-splitting\shardingsphere-readwrite-splitting-distsql\shardingsphere-readwrite-splitting-distsql-handler\src\test\java\org\apache\shardingsphere\readwritesplitting\distsql\handler\update\CreateReadwriteSplittingRuleStatementUpdaterTest.java,0,41,0,30,0,71
 shardingsphere-master\shardingsphere-master\shardingsphere-sql-parser\shardingsphere-sql-parser-statement\src\main\java\org\apache\shardingsphere\sql\parser\sql\dialect\statement\postgresql\tcl\PostgreSQLSetConstraintsStatement.java,0,1,0,5,0,6
 shardingsphere-master\shardingsphere-master\shardingsphere-mode\shardingsphere-mode-core\src\main\java\org\apache\shardingsphere\mode\metadata\persist\service\SchemaMetaDataPersistService.java,0,39,2,27,0,68
 shardingsphere-master\shardingsphere-master\shardingsphere-infra\shardingsphere-infra-binder\src\main\java\org\apache\shardingsphere\infra\binder\statement\ddl\AlterTableStatementContext.java,0,21,0,27,0,48
 shardingsphere-master\shardingsphere-master\shardingsphere-infra\shardingsphere-infra-common\src\main\java\org\apache\shardingsphere\infra\instance\definition\InstanceType.java,0,3,0,1,0,4
 shardingsphere-master\shardingsphere-master\shardingsphere-infra\shardingsphere-infra-common\src\main\java\org\apache\shardingsphere\infra\rule\event\impl\DataSourceDisabledEvent.java,0,10,0,2,0,12
 shardingsphere-master\shardingsphere-master\shardingsphere-agent\shardingsphere-agent-plugins\shardingsphere-agent-plugin-tracing\shardingsphere-agent-tracing-jaeger\src\main\java\org\apache\shardingsphere\agent\plugin\tracing\jaeger\service\JaegerTracingPluginBootService.java,0,14,0,8,0,22
 shardingsphere-master\shardingsphere-master\shardingsphere-mode\shardingsphere-mode-core\src\test\java\org\apache\shardingsphere\mode\manager\ContextManagerTest.java,0,115,0,73,0,188
 shardingsphere-master\shardingsphere-master\examples\shardingsphere-jdbc-example\single-feature-example\encrypt-example\encrypt-raw-jdbc-example\src\main\java\org\apache\shardingsphere\example\encrypt\raw\jdbc\EncryptRawJavaConfigurationExample.java,0,8,1,6,0,15
 shardingsphere-master\shardingsphere-master\shardingsphere-test\shardingsphere-parser-test\src\main\java\org\apache\shardingsphere\test\sql\parser\parameterized\jaxb\CasesRegistry.java,0,11,0,3,0,14
 shardingsphere-master\shardingsphere-master\shardingsphere-features\shardingsphere-sharding\shardingsphere-sharding-distsql\shardingsphere-sharding-distsql-handler\src\test\java\org\apache\shardingsphere\sharding\distsql\checker\ShardingRuleStatementCheckerTest.java,0,119,0,90,0,209
 shardingsphere-master\shardingsphere-master\shardingsphere-proxy\shardingsphere-proxy-backend\src\test\java\org\apache\shardingsphere\proxy\backend\text\transaction\TransactionBackendHandlerFactoryTest.java,0,43,3,40,0,86
 shardingsphere-master\shardingsphere-master\shardingsphere-test\shardingsphere-parser-test\src\main\java\org\apache\shardingsphere\test\sql\parser\parameterized\asserts\statement\distsql\rql\impl\rule\ShowShadowRulesStatementAssert.java,0,6,0,10,0,16
 shardingsphere-master\shardingsphere-master\shardingsphere-test\shardingsphere-parser-test\src\main\java\org\apache\shardingsphere\test\sql\parser\parameterized\asserts\segment\parameter\ParameterMarkerAssert.java,0,7,0,7,0,14
 shardingsphere-master\shardingsphere-master\shardingsphere-distsql\shardingsphere-distsql-statement\src\main\java\org\apache\shardingsphere\distsql\parser\statement\ral\common\updatable\ApplyDistSQLStatement.java,0,0,0,2,0,2
 shardingsphere-master\shardingsphere-master\shardingsphere-sql-parser\shardingsphere-sql-parser-statement\src\main\java\org\apache\shardingsphere\sql\parser\sql\dialect\statement\sqlserver\ddl\SQLServerDropFunctionStatement.java,0,1,0,5,0,6
 shardingsphere-master\shardingsphere-master\shardingsphere-test\shardingsphere-integration-test\shardingsphere-integration-test-suite\src\test\java\org\apache\shardingsphere\test\integration\cases\SQLExecuteType.java,0,3,0,1,0,4
 shardingsphere-master\shardingsphere-master\shardingsphere-features\shardingsphere-sharding\shardingsphere-sharding-distsql\shardingsphere-sharding-distsql-handler\src\test\java\org\apache\shardingsphere\scaling\distsql\handler\DropShardingScalingRuleStatementUpdaterTest.java,0,28,0,14,0,42
 shardingsphere-master\shardingsphere-master\shardingsphere-sql-parser\shardingsphere-sql-parser-statement\src\main\java\org\apache\shardingsphere\sql\parser\sql\dialect\statement\oracle\ddl\OracleCreateFunctionStatement.java,0,1,0,4,0,5
 shardingsphere-master\shardingsphere-master\shardingsphere-sql-parser\shardingsphere-sql-parser-statement\src\main\java\org\apache\shardingsphere\sql\parser\sql\dialect\statement\sqlserver\dal\SQLServerExplainStatement.java,0,2,0,5,0,7
 shardingsphere-master\shardingsphere-master\shardingsphere-jdbc\shardingsphere-jdbc-spring\shardingsphere-jdbc-spring-infra\shardingsphere-jdbc-spring-namespace-infra\src\test\java\org\apache\shardingsphere\spring\namespace\fixture\ShardingSphereFixtureAlgorithm.java,0,1,0,3,0,4
 shardingsphere-master\shardingsphere-master\shardingsphere-mode\shardingsphere-mode-type\shardingsphere-standalone-mode\shardingsphere-standalone-mode-core\src\main\java\org\apache\shardingsphere\mode\manager\standalone\workerid\generator\StandaloneWorkerIdGenerator.java,0,2,0,1,0,3
 shardingsphere-master\shardingsphere-master\shardingsphere-test\shardingsphere-integration-test\shardingsphere-integration-test-suite\src\test\java\org\apache\shardingsphere\test\integration\framework\container\atomic\storage\StorageContainer.java,0,3,0,3,0,6
 shardingsphere-master\shardingsphere-master\shardingsphere-test\shardingsphere-parser-test\src\main\java\org\apache\shardingsphere\test\sql\parser\parameterized\jaxb\cases\domain\segment\impl\window\ExpectedWindowClause.java,0,1,0,3,0,4
 shardingsphere-master\shardingsphere-master\shardingsphere-agent\shardingsphere-agent-plugins\shardingsphere-agent-plugin-metrics\shardingsphere-agent-metrics-api\src\test\java\org\apache\shardingsphere\agent\metrics\api\MetricsPoolTest.java,0,2,0,2,0,4
 shardingsphere-master\shardingsphere-master\shardingsphere-features\shardingsphere-sharding\shardingsphere-sharding-distsql\shardingsphere-sharding-distsql-handler\src\test\java\org\apache\shardingsphere\scaling\distsql\handler\DisabledShardingScalingRuleStatementUpdaterTest.java,0,25,0,13,0,38
 shardingsphere-master\shardingsphere-master\shardingsphere-features\shardingsphere-shadow\shardingsphere-shadow-core\src\main\java\org\apache\shardingsphere\shadow\yaml\swapper\ShadowRuleAlgorithmProviderConfigurationYamlSwapper.java,0,33,0,24,0,57
 shardingsphere-master\shardingsphere-master\shardingsphere-sql-parser\shardingsphere-sql-parser-engine\src\test\java\org\apache\shardingsphere\sql\parser\fixture\DatabaseTypedSQLParserFacadeFixture.java,0,5,0,2,0,7
 shardingsphere-master\shardingsphere-master\shardingsphere-test\shardingsphere-parser-test\src\main\java\org\apache\shardingsphere\test\sql\parser\parameterized\jaxb\cases\domain\segment\impl\expr\complex\ExpectedCommonExpression.java,0,3,0,3,0,6
 shardingsphere-master\shardingsphere-master\shardingsphere-features\shardingsphere-sharding\shardingsphere-sharding-core\src\main\java\org\apache\shardingsphere\sharding\route\engine\condition\engine\ShardingConditionEngine.java,0,4,0,3,0,7
 shardingsphere-master\shardingsphere-master\shardingsphere-infra\shardingsphere-infra-common\src\main\java\org\apache\shardingsphere\infra\rule\identifier\type\DataSourceContainedRule.java,0,1,0,1,0,2
 shardingsphere-master\shardingsphere-master\shardingsphere-kernel\shardingsphere-data-pipeline\shardingsphere-data-pipeline-dialect\shardingsphere-data-pipeline-postgresql\src\test\java\org\apache\shardingsphere\data\pipeline\postgresql\ingest\wal\WalEventConverterTest.java,0,35,0,20,0,55
 shardingsphere-master\shardingsphere-master\shardingsphere-infra\shardingsphere-infra-common\src\main\java\org\apache\shardingsphere\infra\database\metadata\dialect\OpenGaussDataSourceMetaData.java,0,15,0,2,0,17
 shardingsphere-master\shardingsphere-master\shardingsphere-kernel\shardingsphere-data-pipeline\shardingsphere-data-pipeline-core\src\main\java\org\apache\shardingsphere\data\pipeline\core\job\FinishedCheckJob.java,0,26,0,27,0,53
 shardingsphere-master\shardingsphere-master\shardingsphere-features\shardingsphere-sharding\shardingsphere-sharding-core\src\main\java\org\apache\shardingsphere\sharding\merge\dql\groupby\aggregation\AverageAggregationUnit.java,0,7,2,1,0,10
 shardingsphere-master\shardingsphere-master\shardingsphere-infra\shardingsphere-infra-binder\src\main\java\org\apache\shardingsphere\infra\binder\statement\dml\CopyStatementContext.java,0,3,0,4,0,7
 shardingsphere-master\shardingsphere-master\shardingsphere-infra\shardingsphere-infra-federation\shardingsphere-infra-federation-optimizer\src\main\java\org\apache\shardingsphere\infra\federation\optimizer\converter\segment\groupby\HavingConverter.java,0,4,0,7,0,11
 shardingsphere-master\shardingsphere-master\shardingsphere-sql-parser\shardingsphere-sql-parser-statement\src\main\java\org\apache\shardingsphere\sql\parser\sql\dialect\statement\opengauss\dcl\OpenGaussRevokeStatement.java,0,1,0,5,0,6
 shardingsphere-master\shardingsphere-master\shardingsphere-db-protocol\shardingsphere-db-protocol-postgresql\src\main\java\org\apache\shardingsphere\db\protocol\postgresql\packet\command\query\extended\PostgreSQLColumnType.java,0,135,0,9,0,144
 shardingsphere-master\shardingsphere-master\shardingsphere-kernel\shardingsphere-authority\shardingsphere-authority-core\src\test\java\org\apache\shardingsphere\authority\provider\natived\builder\dialect\PostgreSQLPrivilegeHandlerTest.java,0,53,8,36,0,97
 shardingsphere-master\shardingsphere-master\shardingsphere-infra\shardingsphere-infra-datetime\shardingsphere-infra-datetime-type\shardingsphere-database-datetime\src\main\java\org\apache\shardingsphere\datetime\database\provider\dialect\OracleDatetimeLoadingSQLProvider.java,0,3,0,3,0,6
 shardingsphere-master\shardingsphere-master\shardingsphere-sql-parser\shardingsphere-sql-parser-statement\src\main\java\org\apache\shardingsphere\sql\parser\sql\common\statement\available\FromSchemaAvailable.java,0,3,0,2,0,5
 shardingsphere-master\shardingsphere-master\shardingsphere-test\shardingsphere-parser-test\src\main\java\org\apache\shardingsphere\test\sql\parser\parameterized\asserts\statement\distsql\rdl\drop\impl\DropShadowAlgorithmStatementAssert.java,0,8,0,11,0,19
 shardingsphere-master\shardingsphere-master\shardingsphere-infra\shardingsphere-infra-binder\src\main\java\org\apache\shardingsphere\infra\binder\statement\ddl\CreateProcedureStatementContext.java,0,8,0,10,0,18
 shardingsphere-master\shardingsphere-master\shardingsphere-test\shardingsphere-parser-test\src\main\java\org\apache\shardingsphere\test\sql\parser\parameterized\jaxb\cases\domain\segment\ExpectedSQLSegment.java,0,4,0,2,0,6
 shardingsphere-master\shardingsphere-master\shardingsphere-kernel\shardingsphere-single-table\shardingsphere-single-table-core\src\test\java\org\apache\shardingsphere\singletable\rule\builder\DefaultSingleTableSchemaRuleConfigurationBuilderTest.java,0,6,0,7,0,13
 shardingsphere-master\shardingsphere-master\shardingsphere-sql-parser\shardingsphere-sql-parser-statement\src\main\java\org\apache\shardingsphere\sql\parser\sql\dialect\statement\sqlserver\ddl\SQLServerCreateTriggerStatement.java,0,1,0,6,0,7
 shardingsphere-master\shardingsphere-master\shardingsphere-spi\src\test\java\org\apache\shardingsphere\spi\fixture\required\RequiredSPIFixture.java,0,0,0,1,0,1
 shardingsphere-master\shardingsphere-master\shardingsphere-sql-parser\shardingsphere-sql-parser-statement\src\main\java\org\apache\shardingsphere\sql\parser\sql\common\statement\ddl\DropExtensionStatement.java,3,1,1,3,0,5
 shardingsphere-master\shardingsphere-master\shardingsphere-jdbc\shardingsphere-jdbc-core\src\main\java\org\apache\shardingsphere\driver\executor\batch\BatchPreparedStatementExecutor.java,0,73,1,44,0,118
 shardingsphere-master\shardingsphere-master\shardingsphere-infra\shardingsphere-infra-common\src\test\java\org\apache\shardingsphere\infra\metadata\schema\builder\TableMetaDataBuilderTest.java,0,15,0,7,0,22
 shardingsphere-master\shardingsphere-master\shardingsphere-infra\shardingsphere-infra-federation\shardingsphere-infra-federation-optimizer\src\main\java\org\apache\shardingsphere\infra\federation\optimizer\converter\segment\projection\impl\SubqueryProjectionConverter.java,0,18,0,19,0,37
 shardingsphere-master\shardingsphere-master\shardingsphere-features\shardingsphere-sharding\shardingsphere-sharding-core\src\test\java\org\apache\shardingsphere\sharding\rewrite\token\DistinctProjectionPrefixTokenGeneratorTest.java,0,15,0,19,0,34
 shardingsphere-master\shardingsphere-master\shardingsphere-sql-parser\shardingsphere-sql-parser-statement\src\main\java\org\apache\shardingsphere\sql\parser\sql\common\segment\generic\SchemaSegment.java,0,6,0,2,0,8
 shardingsphere-master\shardingsphere-master\shardingsphere-sql-parser\shardingsphere-sql-parser-statement\src\main\java\org\apache\shardingsphere\sql\parser\sql\dialect\statement\mysql\dcl\MySQLDropUserStatement.java,0,1,0,4,0,5
 shardingsphere-master\shardingsphere-master\shardingsphere-features\shardingsphere-sharding\shardingsphere-sharding-distsql\shardingsphere-sharding-distsql-statement\src\main\java\org\apache\shardingsphere\sharding\distsql\parser\statement\CreateShardingKeyGeneratorStatement.java,0,3,0,4,0,7
 shardingsphere-master\shardingsphere-master\shardingsphere-features\shardingsphere-encrypt\shardingsphere-encrypt-core\src\test\java\org\apache\shardingsphere\encrypt\fixture\TestEncryptAlgorithm.java,0,7,1,4,0,12
 shardingsphere-master\shardingsphere-master\shardingsphere-db-protocol\shardingsphere-db-protocol-mysql\src\main\java\org\apache\shardingsphere\db\protocol\mysql\constant\MySQLAuthenticationMethod.java,0,14,0,2,0,16
 shardingsphere-master\shardingsphere-master\shardingsphere-kernel\shardingsphere-data-pipeline\shardingsphere-data-pipeline-spi\src\main\java\org\apache\shardingsphere\data\pipeline\api\ingest\record\PlaceholderRecord.java,0,2,0,2,0,4
 shardingsphere-master\shardingsphere-master\shardingsphere-sql-parser\shardingsphere-sql-parser-statement\src\main\java\org\apache\shardingsphere\sql\parser\sql\dialect\statement\mysql\dal\MySQLAlterResourceGroupStatement.java,0,4,0,5,0,9
 shardingsphere-master\shardingsphere-master\shardingsphere-proxy\shardingsphere-proxy-backend\src\main\java\org\apache\shardingsphere\proxy\backend\text\admin\opengauss\schema\OgDatabase.java,0,6,0,1,0,7
 shardingsphere-master\shardingsphere-master\shardingsphere-infra\shardingsphere-infra-common\src\main\java\org\apache\shardingsphere\infra\metadata\schema\loader\SchemaLoader.java,0,10,1,8,0,19
 shardingsphere-master\shardingsphere-master\shardingsphere-features\shardingsphere-shadow\shardingsphere-shadow-core\src\test\java\org\apache\shardingsphere\shadow\route\engine\determiner\HintShadowAlgorithmDeterminerTest.java,0,14,0,13,0,27
 shardingsphere-master\shardingsphere-master\shardingsphere-test\shardingsphere-parser-test\src\main\java\org\apache\shardingsphere\test\sql\parser\parameterized\asserts\statement\distsql\rql\impl\rule\ShowSingleTableStatementAssert.java,0,7,0,11,0,18
 shardingsphere-master\shardingsphere-master\shardingsphere-test\shardingsphere-parser-test\src\main\java\org\apache\shardingsphere\test\sql\parser\parameterized\asserts\statement\dal\impl\ShowTableStatusStatementAssert.java,0,8,0,13,0,21
 shardingsphere-master\shardingsphere-master\shardingsphere-test\shardingsphere-parser-test\src\main\java\org\apache\shardingsphere\test\sql\parser\parameterized\asserts\statement\dcl\impl\sqlserver\SQLServerGrantStatementAssert.java,0,6,0,10,0,16
 shardingsphere-master\shardingsphere-master\shardingsphere-infra\shardingsphere-infra-federation\shardingsphere-infra-federation-executor\src\main\java\org\apache\shardingsphere\infra\federation\executor\FederationExecutorFactory.java,0,8,0,7,0,15
 shardingsphere-master\shardingsphere-master\shardingsphere-test\shardingsphere-rewrite-test\src\test\java\org\apache\shardingsphere\sharding\rewrite\parameterized\scenario\EncryptSQLRewriterParameterizedTest.java,0,32,8,21,0,61
 shardingsphere-master\shardingsphere-master\shardingsphere-sql-parser\shardingsphere-sql-parser-dialect\shardingsphere-sql-parser-oracle\src\test\java\org\apache\shardingsphere\sql\parser\oracle\OracleParserParameterizedTest.java,0,7,0,5,0,12
 shardingsphere-master\shardingsphere-master\shardingsphere-features\shardingsphere-sharding\shardingsphere-sharding-distsql\shardingsphere-sharding-distsql-statement\src\main\java\org\apache\shardingsphere\sharding\distsql\parser\statement\AlterShardingBroadcastTableRulesStatement.java,0,3,0,3,0,6
 shardingsphere-master\shardingsphere-master\shardingsphere-test\shardingsphere-parser-test\src\main\java\org\apache\shardingsphere\test\sql\parser\parameterized\jaxb\cases\domain\statement\ddl\DropPolicyStatementTestCase.java,0,0,0,3,0,3
 shardingsphere-master\shardingsphere-master\examples\shardingsphere-example-generator\src\main\java\org\apache\shardingsphere\example\generator\scenario\framework\type\SpringNamespaceJdbcExampleScenario.java,0,10,0,7,0,17
 shardingsphere-master\shardingsphere-master\shardingsphere-features\shardingsphere-sharding\shardingsphere-sharding-core\src\main\java\org\apache\shardingsphere\sharding\algorithm\sharding\mod\HashModShardingAlgorithm.java,0,21,0,11,0,32
 shardingsphere-master\shardingsphere-master\shardingsphere-features\shardingsphere-shadow\shardingsphere-shadow-distsql\shardingsphere-shadow-distsql-handler\src\main\java\org\apache\shardingsphere\shadow\distsql\handler\update\DropDefaultShadowAlgorithmStatementUpdater.java,0,21,0,16,0,37
 shardingsphere-master\shardingsphere-master\shardingsphere-proxy\shardingsphere-proxy-backend\src\main\java\org\apache\shardingsphere\proxy\backend\exception\SchemaLockedException.java,0,3,0,1,0,4
 shardingsphere-master\shardingsphere-master\shardingsphere-kernel\shardingsphere-transaction\shardingsphere-transaction-core\src\main\java\org\apache\shardingsphere\transaction\core\TransactionType.java,0,9,0,3,0,12
 shardingsphere-master\shardingsphere-master\shardingsphere-agent\shardingsphere-agent-plugins\shardingsphere-agent-plugin-tracing\shardingsphere-agent-tracing-opentelemetry\src\main\java\org\apache\shardingsphere\agent\plugin\tracing\opentelemetry\advice\CommandExecutorTaskAdvice.java,27,11,0,8,0,19
 shardingsphere-master\shardingsphere-master\shardingsphere-sql-parser\shardingsphere-sql-parser-statement\src\main\java\org\apache\shardingsphere\sql\parser\sql\common\statement\dcl\GrantStatement.java,5,2,1,4,1,8
 shardingsphere-master\shardingsphere-master\shardingsphere-features\shardingsphere-sharding\shardingsphere-sharding-core\src\main\java\org\apache\shardingsphere\sharding\constant\ShardingOrder.java,0,4,0,1,0,5
 shardingsphere-master\shardingsphere-master\shardingsphere-db-protocol\shardingsphere-db-protocol-postgresql\src\main\java\org\apache\shardingsphere\db\protocol\postgresql\packet\command\query\extended\bind\protocol\PostgreSQLDoubleBinaryProtocolValue.java,0,7,0,6,0,13
 shardingsphere-master\shardingsphere-master\examples\shardingsphere-example-generator\src\main\java\org\apache\shardingsphere\example\generator\scenario\framework\type\JDBCExampleScenario.java,0,11,0,6,0,17
 shardingsphere-master\shardingsphere-master\shardingsphere-proxy\shardingsphere-proxy-frontend\shardingsphere-proxy-frontend-postgresql\src\main\java\org\apache\shardingsphere\proxy\frontend\postgresql\PostgreSQLFrontendEngine.java,0,20,0,16,0,36
 shardingsphere-master\shardingsphere-master\shardingsphere-kernel\shardingsphere-data-pipeline\shardingsphere-data-pipeline-core\src\main\java\org\apache\shardingsphere\data\pipeline\scenario\rulealtered\RuleAlteredJob.java,0,13,2,11,0,26
 shardingsphere-master\shardingsphere-master\shardingsphere-infra\shardingsphere-infra-common\src\main\java\org\apache\shardingsphere\infra\datasource\pool\destroyer\detector\type\HikariDataSourcePoolActiveDetector.java,0,6,0,5,0,11
 shardingsphere-master\shardingsphere-master\shardingsphere-features\shardingsphere-db-discovery\shardingsphere-db-discovery-core\src\main\java\org\apache\shardingsphere\dbdiscovery\checker\DatabaseDiscoveryRuleConfigurationChecker.java,0,7,0,5,0,12
 shardingsphere-master\shardingsphere-master\shardingsphere-test\shardingsphere-parser-test\src\main\java\org\apache\shardingsphere\test\sql\parser\parameterized\asserts\segment\type\TypeAssert.java,0,7,0,13,0,20
 shardingsphere-master\shardingsphere-master\shardingsphere-kernel\shardingsphere-transaction\shardingsphere-transaction-type\shardingsphere-transaction-base\shardingsphere-transaction-base-seata-at\src\test\java\org\apache\shardingsphere\transaction\base\seata\at\SeataATShardingSphereTransactionManagerTest.java,0,67,7,29,0,103
 shardingsphere-master\shardingsphere-master\shardingsphere-features\shardingsphere-encrypt\shardingsphere-encrypt-api\src\main\java\org\apache\shardingsphere\encrypt\spi\context\EncryptColumnDataType.java,0,14,1,5,0,20
 shardingsphere-master\shardingsphere-master\shardingsphere-features\shardingsphere-sharding\shardingsphere-sharding-distsql\shardingsphere-sharding-distsql-statement\src\main\java\org\apache\shardingsphere\sharding\distsql\parser\statement\AlterShardingBindingTableRulesStatement.java,0,5,0,4,0,9
 shardingsphere-master\shardingsphere-master\shardingsphere-infra\shardingsphere-infra-executor\src\main\java\org\apache\shardingsphere\infra\executor\kernel\thread\ExecutorServiceManager.java,0,20,0,7,0,27
 shardingsphere-master\shardingsphere-master\shardingsphere-proxy\shardingsphere-proxy-backend\src\main\java\org\apache\shardingsphere\proxy\backend\response\data\impl\TextQueryResponseCell.java,0,2,0,1,0,3
 shardingsphere-master\shardingsphere-master\shardingsphere-sql-parser\shardingsphere-sql-parser-statement\src\main\java\org\apache\shardingsphere\sql\parser\sql\dialect\statement\mysql\dal\MySQLShowEventsStatement.java,0,7,0,7,1,15
 shardingsphere-master\shardingsphere-master\shardingsphere-infra\shardingsphere-infra-common\src\main\java\org\apache\shardingsphere\infra\rule\event\impl\PrimaryDataSourceChangedEvent.java,0,3,0,2,0,5
 shardingsphere-master\shardingsphere-master\shardingsphere-features\shardingsphere-sharding\shardingsphere-sharding-core\src\test\java\org\apache\shardingsphere\sharding\rewrite\token\OffsetTokenGeneratorTest.java,0,20,0,26,0,46
 shardingsphere-master\shardingsphere-master\shardingsphere-test\shardingsphere-parser-test\src\main\java\org\apache\shardingsphere\test\sql\parser\parameterized\asserts\statement\dal\impl\ShutdownStatementAssert.java,0,3,1,6,0,10
 shardingsphere-master\shardingsphere-master\shardingsphere-features\shardingsphere-sharding\shardingsphere-sharding-core\src\test\java\org\apache\shardingsphere\sharding\route\engine\type\broadcast\ShardingDatabaseBroadcastRoutingEngineTest.java,0,12,0,9,0,21
 shardingsphere-master\shardingsphere-master\shardingsphere-sql-parser\shardingsphere-sql-parser-statement\src\main\java\org\apache\shardingsphere\sql\parser\sql\dialect\statement\sqlserver\ddl\SQLServerCreateTableStatement.java,0,6,0,7,2,15
 shardingsphere-master\shardingsphere-master\shardingsphere-proxy\shardingsphere-proxy-backend\src\main\java\org\apache\shardingsphere\proxy\backend\response\header\ResponseHeader.java,0,1,0,1,0,2
 shardingsphere-master\shardingsphere-master\examples\example-core\example-raw-jdbc\src\main\java\org\apache\shardingsphere\example\core\jdbc\repository\ShadowUserRepositoryImpl.java,0,32,1,11,0,44
 shardingsphere-master\shardingsphere-master\shardingsphere-jdbc\shardingsphere-jdbc-core\src\test\java\org\apache\shardingsphere\driver\fixture\TestEncryptAlgorithm.java,0,7,1,4,0,12
 shardingsphere-master\shardingsphere-master\shardingsphere-jdbc\shardingsphere-jdbc-core\src\test\java\org\apache\shardingsphere\driver\jdbc\unsupported\UnsupportedOperationParameterMetaTest.java,0,19,0,3,0,22
 shardingsphere-master\shardingsphere-master\shardingsphere-features\shardingsphere-shadow\shardingsphere-shadow-distsql\shardingsphere-shadow-distsql-handler\src\main\java\org\apache\shardingsphere\shadow\distsql\handler\update\DropShadowRuleStatementUpdater.java,0,22,0,17,0,39
 shardingsphere-master\shardingsphere-master\shardingsphere-sql-parser\shardingsphere-sql-parser-statement\src\main\java\org\apache\shardingsphere\sql\parser\sql\dialect\statement\mysql\dal\MySQLOptimizeTableStatement.java,0,3,0,6,1,10
 shardingsphere-master\shardingsphere-master\shardingsphere-features\shardingsphere-sharding\shardingsphere-sharding-distsql\shardingsphere-sharding-distsql-handler\src\main\java\org\apache\shardingsphere\sharding\distsql\handler\update\CreateShardingBroadcastTableRuleStatementUpdater.java,0,16,0,14,0,30
 shardingsphere-master\shardingsphere-master\shardingsphere-features\shardingsphere-sharding\shardingsphere-sharding-core\src\main\java\org\apache\shardingsphere\sharding\rewrite\token\pojo\GeneratedKeyInsertColumnToken.java,0,8,0,3,0,11
 shardingsphere-master\shardingsphere-master\shardingsphere-features\shardingsphere-sharding\shardingsphere-sharding-distsql\shardingsphere-sharding-distsql-handler\src\test\java\org\apache\shardingsphere\sharding\distsql\update\DropShardingTableRuleStatementUpdaterTest.java,0,42,0,32,0,74
 shardingsphere-master\shardingsphere-master\shardingsphere-test\shardingsphere-parser-test\src\main\java\org\apache\shardingsphere\test\sql\parser\parameterized\jaxb\cases\domain\statement\dal\ShowSlaveStatusStatementTestCase.java,0,2,0,3,0,5
 shardingsphere-master\shardingsphere-master\shardingsphere-features\shardingsphere-encrypt\shardingsphere-encrypt-distsql\shardingsphere-encrypt-distsql-statement\src\main\java\org\apache\shardingsphere\encrypt\distsql\parser\segment\EncryptColumnSegment.java,0,28,0,8,0,36
 shardingsphere-master\shardingsphere-master\shardingsphere-kernel\shardingsphere-schedule\shardingsphere-schedule-core\src\main\java\org\apache\shardingsphere\schedule\core\api\JobParameter.java,0,1,0,1,0,2
 shardingsphere-master\shardingsphere-master\shardingsphere-sql-parser\shardingsphere-sql-parser-statement\src\main\java\org\apache\shardingsphere\sql\parser\sql\common\statement\ddl\DropFunctionStatement.java,3,1,1,3,0,5
 shardingsphere-master\shardingsphere-master\shardingsphere-sql-parser\shardingsphere-sql-parser-dialect\shardingsphere-sql-parser-mysql\src\test\java\org\apache\shardingsphere\sql\parser\mysql\MySQLParameterizedTest.java,0,23,0,13,0,36
 shardingsphere-master\shardingsphere-master\shardingsphere-kernel\shardingsphere-data-pipeline\shardingsphere-data-pipeline-core\src\main\java\org\apache\shardingsphere\scaling\core\job\dumper\DumperFactory.java,0,17,0,21,0,38
 shardingsphere-master\shardingsphere-master\shardingsphere-infra\shardingsphere-infra-context\src\main\java\org\apache\shardingsphere\infra\context\refresher\type\DropIndexStatementSchemaRefresher.java,0,22,0,21,0,43
 shardingsphere-master\shardingsphere-master\shardingsphere-db-protocol\shardingsphere-db-protocol-core\src\main\java\org\apache\shardingsphere\db\protocol\packet\CommandPacket.java,0,1,0,1,0,2
 shardingsphere-master\shardingsphere-master\shardingsphere-features\shardingsphere-shadow\shardingsphere-shadow-core\src\main\java\org\apache\shardingsphere\shadow\rule\builder\ShadowRuleBuilder.java,0,6,0,4,0,10
 shardingsphere-master\shardingsphere-master\shardingsphere-features\shardingsphere-sharding\shardingsphere-sharding-core\src\test\java\org\apache\shardingsphere\sharding\algorithm\keygen\SnowflakeKeyGenerateAlgorithmTest.java,0,108,3,35,0,146
 shardingsphere-master\shardingsphere-master\shardingsphere-db-protocol\shardingsphere-db-protocol-postgresql\src\test\java\org\apache\shardingsphere\db\protocol\postgresql\packet\command\query\extended\bind\protocol\PostgreSQLFloat8ArrayBinaryProtocolValueTest.java,0,13,0,5,0,18
 shardingsphere-master\shardingsphere-master\shardingsphere-infra\shardingsphere-infra-common\src\main\java\org\apache\shardingsphere\infra\rule\builder\RuleBuilder.java,0,1,0,1,0,2
 shardingsphere-master\shardingsphere-master\shardingsphere-sql-parser\shardingsphere-sql-parser-statement\src\main\java\org\apache\shardingsphere\sql\parser\sql\dialect\statement\sqlserver\ddl\SQLServerDropSequenceStatement.java,0,1,0,5,0,6
 shardingsphere-master\shardingsphere-master\shardingsphere-proxy\shardingsphere-proxy-frontend\shardingsphere-proxy-frontend-opengauss\src\test\java\org\apache\shardingsphere\proxy\frontend\opengauss\command\OpenGaussCommandExecutorFactoryTest.java,0,65,1,75,0,141
 shardingsphere-master\shardingsphere-master\shardingsphere-proxy\shardingsphere-proxy-backend\src\main\java\org\apache\shardingsphere\proxy\backend\text\distsql\ral\common\updatable\SetVariableHandler.java,0,26,4,24,0,54
 shardingsphere-master\shardingsphere-master\shardingsphere-infra\shardingsphere-infra-merge\src\test\java\org\apache\shardingsphere\infra\merge\fixture\rule\MergerRuleFixture.java,0,1,0,1,0,2
 shardingsphere-master\shardingsphere-master\shardingsphere-sql-parser\shardingsphere-sql-parser-statement\src\main\java\org\apache\shardingsphere\sql\parser\sql\common\statement\ddl\CreateExtensionStatement.java,3,1,1,3,0,5
 shardingsphere-master\shardingsphere-master\shardingsphere-features\shardingsphere-sharding\shardingsphere-sharding-core\src\main\java\org\apache\shardingsphere\sharding\rewrite\token\generator\impl\TableTokenGenerator.java,0,14,0,11,0,25
 shardingsphere-master\shardingsphere-master\shardingsphere-features\shardingsphere-sharding\shardingsphere-sharding-core\src\main\java\org\apache\shardingsphere\sharding\route\engine\type\ignore\ShardingIgnoreRoutingEngine.java,0,2,0,1,0,3
 shardingsphere-master\shardingsphere-master\shardingsphere-db-protocol\shardingsphere-db-protocol-mysql\src\main\java\org\apache\shardingsphere\db\protocol\mysql\packet\command\query\binary\MySQLPreparedStatementRegistry.java,0,24,0,8,0,32
 shardingsphere-master\shardingsphere-master\shardingsphere-features\shardingsphere-sharding\shardingsphere-sharding-core\src\main\java\org\apache\shardingsphere\sharding\route\engine\validator\ddl\impl\ShardingAlterViewStatementValidator.java,0,10,1,11,0,22
 shardingsphere-master\shardingsphere-master\shardingsphere-sql-parser\shardingsphere-sql-parser-statement\src\main\java\org\apache\shardingsphere\sql\parser\sql\dialect\statement\postgresql\ddl\PostgreSQLCreateViewStatement.java,0,1,0,5,0,6
 shardingsphere-master\shardingsphere-master\shardingsphere-infra\shardingsphere-infra-route\src\main\java\org\apache\shardingsphere\infra\route\engine\SQLRouteEngine.java,0,10,0,7,0,17
 shardingsphere-master\shardingsphere-master\shardingsphere-sql-parser\shardingsphere-sql-parser-statement\src\main\java\org\apache\shardingsphere\sql\parser\sql\dialect\statement\sqlserver\ddl\SQLServerAlterSequenceStatement.java,0,1,0,5,0,6
 shardingsphere-master\shardingsphere-master\shardingsphere-sql-parser\shardingsphere-sql-parser-statement\src\main\java\org\apache\shardingsphere\sql\parser\sql\common\segment\generic\table\JoinTableSegment.java,0,18,0,5,2,25
 shardingsphere-master\shardingsphere-master\shardingsphere-features\shardingsphere-sharding\shardingsphere-sharding-distsql\shardingsphere-sharding-distsql-handler\src\test\java\org\apache\shardingsphere\sharding\distsql\query\ShardingAlgorithmsQueryResultSetTest.java,0,9,0,8,0,17
 shardingsphere-master\shardingsphere-master\shardingsphere-kernel\shardingsphere-data-pipeline\shardingsphere-data-pipeline-core\src\main\java\org\apache\shardingsphere\data\pipeline\core\spi\check\consistency\AbstractStreamingSingleTableDataCalculator.java,68,25,1,9,0,35
 shardingsphere-master\shardingsphere-master\shardingsphere-features\shardingsphere-sharding\shardingsphere-sharding-core\src\test\java\org\apache\shardingsphere\sharding\merge\dql\pagination\TopAndRowNumberDecoratorMergedResultTest.java,0,43,0,33,0,76
 shardingsphere-master\shardingsphere-master\shardingsphere-jdbc\shardingsphere-jdbc-core\src\test\java\org\apache\shardingsphere\driver\jdbc\base\AbstractShardingSphereDataSourceForShardingTest.java,50,22,1,10,0,33
 shardingsphere-master\shardingsphere-master\shardingsphere-jdbc\shardingsphere-jdbc-core\src\test\java\org\apache\shardingsphere\driver\jdbc\core\datasource\metadata\ShardingSphereDatabaseMetaDataTest.java,0,590,0,224,0,814
 shardingsphere-master\shardingsphere-master\shardingsphere-features\shardingsphere-encrypt\shardingsphere-encrypt-core\src\main\java\org\apache\shardingsphere\encrypt\rewrite\parameter\rewriter\EncryptAssignmentParameterRewriter.java,0,30,0,33,0,63
 shardingsphere-master\shardingsphere-master\shardingsphere-infra\shardingsphere-infra-common\src\main\java\org\apache\shardingsphere\infra\instance\workerid\WorkerIdGenerator.java,0,3,0,1,0,4
 shardingsphere-master\shardingsphere-master\shardingsphere-kernel\shardingsphere-parser\shardingsphere-parser-core\src\main\java\org\apache\shardingsphere\parser\rule\SQLParserRule.java,0,13,0,2,0,15
 shardingsphere-master\shardingsphere-master\shardingsphere-infra\shardingsphere-infra-common\src\main\java\org\apache\shardingsphere\infra\schedule\CronJob.java,0,6,0,1,0,7
 shardingsphere-master\shardingsphere-master\shardingsphere-jdbc\shardingsphere-jdbc-core\src\main\java\org\apache\shardingsphere\driver\jdbc\core\resultset\ResultSetUtil.java,0,31,1,20,0,52
 shardingsphere-master\shardingsphere-master\examples\shardingsphere-jdbc-example\single-feature-example\encrypt-example\encrypt-raw-jdbc-example\src\main\java\org\apache\shardingsphere\example\encrypt\raw\jdbc\EncryptRawYamlConfigurationExample.java,0,9,1,7,0,17
 shardingsphere-master\shardingsphere-master\shardingsphere-infra\shardingsphere-infra-merge\src\test\java\org\apache\shardingsphere\infra\merge\result\impl\memory\MemoryQueryResultRowTest.java,0,16,0,2,0,18
 shardingsphere-master\shardingsphere-master\shardingsphere-proxy\shardingsphere-proxy-frontend\shardingsphere-proxy-frontend-postgresql\src\test\java\org\apache\shardingsphere\proxy\frontend\postgresql\command\PostgreSQLCommandExecutorFactoryTest.java,0,70,1,74,0,145
 shardingsphere-master\shardingsphere-master\shardingsphere-db-protocol\shardingsphere-db-protocol-mysql\src\test\java\org\apache\shardingsphere\db\protocol\mysql\packet\command\query\text\fieldlist\MySQLComFieldListPacketTest.java,0,8,0,4,0,12
 shardingsphere-master\shardingsphere-master\shardingsphere-proxy\shardingsphere-proxy-backend\src\main\java\org\apache\shardingsphere\proxy\backend\text\distsql\ral\common\queryable\ExportSchemaConfigurationHandler.java,0,81,1,44,0,126
 shardingsphere-master\shardingsphere-master\shardingsphere-sql-parser\shardingsphere-sql-parser-statement\src\main\java\org\apache\shardingsphere\sql\parser\sql\dialect\statement\mysql\dcl\MySQLRenameUserStatement.java,0,1,0,5,0,6
 shardingsphere-master\shardingsphere-master\shardingsphere-features\shardingsphere-shadow\shardingsphere-shadow-distsql\shardingsphere-shadow-distsql-handler\src\main\java\org\apache\shardingsphere\shadow\distsql\handler\query\ShadowRuleQueryResultSet.java,0,43,0,24,0,67
 shardingsphere-master\shardingsphere-master\shardingsphere-infra\shardingsphere-infra-common\src\test\java\org\apache\shardingsphere\infra\metadata\schema\builder\SystemSchemaBuilderTest.java,0,9,0,4,0,13
 shardingsphere-master\shardingsphere-master\shardingsphere-infra\shardingsphere-infra-common\src\main\java\org\apache\shardingsphere\infra\database\metadata\dialect\PostgreSQLDataSourceMetaData.java,0,15,0,2,0,17
 shardingsphere-master\shardingsphere-master\shardingsphere-features\shardingsphere-sharding\shardingsphere-sharding-core\src\main\java\org\apache\shardingsphere\sharding\rewrite\token\pojo\GeneratedKeyAssignmentToken.java,17,8,0,3,0,11
 shardingsphere-master\shardingsphere-master\shardingsphere-infra\shardingsphere-infra-common\src\test\java\org\apache\shardingsphere\infra\yaml\config\swapper\fixture\RuleConfigurationFixture.java,0,4,0,3,0,7
 shardingsphere-master\shardingsphere-master\shardingsphere-sql-parser\shardingsphere-sql-parser-spi\src\main\java\org\apache\shardingsphere\sql\parser\spi\SQLParserFacade.java,0,3,0,1,0,4
 shardingsphere-master\shardingsphere-master\shardingsphere-test\shardingsphere-integration-agent-test\shardingsphere-integration-agent-test-plugins\shardingsphere-integration-agent-test-common\src\test\java\org\apache\shardingsphere\integration\agent\test\common\util\JDBCAgentTestUtils.java,0,25,1,16,0,42
 shardingsphere-master\shardingsphere-master\shardingsphere-proxy\shardingsphere-proxy-backend\src\main\java\org\apache\shardingsphere\proxy\backend\session\ConnectionSession.java,0,41,3,16,0,60
 shardingsphere-master\shardingsphere-master\shardingsphere-test\shardingsphere-integration-scaling-test\shardingsphere-integration-scaling-test-mysql\src\test\java\org\apache\shardingsphere\integration\scaling\test\mysql\env\config\TargetConfiguration.java,0,16,1,11,0,28
 shardingsphere-master\shardingsphere-master\shardingsphere-test\shardingsphere-parser-test\src\main\java\org\apache\shardingsphere\test\sql\parser\parameterized\asserts\statement\dal\impl\UninstallPluginStatementAssert.java,0,5,0,8,0,13
 shardingsphere-master\shardingsphere-master\shardingsphere-test\shardingsphere-parser-test\src\main\java\org\apache\shardingsphere\test\sql\parser\parameterized\jaxb\cases\domain\statement\distsql\rdl\alter\AlterDatabaseDiscoveryDefinitionRuleStatementTestCase.java,0,4,0,6,0,10
 shardingsphere-master\shardingsphere-master\shardingsphere-db-protocol\shardingsphere-db-protocol-postgresql\src\test\java\org\apache\shardingsphere\db\protocol\postgresql\packet\generic\PostgreSQLPasswordMessagePacketTest.java,0,6,0,7,0,13
 shardingsphere-master\shardingsphere-master\examples\example-core\example-raw-jdbc\src\main\java\org\apache\shardingsphere\example\core\jdbc\repository\OrderItemRepositoryImpl.java,90,30,0,10,0,40
 shardingsphere-master\shardingsphere-master\shardingsphere-features\shardingsphere-encrypt\shardingsphere-encrypt-core\src\main\java\org\apache\shardingsphere\encrypt\rewrite\token\pojo\EncryptPredicateInRightValueToken.java,0,15,0,4,0,19
 shardingsphere-master\shardingsphere-master\shardingsphere-features\shardingsphere-db-discovery\shardingsphere-db-discovery-core\src\test\java\org\apache\shardingsphere\dbdiscovery\checker\DatabaseDiscoveryRuleConfigurationCheckerTest.java,0,18,0,13,0,31
 shardingsphere-master\shardingsphere-master\shardingsphere-infra\shardingsphere-infra-binder\src\test\java\org\apache\shardingsphere\infra\binder\segment\select\orderby\OrderByItemTest.java,0,4,2,3,0,9
 shardingsphere-master\shardingsphere-master\shardingsphere-infra\shardingsphere-infra-common\src\main\java\org\apache\shardingsphere\infra\metadata\database\ShardingSphereDatabase.java,0,10,1,3,0,14
 shardingsphere-master\shardingsphere-master\examples\example-core\config-utility\src\main\java\org\apache\shardingsphere\example\type\RegistryCenterType.java,0,4,0,1,0,5
 shardingsphere-master\shardingsphere-master\shardingsphere-db-protocol\shardingsphere-db-protocol-mysql\src\test\java\org\apache\shardingsphere\db\protocol\mysql\packet\binlog\row\MySQLBinlogTableMapEventPacketTest.java,0,35,0,15,0,50
 shardingsphere-master\shardingsphere-master\shardingsphere-db-protocol\shardingsphere-db-protocol-mysql\src\main\java\org\apache\shardingsphere\db\protocol\mysql\packet\binlog\row\column\value\string\MySQLJsonValueDecoder.java,0,70,2,20,0,92
 shardingsphere-master\shardingsphere-master\shardingsphere-kernel\shardingsphere-transaction\shardingsphere-transaction-type\shardingsphere-transaction-xa\shardingsphere-transaction-xa-spi\src\test\java\org\apache\shardingsphere\transaction\xa\spi\SingleXAResourceTest.java,0,30,0,2,0,32
 shardingsphere-master\shardingsphere-master\shardingsphere-sql-parser\shardingsphere-sql-parser-statement\src\main\java\org\apache\shardingsphere\sql\parser\sql\dialect\statement\opengauss\ddl\OpenGaussAlterSequenceStatement.java,0,1,0,5,0,6
 shardingsphere-master\shardingsphere-master\shardingsphere-agent\shardingsphere-agent-bootstrap\src\main\java\org\apache\shardingsphere\agent\bootstrap\ShardingSphereAgent.java,0,13,0,11,0,24
 shardingsphere-master\shardingsphere-master\shardingsphere-features\shardingsphere-sharding\shardingsphere-sharding-core\src\test\java\org\apache\shardingsphere\sharding\algorithm\keygen\fixture\WorkerIdGeneratorFixture.java,0,3,0,1,0,4
 shardingsphere-master\shardingsphere-master\examples\shardingsphere-jdbc-example\mixed-feature-example\sharding-readwrite-splitting-example\sharding-readwrite-splitting-spring-boot-mybatis-example\src\main\java\org\apache\shardingsphere\example\sharding\readwrite\splitting\spring\boot\mybatis\ShardingReadwriteSplittingSpringBootMybatisExample.java,9,7,1,6,0,14
 shardingsphere-master\shardingsphere-master\shardingsphere-sql-parser\shardingsphere-sql-parser-statement\src\main\java\org\apache\shardingsphere\sql\parser\sql\common\statement\ddl\CreateViewStatement.java,5,3,1,4,2,10
 shardingsphere-master\shardingsphere-master\shardingsphere-proxy\shardingsphere-proxy-backend\src\test\java\org\apache\shardingsphere\proxy\backend\communication\jdbc\connection\JDBCBackendConnectionTest.java,0,145,16,80,0,241
 shardingsphere-master\shardingsphere-master\shardingsphere-test\shardingsphere-parser-test\src\main\java\org\apache\shardingsphere\test\sql\parser\parameterized\jaxb\cases\domain\segment\impl\insert\ExpectedInsertValuesClause.java,0,3,0,4,0,7
 shardingsphere-master\shardingsphere-master\shardingsphere-kernel\shardingsphere-authority\shardingsphere-authority-core\src\main\java\org\apache\shardingsphere\authority\provider\natived\model\privilege\database\TablePrivileges.java,0,6,0,2,0,8
 shardingsphere-master\shardingsphere-master\shardingsphere-kernel\shardingsphere-data-pipeline\shardingsphere-data-pipeline-core\src\main\java\org\apache\shardingsphere\data\pipeline\core\ingest\dumper\AbstractInventoryDumper.java,145,61,2,41,0,104
 shardingsphere-master\shardingsphere-master\shardingsphere-features\shardingsphere-db-discovery\shardingsphere-db-discovery-distsql\shardingsphere-db-discovery-distsql-handler\src\test\java\org\apache\shardingsphere\dbdiscovery\distsql\handler\update\DropDatabaseDiscoveryHeartbeatStatementUpdaterTest.java,0,43,0,33,0,76
 shardingsphere-master\shardingsphere-master\shardingsphere-infra\shardingsphere-infra-common\src\main\java\org\apache\shardingsphere\infra\metadata\user\Grantee.java,0,21,3,3,0,27
 shardingsphere-master\shardingsphere-master\shardingsphere-agent\shardingsphere-agent-core\src\test\java\org\apache\shardingsphere\agent\core\plugin\interceptor\ConstructorInterceptorTest.java,0,23,0,6,0,29
 shardingsphere-master\shardingsphere-master\shardingsphere-kernel\shardingsphere-transaction\shardingsphere-transaction-type\shardingsphere-transaction-xa\shardingsphere-transaction-xa-core\src\main\java\org\apache\shardingsphere\transaction\xa\jta\connection\dialect\OracleXAConnectionWrapper.java,0,15,3,5,0,23
 shardingsphere-master\shardingsphere-master\shardingsphere-infra\shardingsphere-infra-common\src\main\java\org\apache\shardingsphere\infra\metadata\schema\loader\TableMetaDataLoaderMaterial.java,0,4,0,1,0,5
 shardingsphere-master\shardingsphere-master\shardingsphere-features\shardingsphere-readwrite-splitting\shardingsphere-readwrite-splitting-spring\shardingsphere-readwrite-splitting-spring-boot-starter\src\main\java\org\apache\shardingsphere\readwritesplitting\spring\boot\condition\ReadwriteSplittingSpringBootCondition.java,0,9,0,6,0,15
 shardingsphere-master\shardingsphere-master\shardingsphere-features\shardingsphere-db-discovery\shardingsphere-db-discovery-distsql\shardingsphere-db-discovery-distsql-handler\src\test\java\org\apache\shardingsphere\dbdiscovery\distsql\handler\query\DatabaseDiscoveryHeartbeatQueryResultSetTest.java,0,12,0,13,0,25
 shardingsphere-master\shardingsphere-master\shardingsphere-db-protocol\shardingsphere-db-protocol-mysql\src\test\java\org\apache\shardingsphere\db\protocol\mysql\packet\binlog\row\column\value\time\MySQLTime2BinlogProtocolValueTest.java,0,58,0,14,0,72
 shardingsphere-master\shardingsphere-master\shardingsphere-features\shardingsphere-sharding\shardingsphere-sharding-core\src\test\java\org\apache\shardingsphere\sharding\algorithm\sharding\range\VolumeBasedRangeShardingAlgorithmTest.java,0,64,0,25,0,89
 shardingsphere-master\shardingsphere-master\shardingsphere-jdbc\shardingsphere-jdbc-spring\shardingsphere-jdbc-spring-infra\shardingsphere-jdbc-spring-namespace-infra\src\test\java\org\apache\shardingsphere\spring\namespace\fixture\FooShardingSphereFixtureAlgorithm.java,0,8,0,2,0,10
 shardingsphere-master\shardingsphere-master\shardingsphere-distsql\shardingsphere-distsql-statement\src\main\java\org\apache\shardingsphere\distsql\parser\statement\ral\common\queryable\ShowInstanceModeStatement.java,0,0,0,2,0,2
 shardingsphere-master\shardingsphere-master\shardingsphere-jdbc\shardingsphere-jdbc-core\src\test\java\org\apache\shardingsphere\driver\jdbc\core\statement\ShadowStatementTest.java,0,63,3,25,0,91
 shardingsphere-master\shardingsphere-master\shardingsphere-db-protocol\shardingsphere-db-protocol-postgresql\src\test\java\org\apache\shardingsphere\db\protocol\postgresql\packet\command\query\extended\bind\protocol\PostgreSQLNumericBinaryProtocolValueTest.java,0,34,1,15,0,50
 shardingsphere-master\shardingsphere-master\shardingsphere-sql-parser\shardingsphere-sql-parser-statement\src\main\java\org\apache\shardingsphere\sql\parser\sql\common\segment\dml\pagination\limit\LimitSegment.java,0,12,0,3,0,15
 shardingsphere-master\shardingsphere-master\shardingsphere-distsql\shardingsphere-distsql-statement\src\main\java\org\apache\shardingsphere\distsql\parser\statement\ral\common\updatable\SetInstanceStatusStatement.java,9,6,0,2,0,8
 shardingsphere-master\shardingsphere-master\shardingsphere-kernel\shardingsphere-transaction\shardingsphere-transaction-type\shardingsphere-transaction-xa\shardingsphere-transaction-xa-core\src\main\java\org\apache\shardingsphere\transaction\xa\jta\connection\dialect\OpenGaussXAConnectionWrapper.java,0,15,3,5,0,23
 shardingsphere-master\shardingsphere-master\shardingsphere-test\shardingsphere-pipeline-test\src\test\java\org\apache\shardingsphere\data\pipeline\api\datanode\JobDataNodeEntryTest.java,0,3,0,1,0,4
 shardingsphere-master\shardingsphere-master\shardingsphere-test\shardingsphere-parser-test\src\main\java\org\apache\shardingsphere\test\sql\parser\parameterized\asserts\statement\dal\impl\ShowFunctionStatusStatementAssert.java,0,5,0,9,0,14
 shardingsphere-master\shardingsphere-master\shardingsphere-proxy\shardingsphere-proxy-backend\src\main\java\org\apache\shardingsphere\proxy\backend\text\distsql\ral\common\hint\executor\ClearShardingHintExecutor.java,0,2,0,7,0,9
 shardingsphere-master\shardingsphere-master\shardingsphere-infra\shardingsphere-infra-common\src\main\java\org\apache\shardingsphere\infra\metadata\schema\ShardingSphereSchema.java,0,21,6,5,0,32
 shardingsphere-master\shardingsphere-master\shardingsphere-sql-parser\shardingsphere-sql-parser-statement\src\main\java\org\apache\shardingsphere\sql\parser\sql\common\segment\dml\column\InsertColumnsSegment.java,0,6,0,1,2,9
 shardingsphere-master\shardingsphere-master\shardingsphere-proxy\shardingsphere-proxy-backend\src\main\java\org\apache\shardingsphere\proxy\backend\text\distsql\ral\common\updatable\AlterTransactionRuleHandler.java,0,16,0,18,0,34
 shardingsphere-master\shardingsphere-master\examples\shardingsphere-jdbc-example\single-feature-example\shadow-example\shadow-raw-jdbc-example\src\main\java\org\apache\shardingsphere\example\shadow\raw\jdbc\factory\DataSourceFactory.java,0,6,1,6,0,13
 shardingsphere-master\shardingsphere-master\shardingsphere-sql-parser\shardingsphere-sql-parser-statement\src\main\java\org\apache\shardingsphere\sql\parser\sql\dialect\statement\postgresql\dml\PostgreSQLSelectStatement.java,0,7,0,8,0,15
 shardingsphere-master\shardingsphere-master\shardingsphere-test\shardingsphere-parser-test\src\main\java\org\apache\shardingsphere\test\sql\parser\parameterized\jaxb\cases\domain\statement\ddl\CreateServerStatementTestCase.java,0,0,0,3,0,3
 shardingsphere-master\shardingsphere-master\shardingsphere-agent\shardingsphere-agent-plugins\shardingsphere-agent-plugin-logging\shardingsphere-agent-logging-base\src\main\java\org\apache\shardingsphere\agent\plugin\logging\base\threadlocal\ElapsedTimeThreadLocal.java,0,7,0,1,0,8
 shardingsphere-master\shardingsphere-master\shardingsphere-test\shardingsphere-parser-test\src\main\java\org\apache\shardingsphere\test\sql\parser\parameterized\jaxb\cases\domain\statement\ddl\DropLanguageStatementTestCase.java,0,0,0,3,0,3
 shardingsphere-master\shardingsphere-master\shardingsphere-test\shardingsphere-parser-test\src\main\java\org\apache\shardingsphere\test\sql\parser\parameterized\jaxb\cases\domain\statement\distsql\rql\ShowShardingTableRulesStatementTestCase.java,0,5,0,5,0,10
 shardingsphere-master\shardingsphere-master\shardingsphere-infra\shardingsphere-infra-executor\src\main\java\org\apache\shardingsphere\infra\executor\check\SQLCheckEngine.java,0,19,0,13,0,32
 shardingsphere-master\shardingsphere-master\shardingsphere-features\shardingsphere-db-discovery\shardingsphere-db-discovery-distsql\shardingsphere-db-discovery-distsql-handler\src\main\java\org\apache\shardingsphere\dbdiscovery\distsql\handler\update\AlterDatabaseDiscoveryRuleStatementUpdater.java,0,58,0,56,0,114
 shardingsphere-master\shardingsphere-master\shardingsphere-proxy\shardingsphere-proxy-backend\src\main\java\org\apache\shardingsphere\proxy\backend\communication\jdbc\executor\callback\impl\ProxyStatementExecutorCallback.java,0,9,0,10,0,19
 shardingsphere-master\shardingsphere-master\shardingsphere-sql-parser\shardingsphere-sql-parser-statement\src\main\java\org\apache\shardingsphere\sql\parser\sql\dialect\statement\opengauss\ddl\OpenGaussDropTableStatement.java,0,3,0,5,0,8
 shardingsphere-master\shardingsphere-master\shardingsphere-features\shardingsphere-readwrite-splitting\shardingsphere-readwrite-splitting-distsql\shardingsphere-readwrite-splitting-distsql-statement\src\main\java\org\apache\shardingsphere\readwritesplitting\distsql\parser\statement\hint\ShowReadwriteSplittingHintStatusStatement.java,0,1,0,4,0,5
 shardingsphere-master\shardingsphere-master\shardingsphere-mode\shardingsphere-mode-type\shardingsphere-standalone-mode\shardingsphere-standalone-mode-core\src\test\java\org\apache\shardingsphere\mode\manager\standalone\StandaloneContextManagerBuilderTextTest.java,0,15,0,12,0,27
 shardingsphere-master\shardingsphere-master\shardingsphere-proxy\shardingsphere-proxy-backend\src\main\java\org\apache\shardingsphere\proxy\backend\text\distsql\ral\scaling\query\QueryableScalingRALBackendHandler.java,0,15,0,9,0,24
 shardingsphere-master\shardingsphere-master\shardingsphere-test\shardingsphere-parser-test\src\main\java\org\apache\shardingsphere\test\sql\parser\parameterized\asserts\statement\distsql\rql\impl\rule\ShowShardingTableRulesStatementAssert.java,0,8,0,12,0,20
 shardingsphere-master\shardingsphere-master\shardingsphere-test\shardingsphere-integration-scaling-test\shardingsphere-integration-scaling-test-mysql\src\test\java\org\apache\shardingsphere\integration\scaling\test\mysql\env\cases\DataSet.java,0,3,0,1,0,4
 shardingsphere-master\shardingsphere-master\shardingsphere-kernel\shardingsphere-traffic\shardingsphere-traffic-core\src\main\java\org\apache\shardingsphere\traffic\rule\TrafficStrategyRule.java,0,8,0,1,0,9
 shardingsphere-master\shardingsphere-master\shardingsphere-infra\shardingsphere-infra-rewrite\src\test\java\org\apache\shardingsphere\infra\rewrite\sql\token\pojo\generic\RemoveTokenTest.java,0,2,0,1,0,3
 shardingsphere-master\shardingsphere-master\shardingsphere-test\shardingsphere-pipeline-test\src\test\java\org\apache\shardingsphere\data\pipeline\core\util\ConfigurationFileUtil.java,0,8,0,4,0,12
 shardingsphere-master\shardingsphere-master\shardingsphere-features\shardingsphere-db-discovery\shardingsphere-db-discovery-distsql\shardingsphere-db-discovery-distsql-handler\src\main\java\org\apache\shardingsphere\dbdiscovery\distsql\handler\update\DropDatabaseDiscoveryHeartbeatStatementUpdater.java,0,33,0,28,0,61
 shardingsphere-master\shardingsphere-master\shardingsphere-infra\shardingsphere-infra-common\src\main\java\org\apache\shardingsphere\infra\database\metadata\UnrecognizedDatabaseURLException.java,0,6,0,4,0,10
 shardingsphere-master\shardingsphere-master\shardingsphere-features\shardingsphere-encrypt\shardingsphere-encrypt-distsql\shardingsphere-encrypt-distsql-handler\src\main\java\org\apache\shardingsphere\encrypt\distsql\handler\query\EncryptRuleQueryResultSet.java,0,27,0,20,0,47
 shardingsphere-master\shardingsphere-master\shardingsphere-test\shardingsphere-parser-test\src\main\java\org\apache\shardingsphere\test\sql\parser\parameterized\asserts\statement\dcl\DCLStatementAssert.java,0,22,0,74,0,96
 shardingsphere-master\shardingsphere-master\shardingsphere-sql-parser\shardingsphere-sql-parser-statement\src\main\java\org\apache\shardingsphere\sql\parser\sql\dialect\statement\mysql\dal\MySQLInstallPluginStatement.java,0,3,0,5,0,8
 shardingsphere-master\shardingsphere-master\shardingsphere-features\shardingsphere-sharding\shardingsphere-sharding-api\src\main\java\org\apache\shardingsphere\sharding\api\sharding\ShardingValue.java,0,0,0,1,0,1
 shardingsphere-master\shardingsphere-master\shardingsphere-spi\src\test\java\org\apache\shardingsphere\spi\ordered\OrderedSPIRegistryTest.java,0,16,1,7,0,24
 shardingsphere-master\shardingsphere-master\shardingsphere-sql-parser\shardingsphere-sql-parser-statement\src\main\java\org\apache\shardingsphere\sql\parser\sql\dialect\handler\ddl\CreateIndexStatementHandler.java,0,5,0,10,2,17
 shardingsphere-master\shardingsphere-master\shardingsphere-sql-parser\shardingsphere-sql-parser-statement\src\main\java\org\apache\shardingsphere\sql\parser\sql\dialect\statement\mysql\segment\CloneActionSegment.java,0,4,0,2,2,8
 shardingsphere-master\shardingsphere-master\shardingsphere-mode\shardingsphere-mode-type\shardingsphere-cluster-mode\shardingsphere-cluster-mode-core\src\main\java\org\apache\shardingsphere\mode\manager\cluster\coordinator\lock\DistributeLockContext.java,0,36,2,21,0,59
 shardingsphere-master\shardingsphere-master\shardingsphere-sql-parser\shardingsphere-sql-parser-statement\src\main\java\org\apache\shardingsphere\sql\parser\sql\common\statement\dcl\SetRoleStatement.java,3,1,1,3,0,5
 shardingsphere-master\shardingsphere-master\shardingsphere-sql-parser\shardingsphere-sql-parser-statement\src\main\java\org\apache\shardingsphere\sql\parser\sql\common\segment\dml\pagination\PaginationValueSegment.java,0,2,0,1,0,3
 shardingsphere-master\shardingsphere-master\shardingsphere-test\shardingsphere-parser-test\src\main\java\org\apache\shardingsphere\test\sql\parser\parameterized\jaxb\cases\domain\statement\dal\ShowTableStatusStatementTestCase.java,0,4,0,5,0,9
 shardingsphere-master\shardingsphere-master\shardingsphere-test\shardingsphere-parser-test\src\main\java\org\apache\shardingsphere\test\sql\parser\parameterized\jaxb\cases\domain\statement\ddl\AlterDimensionStatementTestCase.java,0,0,0,3,0,3
 shardingsphere-master\shardingsphere-master\shardingsphere-db-protocol\shardingsphere-db-protocol-mysql\src\main\java\org\apache\shardingsphere\db\protocol\mysql\packet\command\query\binary\execute\MySQLComStmtExecutePacket.java,0,40,0,28,0,68
 shardingsphere-master\shardingsphere-master\shardingsphere-db-protocol\shardingsphere-db-protocol-mysql\src\test\java\org\apache\shardingsphere\db\protocol\mysql\packet\handshake\MySQLAuthPluginDataTest.java,0,31,0,4,0,35
 shardingsphere-master\shardingsphere-master\shardingsphere-proxy\shardingsphere-proxy-backend\src\main\java\org\apache\shardingsphere\proxy\backend\exception\NoDatabaseSelectedException.java,0,1,0,1,0,2
 shardingsphere-master\shardingsphere-master\shardingsphere-proxy\shardingsphere-proxy-frontend\shardingsphere-proxy-frontend-postgresql\src\main\java\org\apache\shardingsphere\proxy\frontend\postgresql\command\query\extended\describe\PostgreSQLComDescribeExecutor.java,0,63,1,65,0,129
 shardingsphere-master\shardingsphere-master\shardingsphere-sql-parser\shardingsphere-sql-parser-statement\src\main\java\org\apache\shardingsphere\sql\parser\sql\dialect\statement\opengauss\ddl\OpenGaussCreateDomainStatement.java,0,1,0,5,0,6
 shardingsphere-master\shardingsphere-master\shardingsphere-jdbc\shardingsphere-jdbc-core\src\test\java\org\apache\shardingsphere\driver\state\circuit\CircuitBreakDriverStateTest.java,0,4,1,3,0,8
 shardingsphere-master\shardingsphere-master\shardingsphere-infra\shardingsphere-infra-common\src\test\java\org\apache\shardingsphere\infra\config\algorithm\ShardingSphereAlgorithmFactoryTest.java,0,9,0,3,0,12
 shardingsphere-master\shardingsphere-master\shardingsphere-features\shardingsphere-sharding\shardingsphere-sharding-core\src\main\java\org\apache\shardingsphere\sharding\route\engine\validator\ddl\impl\ShardingCreateIndexStatementValidator.java,0,13,1,12,0,26
 shardingsphere-master\shardingsphere-master\shardingsphere-agent\shardingsphere-agent-plugins\shardingsphere-agent-plugin-tracing\shardingsphere-agent-tracing-opentelemetry\src\test\java\org\apache\shardingsphere\agent\plugin\tracing\opentelemetry\collector\OpenTelemetryCollector.java,0,5,0,3,0,8
 shardingsphere-master\shardingsphere-master\shardingsphere-features\shardingsphere-sharding\shardingsphere-sharding-core\src\main\java\org\apache\shardingsphere\sharding\route\strategy\type\hint\HintShardingStrategy.java,0,18,0,12,0,30
 shardingsphere-master\shardingsphere-master\shardingsphere-infra\shardingsphere-infra-common\src\test\java\org\apache\shardingsphere\infra\config\fixture\WithInitAlgorithm.java,0,8,0,3,0,11
 shardingsphere-master\shardingsphere-master\shardingsphere-spi\src\main\java\org\apache\shardingsphere\spi\ordered\OrderedSPIRegistry.java,0,21,0,16,0,37
 shardingsphere-master\shardingsphere-master\shardingsphere-sql-parser\shardingsphere-sql-parser-statement\src\main\java\org\apache\shardingsphere\sql\parser\sql\common\segment\generic\WindowSegment.java,0,4,0,1,0,5
 shardingsphere-master\shardingsphere-master\shardingsphere-test\shardingsphere-parser-test\src\main\java\org\apache\shardingsphere\test\sql\parser\parameterized\jaxb\Case.java,9,5,1,1,0,7
 shardingsphere-master\shardingsphere-master\shardingsphere-features\shardingsphere-readwrite-splitting\shardingsphere-readwrite-splitting-core\src\test\java\org\apache\shardingsphere\readwritesplitting\rule\builder\ReadwriteSplittingRuleBuilderTest.java,0,8,0,7,0,15
 shardingsphere-master\shardingsphere-master\shardingsphere-proxy\shardingsphere-proxy-backend\src\main\java\org\apache\shardingsphere\proxy\backend\text\distsql\ral\common\hint\HintStatementExecutorFactory.java,0,8,0,26,0,34
 shardingsphere-master\shardingsphere-master\shardingsphere-sql-parser\shardingsphere-sql-parser-dialect\shardingsphere-sql-parser-opengauss\src\main\java\org\apache\shardingsphere\sql\parser\opengauss\visitor\statement\impl\OpenGaussDCLStatementSQLVisitor.java,0,19,0,29,0,48
 shardingsphere-master\shardingsphere-master\shardingsphere-test\shardingsphere-parser-test\src\main\java\org\apache\shardingsphere\test\sql\parser\parameterized\jaxb\cases\domain\statement\dal\ShowSlaveHostsStatementTestCase.java,0,0,0,3,0,3
 shardingsphere-master\shardingsphere-master\shardingsphere-proxy\shardingsphere-proxy-backend\src\main\java\org\apache\shardingsphere\proxy\backend\text\distsql\rql\resource\DataSourceQueryResultSet.java,0,45,0,22,0,67
 shardingsphere-master\shardingsphere-master\shardingsphere-proxy\shardingsphere-proxy-backend\src\test\java\org\apache\shardingsphere\proxy\backend\communication\jdbc\recognizer\impl\SQLServerRecognizerTest.java,0,9,0,6,0,15
 shardingsphere-master\shardingsphere-master\shardingsphere-kernel\shardingsphere-data-pipeline\shardingsphere-data-pipeline-spi\src\main\java\org\apache\shardingsphere\data\pipeline\api\ingest\position\PlaceholderPosition.java,0,3,0,2,0,5
 shardingsphere-master\shardingsphere-master\shardingsphere-features\shardingsphere-shadow\shardingsphere-shadow-spring\shardingsphere-shadow-spring-namespace\src\main\java\org\apache\shardingsphere\shadow\spring\namespace\tag\ShadowRuleBeanDefinitionTag.java,0,28,0,6,0,34
 shardingsphere-master\shardingsphere-master\shardingsphere-infra\shardingsphere-infra-route\src\main\java\org\apache\shardingsphere\infra\route\context\RouteMapper.java,0,4,0,1,0,5
 shardingsphere-master\shardingsphere-master\examples\shardingsphere-proxy-example\shardingsphere-proxy-distsql-example\src\main\java\org\apache\shardingsphere\example\proxy\distsql\feature\FeatureType.java,0,8,0,6,0,14
 shardingsphere-master\shardingsphere-master\shardingsphere-sql-parser\shardingsphere-sql-parser-statement\src\main\java\org\apache\shardingsphere\sql\parser\sql\dialect\statement\postgresql\ddl\PostgreSQLCreateTableStatement.java,0,2,0,5,0,7
 shardingsphere-master\shardingsphere-master\shardingsphere-sql-parser\shardingsphere-sql-parser-statement\src\main\java\org\apache\shardingsphere\sql\parser\sql\common\segment\ddl\column\position\ColumnAfterPositionSegment.java,0,4,0,4,0,8
 shardingsphere-master\shardingsphere-master\shardingsphere-kernel\shardingsphere-transaction\shardingsphere-transaction-type\shardingsphere-transaction-xa\shardingsphere-transaction-xa-provider\shardingsphere-transaction-xa-narayana\src\test\java\org\apache\shardingsphere\transaction\xa\narayana\manager\NarayanaXATransactionManagerProviderTest.java,0,31,0,11,0,42
 shardingsphere-master\shardingsphere-master\shardingsphere-proxy\shardingsphere-proxy-frontend\shardingsphere-proxy-frontend-mysql\src\main\java\org\apache\shardingsphere\proxy\frontend\mysql\authentication\authenticator\MySQLNativePasswordAuthenticator.java,0,15,0,12,0,27
 shardingsphere-master\shardingsphere-master\shardingsphere-features\shardingsphere-sharding\shardingsphere-sharding-core\src\main\java\org\apache\shardingsphere\sharding\merge\ShardingResultMergerEngine.java,0,8,0,7,0,15
 shardingsphere-master\shardingsphere-master\shardingsphere-sql-parser\shardingsphere-sql-parser-statement\src\main\java\org\apache\shardingsphere\sql\parser\sql\dialect\statement\sqlserver\ddl\SQLServerAlterTableStatement.java,0,1,0,5,0,6
 shardingsphere-master\shardingsphere-master\shardingsphere-kernel\shardingsphere-single-table\shardingsphere-single-table-core\src\test\java\org\apache\shardingsphere\singletable\route\SingleTableSQLRouterTest.java,0,42,0,37,0,79
 shardingsphere-master\shardingsphere-master\shardingsphere-features\shardingsphere-sharding\shardingsphere-sharding-core\src\main\java\org\apache\shardingsphere\sharding\algorithm\keygen\UUIDKeyGenerateAlgorithm.java,0,3,1,1,0,5
 shardingsphere-master\shardingsphere-master\shardingsphere-db-protocol\shardingsphere-db-protocol-mysql\src\main\java\org\apache\shardingsphere\db\protocol\mysql\packet\command\admin\quit\MySQLComQuitPacket.java,0,5,0,4,0,9
 shardingsphere-master\shardingsphere-master\shardingsphere-kernel\shardingsphere-authority\shardingsphere-authority-core\src\test\java\org\apache\shardingsphere\authority\provider\simple\AllPrivilegesProviderAlgorithmTest.java,0,5,0,4,0,9
 shardingsphere-master\shardingsphere-master\shardingsphere-test\shardingsphere-parser-test\src\main\java\org\apache\shardingsphere\test\sql\parser\parameterized\jaxb\cases\domain\statement\ddl\AlterFunctionStatementTestCase.java,0,0,0,3,0,3
 shardingsphere-master\shardingsphere-master\shardingsphere-infra\shardingsphere-infra-rewrite\src\test\java\org\apache\shardingsphere\infra\rewrite\sql\token\generator\SQLTokenGeneratorsTest.java,0,31,1,20,0,52
 shardingsphere-master\shardingsphere-master\shardingsphere-sql-parser\shardingsphere-sql-parser-statement\src\test\java\org\apache\shardingsphere\sql\parser\sql\dialect\handler\ddl\DropIndexStatementHandlerTest.java,0,20,0,18,0,38
 shardingsphere-master\shardingsphere-master\shardingsphere-infra\shardingsphere-infra-common\src\main\java\org\apache\shardingsphere\infra\yaml\schema\swapper\TableMetaDataYamlSwapper.java,0,33,0,21,0,54
 shardingsphere-master\shardingsphere-master\shardingsphere-kernel\shardingsphere-data-pipeline\shardingsphere-data-pipeline-core\src\main\java\org\apache\shardingsphere\scaling\core\job\environment\ScalingEnvironmentManager.java,0,11,0,14,0,25
 shardingsphere-master\shardingsphere-master\shardingsphere-features\shardingsphere-sharding\shardingsphere-sharding-core\src\test\java\org\apache\shardingsphere\sharding\merge\dql\orderby\CompareUtilTest.java,0,51,1,22,0,74
 shardingsphere-master\shardingsphere-master\shardingsphere-infra\shardingsphere-infra-common\src\main\java\org\apache\shardingsphere\infra\yaml\config\swapper\YamlRuleConfigurationSwapper.java,0,4,0,2,0,6
 shardingsphere-master\shardingsphere-master\shardingsphere-infra\shardingsphere-infra-common\src\main\java\org\apache\shardingsphere\infra\distsql\exception\resource\ResourceInUsedException.java,0,11,0,5,0,16
 shardingsphere-master\shardingsphere-master\shardingsphere-mode\shardingsphere-mode-type\shardingsphere-cluster-mode\shardingsphere-cluster-mode-core\src\test\java\org\apache\shardingsphere\mode\manager\cluster\process\GovernanceExecuteProcessReporterTest.java,0,11,0,13,0,24
 shardingsphere-master\shardingsphere-master\examples\shardingsphere-jdbc-example\single-feature-example\sharding-example\sharding-raw-jdbc-example\src\main\java\org\apache\shardingsphere\example\sharding\raw\jdbc\factory\DataSourceFactory.java,0,7,1,7,0,15
 shardingsphere-master\shardingsphere-master\shardingsphere-proxy\shardingsphere-proxy-frontend\shardingsphere-proxy-frontend-mysql\src\main\java\org\apache\shardingsphere\proxy\frontend\mysql\command\generic\MySQLUnsupportedCommandExecutor.java,0,4,0,4,0,8
 shardingsphere-master\shardingsphere-master\shardingsphere-sql-parser\shardingsphere-sql-parser-statement\src\main\java\org\apache\shardingsphere\sql\parser\sql\common\statement\ddl\CreateDomainStatement.java,3,1,1,3,0,5
 shardingsphere-master\shardingsphere-master\shardingsphere-agent\shardingsphere-agent-plugins\shardingsphere-agent-plugin-logging\shardingsphere-agent-logging-base\src\main\java\org\apache\shardingsphere\agent\plugin\logging\base\definition\BaseLoggingPluginDefinitionService.java,0,14,0,7,0,21
 shardingsphere-master\shardingsphere-master\shardingsphere-features\shardingsphere-sharding\shardingsphere-sharding-distsql\shardingsphere-sharding-distsql-statement\src\main\java\org\apache\shardingsphere\sharding\distsql\parser\statement\AlterShardingKeyGeneratorStatement.java,0,3,0,4,0,7
 shardingsphere-master\shardingsphere-master\shardingsphere-test\shardingsphere-parser-test\src\main\java\org\apache\shardingsphere\test\sql\parser\parameterized\jaxb\cases\domain\statement\dal\ShowTablesStatementTestCase.java,0,4,0,5,0,9
 shardingsphere-master\shardingsphere-master\shardingsphere-sql-parser\shardingsphere-sql-parser-statement\src\main\java\org\apache\shardingsphere\sql\parser\sql\common\statement\tcl\SetConstraintsStatement.java,3,1,1,3,0,5
 shardingsphere-master\shardingsphere-master\shardingsphere-db-protocol\shardingsphere-db-protocol-postgresql\src\main\java\org\apache\shardingsphere\db\protocol\postgresql\packet\command\query\extended\PostgreSQLPreparedStatementRegistry.java,0,23,0,12,0,35
 shardingsphere-master\shardingsphere-master\shardingsphere-test\shardingsphere-integration-test\shardingsphere-integration-test-suite\src\test\java\org\apache\shardingsphere\test\integration\cases\dataset\row\DataSetRow.java,0,6,0,1,0,7
 shardingsphere-master\shardingsphere-master\shardingsphere-kernel\shardingsphere-data-pipeline\shardingsphere-data-pipeline-core\src\main\java\org\apache\shardingsphere\data\pipeline\core\api\impl\AbstractPipelineJobAPIImpl.java,58,25,0,13,0,38
 shardingsphere-master\shardingsphere-master\shardingsphere-jdbc\shardingsphere-jdbc-spring\shardingsphere-jdbc-spring-infra\shardingsphere-jdbc-spring-boot-starter-infra\src\main\java\org\apache\shardingsphere\spring\boot\schema\SchemaNameSetter.java,0,8,0,2,0,10
 shardingsphere-master\shardingsphere-master\shardingsphere-kernel\shardingsphere-parser\shardingsphere-parser-core\src\main\java\org\apache\shardingsphere\parser\rule\builder\SQLParserRuleBuilder.java,0,5,0,3,0,8
 shardingsphere-master\shardingsphere-master\shardingsphere-mode\shardingsphere-mode-type\shardingsphere-cluster-mode\shardingsphere-cluster-mode-repository\shardingsphere-cluster-mode-repository-provider\shardingsphere-cluster-mode-repository-etcd\src\test\java\org\apache\shardingsphere\mode\repository\cluster\etcd\props\EtcdPropertiesTest.java,0,9,0,3,0,12
 shardingsphere-master\shardingsphere-master\shardingsphere-test\shardingsphere-pipeline-test\src\test\java\org\apache\shardingsphere\data\pipeline\core\job\progress\JobProgressTest.java,0,41,0,22,0,63
 shardingsphere-master\shardingsphere-master\shardingsphere-features\shardingsphere-encrypt\shardingsphere-encrypt-core\src\main\java\org\apache\shardingsphere\encrypt\rewrite\token\pojo\EncryptFunctionAssignmentToken.java,0,19,0,5,0,24
 shardingsphere-master\shardingsphere-master\shardingsphere-features\shardingsphere-db-discovery\shardingsphere-db-discovery-core\src\main\java\org\apache\shardingsphere\dbdiscovery\route\impl\DatabaseDiscoveryDataSourceRouter.java,0,5,0,2,0,7
 shardingsphere-master\shardingsphere-master\shardingsphere-features\shardingsphere-readwrite-splitting\shardingsphere-readwrite-splitting-core\src\main\java\org\apache\shardingsphere\readwritesplitting\rule\ReadwriteSplittingDataSourceRule.java,0,25,0,12,0,37
 shardingsphere-master\shardingsphere-master\shardingsphere-test\shardingsphere-parser-test\src\main\java\org\apache\shardingsphere\test\sql\parser\parameterized\jaxb\distsql\DistSQLCases.java,0,2,0,1,0,3
 shardingsphere-master\shardingsphere-master\shardingsphere-test\shardingsphere-pipeline-test\src\test\java\org\apache\shardingsphere\data\pipeline\spi\sqlbuilder\PipelineSQLBuilderTest.java,0,26,0,13,0,39
 shardingsphere-master\shardingsphere-master\shardingsphere-sql-parser\shardingsphere-sql-parser-statement\src\main\java\org\apache\shardingsphere\sql\parser\sql\dialect\statement\postgresql\PostgreSQLStatement.java,0,1,0,1,0,2
 shardingsphere-master\shardingsphere-master\shardingsphere-sql-parser\shardingsphere-sql-parser-statement\src\main\java\org\apache\shardingsphere\sql\parser\sql\dialect\statement\mysql\dal\MySQLShowCreateDatabaseStatement.java,0,3,0,5,0,8
 shardingsphere-master\shardingsphere-master\examples\shardingsphere-jdbc-example\single-feature-example\cluster-mode-example\cluster-mode-raw-jdbc-example\src\main\java\org\apache\shardingsphere\example\cluster\mode\raw\jdbc\config\ClusterModeConfigurationUtil.java,0,16,1,12,0,29
 shardingsphere-master\shardingsphere-master\shardingsphere-features\shardingsphere-sharding\shardingsphere-sharding-distsql\shardingsphere-sharding-distsql-statement\src\main\java\org\apache\shardingsphere\sharding\distsql\parser\statement\hint\ClearShardingHintStatement.java,0,0,0,2,0,2
 shardingsphere-master\shardingsphere-master\shardingsphere-jdbc\shardingsphere-jdbc-core\src\test\java\org\apache\shardingsphere\driver\jdbc\adapter\ResultSetGetterAdapterTest.java,0,194,17,67,0,278
 shardingsphere-master\shardingsphere-master\shardingsphere-proxy\shardingsphere-proxy-backend\src\main\java\org\apache\shardingsphere\proxy\backend\text\distsql\rql\rule\SingleTableQueryResultSet.java,0,13,0,8,0,21
 shardingsphere-master\shardingsphere-master\shardingsphere-features\shardingsphere-sharding\shardingsphere-sharding-distsql\shardingsphere-sharding-distsql-handler\src\test\java\org\apache\shardingsphere\sharding\distsql\update\AlterShardingTableRuleStatementUpdaterTest.java,0,83,0,71,0,154
 shardingsphere-master\shardingsphere-master\shardingsphere-mode\shardingsphere-mode-type\shardingsphere-cluster-mode\shardingsphere-cluster-mode-core\src\main\java\org\apache\shardingsphere\mode\manager\cluster\coordinator\lock\event\GlobalAckLockReleasedEvent.java,0,4,0,2,0,6
 shardingsphere-master\shardingsphere-master\shardingsphere-infra\shardingsphere-infra-context\src\main\java\org\apache\shardingsphere\infra\context\refresher\type\RenameTableStatementSchemaRefresher.java,0,31,0,31,0,62
 shardingsphere-master\shardingsphere-master\shardingsphere-proxy\shardingsphere-proxy-backend\src\main\java\org\apache\shardingsphere\proxy\backend\text\transaction\TransactionSetHandler.java,0,8,0,11,0,19
 shardingsphere-master\shardingsphere-master\shardingsphere-features\shardingsphere-shadow\shardingsphere-shadow-distsql\shardingsphere-shadow-distsql-handler\src\test\java\org\apache\shardingsphere\shadow\distsql\query\ShadowAlgorithmQueryResultSetTest.java,0,9,0,9,0,18
 shardingsphere-master\shardingsphere-master\shardingsphere-features\shardingsphere-encrypt\shardingsphere-encrypt-core\src\main\java\org\apache\shardingsphere\encrypt\rewrite\token\generator\EncryptAlterTableTokenGenerator.java,0,178,0,153,0,331
 shardingsphere-master\shardingsphere-master\shardingsphere-proxy\shardingsphere-proxy-frontend\shardingsphere-proxy-frontend-core\src\main\java\org\apache\shardingsphere\proxy\frontend\netty\FrontendChannelLimitationInboundHandler.java,23,9,1,7,0,17
 shardingsphere-master\shardingsphere-master\shardingsphere-test\shardingsphere-parser-test\src\main\java\org\apache\shardingsphere\test\sql\parser\parameterized\jaxb\cases\domain\segment\impl\comments\ExpectedComment.java,6,3,0,3,0,6
 shardingsphere-master\shardingsphere-master\shardingsphere-kernel\shardingsphere-data-pipeline\shardingsphere-data-pipeline-spi\src\main\java\org\apache\shardingsphere\data\pipeline\api\RuleAlteredJobAPI.java,0,24,0,9,0,33
 shardingsphere-master\shardingsphere-master\shardingsphere-sql-parser\shardingsphere-sql-parser-statement\src\main\java\org\apache\shardingsphere\sql\parser\sql\dialect\statement\postgresql\ddl\PostgreSQLDropTablespaceStatement.java,0,1,0,5,0,6
 shardingsphere-master\shardingsphere-master\examples\example-core\example-spring-mybatis\src\main\java\org\apache\shardingsphere\example\core\mybatis\repository\MybatisOrderItemRepository.java,0,0,0,2,0,2
 shardingsphere-master\shardingsphere-master\shardingsphere-infra\shardingsphere-infra-datetime\shardingsphere-infra-datetime-type\shardingsphere-database-datetime\src\main\java\org\apache\shardingsphere\datetime\database\provider\dialect\MySQLDatetimeLoadingSQLProvider.java,0,4,0,3,0,7
 shardingsphere-master\shardingsphere-master\shardingsphere-proxy\shardingsphere-proxy-bootstrap\src\test\java\org\apache\shardingsphere\proxy\fixture\YamlRuleConfigurationFixture.java,0,4,0,2,0,6
 shardingsphere-master\shardingsphere-master\shardingsphere-kernel\shardingsphere-traffic\shardingsphere-traffic-api\src\main\java\org\apache\shardingsphere\traffic\spi\TrafficAlgorithm.java,0,2,0,3,0,5
 shardingsphere-master\shardingsphere-master\shardingsphere-infra\shardingsphere-infra-common\src\main\java\org\apache\shardingsphere\infra\config\schema\impl\DataSourceProvidedSchemaConfiguration.java,0,5,0,2,0,7
 shardingsphere-master\shardingsphere-master\shardingsphere-jdbc\shardingsphere-jdbc-core\src\main\java\org\apache\shardingsphere\driver\jdbc\exception\SQLExceptionErrorCode.java,0,11,0,1,0,12
 shardingsphere-master\shardingsphere-master\shardingsphere-infra\shardingsphere-infra-executor\src\main\java\org\apache\shardingsphere\infra\executor\sql\prepare\driver\DriverExecutionPrepareEngine.java,0,35,1,15,0,51
 shardingsphere-master\shardingsphere-master\shardingsphere-infra\shardingsphere-infra-common\src\test\java\org\apache\shardingsphere\infra\database\metadata\dialect\MariaDBDataSourceMetaDataTest.java,0,12,2,6,0,20
 shardingsphere-master\shardingsphere-master\shardingsphere-features\shardingsphere-sharding\shardingsphere-sharding-core\src\main\java\org\apache\shardingsphere\sharding\algorithm\constant\CosIdAlgorithmConstants.java,0,8,0,1,0,9
 shardingsphere-master\shardingsphere-master\shardingsphere-features\shardingsphere-sharding\shardingsphere-sharding-core\src\test\java\org\apache\shardingsphere\sharding\algorithm\sharding\hint\HintInlineShardingAlgorithmTest.java,0,27,0,10,0,37
 shardingsphere-master\shardingsphere-master\shardingsphere-sql-parser\shardingsphere-sql-parser-statement\src\main\java\org\apache\shardingsphere\sql\parser\sql\common\statement\ddl\AlterSystemStatement.java,3,1,0,3,0,4
 shardingsphere-master\shardingsphere-master\shardingsphere-test\shardingsphere-parser-test\src\main\java\org\apache\shardingsphere\test\sql\parser\parameterized\jaxb\cases\domain\statement\dal\DropResourceGroupStatementTestCase.java,0,3,0,5,0,8
 shardingsphere-master\shardingsphere-master\shardingsphere-infra\shardingsphere-infra-common\src\main\java\org\apache\shardingsphere\infra\metadata\resource\ShardingSphereResource.java,0,15,0,5,0,20
 shardingsphere-master\shardingsphere-master\shardingsphere-test\shardingsphere-parser-test\src\main\java\org\apache\shardingsphere\test\sql\parser\parameterized\jaxb\cases\domain\statement\ddl\AlterConversionStatementTestCase.java,0,0,0,3,0,3
 shardingsphere-master\shardingsphere-master\shardingsphere-agent\shardingsphere-agent-core\src\main\java\org\apache\shardingsphere\agent\core\config\yaml\YamlPluginConfiguration.java,0,8,0,1,0,9
 shardingsphere-master\shardingsphere-master\shardingsphere-features\shardingsphere-readwrite-splitting\shardingsphere-readwrite-splitting-distsql\shardingsphere-readwrite-splitting-distsql-handler\src\main\java\org\apache\shardingsphere\readwritesplitting\distsql\handler\update\DropReadwriteSplittingRuleStatementUpdater.java,0,41,0,38,0,79
 shardingsphere-master\shardingsphere-master\shardingsphere-features\shardingsphere-sharding\shardingsphere-sharding-core\src\main\java\org\apache\shardingsphere\sharding\algorithm\sharding\datetime\AutoIntervalShardingAlgorithm.java,0,47,1,24,0,72
 shardingsphere-master\shardingsphere-master\shardingsphere-proxy\shardingsphere-proxy-backend\src\main\java\org\apache\shardingsphere\proxy\backend\text\admin\postgresql\executor\SelectTableExecutor.java,0,25,0,10,0,35
 shardingsphere-master\shardingsphere-master\shardingsphere-sql-parser\shardingsphere-sql-parser-statement\src\main\java\org\apache\shardingsphere\sql\parser\sql\common\statement\dal\SetStatement.java,5,4,1,5,1,11
 shardingsphere-master\shardingsphere-master\shardingsphere-infra\shardingsphere-infra-common\src\main\java\org\apache\shardingsphere\infra\yaml\schema\pojo\YamlSchema.java,0,2,0,1,0,3
 shardingsphere-master\shardingsphere-master\shardingsphere-infra\shardingsphere-infra-common\src\test\java\org\apache\shardingsphere\infra\eventbus\ShardingSphereEventBusTest.java,0,4,0,2,0,6
 shardingsphere-master\shardingsphere-master\shardingsphere-proxy\shardingsphere-proxy-frontend\shardingsphere-proxy-frontend-mysql\src\main\java\org\apache\shardingsphere\proxy\frontend\mysql\command\query\binary\close\MySQLComStmtCloseExecutor.java,0,10,0,9,0,19
 shardingsphere-master\shardingsphere-master\shardingsphere-proxy\shardingsphere-proxy-backend\src\main\java\org\apache\shardingsphere\proxy\backend\text\distsql\ral\common\queryable\ShowSQLParserRuleHandler.java,0,18,0,12,0,30
 shardingsphere-master\shardingsphere-master\shardingsphere-test\shardingsphere-pipeline-test\src\test\java\org\apache\shardingsphere\data\pipeline\core\check\consistency\DataConsistencyCheckerImplTest.java,0,23,1,23,0,47
 shardingsphere-master\shardingsphere-master\shardingsphere-sql-parser\shardingsphere-sql-parser-statement\src\test\java\org\apache\shardingsphere\sql\parser\sql\common\extractor\TableExtractorTest.java,0,24,0,12,0,36
 shardingsphere-master\shardingsphere-master\shardingsphere-test\shardingsphere-parser-test\src\main\java\org\apache\shardingsphere\test\sql\parser\parameterized\jaxb\cases\domain\segment\impl\column\ExpectedColumn.java,0,4,0,6,0,10
 shardingsphere-master\shardingsphere-master\shardingsphere-features\shardingsphere-shadow\shardingsphere-shadow-core\src\test\java\org\apache\shardingsphere\shadow\yaml\swapper\datasource\ShadowDataSourcePropertiesYamlSwapperTest.java,0,13,0,13,0,26
 shardingsphere-master\shardingsphere-master\shardingsphere-sql-parser\shardingsphere-sql-parser-statement\src\main\java\org\apache\shardingsphere\sql\parser\sql\dialect\statement\sqlserver\tcl\SQLServerRollbackStatement.java,0,1,0,5,0,6
 shardingsphere-master\shardingsphere-master\shardingsphere-kernel\shardingsphere-transaction\shardingsphere-transaction-type\shardingsphere-transaction-xa\shardingsphere-transaction-xa-core\src\main\java\org\apache\shardingsphere\transaction\xa\jta\datasource\swapper\DataSourcePropertyProvider.java,0,6,0,1,0,7
 shardingsphere-master\shardingsphere-master\shardingsphere-infra\shardingsphere-infra-executor\src\main\java\org\apache\shardingsphere\infra\executor\sql\execute\engine\driver\jdbc\sane\JDBCSaneQueryResultEngineFactory.java,0,6,0,4,0,10
 shardingsphere-master\shardingsphere-master\shardingsphere-kernel\shardingsphere-data-pipeline\shardingsphere-data-pipeline-spi\src\main\java\org\apache\shardingsphere\data\pipeline\spi\ingest\dumper\Dumper.java,0,1,0,1,0,2
 shardingsphere-master\shardingsphere-master\shardingsphere-spi\src\test\java\org\apache\shardingsphere\spi\required\RequiredSPIRegistryTest.java,0,16,0,10,0,26
 shardingsphere-master\shardingsphere-master\examples\shardingsphere-jdbc-example\mixed-feature-example\sharding-readwrite-splitting-example\sharding-readwrite-splitting-raw-jdbc-example\src\main\java\org\apache\shardingsphere\example\sharding\readwrite\splitting\raw\config\ShardingReadwriteSplittingConfigurationPrecise.java,0,34,0,33,0,67
 shardingsphere-master\shardingsphere-master\shardingsphere-test\shardingsphere-parser-test\src\main\java\org\apache\shardingsphere\test\sql\parser\parameterized\asserts\statement\dcl\impl\SetDefaultRoleStatementAssert.java,0,4,1,6,0,11
 shardingsphere-master\shardingsphere-master\shardingsphere-kernel\shardingsphere-traffic\shardingsphere-traffic-core\src\main\java\org\apache\shardingsphere\traffic\algorithm\traffic\segment\SQLMatchTrafficAlgorithm.java,0,17,0,7,0,24
 shardingsphere-master\shardingsphere-master\shardingsphere-kernel\shardingsphere-data-pipeline\shardingsphere-data-pipeline-core\src\main\java\org\apache\shardingsphere\data\pipeline\core\exception\PipelineJobNotFoundException.java,0,7,0,2,0,9
 shardingsphere-master\shardingsphere-master\shardingsphere-mode\shardingsphere-mode-type\shardingsphere-standalone-mode\shardingsphere-standalone-mode-core\src\test\java\org\apache\shardingsphere\mode\manager\standalone\StandalonePersistRepositoryFactoryTest.java,0,8,0,11,0,19
 shardingsphere-master\shardingsphere-master\shardingsphere-features\shardingsphere-readwrite-splitting\shardingsphere-readwrite-splitting-spring\shardingsphere-readwrite-splitting-spring-namespace\src\main\java\org\apache\shardingsphere\readwritesplitting\spring\namespace\tag\ReadwriteSplittingRuleBeanDefinitionTag.java,0,15,0,3,0,18
 shardingsphere-master\shardingsphere-master\shardingsphere-infra\shardingsphere-infra-common\src\main\java\org\apache\shardingsphere\infra\metadata\schema\loader\dialect\H2TableMetaDataLoader.java,0,55,0,42,0,97
 shardingsphere-master\shardingsphere-master\shardingsphere-proxy\shardingsphere-proxy-backend\src\main\java\org\apache\shardingsphere\proxy\backend\text\distsql\ral\scaling\update\UpdatableScalingRALBackendHandler.java,0,7,0,5,0,12
 shardingsphere-master\shardingsphere-master\shardingsphere-sql-parser\shardingsphere-sql-parser-statement\src\main\java\org\apache\shardingsphere\sql\parser\sql\dialect\statement\oracle\dml\OracleMergeStatement.java,0,1,0,4,0,5
 shardingsphere-master\shardingsphere-master\shardingsphere-proxy\shardingsphere-proxy-backend\src\test\java\org\apache\shardingsphere\proxy\backend\context\BackendExecutorContextTest.java,0,11,0,7,0,18
 shardingsphere-master\shardingsphere-master\shardingsphere-infra\shardingsphere-infra-common\src\test\java\org\apache\shardingsphere\infra\datasource\pool\metadata\fixture\MockedDataSourcePoolFieldMetaData.java,0,6,0,3,0,9
 shardingsphere-master\shardingsphere-master\shardingsphere-features\shardingsphere-sharding\shardingsphere-sharding-core\src\main\java\org\apache\shardingsphere\sharding\yaml\config\rule\YamlTableRuleConfiguration.java,0,10,0,3,0,13
 shardingsphere-master\shardingsphere-master\shardingsphere-test\shardingsphere-parser-test\src\main\java\org\apache\shardingsphere\test\sql\parser\parameterized\jaxb\cases\domain\statement\ddl\CreateDimensionStatementTestCase.java,0,0,0,3,0,3
 shardingsphere-master\shardingsphere-master\shardingsphere-test\shardingsphere-parser-test\src\main\java\org\apache\shardingsphere\test\sql\parser\parameterized\jaxb\cases\domain\segment\impl\expr\simple\ExpectedSubquery.java,0,2,0,3,0,5
 shardingsphere-master\shardingsphere-master\shardingsphere-test\shardingsphere-integration-test\shardingsphere-integration-test-suite\src\test\java\org\apache\shardingsphere\test\integration\framework\param\array\ClusterParameterizedArrayGenerator.java,0,11,0,9,0,20
 shardingsphere-master\shardingsphere-master\shardingsphere-sql-parser\shardingsphere-sql-parser-statement\src\main\java\org\apache\shardingsphere\sql\parser\sql\dialect\statement\mysql\segment\PasswordOrLockOptionSegment.java,0,38,0,2,0,40
 shardingsphere-master\shardingsphere-master\shardingsphere-proxy\shardingsphere-proxy-backend\src\main\java\org\apache\shardingsphere\proxy\backend\text\admin\mysql\executor\ShowProcedureStatusExecutor.java,0,34,0,23,0,57
 shardingsphere-master\shardingsphere-master\shardingsphere-proxy\shardingsphere-proxy-backend\src\main\java\org\apache\shardingsphere\proxy\backend\text\distsql\ral\common\queryable\ShowReadwriteSplittingReadResourcesHandler.java,0,47,4,37,0,88
 shardingsphere-master\shardingsphere-master\shardingsphere-infra\shardingsphere-infra-common\src\test\java\org\apache\shardingsphere\infra\config\checker\fixture\TestRuleConfigurationWithoutChecker.java,0,2,0,3,0,5
 shardingsphere-master\shardingsphere-master\shardingsphere-mode\shardingsphere-mode-type\shardingsphere-cluster-mode\shardingsphere-cluster-mode-core\src\main\java\org\apache\shardingsphere\mode\manager\cluster\coordinator\lock\service\GlobalLockRegistryService.java,0,13,0,5,0,18
 shardingsphere-master\shardingsphere-master\shardingsphere-mode\shardingsphere-mode-type\shardingsphere-cluster-mode\shardingsphere-cluster-mode-core\src\main\java\org\apache\shardingsphere\mode\manager\cluster\coordinator\lock\service\LockRegistryService.java,0,12,0,5,0,17
 shardingsphere-master\shardingsphere-master\shardingsphere-features\shardingsphere-sharding\shardingsphere-sharding-spring\shardingsphere-sharding-spring-boot-starter\src\main\java\org\apache\shardingsphere\sharding\spring\boot\algorithm\ShardingAlgorithmProvidedBeanRegistry.java,0,9,0,6,0,15
 shardingsphere-master\shardingsphere-master\shardingsphere-agent\shardingsphere-agent-plugins\shardingsphere-agent-plugin-metrics\shardingsphere-agent-metrics-api\src\main\java\org\apache\shardingsphere\agent\metrics\api\MetricsWrapperFactory.java,0,1,0,1,0,2
 shardingsphere-master\shardingsphere-master\shardingsphere-infra\shardingsphere-infra-federation\shardingsphere-infra-federation-optimizer\src\main\java\org\apache\shardingsphere\infra\federation\optimizer\converter\segment\projection\ProjectionsConverter.java,0,37,0,44,0,81
 shardingsphere-master\shardingsphere-master\shardingsphere-db-protocol\shardingsphere-db-protocol-mysql\src\main\java\org\apache\shardingsphere\db\protocol\mysql\packet\binlog\row\column\value\integer\MySQLBitBinlogProtocolValue.java,0,10,1,6,0,17
 shardingsphere-master\shardingsphere-master\shardingsphere-test\shardingsphere-integration-test\shardingsphere-integration-test-suite\src\test\java\org\apache\shardingsphere\test\integration\framework\container\atomic\ITContainer.java,0,1,1,1,0,3
 shardingsphere-master\shardingsphere-master\shardingsphere-proxy\shardingsphere-proxy-backend\src\main\java\org\apache\shardingsphere\proxy\backend\text\SchemaRequiredBackendHandler.java,30,18,0,10,0,28
 shardingsphere-master\shardingsphere-master\shardingsphere-db-protocol\shardingsphere-db-protocol-mysql\src\test\java\org\apache\shardingsphere\db\protocol\mysql\constant\MySQLServerErrorCodeTest.java,0,20,0,12,0,32
 shardingsphere-master\shardingsphere-master\shardingsphere-infra\shardingsphere-infra-common\src\test\java\org\apache\shardingsphere\infra\yaml\engine\constructor\ShardingSphereYamlConstructorTest.java,0,8,0,6,0,14
 shardingsphere-master\shardingsphere-master\shardingsphere-sql-parser\shardingsphere-sql-parser-statement\src\main\java\org\apache\shardingsphere\sql\parser\sql\common\statement\ddl\DropMaterializedViewStatement.java,3,1,1,3,0,5
 shardingsphere-master\shardingsphere-master\shardingsphere-features\shardingsphere-encrypt\shardingsphere-encrypt-core\src\main\java\org\apache\shardingsphere\encrypt\rule\EncryptColumn.java,0,22,0,3,0,25
 shardingsphere-master\shardingsphere-master\shardingsphere-sql-parser\shardingsphere-sql-parser-statement\src\main\java\org\apache\shardingsphere\sql\parser\sql\common\statement\dml\DoStatement.java,3,1,1,3,0,5
 shardingsphere-master\shardingsphere-master\shardingsphere-features\shardingsphere-encrypt\shardingsphere-encrypt-core\src\test\java\org\apache\shardingsphere\encrypt\rewrite\parameter\EncryptParameterRewriterBuilderTest.java,0,18,0,17,0,35
 shardingsphere-master\shardingsphere-master\shardingsphere-kernel\shardingsphere-data-pipeline\shardingsphere-data-pipeline-dialect\shardingsphere-data-pipeline-mysql\src\main\java\org\apache\shardingsphere\data\pipeline\mysql\prepare\datasource\MySQLDataSourcePreparer.java,0,19,0,22,0,41
 shardingsphere-master\shardingsphere-master\shardingsphere-agent\shardingsphere-agent-core\src\main\java\org\apache\shardingsphere\agent\core\bytebuddy\listener\LoggingListener.java,0,11,4,6,0,21
 shardingsphere-master\shardingsphere-master\shardingsphere-infra\shardingsphere-infra-binder\src\main\java\org\apache\shardingsphere\infra\binder\segment\select\projection\engine\ProjectionsContextEngine.java,0,43,0,45,0,88
 shardingsphere-master\shardingsphere-master\shardingsphere-kernel\shardingsphere-data-pipeline\shardingsphere-data-pipeline-spi\src\main\java\org\apache\shardingsphere\data\pipeline\api\executor\AbstractLifecycleExecutor.java,36,11,4,1,0,16
 shardingsphere-master\shardingsphere-master\shardingsphere-features\shardingsphere-sharding\shardingsphere-sharding-distsql\shardingsphere-sharding-distsql-handler\src\main\java\org\apache\shardingsphere\sharding\distsql\handler\update\AlterShardingKeyGeneratorStatementUpdater.java,0,28,0,30,0,58
 shardingsphere-master\shardingsphere-master\shardingsphere-sql-parser\shardingsphere-sql-parser-statement\src\main\java\org\apache\shardingsphere\sql\parser\sql\dialect\statement\mysql\ddl\MySQLDropTableStatement.java,0,3,0,4,0,7
 shardingsphere-master\shardingsphere-master\shardingsphere-db-protocol\shardingsphere-db-protocol-postgresql\src\main\java\org\apache\shardingsphere\db\protocol\postgresql\constant\PostgreSQLAuthenticationMethod.java,0,8,0,2,0,10
 shardingsphere-master\shardingsphere-master\shardingsphere-sql-parser\shardingsphere-sql-parser-statement\src\main\java\org\apache\shardingsphere\sql\parser\sql\common\segment\ddl\constraint\ConstraintDefinitionSegment.java,0,20,0,8,4,32
 shardingsphere-master\shardingsphere-master\shardingsphere-features\shardingsphere-shadow\shardingsphere-shadow-core\src\test\java\org\apache\shardingsphere\shadow\route\engine\util\ShadowExtractorTest.java,0,5,0,6,0,11
 shardingsphere-master\shardingsphere-master\shardingsphere-features\shardingsphere-sharding\shardingsphere-sharding-core\src\main\java\org\apache\shardingsphere\sharding\route\engine\type\federated\ShardingFederatedRoutingEngine.java,0,10,0,6,0,16
 shardingsphere-master\shardingsphere-master\shardingsphere-test\shardingsphere-parser-test\src\main\java\org\apache\shardingsphere\test\sql\parser\parameterized\jaxb\cases\domain\statement\distsql\rdl\create\CreateDefaultShadowAlgorithmStatementTestCase.java,0,3,0,4,0,7
 shardingsphere-master\shardingsphere-master\shardingsphere-infra\shardingsphere-infra-common\src\main\java\org\apache\shardingsphere\infra\database\metadata\url\JdbcUrl.java,0,9,0,1,0,10
 shardingsphere-master\shardingsphere-master\shardingsphere-proxy\shardingsphere-proxy-backend\src\main\java\org\apache\shardingsphere\proxy\backend\communication\SQLStatementSchemaHolder.java,0,7,0,2,0,9
 shardingsphere-master\shardingsphere-master\shardingsphere-sql-parser\shardingsphere-sql-parser-statement\src\main\java\org\apache\shardingsphere\sql\parser\sql\common\statement\ddl\DropViewStatement.java,5,3,1,4,1,9
 shardingsphere-master\shardingsphere-master\shardingsphere-features\shardingsphere-encrypt\shardingsphere-encrypt-distsql\shardingsphere-encrypt-distsql-handler\src\test\java\org\apache\shardingsphere\encrypt\distsql\handler\update\DropEncryptRuleStatementUpdaterTest.java,0,44,0,32,0,76
 shardingsphere-master\shardingsphere-master\shardingsphere-sql-parser\shardingsphere-sql-parser-statement\src\main\java\org\apache\shardingsphere\sql\parser\sql\dialect\statement\opengauss\tcl\OpenGaussReleaseSavepointStatement.java,0,1,0,5,0,6
 shardingsphere-master\shardingsphere-master\shardingsphere-infra\shardingsphere-infra-rewrite\src\main\java\org\apache\shardingsphere\infra\rewrite\sql\token\pojo\Attachable.java,0,2,0,1,0,3
 shardingsphere-master\shardingsphere-master\shardingsphere-features\shardingsphere-encrypt\shardingsphere-encrypt-core\src\main\java\org\apache\shardingsphere\encrypt\rewrite\token\pojo\EncryptPredicateEqualRightValueToken.java,0,15,0,4,0,19
 shardingsphere-master\shardingsphere-master\shardingsphere-infra\shardingsphere-infra-common\src\main\java\org\apache\shardingsphere\infra\config\algorithm\ShardingSphereInstanceRequiredAlgorithm.java,0,2,0,1,0,3
 shardingsphere-master\shardingsphere-master\shardingsphere-mode\shardingsphere-mode-type\shardingsphere-cluster-mode\shardingsphere-cluster-mode-core\src\test\java\org\apache\shardingsphere\mode\manager\cluster\coordinator\lock\service\GlobalLockNodeTest.java,0,15,0,7,0,22
 shardingsphere-master\shardingsphere-master\shardingsphere-sql-parser\shardingsphere-sql-parser-statement\src\main\java\org\apache\shardingsphere\sql\parser\sql\common\util\SubqueryExtractUtil.java,0,27,0,37,0,64
 shardingsphere-master\shardingsphere-master\shardingsphere-jdbc\shardingsphere-jdbc-core\src\test\java\org\apache\shardingsphere\driver\jdbc\base\AbstractSQLTest.java,45,22,0,12,0,34
 shardingsphere-master\shardingsphere-master\shardingsphere-infra\shardingsphere-infra-common\src\main\java\org\apache\shardingsphere\infra\distsql\update\RuleDefinitionDropUpdater.java,0,10,0,4,0,14
 shardingsphere-master\shardingsphere-master\shardingsphere-kernel\shardingsphere-traffic\shardingsphere-traffic-core\src\main\java\org\apache\shardingsphere\traffic\algorithm\loadbalance\RoundRobinTrafficLoadBalanceAlgorithm.java,0,10,0,6,0,16
 shardingsphere-master\shardingsphere-master\shardingsphere-test\shardingsphere-parser-test\src\main\java\org\apache\shardingsphere\test\sql\parser\parameterized\asserts\segment\distsql\rdl\ShadowRuleAssert.java,0,22,0,27,0,49
 shardingsphere-master\shardingsphere-master\shardingsphere-test\shardingsphere-parser-test\src\main\java\org\apache\shardingsphere\test\sql\parser\parameterized\jaxb\cases\domain\statement\ddl\AlterAggregateStatementTestCase.java,0,1,0,3,0,4
 shardingsphere-master\shardingsphere-master\shardingsphere-infra\shardingsphere-infra-binder\src\main\java\org\apache\shardingsphere\infra\binder\statement\CommonSQLStatementContext.java,58,20,0,10,0,30
 shardingsphere-master\shardingsphere-master\shardingsphere-sql-parser\shardingsphere-sql-parser-statement\src\main\java\org\apache\shardingsphere\sql\parser\sql\dialect\statement\sqlserver\dcl\SQLServerSetUserStatement.java,0,3,0,7,2,12
 shardingsphere-master\shardingsphere-master\shardingsphere-test\shardingsphere-parser-test\src\main\java\org\apache\shardingsphere\test\sql\parser\parameterized\jaxb\cases\domain\statement\distsql\rdl\alter\AlterShardingAutoTableRuleStatementTestCase.java,0,3,0,5,0,8
 shardingsphere-master\shardingsphere-master\shardingsphere-agent\shardingsphere-agent-core\src\main\java\org\apache\shardingsphere\agent\core\bytebuddy\transformer\advice\ComposeInstanceMethodAroundAdvice.java,0,11,0,7,0,18
 shardingsphere-master\shardingsphere-master\shardingsphere-db-protocol\shardingsphere-db-protocol-postgresql\src\main\java\org\apache\shardingsphere\db\protocol\postgresql\packet\command\query\extended\bind\protocol\PostgreSQLBinaryProtocolValueFactory.java,0,55,0,36,0,91
 shardingsphere-master\shardingsphere-master\shardingsphere-features\shardingsphere-encrypt\shardingsphere-encrypt-distsql\shardingsphere-encrypt-distsql-statement\src\main\java\org\apache\shardingsphere\encrypt\distsql\parser\statement\CreateEncryptRuleStatement.java,0,2,0,3,0,5
 shardingsphere-master\shardingsphere-master\shardingsphere-features\shardingsphere-sharding\shardingsphere-sharding-core\src\main\java\org\apache\shardingsphere\sharding\algorithm\sharding\complex\ComplexInlineShardingAlgorithm.java,0,39,0,19,0,58
 shardingsphere-master\shardingsphere-master\examples\other-example\shardingsphere-parser-example\src\main\java\org\apache\shardingsphere\example\parser\postgresql\statement\PostgreSQLParserStatementExample.java,0,33,1,11,0,45
 shardingsphere-master\shardingsphere-master\shardingsphere-features\shardingsphere-encrypt\shardingsphere-encrypt-api\src\main\java\org\apache\shardingsphere\encrypt\api\config\EncryptRuleConfiguration.java,0,24,0,9,0,33
 shardingsphere-master\shardingsphere-master\shardingsphere-infra\shardingsphere-infra-executor\src\main\java\org\apache\shardingsphere\infra\executor\sql\process\model\yaml\YamlExecuteProcessUnit.java,0,6,0,3,0,9
 shardingsphere-master\shardingsphere-master\shardingsphere-features\shardingsphere-db-discovery\shardingsphere-db-discovery-core\src\main\java\org\apache\shardingsphere\dbdiscovery\rule\DatabaseDiscoveryRule.java,0,68,0,55,0,123
 shardingsphere-master\shardingsphere-master\shardingsphere-infra\shardingsphere-infra-common\src\test\java\org\apache\shardingsphere\infra\database\type\dialect\MariaDBDatabaseTypeTest.java,0,19,1,7,0,27
 shardingsphere-master\shardingsphere-master\shardingsphere-test\shardingsphere-parser-test\src\main\java\org\apache\shardingsphere\test\sql\parser\parameterized\jaxb\cases\domain\segment\impl\where\ExpectedWhereClause.java,0,2,0,4,0,6
 shardingsphere-master\shardingsphere-master\shardingsphere-test\shardingsphere-parser-test\src\main\java\org\apache\shardingsphere\test\sql\parser\parameterized\jaxb\cases\domain\statement\ddl\AlterIndexStatementTestCase.java,0,4,0,5,0,9
 shardingsphere-master\shardingsphere-master\shardingsphere-test\shardingsphere-parser-test\src\main\java\org\apache\shardingsphere\test\sql\parser\parameterized\jaxb\cases\domain\statement\distsql\rdl\alter\AlterDatabaseDiscoveryConstructionRuleStatementTestCase.java,0,5,0,6,0,11
 shardingsphere-master\shardingsphere-master\shardingsphere-test\shardingsphere-pipeline-test\src\test\java\org\apache\shardingsphere\data\pipeline\core\ingest\position\PlaceholderPositionTest.java,0,5,0,2,0,7
 shardingsphere-master\shardingsphere-master\shardingsphere-sql-parser\shardingsphere-sql-parser-statement\src\main\java\org\apache\shardingsphere\sql\parser\sql\common\statement\ddl\DropCastStatement.java,3,1,1,3,0,5
 shardingsphere-master\shardingsphere-master\shardingsphere-kernel\shardingsphere-data-pipeline\shardingsphere-data-pipeline-dialect\shardingsphere-data-pipeline-postgresql\src\test\java\org\apache\shardingsphere\data\pipeline\postgresql\ingest\PostgreSQLPositionInitializerTest.java,0,37,10,11,0,58
 shardingsphere-master\shardingsphere-master\shardingsphere-mode\shardingsphere-mode-type\shardingsphere-cluster-mode\shardingsphere-cluster-mode-core\src\test\java\org\apache\shardingsphere\mode\manager\cluster\coordinator\fixture\YamlRuleConfigurationSwapperFixture.java,0,10,0,6,0,16
 shardingsphere-master\shardingsphere-master\shardingsphere-kernel\shardingsphere-data-pipeline\shardingsphere-data-pipeline-spi\src\main\java\org\apache\shardingsphere\data\pipeline\api\check\consistency\DataCalculateParameter.java,0,12,3,3,0,18
 shardingsphere-master\shardingsphere-master\shardingsphere-spi\src\main\java\org\apache\shardingsphere\spi\optional\OptionalSPI.java,0,1,0,1,0,2
 shardingsphere-master\shardingsphere-master\shardingsphere-db-protocol\shardingsphere-db-protocol-mysql\src\main\java\org\apache\shardingsphere\db\protocol\mysql\packet\handshake\MySQLAuthMoreDataPacket.java,0,11,0,3,0,14
 shardingsphere-master\shardingsphere-master\shardingsphere-proxy\shardingsphere-proxy-frontend\shardingsphere-proxy-frontend-mysql\src\test\java\org\apache\shardingsphere\proxy\frontend\mysql\command\query\builder\ResponsePacketBuilderTest.java,0,25,0,16,0,41
 shardingsphere-master\shardingsphere-master\shardingsphere-sql-parser\shardingsphere-sql-parser-statement\src\main\java\org\apache\shardingsphere\sql\parser\sql\common\value\keyword\KeywordValue.java,0,3,0,1,0,4
 shardingsphere-master\shardingsphere-master\shardingsphere-sql-parser\shardingsphere-sql-parser-statement\src\main\java\org\apache\shardingsphere\sql\parser\sql\common\segment\dml\column\ColumnSegment.java,0,17,1,8,1,27
 shardingsphere-master\shardingsphere-master\shardingsphere-sql-parser\shardingsphere-sql-parser-statement\src\main\java\org\apache\shardingsphere\sql\parser\sql\dialect\handler\dml\SelectStatementHandler.java,0,11,0,25,13,49
 shardingsphere-master\shardingsphere-master\shardingsphere-infra\shardingsphere-infra-executor\src\test\java\org\apache\shardingsphere\infra\executor\sql\process\fixture\ExecuteProcessReporterFixture.java,20,8,1,8,0,17
 shardingsphere-master\shardingsphere-master\shardingsphere-sql-parser\shardingsphere-sql-parser-dialect\shardingsphere-sql-parser-sqlserver\src\main\java\org\apache\shardingsphere\sql\parser\sqlserver\visitor\statement\impl\SQLServerDDLStatementSQLVisitor.java,0,75,0,168,0,243
 shardingsphere-master\shardingsphere-master\shardingsphere-features\shardingsphere-sharding\shardingsphere-sharding-core\src\main\java\org\apache\shardingsphere\sharding\merge\dal\show\ShowIndexMergedResult.java,26,14,0,13,0,27
 shardingsphere-master\shardingsphere-master\shardingsphere-kernel\shardingsphere-data-pipeline\shardingsphere-data-pipeline-spi\src\main\java\org\apache\shardingsphere\data\pipeline\spi\ratelimit\JobRateLimitAlgorithm.java,0,4,0,4,0,8
 shardingsphere-master\shardingsphere-master\shardingsphere-infra\shardingsphere-infra-common\src\test\java\org\apache\shardingsphere\infra\database\metadata\dialect\MySQLDataSourceMetaDataTest.java,0,12,2,6,0,20
 shardingsphere-master\shardingsphere-master\shardingsphere-infra\shardingsphere-infra-federation\shardingsphere-infra-federation-optimizer\src\main\java\org\apache\shardingsphere\infra\federation\optimizer\metadata\calcite\FederationSchema.java,0,7,0,5,0,12
 shardingsphere-master\shardingsphere-master\shardingsphere-sql-parser\shardingsphere-sql-parser-statement\src\main\java\org\apache\shardingsphere\sql\parser\sql\dialect\statement\mysql\ddl\MySQLDropLogfileGroupStatement.java,0,1,0,5,0,6
 shardingsphere-master\shardingsphere-master\shardingsphere-agent\shardingsphere-agent-core\src\test\java\org\apache\shardingsphere\agent\core\entity\InterceptorConvertTest.java,0,4,0,2,0,6
 shardingsphere-master\shardingsphere-master\shardingsphere-sql-parser\shardingsphere-sql-parser-statement\src\main\java\org\apache\shardingsphere\sql\parser\sql\dialect\statement\postgresql\ddl\PostgreSQLDropDomainStatement.java,0,1,0,5,0,6
 shardingsphere-master\shardingsphere-master\shardingsphere-features\shardingsphere-db-discovery\shardingsphere-db-discovery-spring\shardingsphere-db-discovery-spring-namespace\src\main\java\org\apache\shardingsphere\dbdiscovery\spring\namespace\parser\DatabaseDiscoveryRuleBeanDefinitionParser.java,0,32,0,32,0,64
 shardingsphere-master\shardingsphere-master\shardingsphere-features\shardingsphere-sharding\shardingsphere-sharding-api\src\main\java\org\apache\shardingsphere\sharding\api\sharding\complex\ComplexKeysShardingValue.java,0,8,0,2,0,10
 shardingsphere-master\shardingsphere-master\shardingsphere-agent\shardingsphere-agent-api\src\main\java\org\apache\shardingsphere\agent\api\point\InstanceMethodPoint.java,0,6,0,1,0,7
 shardingsphere-master\shardingsphere-master\shardingsphere-db-protocol\shardingsphere-db-protocol-mysql\src\main\java\org\apache\shardingsphere\db\protocol\mysql\packet\handshake\MySQLHandshakePacket.java,0,59,0,21,0,80
 shardingsphere-master\shardingsphere-master\shardingsphere-sql-parser\shardingsphere-sql-parser-statement\src\main\java\org\apache\shardingsphere\sql\parser\sql\dialect\statement\mysql\dal\MySQLShowTableStatusStatement.java,0,7,0,7,1,15
 shardingsphere-master\shardingsphere-master\shardingsphere-test\shardingsphere-parser-test\src\main\java\org\apache\shardingsphere\test\sql\parser\parameterized\asserts\statement\distsql\ral\impl\common\queryable\ShowTransactionRuleStatementAssert.java,0,6,0,9,0,15
 shardingsphere-master\shardingsphere-master\shardingsphere-features\shardingsphere-sharding\shardingsphere-sharding-core\src\test\java\org\apache\shardingsphere\sharding\rewrite\token\TableTokenGeneratorTest.java,0,12,1,17,0,30
 shardingsphere-master\shardingsphere-master\shardingsphere-test\shardingsphere-parser-test\src\main\java\org\apache\shardingsphere\test\sql\parser\parameterized\jaxb\cases\domain\statement\ddl\AlterForeignDataWrapperTestCase.java,0,0,0,3,0,3
 shardingsphere-master\shardingsphere-master\shardingsphere-proxy\shardingsphere-proxy-backend\src\main\java\org\apache\shardingsphere\proxy\backend\text\admin\DatabaseAdminQueryBackendHandler.java,0,25,0,19,0,44
 shardingsphere-master\shardingsphere-master\shardingsphere-infra\shardingsphere-infra-rewrite\src\main\java\org\apache\shardingsphere\infra\rewrite\sql\token\pojo\RouteUnitAware.java,0,2,0,1,0,3
 shardingsphere-master\shardingsphere-master\shardingsphere-features\shardingsphere-sharding\shardingsphere-sharding-core\src\main\java\org\apache\shardingsphere\sharding\merge\dql\orderby\CompareUtil.java,0,11,2,7,0,20
 shardingsphere-master\shardingsphere-master\shardingsphere-features\shardingsphere-sharding\shardingsphere-sharding-core\src\main\java\org\apache\shardingsphere\sharding\route\strategy\type\standard\StandardShardingStrategy.java,0,32,0,25,0,57
 shardingsphere-master\shardingsphere-master\shardingsphere-kernel\shardingsphere-parser\shardingsphere-parser-core\src\main\java\org\apache\shardingsphere\parser\rule\builder\DefaultSQLParserRuleConfigurationBuilder.java,0,11,0,6,0,17
 shardingsphere-master\shardingsphere-master\shardingsphere-test\shardingsphere-parser-test\src\main\java\org\apache\shardingsphere\test\sql\parser\parameterized\asserts\statement\distsql\ral\impl\scaling\update\DropScalingStatementAssert.java,0,11,1,12,0,24
 shardingsphere-master\shardingsphere-master\shardingsphere-infra\shardingsphere-infra-merge\src\test\java\org\apache\shardingsphere\infra\merge\result\impl\memory\fixture\TestMemoryMergedResult.java,0,10,0,8,0,18
 shardingsphere-master\shardingsphere-master\shardingsphere-proxy\shardingsphere-proxy-frontend\shardingsphere-proxy-frontend-core\src\test\java\org\apache\shardingsphere\proxy\frontend\fixture\DatabaseProtocolFrontendEngineFixture.java,0,9,2,4,0,15
 shardingsphere-master\shardingsphere-master\shardingsphere-test\shardingsphere-rewrite-test\src\test\java\org\apache\shardingsphere\sharding\rewrite\fixture\SchemaBasedEncryptAlgorithmFixture.java,0,10,1,6,0,17
 shardingsphere-master\shardingsphere-master\shardingsphere-sql-parser\shardingsphere-sql-parser-statement\src\main\java\org\apache\shardingsphere\sql\parser\sql\common\constant\AggregationType.java,0,10,0,2,0,12
 shardingsphere-master\shardingsphere-master\shardingsphere-test\shardingsphere-parser-test\src\main\java\org\apache\shardingsphere\test\sql\parser\parameterized\asserts\statement\distsql\ral\impl\common\queryable\ShowInstanceStatementAssert.java,0,5,1,8,0,14
 shardingsphere-master\shardingsphere-master\shardingsphere-features\shardingsphere-sharding\shardingsphere-sharding-core\src\main\java\org\apache\shardingsphere\sharding\merge\dql\orderby\OrderByStreamMergedResult.java,48,15,0,9,0,24
 shardingsphere-master\shardingsphere-master\shardingsphere-infra\shardingsphere-infra-executor\src\main\java\org\apache\shardingsphere\infra\executor\check\SQLChecker.java,0,10,0,4,0,14
 shardingsphere-master\shardingsphere-master\shardingsphere-features\shardingsphere-sharding\shardingsphere-sharding-distsql\shardingsphere-sharding-distsql-statement\src\main\java\org\apache\shardingsphere\scaling\distsql\statement\RestoreScalingSourceWritingStatement.java,0,3,0,3,0,6
 shardingsphere-master\shardingsphere-master\shardingsphere-features\shardingsphere-sharding\shardingsphere-sharding-core\src\main\java\org\apache\shardingsphere\sharding\route\engine\validator\ddl\impl\ShardingCreateProcedureStatementValidator.java,0,12,1,14,0,27
 shardingsphere-master\shardingsphere-master\shardingsphere-features\shardingsphere-encrypt\shardingsphere-encrypt-distsql\shardingsphere-encrypt-distsql-handler\src\main\java\org\apache\shardingsphere\encrypt\distsql\handler\converter\EncryptRuleStatementConverter.java,0,22,1,20,0,43
 shardingsphere-master\shardingsphere-master\shardingsphere-infra\shardingsphere-infra-federation\shardingsphere-infra-federation-optimizer\src\main\java\org\apache\shardingsphere\infra\federation\optimizer\context\parser\dialect\impl\H2OptimizerBuilder.java,0,6,0,6,0,12
 shardingsphere-master\shardingsphere-master\shardingsphere-db-protocol\shardingsphere-db-protocol-postgresql\src\main\java\org\apache\shardingsphere\db\protocol\postgresql\packet\command\query\extended\bind\protocol\PostgreSQLBinaryTimestampUtils.java,0,26,0,6,0,32
 shardingsphere-master\shardingsphere-master\shardingsphere-features\shardingsphere-shadow\shardingsphere-shadow-core\src\main\java\org\apache\shardingsphere\shadow\route\engine\ShadowRouteEngine.java,0,9,0,7,0,16
 shardingsphere-master\shardingsphere-master\shardingsphere-test\shardingsphere-rewrite-test\src\test\java\org\apache\shardingsphere\sharding\rewrite\fixture\HintShardingAlgorithmFixture.java,0,6,2,5,0,13
 shardingsphere-master\shardingsphere-master\shardingsphere-features\shardingsphere-sharding\shardingsphere-sharding-core\src\main\java\org\apache\shardingsphere\sharding\algorithm\sharding\cosid\AbstractIntervalShardingAlgorithm.java,0,56,1,27,0,84
 shardingsphere-master\shardingsphere-master\shardingsphere-features\shardingsphere-encrypt\shardingsphere-encrypt-core\src\main\java\org\apache\shardingsphere\encrypt\constant\EncryptOrder.java,0,4,0,1,0,5
 shardingsphere-master\shardingsphere-master\shardingsphere-features\shardingsphere-readwrite-splitting\shardingsphere-readwrite-splitting-core\src\main\java\org\apache\shardingsphere\readwritesplitting\algorithm\config\AlgorithmProvidedReadwriteSplittingRuleConfiguration.java,0,8,0,7,0,15
 shardingsphere-master\shardingsphere-master\shardingsphere-features\shardingsphere-encrypt\shardingsphere-encrypt-distsql\shardingsphere-encrypt-distsql-handler\src\test\java\org\apache\shardingsphere\encrypt\distsql\handler\update\CreateEncryptRuleStatementUpdaterTest.java,0,27,0,23,0,50
 shardingsphere-master\shardingsphere-master\shardingsphere-proxy\shardingsphere-proxy-backend\src\test\java\org\apache\shardingsphere\proxy\backend\communication\jdbc\recognizer\impl\OracleRecognizerTest.java,0,8,0,5,0,13
 shardingsphere-master\shardingsphere-master\shardingsphere-features\shardingsphere-db-discovery\shardingsphere-db-discovery-api\src\main\java\org\apache\shardingsphere\dbdiscovery\api\config\rule\DatabaseDiscoveryDataSourceRuleConfiguration.java,0,9,0,1,0,10
 shardingsphere-master\shardingsphere-master\shardingsphere-infra\shardingsphere-infra-executor\src\main\java\org\apache\shardingsphere\infra\executor\sql\prepare\driver\vertx\VertxExecutionContext.java,0,0,0,2,0,2
 shardingsphere-master\shardingsphere-master\shardingsphere-features\shardingsphere-sharding\shardingsphere-sharding-distsql\shardingsphere-sharding-distsql-handler\src\test\java\org\apache\shardingsphere\sharding\distsql\update\CreateDefaultShardingStrategyStatementUpdaterTest.java,0,57,0,44,0,101
 shardingsphere-master\shardingsphere-master\shardingsphere-kernel\shardingsphere-transaction\shardingsphere-transaction-core\src\main\java\org\apache\shardingsphere\transaction\core\TransactionOperationType.java,0,7,0,1,0,8
 shardingsphere-master\shardingsphere-master\shardingsphere-features\shardingsphere-sharding\shardingsphere-sharding-api\src\main\java\org\apache\shardingsphere\sharding\api\config\strategy\sharding\ComplexShardingStrategyConfiguration.java,0,13,0,5,0,18
 shardingsphere-master\shardingsphere-master\shardingsphere-proxy\shardingsphere-proxy-backend\src\main\java\org\apache\shardingsphere\proxy\backend\text\distsql\rdl\rule\CreateDefaultSingleTableRuleStatementUpdater.java,0,20,0,19,0,39
 shardingsphere-master\shardingsphere-master\shardingsphere-features\shardingsphere-sharding\shardingsphere-sharding-distsql\shardingsphere-sharding-distsql-statement\src\main\java\org\apache\shardingsphere\sharding\distsql\parser\statement\ShowUnusedShardingKeyGeneratorsStatement.java,0,4,0,5,0,9
 shardingsphere-master\shardingsphere-master\shardingsphere-proxy\shardingsphere-proxy-backend\src\main\java\org\apache\shardingsphere\proxy\backend\text\distsql\ral\common\checker\ShardingRuleConfigurationImportChecker.java,0,49,0,40,0,89
 shardingsphere-master\shardingsphere-master\shardingsphere-proxy\shardingsphere-proxy-frontend\shardingsphere-proxy-frontend-reactive-core\src\test\java\org\apache\shardingsphere\proxy\frontend\reactive\state\impl\ReactiveOKProxyStateTest.java,0,14,0,12,0,26
 shardingsphere-master\shardingsphere-master\shardingsphere-test\shardingsphere-parser-test\src\main\java\org\apache\shardingsphere\test\sql\parser\parameterized\jaxb\cases\domain\statement\distsql\rdl\create\CreateShardingAlgorithmStatementTestCase.java,0,4,0,6,0,10
 shardingsphere-master\shardingsphere-master\shardingsphere-test\shardingsphere-parser-test\src\main\java\org\apache\shardingsphere\test\sql\parser\parameterized\asserts\statement\distsql\rql\impl\rule\ShowShardingScalingRulesStatementAssert.java,0,7,0,11,0,18
 shardingsphere-master\shardingsphere-master\shardingsphere-sql-parser\shardingsphere-sql-parser-statement\src\main\java\org\apache\shardingsphere\sql\parser\sql\dialect\statement\opengauss\ddl\OpenGaussDropFunctionStatement.java,0,1,0,5,0,6
 shardingsphere-master\shardingsphere-master\shardingsphere-infra\shardingsphere-infra-binder\src\test\java\org\apache\shardingsphere\infra\binder\statement\dcl\DenyUserStatementContextTest.java,0,6,0,10,0,16
 shardingsphere-master\shardingsphere-master\shardingsphere-infra\shardingsphere-infra-common\src\test\java\org\apache\shardingsphere\infra\database\metadata\dialect\OpenGaussDataSourceMetaDataTest.java,0,11,2,5,0,18
 shardingsphere-master\shardingsphere-master\shardingsphere-mode\shardingsphere-mode-type\shardingsphere-cluster-mode\shardingsphere-cluster-mode-core\src\main\java\org\apache\shardingsphere\mode\manager\cluster\coordinator\lock\service\LockNode.java,0,12,0,3,0,15
 shardingsphere-master\shardingsphere-master\shardingsphere-proxy\shardingsphere-proxy-backend\src\main\java\org\apache\shardingsphere\proxy\backend\text\transaction\TransactionXAHandler.java,0,16,2,14,0,32
 shardingsphere-master\shardingsphere-master\shardingsphere-test\shardingsphere-parser-test\src\main\java\org\apache\shardingsphere\test\sql\parser\parameterized\asserts\statement\distsql\ral\impl\scaling\UpdatableScalingRALStatementAssert.java,0,10,0,33,0,43
 shardingsphere-master\shardingsphere-master\shardingsphere-test\shardingsphere-rewrite-test\src\test\java\org\apache\shardingsphere\sharding\rewrite\parameterized\engine\parameter\SQLRewriteEngineTestParameters.java,0,24,0,2,0,26
 shardingsphere-master\shardingsphere-master\shardingsphere-sql-parser\shardingsphere-sql-parser-dialect\shardingsphere-sql-parser-sql92\src\main\java\org\apache\shardingsphere\sql\parser\sql92\visitor\statement\impl\SQL92DDLStatementSQLVisitor.java,0,62,0,80,0,142
 shardingsphere-master\shardingsphere-master\shardingsphere-features\shardingsphere-sharding\shardingsphere-sharding-distsql\shardingsphere-sharding-distsql-statement\src\main\java\org\apache\shardingsphere\sharding\distsql\parser\statement\CreateShardingBindingTableRulesStatement.java,0,4,0,4,0,8
 shardingsphere-master\shardingsphere-master\shardingsphere-infra\shardingsphere-infra-common\src\main\java\org\apache\shardingsphere\infra\config\function\EnhancedRuleConfiguration.java,0,0,0,1,0,1
 shardingsphere-master\shardingsphere-master\shardingsphere-infra\shardingsphere-infra-executor\src\main\java\org\apache\shardingsphere\infra\executor\sql\execute\result\query\type\stream\AbstractStreamQueryResult.java,5,3,1,4,0,8
 shardingsphere-master\shardingsphere-master\shardingsphere-test\shardingsphere-integration-test\shardingsphere-integration-test-suite\src\test\java\org\apache\shardingsphere\test\integration\framework\container\atomic\ITContainers.java,0,24,3,9,0,36
 shardingsphere-master\shardingsphere-master\shardingsphere-test\shardingsphere-parser-test\src\main\java\org\apache\shardingsphere\test\sql\parser\parameterized\asserts\statement\distsql\ral\impl\common\queryable\ShowTableMetadataStatementAssert.java,0,10,1,13,0,24
 shardingsphere-master\shardingsphere-master\shardingsphere-jdbc\shardingsphere-jdbc-spring\shardingsphere-jdbc-core-spring\shardingsphere-jdbc-core-spring-namespace\src\main\java\org\apache\shardingsphere\spring\namespace\tag\mode\ModeBeanDefinitionTag.java,0,9,0,1,0,10
 shardingsphere-master\shardingsphere-master\shardingsphere-features\shardingsphere-db-discovery\shardingsphere-db-discovery-spring\shardingsphere-db-discovery-spring-boot-starter\src\test\java\org\apache\shardingsphere\dbdiscovery\spring\boot\DatabaseDiscoverySpringBootStarterTest.java,18,7,0,5,0,12
 shardingsphere-master\shardingsphere-master\shardingsphere-test\shardingsphere-parser-test\src\main\java\org\apache\shardingsphere\test\sql\parser\parameterized\asserts\statement\distsql\rdl\RDLStatementAssert.java,0,17,0,49,0,66
 shardingsphere-master\shardingsphere-master\shardingsphere-kernel\shardingsphere-traffic\shardingsphere-traffic-core\src\main\java\org\apache\shardingsphere\traffic\context\TrafficContext.java,0,7,0,1,0,8
 shardingsphere-master\shardingsphere-master\shardingsphere-features\shardingsphere-db-discovery\shardingsphere-db-discovery-distsql\shardingsphere-db-discovery-distsql-handler\src\test\java\org\apache\shardingsphere\dbdiscovery\distsql\handler\update\CreateDatabaseDiscoveryHeartbeatStatementUpdaterTest.java,0,28,0,22,0,50
 shardingsphere-master\shardingsphere-master\shardingsphere-jdbc\shardingsphere-jdbc-core\src\test\java\org\apache\shardingsphere\driver\jdbc\adapter\PreparedStatementAdapterTest.java,0,106,1,25,0,132
 shardingsphere-master\shardingsphere-master\shardingsphere-proxy\shardingsphere-proxy-backend\src\main\java\org\apache\shardingsphere\proxy\backend\text\distsql\rql\rule\SchemaRulesCountResultSet.java,0,72,0,36,0,108
 shardingsphere-master\shardingsphere-master\shardingsphere-sql-parser\shardingsphere-sql-parser-dialect\shardingsphere-sql-parser-sqlserver\src\main\java\org\apache\shardingsphere\sql\parser\sqlserver\visitor\format\facade\SQLServerFormatSQLVisitorFacade.java,0,9,0,1,0,10
 shardingsphere-master\shardingsphere-master\shardingsphere-features\shardingsphere-sharding\shardingsphere-sharding-distsql\shardingsphere-sharding-distsql-handler\src\test\java\org\apache\shardingsphere\sharding\distsql\update\DropShardingBindingTableRuleStatementUpdaterTest.java,0,62,0,44,0,106
 shardingsphere-master\shardingsphere-master\shardingsphere-sql-parser\shardingsphere-sql-parser-statement\src\main\java\org\apache\shardingsphere\sql\parser\sql\dialect\statement\sql92\tcl\SQL92RollbackStatement.java,0,1,0,4,0,5
 shardingsphere-master\shardingsphere-master\shardingsphere-kernel\shardingsphere-transaction\shardingsphere-transaction-type\shardingsphere-transaction-xa\shardingsphere-transaction-xa-core\src\test\java\org\apache\shardingsphere\transaction\xa\fixture\DataSourceUtils.java,0,24,0,15,0,39
 shardingsphere-master\shardingsphere-master\shardingsphere-infra\shardingsphere-infra-common\src\main\java\org\apache\shardingsphere\infra\distsql\exception\resource\ResourceDefinitionViolationException.java,9,5,0,3,0,8
 shardingsphere-master\shardingsphere-master\shardingsphere-sql-parser\shardingsphere-sql-parser-statement\src\main\java\org\apache\shardingsphere\sql\parser\sql\dialect\statement\opengauss\ddl\OpenGaussDropSchemaStatement.java,0,1,0,6,0,7
 shardingsphere-master\shardingsphere-master\shardingsphere-distsql\shardingsphere-distsql-statement\src\main\java\org\apache\shardingsphere\distsql\parser\statement\ral\common\updatable\RefreshTableMetadataStatement.java,0,4,0,2,0,6
 shardingsphere-master\shardingsphere-master\shardingsphere-kernel\shardingsphere-single-table\shardingsphere-single-table-core\src\test\java\org\apache\shardingsphere\singletable\swapper\SingleTableRuleConfigurationYamlSwapperTest.java,0,21,0,14,0,35
 shardingsphere-master\shardingsphere-master\shardingsphere-sql-parser\shardingsphere-sql-parser-dialect\shardingsphere-sql-parser-sql92\src\test\java\org\apache\shardingsphere\sql\parser\sql92\SQL92ParserParameterizedTest.java,0,7,0,5,0,12
 shardingsphere-master\shardingsphere-master\shardingsphere-sql-parser\shardingsphere-sql-parser-statement\src\main\java\org\apache\shardingsphere\sql\parser\sql\common\segment\dml\union\UnionSegment.java,18,16,0,3,2,21
 shardingsphere-master\shardingsphere-master\shardingsphere-features\shardingsphere-db-discovery\shardingsphere-db-discovery-core\src\test\java\org\apache\shardingsphere\dbdiscovery\yaml\swapper\DatabaseDiscoveryRuleAlgorithmProviderConfigurationYamlSwapperTest.java,0,31,0,23,0,54
 shardingsphere-master\shardingsphere-master\shardingsphere-features\shardingsphere-encrypt\shardingsphere-encrypt-core\src\test\java\org\apache\shardingsphere\encrypt\rewrite\pojo\EncryptLiteralAssignmentTokenTest.java,0,4,0,3,0,7
 shardingsphere-master\shardingsphere-master\shardingsphere-sql-parser\shardingsphere-sql-parser-spi\src\main\java\org\apache\shardingsphere\sql\parser\spi\SQLVisitorFacade.java,0,8,0,1,0,9
 shardingsphere-master\shardingsphere-master\examples\example-core\config-utility\src\main\java\org\apache\shardingsphere\example\algorithm\StandardModuloShardingTableAlgorithm.java,0,10,1,8,0,19
 shardingsphere-master\shardingsphere-master\shardingsphere-features\shardingsphere-sharding\shardingsphere-sharding-core\src\main\java\org\apache\shardingsphere\sharding\route\engine\validator\ddl\impl\ShardingDropIndexStatementValidator.java,0,21,0,21,0,42
 shardingsphere-master\shardingsphere-master\shardingsphere-test\shardingsphere-parser-test\src\main\java\org\apache\shardingsphere\test\sql\parser\parameterized\asserts\segment\distsql\AlgorithmAssert.java,0,8,0,9,0,17
 shardingsphere-master\shardingsphere-master\shardingsphere-infra\shardingsphere-infra-rewrite\src\test\java\org\apache\shardingsphere\infra\rewrite\sql\token\pojo\generic\ComposableSQLTokenTest.java,0,4,0,2,0,6
 shardingsphere-master\shardingsphere-master\shardingsphere-infra\shardingsphere-infra-binder\src\main\java\org\apache\shardingsphere\infra\binder\statement\dcl\RevokeStatementContext.java,0,7,0,6,0,13
 shardingsphere-master\shardingsphere-master\examples\shardingsphere-jdbc-example\single-feature-example\extension-example\custom-sharding-algortihm-example\spi-based-sharding-algorithm-example\spi-based-sharding-spring-namespace-jpa-example\src\main\java\org\apache\shardingsphere\example\extension\spibased\sharding\spring\namespace\jpa\SPIBasedShardingSpringNamespaceJpaExample.java,0,11,1,7,0,19
 shardingsphere-master\shardingsphere-master\shardingsphere-test\shardingsphere-rewrite-test\src\test\java\org\apache\shardingsphere\sharding\rewrite\fixture\QueryAssistedEncryptAlgorithmFixture.java,0,9,1,5,0,15
 shardingsphere-master\shardingsphere-master\shardingsphere-db-protocol\shardingsphere-db-protocol-postgresql\src\main\java\org\apache\shardingsphere\db\protocol\postgresql\packet\command\query\extended\execute\PostgreSQLPortalSuspendedPacket.java,0,3,1,7,0,11
 shardingsphere-master\shardingsphere-master\shardingsphere-test\shardingsphere-parser-test\src\main\java\org\apache\shardingsphere\test\sql\parser\parameterized\asserts\statement\distsql\rdl\drop\impl\DropDefaultSingleTableRuleAssert.java,0,9,0,12,0,21
 shardingsphere-master\shardingsphere-master\shardingsphere-sql-parser\shardingsphere-sql-parser-statement\src\main\java\org\apache\shardingsphere\sql\parser\sql\dialect\statement\postgresql\ddl\PostgreSQLDropTableStatement.java,0,3,0,5,0,8
 shardingsphere-master\shardingsphere-master\shardingsphere-features\shardingsphere-sharding\shardingsphere-sharding-core\src\test\java\org\apache\shardingsphere\sharding\swapper\ShardingRuleConfigurationYamlSwapperTest.java,0,60,1,52,0,113
 shardingsphere-master\shardingsphere-master\shardingsphere-sql-parser\shardingsphere-sql-parser-statement\src\main\java\org\apache\shardingsphere\sql\parser\sql\common\statement\ddl\AlterSequenceStatement.java,5,2,1,3,0,6
 shardingsphere-master\shardingsphere-master\shardingsphere-test\shardingsphere-integration-test\shardingsphere-integration-test-suite\src\test\java\org\apache\shardingsphere\test\integration\cases\dataset\metadata\DataSetColumn.java,0,5,0,1,0,6
 shardingsphere-master\shardingsphere-master\shardingsphere-features\shardingsphere-shadow\shardingsphere-shadow-spring\shardingsphere-shadow-spring-namespace\src\main\java\org\apache\shardingsphere\shadow\spring\namespace\handler\ShadowNamespaceHandler.java,0,4,0,8,0,12
 shardingsphere-master\shardingsphere-master\shardingsphere-infra\shardingsphere-infra-merge\src\main\java\org\apache\shardingsphere\infra\merge\engine\decorator\impl\TransparentRule.java,0,1,0,1,0,2
 shardingsphere-master\shardingsphere-master\shardingsphere-test\shardingsphere-parser-test\src\main\java\org\apache\shardingsphere\test\sql\parser\parameterized\jaxb\cases\domain\segment\impl\index\ExpectedLoadTableIndex.java,0,7,0,5,0,12
 shardingsphere-master\shardingsphere-master\shardingsphere-jdbc\shardingsphere-jdbc-core\src\test\java\org\apache\shardingsphere\driver\jdbc\core\resultset\DatabaseMetaDataResultSetTest.java,0,228,5,54,0,287
 shardingsphere-master\shardingsphere-master\shardingsphere-distsql\shardingsphere-distsql-statement\src\main\java\org\apache\shardingsphere\distsql\parser\statement\rql\show\ShowRulesStatement.java,10,4,0,4,0,8
 shardingsphere-master\shardingsphere-master\shardingsphere-db-protocol\shardingsphere-db-protocol-mysql\src\test\java\org\apache\shardingsphere\db\protocol\mysql\packet\command\query\binary\execute\protocol\MySQLStringLenencBinaryProtocolValueTest.java,0,10,0,4,0,14
 shardingsphere-master\shardingsphere-master\shardingsphere-test\shardingsphere-integration-test\shardingsphere-integration-test-suite\src\test\java\org\apache\shardingsphere\test\integration\framework\param\array\ParameterizedArrayGenerator.java,0,59,0,46,0,105
 shardingsphere-master\shardingsphere-master\shardingsphere-proxy\shardingsphere-proxy-frontend\shardingsphere-proxy-frontend-mysql\src\main\java\org\apache\shardingsphere\proxy\frontend\mysql\command\MySQLCommandExecuteEngine.java,0,21,0,23,0,44
 shardingsphere-master\shardingsphere-master\shardingsphere-test\shardingsphere-parser-test\src\main\java\org\apache\shardingsphere\test\sql\parser\parameterized\asserts\statement\dcl\impl\CreateLoginStatementAssert.java,0,8,0,11,0,19
 shardingsphere-master\shardingsphere-master\shardingsphere-infra\shardingsphere-infra-federation\shardingsphere-infra-federation-executor\src\main\java\org\apache\shardingsphere\infra\federation\executor\original\table\FilterableTableScanExecutorContext.java,0,8,0,1,0,9
 shardingsphere-master\shardingsphere-master\examples\example-core\example-spring-jpa\src\main\java\org\apache\shardingsphere\example\core\jpa\entity\OrderItemEntity.java,0,5,0,1,0,6
 shardingsphere-master\shardingsphere-master\shardingsphere-infra\shardingsphere-infra-federation\shardingsphere-infra-federation-executor\src\main\java\org\apache\shardingsphere\infra\federation\executor\original\table\FilterableTable.java,0,13,0,6,0,19
 shardingsphere-master\shardingsphere-master\shardingsphere-features\shardingsphere-db-discovery\shardingsphere-db-discovery-distsql\shardingsphere-db-discovery-distsql-handler\src\main\java\org\apache\shardingsphere\dbdiscovery\distsql\handler\update\CreateDatabaseDiscoveryHeartbeatStatementUpdater.java,0,26,0,24,0,50
 shardingsphere-master\shardingsphere-master\shardingsphere-kernel\shardingsphere-authority\shardingsphere-authority-core\src\main\java\org\apache\shardingsphere\authority\provider\natived\builder\dialect\PostgreSQLPrivilegeHandler.java,0,77,0,54,0,131
 shardingsphere-master\shardingsphere-master\shardingsphere-infra\shardingsphere-infra-common\src\main\java\org\apache\shardingsphere\infra\rule\identifier\type\DataNodeContainedRule.java,0,13,0,3,0,16
 shardingsphere-master\shardingsphere-master\shardingsphere-mode\shardingsphere-mode-type\shardingsphere-standalone-mode\shardingsphere-standalone-mode-repository\shardingsphere-standalone-mode-repository-provider\shardingsphere-standalone-mode-repository-file\src\main\java\org\apache\shardingsphere\mode\repository\standalone\file\FileRepositoryProperties.java,0,3,0,2,0,5
 shardingsphere-master\shardingsphere-master\shardingsphere-infra\shardingsphere-infra-common\src\main\java\org\apache\shardingsphere\infra\metadata\schema\loader\common\TableMetaDataLoader.java,0,10,0,9,0,19
 shardingsphere-master\shardingsphere-master\shardingsphere-proxy\shardingsphere-proxy-backend\src\test\java\org\apache\shardingsphere\proxy\backend\util\SystemPropertyUtilTest.java,0,7,0,3,0,10
 shardingsphere-master\shardingsphere-master\shardingsphere-sql-parser\shardingsphere-sql-parser-statement\src\main\java\org\apache\shardingsphere\sql\parser\sql\dialect\statement\mysql\dal\MySQLBinlogStatement.java,0,3,0,5,0,8
 shardingsphere-master\shardingsphere-master\shardingsphere-kernel\shardingsphere-authority\shardingsphere-authority-core\src\main\java\org\apache\shardingsphere\authority\provider\natived\builder\StoragePrivilegeBuilder.java,0,53,0,37,0,90
 shardingsphere-master\shardingsphere-master\shardingsphere-proxy\shardingsphere-proxy-frontend\shardingsphere-proxy-frontend-postgresql\src\main\java\org\apache\shardingsphere\proxy\frontend\postgresql\authentication\PostgreSQLAuthenticationHandler.java,0,17,0,19,0,36
 shardingsphere-master\shardingsphere-master\shardingsphere-test\shardingsphere-parser-test\src\main\java\org\apache\shardingsphere\test\sql\parser\parameterized\asserts\statement\distsql\ral\impl\common\updatable\AlterInstanceStatementAssert.java,0,6,0,8,0,14
 shardingsphere-master\shardingsphere-master\shardingsphere-test\shardingsphere-parser-test\src\main\java\org\apache\shardingsphere\test\sql\parser\parameterized\asserts\statement\distsql\rdl\create\impl\CreateShardingBindingTableRulesStatementAssert.java,0,18,0,23,0,41
 shardingsphere-master\shardingsphere-master\shardingsphere-kernel\shardingsphere-data-pipeline\shardingsphere-data-pipeline-core\src\main\java\org\apache\shardingsphere\data\pipeline\core\exception\PipelineJobPrepareFailedException.java,0,6,0,2,0,8
 shardingsphere-master\shardingsphere-master\shardingsphere-features\shardingsphere-db-discovery\shardingsphere-db-discovery-distsql\shardingsphere-db-discovery-distsql-parser\src\main\java\org\apache\shardingsphere\dbdiscovery\distsql\parser\core\DatabaseDiscoveryDistSQLParser.java,0,5,0,4,0,9
 shardingsphere-master\shardingsphere-master\shardingsphere-test\shardingsphere-parser-test\src\main\java\org\apache\shardingsphere\test\sql\parser\parameterized\jaxb\cases\domain\statement\ddl\AlterTextSearchStatementTestCase.java,0,0,0,3,0,3
 shardingsphere-master\shardingsphere-master\shardingsphere-test\shardingsphere-parser-test\src\main\java\org\apache\shardingsphere\test\sql\parser\parameterized\asserts\segment\model\ModelClauseAssert.java,0,27,0,35,0,62
 shardingsphere-master\shardingsphere-master\shardingsphere-agent\shardingsphere-agent-plugins\shardingsphere-agent-plugin-metrics\shardingsphere-agent-metrics-prometheus\src\test\java\org\apache\shardingsphere\agent\metrics\prometheus\collector\MetaDataInfoCollectorTest.java,0,2,0,1,0,3
 shardingsphere-master\shardingsphere-master\shardingsphere-features\shardingsphere-db-discovery\shardingsphere-db-discovery-distsql\shardingsphere-db-discovery-distsql-statement\src\main\java\org\apache\shardingsphere\dbdiscovery\distsql\parser\segment\DatabaseDiscoveryTypeSegment.java,0,4,0,1,0,5
 shardingsphere-master\shardingsphere-master\shardingsphere-sql-parser\shardingsphere-sql-parser-statement\src\main\java\org\apache\shardingsphere\sql\parser\sql\dialect\statement\mysql\dal\MySQLShowTriggersStatement.java,0,7,0,7,1,15
 shardingsphere-master\shardingsphere-master\shardingsphere-features\shardingsphere-db-discovery\shardingsphere-db-discovery-distsql\shardingsphere-db-discovery-distsql-handler\src\main\java\org\apache\shardingsphere\dbdiscovery\distsql\handler\update\CreateDatabaseDiscoveryTypeStatementUpdater.java,0,33,0,30,0,63
 shardingsphere-master\shardingsphere-master\shardingsphere-test\shardingsphere-integration-test\shardingsphere-integration-test-suite\src\test\java\org\apache\shardingsphere\test\integration\engine\rdl\GeneralRDLIT.java,0,7,0,6,0,13
 shardingsphere-master\shardingsphere-master\shardingsphere-sql-parser\shardingsphere-sql-parser-statement\src\main\java\org\apache\shardingsphere\sql\parser\sql\dialect\statement\mysql\dal\MySQLShowCreateViewStatement.java,0,3,0,5,0,8
 shardingsphere-master\shardingsphere-master\shardingsphere-spi\src\main\java\org\apache\shardingsphere\spi\exception\ShardingSphereSPIException.java,13,6,0,2,0,8
 shardingsphere-master\shardingsphere-master\shardingsphere-test\shardingsphere-parser-test\src\main\java\org\apache\shardingsphere\test\sql\parser\parameterized\jaxb\cases\domain\statement\distsql\rdl\alter\AlterShardingBindingTableRulesStatementTestCase.java,0,4,0,6,0,10
 shardingsphere-master\shardingsphere-master\shardingsphere-sql-parser\shardingsphere-sql-parser-statement\src\main\java\org\apache\shardingsphere\sql\parser\sql\dialect\statement\mysql\ddl\MySQLDropDatabaseStatement.java,0,1,0,4,0,5
 shardingsphere-master\shardingsphere-master\shardingsphere-test\shardingsphere-parser-test\src\main\java\org\apache\shardingsphere\test\sql\parser\parameterized\jaxb\cases\domain\statement\distsql\rql\ShowShardingAlgorithmsStatementTestCase.java,0,3,0,5,0,8
 shardingsphere-master\shardingsphere-master\shardingsphere-db-protocol\shardingsphere-db-protocol-mysql\src\test\java\org\apache\shardingsphere\db\protocol\mysql\packet\binlog\row\column\value\time\MySQLTimestampBinlogProtocolValueTest.java,0,13,1,6,0,20
 shardingsphere-master\shardingsphere-master\shardingsphere-db-protocol\shardingsphere-db-protocol-mysql\src\test\java\org\apache\shardingsphere\db\protocol\mysql\packet\handshake\MySQLAuthSwitchRequestPacketTest.java,0,11,0,3,0,14
 shardingsphere-master\shardingsphere-master\shardingsphere-test\shardingsphere-parser-test\src\main\java\org\apache\shardingsphere\test\sql\parser\parameterized\jaxb\cases\domain\segment\impl\projection\impl\subquery\ExpectedSubqueryProjection.java,0,10,0,6,0,16
 shardingsphere-master\shardingsphere-master\examples\shardingsphere-proxy-example\shardingsphere-proxy-hint-example\src\main\java\org\apache\shardingsphere\example\proxy\hint\config\DatasourceConfiguration.java,0,29,0,1,0,30
 shardingsphere-master\shardingsphere-master\shardingsphere-kernel\shardingsphere-data-pipeline\shardingsphere-data-pipeline-spi\src\main\java\org\apache\shardingsphere\data\pipeline\api\ingest\position\PrimaryKeyPosition.java,0,10,0,4,0,14
 shardingsphere-master\shardingsphere-master\shardingsphere-test\shardingsphere-parser-test\src\main\java\org\apache\shardingsphere\test\sql\parser\parameterized\jaxb\cases\domain\statement\dal\BinlogStatementTestCase.java,0,2,0,3,0,5
 shardingsphere-master\shardingsphere-master\shardingsphere-sql-parser\shardingsphere-sql-parser-statement\src\main\java\org\apache\shardingsphere\sql\parser\sql\dialect\statement\mysql\dcl\MySQLDropRoleStatement.java,0,1,0,4,0,5
 shardingsphere-master\shardingsphere-master\shardingsphere-test\shardingsphere-parser-test\src\main\java\org\apache\shardingsphere\test\sql\parser\parameterized\jaxb\cases\domain\statement\distsql\rdl\drop\DropShardingScalingRuleStatementTestCase.java,0,2,0,4,0,6
 shardingsphere-master\shardingsphere-master\shardingsphere-features\shardingsphere-sharding\shardingsphere-sharding-distsql\shardingsphere-sharding-distsql-handler\src\main\java\org\apache\shardingsphere\sharding\distsql\handler\update\AlterShardingBroadcastTableRuleStatementUpdater.java,0,19,0,15,0,34
 shardingsphere-master\shardingsphere-master\shardingsphere-spi\src\test\java\org\apache\shardingsphere\spi\fixture\FixtureCustomInterfaceImpl.java,0,1,0,2,0,3
 shardingsphere-master\shardingsphere-master\shardingsphere-test\shardingsphere-parser-test\src\main\java\org\apache\shardingsphere\test\sql\parser\parameterized\jaxb\cases\domain\statement\distsql\ral\LabelInstanceStatementTestCase.java,0,8,0,3,0,11
 shardingsphere-master\shardingsphere-master\shardingsphere-jdbc\shardingsphere-jdbc-core\src\test\java\org\apache\shardingsphere\driver\jdbc\core\datasource\ShardingSphereDataSourceTest.java,0,59,2,33,0,94
 shardingsphere-master\shardingsphere-master\shardingsphere-features\shardingsphere-sharding\shardingsphere-sharding-core\src\main\java\org\apache\shardingsphere\sharding\route\strategy\type\none\NoneShardingStrategy.java,0,7,0,4,0,11
 shardingsphere-master\shardingsphere-master\shardingsphere-jdbc\shardingsphere-jdbc-spring\shardingsphere-jdbc-core-spring\shardingsphere-jdbc-core-spring-namespace\src\test\java\org\apache\shardingsphere\spring\namespace\AbstractSpringNamespaceTest.java,86,36,0,17,0,53
 shardingsphere-master\shardingsphere-master\shardingsphere-sql-parser\shardingsphere-sql-parser-statement\src\main\java\org\apache\shardingsphere\sql\parser\sql\dialect\statement\oracle\dcl\OracleAlterRoleStatement.java,0,2,0,4,0,6
 shardingsphere-master\shardingsphere-master\shardingsphere-infra\shardingsphere-infra-common\src\test\java\org\apache\shardingsphere\infra\datasource\pool\creator\DataSourcePoolCreatorTest.java,0,12,0,5,0,17
 shardingsphere-master\shardingsphere-master\shardingsphere-features\shardingsphere-encrypt\shardingsphere-encrypt-core\src\main\java\org\apache\shardingsphere\encrypt\yaml\swapper\EncryptRuleAlgorithmProviderConfigurationYamlSwapper.java,0,21,0,20,0,41
 shardingsphere-master\shardingsphere-master\shardingsphere-db-protocol\shardingsphere-db-protocol-postgresql\src\main\java\org\apache\shardingsphere\db\protocol\postgresql\packet\generic\PostgreSQLReadyForQueryPacket.java,0,15,0,7,0,22
 shardingsphere-master\shardingsphere-master\shardingsphere-kernel\shardingsphere-single-table\shardingsphere-single-table-core\src\test\java\org\apache\shardingsphere\singletable\rule\SingleTableRuleTest.java,0,137,3,78,0,218
 shardingsphere-master\shardingsphere-master\shardingsphere-mode\shardingsphere-mode-core\src\test\java\org\apache\shardingsphere\mode\metadata\persist\fixture\RuleConfigurationFixture.java,0,4,0,3,0,7
 shardingsphere-master\shardingsphere-master\shardingsphere-db-protocol\shardingsphere-db-protocol-mysql\src\main\java\org\apache\shardingsphere\db\protocol\mysql\constant\MySQLCharacterSet.java,0,285,1,5,0,291
 shardingsphere-master\shardingsphere-master\shardingsphere-proxy\shardingsphere-proxy-frontend\shardingsphere-proxy-frontend-reactive-mysql\src\main\java\org\apache\shardingsphere\proxy\frontend\reactive\mysql\command\query\binary\execute\ReactiveMySQLComStmtExecuteExecutor.java,0,49,1,44,0,94
 shardingsphere-master\shardingsphere-master\shardingsphere-features\shardingsphere-encrypt\shardingsphere-encrypt-core\src\main\java\org\apache\shardingsphere\encrypt\merge\dql\EncryptAlgorithmMetaData.java,0,28,0,16,0,44
 shardingsphere-master\shardingsphere-master\shardingsphere-features\shardingsphere-shadow\shardingsphere-shadow-api\src\main\java\org\apache\shardingsphere\shadow\api\shadow\column\PreciseColumnShadowValue.java,0,9,0,2,0,11
 shardingsphere-master\shardingsphere-master\shardingsphere-infra\shardingsphere-infra-common\src\main\java\org\apache\shardingsphere\infra\datasource\props\InvalidDataSourcePropertiesException.java,0,5,0,3,0,8
 shardingsphere-master\shardingsphere-master\shardingsphere-proxy\shardingsphere-proxy-frontend\shardingsphere-proxy-frontend-core\src\main\java\org\apache\shardingsphere\proxy\frontend\ShardingSphereProxy.java,0,29,1,16,0,46
 shardingsphere-master\shardingsphere-master\shardingsphere-test\shardingsphere-parser-test\src\main\java\org\apache\shardingsphere\test\sql\parser\parameterized\jaxb\cases\domain\statement\distsql\rdl\alter\EnableShardingScalingRuleStatementTestCase.java,0,2,0,4,0,6
 shardingsphere-master\shardingsphere-master\shardingsphere-infra\shardingsphere-infra-common\src\test\java\org\apache\shardingsphere\infra\metadata\schema\loader\dialect\SQLServerTableMetaDataLoaderTest.java,0,43,8,29,0,80
 shardingsphere-master\shardingsphere-master\shardingsphere-features\shardingsphere-sharding\shardingsphere-sharding-core\src\main\java\org\apache\shardingsphere\sharding\route\strategy\type\complex\ComplexShardingStrategy.java,0,22,0,18,0,40
 shardingsphere-master\shardingsphere-master\shardingsphere-test\shardingsphere-rewrite-test\src\test\java\org\apache\shardingsphere\sharding\rewrite\parameterized\scenario\ShardingSQLRewriterParameterizedTest.java,0,29,6,22,0,57
 shardingsphere-master\shardingsphere-master\shardingsphere-proxy\shardingsphere-proxy-backend\src\main\java\org\apache\shardingsphere\proxy\backend\text\encoding\DatabaseSetCharsetBackendHandler.java,17,10,0,6,0,16
 shardingsphere-master\shardingsphere-master\examples\other-example\shardingsphere-parser-example\src\main\java\org\apache\shardingsphere\example\parser\sql92\statement\SQL92ParserStatementExample.java,0,33,1,10,0,44
 shardingsphere-master\shardingsphere-master\shardingsphere-kernel\shardingsphere-data-pipeline\shardingsphere-data-pipeline-dialect\shardingsphere-data-pipeline-postgresql\src\test\java\org\apache\shardingsphere\data\pipeline\postgresql\PostgreSQLScalingEntryTest.java,0,8,0,9,0,17
 shardingsphere-master\shardingsphere-master\shardingsphere-features\shardingsphere-sharding\shardingsphere-sharding-core\src\test\java\org\apache\shardingsphere\sharding\swapper\rule\ShardingAutoTableRuleConfigurationYamlSwapperTest.java,0,30,1,25,0,56
 shardingsphere-master\shardingsphere-master\shardingsphere-sql-parser\shardingsphere-sql-parser-statement\src\main\java\org\apache\shardingsphere\sql\parser\sql\dialect\statement\mysql\ddl\MySQLDropTablespaceStatement.java,0,1,0,4,0,5
 shardingsphere-master\shardingsphere-master\shardingsphere-proxy\shardingsphere-proxy-frontend\shardingsphere-proxy-frontend-mysql\src\test\java\org\apache\shardingsphere\proxy\frontend\mysql\command\query\text\query\MySQLComQueryPacketExecutorTest.java,0,53,0,39,0,92
 shardingsphere-master\shardingsphere-master\shardingsphere-test\shardingsphere-parser-test\src\main\java\org\apache\shardingsphere\test\sql\parser\parameterized\jaxb\cases\domain\statement\ddl\CreateFunctionStatementTestCase.java,0,0,0,3,0,3
 shardingsphere-master\shardingsphere-master\shardingsphere-features\shardingsphere-encrypt\shardingsphere-encrypt-core\src\test\java\org\apache\shardingsphere\encrypt\algorithm\SM3EncryptAlgorithmTest.java,0,28,0,14,0,42
 shardingsphere-master\shardingsphere-master\shardingsphere-sql-parser\shardingsphere-sql-parser-statement\src\main\java\org\apache\shardingsphere\sql\parser\sql\common\statement\ddl\DropDomainStatement.java,3,1,1,3,0,5
 shardingsphere-master\shardingsphere-master\shardingsphere-infra\shardingsphere-infra-federation\shardingsphere-infra-federation-optimizer\src\main\java\org\apache\shardingsphere\infra\federation\optimizer\converter\segment\projection\DistinctConverter.java,0,7,0,8,0,15
 shardingsphere-master\shardingsphere-master\shardingsphere-sql-parser\shardingsphere-sql-parser-dialect\shardingsphere-sql-parser-sql92\src\main\java\org\apache\shardingsphere\sql\parser\sql92\visitor\statement\impl\SQL92StatementSQLVisitor.java,439,125,3,143,0,271
 shardingsphere-master\shardingsphere-master\shardingsphere-proxy\shardingsphere-proxy-backend\src\test\java\org\apache\shardingsphere\proxy\backend\communication\jdbc\datasource\fixture\CallTimeRecordDataSource.java,0,83,21,16,0,120
 shardingsphere-master\shardingsphere-master\shardingsphere-db-protocol\shardingsphere-db-protocol-mysql\src\test\java\org\apache\shardingsphere\db\protocol\mysql\packet\handshake\MySQLAuthSwitchResponsePacketTest.java,0,10,0,3,0,13
 shardingsphere-master\shardingsphere-master\shardingsphere-features\shardingsphere-readwrite-splitting\shardingsphere-readwrite-splitting-core\src\main\java\org\apache\shardingsphere\readwritesplitting\yaml\config\YamlReadwriteSplittingRuleConfiguration.java,0,10,0,8,0,18
 shardingsphere-master\shardingsphere-master\shardingsphere-features\shardingsphere-readwrite-splitting\shardingsphere-readwrite-splitting-core\src\main\java\org\apache\shardingsphere\readwritesplitting\algorithm\loadbalance\RandomReplicaLoadBalanceAlgorithm.java,0,8,0,5,0,13
 shardingsphere-master\shardingsphere-master\shardingsphere-distsql\shardingsphere-distsql-statement\src\main\java\org\apache\shardingsphere\distsql\parser\statement\ral\scaling\QueryableScalingRALStatement.java,3,1,1,1,0,3
 shardingsphere-master\shardingsphere-master\shardingsphere-test\shardingsphere-integration-agent-test\shardingsphere-integration-agent-test-plugins\shardingsphere-integration-agent-test-common\src\test\java\org\apache\shardingsphere\integration\agent\test\common\env\IntegrationTestEnvironment.java,0,22,0,7,0,29
 shardingsphere-master\shardingsphere-master\shardingsphere-test\shardingsphere-parser-test\src\main\java\org\apache\shardingsphere\test\sql\parser\parameterized\jaxb\cases\domain\statement\distsql\ral\AddShardingHintTableValueStatementTestCase.java,0,1,0,4,0,5
 shardingsphere-master\shardingsphere-master\shardingsphere-mode\shardingsphere-mode-type\shardingsphere-cluster-mode\shardingsphere-cluster-mode-core\src\main\java\org\apache\shardingsphere\mode\manager\cluster\coordinator\registry\process\event\ShowProcessListRequestEvent.java,0,0,0,2,0,2
 shardingsphere-master\shardingsphere-master\shardingsphere-sql-parser\shardingsphere-sql-parser-statement\src\main\java\org\apache\shardingsphere\sql\parser\sql\dialect\statement\oracle\tcl\OracleSetConstraintsStatement.java,0,1,0,4,0,5
 shardingsphere-master\shardingsphere-master\shardingsphere-jdbc\shardingsphere-jdbc-core\src\main\java\org\apache\shardingsphere\driver\jdbc\core\resultset\ShardingSphereResultSetMetaData.java,0,41,0,19,0,60
 shardingsphere-master\shardingsphere-master\shardingsphere-proxy\shardingsphere-proxy-backend\src\test\java\org\apache\shardingsphere\proxy\backend\text\distsql\rdl\resource\AddResourceBackendHandlerTest.java,0,36,1,18,0,55
 shardingsphere-master\shardingsphere-master\shardingsphere-kernel\shardingsphere-transaction\shardingsphere-transaction-type\shardingsphere-transaction-base\shardingsphere-transaction-base-seata-at\src\test\java\org\apache\shardingsphere\transaction\base\seata\at\fixture\MockMessageHandler.java,0,22,1,11,0,34
 shardingsphere-master\shardingsphere-master\shardingsphere-kernel\shardingsphere-data-pipeline\shardingsphere-data-pipeline-dialect\shardingsphere-data-pipeline-mysql\src\test\java\org\apache\shardingsphere\data\pipeline\mysql\ingest\client\netty\MySQLCommandPacketDecoderTest.java,0,39,0,20,0,59
 shardingsphere-master\shardingsphere-master\shardingsphere-sql-parser\shardingsphere-sql-parser-statement\src\main\java\org\apache\shardingsphere\sql\parser\sql\common\util\WhereExtractUtil.java,0,10,0,14,0,24
 shardingsphere-master\shardingsphere-master\shardingsphere-infra\shardingsphere-infra-common\src\test\java\org\apache\shardingsphere\infra\metadata\schema\util\IndexMetaDataUtilTest.java,0,16,0,6,0,22
 shardingsphere-master\shardingsphere-master\shardingsphere-features\shardingsphere-sharding\shardingsphere-sharding-distsql\shardingsphere-sharding-distsql-handler\src\test\java\org\apache\shardingsphere\sharding\distsql\query\ShardingBindingTableRuleQueryResultSetTest.java,0,9,0,10,0,19
 shardingsphere-master\shardingsphere-master\shardingsphere-proxy\shardingsphere-proxy-frontend\shardingsphere-proxy-frontend-postgresql\src\main\java\org\apache\shardingsphere\proxy\frontend\postgresql\command\query\extended\JDBCPortal.java,0,75,0,70,0,145
 shardingsphere-master\shardingsphere-master\shardingsphere-proxy\shardingsphere-proxy-backend\src\main\java\org\apache\shardingsphere\proxy\backend\response\header\query\impl\QueryHeader.java,0,24,0,1,0,25
 shardingsphere-master\shardingsphere-master\shardingsphere-infra\shardingsphere-infra-context\src\main\java\org\apache\shardingsphere\infra\context\refresher\type\CreateTableStatementSchemaRefresher.java,0,16,0,19,0,35
 shardingsphere-master\shardingsphere-master\shardingsphere-sql-parser\shardingsphere-sql-parser-statement\src\main\java\org\apache\shardingsphere\sql\parser\sql\dialect\statement\oracle\dml\OracleUpdateStatement.java,0,1,0,4,0,5
 shardingsphere-master\shardingsphere-master\shardingsphere-test\shardingsphere-parser-test\src\main\java\org\apache\shardingsphere\test\sql\parser\parameterized\asserts\statement\distsql\rql\impl\rule\ShowSingleTableRulesStatementAssert.java,0,7,0,11,0,18
 shardingsphere-master\shardingsphere-master\shardingsphere-distsql\shardingsphere-distsql-statement\src\main\java\org\apache\shardingsphere\distsql\parser\statement\rql\show\ShowUnusedResourcesStatement.java,0,4,0,4,0,8
 shardingsphere-master\shardingsphere-master\shardingsphere-jdbc\shardingsphere-jdbc-core\src\test\java\org\apache\shardingsphere\driver\executor\batch\BatchPreparedStatementExecutorTest.java,0,51,12,26,0,89
 shardingsphere-master\shardingsphere-master\examples\shardingsphere-jdbc-example\single-feature-example\shadow-example\shadow-spring-boot-mybatis-example\src\main\java\org\apache\shardingsphere\example\shadow\spring\boot\mybatis\ShadowSpringBootMybatisExample.java,9,7,1,5,0,13
 shardingsphere-master\shardingsphere-master\shardingsphere-test\shardingsphere-parser-test\src\main\java\org\apache\shardingsphere\test\sql\parser\parameterized\asserts\statement\distsql\ral\impl\scaling\query\ShowScalingListStatementAssert.java,0,6,1,9,0,16
 shardingsphere-master\shardingsphere-master\shardingsphere-proxy\shardingsphere-proxy-frontend\shardingsphere-proxy-frontend-spi\src\main\java\org\apache\shardingsphere\proxy\frontend\command\CommandExecuteEngine.java,0,11,0,7,0,18
 shardingsphere-master\shardingsphere-master\shardingsphere-proxy\shardingsphere-proxy-backend\src\test\java\org\apache\shardingsphere\proxy\backend\text\distsql\rql\RQLBackendHandlerTest.java,0,22,0,17,0,39
 shardingsphere-master\shardingsphere-master\shardingsphere-kernel\shardingsphere-traffic\shardingsphere-traffic-core\src\main\java\org\apache\shardingsphere\traffic\algorithm\traffic\transaction\ProxyTrafficAlgorithm.java,0,5,1,5,0,11
 shardingsphere-master\shardingsphere-master\shardingsphere-test\shardingsphere-parser-test\src\main\java\org\apache\shardingsphere\test\sql\parser\parameterized\jaxb\cases\domain\segment\impl\projection\impl\aggregation\ExpectedAggregationProjection.java,12,7,0,5,0,12
 shardingsphere-master\shardingsphere-master\shardingsphere-test\shardingsphere-parser-test\src\main\java\org\apache\shardingsphere\test\sql\parser\parameterized\jaxb\cases\domain\segment\impl\packages\ExpectedPackage.java,0,3,0,5,0,8
 shardingsphere-master\shardingsphere-master\shardingsphere-sql-parser\shardingsphere-sql-parser-statement\src\main\java\org\apache\shardingsphere\sql\parser\sql\dialect\statement\mysql\dal\MySQLDelimiterStatement.java,0,2,0,5,0,7
 shardingsphere-master\shardingsphere-master\examples\shardingsphere-proxy-example\shardingsphere-proxy-hint-example\src\main\java\org\apache\shardingsphere\example\proxy\hint\factory\YamlDataSourceFactory.java,0,6,1,4,0,11
 shardingsphere-master\shardingsphere-master\shardingsphere-sql-parser\shardingsphere-sql-parser-statement\src\main\java\org\apache\shardingsphere\sql\parser\sql\dialect\statement\postgresql\dcl\PostgreSQLGrantStatement.java,0,1,0,5,0,6
 shardingsphere-master\shardingsphere-master\shardingsphere-test\shardingsphere-parser-test\src\main\java\org\apache\shardingsphere\test\sql\parser\parameterized\asserts\statement\distsql\rdl\alter\impl\AlterShardingTableRuleStatementAssert.java,0,23,0,32,0,55
 shardingsphere-master\shardingsphere-master\shardingsphere-sql-parser\shardingsphere-sql-parser-statement\src\main\java\org\apache\shardingsphere\sql\parser\sql\dialect\statement\mysql\dal\MySQLShowCharacterSetStatement.java,0,4,0,6,1,11
 shardingsphere-master\shardingsphere-master\shardingsphere-agent\shardingsphere-agent-plugins\shardingsphere-agent-plugin-tracing\shardingsphere-agent-tracing-opentracing\src\main\java\org\apache\shardingsphere\agent\plugin\tracing\opentracing\definition\OpenTracingPluginDefinitionService.java,0,34,0,13,0,47
 shardingsphere-master\shardingsphere-master\shardingsphere-proxy\shardingsphere-proxy-frontend\shardingsphere-proxy-frontend-postgresql\src\test\java\org\apache\shardingsphere\proxy\frontend\postgresql\command\query\PostgreSQLCommandTest.java,0,151,0,116,0,267
 shardingsphere-master\shardingsphere-master\shardingsphere-proxy\shardingsphere-proxy-backend\src\main\java\org\apache\shardingsphere\proxy\backend\text\distsql\ral\common\updatable\DropTrafficRuleHandler.java,0,28,0,29,0,57
 shardingsphere-master\shardingsphere-master\shardingsphere-db-protocol\shardingsphere-db-protocol-mysql\src\main\java\org\apache\shardingsphere\db\protocol\mysql\packet\generic\MySQLOKPacket.java,0,32,0,6,0,38
 shardingsphere-master\shardingsphere-master\shardingsphere-features\shardingsphere-shadow\shardingsphere-shadow-distsql\shardingsphere-shadow-distsql-handler\src\test\java\org\apache\shardingsphere\shadow\distsql\query\ShadowTableRuleQueryResultSetTest.java,0,8,0,10,0,18
 shardingsphere-master\shardingsphere-master\shardingsphere-test\shardingsphere-parser-test\src\main\java\org\apache\shardingsphere\test\sql\parser\parameterized\jaxb\cases\domain\statement\distsql\ral\scaling\RestoreScalingSourceWritingStatementTestCase.java,0,3,0,4,0,7
 shardingsphere-master\shardingsphere-master\shardingsphere-test\shardingsphere-parser-test\src\main\java\org\apache\shardingsphere\test\sql\parser\parameterized\jaxb\cases\domain\statement\dcl\RenameUserStatementTestCase.java,0,0,0,3,0,3
 shardingsphere-master\shardingsphere-master\shardingsphere-infra\shardingsphere-infra-common\src\main\java\org\apache\shardingsphere\infra\config\algorithm\ShardingSphereAlgorithmFactory.java,0,5,0,3,0,8
 shardingsphere-master\shardingsphere-master\shardingsphere-kernel\shardingsphere-single-table\shardingsphere-single-table-core\src\main\java\org\apache\shardingsphere\singletable\yaml\config\swapper\SingleTableRuleConfigurationYamlSwapper.java,0,11,0,9,0,20
 shardingsphere-master\shardingsphere-master\shardingsphere-test\shardingsphere-parser-test\src\main\java\org\apache\shardingsphere\test\sql\parser\parameterized\jaxb\cases\domain\statement\distsql\ral\scaling\ApplyScalingStatementTestCase.java,0,3,0,3,0,6
 shardingsphere-master\shardingsphere-master\shardingsphere-mode\shardingsphere-mode-type\shardingsphere-cluster-mode\shardingsphere-cluster-mode-core\src\main\java\org\apache\shardingsphere\mode\manager\cluster\coordinator\lock\util\LockNodeUtil.java,0,7,0,2,0,9
 shardingsphere-master\shardingsphere-master\shardingsphere-db-protocol\shardingsphere-db-protocol-postgresql\src\main\java\org\apache\shardingsphere\db\protocol\postgresql\codec\PostgreSQLPacketCodecEngine.java,0,45,0,27,0,72
 shardingsphere-master\shardingsphere-master\shardingsphere-infra\shardingsphere-infra-common\src\main\java\org\apache\shardingsphere\infra\config\exception\ShardingSphereConfigurationException.java,0,8,0,3,0,11
 shardingsphere-master\shardingsphere-master\shardingsphere-kernel\shardingsphere-transaction\shardingsphere-transaction-type\shardingsphere-transaction-base\shardingsphere-transaction-base-seata-at\src\test\java\org\apache\shardingsphere\transaction\base\seata\at\fixture\MockSeataServer.java,0,19,0,2,0,21
 shardingsphere-master\shardingsphere-master\shardingsphere-infra\shardingsphere-infra-common\src\main\java\org\apache\shardingsphere\infra\hint\SQLHintPropertiesKey.java,0,10,0,2,0,12
 shardingsphere-master\shardingsphere-master\shardingsphere-db-protocol\shardingsphere-db-protocol-postgresql\src\main\java\org\apache\shardingsphere\db\protocol\postgresql\packet\command\PostgreSQLCommandPacketFactory.java,0,10,0,19,0,29
 shardingsphere-master\shardingsphere-master\shardingsphere-proxy\shardingsphere-proxy-frontend\shardingsphere-proxy-frontend-postgresql\src\main\java\org\apache\shardingsphere\proxy\frontend\postgresql\command\generic\PostgreSQLUnsupportedCommandExecutor.java,0,4,0,8,0,12
 shardingsphere-master\shardingsphere-master\shardingsphere-db-protocol\shardingsphere-db-protocol-postgresql\src\main\java\org\apache\shardingsphere\db\protocol\postgresql\packet\command\query\extended\bind\protocol\PostgreSQLFloatBinaryProtocolValue.java,0,7,0,6,0,13
 shardingsphere-master\shardingsphere-master\shardingsphere-agent\shardingsphere-agent-plugins\shardingsphere-agent-plugin-metrics\shardingsphere-agent-metrics-api\src\main\java\org\apache\shardingsphere\agent\metrics\api\advice\ChannelHandlerAdvice.java,0,13,0,5,0,18
 shardingsphere-master\shardingsphere-master\shardingsphere-proxy\shardingsphere-proxy-frontend\shardingsphere-proxy-frontend-mysql\src\main\java\org\apache\shardingsphere\proxy\frontend\mysql\err\MySQLErrPacketFactory.java,0,33,0,50,0,83
 shardingsphere-master\shardingsphere-master\examples\shardingsphere-jdbc-example\single-feature-example\cluster-mode-example\cluster-mode-raw-jdbc-example\src\main\java\org\apache\shardingsphere\example\cluster\mode\raw\jdbc\config\local\LocalShardingDatabasesConfiguration.java,0,20,0,14,0,34
 shardingsphere-master\shardingsphere-master\shardingsphere-sql-parser\shardingsphere-sql-parser-statement\src\main\java\org\apache\shardingsphere\sql\parser\sql\dialect\statement\mysql\dal\MySQLShowSlaveStatusStatement.java,0,3,0,5,0,8
 shardingsphere-master\shardingsphere-master\shardingsphere-sql-parser\shardingsphere-sql-parser-statement\src\main\java\org\apache\shardingsphere\sql\parser\sql\dialect\statement\mysql\dal\MySQLShowProcedureStatusStatement.java,0,4,0,6,1,11
 shardingsphere-master\shardingsphere-master\shardingsphere-features\shardingsphere-readwrite-splitting\shardingsphere-readwrite-splitting-core\src\test\java\org\apache\shardingsphere\readwritesplitting\algorithm\loadbalance\RoundRobinReplicaLoadBalanceAlgorithmTest.java,0,13,1,8,0,22
 shardingsphere-master\shardingsphere-master\shardingsphere-test\shardingsphere-parser-test\src\main\java\org\apache\shardingsphere\test\sql\parser\parameterized\asserts\statement\dcl\impl\AlterLoginStatementAssert.java,0,9,0,11,0,20
 shardingsphere-master\shardingsphere-master\shardingsphere-sql-parser\shardingsphere-sql-parser-statement\src\main\java\org\apache\shardingsphere\sql\parser\sql\dialect\statement\oracle\ddl\OracleRenameStatement.java,0,1,0,4,0,5
 shardingsphere-master\shardingsphere-master\shardingsphere-infra\shardingsphere-infra-common\src\main\java\org\apache\shardingsphere\infra\rule\identifier\scope\SchemaRule.java,0,0,0,1,0,1
 shardingsphere-master\shardingsphere-master\shardingsphere-features\shardingsphere-shadow\shardingsphere-shadow-core\src\test\java\org\apache\shardingsphere\shadow\route\engine\dml\ShadowSelectStatementRoutingEngineTest.java,0,35,0,36,0,71
 shardingsphere-master\shardingsphere-master\shardingsphere-db-protocol\shardingsphere-db-protocol-postgresql\src\test\java\org\apache\shardingsphere\db\protocol\postgresql\packet\command\PostgreSQLCommandPacketFactoryTest.java,0,31,0,18,0,49
 shardingsphere-master\shardingsphere-master\shardingsphere-sql-parser\shardingsphere-sql-parser-dialect\shardingsphere-sql-parser-sql92\src\main\java\org\apache\shardingsphere\sql\parser\sql92\visitor\format\facade\SQL92FormatSQLVisitorFacade.java,0,9,0,1,0,10
 shardingsphere-master\shardingsphere-master\examples\shardingsphere-jdbc-example\mixed-feature-example\sharding-readwrite-splitting-example\sharding-readwrite-splitting-raw-jdbc-example\src\main\java\org\apache\shardingsphere\example\sharding\readwrite\splitting\raw\ShardingReadwriteSplittingRawYamlRangeConfigurationExample.java,0,9,1,6,0,16
 shardingsphere-master\shardingsphere-master\shardingsphere-test\shardingsphere-parser-test\src\main\java\org\apache\shardingsphere\test\sql\parser\parameterized\asserts\statement\distsql\rdl\create\impl\CreateEncryptRuleStatementAssert.java,0,16,0,20,0,36
 shardingsphere-master\shardingsphere-master\shardingsphere-proxy\shardingsphere-proxy-frontend\shardingsphere-proxy-frontend-core\src\test\java\org\apache\shardingsphere\proxy\frontend\state\impl\CircuitBreakProxyStateTest.java,0,8,0,7,0,15
 shardingsphere-master\shardingsphere-master\shardingsphere-test\shardingsphere-parser-test\src\main\java\org\apache\shardingsphere\test\sql\parser\parameterized\asserts\statement\distsql\rdl\drop\impl\DropDatabaseDiscoveryRuleStatementAssert.java,0,7,0,10,0,17
 shardingsphere-master\shardingsphere-master\shardingsphere-test\shardingsphere-parser-test\src\main\java\org\apache\shardingsphere\test\sql\parser\parameterized\jaxb\cases\domain\segment\impl\expr\complex\ExpectedBaseComplexExpression.java,6,4,1,4,0,9
 shardingsphere-master\shardingsphere-master\shardingsphere-infra\shardingsphere-infra-common\src\main\java\org\apache\shardingsphere\infra\config\algorithm\ShardingSphereAlgorithmConfiguration.java,0,4,0,3,0,7
 shardingsphere-master\shardingsphere-master\shardingsphere-agent\shardingsphere-agent-plugins\shardingsphere-agent-plugin-tracing\shardingsphere-agent-tracing-opentelemetry\src\test\java\org\apache\shardingsphere\agent\plugin\tracing\opentelemetry\advice\CommandExecutorTaskAdviceTest.java,0,15,0,13,0,28
 shardingsphere-master\shardingsphere-master\shardingsphere-kernel\shardingsphere-data-pipeline\shardingsphere-data-pipeline-dialect\shardingsphere-data-pipeline-opengauss\src\main\java\org\apache\shardingsphere\data\pipeline\opengauss\ingest\OpenGaussPositionInitializer.java,0,10,0,9,0,19
 shardingsphere-master\shardingsphere-master\shardingsphere-infra\shardingsphere-infra-common\src\main\java\org\apache\shardingsphere\infra\database\type\dialect\OpenGaussDatabaseType.java,0,13,1,9,0,23
 shardingsphere-master\shardingsphere-master\shardingsphere-proxy\shardingsphere-proxy-backend\src\main\java\org\apache\shardingsphere\proxy\backend\communication\jdbc\recognizer\JDBCDriverURLRecognizerEngine.java,0,16,0,11,0,27
 shardingsphere-master\shardingsphere-master\shardingsphere-test\shardingsphere-parser-test\src\main\java\org\apache\shardingsphere\test\sql\parser\parameterized\jaxb\cases\domain\statement\distsql\ral\ShowReadwriteSplittingHintStatusStatementTestCase.java,0,1,0,4,0,5
 shardingsphere-master\shardingsphere-master\shardingsphere-infra\shardingsphere-infra-common\src\test\java\org\apache\shardingsphere\infra\properties\fixture\TestTypedProperties.java,0,4,0,2,0,6
 shardingsphere-master\shardingsphere-master\shardingsphere-db-protocol\shardingsphere-db-protocol-mysql\src\main\java\org\apache\shardingsphere\db\protocol\mysql\packet\binlog\management\MySQLBinlogFormatDescriptionEventPacket.java,0,28,2,14,0,44
 shardingsphere-master\shardingsphere-master\shardingsphere-infra\shardingsphere-infra-binder\src\main\java\org\apache\shardingsphere\infra\binder\type\RemoveAvailable.java,0,1,0,1,0,2
 shardingsphere-master\shardingsphere-master\shardingsphere-test\shardingsphere-parser-test\src\main\java\org\apache\shardingsphere\test\sql\parser\parameterized\jaxb\cases\domain\segment\impl\like\ExpectedLikeClause.java,0,3,0,3,0,6
 shardingsphere-master\shardingsphere-master\examples\shardingsphere-jdbc-example\single-feature-example\cluster-mode-example\cluster-mode-spring-namespace-mybatis-example\src\main\java\org\apache\shardingsphere\example\cluster\mode\spring\namespace\mybatis\ClusterModeSpringNamespaceMybatisExample.java,0,19,5,10,0,34
 shardingsphere-master\shardingsphere-master\shardingsphere-test\shardingsphere-parser-test\src\main\java\org\apache\shardingsphere\test\sql\parser\parameterized\asserts\statement\dal\impl\ShowReplicasStatementAssert.java,0,3,1,6,0,10
 shardingsphere-master\shardingsphere-master\shardingsphere-test\shardingsphere-integration-test\shardingsphere-integration-test-suite\src\test\java\org\apache\shardingsphere\test\integration\engine\rql\GeneralRQLIT.java,0,7,0,6,0,13
 shardingsphere-master\shardingsphere-master\shardingsphere-kernel\shardingsphere-transaction\shardingsphere-transaction-type\shardingsphere-transaction-xa\shardingsphere-transaction-xa-core\src\main\java\org\apache\shardingsphere\transaction\xa\jta\connection\XAConnectionWrapper.java,0,3,0,2,0,5
 shardingsphere-master\shardingsphere-master\shardingsphere-sql-parser\shardingsphere-sql-parser-statement\src\main\java\org\apache\shardingsphere\sql\parser\sql\dialect\statement\sqlserver\dcl\SQLServerDenyUserStatement.java,0,5,0,8,3,16
 shardingsphere-master\shardingsphere-master\shardingsphere-features\shardingsphere-sharding\shardingsphere-sharding-core\src\main\java\org\apache\shardingsphere\sharding\rewrite\token\pojo\OrderByToken.java,0,9,0,3,0,12
 shardingsphere-master\shardingsphere-master\shardingsphere-test\shardingsphere-parser-test\src\main\java\org\apache\shardingsphere\test\sql\parser\parameterized\jaxb\cases\domain\segment\impl\expr\ExpectedExpression.java,0,31,0,12,0,43
 shardingsphere-master\shardingsphere-master\shardingsphere-sql-parser\shardingsphere-sql-parser-statement\src\main\java\org\apache\shardingsphere\sql\parser\sql\common\statement\tcl\SavepointStatement.java,5,3,1,3,0,7
 shardingsphere-master\shardingsphere-master\shardingsphere-features\shardingsphere-db-discovery\shardingsphere-db-discovery-core\src\test\java\org\apache\shardingsphere\dbdiscovery\fixture\TestDatabaseDiscoveryType.java,0,9,3,4,0,16
 shardingsphere-master\shardingsphere-master\shardingsphere-test\shardingsphere-integration-test\shardingsphere-integration-test-suite\src\test\java\org\apache\shardingsphere\test\integration\framework\container\compose\mode\ClusterComposedContainer.java,0,24,0,20,0,44
 shardingsphere-master\shardingsphere-master\shardingsphere-infra\shardingsphere-infra-common\src\main\java\org\apache\shardingsphere\infra\yaml\engine\constructor\ShardingSphereYamlConstructor.java,31,16,0,7,0,23
 shardingsphere-master\shardingsphere-master\shardingsphere-jdbc\shardingsphere-jdbc-core\src\main\java\org\apache\shardingsphere\driver\jdbc\unsupported\AbstractUnsupportedUpdateOperationResultSet.java,413,163,0,82,0,245
 shardingsphere-master\shardingsphere-master\shardingsphere-infra\shardingsphere-infra-merge\src\test\java\org\apache\shardingsphere\infra\merge\result\impl\stream\StreamMergedResultTest.java,0,17,1,7,0,25
 shardingsphere-master\shardingsphere-master\shardingsphere-test\shardingsphere-pipeline-test\src\test\java\org\apache\shardingsphere\data\pipeline\core\fixture\FixtureScalingEntry.java,0,5,0,3,0,8
 shardingsphere-master\shardingsphere-master\shardingsphere-infra\shardingsphere-infra-common\src\main\java\org\apache\shardingsphere\infra\metadata\schema\loader\TableMetaDataLoaderEngine.java,0,22,0,17,0,39
 shardingsphere-master\shardingsphere-master\shardingsphere-agent\shardingsphere-agent-plugins\shardingsphere-agent-plugin-metrics\shardingsphere-agent-metrics-prometheus\src\test\java\org\apache\shardingsphere\agent\metrics\prometheus\wrapper\PrometheusWrapperFactoryTest.java,0,2,0,1,0,3
 shardingsphere-master\shardingsphere-master\shardingsphere-infra\shardingsphere-infra-route\src\main\java\org\apache\shardingsphere\infra\route\engine\SQLRouteExecutor.java,0,2,0,1,0,3
 shardingsphere-master\shardingsphere-master\shardingsphere-features\shardingsphere-sharding\shardingsphere-sharding-core\src\test\java\org\apache\shardingsphere\sharding\algorithm\sharding\datetime\IntervalShardingAlgorithmTest.java,0,126,0,56,0,182
 shardingsphere-master\shardingsphere-master\shardingsphere-infra\shardingsphere-infra-binder\src\main\java\org\apache\shardingsphere\infra\binder\type\ConstraintAvailable.java,0,2,0,2,0,4
 shardingsphere-master\shardingsphere-master\shardingsphere-features\shardingsphere-sharding\shardingsphere-sharding-distsql\shardingsphere-sharding-distsql-handler\src\test\java\org\apache\shardingsphere\sharding\distsql\update\CreateShardingBindingTableRuleStatementUpdaterTest.java,0,20,0,16,0,36
 shardingsphere-master\shardingsphere-master\shardingsphere-infra\shardingsphere-infra-executor\src\main\java\org\apache\shardingsphere\infra\executor\sql\hook\SPISQLExecutionHook.java,0,12,0,5,0,17
 shardingsphere-master\shardingsphere-master\shardingsphere-sql-parser\shardingsphere-sql-parser-statement\src\main\java\org\apache\shardingsphere\sql\parser\sql\common\statement\dcl\DCLStatement.java,0,0,0,1,0,1
 shardingsphere-master\shardingsphere-master\shardingsphere-infra\shardingsphere-infra-federation\shardingsphere-infra-federation-optimizer\src\main\java\org\apache\shardingsphere\infra\federation\optimizer\converter\segment\projection\impl\ExpressionProjectionConverter.java,0,16,0,23,0,39
 shardingsphere-master\shardingsphere-master\shardingsphere-features\shardingsphere-encrypt\shardingsphere-encrypt-core\src\main\java\org\apache\shardingsphere\encrypt\rewrite\context\EncryptSQLRewriteContextDecorator.java,0,27,0,28,0,55
 shardingsphere-master\shardingsphere-master\shardingsphere-test\shardingsphere-parser-test\src\main\java\org\apache\shardingsphere\test\sql\parser\parameterized\jaxb\cases\domain\statement\distsql\ral\ShowScalingListStatementTestCase.java,0,0,0,3,0,3
 shardingsphere-master\shardingsphere-master\shardingsphere-jdbc\shardingsphere-jdbc-core\src\test\java\org\apache\shardingsphere\driver\state\circuit\metadata\CircuitBreakerDatabaseMetaDataTest.java,0,358,0,4,0,362
 shardingsphere-master\shardingsphere-master\examples\shardingsphere-example-generator\src\main\java\org\apache\shardingsphere\example\generator\scenario\ExampleScenarioFactory.java,0,19,0,10,0,29
 shardingsphere-master\shardingsphere-master\shardingsphere-proxy\shardingsphere-proxy-backend\src\test\java\org\apache\shardingsphere\proxy\backend\text\distsql\fixture\FixtureRuleConfiguration.java,0,1,0,3,0,4
 shardingsphere-master\shardingsphere-master\shardingsphere-infra\shardingsphere-infra-datetime\shardingsphere-infra-datetime-type\shardingsphere-database-datetime\src\test\java\org\apache\shardingsphere\datetime\database\DatabaseDatetimeServiceTest.java,0,4,0,2,0,6
 shardingsphere-master\shardingsphere-master\shardingsphere-infra\shardingsphere-infra-common\src\main\java\org\apache\shardingsphere\infra\distsql\exception\rule\RequiredAlgorithmMissedException.java,0,18,0,7,0,25
 shardingsphere-master\shardingsphere-master\shardingsphere-distsql\shardingsphere-distsql-statement\src\main\java\org\apache\shardingsphere\distsql\parser\statement\ral\common\queryable\ShowTableMetadataStatement.java,0,6,0,5,0,11
 shardingsphere-master\shardingsphere-master\shardingsphere-infra\shardingsphere-infra-common\src\main\java\org\apache\shardingsphere\infra\yaml\engine\constructor\ShardingSphereYamlConstruct.java,0,3,0,1,0,4
 shardingsphere-master\shardingsphere-master\shardingsphere-db-protocol\shardingsphere-db-protocol-opengauss\src\test\java\org\apache\shardingsphere\db\protocol\opengauss\packet\command\OpenGaussCommandPacketTypeTest.java,0,4,0,2,0,6
 shardingsphere-master\shardingsphere-master\shardingsphere-test\shardingsphere-parser-test\src\main\java\org\apache\shardingsphere\test\sql\parser\parameterized\asserts\statement\tcl\impl\CommitStatementAssert.java,0,4,1,6,0,11
 shardingsphere-master\shardingsphere-master\shardingsphere-infra\shardingsphere-infra-executor\src\main\java\org\apache\shardingsphere\infra\executor\sql\execute\engine\SQLExecutionUnit.java,0,2,0,1,0,3
 shardingsphere-master\shardingsphere-master\shardingsphere-proxy\shardingsphere-proxy-backend\src\test\java\org\apache\shardingsphere\proxy\backend\text\distsql\ral\common\queryable\ShowTableMetadataHandlerTest.java,0,22,0,18,0,40
 shardingsphere-master\shardingsphere-master\shardingsphere-kernel\shardingsphere-data-pipeline\shardingsphere-data-pipeline-dialect\shardingsphere-data-pipeline-mysql\src\main\java\org\apache\shardingsphere\data\pipeline\mysql\ingest\binlog\event\AbstractRowsEvent.java,7,4,1,1,0,6
 shardingsphere-master\shardingsphere-master\shardingsphere-sql-parser\shardingsphere-sql-parser-statement\src\main\java\org\apache\shardingsphere\sql\parser\sql\dialect\handler\ddl\AlterIndexStatementHandler.java,0,9,0,16,3,28
 shardingsphere-master\shardingsphere-master\shardingsphere-db-protocol\shardingsphere-db-protocol-mysql\src\main\java\org\apache\shardingsphere\db\protocol\mysql\packet\command\query\MySQLFieldCountPacket.java,0,9,0,2,0,11
 shardingsphere-master\shardingsphere-master\shardingsphere-infra\shardingsphere-infra-binder\src\main\java\org\apache\shardingsphere\infra\binder\segment\insert\values\InsertValueContext.java,0,28,0,17,0,45
 shardingsphere-master\shardingsphere-master\shardingsphere-sql-parser\shardingsphere-sql-parser-statement\src\main\java\org\apache\shardingsphere\sql\parser\sql\dialect\statement\sqlserver\dcl\SQLServerRevokeStatement.java,0,3,0,6,1,10
 shardingsphere-master\shardingsphere-master\shardingsphere-proxy\shardingsphere-proxy-backend\src\test\java\org\apache\shardingsphere\proxy\backend\text\distsql\fixture\TestTrafficLoadBalanceAlgorithm.java,0,6,0,3,0,9
 shardingsphere-master\shardingsphere-master\shardingsphere-infra\shardingsphere-infra-binder\src\main\java\org\apache\shardingsphere\infra\binder\SQLStatementContextFactory.java,0,41,0,104,0,145
 shardingsphere-master\shardingsphere-master\shardingsphere-sql-parser\shardingsphere-sql-parser-statement\src\main\java\org\apache\shardingsphere\sql\parser\sql\dialect\statement\sqlserver\ddl\SQLServerCreateSchemaStatement.java,0,1,0,6,0,7
 shardingsphere-master\shardingsphere-master\shardingsphere-test\shardingsphere-integration-agent-test\shardingsphere-integration-agent-test-plugins\shardingsphere-integration-agent-test-zipkin\src\test\java\org\apache\shardingsphere\integration\agent\test\zipkin\ZipkinPluginIT.java,0,3,0,1,0,4
 shardingsphere-master\shardingsphere-master\shardingsphere-db-protocol\shardingsphere-db-protocol-core\src\main\java\org\apache\shardingsphere\db\protocol\packet\CommandPacketType.java,0,0,0,1,0,1
 shardingsphere-master\shardingsphere-master\shardingsphere-infra\shardingsphere-infra-common\src\main\java\org\apache\shardingsphere\infra\datasource\pool\metadata\type\hikari\HikariDataSourcePoolFieldMetaData.java,0,6,0,3,0,9
 shardingsphere-master\shardingsphere-master\shardingsphere-test\shardingsphere-parser-test\src\main\java\org\apache\shardingsphere\test\sql\parser\parameterized\jaxb\cases\domain\segment\impl\expr\simple\ExpectedLiteralExpression.java,0,3,0,3,0,6
 shardingsphere-master\shardingsphere-master\shardingsphere-features\shardingsphere-readwrite-splitting\shardingsphere-readwrite-splitting-distsql\shardingsphere-readwrite-splitting-distsql-statement\src\main\java\org\apache\shardingsphere\readwritesplitting\distsql\parser\statement\AlterReadwriteSplittingRuleStatement.java,0,4,0,4,0,8
 shardingsphere-master\shardingsphere-master\shardingsphere-db-protocol\shardingsphere-db-protocol-mysql\src\test\java\org\apache\shardingsphere\db\protocol\mysql\packet\command\query\binary\execute\MySQLBinaryResultSetRowPacketTest.java,0,9,0,5,0,14
 shardingsphere-master\shardingsphere-master\shardingsphere-features\shardingsphere-db-discovery\shardingsphere-db-discovery-core\src\test\java\org\apache\shardingsphere\dbdiscovery\route\DatabaseDiscoverySQLRouterTest.java,0,64,0,41,0,105
 shardingsphere-master\shardingsphere-master\shardingsphere-infra\shardingsphere-infra-common\src\main\java\org\apache\shardingsphere\infra\datasource\pool\destroyer\detector\DataSourcePoolActiveDetector.java,0,3,0,1,0,4
 shardingsphere-master\shardingsphere-master\shardingsphere-db-protocol\shardingsphere-db-protocol-postgresql\src\main\java\org\apache\shardingsphere\db\protocol\postgresql\packet\command\query\extended\bind\protocol\PostgreSQLStringBinaryProtocolValue.java,0,6,0,6,0,12
 shardingsphere-master\shardingsphere-master\shardingsphere-distsql\shardingsphere-distsql-statement\src\main\java\org\apache\shardingsphere\distsql\parser\statement\ral\common\HintDistSQLStatement.java,3,1,1,2,0,4
 shardingsphere-master\shardingsphere-master\shardingsphere-infra\shardingsphere-infra-federation\shardingsphere-infra-federation-optimizer\src\main\java\org\apache\shardingsphere\infra\federation\optimizer\metadata\FederationMetaData.java,0,7,1,4,0,12
 shardingsphere-master\shardingsphere-master\shardingsphere-features\shardingsphere-shadow\shardingsphere-shadow-distsql\shardingsphere-shadow-distsql-statement\src\main\java\org\apache\shardingsphere\shadow\distsql\parser\statement\AlterShadowRuleStatement.java,0,1,0,3,0,4
 shardingsphere-master\shardingsphere-master\shardingsphere-test\shardingsphere-parser-test\src\main\java\org\apache\shardingsphere\test\sql\parser\parameterized\asserts\segment\distsql\SQLSegmentAssert.java,0,7,0,8,0,15
 shardingsphere-master\shardingsphere-master\shardingsphere-infra\shardingsphere-infra-federation\shardingsphere-infra-federation-optimizer\src\test\java\org\apache\shardingsphere\infra\federation\optimizer\metadata\fixture\CommonFixtureTableMetaDataBuilder.java,0,8,0,7,0,15
 shardingsphere-master\shardingsphere-master\shardingsphere-db-protocol\shardingsphere-db-protocol-mysql\src\main\java\org\apache\shardingsphere\db\protocol\mysql\packet\command\query\text\query\MySQLComQueryPacket.java,0,10,0,5,0,15
 shardingsphere-master\shardingsphere-master\shardingsphere-sql-parser\shardingsphere-sql-parser-statement\src\main\java\org\apache\shardingsphere\sql\parser\sql\common\statement\dcl\CreateUserStatement.java,5,3,1,4,1,9
 shardingsphere-master\shardingsphere-master\shardingsphere-infra\shardingsphere-infra-common\src\test\java\org\apache\shardingsphere\infra\metadata\resource\CachedDatabaseMetaDataTest.java,0,19,0,9,0,28
 shardingsphere-master\shardingsphere-master\shardingsphere-sql-parser\shardingsphere-sql-parser-statement\src\main\java\org\apache\shardingsphere\sql\parser\sql\common\statement\dcl\CreateRoleStatement.java,3,1,1,3,0,5
 shardingsphere-master\shardingsphere-master\shardingsphere-agent\shardingsphere-agent-core\src\main\java\org\apache\shardingsphere\agent\core\plugin\interceptor\compose\ComposeClassStaticMethodInterceptorArgsOverride.java,0,5,0,6,0,11
 shardingsphere-master\shardingsphere-master\shardingsphere-infra\shardingsphere-infra-common\src\main\java\org\apache\shardingsphere\infra\distsql\update\RuleDefinitionAlterUpdater.java,0,5,0,3,0,8
 shardingsphere-master\shardingsphere-master\shardingsphere-kernel\shardingsphere-transaction\shardingsphere-transaction-type\shardingsphere-transaction-xa\shardingsphere-transaction-xa-provider\shardingsphere-transaction-xa-narayana\src\main\java\org\apache\shardingsphere\transaction\xa\narayana\config\NarayanaConfigEntry.java,0,5,0,1,0,6
 shardingsphere-master\shardingsphere-master\shardingsphere-infra\shardingsphere-infra-merge\src\test\java\org\apache\shardingsphere\infra\merge\MergeEngineTest.java,0,29,0,13,0,42
 shardingsphere-master\shardingsphere-master\shardingsphere-proxy\shardingsphere-proxy-frontend\shardingsphere-proxy-frontend-reactive-core\src\main\java\org\apache\shardingsphere\proxy\frontend\reactive\state\impl\ReactiveOKProxyState.java,0,10,0,11,0,21
 shardingsphere-master\shardingsphere-master\shardingsphere-infra\shardingsphere-infra-common\src\main\java\org\apache\shardingsphere\infra\metadata\user\yaml\config\YamlUserConfiguration.java,0,9,0,2,0,11
 shardingsphere-master\shardingsphere-master\shardingsphere-proxy\shardingsphere-proxy-frontend\shardingsphere-proxy-frontend-mysql\src\main\java\org\apache\shardingsphere\proxy\frontend\mysql\authentication\authenticator\MySQLAuthenticator.java,0,2,0,2,0,4
 shardingsphere-master\shardingsphere-master\shardingsphere-features\shardingsphere-sharding\shardingsphere-sharding-api\src\main\java\org\apache\shardingsphere\sharding\api\config\strategy\keygen\KeyGenerateStrategyConfiguration.java,0,11,0,3,0,14
 shardingsphere-master\shardingsphere-master\shardingsphere-infra\shardingsphere-infra-executor\src\main\java\org\apache\shardingsphere\infra\executor\sql\execute\engine\driver\jdbc\sane\DefaultSaneQueryResultEngine.java,0,11,0,15,0,26
 shardingsphere-master\shardingsphere-master\shardingsphere-proxy\shardingsphere-proxy-frontend\shardingsphere-proxy-frontend-mysql\src\main\java\org\apache\shardingsphere\proxy\frontend\mysql\authentication\authenticator\MySQLClearPasswordAuthenticator.java,0,8,0,8,0,16
 shardingsphere-master\shardingsphere-master\shardingsphere-proxy\shardingsphere-proxy-backend\src\test\java\org\apache\shardingsphere\proxy\backend\text\admin\mysql\executor\ShowDatabasesExecutorTest.java,0,48,1,32,0,81
 shardingsphere-master\shardingsphere-master\shardingsphere-test\shardingsphere-parser-test\src\main\java\org\apache\shardingsphere\test\sql\parser\parameterized\jaxb\cases\domain\statement\dal\OptimizeTableStatementTestCase.java,0,2,0,4,0,6
 shardingsphere-master\shardingsphere-master\shardingsphere-sql-parser\shardingsphere-sql-parser-statement\src\main\java\org\apache\shardingsphere\sql\parser\sql\common\constant\JoinType.java,0,9,0,1,0,10
 shardingsphere-master\shardingsphere-master\shardingsphere-test\shardingsphere-parser-test\src\main\java\org\apache\shardingsphere\test\sql\parser\parameterized\jaxb\cases\domain\statement\distsql\rdl\alter\AlterEncryptRuleStatementTestCase.java,0,2,0,4,0,6
 shardingsphere-master\shardingsphere-master\shardingsphere-kernel\shardingsphere-transaction\shardingsphere-transaction-type\shardingsphere-transaction-xa\shardingsphere-transaction-xa-core\src\test\java\org\apache\shardingsphere\transaction\xa\jta\datasource\swapper\DataSourcePropertyProviderLoaderTest.java,0,7,0,5,0,12
 shardingsphere-master\shardingsphere-master\shardingsphere-kernel\shardingsphere-traffic\shardingsphere-traffic-core\src\test\java\org\apache\shardingsphere\traffic\algorithm\traffic\transaction\JDBCTrafficAlgorithmTest.java,0,12,0,4,0,16
 shardingsphere-master\shardingsphere-master\shardingsphere-agent\shardingsphere-agent-plugins\shardingsphere-agent-plugin-tracing\shardingsphere-agent-tracing-zipkin\src\main\java\org\apache\shardingsphere\agent\plugin\tracing\zipkin\service\ZipkinTracingPluginBootService.java,0,22,0,10,0,32
 shardingsphere-master\shardingsphere-master\shardingsphere-test\shardingsphere-parser-test\src\main\java\org\apache\shardingsphere\test\sql\parser\parameterized\jaxb\cases\domain\segment\impl\limit\ExpectedPaginationValue.java,0,4,0,3,0,7
 shardingsphere-master\shardingsphere-master\shardingsphere-kernel\shardingsphere-data-pipeline\shardingsphere-data-pipeline-dialect\shardingsphere-data-pipeline-mysql\src\main\java\org\apache\shardingsphere\data\pipeline\mysql\ingest\column\value\UnsignedTinyintHandler.java,0,4,0,1,0,5
 shardingsphere-master\shardingsphere-master\shardingsphere-features\shardingsphere-encrypt\shardingsphere-encrypt-core\src\test\java\org\apache\shardingsphere\encrypt\algorithm\CustomizedEncryptAlgorithmTest.java,0,16,0,6,0,22
 shardingsphere-master\shardingsphere-master\shardingsphere-sql-parser\shardingsphere-sql-parser-statement\src\main\java\org\apache\shardingsphere\sql\parser\sql\dialect\statement\oracle\ddl\OracleAlterTableStatement.java,0,1,0,4,0,5
 shardingsphere-master\shardingsphere-master\shardingsphere-features\shardingsphere-sharding\shardingsphere-sharding-core\src\main\java\org\apache\shardingsphere\sharding\route\engine\validator\ddl\impl\ShardingCreateFunctionStatementValidator.java,0,12,1,14,0,27
 shardingsphere-master\shardingsphere-master\shardingsphere-proxy\shardingsphere-proxy-backend\src\main\java\org\apache\shardingsphere\proxy\backend\config\yaml\YamlProxyServerConfiguration.java,0,12,0,2,0,14
 shardingsphere-master\shardingsphere-master\shardingsphere-jdbc\shardingsphere-jdbc-spring\shardingsphere-jdbc-core-spring\shardingsphere-jdbc-core-spring-boot-starter\src\main\java\org\apache\shardingsphere\spring\boot\rule\LocalRulesCondition.java,0,7,0,4,0,11
 shardingsphere-master\shardingsphere-master\shardingsphere-test\shardingsphere-parser-test\src\main\java\org\apache\shardingsphere\test\sql\parser\parameterized\jaxb\cases\domain\segment\impl\call\ExpectedProcedureName.java,0,2,0,3,0,5
 shardingsphere-master\shardingsphere-master\shardingsphere-sql-parser\shardingsphere-sql-parser-statement\src\main\java\org\apache\shardingsphere\sql\parser\sql\common\statement\ddl\AlterTableStatement.java,46,35,0,23,13,71
 shardingsphere-master\shardingsphere-master\shardingsphere-sql-parser\shardingsphere-sql-parser-statement\src\main\java\org\apache\shardingsphere\sql\parser\sql\dialect\statement\opengauss\ddl\OpenGaussAlterTextSearchStatement.java,0,1,0,5,0,6
 shardingsphere-master\shardingsphere-master\shardingsphere-sql-parser\shardingsphere-sql-parser-statement\src\main\java\org\apache\shardingsphere\sql\parser\sql\common\segment\dml\item\AggregationProjectionSegment.java,0,20,0,7,0,27
 shardingsphere-master\shardingsphere-master\shardingsphere-features\shardingsphere-sharding\shardingsphere-sharding-core\src\main\java\org\apache\shardingsphere\sharding\rewrite\token\pojo\AggregationDistinctToken.java,0,16,0,4,0,20
 shardingsphere-master\shardingsphere-master\shardingsphere-proxy\shardingsphere-proxy-backend\src\main\java\org\apache\shardingsphere\proxy\backend\communication\jdbc\recognizer\impl\OpenGaussRecognizer.java,0,3,0,3,0,6
 shardingsphere-master\shardingsphere-master\shardingsphere-features\shardingsphere-sharding\shardingsphere-sharding-distsql\shardingsphere-sharding-distsql-statement\src\main\java\org\apache\shardingsphere\sharding\distsql\parser\statement\ShowShardingTableNodesStatement.java,0,6,0,4,0,10
 shardingsphere-master\shardingsphere-master\shardingsphere-features\shardingsphere-db-discovery\shardingsphere-db-discovery-core\src\main\java\org\apache\shardingsphere\dbdiscovery\algorithm\config\AlgorithmProvidedDatabaseDiscoveryRuleConfiguration.java,0,11,0,8,0,19
 shardingsphere-master\shardingsphere-master\shardingsphere-db-protocol\shardingsphere-db-protocol-postgresql\src\test\java\org\apache\shardingsphere\db\protocol\postgresql\packet\command\query\extended\bind\protocol\PostgreSQLBoolArrayBinaryProtocolValueTest.java,0,11,0,5,0,16
 shardingsphere-master\shardingsphere-master\shardingsphere-features\shardingsphere-db-discovery\shardingsphere-db-discovery-core\src\main\java\org\apache\shardingsphere\dbdiscovery\rule\builder\AlgorithmProvidedDatabaseDiscoveryRuleBuilder.java,0,9,0,6,0,15
 shardingsphere-master\shardingsphere-master\shardingsphere-distsql\shardingsphere-distsql-statement\src\main\java\org\apache\shardingsphere\distsql\parser\statement\ral\advanced\ParseStatement.java,0,2,0,2,0,4
 shardingsphere-master\shardingsphere-master\examples\shardingsphere-jdbc-example\single-feature-example\extension-example\custom-sharding-algortihm-example\class-based-sharding-algorithm-example\class-based-sharding-raw-jdbc-example\src\main\java\org\apache\shardingsphere\example\extension\classbased\sharding\raw\jdbc\fixture\ClassBasedStandardShardingAlgorithmFixture.java,0,14,0,11,0,25
 shardingsphere-master\shardingsphere-master\examples\shardingsphere-jdbc-example\single-feature-example\sharding-example\sharding-raw-jdbc-example\src\main\java\org\apache\shardingsphere\example\sharding\raw\jdbc\ShardingSQLCommentHintRawExample.java,0,15,1,11,0,27
 shardingsphere-master\shardingsphere-master\shardingsphere-test\shardingsphere-parser-test\src\main\java\org\apache\shardingsphere\test\sql\parser\parameterized\jaxb\cases\domain\statement\dal\CacheIndexStatementTestCase.java,0,7,0,6,0,13
 shardingsphere-master\shardingsphere-master\shardingsphere-infra\shardingsphere-infra-rewrite\src\main\java\org\apache\shardingsphere\infra\rewrite\parameter\rewriter\ParameterRewriter.java,0,6,0,3,0,9
 shardingsphere-master\shardingsphere-master\shardingsphere-sql-parser\shardingsphere-sql-parser-statement\src\main\java\org\apache\shardingsphere\sql\parser\sql\dialect\statement\opengauss\ddl\OpenGaussCreateLanguageStatement.java,0,1,0,5,0,6
 shardingsphere-master\shardingsphere-master\shardingsphere-kernel\shardingsphere-transaction\shardingsphere-transaction-type\shardingsphere-transaction-xa\shardingsphere-transaction-xa-provider\shardingsphere-transaction-xa-narayana\src\test\java\org\apache\shardingsphere\transaction\xa\narayana\config\NarayanaConfigurationFileGeneratorTest.java,0,104,1,70,0,175
 shardingsphere-master\shardingsphere-master\shardingsphere-sql-parser\shardingsphere-sql-parser-statement\src\main\java\org\apache\shardingsphere\sql\parser\sql\dialect\statement\sqlserver\ddl\SQLServerTruncateStatement.java,0,1,0,5,0,6
 shardingsphere-master\shardingsphere-master\shardingsphere-jdbc\shardingsphere-jdbc-core\src\main\java\org\apache\shardingsphere\driver\api\ShardingSphereDataSourceFactory.java,0,38,0,24,0,62
 shardingsphere-master\shardingsphere-master\shardingsphere-features\shardingsphere-sharding\shardingsphere-sharding-core\src\main\java\org\apache\shardingsphere\sharding\route\engine\condition\generator\ConditionValueGenerator.java,0,3,0,4,0,7
 shardingsphere-master\shardingsphere-master\shardingsphere-proxy\shardingsphere-proxy-backend\src\test\java\org\apache\shardingsphere\proxy\backend\communication\jdbc\JDBCDatabaseCommunicationEngineTest.java,0,72,2,56,0,130
 shardingsphere-master\shardingsphere-master\shardingsphere-test\shardingsphere-parser-test\src\main\java\org\apache\shardingsphere\test\sql\parser\parameterized\asserts\statement\ddl\impl\AuditStatementAssert.java,0,3,1,6,0,10
 shardingsphere-master\shardingsphere-master\shardingsphere-infra\shardingsphere-infra-common\src\main\java\org\apache\shardingsphere\infra\metadata\resource\CachedDatabaseMetaData.java,0,325,0,55,0,380
 shardingsphere-master\shardingsphere-master\shardingsphere-proxy\shardingsphere-proxy-backend\src\test\java\org\apache\shardingsphere\proxy\backend\text\distsql\ral\common\queryable\CountInstanceRulesTest.java,0,40,0,27,0,67
 shardingsphere-master\shardingsphere-master\shardingsphere-agent\shardingsphere-agent-plugins\shardingsphere-agent-plugin-tracing\shardingsphere-agent-tracing-opentracing\src\main\java\org\apache\shardingsphere\agent\plugin\tracing\opentracing\advice\CommandExecutorTaskAdvice.java,0,14,0,9,0,23
 shardingsphere-master\shardingsphere-master\shardingsphere-infra\shardingsphere-infra-common\src\main\java\org\apache\shardingsphere\infra\datasource\props\custom\CustomDataSourceProperties.java,0,9,0,3,0,12
 shardingsphere-master\shardingsphere-master\shardingsphere-db-protocol\shardingsphere-db-protocol-core\src\main\java\org\apache\shardingsphere\db\protocol\parameter\TypeUnspecifiedSQLParameter.java,0,1,0,1,0,2
 shardingsphere-master\shardingsphere-master\shardingsphere-proxy\shardingsphere-proxy-backend\src\main\java\org\apache\shardingsphere\proxy\backend\text\distsql\ral\common\hint\HintStatementExecutor.java,0,4,0,2,0,6
 shardingsphere-master\shardingsphere-master\shardingsphere-test\shardingsphere-integration-test\shardingsphere-integration-test-suite\src\test\java\org\apache\shardingsphere\test\integration\framework\watcher\ITWatcher.java,0,5,1,3,0,9
 shardingsphere-master\shardingsphere-master\shardingsphere-db-protocol\shardingsphere-db-protocol-postgresql\src\test\java\org\apache\shardingsphere\db\protocol\postgresql\constant\PostgreSQLServerInfoTest.java,0,6,0,3,0,9
 shardingsphere-master\shardingsphere-master\shardingsphere-infra\shardingsphere-infra-route\src\test\java\org\apache\shardingsphere\infra\route\context\RouteContextTest.java,0,51,0,17,0,68
 shardingsphere-master\shardingsphere-master\shardingsphere-sql-parser\shardingsphere-sql-parser-statement\src\main\java\org\apache\shardingsphere\sql\parser\sql\common\segment\ddl\AlterDefinitionSegment.java,0,1,0,1,0,2
 shardingsphere-master\shardingsphere-master\shardingsphere-test\shardingsphere-integration-driver-test\src\test\java\org\apache\shardingsphere\driver\fixture\algorithm\MultiAlgorithm.java,0,7,2,5,0,14
 shardingsphere-master\shardingsphere-master\shardingsphere-infra\shardingsphere-infra-binder\src\main\java\org\apache\shardingsphere\infra\binder\segment\select\subquery\engine\SubqueryTableContextEngine.java,0,5,0,7,0,12
 shardingsphere-master\shardingsphere-master\shardingsphere-db-protocol\shardingsphere-db-protocol-mysql\src\test\java\org\apache\shardingsphere\db\protocol\mysql\packet\command\query\binary\execute\protocol\MySQLInt2BinaryProtocolValueTest.java,0,6,0,2,0,8
 shardingsphere-master\shardingsphere-master\shardingsphere-infra\shardingsphere-infra-executor\src\main\java\org\apache\shardingsphere\infra\executor\sql\process\model\ExecuteProcessContext.java,0,23,0,8,0,31
 shardingsphere-master\shardingsphere-master\shardingsphere-agent\shardingsphere-agent-plugins\shardingsphere-agent-plugin-tracing\shardingsphere-agent-tracing-test\src\main\java\org\apache\shardingsphere\agent\plugin\tracing\advice\AbstractSQLParserEngineAdviceTest.java,25,7,0,3,0,10
 shardingsphere-master\shardingsphere-master\shardingsphere-agent\shardingsphere-agent-core\src\main\java\org\apache\shardingsphere\agent\core\plugin\interceptor\compose\ComposeConstructorInterceptor.java,0,4,0,5,0,9
 shardingsphere-master\shardingsphere-master\shardingsphere-db-protocol\shardingsphere-db-protocol-postgresql\src\test\java\org\apache\shardingsphere\db\protocol\postgresql\packet\generic\PostgreSQLSSLNegativePacketTest.java,0,3,0,4,0,7
 shardingsphere-master\shardingsphere-master\shardingsphere-test\shardingsphere-parser-test\src\main\java\org\apache\shardingsphere\test\sql\parser\parameterized\jaxb\cases\domain\statement\distsql\rql\ShowDataBaseDiscoveryRulesStatementTestCase.java,0,3,0,5,0,8
 shardingsphere-master\shardingsphere-master\shardingsphere-sql-parser\shardingsphere-sql-parser-statement\src\main\java\org\apache\shardingsphere\sql\parser\sql\common\statement\ddl\CreateConversionStatement.java,3,1,1,3,0,5
 shardingsphere-master\shardingsphere-master\examples\example-core\example-spring-mybatis\src\main\java\org\apache\shardingsphere\example\core\mybatis\repository\MybatisOrderRepository.java,0,0,0,1,0,1
 shardingsphere-master\shardingsphere-master\shardingsphere-kernel\shardingsphere-data-pipeline\shardingsphere-data-pipeline-core\src\main\java\org\apache\shardingsphere\data\pipeline\core\api\impl\RuleAlteredJobAPIImpl.java,0,107,6,97,0,210
 shardingsphere-master\shardingsphere-master\shardingsphere-agent\shardingsphere-agent-plugins\shardingsphere-agent-plugin-tracing\shardingsphere-agent-tracing-opentelemetry\src\test\java\org\apache\shardingsphere\agent\plugin\tracing\opentelemetry\service\OpenTelemetryTracingPluginBootServiceTest.java,0,9,0,5,0,14
 shardingsphere-master\shardingsphere-master\shardingsphere-kernel\shardingsphere-data-pipeline\shardingsphere-data-pipeline-dialect\shardingsphere-data-pipeline-postgresql\src\main\java\org\apache\shardingsphere\data\pipeline\postgresql\check\consistency\CRC32MatchPostgreSQLSingleTableDataCalculator.java,0,9,0,8,0,17
 shardingsphere-master\shardingsphere-master\shardingsphere-kernel\shardingsphere-data-pipeline\shardingsphere-data-pipeline-core\src\main\java\org\apache\shardingsphere\data\pipeline\scenario\rulealtered\RuleAlteredJobScheduler.java,0,23,4,13,0,40
 shardingsphere-master\shardingsphere-master\shardingsphere-sql-parser\shardingsphere-sql-parser-statement\src\main\java\org\apache\shardingsphere\sql\parser\sql\dialect\statement\postgresql\tcl\PostgreSQLBeginTransactionStatement.java,0,2,0,5,0,7
 shardingsphere-master\shardingsphere-master\shardingsphere-kernel\shardingsphere-data-pipeline\shardingsphere-data-pipeline-core\src\main\java\org\apache\shardingsphere\data\pipeline\core\exception\PipelineDataConsistencyCheckFailedException.java,0,8,0,3,0,11
 shardingsphere-master\shardingsphere-master\shardingsphere-infra\shardingsphere-infra-common\src\test\java\org\apache\shardingsphere\infra\fixture\ReadWriteSplittingDataNodeBuilderFixture.java,0,8,0,4,0,12
 shardingsphere-master\shardingsphere-master\shardingsphere-features\shardingsphere-sharding\shardingsphere-sharding-core\src\main\java\org\apache\shardingsphere\sharding\route\engine\type\complex\ShardingComplexRoutingEngine.java,0,15,0,11,0,26
 shardingsphere-master\shardingsphere-master\shardingsphere-infra\shardingsphere-infra-common\src\main\java\org\apache\shardingsphere\infra\properties\TypedPropertyValueException.java,0,5,0,3,0,8
 shardingsphere-master\shardingsphere-master\shardingsphere-agent\shardingsphere-agent-core\src\main\java\org\apache\shardingsphere\agent\core\entity\Interceptor.java,0,11,1,1,0,13
 shardingsphere-master\shardingsphere-master\shardingsphere-sql-parser\shardingsphere-sql-parser-statement\src\main\java\org\apache\shardingsphere\sql\parser\sql\dialect\statement\opengauss\ddl\OpenGaussCreateConversionStatement.java,0,1,0,5,0,6
 shardingsphere-master\shardingsphere-master\shardingsphere-sql-parser\shardingsphere-sql-parser-dialect\shardingsphere-sql-parser-opengauss\src\main\java\org\apache\shardingsphere\sql\parser\opengauss\visitor\statement\impl\OpenGaussStatementSQLVisitor.java,1007,342,3,349,0,694
 shardingsphere-master\shardingsphere-master\shardingsphere-test\shardingsphere-parser-test\src\main\java\org\apache\shardingsphere\test\sql\parser\parameterized\jaxb\cases\domain\segment\impl\call\ExpectedCallParameter.java,0,7,0,6,0,13
 shardingsphere-master\shardingsphere-master\shardingsphere-test\shardingsphere-parser-test\src\main\java\org\apache\shardingsphere\test\sql\parser\parameterized\asserts\statement\dal\impl\InstallPluginStatementAssert.java,0,5,0,8,0,13
 shardingsphere-master\shardingsphere-master\shardingsphere-kernel\shardingsphere-traffic\shardingsphere-traffic-api\src\main\java\org\apache\shardingsphere\traffic\spi\TrafficLoadBalanceAlgorithm.java,0,3,0,2,0,5
 shardingsphere-master\shardingsphere-master\shardingsphere-kernel\shardingsphere-authority\shardingsphere-authority-core\src\test\java\org\apache\shardingsphere\authority\provider\natived\NativeAuthorityProviderAlgorithmTest.java,0,69,6,55,0,130
 shardingsphere-master\shardingsphere-master\shardingsphere-db-protocol\shardingsphere-db-protocol-postgresql\src\main\java\org\apache\shardingsphere\db\protocol\postgresql\packet\command\query\extended\bind\PostgreSQLBindCompletePacket.java,0,9,0,6,0,15
 shardingsphere-master\shardingsphere-master\shardingsphere-features\shardingsphere-sharding\shardingsphere-sharding-core\src\main\java\org\apache\shardingsphere\sharding\merge\dql\pagination\TopAndRowNumberDecoratorMergedResult.java,0,14,0,6,0,20
 shardingsphere-master\shardingsphere-master\shardingsphere-mode\shardingsphere-mode-type\shardingsphere-cluster-mode\shardingsphere-cluster-mode-core\src\main\java\org\apache\shardingsphere\mode\manager\cluster\coordinator\registry\config\event\version\SchemaVersionChangedEvent.java,0,5,0,3,0,8
 shardingsphere-master\shardingsphere-master\shardingsphere-sql-parser\shardingsphere-sql-parser-statement\src\main\java\org\apache\shardingsphere\sql\parser\sql\dialect\statement\mysql\dal\MySQLResetStatement.java,0,3,0,6,1,10
 shardingsphere-master\shardingsphere-master\shardingsphere-features\shardingsphere-sharding\shardingsphere-sharding-distsql\shardingsphere-sharding-distsql-handler\src\main\java\org\apache\shardingsphere\scaling\distsql\handler\ShowScalingJobStatusQueryResultSet.java,0,18,0,11,0,29
 shardingsphere-master\shardingsphere-master\shardingsphere-proxy\shardingsphere-proxy-backend\src\test\java\org\apache\shardingsphere\proxy\backend\text\distsql\rql\SchemaRulesCountResultSetTest.java,0,25,0,21,0,46
 shardingsphere-master\shardingsphere-master\shardingsphere-features\shardingsphere-db-discovery\shardingsphere-db-discovery-spring\shardingsphere-db-discovery-spring-namespace\src\test\java\org\apache\shardingsphere\dbdiscovery\spring\namespace\DatabaseDiscoverySpringNamespaceTest.java,0,25,0,18,0,43
 shardingsphere-master\shardingsphere-master\shardingsphere-db-protocol\shardingsphere-db-protocol-mysql\src\main\java\org\apache\shardingsphere\db\protocol\mysql\packet\command\query\binary\execute\MySQLNullBitmap.java,0,23,0,5,0,28
 shardingsphere-master\shardingsphere-master\shardingsphere-mode\shardingsphere-mode-type\shardingsphere-cluster-mode\shardingsphere-cluster-mode-core\src\test\java\org\apache\shardingsphere\mode\manager\cluster\coordinator\ClusterContextManagerCoordinatorTest.java,0,153,0,115,0,268
 shardingsphere-master\shardingsphere-master\shardingsphere-agent\shardingsphere-agent-core\src\main\java\org\apache\shardingsphere\agent\core\config\yaml\swapper\YamlAgentConfigurationSwapper.java,0,10,0,7,0,17
 shardingsphere-master\shardingsphere-master\shardingsphere-test\shardingsphere-parser-test\src\main\java\org\apache\shardingsphere\test\sql\parser\parameterized\asserts\statement\dml\impl\InsertStatementAssert.java,0,59,0,66,0,125
 shardingsphere-master\shardingsphere-master\shardingsphere-jdbc\shardingsphere-jdbc-core\src\main\java\org\apache\shardingsphere\driver\state\circuit\resultset\CircuitBreakerResultSetMetaData.java,0,24,0,2,0,26
 shardingsphere-master\shardingsphere-master\shardingsphere-test\shardingsphere-parser-test\src\main\java\org\apache\shardingsphere\test\sql\parser\parameterized\jaxb\cases\domain\segment\impl\component\ExpectedComponent.java,0,2,0,4,0,6
 shardingsphere-master\shardingsphere-master\shardingsphere-infra\shardingsphere-infra-common\src\main\java\org\apache\shardingsphere\infra\metadata\schema\event\SchemaAlteredEvent.java,0,10,0,1,0,11
 shardingsphere-master\shardingsphere-master\shardingsphere-proxy\shardingsphere-proxy-backend\src\test\java\org\apache\shardingsphere\proxy\backend\text\distsql\ral\common\updatable\AlterSQLParserRuleHandlerTest.java,0,54,0,34,0,88
 shardingsphere-master\shardingsphere-master\shardingsphere-sql-parser\shardingsphere-sql-parser-statement\src\main\java\org\apache\shardingsphere\sql\parser\sql\dialect\statement\postgresql\ddl\PostgreSQLDropForeignDataWrapperStatement.java,0,1,0,5,0,6
 shardingsphere-master\shardingsphere-master\shardingsphere-kernel\shardingsphere-data-pipeline\shardingsphere-data-pipeline-core\src\main\java\org\apache\shardingsphere\data\pipeline\scenario\rulealtered\RuleAlteredJobSchedulerCenter.java,0,26,1,15,0,42
 shardingsphere-master\shardingsphere-master\shardingsphere-proxy\shardingsphere-proxy-frontend\shardingsphere-proxy-frontend-mysql\src\main\java\org\apache\shardingsphere\proxy\frontend\mysql\command\admin\MySQLComSetOptionExecutor.java,0,7,0,4,0,11
 shardingsphere-master\shardingsphere-master\shardingsphere-distsql\shardingsphere-distsql-statement\src\main\java\org\apache\shardingsphere\distsql\parser\statement\rql\show\ShowSingleTableStatement.java,0,6,0,3,0,9
 shardingsphere-master\shardingsphere-master\shardingsphere-test\shardingsphere-integration-test\shardingsphere-integration-test-suite\src\test\java\org\apache\shardingsphere\test\integration\framework\container\atomic\adapter\impl\ShardingSphereProxyContainer.java,0,37,1,16,0,54
 shardingsphere-master\shardingsphere-master\shardingsphere-test\shardingsphere-parser-test\src\main\java\org\apache\shardingsphere\test\sql\parser\parameterized\asserts\statement\distsql\rdl\create\impl\CreateDefaultShardingStrategyStatementAssert.java,0,19,0,18,0,37
 shardingsphere-master\shardingsphere-master\shardingsphere-sql-parser\shardingsphere-sql-parser-statement\src\main\java\org\apache\shardingsphere\sql\parser\sql\dialect\statement\mysql\dml\MySQLTableStatement.java,0,6,0,7,4,17
 shardingsphere-master\shardingsphere-master\shardingsphere-test\shardingsphere-parser-test\src\main\java\org\apache\shardingsphere\test\sql\parser\parameterized\jaxb\cases\SQLParserTestCasesRegistryFactory.java,0,7,0,3,0,10
 shardingsphere-master\shardingsphere-master\shardingsphere-test\shardingsphere-parser-test\src\main\java\org\apache\shardingsphere\test\sql\parser\parameterized\jaxb\cases\domain\statement\distsql\ral\scaling\ShowScalingStatusStatementTestCase.java,0,5,0,5,0,10
 shardingsphere-master\shardingsphere-master\shardingsphere-mode\shardingsphere-mode-core\src\main\java\org\apache\shardingsphere\mode\manager\listener\ContextManagerLifecycleListener.java,0,5,0,4,0,9
 shardingsphere-master\shardingsphere-master\shardingsphere-features\shardingsphere-sharding\shardingsphere-sharding-core\src\test\java\org\apache\shardingsphere\sharding\rewrite\token\OrderByTokenGeneratorTest.java,0,38,0,41,0,79
 shardingsphere-master\shardingsphere-master\shardingsphere-kernel\shardingsphere-single-table\shardingsphere-single-table-core\src\main\java\org\apache\shardingsphere\singletable\rule\SingleTableRule.java,0,62,7,32,0,101
 shardingsphere-master\shardingsphere-master\shardingsphere-features\shardingsphere-sharding\shardingsphere-sharding-api\src\main\java\org\apache\shardingsphere\sharding\api\sharding\standard\RangeShardingValue.java,0,10,0,2,0,12
 shardingsphere-master\shardingsphere-master\shardingsphere-sql-parser\shardingsphere-sql-parser-dialect\shardingsphere-sql-parser-opengauss\src\main\java\org\apache\shardingsphere\sql\parser\opengauss\visitor\statement\impl\OpenGaussDALStatementSQLVisitor.java,0,22,0,35,0,57
 shardingsphere-master\shardingsphere-master\shardingsphere-proxy\shardingsphere-proxy-bootstrap\src\main\java\org\apache\shardingsphere\proxy\arguments\BootstrapArguments.java,0,16,1,3,0,20
 shardingsphere-master\shardingsphere-master\shardingsphere-sql-parser\shardingsphere-sql-parser-statement\src\main\java\org\apache\shardingsphere\sql\parser\sql\dialect\statement\mysql\dml\MySQLInsertStatement.java,0,7,0,6,0,13
 shardingsphere-master\shardingsphere-master\shardingsphere-infra\shardingsphere-infra-common\src\main\java\org\apache\shardingsphere\infra\database\type\dialect\MariaDBDatabaseType.java,0,10,1,4,0,15
 shardingsphere-master\shardingsphere-master\shardingsphere-infra\shardingsphere-infra-executor\src\main\java\org\apache\shardingsphere\infra\executor\sql\prepare\driver\jdbc\builder\StatementExecutionUnitBuilder.java,0,10,0,14,0,24
 shardingsphere-master\shardingsphere-master\shardingsphere-features\shardingsphere-encrypt\shardingsphere-encrypt-distsql\shardingsphere-encrypt-distsql-handler\src\main\java\org\apache\shardingsphere\encrypt\distsql\handler\update\DropEncryptRuleStatementUpdater.java,0,28,0,24,0,52
 shardingsphere-master\shardingsphere-master\shardingsphere-infra\shardingsphere-infra-merge\src\test\java\org\apache\shardingsphere\infra\merge\fixture\merger\ResultMergerFixture.java,0,2,1,5,0,8
 shardingsphere-master\shardingsphere-master\shardingsphere-jdbc\shardingsphere-jdbc-core\src\test\java\org\apache\shardingsphere\driver\fixture\StandardOrderShardingAlgorithm.java,0,8,1,8,0,17
 shardingsphere-master\shardingsphere-master\shardingsphere-infra\shardingsphere-infra-binder\src\test\java\org\apache\shardingsphere\infra\binder\statement\ddl\PrepareStatementContextTest.java,0,13,0,26,0,39
 shardingsphere-master\shardingsphere-master\shardingsphere-agent\shardingsphere-agent-core\src\test\java\org\apache\shardingsphere\agent\core\plugin\interceptor\InstanceMethodAroundInterceptorTest.java,0,33,0,10,0,43
 shardingsphere-master\shardingsphere-master\shardingsphere-sql-parser\shardingsphere-sql-parser-statement\src\main\java\org\apache\shardingsphere\sql\parser\sql\dialect\statement\mysql\dal\MySQLShowStatusStatement.java,0,4,0,6,1,11
 shardingsphere-master\shardingsphere-master\shardingsphere-test\shardingsphere-parser-test\src\main\java\org\apache\shardingsphere\test\sql\parser\parameterized\asserts\segment\schema\SchemaAssert.java,0,5,0,9,0,14
 shardingsphere-master\shardingsphere-master\shardingsphere-test\shardingsphere-parser-test\src\main\java\org\apache\shardingsphere\test\sql\parser\parameterized\asserts\statement\dal\impl\ShowOpenTablesStatementAssert.java,0,6,0,12,0,18
 shardingsphere-master\shardingsphere-master\shardingsphere-infra\shardingsphere-infra-binder\src\test\java\org\apache\shardingsphere\infra\binder\segment\insert\values\InsertValueContextTest.java,0,38,2,27,0,67
 shardingsphere-master\shardingsphere-master\shardingsphere-test\shardingsphere-parser-test\src\main\java\org\apache\shardingsphere\test\sql\parser\parameterized\asserts\statement\dal\impl\SetParameterStatementAssert.java,0,12,0,14,0,26
 shardingsphere-master\shardingsphere-master\shardingsphere-kernel\shardingsphere-transaction\shardingsphere-transaction-type\shardingsphere-transaction-xa\shardingsphere-transaction-xa-core\src\test\java\org\apache\shardingsphere\transaction\xa\jta\datasource\properties\dialect\H2XADataSourceDefinitionTest.java,0,4,0,3,0,7
 shardingsphere-master\shardingsphere-master\shardingsphere-infra\shardingsphere-infra-binder\src\test\java\org\apache\shardingsphere\infra\binder\statement\impl\SelectStatementContextTest.java,0,266,0,155,0,421
 shardingsphere-master\shardingsphere-master\shardingsphere-kernel\shardingsphere-data-pipeline\shardingsphere-data-pipeline-dialect\shardingsphere-data-pipeline-mysql\src\main\java\org\apache\shardingsphere\data\pipeline\mysql\ingest\client\InternalResultSet.java,0,8,0,6,0,14
 shardingsphere-master\shardingsphere-master\shardingsphere-db-protocol\shardingsphere-db-protocol-mysql\src\main\java\org\apache\shardingsphere\db\protocol\mysql\packet\binlog\AbstractMySQLBinlogEventPacket.java,0,7,0,2,0,9
 shardingsphere-master\shardingsphere-master\shardingsphere-test\shardingsphere-parser-test\src\main\java\org\apache\shardingsphere\test\sql\parser\parameterized\jaxb\cases\domain\statement\dal\ExplainStatementTestCase.java,0,14,0,10,0,24
 shardingsphere-master\shardingsphere-master\shardingsphere-proxy\shardingsphere-proxy-frontend\shardingsphere-proxy-frontend-reactive-spi\src\main\java\org\apache\shardingsphere\proxy\frontend\reactive\command\ReactiveCommandExecuteEngine.java,0,3,0,3,0,6
 shardingsphere-master\shardingsphere-master\shardingsphere-infra\shardingsphere-infra-executor\src\main\java\org\apache\shardingsphere\infra\executor\sql\prepare\driver\jdbc\builder\PreparedStatementExecutionUnitBuilder.java,0,11,1,15,0,27
 shardingsphere-master\shardingsphere-master\shardingsphere-sql-parser\shardingsphere-sql-parser-statement\src\main\java\org\apache\shardingsphere\sql\parser\sql\dialect\statement\opengauss\ddl\OpenGaussCreateIndexStatement.java,0,4,0,5,0,9
 shardingsphere-master\shardingsphere-master\shardingsphere-kernel\shardingsphere-transaction\shardingsphere-transaction-type\shardingsphere-transaction-xa\shardingsphere-transaction-xa-core\src\test\java\org\apache\shardingsphere\transaction\xa\jta\connection\dialect\OpenGaussXAConnectionWrapperTest.java,0,10,0,7,0,17
 shardingsphere-master\shardingsphere-master\shardingsphere-db-protocol\shardingsphere-db-protocol-postgresql\src\test\java\org\apache\shardingsphere\db\protocol\postgresql\packet\command\query\extended\close\PostgreSQLCloseCompletePacketTest.java,0,5,0,4,0,9
 shardingsphere-master\shardingsphere-master\shardingsphere-kernel\shardingsphere-transaction\shardingsphere-transaction-core\src\main\java\org\apache\shardingsphere\transaction\spi\ShardingSphereTransactionManager.java,0,10,0,2,0,12
 shardingsphere-master\shardingsphere-master\shardingsphere-sql-parser\shardingsphere-sql-parser-dialect\shardingsphere-sql-parser-sql92\src\main\java\org\apache\shardingsphere\sql\parser\sql92\visitor\statement\impl\SQL92TCLStatementSQLVisitor.java,0,4,0,9,0,13
 shardingsphere-master\shardingsphere-master\shardingsphere-infra\shardingsphere-infra-binder\src\test\java\org\apache\shardingsphere\infra\binder\statement\dal\OptimizeTableStatementContextTest.java,0,6,0,10,0,16
 shardingsphere-master\shardingsphere-master\shardingsphere-test\shardingsphere-parser-test\src\main\java\org\apache\shardingsphere\test\sql\parser\parameterized\jaxb\cases\domain\statement\ddl\CreateTypeStatementTestCase.java,0,0,0,3,0,3
 shardingsphere-master\shardingsphere-master\shardingsphere-test\shardingsphere-integration-test\shardingsphere-integration-test-suite\src\test\java\org\apache\shardingsphere\test\integration\env\scenario\database\DatabaseEnvironmentManager.java,0,11,0,9,0,20
 shardingsphere-master\shardingsphere-master\shardingsphere-infra\shardingsphere-infra-rewrite\src\test\java\org\apache\shardingsphere\infra\rewrite\engine\RouteSQLRewriteEngineTest.java,0,77,0,63,0,140
 shardingsphere-master\shardingsphere-master\shardingsphere-features\shardingsphere-shadow\shardingsphere-shadow-distsql\shardingsphere-shadow-distsql-handler\src\test\java\org\apache\shardingsphere\shadow\distsql\update\CreateDefaultShadowAlgorithmStatementUpdaterTest.java,0,14,0,9,0,23
 shardingsphere-master\shardingsphere-master\shardingsphere-sql-parser\shardingsphere-sql-parser-statement\src\main\java\org\apache\shardingsphere\sql\parser\sql\dialect\statement\mysql\tcl\MySQLRollbackStatement.java,0,1,0,4,0,5
 shardingsphere-master\shardingsphere-master\shardingsphere-sql-parser\shardingsphere-sql-parser-statement\src\main\java\org\apache\shardingsphere\sql\parser\sql\dialect\statement\sqlserver\ddl\SQLServerCreateSequenceStatement.java,0,1,0,5,0,6
 shardingsphere-master\shardingsphere-master\shardingsphere-kernel\shardingsphere-data-pipeline\shardingsphere-data-pipeline-dialect\shardingsphere-data-pipeline-mysql\src\test\java\org\apache\shardingsphere\data\pipeline\mysql\ingest\column\value\UnsignedTinyintHandlerTest.java,0,5,0,1,0,6
 shardingsphere-master\shardingsphere-master\shardingsphere-features\shardingsphere-shadow\shardingsphere-shadow-distsql\shardingsphere-shadow-distsql-statement\src\main\java\org\apache\shardingsphere\shadow\distsql\parser\statement\CreateShadowAlgorithmStatement.java,0,1,0,3,0,4
 shardingsphere-master\shardingsphere-master\shardingsphere-kernel\shardingsphere-transaction\shardingsphere-transaction-type\shardingsphere-transaction-xa\shardingsphere-transaction-xa-core\src\test\java\org\apache\shardingsphere\transaction\xa\jta\datasource\properties\dialect\MariaDBXADataSourceDefinitionTest.java,0,3,0,3,0,6
 shardingsphere-master\shardingsphere-master\shardingsphere-infra\shardingsphere-infra-executor\src\main\java\org\apache\shardingsphere\infra\executor\sql\execute\engine\driver\DriverExecutionUnit.java,0,4,0,2,0,6
 shardingsphere-master\shardingsphere-master\shardingsphere-sql-parser\shardingsphere-sql-parser-engine\src\main\java\org\apache\shardingsphere\sql\parser\core\database\parser\SQLParserExecutor.java,0,10,2,6,0,18
 shardingsphere-master\shardingsphere-master\shardingsphere-db-protocol\shardingsphere-db-protocol-postgresql\src\test\java\org\apache\shardingsphere\db\protocol\postgresql\packet\command\PostgreSQLCommandPacketTypeLoaderTest.java,0,7,0,5,0,12
 shardingsphere-master\shardingsphere-master\shardingsphere-test\shardingsphere-parser-test\src\main\java\org\apache\shardingsphere\test\sql\parser\parameterized\jaxb\cases\domain\statement\ddl\CreateSchemaStatementTestCase.java,0,0,0,3,0,3
 shardingsphere-master\shardingsphere-master\shardingsphere-features\shardingsphere-sharding\shardingsphere-sharding-distsql\shardingsphere-sharding-distsql-handler\src\main\java\org\apache\shardingsphere\sharding\distsql\handler\update\CreateShardingKeyGeneratorStatementUpdater.java,0,34,0,33,0,67
 shardingsphere-master\shardingsphere-master\shardingsphere-kernel\shardingsphere-data-pipeline\shardingsphere-data-pipeline-core\src\main\java\org\apache\shardingsphere\data\pipeline\scenario\rulealtered\spi\DefaultSourceWritingStopAlgorithm.java,0,6,0,4,0,10
 shardingsphere-master\shardingsphere-master\shardingsphere-features\shardingsphere-sharding\shardingsphere-sharding-core\src\test\java\org\apache\shardingsphere\sharding\route\engine\type\broadcast\ShardingDataSourceGroupBroadcastRoutingEngineTest.java,0,13,0,6,0,19
 shardingsphere-master\shardingsphere-master\shardingsphere-kernel\shardingsphere-data-pipeline\shardingsphere-data-pipeline-dialect\shardingsphere-data-pipeline-postgresql\src\main\java\org\apache\shardingsphere\data\pipeline\postgresql\ingest\wal\event\PlaceholderEvent.java,0,0,0,1,0,1
 shardingsphere-master\shardingsphere-master\examples\shardingsphere-jdbc-example\single-feature-example\cluster-mode-example\cluster-mode-raw-jdbc-example\src\main\java\org\apache\shardingsphere\example\cluster\mode\raw\jdbc\config\cloud\CloudReadwriteSplittingConfiguration.java,0,8,0,3,0,11
 shardingsphere-master\shardingsphere-master\shardingsphere-sql-parser\shardingsphere-sql-parser-statement\src\main\java\org\apache\shardingsphere\sql\parser\sql\common\statement\ddl\CreateTextSearchStatement.java,3,1,1,3,0,5
 shardingsphere-master\shardingsphere-master\shardingsphere-proxy\shardingsphere-proxy-backend\src\test\java\org\apache\shardingsphere\proxy\backend\config\yaml\swapper\YamlProxyConfigurationSwapperTest.java,0,32,0,24,0,56
 shardingsphere-master\shardingsphere-master\shardingsphere-agent\shardingsphere-agent-api\src\main\java\org\apache\shardingsphere\agent\api\result\MethodInvocationResult.java,0,7,0,1,0,8
 shardingsphere-master\shardingsphere-master\shardingsphere-test\shardingsphere-parser-test\src\main\java\org\apache\shardingsphere\test\sql\parser\parameterized\jaxb\cases\domain\segment\impl\type\ExpectedType.java,0,2,0,4,0,6
 shardingsphere-master\shardingsphere-master\shardingsphere-features\shardingsphere-sharding\shardingsphere-sharding-spring\shardingsphere-sharding-spring-namespace\src\main\java\org\apache\shardingsphere\sharding\spring\namespace\tag\algorithm\KeyGenerateAlgorithmBeanDefinitionTag.java,0,4,0,1,0,5
 shardingsphere-master\shardingsphere-master\shardingsphere-sql-parser\shardingsphere-sql-parser-engine\src\main\java\org\apache\shardingsphere\sql\parser\core\SQLParserFactory.java,0,12,0,7,0,19
 shardingsphere-master\shardingsphere-master\shardingsphere-features\shardingsphere-db-discovery\shardingsphere-db-discovery-core\src\main\java\org\apache\shardingsphere\dbdiscovery\yaml\config\YamlDatabaseDiscoveryRuleConfiguration.java,0,13,0,10,0,23
 shardingsphere-master\shardingsphere-master\shardingsphere-sql-parser\shardingsphere-sql-parser-statement\src\main\java\org\apache\shardingsphere\sql\parser\sql\common\statement\ddl\AlterForeignTableStatement.java,3,1,1,3,0,5
 shardingsphere-master\shardingsphere-master\shardingsphere-proxy\shardingsphere-proxy-backend\src\test\java\org\apache\shardingsphere\proxy\backend\communication\ProxySQLExecutorTest.java,0,72,0,60,0,132
 shardingsphere-master\shardingsphere-master\shardingsphere-test\shardingsphere-parser-test\src\main\java\org\apache\shardingsphere\test\sql\parser\parameterized\jaxb\cases\domain\statement\dal\ShowIndexStatementTestCase.java,0,3,0,5,0,8
 shardingsphere-master\shardingsphere-master\shardingsphere-db-protocol\shardingsphere-db-protocol-mysql\src\main\java\org\apache\shardingsphere\db\protocol\mysql\packet\binlog\management\MySQLBinlogRotateEventPacket.java,0,15,0,7,0,22
 shardingsphere-master\shardingsphere-master\shardingsphere-kernel\shardingsphere-single-table\shardingsphere-single-table-core\src\main\java\org\apache\shardingsphere\singletable\metadata\SingleTableMetaDataBuilder.java,0,23,0,19,0,42
 shardingsphere-master\shardingsphere-master\shardingsphere-test\shardingsphere-integration-test\shardingsphere-integration-test-suite\src\test\java\org\apache\shardingsphere\test\integration\framework\container\compose\ComposedContainerRegistry.java,0,15,1,10,0,26
 shardingsphere-master\shardingsphere-master\shardingsphere-db-protocol\shardingsphere-db-protocol-postgresql\src\test\java\org\apache\shardingsphere\db\protocol\postgresql\packet\command\query\extended\bind\protocol\PostgreSQLDateBinaryProtocolValueTest.java,0,12,0,5,0,17
 shardingsphere-master\shardingsphere-master\shardingsphere-infra\shardingsphere-infra-binder\src\main\java\org\apache\shardingsphere\infra\binder\segment\select\groupby\GroupByContext.java,0,3,0,2,0,5
 shardingsphere-master\shardingsphere-master\shardingsphere-infra\shardingsphere-infra-datetime\shardingsphere-infra-datetime-type\shardingsphere-system-datetime\src\test\java\org\apache\shardingsphere\datetime\system\SystemDatetimeServiceTest.java,0,6,0,2,0,8
 shardingsphere-master\shardingsphere-master\examples\shardingsphere-jdbc-example\single-feature-example\transaction-example\transaction-base-seata-spring-boot-example\src\main\java\org\apache\shardingsphere\example\transaction\base\seata\spring\boot\SeataATOrderService.java,71,17,0,7,0,24
 shardingsphere-master\shardingsphere-master\shardingsphere-sql-parser\shardingsphere-sql-parser-statement\src\main\java\org\apache\shardingsphere\sql\parser\sql\dialect\statement\oracle\dcl\OracleAlterUserStatement.java,0,1,0,4,0,5
 shardingsphere-master\shardingsphere-master\shardingsphere-test\shardingsphere-parser-test\src\main\java\org\apache\shardingsphere\test\sql\parser\parameterized\asserts\statement\distsql\rdl\create\impl\CreateShadowAlgorithmStatementAssert.java,0,10,0,16,0,26
 shardingsphere-master\shardingsphere-master\shardingsphere-test\shardingsphere-parser-test\src\main\java\org\apache\shardingsphere\test\sql\parser\parameterized\jaxb\cases\domain\statement\ddl\AuditStatementTestCase.java,0,0,0,3,0,3
 shardingsphere-master\shardingsphere-master\shardingsphere-test\shardingsphere-parser-test\src\main\java\org\apache\shardingsphere\test\sql\parser\parameterized\asserts\statement\ddl\DDLStatementAssert.java,0,21,0,70,0,91
 shardingsphere-master\shardingsphere-master\shardingsphere-test\shardingsphere-parser-test\src\main\java\org\apache\shardingsphere\test\sql\parser\parameterized\asserts\SQLCaseAssertContext.java,0,21,0,10,0,31
 shardingsphere-master\shardingsphere-master\shardingsphere-features\shardingsphere-shadow\shardingsphere-shadow-spring\shardingsphere-shadow-spring-namespace\src\main\java\org\apache\shardingsphere\shadow\spring\namespace\tag\ShadowAlgorithmBeanDefinitionTag.java,0,4,0,1,0,5
 shardingsphere-master\shardingsphere-master\shardingsphere-kernel\shardingsphere-transaction\shardingsphere-transaction-type\shardingsphere-transaction-xa\shardingsphere-transaction-xa-core\src\main\java\org\apache\shardingsphere\transaction\xa\jta\connection\dialect\PostgreSQLXAConnectionWrapper.java,0,16,3,6,0,25
 shardingsphere-master\shardingsphere-master\shardingsphere-test\shardingsphere-parser-test\src\main\java\org\apache\shardingsphere\test\sql\parser\parameterized\jaxb\cases\domain\segment\impl\expr\ExpectedCollateExpression.java,0,3,0,4,0,7
 shardingsphere-master\shardingsphere-master\shardingsphere-features\shardingsphere-sharding\shardingsphere-sharding-distsql\shardingsphere-sharding-distsql-statement\src\main\java\org\apache\shardingsphere\sharding\distsql\parser\statement\ShowShardingAlgorithmsStatement.java,0,2,0,3,0,5
 shardingsphere-master\shardingsphere-master\shardingsphere-test\shardingsphere-parser-test\src\main\java\org\apache\shardingsphere\test\sql\parser\parameterized\jaxb\cases\domain\statement\distsql\rdl\create\CreateDatabaseDiscoveryDefinitionRuleStatementTestCase.java,0,4,0,6,0,10
 shardingsphere-master\shardingsphere-master\shardingsphere-features\shardingsphere-shadow\shardingsphere-shadow-distsql\shardingsphere-shadow-distsql-handler\src\main\java\org\apache\shardingsphere\shadow\distsql\handler\update\AlterShadowRuleStatementUpdater.java,0,38,0,38,0,76
 shardingsphere-master\shardingsphere-master\shardingsphere-test\shardingsphere-parser-test\src\main\java\org\apache\shardingsphere\test\sql\parser\parameterized\asserts\statement\distsql\rql\impl\rule\ShowDefaultShardingStrategyStatementAssert.java,0,8,0,12,0,20
 shardingsphere-master\shardingsphere-master\shardingsphere-proxy\shardingsphere-proxy-backend\src\main\java\org\apache\shardingsphere\proxy\backend\text\distsql\ral\common\convert\TrafficRuleConverter.java,0,22,2,18,0,42
 shardingsphere-master\shardingsphere-master\shardingsphere-features\shardingsphere-sharding\shardingsphere-sharding-core\src\test\java\org\apache\shardingsphere\sharding\route\engine\validator\ddl\ShardingDropTableStatementValidatorTest.java,0,59,0,45,0,104
 shardingsphere-master\shardingsphere-master\shardingsphere-infra\shardingsphere-infra-common\src\main\java\org\apache\shardingsphere\infra\database\metadata\dialect\MySQLDataSourceMetaData.java,0,27,0,12,0,39
 shardingsphere-master\shardingsphere-master\shardingsphere-jdbc\shardingsphere-jdbc-core\src\test\java\org\apache\shardingsphere\driver\jdbc\core\connection\ConnectionManagerTest.java,0,93,2,48,0,143
 shardingsphere-master\shardingsphere-master\shardingsphere-test\shardingsphere-parser-test\src\main\java\org\apache\shardingsphere\test\sql\parser\parameterized\jaxb\cases\domain\statement\dal\ShowEventsStatementTestCase.java,0,4,0,5,0,9
 shardingsphere-master\shardingsphere-master\shardingsphere-infra\shardingsphere-infra-common\src\main\java\org\apache\shardingsphere\infra\database\type\dialect\SQL92DatabaseType.java,0,8,0,3,0,11
 shardingsphere-master\shardingsphere-master\shardingsphere-test\shardingsphere-pipeline-test\src\test\java\org\apache\shardingsphere\data\pipeline\core\ingest\channel\memory\ManualBitSetTest.java,0,33,0,4,0,37
 shardingsphere-master\shardingsphere-master\shardingsphere-kernel\shardingsphere-data-pipeline\shardingsphere-data-pipeline-spi\src\main\java\org\apache\shardingsphere\data\pipeline\api\job\JobOperationType.java,0,7,0,1,0,8
 shardingsphere-master\shardingsphere-master\shardingsphere-db-protocol\shardingsphere-db-protocol-mysql\src\main\java\org\apache\shardingsphere\db\protocol\mysql\packet\binlog\row\column\value\decimal\MySQLFloatBinlogProtocolValue.java,0,3,0,6,0,9
 shardingsphere-master\shardingsphere-master\shardingsphere-features\shardingsphere-sharding\shardingsphere-sharding-distsql\shardingsphere-sharding-distsql-handler\src\main\java\org\apache\shardingsphere\scaling\distsql\handler\ShowScalingCheckAlgorithmsQueryResultSet.java,0,15,0,8,0,23
 shardingsphere-master\shardingsphere-master\examples\shardingsphere-jdbc-example\single-feature-example\cluster-mode-example\cluster-mode-spring-boot-mybatis-example\src\main\java\org\apache\shardingsphere\example\cluster\mode\spring\boot\mybatis\ClusterModeSpringBootMybatisExample.java,9,7,1,5,0,13
 shardingsphere-master\shardingsphere-master\shardingsphere-infra\shardingsphere-infra-binder\src\test\java\org\apache\shardingsphere\infra\binder\statement\ddl\CreateFunctionStatementContextTest.java,0,5,0,8,0,13
 shardingsphere-master\shardingsphere-master\shardingsphere-kernel\shardingsphere-data-pipeline\shardingsphere-data-pipeline-dialect\shardingsphere-data-pipeline-postgresql\src\test\java\org\apache\shardingsphere\data\pipeline\postgresql\ingest\wal\decode\TestDecodingPluginTest.java,0,35,0,23,0,58
 shardingsphere-master\shardingsphere-master\shardingsphere-spi\src\main\java\org\apache\shardingsphere\spi\ordered\cache\OrderedServicesCache.java,0,19,1,5,0,25
 shardingsphere-master\shardingsphere-master\shardingsphere-infra\shardingsphere-infra-rewrite\src\main\java\org\apache\shardingsphere\infra\rewrite\engine\result\GenericSQLRewriteResult.java,0,3,0,1,0,4
 shardingsphere-master\shardingsphere-master\shardingsphere-sql-parser\shardingsphere-sql-parser-dialect\shardingsphere-sql-parser-mysql\src\main\java\org\apache\shardingsphere\sql\parser\mysql\visitor\format\impl\MySQLDALFormatSQLVisitor.java,0,4,0,3,0,7
 shardingsphere-master\shardingsphere-master\shardingsphere-jdbc\shardingsphere-jdbc-core\src\test\java\org\apache\shardingsphere\driver\jdbc\unsupported\UnSupportedDatabaseMetaDataResultSetTest.java,0,52,1,3,0,56
 shardingsphere-master\shardingsphere-master\shardingsphere-test\shardingsphere-parser-test\src\main\java\org\apache\shardingsphere\test\sql\parser\parameterized\asserts\statement\distsql\rdl\drop\impl\DropShardingAlgorithmStatementAssert.java,0,7,0,10,0,17
 shardingsphere-master\shardingsphere-master\shardingsphere-proxy\shardingsphere-proxy-backend\src\main\java\org\apache\shardingsphere\proxy\backend\text\database\DropDatabaseBackendHandler.java,0,17,0,13,0,30
 shardingsphere-master\shardingsphere-master\shardingsphere-proxy\shardingsphere-proxy-backend\src\test\java\org\apache\shardingsphere\proxy\backend\communication\jdbc\recognizer\impl\H2RecognizerTest.java,0,8,0,4,0,12
 shardingsphere-master\shardingsphere-master\shardingsphere-infra\shardingsphere-infra-common\src\test\java\org\apache\shardingsphere\infra\metadata\schema\fixture\loader\DataNodeContainedFixtureRuleBasedTableMetaDataBuilder.java,0,9,0,9,0,18
 shardingsphere-master\shardingsphere-master\shardingsphere-mode\shardingsphere-mode-type\shardingsphere-cluster-mode\shardingsphere-cluster-mode-core\src\main\java\org\apache\shardingsphere\mode\manager\cluster\coordinator\lock\watcher\GlobalAckChangedWatcher.java,0,12,0,16,0,28
 shardingsphere-master\shardingsphere-master\shardingsphere-features\shardingsphere-sharding\shardingsphere-sharding-distsql\shardingsphere-sharding-distsql-handler\src\main\java\org\apache\shardingsphere\sharding\distsql\handler\enums\ShardingStrategyType.java,0,52,2,34,0,88
 shardingsphere-master\shardingsphere-master\shardingsphere-test\shardingsphere-parser-test\src\main\java\org\apache\shardingsphere\test\sql\parser\parameterized\jaxb\cases\domain\statement\ddl\CreateSequenceStatementTestCase.java,0,0,0,3,0,3
 shardingsphere-master\shardingsphere-master\shardingsphere-proxy\shardingsphere-proxy-backend\src\main\java\org\apache\shardingsphere\proxy\backend\text\data\impl\UnicastDatabaseBackendHandler.java,0,29,0,19,0,48
 shardingsphere-master\shardingsphere-master\shardingsphere-proxy\shardingsphere-proxy-backend\src\test\java\org\apache\shardingsphere\proxy\backend\text\admin\mysql\executor\ShowConnectionIdExecutorTest.java,0,7,0,2,0,9
 shardingsphere-master\shardingsphere-master\shardingsphere-sql-parser\shardingsphere-sql-parser-statement\src\main\java\org\apache\shardingsphere\sql\parser\sql\common\statement\SQLStatement.java,0,1,0,1,0,2
 shardingsphere-master\shardingsphere-master\shardingsphere-infra\shardingsphere-infra-executor\src\test\java\org\apache\shardingsphere\infra\executor\sql\execute\engine\ExecutorExceptionHandlerTest.java,0,12,1,4,0,17
 shardingsphere-master\shardingsphere-master\shardingsphere-sql-parser\shardingsphere-sql-parser-dialect\shardingsphere-sql-parser-postgresql\src\main\java\org\apache\shardingsphere\sql\parser\postgresql\visitor\statement\impl\PostgreSQLDMLStatementSQLVisitor.java,0,6,0,9,0,15
 shardingsphere-master\shardingsphere-master\shardingsphere-db-protocol\shardingsphere-db-protocol-mysql\src\test\java\org\apache\shardingsphere\db\protocol\mysql\packet\binlog\row\column\value\integer\MySQLShortBinlogProtocolValueTest.java,0,9,0,4,0,13
 shardingsphere-master\shardingsphere-master\shardingsphere-test\shardingsphere-parser-test\src\main\java\org\apache\shardingsphere\test\sql\parser\parameterized\asserts\value\IdentifierValueAssert.java,0,10,0,11,0,21
 shardingsphere-master\shardingsphere-master\shardingsphere-proxy\shardingsphere-proxy-backend\src\main\java\org\apache\shardingsphere\proxy\backend\communication\ProxySQLExecutor.java,0,68,0,68,0,136
 shardingsphere-master\shardingsphere-master\shardingsphere-proxy\shardingsphere-proxy-backend\src\main\java\org\apache\shardingsphere\proxy\backend\communication\TransactionManager.java,0,6,0,1,0,7
 shardingsphere-master\shardingsphere-master\shardingsphere-kernel\shardingsphere-data-pipeline\shardingsphere-data-pipeline-dialect\shardingsphere-data-pipeline-postgresql\src\test\java\org\apache\shardingsphere\data\pipeline\postgresql\ingest\PostgreSQLWalDumperTest.java,0,43,0,28,0,71
 shardingsphere-master\shardingsphere-master\shardingsphere-sql-parser\shardingsphere-sql-parser-engine\src\test\java\org\apache\shardingsphere\sql\parser\fixture\ParserFixture.java,0,7,0,1,0,8
 shardingsphere-master\shardingsphere-master\shardingsphere-features\shardingsphere-sharding\shardingsphere-sharding-core\src\main\java\org\apache\shardingsphere\sharding\checker\AlgorithmProvidedShardingRuleConfigurationChecker.java,0,6,0,5,0,11
 shardingsphere-master\shardingsphere-master\shardingsphere-infra\shardingsphere-infra-common\src\main\java\org\apache\shardingsphere\infra\datasource\pool\metadata\DataSourcePoolFieldMetaData.java,0,5,0,1,0,6
 shardingsphere-master\shardingsphere-master\shardingsphere-test\shardingsphere-parser-test\src\main\java\org\apache\shardingsphere\test\sql\parser\parameterized\asserts\statement\distsql\rdl\drop\impl\DropEncryptRuleStatementAssert.java,0,7,0,10,0,17
 shardingsphere-master\shardingsphere-master\shardingsphere-infra\shardingsphere-infra-route\src\test\java\org\apache\shardingsphere\infra\route\context\RouteUnitTest.java,0,23,0,4,0,27
 shardingsphere-master\shardingsphere-master\shardingsphere-kernel\shardingsphere-transaction\shardingsphere-transaction-type\shardingsphere-transaction-xa\shardingsphere-transaction-xa-core\src\test\java\org\apache\shardingsphere\transaction\xa\jta\datasource\XATransactionDataSourceTest.java,0,34,0,18,0,52
 shardingsphere-master\shardingsphere-master\shardingsphere-db-protocol\shardingsphere-db-protocol-mysql\src\main\java\org\apache\shardingsphere\db\protocol\mysql\packet\command\query\binary\execute\protocol\MySQLBinaryProtocolValue.java,0,4,0,3,0,7
 shardingsphere-master\shardingsphere-master\shardingsphere-sql-parser\shardingsphere-sql-parser-statement\src\main\java\org\apache\shardingsphere\sql\parser\sql\common\statement\ddl\CreateTableStatement.java,9,9,1,8,4,22
 shardingsphere-master\shardingsphere-master\shardingsphere-db-protocol\shardingsphere-db-protocol-mysql\src\main\java\org\apache\shardingsphere\db\protocol\mysql\packet\command\binlog\MySQLComRegisterSlaveCommandPacket.java,0,28,0,7,0,35
 shardingsphere-master\shardingsphere-master\shardingsphere-spi\src\test\java\org\apache\shardingsphere\spi\ordered\cache\OrderedServicesCacheTest.java,0,18,1,11,0,30
 shardingsphere-master\shardingsphere-master\shardingsphere-kernel\shardingsphere-authority\shardingsphere-authority-core\src\test\java\org\apache\shardingsphere\authority\rule\AuthorityRuleTest.java,0,7,0,6,0,13
 shardingsphere-master\shardingsphere-master\shardingsphere-test\shardingsphere-parser-test\src\main\java\org\apache\shardingsphere\test\sql\parser\parameterized\asserts\statement\dcl\impl\SetRoleStatementAssert.java,0,4,1,6,0,11
 shardingsphere-master\shardingsphere-master\shardingsphere-mode\shardingsphere-mode-type\shardingsphere-cluster-mode\shardingsphere-cluster-mode-repository\shardingsphere-cluster-mode-repository-provider\shardingsphere-cluster-mode-repository-zookeeper-curator\src\main\java\org\apache\shardingsphere\mode\repository\cluster\zookeeper\CuratorZookeeperRepository.java,0,63,0,35,0,98
 shardingsphere-master\shardingsphere-master\shardingsphere-proxy\shardingsphere-proxy-backend\src\test\java\org\apache\shardingsphere\proxy\backend\communication\DatabaseCommunicationEngineFactoryTest.java,0,26,1,20,0,47
 shardingsphere-master\shardingsphere-master\shardingsphere-agent\shardingsphere-agent-plugins\shardingsphere-agent-plugin-metrics\shardingsphere-agent-metrics-api\src\test\java\org\apache\shardingsphere\agent\metrics\api\advice\MetricsAdviceBaseTest.java,8,2,0,2,0,4
 shardingsphere-master\shardingsphere-master\shardingsphere-proxy\shardingsphere-proxy-bootstrap\src\test\java\org\apache\shardingsphere\proxy\fixture\RuleConfigurationFixture.java,0,3,0,3,0,6
 shardingsphere-master\shardingsphere-master\shardingsphere-agent\shardingsphere-agent-plugins\shardingsphere-agent-plugin-metrics\shardingsphere-agent-metrics-api\src\test\java\org\apache\shardingsphere\agent\metrics\api\advice\SQLParserEngineAdviceTest.java,0,30,0,20,0,50
 shardingsphere-master\shardingsphere-master\shardingsphere-test\shardingsphere-parser-test\src\main\java\org\apache\shardingsphere\test\sql\parser\parameterized\jaxb\cases\domain\statement\ddl\AlterServiceStatementTestCase.java,0,0,0,3,0,3
 shardingsphere-master\shardingsphere-master\shardingsphere-sql-parser\shardingsphere-sql-parser-statement\src\main\java\org\apache\shardingsphere\sql\parser\sql\dialect\statement\postgresql\dal\PostgreSQLAnalyzeTableStatement.java,0,2,0,5,0,7
 shardingsphere-master\shardingsphere-master\shardingsphere-features\shardingsphere-sharding\shardingsphere-sharding-distsql\shardingsphere-sharding-distsql-handler\src\test\java\org\apache\shardingsphere\sharding\distsql\query\ShardingTableRuleQueryResultSetTest.java,0,32,0,23,0,55
 shardingsphere-master\shardingsphere-master\shardingsphere-db-protocol\shardingsphere-db-protocol-mysql\src\test\java\org\apache\shardingsphere\db\protocol\mysql\packet\binlog\row\column\value\MySQLBinlogProtocolValueFactoryTest.java,0,7,0,6,0,13
 shardingsphere-master\shardingsphere-master\shardingsphere-kernel\shardingsphere-transaction\shardingsphere-transaction-type\shardingsphere-transaction-xa\shardingsphere-transaction-xa-core\src\main\java\org\apache\shardingsphere\transaction\xa\XAShardingSphereTransactionManager.java,0,24,0,16,0,40
 shardingsphere-master\shardingsphere-master\shardingsphere-test\shardingsphere-parser-test\src\main\java\org\apache\shardingsphere\test\sql\parser\parameterized\asserts\segment\distsql\AutoTableRuleAssert.java,0,14,0,17,0,31
 shardingsphere-master\shardingsphere-master\shardingsphere-features\shardingsphere-shadow\shardingsphere-shadow-core\src\main\java\org\apache\shardingsphere\shadow\algorithm\shadow\validator\column\ShadowEnumValueValidator.java,0,3,0,5,0,8
 shardingsphere-master\shardingsphere-master\shardingsphere-sql-parser\shardingsphere-sql-parser-statement\src\main\java\org\apache\shardingsphere\sql\parser\sql\dialect\statement\opengauss\ddl\OpenGaussCreateRuleStatement.java,0,1,0,5,0,6
 shardingsphere-master\shardingsphere-master\shardingsphere-infra\shardingsphere-infra-binder\src\main\java\org\apache\shardingsphere\infra\binder\statement\ddl\CreateIndexStatementContext.java,0,15,0,13,0,28
 shardingsphere-master\shardingsphere-master\shardingsphere-kernel\shardingsphere-data-pipeline\shardingsphere-data-pipeline-spi\src\test\java\org\apache\shardingsphere\data\pipeline\api\datasource\config\impl\ShardingSpherePipelineDataSourceConfigurationTest.java,0,17,0,14,0,31
 shardingsphere-master\shardingsphere-master\shardingsphere-mode\shardingsphere-mode-type\shardingsphere-cluster-mode\shardingsphere-cluster-mode-repository\shardingsphere-cluster-mode-repository-provider\shardingsphere-cluster-mode-repository-etcd\src\test\java\org\apache\shardingsphere\mode\repository\cluster\etcd\EtcdRepositoryTest.java,0,97,0,32,0,129
 shardingsphere-master\shardingsphere-master\shardingsphere-sql-parser\shardingsphere-sql-parser-statement\src\main\java\org\apache\shardingsphere\sql\parser\sql\dialect\statement\opengauss\ddl\OpenGaussCreateTextSearchStatement.java,0,1,0,5,0,6
 shardingsphere-master\shardingsphere-master\shardingsphere-sql-parser\shardingsphere-sql-parser-statement\src\test\java\org\apache\shardingsphere\sql\parser\sql\common\constant\LogicalOperatorTest.java,0,16,0,7,0,23
 shardingsphere-master\shardingsphere-master\shardingsphere-sql-parser\shardingsphere-sql-parser-statement\src\main\java\org\apache\shardingsphere\sql\parser\sql\dialect\statement\mysql\dal\MySQLShowProcedureCodeStatement.java,0,3,0,6,2,11
 shardingsphere-master\shardingsphere-master\shardingsphere-db-protocol\shardingsphere-db-protocol-mysql\src\main\java\org\apache\shardingsphere\db\protocol\mysql\constant\MySQLNewParametersBoundFlag.java,0,11,0,3,0,14
 shardingsphere-master\shardingsphere-master\shardingsphere-features\shardingsphere-encrypt\shardingsphere-encrypt-core\src\test\java\org\apache\shardingsphere\encrypt\rule\EncryptColumnDataTypeTest.java,0,13,0,5,0,18
 shardingsphere-master\shardingsphere-master\shardingsphere-features\shardingsphere-sharding\shardingsphere-sharding-core\src\main\java\org\apache\shardingsphere\sharding\route\engine\validator\ddl\impl\ShardingCreateTableStatementValidator.java,0,14,0,14,0,28
 shardingsphere-master\shardingsphere-master\shardingsphere-kernel\shardingsphere-transaction\shardingsphere-transaction-core\src\main\java\org\apache\shardingsphere\transaction\constant\TransactionOrder.java,0,3,0,1,0,4
 shardingsphere-master\shardingsphere-master\shardingsphere-sql-parser\shardingsphere-sql-parser-statement\src\main\java\org\apache\shardingsphere\sql\parser\sql\dialect\statement\mysql\segment\CloneInstanceSegment.java,0,14,0,2,0,16
 shardingsphere-master\shardingsphere-master\shardingsphere-test\shardingsphere-parser-test\src\main\java\org\apache\shardingsphere\test\sql\parser\parameterized\jaxb\cases\domain\statement\dcl\DropLoginStatementTestCase.java,0,0,0,3,0,3
 shardingsphere-master\shardingsphere-master\shardingsphere-test\shardingsphere-parser-test\src\main\java\org\apache\shardingsphere\test\sql\parser\parameterized\jaxb\cases\domain\statement\ddl\RenameStatementTestCase.java,0,0,0,3,0,3
 shardingsphere-master\shardingsphere-master\shardingsphere-test\shardingsphere-parser-test\src\main\java\org\apache\shardingsphere\test\sql\parser\parameterized\jaxb\cases\domain\segment\impl\definition\ExpectedAddColumnDefinition.java,0,7,0,5,0,12
 shardingsphere-master\shardingsphere-master\shardingsphere-distsql\shardingsphere-distsql-statement\src\main\java\org\apache\shardingsphere\distsql\parser\statement\rdl\drop\DropDefaultSingleTableRuleStatement.java,0,5,0,3,0,8
 shardingsphere-master\shardingsphere-master\shardingsphere-sql-parser\shardingsphere-sql-parser-statement\src\main\java\org\apache\shardingsphere\sql\parser\sql\common\statement\ddl\DropCollationStatement.java,3,1,1,3,0,5
 shardingsphere-master\shardingsphere-master\shardingsphere-features\shardingsphere-sharding\shardingsphere-sharding-distsql\shardingsphere-sharding-distsql-statement\src\main\java\org\apache\shardingsphere\scaling\distsql\statement\ShowScalingListStatement.java,0,1,0,3,0,4
 shardingsphere-master\shardingsphere-master\shardingsphere-infra\shardingsphere-infra-federation\shardingsphere-infra-federation-optimizer\src\main\java\org\apache\shardingsphere\infra\federation\optimizer\converter\segment\from\impl\SimpleTableConverter.java,0,11,0,17,0,28
 shardingsphere-master\shardingsphere-master\shardingsphere-features\shardingsphere-readwrite-splitting\shardingsphere-readwrite-splitting-core\src\test\java\org\apache\shardingsphere\readwritesplitting\algorithm\loadbalance\WeightReplicaLoadBalanceAlgorithmTest.java,0,12,0,7,0,19
 shardingsphere-master\shardingsphere-master\shardingsphere-sql-parser\shardingsphere-sql-parser-dialect\shardingsphere-sql-parser-mysql\src\main\java\org\apache\shardingsphere\sql\parser\mysql\visitor\format\impl\MySQLFormatSQLVisitor.java,824,134,5,64,0,203
 shardingsphere-master\shardingsphere-master\shardingsphere-features\shardingsphere-sharding\shardingsphere-sharding-core\src\main\java\org\apache\shardingsphere\sharding\merge\dal\show\ShowTableStatusMergedResult.java,0,37,0,17,0,54
 shardingsphere-master\shardingsphere-master\shardingsphere-features\shardingsphere-db-discovery\shardingsphere-db-discovery-distsql\shardingsphere-db-discovery-distsql-handler\src\main\java\org\apache\shardingsphere\dbdiscovery\distsql\handler\query\DatabaseDiscoveryTypeQueryResultSet.java,0,14,0,11,0,25
 shardingsphere-master\shardingsphere-master\shardingsphere-jdbc\shardingsphere-jdbc-core\src\main\java\org\apache\shardingsphere\driver\jdbc\core\statement\StatementManager.java,0,24,1,16,0,41
 shardingsphere-master\shardingsphere-master\shardingsphere-features\shardingsphere-sharding\shardingsphere-sharding-core\src\test\java\org\apache\shardingsphere\sharding\rewrite\token\pojo\GeneratedKeyAssignmentTokenTest.java,0,21,0,11,0,32
 shardingsphere-master\shardingsphere-master\shardingsphere-sql-parser\shardingsphere-sql-parser-statement\src\main\java\org\apache\shardingsphere\sql\parser\sql\common\segment\ddl\constraint\alter\ValidateConstraintDefinitionSegment.java,0,7,0,5,0,12
 shardingsphere-master\shardingsphere-master\shardingsphere-sql-parser\shardingsphere-sql-parser-statement\src\main\java\org\apache\shardingsphere\sql\parser\sql\dialect\statement\mysql\dal\MySQLShowTablesStatement.java,0,8,0,7,1,16
 shardingsphere-master\shardingsphere-master\shardingsphere-proxy\shardingsphere-proxy-backend\src\test\java\org\apache\shardingsphere\proxy\backend\text\distsql\DistSQLBackendHandlerFactoryTest.java,0,101,1,76,0,178
 shardingsphere-master\shardingsphere-master\shardingsphere-db-protocol\shardingsphere-db-protocol-mysql\src\main\java\org\apache\shardingsphere\db\protocol\mysql\packet\command\query\binary\execute\protocol\MySQLFloatBinaryProtocolValue.java,0,3,0,3,0,6
 shardingsphere-master\shardingsphere-master\shardingsphere-sql-parser\shardingsphere-sql-parser-dialect\shardingsphere-sql-parser-sql92\src\main\java\org\apache\shardingsphere\sql\parser\sql92\visitor\statement\facade\SQL92StatementSQLVisitorFacade.java,0,9,0,6,0,15
 shardingsphere-master\shardingsphere-master\shardingsphere-features\shardingsphere-db-discovery\shardingsphere-db-discovery-core\src\test\java\org\apache\shardingsphere\dbdiscovery\yaml\swapper\DatabaseDiscoveryRuleConfigurationYamlSwapperTest.java,0,46,0,37,0,83
 shardingsphere-master\shardingsphere-master\shardingsphere-test\shardingsphere-parser-test\src\main\java\org\apache\shardingsphere\test\sql\parser\parameterized\asserts\statement\dal\impl\MySQLOptimizeTableStatementAssert.java,0,6,0,9,0,15
 shardingsphere-master\shardingsphere-master\shardingsphere-sql-parser\shardingsphere-sql-parser-statement\src\test\java\org\apache\shardingsphere\sql\parser\sql\common\value\identifier\IdentifierValueTest.java,0,12,0,5,0,17
 shardingsphere-master\shardingsphere-master\examples\shardingsphere-example-generator\src\main\java\org\apache\shardingsphere\example\generator\scenario\framework\type\SpringNamespaceMyBatisExampleScenario.java,0,14,0,10,0,24
 shardingsphere-master\shardingsphere-master\shardingsphere-features\shardingsphere-shadow\shardingsphere-shadow-core\src\main\java\org\apache\shardingsphere\shadow\checker\AlgorithmProvidedShadowRuleConfigurationChecker.java,0,10,0,11,0,21
 shardingsphere-master\shardingsphere-master\shardingsphere-proxy\shardingsphere-proxy-backend\src\main\java\org\apache\shardingsphere\proxy\backend\text\admin\executor\AbstractDatabaseMetadataExecutor.java,186,59,5,36,0,100
 shardingsphere-master\shardingsphere-master\examples\shardingsphere-example-generator\src\main\java\org\apache\shardingsphere\example\generator\scenario\feature\type\ReadwriteSplittingExampleScenario.java,0,6,0,3,0,9
 shardingsphere-master\shardingsphere-master\shardingsphere-features\shardingsphere-shadow\shardingsphere-shadow-distsql\shardingsphere-shadow-distsql-handler\src\main\java\org\apache\shardingsphere\shadow\distsql\handler\converter\ShadowRuleStatementConverter.java,0,22,0,21,0,43
 shardingsphere-master\shardingsphere-master\shardingsphere-features\shardingsphere-sharding\shardingsphere-sharding-core\src\main\java\org\apache\shardingsphere\sharding\route\engine\type\broadcast\ShardingDatabaseBroadcastRoutingEngine.java,0,4,0,3,0,7
 shardingsphere-master\shardingsphere-master\shardingsphere-db-protocol\shardingsphere-db-protocol-mysql\src\test\java\org\apache\shardingsphere\db\protocol\mysql\constant\MySQLStatusFlagTest.java,0,9,0,3,0,12
 shardingsphere-master\shardingsphere-master\shardingsphere-sql-parser\shardingsphere-sql-parser-statement\src\main\java\org\apache\shardingsphere\sql\parser\sql\common\segment\tcl\ImplicitTransactionsSegment.java,0,6,0,1,0,7
 shardingsphere-master\shardingsphere-master\shardingsphere-distsql\shardingsphere-distsql-statement\src\main\java\org\apache\shardingsphere\distsql\parser\statement\ral\advanced\PreviewStatement.java,0,2,0,2,0,4
 shardingsphere-master\shardingsphere-master\shardingsphere-mode\shardingsphere-mode-core\src\main\java\org\apache\shardingsphere\mode\metadata\MetaDataContextsBuilder.java,0,48,0,24,0,72
 shardingsphere-master\shardingsphere-master\shardingsphere-test\shardingsphere-parser-test\src\main\java\org\apache\shardingsphere\test\sql\parser\parameterized\jaxb\cases\domain\statement\dal\ShowRelaylogEventsStatementTestCase.java,0,5,0,4,0,9
 shardingsphere-master\shardingsphere-master\shardingsphere-features\shardingsphere-sharding\shardingsphere-sharding-core\src\main\java\org\apache\shardingsphere\sharding\route\engine\validator\ShardingStatementValidatorFactory.java,0,9,0,40,0,49
 shardingsphere-master\shardingsphere-master\shardingsphere-proxy\shardingsphere-proxy-backend\src\main\java\org\apache\shardingsphere\proxy\backend\exception\UnknownDatabaseException.java,0,3,0,1,0,4
 shardingsphere-master\shardingsphere-master\shardingsphere-jdbc\shardingsphere-jdbc-core\src\test\java\org\apache\shardingsphere\driver\jdbc\core\resultset\ShardingSphereResultSetTest.java,0,245,19,82,0,346
 shardingsphere-master\shardingsphere-master\shardingsphere-db-protocol\shardingsphere-db-protocol-mysql\src\main\java\org\apache\shardingsphere\db\protocol\mysql\packet\command\query\binary\execute\protocol\MySQLStringLenencBinaryProtocolValue.java,0,3,0,3,0,6
 shardingsphere-master\shardingsphere-master\shardingsphere-infra\shardingsphere-infra-merge\src\main\java\org\apache\shardingsphere\infra\merge\engine\decorator\ResultDecorator.java,0,7,0,4,0,11
 shardingsphere-master\shardingsphere-master\shardingsphere-features\shardingsphere-db-discovery\shardingsphere-db-discovery-spring\shardingsphere-db-discovery-spring-namespace\src\main\java\org\apache\shardingsphere\dbdiscovery\spring\namespace\handler\DatabaseDiscoveryNamespaceHandler.java,0,5,0,9,0,14
 shardingsphere-master\shardingsphere-master\shardingsphere-test\shardingsphere-parser-test\src\main\java\org\apache\shardingsphere\test\sql\parser\parameterized\asserts\statement\dal\impl\MySQLDropResourceGroupStatementAssert.java,0,5,0,8,0,13
 shardingsphere-master\shardingsphere-master\shardingsphere-db-protocol\shardingsphere-db-protocol-mysql\src\test\java\org\apache\shardingsphere\db\protocol\mysql\payload\MySQLPacketPayloadTest.java,0,148,6,39,0,193
 shardingsphere-master\shardingsphere-master\shardingsphere-infra\shardingsphere-infra-binder\src\main\java\org\apache\shardingsphere\infra\binder\statement\ddl\TruncateStatementContext.java,0,7,0,6,0,13
 shardingsphere-master\shardingsphere-master\shardingsphere-test\shardingsphere-parser-test\src\main\java\org\apache\shardingsphere\test\sql\parser\parameterized\jaxb\cases\domain\statement\distsql\ral\ClearHintStatementTestCase.java,0,0,0,3,0,3
 shardingsphere-master\shardingsphere-master\shardingsphere-sql-parser\shardingsphere-sql-parser-statement\src\main\java\org\apache\shardingsphere\sql\parser\sql\dialect\statement\opengauss\dal\OpenGaussSetStatement.java,0,1,0,5,0,6
 shardingsphere-master\shardingsphere-master\shardingsphere-sql-parser\shardingsphere-sql-parser-statement\src\main\java\org\apache\shardingsphere\sql\parser\sql\dialect\statement\mysql\dml\MySQLSelectStatement.java,0,12,0,8,1,21
 shardingsphere-master\shardingsphere-master\shardingsphere-test\shardingsphere-integration-test\shardingsphere-integration-test-fixture\src\test\java\org\apache\shardingsphere\test\integration\fixture\StandardModuloAlgorithm.java,0,14,1,11,0,26
 shardingsphere-master\shardingsphere-master\shardingsphere-kernel\shardingsphere-data-pipeline\shardingsphere-data-pipeline-core\src\main\java\org\apache\shardingsphere\data\pipeline\scenario\rulealtered\RuleAlteredJobProgressDetector.java,0,7,0,6,0,13
 shardingsphere-master\shardingsphere-master\shardingsphere-sql-parser\shardingsphere-sql-parser-spi\src\main\java\org\apache\shardingsphere\sql\parser\api\visitor\ASTNode.java,0,1,0,1,0,2
 shardingsphere-master\shardingsphere-master\shardingsphere-db-protocol\shardingsphere-db-protocol-postgresql\src\test\java\org\apache\shardingsphere\db\protocol\postgresql\packet\command\query\PostgreSQLNoDataPacketTest.java,0,3,0,2,0,5
 shardingsphere-master\shardingsphere-master\shardingsphere-proxy\shardingsphere-proxy-frontend\shardingsphere-proxy-frontend-reactive-core\src\main\java\org\apache\shardingsphere\proxy\frontend\reactive\wrap\WrappedReactiveCommandExecutor.java,0,6,0,4,0,10
 shardingsphere-master\shardingsphere-master\shardingsphere-test\shardingsphere-parser-test\src\main\java\org\apache\shardingsphere\test\sql\parser\parameterized\jaxb\cases\domain\segment\impl\login\ExpectedLogin.java,0,1,0,3,0,4
 shardingsphere-master\shardingsphere-master\shardingsphere-jdbc\shardingsphere-jdbc-spring\shardingsphere-jdbc-spring-infra\shardingsphere-jdbc-spring-boot-starter-infra\src\test\java\org\apache\shardingsphere\spring\boot\converter\StringToNoneShardingStrategyConfigurationConverterTest.java,0,5,0,4,0,9
 shardingsphere-master\shardingsphere-master\shardingsphere-kernel\shardingsphere-traffic\shardingsphere-traffic-core\src\test\java\org\apache\shardingsphere\traffic\algorithm\engine\TrafficEngineTest.java,0,34,0,16,0,50
 shardingsphere-master\shardingsphere-master\shardingsphere-test\shardingsphere-parser-test\src\main\java\org\apache\shardingsphere\test\sql\parser\parameterized\asserts\statement\distsql\ral\impl\advanced\PreviewStatementAssert.java,0,5,1,8,0,14
 shardingsphere-master\shardingsphere-master\shardingsphere-mode\shardingsphere-mode-type\shardingsphere-memory-mode\shardingsphere-memory-mode-core\src\main\java\org\apache\shardingsphere\mode\manager\memory\workerid\generator\MemoryWorkerIdGenerator.java,0,2,0,1,0,3
 shardingsphere-master\shardingsphere-master\shardingsphere-mode\shardingsphere-mode-type\shardingsphere-cluster-mode\shardingsphere-cluster-mode-core\src\main\java\org\apache\shardingsphere\mode\manager\cluster\coordinator\registry\config\event\props\PropertiesChangedEvent.java,0,3,0,3,0,6
 shardingsphere-master\shardingsphere-master\shardingsphere-kernel\shardingsphere-single-table\shardingsphere-single-table-core\src\main\java\org\apache\shardingsphere\singletable\rule\SingleTableDataNodeLoader.java,0,16,2,13,0,31
 shardingsphere-master\shardingsphere-master\shardingsphere-jdbc\shardingsphere-jdbc-core\src\test\java\org\apache\shardingsphere\driver\jdbc\adapter\StatementAdapterTest.java,0,86,19,27,0,132
 shardingsphere-master\shardingsphere-master\shardingsphere-kernel\shardingsphere-transaction\shardingsphere-transaction-type\shardingsphere-transaction-xa\shardingsphere-transaction-xa-core\src\main\java\org\apache\shardingsphere\transaction\xa\jta\datasource\properties\XADataSourceDefinitionFactory.java,0,9,0,4,0,13
 shardingsphere-master\shardingsphere-master\shardingsphere-test\shardingsphere-pipeline-test\src\test\java\org\apache\shardingsphere\data\pipeline\core\util\PipelineContextUtil.java,0,40,1,29,0,70
 shardingsphere-master\shardingsphere-master\shardingsphere-features\shardingsphere-encrypt\shardingsphere-encrypt-core\src\main\java\org\apache\shardingsphere\encrypt\rewrite\token\generator\EncryptPredicateRightValueTokenGenerator.java,0,45,0,31,0,76
 shardingsphere-master\shardingsphere-master\shardingsphere-kernel\shardingsphere-data-pipeline\shardingsphere-data-pipeline-core\src\main\java\org\apache\shardingsphere\data\pipeline\core\registry\CoordinatorRegistryCenterInitializer.java,0,18,0,21,0,39
 shardingsphere-master\shardingsphere-master\shardingsphere-test\shardingsphere-parser-test\src\main\java\org\apache\shardingsphere\test\sql\parser\parameterized\jaxb\cases\domain\statement\distsql\rdl\create\CreateDatabaseDiscoveryHeartbeatStatementTestCase.java,0,4,0,6,0,10
 shardingsphere-master\shardingsphere-master\shardingsphere-test\shardingsphere-integration-test\shardingsphere-integration-test-suite\src\test\java\org\apache\shardingsphere\test\integration\engine\dml\BaseDMLIT.java,82,35,0,30,0,65
 shardingsphere-master\shardingsphere-master\shardingsphere-distsql\shardingsphere-distsql-statement\src\main\java\org\apache\shardingsphere\distsql\parser\statement\rql\RQLStatement.java,3,1,1,1,0,3
 shardingsphere-master\shardingsphere-master\shardingsphere-features\shardingsphere-encrypt\shardingsphere-encrypt-core\src\main\java\org\apache\shardingsphere\encrypt\rewrite\condition\EncryptConditionEngine.java,0,47,1,42,0,90
 shardingsphere-master\shardingsphere-master\shardingsphere-features\shardingsphere-sharding\shardingsphere-sharding-distsql\shardingsphere-sharding-distsql-statement\src\main\java\org\apache\shardingsphere\sharding\distsql\parser\segment\ShardingStrategySegment.java,0,7,0,1,0,8
 shardingsphere-master\shardingsphere-master\shardingsphere-infra\shardingsphere-infra-context\src\test\java\org\apache\shardingsphere\infra\context\refresher\type\DummyDropDatabaseMetaDataRefresher.java,0,6,0,7,0,13
 shardingsphere-master\shardingsphere-master\shardingsphere-sql-parser\shardingsphere-sql-parser-statement\src\main\java\org\apache\shardingsphere\sql\parser\sql\dialect\statement\mysql\dal\MySQLCreateLoadableFunctionStatement.java,0,1,0,5,0,6
 shardingsphere-master\shardingsphere-master\shardingsphere-sql-parser\shardingsphere-sql-parser-statement\src\main\java\org\apache\shardingsphere\sql\parser\sql\common\segment\generic\GrantLevelSegment.java,0,8,0,1,0,9
 shardingsphere-master\shardingsphere-master\shardingsphere-jdbc\shardingsphere-jdbc-core\src\main\java\org\apache\shardingsphere\driver\jdbc\adapter\executor\ForceExecuteTemplate.java,0,5,0,3,0,8
 shardingsphere-master\shardingsphere-master\shardingsphere-features\shardingsphere-sharding\shardingsphere-sharding-core\src\main\java\org\apache\shardingsphere\sharding\merge\dql\groupby\GroupByMemoryMergedResult.java,0,60,0,53,0,113
 shardingsphere-master\shardingsphere-master\shardingsphere-proxy\shardingsphere-proxy-frontend\shardingsphere-proxy-frontend-postgresql\src\main\java\org\apache\shardingsphere\proxy\frontend\postgresql\command\query\extended\PostgreSQLAggregatedBatchedStatementsCommandExecutor.java,0,17,0,23,0,40
 shardingsphere-master\shardingsphere-master\shardingsphere-infra\shardingsphere-infra-common\src\main\java\org\apache\shardingsphere\infra\metadata\schema\builder\spi\RuleBasedTableMetaDataBuilder.java,0,10,0,8,0,18
 shardingsphere-master\shardingsphere-master\shardingsphere-sql-parser\shardingsphere-sql-parser-statement\src\test\java\org\apache\shardingsphere\sql\parser\sql\common\util\SQLUtilTest.java,0,87,0,44,0,131
 shardingsphere-master\shardingsphere-master\shardingsphere-db-protocol\shardingsphere-db-protocol-postgresql\src\main\java\org\apache\shardingsphere\db\protocol\postgresql\packet\command\query\PostgreSQLRowDescriptionPacket.java,0,7,0,6,0,13
 shardingsphere-master\shardingsphere-master\shardingsphere-spi\src\main\java\org\apache\shardingsphere\spi\exception\ServiceLoaderInstantiationException.java,0,7,0,4,0,11
 shardingsphere-master\shardingsphere-master\shardingsphere-proxy\shardingsphere-proxy-backend\src\test\java\org\apache\shardingsphere\proxy\backend\text\admin\mysql\executor\ShowTablesExecutorTest.java,0,71,1,52,0,124
 shardingsphere-master\shardingsphere-master\shardingsphere-infra\shardingsphere-infra-binder\src\test\java\org\apache\shardingsphere\infra\binder\statement\impl\InsertStatementContextTest.java,0,157,0,101,0,258
 shardingsphere-master\shardingsphere-master\shardingsphere-features\shardingsphere-shadow\shardingsphere-shadow-distsql\shardingsphere-shadow-distsql-statement\src\main\java\org\apache\shardingsphere\shadow\distsql\parser\statement\ShowShadowRulesStatement.java,0,5,0,4,0,9
 shardingsphere-master\shardingsphere-master\examples\shardingsphere-jdbc-example\single-feature-example\extension-example\custom-sharding-algortihm-example\class-based-sharding-algorithm-example\class-based-sharding-spring-namespace-mybatis-example\src\main\java\org\apache\shardingsphere\example\extension\classbased\sharding\spring\namespace\mybatis\fixture\ClassBasedDatasourceStandardShardingAlgorithmFixture.java,0,17,0,11,0,28
 shardingsphere-master\shardingsphere-master\shardingsphere-sql-parser\shardingsphere-sql-parser-statement\src\main\java\org\apache\shardingsphere\sql\parser\sql\dialect\statement\postgresql\dcl\PostgreSQLRevokeStatement.java,0,1,0,5,0,6
 shardingsphere-master\shardingsphere-master\shardingsphere-features\shardingsphere-encrypt\shardingsphere-encrypt-core\src\main\java\org\apache\shardingsphere\encrypt\rule\aware\EncryptRuleAware.java,0,3,0,1,0,4
 shardingsphere-master\shardingsphere-master\shardingsphere-distsql\shardingsphere-distsql-statement\src\main\java\org\apache\shardingsphere\distsql\parser\statement\ral\AdvancedDistSQLStatement.java,3,1,1,1,0,3
 shardingsphere-master\shardingsphere-master\shardingsphere-features\shardingsphere-sharding\shardingsphere-sharding-core\src\main\java\org\apache\shardingsphere\sharding\route\engine\ShardingSQLRouter.java,0,22,0,24,0,46
 shardingsphere-master\shardingsphere-master\shardingsphere-sql-parser\shardingsphere-sql-parser-statement\src\main\java\org\apache\shardingsphere\sql\parser\sql\common\value\ValueASTNode.java,0,3,0,1,0,4
 shardingsphere-master\shardingsphere-master\shardingsphere-kernel\shardingsphere-data-pipeline\shardingsphere-data-pipeline-dialect\shardingsphere-data-pipeline-mysql\src\main\java\org\apache\shardingsphere\data\pipeline\mysql\ingest\binlog\event\DeleteRowsEvent.java,0,2,0,1,0,3
 shardingsphere-master\shardingsphere-master\shardingsphere-features\shardingsphere-encrypt\shardingsphere-encrypt-core\src\test\java\org\apache\shardingsphere\encrypt\rewrite\impl\EncryptInConditionTest.java,0,4,0,6,0,10
 shardingsphere-master\shardingsphere-master\shardingsphere-test\shardingsphere-integration-test\shardingsphere-integration-test-suite\src\test\java\org\apache\shardingsphere\test\integration\framework\database\DatabaseAssertionMetaDataFactory.java,0,3,0,3,0,6
 shardingsphere-master\shardingsphere-master\shardingsphere-features\shardingsphere-sharding\shardingsphere-sharding-core\src\main\java\org\apache\shardingsphere\sharding\route\engine\validator\ddl\impl\ShardingDropTableStatementValidator.java,0,20,0,21,0,41
 shardingsphere-master\shardingsphere-master\shardingsphere-db-protocol\shardingsphere-db-protocol-mysql\src\test\java\org\apache\shardingsphere\db\protocol\mysql\packet\command\query\binary\execute\protocol\MySQLTimeBinaryProtocolValueTest.java,0,39,0,8,0,47
 shardingsphere-master\shardingsphere-master\shardingsphere-kernel\shardingsphere-transaction\shardingsphere-transaction-type\shardingsphere-transaction-xa\shardingsphere-transaction-xa-core\src\test\java\org\apache\shardingsphere\transaction\xa\jta\connection\dialect\H2XAConnectionWrapperTest.java,0,11,0,7,0,18
 shardingsphere-master\shardingsphere-master\shardingsphere-infra\shardingsphere-infra-common\src\main\java\org\apache\shardingsphere\infra\yaml\config\pojo\YamlRuleConfiguration.java,0,2,0,1,0,3
 shardingsphere-master\shardingsphere-master\shardingsphere-sql-parser\shardingsphere-sql-parser-statement\src\main\java\org\apache\shardingsphere\sql\parser\sql\common\statement\ddl\DropForeignDataWrapperStatement.java,3,1,1,3,0,5
 shardingsphere-master\shardingsphere-master\shardingsphere-mode\shardingsphere-mode-core\src\test\java\org\apache\shardingsphere\mode\metadata\persist\service\impl\DataSourcePersistServiceTest.java,0,38,0,26,0,64
 shardingsphere-master\shardingsphere-master\shardingsphere-test\shardingsphere-parser-test\src\main\java\org\apache\shardingsphere\test\sql\parser\parameterized\jaxb\cases\domain\statement\dal\LoadIndexInfoStatementTestCase.java,0,3,0,5,0,8
 shardingsphere-master\shardingsphere-master\shardingsphere-sql-parser\shardingsphere-sql-parser-statement\src\main\java\org\apache\shardingsphere\sql\parser\sql\common\segment\dml\predicate\LockSegment.java,0,5,0,3,2,10
 shardingsphere-master\shardingsphere-master\shardingsphere-features\shardingsphere-sharding\shardingsphere-sharding-api\src\main\java\org\apache\shardingsphere\sharding\api\config\rule\ShardingTableRuleConfiguration.java,0,19,0,5,0,24
 shardingsphere-master\shardingsphere-master\shardingsphere-test\shardingsphere-parser-test\src\main\java\org\apache\shardingsphere\test\sql\parser\parameterized\jaxb\cases\domain\segment\impl\with\ExpectedCommonTableExpressionClause.java,0,7,0,5,0,12
 shardingsphere-master\shardingsphere-master\examples\example-core\example-spring-jpa\src\main\java\org\apache\shardingsphere\example\core\jpa\repository\UserRepositoryImpl.java,40,17,0,4,0,21
 shardingsphere-master\shardingsphere-master\shardingsphere-features\shardingsphere-sharding\shardingsphere-sharding-distsql\shardingsphere-sharding-distsql-handler\src\main\java\org\apache\shardingsphere\sharding\distsql\handler\update\CreateShardingBindingTableRuleStatementUpdater.java,0,35,0,32,0,67
 shardingsphere-master\shardingsphere-master\shardingsphere-infra\shardingsphere-infra-common\src\main\java\org\apache\shardingsphere\infra\instance\InstanceContext.java,0,37,0,14,0,51
 shardingsphere-master\shardingsphere-master\shardingsphere-kernel\shardingsphere-data-pipeline\shardingsphere-data-pipeline-core\src\main\java\org\apache\shardingsphere\data\pipeline\core\ingest\exception\IngestException.java,0,8,0,1,0,9
 shardingsphere-master\shardingsphere-master\shardingsphere-test\shardingsphere-parser-test\src\main\java\org\apache\shardingsphere\test\sql\parser\parameterized\asserts\statement\dal\impl\RestartStatementAssert.java,0,3,1,6,0,10
 shardingsphere-master\shardingsphere-master\shardingsphere-test\shardingsphere-parser-test\src\main\java\org\apache\shardingsphere\test\sql\parser\parameterized\asserts\statement\distsql\rdl\create\impl\CreateDefaultSingleTableRuleStatementAssert.java,0,12,0,13,0,25
 shardingsphere-master\shardingsphere-master\examples\example-core\example-spring-mybatis\src\main\java\org\apache\shardingsphere\example\core\mybatis\service\ShadowUserServiceImpl.java,65,23,0,9,0,32
 shardingsphere-master\shardingsphere-master\shardingsphere-features\shardingsphere-encrypt\shardingsphere-encrypt-core\src\test\java\org\apache\shardingsphere\encrypt\rewrite\impl\EncryptSQLRewriteContextDecoratorTest.java,0,15,0,9,0,24
 shardingsphere-master\shardingsphere-master\shardingsphere-sql-parser\shardingsphere-sql-parser-statement\src\main\java\org\apache\shardingsphere\sql\parser\sql\dialect\statement\opengauss\ddl\OpenGaussAlterAggregateStatement.java,0,2,0,5,0,7
 shardingsphere-master\shardingsphere-master\shardingsphere-test\shardingsphere-rewrite-test\src\test\java\org\apache\shardingsphere\sharding\rewrite\fixture\ComplexKeysShardingAlgorithmFixture.java,0,6,1,5,0,12
 shardingsphere-master\shardingsphere-master\shardingsphere-sql-parser\shardingsphere-sql-parser-statement\src\main\java\org\apache\shardingsphere\sql\parser\sql\common\statement\ddl\RenameStatement.java,3,1,1,3,0,5
 shardingsphere-master\shardingsphere-master\shardingsphere-sql-parser\shardingsphere-sql-parser-statement\src\main\java\org\apache\shardingsphere\sql\parser\sql\dialect\statement\sqlserver\dcl\SQLServerAlterRoleStatement.java,0,1,0,5,0,6
 shardingsphere-master\shardingsphere-master\shardingsphere-kernel\shardingsphere-data-pipeline\shardingsphere-data-pipeline-dialect\shardingsphere-data-pipeline-opengauss\src\main\java\org\apache\shardingsphere\data\pipeline\opengauss\ingest\OpenGaussWalDumper.java,0,37,1,32,0,70
 shardingsphere-master\shardingsphere-master\shardingsphere-infra\shardingsphere-infra-binder\src\test\java\org\apache\shardingsphere\infra\binder\segment\select\projection\engine\ProjectionsContextEngineTest.java,0,296,0,203,0,499
 shardingsphere-master\shardingsphere-master\shardingsphere-test\shardingsphere-parser-test\src\main\java\org\apache\shardingsphere\test\sql\parser\parameterized\asserts\statement\ddl\impl\TruncateStatementAssert.java,0,7,0,9,0,16
 shardingsphere-master\shardingsphere-master\shardingsphere-db-protocol\shardingsphere-db-protocol-mysql\src\test\java\org\apache\shardingsphere\db\protocol\mysql\constant\MySQLBinlogEventFlagTest.java,0,4,0,2,0,6
 shardingsphere-master\shardingsphere-master\shardingsphere-infra\shardingsphere-infra-common\src\main\java\org\apache\shardingsphere\infra\config\checker\RuleConfigurationChecker.java,0,5,0,2,0,7
 shardingsphere-master\shardingsphere-master\shardingsphere-infra\shardingsphere-infra-common\src\main\java\org\apache\shardingsphere\infra\distsql\preprocess\RuleDefinitionAlterPreprocessor.java,0,4,0,2,0,6
 shardingsphere-master\shardingsphere-master\shardingsphere-features\shardingsphere-sharding\shardingsphere-sharding-core\src\test\java\org\apache\shardingsphere\sharding\route\engine\validator\ddl\ShardingPrepareStatementValidatorTest.java,0,25,0,15,0,40
 shardingsphere-master\shardingsphere-master\shardingsphere-sql-parser\shardingsphere-sql-parser-statement\src\main\java\org\apache\shardingsphere\sql\parser\sql\dialect\statement\mysql\dal\MySQLUninstallComponentStatement.java,0,3,0,5,1,9
 shardingsphere-master\shardingsphere-master\shardingsphere-features\shardingsphere-readwrite-splitting\shardingsphere-readwrite-splitting-core\src\test\java\org\apache\shardingsphere\readwritesplitting\route\ReadwriteSplittingSQLRouterTest.java,0,98,0,70,0,168
 shardingsphere-master\shardingsphere-master\shardingsphere-sql-parser\shardingsphere-sql-parser-statement\src\main\java\org\apache\shardingsphere\sql\parser\sql\dialect\statement\mysql\ddl\MySQLCreateServerStatement.java,0,1,0,5,0,6
 shardingsphere-master\shardingsphere-master\shardingsphere-db-protocol\shardingsphere-db-protocol-core\src\main\java\org\apache\shardingsphere\db\protocol\CommonConstants.java,0,8,0,3,0,11
 shardingsphere-master\shardingsphere-master\shardingsphere-test\shardingsphere-parser-test\src\main\java\org\apache\shardingsphere\test\sql\parser\parameterized\jaxb\cases\domain\statement\distsql\rql\ShowShardingScalingRulesStatementTestCase.java,0,3,0,5,0,8
 shardingsphere-master\shardingsphere-master\shardingsphere-test\shardingsphere-parser-test\src\main\java\org\apache\shardingsphere\test\sql\parser\parameterized\asserts\statement\dal\impl\ShowIndexStatementAssert.java,0,13,0,15,0,28
 shardingsphere-master\shardingsphere-master\shardingsphere-features\shardingsphere-sharding\shardingsphere-sharding-distsql\shardingsphere-sharding-distsql-handler\src\main\java\org\apache\shardingsphere\sharding\distsql\handler\update\DropShardingBindingTableRuleStatementUpdater.java,0,35,0,26,0,61
 shardingsphere-master\shardingsphere-master\shardingsphere-infra\shardingsphere-infra-rewrite\src\main\java\org\apache\shardingsphere\infra\rewrite\context\SQLRewriteContext.java,0,34,3,15,0,52
 shardingsphere-master\shardingsphere-master\shardingsphere-test\shardingsphere-parser-test\src\main\java\org\apache\shardingsphere\test\sql\parser\parameterized\asserts\statement\dal\impl\MySQLRepairTableStatementAssert.java,0,6,0,9,0,15
 shardingsphere-master\shardingsphere-master\examples\example-core\example-spring-jpa\src\main\java\org\apache\shardingsphere\example\core\jpa\service\ShadowUserServiceImpl.java,64,21,2,9,0,32
 shardingsphere-master\shardingsphere-master\shardingsphere-infra\shardingsphere-infra-common\src\main\java\org\apache\shardingsphere\infra\datasource\pool\metadata\DataSourcePoolMetaDataFactory.java,0,6,0,3,0,9
 shardingsphere-master\shardingsphere-master\shardingsphere-sql-parser\shardingsphere-sql-parser-statement\src\main\java\org\apache\shardingsphere\sql\parser\sql\dialect\statement\mysql\ddl\MySQLAlterInstanceStatement.java,0,1,0,5,0,6
 shardingsphere-master\shardingsphere-master\shardingsphere-features\shardingsphere-sharding\shardingsphere-sharding-core\src\main\java\org\apache\shardingsphere\sharding\yaml\config\strategy\sharding\YamlStandardShardingStrategyConfiguration.java,0,5,0,2,0,7
 shardingsphere-master\shardingsphere-master\shardingsphere-infra\shardingsphere-infra-common\src\main\java\org\apache\shardingsphere\infra\config\rulealtered\OnRuleAlteredActionConfiguration.java,0,25,0,2,0,27
 shardingsphere-master\shardingsphere-master\shardingsphere-sql-parser\shardingsphere-sql-parser-statement\src\main\java\org\apache\shardingsphere\sql\parser\sql\common\statement\dml\CallStatement.java,3,2,1,3,0,6
 shardingsphere-master\shardingsphere-master\shardingsphere-mode\shardingsphere-mode-core\src\test\java\org\apache\shardingsphere\mode\metadata\fixture\FixtureRuleConfiguration.java,0,1,0,3,0,4
 shardingsphere-master\shardingsphere-master\shardingsphere-mode\shardingsphere-mode-type\shardingsphere-cluster-mode\shardingsphere-cluster-mode-core\src\main\java\org\apache\shardingsphere\mode\manager\cluster\coordinator\registry\process\event\ExecuteProcessReportEvent.java,0,3,0,2,0,5
 shardingsphere-master\shardingsphere-master\shardingsphere-sql-parser\shardingsphere-sql-parser-statement\src\main\java\org\apache\shardingsphere\sql\parser\sql\dialect\statement\opengauss\ddl\OpenGaussTruncateStatement.java,0,1,0,5,0,6
 shardingsphere-master\shardingsphere-master\shardingsphere-kernel\shardingsphere-data-pipeline\shardingsphere-data-pipeline-core\src\main\java\org\apache\shardingsphere\scaling\core\job\check\EnvironmentCheckerFactory.java,0,7,1,9,0,17
 shardingsphere-master\shardingsphere-master\shardingsphere-test\shardingsphere-parser-test\src\main\java\org\apache\shardingsphere\test\sql\parser\parameterized\jaxb\cases\domain\statement\ddl\AlterDefaultPrivilegesTestCase.java,0,0,0,3,0,3
 shardingsphere-master\shardingsphere-master\shardingsphere-test\shardingsphere-parser-test\src\main\java\org\apache\shardingsphere\test\sql\parser\parameterized\jaxb\cases\domain\segment\impl\show\ExpectedShowFilter.java,0,5,0,5,0,10
 shardingsphere-master\shardingsphere-master\examples\shardingsphere-jdbc-example\single-feature-example\transaction-example\transaction-2pc-xa-atomikos-raw-jdbc-example\src\main\java\org\apache\shardingsphere\example\transaction\xa\atomikos\raw\jdbc\XAOrderService.java,0,18,6,9,0,33
 shardingsphere-master\shardingsphere-master\shardingsphere-features\shardingsphere-sharding\shardingsphere-sharding-core\src\main\java\org\apache\shardingsphere\sharding\route\engine\validator\ddl\impl\ShardingAlterIndexStatementValidator.java,0,15,1,15,0,31
 shardingsphere-master\shardingsphere-master\shardingsphere-db-protocol\shardingsphere-db-protocol-mysql\src\test\java\org\apache\shardingsphere\db\protocol\mysql\packet\command\binlog\MySQLComRegisterSlaveCommandPacketTest.java,0,27,0,5,0,32
 shardingsphere-master\shardingsphere-master\shardingsphere-sql-parser\shardingsphere-sql-parser-statement\src\test\java\org\apache\shardingsphere\sql\parser\sql\dialect\handler\dal\ExplainStatementHandlerTest.java,0,8,0,8,0,16
 shardingsphere-master\shardingsphere-master\shardingsphere-sql-parser\shardingsphere-sql-parser-statement\src\main\java\org\apache\shardingsphere\sql\parser\sql\dialect\statement\mysql\dal\MySQLSetStatement.java,0,1,0,4,0,5
 shardingsphere-master\shardingsphere-master\shardingsphere-test\shardingsphere-parser-test\src\main\java\org\apache\shardingsphere\test\sql\parser\parameterized\jaxb\cases\domain\segment\impl\definition\ExpectedModifyColumnDefinition.java,0,5,0,4,0,9
 shardingsphere-master\shardingsphere-master\shardingsphere-sql-parser\shardingsphere-sql-parser-statement\src\main\java\org\apache\shardingsphere\sql\parser\sql\dialect\statement\mysql\ddl\MySQLCreateTableStatement.java,0,2,0,4,0,6
 shardingsphere-master\shardingsphere-master\shardingsphere-features\shardingsphere-db-discovery\shardingsphere-db-discovery-distsql\shardingsphere-db-discovery-distsql-handler\src\test\java\org\apache\shardingsphere\dbdiscovery\distsql\handler\update\CreateDatabaseDiscoveryTypeStatementUpdaterTest.java,0,37,0,31,0,68
 shardingsphere-master\shardingsphere-master\shardingsphere-sql-parser\shardingsphere-sql-parser-statement\src\test\java\org\apache\shardingsphere\sql\parser\sql\common\constant\QuoteCharacterTest.java,0,23,0,8,0,31
 shardingsphere-master\shardingsphere-master\shardingsphere-features\shardingsphere-encrypt\shardingsphere-encrypt-core\src\test\java\org\apache\shardingsphere\encrypt\algorithm\AESEncryptAlgorithmTest.java,0,25,0,10,0,35
 shardingsphere-master\shardingsphere-master\shardingsphere-sql-parser\shardingsphere-sql-parser-statement\src\main\java\org\apache\shardingsphere\sql\parser\sql\dialect\statement\mysql\dal\MySQLCheckTableStatement.java,0,2,0,6,1,9
 shardingsphere-master\shardingsphere-master\shardingsphere-sql-parser\shardingsphere-sql-parser-statement\src\main\java\org\apache\shardingsphere\sql\parser\sql\common\segment\ddl\table\RenameTableDefinitionSegment.java,0,9,0,4,4,17
 shardingsphere-master\shardingsphere-master\examples\example-core\example-spring-jpa\src\main\java\org\apache\shardingsphere\example\core\jpa\repository\OrderRepositoryImpl.java,40,17,0,4,0,21
 shardingsphere-master\shardingsphere-master\shardingsphere-agent\shardingsphere-agent-plugins\shardingsphere-agent-plugin-metrics\shardingsphere-agent-metrics-api\src\test\java\org\apache\shardingsphere\agent\metrics\api\fixture\FixtureWrapper.java,0,9,0,1,0,10
 shardingsphere-master\shardingsphere-master\shardingsphere-infra\shardingsphere-infra-common\src\test\java\org\apache\shardingsphere\infra\hint\SQLHintUtilsTest.java,0,11,0,4,0,15
 shardingsphere-master\shardingsphere-master\shardingsphere-features\shardingsphere-db-discovery\shardingsphere-db-discovery-distsql\shardingsphere-db-discovery-distsql-handler\src\main\java\org\apache\shardingsphere\dbdiscovery\distsql\handler\query\DatabaseDiscoveryHeartbeatQueryResultSet.java,0,15,0,11,0,26
 shardingsphere-master\shardingsphere-master\shardingsphere-infra\shardingsphere-infra-common\src\main\java\org\apache\shardingsphere\infra\distsql\exception\rule\RuleDefinitionViolationException.java,9,5,0,3,0,8
 shardingsphere-master\shardingsphere-master\shardingsphere-features\shardingsphere-sharding\shardingsphere-sharding-distsql\shardingsphere-sharding-distsql-handler\src\main\java\org\apache\shardingsphere\sharding\distsql\handler\converter\ShardingTableRuleStatementConverter.java,0,66,1,63,0,130
 shardingsphere-master\shardingsphere-master\examples\shardingsphere-jdbc-example\single-feature-example\cluster-mode-example\cluster-mode-raw-jdbc-example\src\main\java\org\apache\shardingsphere\example\cluster\mode\raw\jdbc\config\cloud\CloudShadowConfiguration.java,0,6,0,1,0,7
 shardingsphere-master\shardingsphere-master\shardingsphere-infra\shardingsphere-infra-executor\src\main\java\org\apache\shardingsphere\infra\executor\kernel\model\ExecutionGroup.java,0,3,0,1,0,4
 shardingsphere-master\shardingsphere-master\shardingsphere-agent\shardingsphere-agent-plugins\shardingsphere-agent-plugin-metrics\shardingsphere-agent-metrics-prometheus\src\test\java\org\apache\shardingsphere\agent\metrics\prometheus\collector\ProxyInfoCollectorTest.java,0,4,0,4,0,8
 shardingsphere-master\shardingsphere-master\shardingsphere-jdbc\shardingsphere-jdbc-core\src\main\java\org\apache\shardingsphere\driver\jdbc\core\connection\ShardingSphereConnection.java,0,72,1,26,0,99
 shardingsphere-master\shardingsphere-master\shardingsphere-sql-parser\shardingsphere-sql-parser-engine\src\main\java\org\apache\shardingsphere\sql\parser\core\database\visitor\SQLVisitorFactory.java,0,14,0,12,0,26
 shardingsphere-master\shardingsphere-master\shardingsphere-sql-parser\shardingsphere-sql-parser-statement\src\main\java\org\apache\shardingsphere\sql\parser\sql\common\statement\dml\InsertStatement.java,38,15,0,9,4,28
 shardingsphere-master\shardingsphere-master\shardingsphere-kernel\shardingsphere-parser\shardingsphere-parser-spring\shardingsphere-parser-spring-boot-starter\src\main\java\org\apache\shardingsphere\parser\spring\boot\condition\SQLParserSpringBootCondition.java,0,8,0,5,0,13
 shardingsphere-master\shardingsphere-master\shardingsphere-sql-parser\shardingsphere-sql-parser-statement\src\main\java\org\apache\shardingsphere\sql\parser\sql\common\segment\dal\FromSchemaSegment.java,0,7,0,2,0,9
 shardingsphere-master\shardingsphere-master\shardingsphere-agent\shardingsphere-agent-api\src\main\java\org\apache\shardingsphere\agent\exception\PluginConfigurationException.java,0,5,0,2,0,7
 shardingsphere-master\shardingsphere-master\shardingsphere-agent\shardingsphere-agent-plugins\shardingsphere-agent-plugin-tracing\shardingsphere-agent-tracing-opentelemetry\src\main\java\org\apache\shardingsphere\agent\plugin\tracing\opentelemetry\constant\OpenTelemetryConstants.java,34,21,0,1,0,22
 shardingsphere-master\shardingsphere-master\shardingsphere-kernel\shardingsphere-data-pipeline\shardingsphere-data-pipeline-dialect\shardingsphere-data-pipeline-mysql\src\main\java\org\apache\shardingsphere\data\pipeline\mysql\ingest\client\netty\MySQLCommandPacketDecoder.java,0,24,1,15,0,40
 shardingsphere-master\shardingsphere-master\shardingsphere-features\shardingsphere-sharding\shardingsphere-sharding-distsql\shardingsphere-sharding-distsql-handler\src\test\java\org\apache\shardingsphere\scaling\distsql\handler\EnableShardingScalingRuleStatementUpdaterTest.java,0,28,0,16,0,44
 shardingsphere-master\shardingsphere-master\shardingsphere-test\shardingsphere-parser-test\src\main\java\org\apache\shardingsphere\test\sql\parser\parameterized\jaxb\cases\domain\segment\impl\clone\ExpectedInstance.java,0,6,0,3,0,9
 shardingsphere-master\shardingsphere-master\shardingsphere-infra\shardingsphere-infra-executor\src\main\java\org\apache\shardingsphere\infra\executor\sql\execute\engine\raw\callback\RawSQLExecutorCallback.java,0,12,0,12,0,24
 shardingsphere-master\shardingsphere-master\shardingsphere-infra\shardingsphere-infra-common\src\main\java\org\apache\shardingsphere\infra\datasource\pool\creator\DataSourcePoolCreator.java,0,35,0,30,0,65
 shardingsphere-master\shardingsphere-master\shardingsphere-test\shardingsphere-parser-test\src\main\java\org\apache\shardingsphere\test\sql\parser\parameterized\jaxb\cases\domain\statement\dcl\DenyUserStatementTestCase.java,0,4,0,5,0,9
 shardingsphere-master\shardingsphere-master\shardingsphere-mode\shardingsphere-mode-type\shardingsphere-standalone-mode\shardingsphere-standalone-mode-repository\shardingsphere-standalone-mode-repository-api\src\main\java\org\apache\shardingsphere\mode\repository\standalone\StandalonePersistRepositoryFactory.java,0,7,0,5,0,12
 shardingsphere-master\shardingsphere-master\shardingsphere-mode\shardingsphere-mode-type\shardingsphere-cluster-mode\shardingsphere-cluster-mode-core\src\test\java\org\apache\shardingsphere\mode\manager\cluster\coordinator\registry\cache\subscriber\ScalingRegistrySubscriberTest.java,0,16,2,8,0,26
 shardingsphere-master\shardingsphere-master\shardingsphere-sql-parser\shardingsphere-sql-parser-statement\src\main\java\org\apache\shardingsphere\sql\parser\sql\common\segment\ddl\type\TypeSegment.java,0,5,0,4,1,10
 shardingsphere-master\shardingsphere-master\examples\shardingsphere-jdbc-example\single-feature-example\transaction-example\transaction-2pc-xa-spring-boot-example\src\main\java\org\apache\shardingsphere\example\transaction\xa\spring\boot\TransactionXaSpringBootExample.java,17,7,0,1,0,8
 shardingsphere-master\shardingsphere-master\shardingsphere-infra\shardingsphere-infra-federation\shardingsphere-infra-federation-optimizer\src\main\java\org\apache\shardingsphere\infra\federation\optimizer\converter\segment\SQLSegmentConverter.java,0,8,0,1,0,9
 shardingsphere-master\shardingsphere-master\shardingsphere-sql-parser\shardingsphere-sql-parser-statement\src\main\java\org\apache\shardingsphere\sql\parser\sql\dialect\statement\oracle\ddl\OracleTruncateStatement.java,0,1,0,4,0,5
 shardingsphere-master\shardingsphere-master\shardingsphere-infra\shardingsphere-infra-binder\src\test\java\org\apache\shardingsphere\infra\binder\segment\select\projection\impl\AggregationDistinctProjectionTest.java,0,11,0,5,0,16
 shardingsphere-master\shardingsphere-master\examples\shardingsphere-example-generator\src\main\java\org\apache\shardingsphere\example\generator\scenario\feature\type\EncryptExampleScenario.java,0,8,0,4,0,12
 shardingsphere-master\shardingsphere-master\shardingsphere-features\shardingsphere-sharding\shardingsphere-sharding-core\src\main\java\org\apache\shardingsphere\sharding\rewrite\token\pojo\RowCountToken.java,0,10,0,2,0,12
 shardingsphere-master\shardingsphere-master\shardingsphere-infra\shardingsphere-infra-executor\src\main\java\org\apache\shardingsphere\infra\executor\sql\prepare\ExecutionPrepareEngine.java,0,3,0,3,0,6
 shardingsphere-master\shardingsphere-master\shardingsphere-proxy\shardingsphere-proxy-backend\src\main\java\org\apache\shardingsphere\proxy\backend\text\distsql\ral\common\updatable\PrepareDistSQLHandler.java,0,3,0,6,0,9
 shardingsphere-master\shardingsphere-master\shardingsphere-kernel\shardingsphere-authority\shardingsphere-authority-core\src\main\java\org\apache\shardingsphere\authority\provider\natived\builder\StoragePrivilegeHandler.java,0,8,0,6,0,14
 shardingsphere-master\shardingsphere-master\shardingsphere-proxy\shardingsphere-proxy-frontend\shardingsphere-proxy-frontend-mysql\src\main\java\org\apache\shardingsphere\proxy\frontend\mysql\command\query\text\query\MySQLComQueryPacketExecutor.java,0,43,1,38,0,82
 shardingsphere-master\shardingsphere-master\shardingsphere-proxy\shardingsphere-proxy-backend\src\main\java\org\apache\shardingsphere\proxy\backend\text\admin\executor\DatabaseAdminExecutorFactory.java,0,4,0,3,0,7
 shardingsphere-master\shardingsphere-master\shardingsphere-test\shardingsphere-parser-test\src\main\java\org\apache\shardingsphere\test\sql\parser\parameterized\asserts\statement\distsql\rql\impl\rule\ShowShardingBroadcastTableRulesStatementAssert.java,0,8,0,12,0,20
 shardingsphere-master\shardingsphere-master\shardingsphere-proxy\shardingsphere-proxy-backend\src\test\java\org\apache\shardingsphere\proxy\backend\text\admin\mysql\executor\fixture\AuthorityCheckerFixture.java,0,14,0,8,0,22
 shardingsphere-master\shardingsphere-master\shardingsphere-db-protocol\shardingsphere-db-protocol-postgresql\src\main\java\org\apache\shardingsphere\db\protocol\postgresql\packet\handshake\PostgreSQLParameterStatusPacket.java,0,7,0,6,0,13
 shardingsphere-master\shardingsphere-master\shardingsphere-proxy\shardingsphere-proxy-backend\src\main\java\org\apache\shardingsphere\proxy\backend\text\admin\mysql\executor\ShowFunctionStatusExecutor.java,0,33,0,22,0,55
 shardingsphere-master\shardingsphere-master\shardingsphere-sql-parser\shardingsphere-sql-parser-statement\src\main\java\org\apache\shardingsphere\sql\parser\sql\common\segment\ddl\column\alter\AddColumnDefinitionSegment.java,0,12,0,6,2,20
 shardingsphere-master\shardingsphere-master\shardingsphere-sql-parser\shardingsphere-sql-parser-dialect\shardingsphere-sql-parser-mysql\src\main\java\org\apache\shardingsphere\sql\parser\mysql\visitor\statement\impl\MySQLStatementSQLVisitor.java,1421,443,5,437,0,885
 shardingsphere-master\shardingsphere-master\shardingsphere-sql-parser\shardingsphere-sql-parser-dialect\shardingsphere-sql-parser-postgresql\src\main\java\org\apache\shardingsphere\sql\parser\postgresql\visitor\statement\impl\PostgreSQLDDLStatementSQLVisitor.java,0,178,0,282,0,460
 shardingsphere-master\shardingsphere-master\shardingsphere-features\shardingsphere-sharding\shardingsphere-sharding-distsql\shardingsphere-sharding-distsql-handler\src\main\java\org\apache\shardingsphere\sharding\distsql\handler\update\AlterShardingAlgorithmStatementUpdater.java,0,28,0,30,0,58
 shardingsphere-master\shardingsphere-master\examples\shardingsphere-jdbc-example\single-feature-example\sharding-example\sharding-spring-namespace-jpa-example\src\main\java\org\apache\shardingsphere\example\sharding\spring\namespace\jpa\ShardingSpringNamespaceJpaExample.java,0,11,1,6,0,18
 shardingsphere-master\shardingsphere-master\shardingsphere-infra\shardingsphere-infra-common\src\test\java\org\apache\shardingsphere\infra\yaml\engine\representer\ShardingSphereYamlRepresenterTest.java,0,14,0,11,0,25
 shardingsphere-master\shardingsphere-master\shardingsphere-sql-parser\shardingsphere-sql-parser-statement\src\main\java\org\apache\shardingsphere\sql\parser\sql\common\statement\ddl\CreateSequenceStatement.java,5,2,1,3,0,6
 shardingsphere-master\shardingsphere-master\shardingsphere-test\shardingsphere-parser-test\src\main\java\org\apache\shardingsphere\test\sql\parser\parameterized\jaxb\cases\domain\statement\distsql\rql\ShowShadowRulesStatementTestCase.java,0,4,0,4,0,8
 shardingsphere-master\shardingsphere-master\shardingsphere-sql-parser\shardingsphere-sql-parser-statement\src\main\java\org\apache\shardingsphere\sql\parser\sql\common\value\literal\LiteralValue.java,0,1,0,1,0,2
 shardingsphere-master\shardingsphere-master\shardingsphere-test\shardingsphere-parser-test\src\main\java\org\apache\shardingsphere\test\sql\parser\parameterized\asserts\statement\dal\impl\ShowProcedureStatusStatementAssert.java,0,5,0,9,0,14
 shardingsphere-master\shardingsphere-master\shardingsphere-sql-parser\shardingsphere-sql-parser-statement\src\main\java\org\apache\shardingsphere\sql\parser\sql\common\statement\dcl\RevokeStatement.java,5,2,1,4,1,8
 shardingsphere-master\shardingsphere-master\shardingsphere-db-protocol\shardingsphere-db-protocol-core\src\main\java\org\apache\shardingsphere\db\protocol\payload\PacketPayload.java,0,5,0,1,0,6
 shardingsphere-master\shardingsphere-master\shardingsphere-mode\shardingsphere-mode-type\shardingsphere-cluster-mode\shardingsphere-cluster-mode-repository\shardingsphere-cluster-mode-repository-provider\shardingsphere-cluster-mode-repository-zookeeper-curator\src\test\java\org\apache\shardingsphere\mode\repository\cluster\zookeeper\props\ZookeeperPropertiesTest.java,0,21,0,10,0,31
 shardingsphere-master\shardingsphere-master\shardingsphere-features\shardingsphere-readwrite-splitting\shardingsphere-readwrite-splitting-spring\shardingsphere-readwrite-splitting-spring-namespace\src\main\java\org\apache\shardingsphere\readwritesplitting\spring\namespace\tag\LoadBalanceAlgorithmBeanDefinitionTag.java,0,4,0,1,0,5
 shardingsphere-master\shardingsphere-master\shardingsphere-kernel\shardingsphere-data-pipeline\shardingsphere-data-pipeline-core\src\main\java\org\apache\shardingsphere\data\pipeline\core\ingest\dumper\AbstractIncrementalDumper.java,7,6,5,10,0,21
 shardingsphere-master\shardingsphere-master\shardingsphere-sql-parser\shardingsphere-sql-parser-statement\src\main\java\org\apache\shardingsphere\sql\parser\sql\dialect\statement\mysql\dcl\MySQLCreateRoleStatement.java,0,1,0,4,0,5
 shardingsphere-master\shardingsphere-master\shardingsphere-sql-parser\shardingsphere-sql-parser-statement\src\main\java\org\apache\shardingsphere\sql\parser\sql\common\value\literal\impl\OtherLiteralValue.java,0,2,0,2,0,4
 shardingsphere-master\shardingsphere-master\shardingsphere-sql-parser\shardingsphere-sql-parser-statement\src\main\java\org\apache\shardingsphere\sql\parser\sql\common\constant\TransactionAccessType.java,0,3,0,1,0,4
 shardingsphere-master\shardingsphere-master\shardingsphere-features\shardingsphere-shadow\shardingsphere-shadow-core\src\test\java\org\apache\shardingsphere\shadow\route\engine\ShadowRouteEngineFactoryTest.java,0,19,0,25,0,44
 shardingsphere-master\shardingsphere-master\shardingsphere-features\shardingsphere-shadow\shardingsphere-shadow-distsql\shardingsphere-shadow-distsql-parser\src\main\java\org\apache\shardingsphere\shadow\distsql\parser\core\ShadowDistSQLLexer.java,0,4,0,3,0,7
 shardingsphere-master\shardingsphere-master\shardingsphere-features\shardingsphere-sharding\shardingsphere-sharding-core\src\test\java\org\apache\shardingsphere\sharding\rule\TableRuleTest.java,0,71,0,51,0,122
 shardingsphere-master\shardingsphere-master\shardingsphere-agent\shardingsphere-agent-api\src\main\java\org\apache\shardingsphere\agent\api\point\ConstructorPoint.java,0,4,0,1,0,5
 shardingsphere-master\shardingsphere-master\shardingsphere-kernel\shardingsphere-authority\shardingsphere-authority-core\src\test\java\org\apache\shardingsphere\authority\provider\natived\builder\dialect\SQLServerPrivilegeHandlerTest.java,0,70,10,52,0,132
 shardingsphere-master\shardingsphere-master\shardingsphere-agent\shardingsphere-agent-plugins\shardingsphere-agent-plugin-metrics\shardingsphere-agent-metrics-api\src\main\java\org\apache\shardingsphere\agent\metrics\api\advice\SQLParserEngineAdvice.java,0,16,0,21,0,37
 shardingsphere-master\shardingsphere-master\shardingsphere-features\shardingsphere-db-discovery\shardingsphere-db-discovery-core\src\test\java\org\apache\shardingsphere\dbdiscovery\rule\DatabaseDiscoveryDataSourceRuleTest.java,0,21,0,11,0,32
 shardingsphere-master\shardingsphere-master\shardingsphere-features\shardingsphere-db-discovery\shardingsphere-db-discovery-distsql\shardingsphere-db-discovery-distsql-handler\src\test\java\org\apache\shardingsphere\dbdiscovery\distsql\handler\query\DatabaseDiscoveryRuleQueryResultSetTest.java,0,21,0,20,0,41
 shardingsphere-master\shardingsphere-master\shardingsphere-distsql\shardingsphere-distsql-parser\src\main\java\org\apache\shardingsphere\distsql\parser\engine\spi\FeaturedDistSQLStatementParserFacade.java,0,3,0,1,0,4
 shardingsphere-master\shardingsphere-master\shardingsphere-proxy\shardingsphere-proxy-backend\src\main\java\org\apache\shardingsphere\proxy\backend\text\distsql\rql\resource\UnusedDataSourceQueryResultSet.java,0,55,0,33,0,88
 shardingsphere-master\shardingsphere-master\shardingsphere-sql-parser\shardingsphere-sql-parser-statement\src\main\java\org\apache\shardingsphere\sql\parser\sql\common\segment\ddl\constraint\alter\DropConstraintDefinitionSegment.java,0,7,0,5,0,12
 shardingsphere-master\shardingsphere-master\shardingsphere-sql-parser\shardingsphere-sql-parser-statement\src\main\java\org\apache\shardingsphere\sql\parser\sql\common\statement\ddl\CreateDatabaseStatement.java,7,5,1,3,0,9
 shardingsphere-master\shardingsphere-master\shardingsphere-sql-parser\shardingsphere-sql-parser-statement\src\main\java\org\apache\shardingsphere\sql\parser\sql\dialect\statement\opengauss\tcl\OpenGaussRollbackStatement.java,0,1,0,5,0,6
 shardingsphere-master\shardingsphere-master\shardingsphere-infra\shardingsphere-infra-executor\src\main\java\org\apache\shardingsphere\infra\executor\sql\execute\result\query\impl\driver\jdbc\type\memory\JDBCMemoryQueryResult.java,0,5,0,6,0,11
 shardingsphere-master\shardingsphere-master\shardingsphere-jdbc\shardingsphere-jdbc-spring\shardingsphere-jdbc-core-spring\shardingsphere-jdbc-core-spring-boot-starter\src\test\java\org\apache\shardingsphere\spring\boot\SpringBootStarterTest.java,133,65,0,44,0,109
 shardingsphere-master\shardingsphere-master\shardingsphere-sql-parser\shardingsphere-sql-parser-statement\src\main\java\org\apache\shardingsphere\sql\parser\sql\dialect\handler\ddl\AlterViewStatementHandler.java,0,3,0,7,1,11
 shardingsphere-master\shardingsphere-master\shardingsphere-test\shardingsphere-parser-test\src\main\java\org\apache\shardingsphere\test\sql\parser\parameterized\jaxb\cases\domain\statement\ddl\AnalyzeStatementTestCase.java,0,3,0,5,0,8
 shardingsphere-master\shardingsphere-master\shardingsphere-sql-parser\shardingsphere-sql-parser-statement\src\main\java\org\apache\shardingsphere\sql\parser\sql\dialect\statement\mysql\ddl\MySQLTruncateStatement.java,0,1,0,4,0,5
 shardingsphere-master\shardingsphere-master\shardingsphere-test\shardingsphere-parser-test\src\main\java\org\apache\shardingsphere\test\sql\parser\parameterized\jaxb\cases\domain\statement\ddl\DropDatabaseLinkStatementTestCase.java,0,0,0,3,0,3
 shardingsphere-master\shardingsphere-master\shardingsphere-db-protocol\shardingsphere-db-protocol-mysql\src\main\java\org\apache\shardingsphere\db\protocol\mysql\packet\command\query\binary\reset\MySQLComStmtResetPacket.java,0,6,0,5,0,11
 shardingsphere-master\shardingsphere-master\shardingsphere-sql-parser\shardingsphere-sql-parser-statement\src\main\java\org\apache\shardingsphere\sql\parser\sql\common\statement\ddl\AlterConversionStatement.java,3,1,1,3,0,5
 shardingsphere-master\shardingsphere-master\shardingsphere-features\shardingsphere-sharding\shardingsphere-sharding-distsql\shardingsphere-sharding-distsql-statement\src\main\java\org\apache\shardingsphere\sharding\distsql\parser\segment\KeyGenerateStrategySegment.java,0,17,0,4,0,21
 shardingsphere-master\shardingsphere-master\shardingsphere-test\shardingsphere-parser-test\src\main\java\org\apache\shardingsphere\test\sql\parser\parameterized\jaxb\cases\domain\segment\impl\orderby\ExpectedOrderByClause.java,0,12,0,9,0,21
 shardingsphere-master\shardingsphere-master\shardingsphere-spi\src\main\java\org\apache\shardingsphere\spi\required\RequiredSPI.java,0,2,0,1,0,3
 shardingsphere-master\shardingsphere-master\shardingsphere-infra\shardingsphere-infra-federation\shardingsphere-infra-federation-optimizer\src\main\java\org\apache\shardingsphere\infra\federation\optimizer\converter\segment\expression\impl\ExistsSubqueryExpressionConverter.java,0,14,0,15,0,29
 shardingsphere-master\shardingsphere-master\shardingsphere-features\shardingsphere-db-discovery\shardingsphere-db-discovery-core\src\main\java\org\apache\shardingsphere\dbdiscovery\aware\DatabaseDiscoveryDataSourceNameAware.java,0,12,0,5,0,17
 shardingsphere-master\shardingsphere-master\shardingsphere-features\shardingsphere-sharding\shardingsphere-sharding-core\src\test\java\org\apache\shardingsphere\sharding\algorithm\keygen\CosIdKeyGenerateAlgorithmTest.java,0,17,0,9,0,26
 shardingsphere-master\shardingsphere-master\shardingsphere-kernel\shardingsphere-data-pipeline\shardingsphere-data-pipeline-core\src\main\java\org\apache\shardingsphere\data\pipeline\core\util\ThreadUtil.java,0,2,0,1,0,3
 shardingsphere-master\shardingsphere-master\shardingsphere-infra\shardingsphere-infra-federation\shardingsphere-infra-federation-optimizer\src\main\java\org\apache\shardingsphere\infra\federation\optimizer\converter\segment\orderby\item\OrderByItemConverterUtil.java,0,11,0,14,0,25
 shardingsphere-master\shardingsphere-master\shardingsphere-features\shardingsphere-sharding\shardingsphere-sharding-distsql\shardingsphere-sharding-distsql-handler\src\test\java\org\apache\shardingsphere\sharding\distsql\fixture\SnowflakeAlgorithmFixture.java,0,3,1,1,0,5
 shardingsphere-master\shardingsphere-master\shardingsphere-features\shardingsphere-encrypt\shardingsphere-encrypt-core\src\main\java\org\apache\shardingsphere\encrypt\merge\dal\impl\MergedEncryptColumnsMergedResult.java,0,11,0,5,0,16
 shardingsphere-master\shardingsphere-master\shardingsphere-features\shardingsphere-encrypt\shardingsphere-encrypt-core\src\main\java\org\apache\shardingsphere\encrypt\algorithm\EmptyEncryptAlgorithm.java,0,9,1,4,0,14
 shardingsphere-master\shardingsphere-master\shardingsphere-kernel\shardingsphere-authority\shardingsphere-authority-core\src\main\java\org\apache\shardingsphere\authority\provider\natived\model\subject\SchemaAccessSubject.java,0,3,0,1,0,4
 shardingsphere-master\shardingsphere-master\shardingsphere-proxy\shardingsphere-proxy-backend\src\main\java\org\apache\shardingsphere\proxy\backend\communication\DatabaseCommunicationEngineFactory.java,0,21,0,21,0,42
 shardingsphere-master\shardingsphere-master\shardingsphere-test\shardingsphere-parser-test\src\main\java\org\apache\shardingsphere\test\sql\parser\parameterized\asserts\statement\distsql\rql\impl\rule\ShowDatabaseDiscoveryRulesStatementAssert.java,0,8,0,12,0,20
 shardingsphere-master\shardingsphere-master\shardingsphere-features\shardingsphere-sharding\shardingsphere-sharding-distsql\shardingsphere-sharding-distsql-statement\src\main\java\org\apache\shardingsphere\sharding\distsql\parser\statement\ShowShardingTableRulesUsedAlgorithmStatement.java,0,5,0,5,0,10
 shardingsphere-master\shardingsphere-master\shardingsphere-kernel\shardingsphere-data-pipeline\shardingsphere-data-pipeline-dialect\shardingsphere-data-pipeline-opengauss\src\main\java\org\apache\shardingsphere\data\pipeline\opengauss\ingest\wal\decode\MppTableData.java,0,16,0,1,0,17
 shardingsphere-master\shardingsphere-master\shardingsphere-sql-parser\shardingsphere-sql-parser-statement\src\main\java\org\apache\shardingsphere\sql\parser\sql\dialect\statement\postgresql\dal\PostgreSQLResetParameterStatement.java,0,1,0,5,0,6
 shardingsphere-master\shardingsphere-master\shardingsphere-test\shardingsphere-parser-test\src\main\java\org\apache\shardingsphere\test\sql\parser\parameterized\asserts\statement\distsql\rql\impl\rule\ShowShadowAlgorithmsStatementAssert.java,0,7,0,11,0,18
 shardingsphere-master\shardingsphere-master\shardingsphere-proxy\shardingsphere-proxy-backend\src\main\java\org\apache\shardingsphere\proxy\backend\context\ProxyContext.java,0,24,1,11,0,36
 shardingsphere-master\shardingsphere-master\shardingsphere-db-protocol\shardingsphere-db-protocol-mysql\src\main\java\org\apache\shardingsphere\db\protocol\mysql\packet\command\query\binary\execute\protocol\MySQLInt8BinaryProtocolValue.java,0,3,0,3,0,6
 shardingsphere-master\shardingsphere-master\shardingsphere-test\shardingsphere-parser-test\src\main\java\org\apache\shardingsphere\test\sql\parser\parameterized\jaxb\cases\domain\segment\impl\user\ExpectedUser.java,0,3,0,3,0,6
 shardingsphere-master\shardingsphere-master\shardingsphere-kernel\shardingsphere-transaction\shardingsphere-transaction-core\src\test\java\org\apache\shardingsphere\transaction\context\TransactionContextsTest.java,0,18,0,12,0,30
 shardingsphere-master\shardingsphere-master\shardingsphere-agent\shardingsphere-agent-plugins\shardingsphere-agent-plugin-tracing\shardingsphere-agent-tracing-opentracing\src\test\java\org\apache\shardingsphere\agent\plugin\tracing\opentracing\service\OpenTracingPluginBootServiceTest.java,0,13,0,4,0,17
 shardingsphere-master\shardingsphere-master\shardingsphere-kernel\shardingsphere-data-pipeline\shardingsphere-data-pipeline-spi\src\main\java\org\apache\shardingsphere\data\pipeline\api\ingest\record\Record.java,7,4,1,2,0,7
 shardingsphere-master\shardingsphere-master\shardingsphere-proxy\shardingsphere-proxy-frontend\shardingsphere-proxy-frontend-core\src\test\java\org\apache\shardingsphere\proxy\frontend\authentication\AuthenticationResultBuilderTest.java,0,9,4,3,0,16
 shardingsphere-master\shardingsphere-master\shardingsphere-test\shardingsphere-parser-test\src\main\java\org\apache\shardingsphere\test\sql\parser\parameterized\asserts\statement\distsql\rdl\alter\impl\AlterEncryptRuleStatementAssert.java,0,14,0,19,0,33
 shardingsphere-master\shardingsphere-master\shardingsphere-test\shardingsphere-parser-test\src\main\java\org\apache\shardingsphere\test\sql\parser\parameterized\asserts\segment\table\TableAssert.java,0,24,0,39,0,63
 shardingsphere-master\shardingsphere-master\shardingsphere-infra\shardingsphere-infra-context\src\main\java\org\apache\shardingsphere\infra\context\refresher\type\AlterTableStatementSchemaRefresher.java,0,32,0,31,0,63
 shardingsphere-master\shardingsphere-master\shardingsphere-infra\shardingsphere-infra-common\src\test\java\org\apache\shardingsphere\infra\metadata\schema\ShardingSphereSchemaTest.java,0,27,0,12,0,39
 shardingsphere-master\shardingsphere-master\shardingsphere-sql-parser\shardingsphere-sql-parser-statement\src\main\java\org\apache\shardingsphere\sql\parser\sql\dialect\statement\oracle\dcl\OracleCreateRoleStatement.java,0,1,0,4,0,5
 shardingsphere-master\shardingsphere-master\shardingsphere-db-protocol\shardingsphere-db-protocol-postgresql\src\test\java\org\apache\shardingsphere\db\protocol\postgresql\packet\generic\PostgreSQLReadyForQueryPacketTest.java,0,21,0,8,0,29
 shardingsphere-master\shardingsphere-master\examples\shardingsphere-example-generator\src\main\java\org\apache\shardingsphere\example\generator\core\ExampleGeneratorFactory.java,0,13,0,5,0,18
 shardingsphere-master\shardingsphere-master\shardingsphere-db-protocol\shardingsphere-db-protocol-opengauss\src\test\java\org\apache\shardingsphere\db\protocol\opengauss\packet\command\generic\OpenGaussErrorResponsePacketTest.java,0,35,0,31,0,66
 shardingsphere-master\shardingsphere-master\shardingsphere-sql-parser\shardingsphere-sql-parser-statement\src\test\java\org\apache\shardingsphere\sql\parser\sql\dialect\handler\dml\DeleteStatementHandlerTest.java,0,14,0,9,0,23
 shardingsphere-master\shardingsphere-master\shardingsphere-kernel\shardingsphere-data-pipeline\shardingsphere-data-pipeline-spi\src\main\java\org\apache\shardingsphere\data\pipeline\api\job\JobType.java,0,7,0,2,0,9
 shardingsphere-master\shardingsphere-master\shardingsphere-infra\shardingsphere-infra-binder\src\main\java\org\apache\shardingsphere\infra\binder\segment\insert\values\expression\DerivedLiteralExpressionSegment.java,0,4,0,3,0,7
 shardingsphere-master\shardingsphere-master\shardingsphere-features\shardingsphere-readwrite-splitting\shardingsphere-readwrite-splitting-api\src\main\java\org\apache\shardingsphere\readwritesplitting\spi\ReadwriteSplittingType.java,0,6,0,3,0,9
 shardingsphere-master\shardingsphere-master\shardingsphere-test\shardingsphere-parser-test\src\main\java\org\apache\shardingsphere\test\sql\parser\parameterized\jaxb\cases\domain\statement\ddl\DropCollationStatementTestCase.java,0,0,0,3,0,3
 shardingsphere-master\shardingsphere-master\shardingsphere-kernel\shardingsphere-traffic\shardingsphere-traffic-api\src\main\java\org\apache\shardingsphere\traffic\api\traffic\segment\SegmentTrafficValue.java,0,4,0,1,0,5
 shardingsphere-master\shardingsphere-master\shardingsphere-proxy\shardingsphere-proxy-frontend\shardingsphere-proxy-frontend-spi\src\main\java\org\apache\shardingsphere\proxy\frontend\authentication\AuthenticationEngine.java,0,4,0,2,0,6
 shardingsphere-master\shardingsphere-master\shardingsphere-infra\shardingsphere-infra-common\src\main\java\org\apache\shardingsphere\infra\instance\definition\InstanceDefinition.java,0,18,0,3,0,21
 shardingsphere-master\shardingsphere-master\shardingsphere-features\shardingsphere-db-discovery\shardingsphere-db-discovery-spring\shardingsphere-db-discovery-spring-boot-starter\src\main\java\org\apache\shardingsphere\dbdiscovery\spring\boot\rule\YamlDatabaseDiscoveryRuleSpringBootConfiguration.java,0,3,0,2,0,5
 shardingsphere-master\shardingsphere-master\shardingsphere-mode\shardingsphere-mode-type\shardingsphere-memory-mode\shardingsphere-memory-mode-core\src\main\java\org\apache\shardingsphere\mode\manager\memory\lock\ShardingSphereNonReentrantLock.java,0,14,1,3,0,18
 shardingsphere-master\shardingsphere-master\shardingsphere-proxy\shardingsphere-proxy-backend\src\main\java\org\apache\shardingsphere\proxy\backend\text\distsql\ral\common\checker\ReadwriteSplittingRuleConfigurationImportChecker.java,0,21,0,22,0,43
 shardingsphere-master\shardingsphere-master\shardingsphere-test\shardingsphere-parser-test\src\main\java\org\apache\shardingsphere\test\sql\parser\parameterized\jaxb\cases\domain\statement\dal\UseStatementTestCase.java,0,2,0,4,0,6
 shardingsphere-master\shardingsphere-master\shardingsphere-sql-parser\shardingsphere-sql-parser-statement\src\main\java\org\apache\shardingsphere\sql\parser\sql\common\segment\dml\item\ProjectionSegment.java,0,0,0,1,0,1
 shardingsphere-master\shardingsphere-master\shardingsphere-features\shardingsphere-sharding\shardingsphere-sharding-distsql\shardingsphere-sharding-distsql-statement\src\main\java\org\apache\shardingsphere\sharding\distsql\parser\statement\DropShardingBroadcastTableRulesStatement.java,0,7,0,4,0,11
 shardingsphere-master\shardingsphere-master\shardingsphere-features\shardingsphere-sharding\shardingsphere-sharding-distsql\shardingsphere-sharding-distsql-statement\src\main\java\org\apache\shardingsphere\scaling\distsql\statement\EnableShardingScalingRuleStatement.java,0,3,0,3,0,6
 shardingsphere-master\shardingsphere-master\shardingsphere-sql-parser\shardingsphere-sql-parser-dialect\shardingsphere-sql-parser-oracle\src\main\java\org\apache\shardingsphere\sql\parser\oracle\visitor\statement\impl\OracleStatementSQLVisitor.java,493,142,3,168,0,313
 shardingsphere-master\shardingsphere-master\shardingsphere-features\shardingsphere-db-discovery\shardingsphere-db-discovery-spring\shardingsphere-db-discovery-spring-namespace\src\main\java\org\apache\shardingsphere\dbdiscovery\spring\namespace\tag\DatabaseDiscoveryHeartbeatBeanDefinitionTag.java,0,8,0,1,0,9
 shardingsphere-master\shardingsphere-master\shardingsphere-kernel\shardingsphere-data-pipeline\shardingsphere-data-pipeline-spi\src\main\java\org\apache\shardingsphere\data\pipeline\api\config\rulealtered\TaskConfiguration.java,0,6,0,2,0,8
 shardingsphere-master\shardingsphere-master\shardingsphere-sql-parser\shardingsphere-sql-parser-statement\src\main\java\org\apache\shardingsphere\sql\parser\sql\common\constant\UnionType.java,0,8,0,1,0,9
 shardingsphere-master\shardingsphere-master\shardingsphere-proxy\shardingsphere-proxy-backend\src\main\java\org\apache\shardingsphere\proxy\backend\communication\jdbc\statement\impl\OpenGaussStatementMemoryStrictlyFetchSizeSetter.java,0,6,0,5,0,11
 shardingsphere-master\shardingsphere-master\shardingsphere-test\shardingsphere-parser-test\src\main\java\org\apache\shardingsphere\test\sql\parser\parameterized\jaxb\cases\domain\statement\ddl\DropIndexStatementTestCase.java,0,4,0,5,0,9
 shardingsphere-master\shardingsphere-master\shardingsphere-kernel\shardingsphere-traffic\shardingsphere-traffic-core\src\test\java\org\apache\shardingsphere\traffic\yaml\swapper\TrafficRuleConfigurationYamlSwapperTest.java,0,40,0,26,0,66
 shardingsphere-master\shardingsphere-master\shardingsphere-db-protocol\shardingsphere-db-protocol-mysql\src\main\java\org\apache\shardingsphere\db\protocol\mysql\packet\handshake\MySQLAuthSwitchRequestPacket.java,0,17,0,5,0,22
 shardingsphere-master\shardingsphere-master\shardingsphere-kernel\shardingsphere-data-pipeline\shardingsphere-data-pipeline-dialect\shardingsphere-data-pipeline-mysql\src\main\java\org\apache\shardingsphere\data\pipeline\mysql\ingest\column\value\ValueHandler.java,0,2,0,1,0,3
 shardingsphere-master\shardingsphere-master\shardingsphere-db-protocol\shardingsphere-db-protocol-postgresql\src\main\java\org\apache\shardingsphere\db\protocol\postgresql\packet\command\query\extended\bind\PostgreSQLComBindPacket.java,0,31,1,23,0,55
 shardingsphere-master\shardingsphere-master\shardingsphere-test\shardingsphere-parser-test\src\main\java\org\apache\shardingsphere\test\sql\parser\parameterized\asserts\segment\generic\GrantLevelSegmentAssert.java,0,4,0,7,0,11
 shardingsphere-master\shardingsphere-master\shardingsphere-db-protocol\shardingsphere-db-protocol-mysql\src\main\java\org\apache\shardingsphere\db\protocol\mysql\constant\MySQLBinlogEventType.java,0,81,0,4,0,85
 shardingsphere-master\shardingsphere-master\shardingsphere-test\shardingsphere-parser-test\src\main\java\org\apache\shardingsphere\test\sql\parser\parameterized\jaxb\cases\domain\statement\distsql\rdl\drop\DropResourceStatementTestCase.java,0,6,0,3,0,9
 shardingsphere-master\shardingsphere-master\shardingsphere-test\shardingsphere-parser-test\src\main\java\org\apache\shardingsphere\test\sql\parser\parameterized\jaxb\distsql\DistSQLCase.java,0,1,0,1,0,2
 shardingsphere-master\shardingsphere-master\shardingsphere-test\shardingsphere-parser-test\src\main\java\org\apache\shardingsphere\test\sql\parser\parameterized\jaxb\cases\domain\statement\dcl\DropUserStatementTestCase.java,0,0,0,3,0,3
 shardingsphere-master\shardingsphere-master\shardingsphere-infra\shardingsphere-infra-common\src\main\java\org\apache\shardingsphere\infra\database\type\DatabaseTypeAwareSPI.java,0,4,0,2,0,6
 shardingsphere-master\shardingsphere-master\shardingsphere-proxy\shardingsphere-proxy-backend\src\main\java\org\apache\shardingsphere\proxy\backend\text\admin\mysql\executor\information\SelectInformationSchemataExecutor.java,0,49,0,28,0,77
 shardingsphere-master\shardingsphere-master\shardingsphere-features\shardingsphere-db-discovery\shardingsphere-db-discovery-distsql\shardingsphere-db-discovery-distsql-statement\src\main\java\org\apache\shardingsphere\dbdiscovery\distsql\parser\segment\DatabaseDiscoveryConstructionSegment.java,0,10,0,3,0,13
 shardingsphere-master\shardingsphere-master\shardingsphere-sql-parser\shardingsphere-sql-parser-statement\src\main\java\org\apache\shardingsphere\sql\parser\sql\dialect\statement\sqlserver\dml\SQLServerSelectStatement.java,0,2,0,6,0,8
 shardingsphere-master\shardingsphere-master\shardingsphere-features\shardingsphere-shadow\shardingsphere-shadow-distsql\shardingsphere-shadow-distsql-handler\src\main\java\org\apache\shardingsphere\shadow\distsql\handler\update\CreateDefaultShadowAlgorithmStatementUpdater.java,0,16,0,13,0,29
 shardingsphere-master\shardingsphere-master\shardingsphere-features\shardingsphere-encrypt\shardingsphere-encrypt-core\src\main\java\org\apache\shardingsphere\encrypt\merge\dal\impl\EncryptColumnsMergedResult.java,62,23,0,12,0,35
 shardingsphere-master\shardingsphere-master\shardingsphere-proxy\shardingsphere-proxy-frontend\shardingsphere-proxy-frontend-opengauss\src\test\java\org\apache\shardingsphere\proxy\frontend\opengauss\command\query\extended\bind\OpenGaussComBatchBindExecutorTest.java,0,33,2,31,0,66
 shardingsphere-master\shardingsphere-master\shardingsphere-infra\shardingsphere-infra-datetime\shardingsphere-infra-datetime-type\shardingsphere-database-datetime\src\test\java\org\apache\shardingsphere\datetime\database\config\DatabaseDatetimeServiceConfigurationTest.java,0,5,0,3,0,8
 shardingsphere-master\shardingsphere-master\shardingsphere-kernel\shardingsphere-transaction\shardingsphere-transaction-core\src\main\java\org\apache\shardingsphere\transaction\spi\TransactionConfigurationFileGenerator.java,0,4,0,3,0,7
 shardingsphere-master\shardingsphere-master\shardingsphere-infra\shardingsphere-infra-executor\src\main\java\org\apache\shardingsphere\infra\executor\sql\execute\result\query\impl\raw\metadata\RawQueryResultMetaData.java,0,13,0,3,0,16
 shardingsphere-master\shardingsphere-master\shardingsphere-distsql\shardingsphere-distsql-statement\src\main\java\org\apache\shardingsphere\distsql\parser\statement\ral\common\updatable\AlterTrafficRuleStatement.java,0,2,0,2,0,4
 shardingsphere-master\shardingsphere-master\shardingsphere-kernel\shardingsphere-transaction\shardingsphere-transaction-type\shardingsphere-transaction-xa\shardingsphere-transaction-xa-core\src\test\java\org\apache\shardingsphere\transaction\xa\jta\datasource\swapper\impl\DefaultDataSourcePropertyProviderTest.java,0,13,0,5,0,18
 shardingsphere-master\shardingsphere-master\shardingsphere-test\shardingsphere-pipeline-test\src\test\java\org\apache\shardingsphere\data\pipeline\core\fixture\EmbedTestingServer.java,0,30,4,10,0,44
 shardingsphere-master\shardingsphere-master\shardingsphere-features\shardingsphere-encrypt\shardingsphere-encrypt-spring\shardingsphere-encrypt-spring-namespace\src\main\java\org\apache\shardingsphere\encrypt\spring\namespace\handler\EncryptRuleNamespaceHandler.java,0,4,0,8,0,12
 shardingsphere-master\shardingsphere-master\shardingsphere-proxy\shardingsphere-proxy-frontend\shardingsphere-proxy-frontend-mysql\src\main\java\org\apache\shardingsphere\proxy\frontend\mysql\command\query\text\fieldlist\MySQLComFieldListPacketExecutor.java,0,32,0,22,0,54
 shardingsphere-master\shardingsphere-master\shardingsphere-infra\shardingsphere-infra-binder\src\main\java\org\apache\shardingsphere\infra\binder\segment\insert\keygen\engine\GeneratedKeyContextEngine.java,0,34,1,28,0,63
 shardingsphere-master\shardingsphere-master\shardingsphere-kernel\shardingsphere-data-pipeline\shardingsphere-data-pipeline-dialect\shardingsphere-data-pipeline-mysql\src\main\java\org\apache\shardingsphere\data\pipeline\mysql\ingest\column\value\UnsignedMediumintHandler.java,0,4,0,1,0,5
 shardingsphere-master\shardingsphere-master\shardingsphere-jdbc\shardingsphere-jdbc-core\src\main\java\org\apache\shardingsphere\driver\state\circuit\statement\CircuitBreakerStatement.java,0,34,10,4,0,48
 shardingsphere-master\shardingsphere-master\shardingsphere-features\shardingsphere-shadow\shardingsphere-shadow-core\src\test\java\org\apache\shardingsphere\shadow\route\engine\dml\ShadowInsertStatementRoutingEngineTest.java,0,42,0,32,0,74
 shardingsphere-master\shardingsphere-master\shardingsphere-kernel\shardingsphere-authority\shardingsphere-authority-core\src\main\java\org\apache\shardingsphere\authority\rule\builder\DefaultAuthorityRuleConfigurationBuilder.java,0,7,0,6,0,13
 shardingsphere-master\shardingsphere-master\shardingsphere-sql-parser\shardingsphere-sql-parser-engine\src\main\java\org\apache\shardingsphere\sql\parser\exception\SQLParsingException.java,0,6,0,1,0,7
 shardingsphere-master\shardingsphere-master\shardingsphere-infra\shardingsphere-infra-common\src\main\java\org\apache\shardingsphere\infra\config\function\ResourceRequiredRuleConfiguration.java,0,1,0,1,0,2
 shardingsphere-master\shardingsphere-master\shardingsphere-features\shardingsphere-shadow\shardingsphere-shadow-spring\shardingsphere-shadow-spring-boot-starter\src\test\java\org\apache\shardingsphere\shadow\spring\boot\YmlShadowDefaultSpringBootStarterTest.java,36,18,0,15,0,33
 shardingsphere-master\shardingsphere-master\shardingsphere-sql-parser\shardingsphere-sql-parser-statement\src\main\java\org\apache\shardingsphere\sql\parser\sql\common\statement\tcl\XAStatement.java,7,3,1,3,0,7
 shardingsphere-master\shardingsphere-master\shardingsphere-infra\shardingsphere-infra-common\src\main\java\org\apache\shardingsphere\infra\yaml\config\swapper\mode\PersistRepositoryConfigurationYamlSwapperEngine.java,0,11,0,9,0,20
 shardingsphere-master\shardingsphere-master\shardingsphere-features\shardingsphere-sharding\shardingsphere-sharding-core\src\test\java\org\apache\shardingsphere\sharding\algorithm\sharding\cosid\CosIdSnowflakeIntervalShardingAlgorithmTest.java,0,65,1,27,0,93
 shardingsphere-master\shardingsphere-master\shardingsphere-sql-parser\shardingsphere-sql-parser-dialect\shardingsphere-sql-parser-sql92\src\main\java\org\apache\shardingsphere\sql\parser\sql92\visitor\statement\impl\SQL92DMLStatementSQLVisitor.java,0,94,0,135,0,229
 shardingsphere-master\shardingsphere-master\shardingsphere-features\shardingsphere-encrypt\shardingsphere-encrypt-distsql\shardingsphere-encrypt-distsql-statement\src\main\java\org\apache\shardingsphere\encrypt\distsql\parser\statement\AlterEncryptRuleStatement.java,0,3,0,3,0,6
 shardingsphere-master\shardingsphere-master\shardingsphere-db-protocol\shardingsphere-db-protocol-mysql\src\test\java\org\apache\shardingsphere\db\protocol\mysql\packet\binlog\row\column\value\integer\MySQLLongBinlogProtocolValueTest.java,0,7,0,4,0,11
 shardingsphere-master\shardingsphere-master\shardingsphere-proxy\shardingsphere-proxy-backend\src\test\java\org\apache\shardingsphere\proxy\backend\context\ProxyContextTest.java,0,50,4,33,0,87
 shardingsphere-master\shardingsphere-master\shardingsphere-features\shardingsphere-shadow\shardingsphere-shadow-core\src\main\java\org\apache\shardingsphere\shadow\algorithm\shadow\hint\ShadowHintExtractor.java,0,22,0,4,0,26
 shardingsphere-master\shardingsphere-master\shardingsphere-features\shardingsphere-sharding\shardingsphere-sharding-distsql\shardingsphere-sharding-distsql-statement\src\main\java\org\apache\shardingsphere\sharding\distsql\parser\statement\ShowShardingBindingTableRulesStatement.java,0,3,0,4,0,7
 shardingsphere-master\shardingsphere-master\shardingsphere-infra\shardingsphere-infra-executor\src\test\java\org\apache\shardingsphere\infra\executor\sql\execute\engine\jdbc\JDBCExecutorTest.java,0,13,0,12,0,25
 shardingsphere-master\shardingsphere-master\shardingsphere-test\shardingsphere-parser-test\src\main\java\org\apache\shardingsphere\test\sql\parser\parameterized\jaxb\cases\domain\statement\distsql\ral\DropTrafficRuleStatementTestCase.java,0,2,0,3,0,5
 shardingsphere-master\shardingsphere-master\shardingsphere-proxy\shardingsphere-proxy-backend\src\main\java\org\apache\shardingsphere\proxy\backend\text\admin\mysql\executor\ShowCurrentUserExecutor.java,0,16,0,13,0,29
 shardingsphere-master\shardingsphere-master\shardingsphere-jdbc\shardingsphere-jdbc-core\src\main\java\org\apache\shardingsphere\driver\jdbc\unsupported\AbstractUnsupportedOperationStatement.java,33,8,0,2,0,10
 shardingsphere-master\shardingsphere-master\shardingsphere-test\shardingsphere-parser-test\src\main\java\org\apache\shardingsphere\test\sql\parser\parameterized\asserts\statement\tcl\TCLStatementAssert.java,0,14,0,42,0,56
 shardingsphere-master\shardingsphere-master\shardingsphere-sql-parser\shardingsphere-sql-parser-statement\src\main\java\org\apache\shardingsphere\sql\parser\sql\common\segment\dml\pagination\rownum\RowNumberValueSegment.java,9,6,1,3,0,10
 shardingsphere-master\shardingsphere-master\shardingsphere-kernel\shardingsphere-traffic\shardingsphere-traffic-api\src\main\java\org\apache\shardingsphere\traffic\api\traffic\hint\HintTrafficAlgorithm.java,0,3,0,1,0,4
 shardingsphere-master\shardingsphere-master\shardingsphere-proxy\shardingsphere-proxy-backend\src\test\java\org\apache\shardingsphere\proxy\backend\communication\jdbc\transaction\LocalTransactionManagerTest.java,0,23,0,7,0,30
 shardingsphere-master\shardingsphere-master\shardingsphere-kernel\shardingsphere-data-pipeline\shardingsphere-data-pipeline-spi\src\main\java\org\apache\shardingsphere\data\pipeline\api\job\JobId.java,0,4,0,1,0,5
 shardingsphere-master\shardingsphere-master\shardingsphere-kernel\shardingsphere-data-pipeline\shardingsphere-data-pipeline-dialect\shardingsphere-data-pipeline-postgresql\src\test\java\org\apache\shardingsphere\data\pipeline\postgresql\importer\PostgreSQLImporterTest.java,0,14,0,9,0,23
 shardingsphere-master\shardingsphere-master\shardingsphere-test\shardingsphere-parser-test\src\main\java\org\apache\shardingsphere\test\sql\parser\parameterized\jaxb\cases\domain\statement\dal\SetResourceGroupStatementTestCase.java,0,2,0,4,0,6
 shardingsphere-master\shardingsphere-master\shardingsphere-infra\shardingsphere-infra-common\src\main\java\org\apache\shardingsphere\infra\config\RuleConfiguration.java,0,1,0,1,0,2
 shardingsphere-master\shardingsphere-master\shardingsphere-features\shardingsphere-db-discovery\shardingsphere-db-discovery-distsql\shardingsphere-db-discovery-distsql-statement\src\main\java\org\apache\shardingsphere\dbdiscovery\distsql\parser\statement\ShowDatabaseDiscoveryRulesStatement.java,0,3,0,4,0,7
 shardingsphere-master\shardingsphere-master\shardingsphere-infra\shardingsphere-infra-common\src\test\java\org\apache\shardingsphere\infra\database\metadata\dialect\SQL92DataSourceMetaDataTest.java,0,5,0,3,0,8
 shardingsphere-master\shardingsphere-master\shardingsphere-mode\shardingsphere-mode-type\shardingsphere-cluster-mode\shardingsphere-cluster-mode-core\src\main\java\org\apache\shardingsphere\mode\manager\cluster\coordinator\registry\config\event\version\SchemaVersionPreparedEvent.java,0,4,0,2,0,6
 shardingsphere-master\shardingsphere-master\shardingsphere-features\shardingsphere-sharding\shardingsphere-sharding-core\src\main\java\org\apache\shardingsphere\sharding\merge\dql\iterator\IteratorStreamMergedResult.java,0,7,0,3,0,10
 shardingsphere-master\shardingsphere-master\shardingsphere-db-protocol\shardingsphere-db-protocol-opengauss\src\test\java\org\apache\shardingsphere\db\protocol\opengauss\packet\command\query\extended\bind\OpenGaussComBatchBindPacketTest.java,0,20,0,12,0,32
 shardingsphere-master\shardingsphere-master\shardingsphere-sql-parser\shardingsphere-sql-parser-statement\src\main\java\org\apache\shardingsphere\sql\parser\sql\dialect\statement\oracle\ddl\OracleNoAuditStatement.java,0,1,0,5,0,6
 shardingsphere-master\shardingsphere-master\shardingsphere-test\shardingsphere-parser-test\src\main\java\org\apache\shardingsphere\test\sql\parser\parameterized\asserts\segment\having\HavingClauseAssert.java,0,6,0,9,0,15
 shardingsphere-master\shardingsphere-master\shardingsphere-kernel\shardingsphere-data-pipeline\shardingsphere-data-pipeline-dialect\shardingsphere-data-pipeline-mysql\src\main\java\org\apache\shardingsphere\data\pipeline\mysql\check\consistency\CRC32MatchMySQLSingleTableDataCalculator.java,0,18,0,16,0,34
 shardingsphere-master\shardingsphere-master\shardingsphere-mode\shardingsphere-mode-core\src\test\java\org\apache\shardingsphere\mode\metadata\persist\fixture\YamlRuleConfigurationFixture.java,0,4,0,2,0,6
 shardingsphere-master\shardingsphere-master\shardingsphere-infra\shardingsphere-infra-rewrite\src\main\java\org\apache\shardingsphere\infra\rewrite\sql\token\generator\aware\RouteContextAware.java,0,2,0,1,0,3
 shardingsphere-master\shardingsphere-master\shardingsphere-test\shardingsphere-parser-test\src\main\java\org\apache\shardingsphere\test\sql\parser\parameterized\asserts\segment\insert\InsertColumnsClauseAssert.java,0,7,0,12,0,19
 shardingsphere-master\shardingsphere-master\shardingsphere-db-protocol\shardingsphere-db-protocol-mysql\src\test\java\org\apache\shardingsphere\db\protocol\mysql\packet\command\query\binary\execute\protocol\MySQLInt8BinaryProtocolValueTest.java,0,8,0,2,0,10
 shardingsphere-master\shardingsphere-master\examples\shardingsphere-proxy-example\shardingsphere-proxy-hint-example\src\main\java\org\apache\shardingsphere\example\proxy\hint\ProxyHintExample.java,0,25,1,17,0,43
 shardingsphere-master\shardingsphere-master\shardingsphere-kernel\shardingsphere-authority\shardingsphere-authority-core\src\test\java\org\apache\shardingsphere\authority\rule\builder\AuthorityRuleBuilderTest.java,0,9,0,2,0,11
 shardingsphere-master\shardingsphere-master\shardingsphere-features\shardingsphere-sharding\shardingsphere-sharding-api\src\main\java\org\apache\shardingsphere\sharding\spi\ShardingAlgorithm.java,0,1,0,3,0,4
 shardingsphere-master\shardingsphere-master\examples\shardingsphere-jdbc-example\mixed-feature-example\sharding-readwrite-splitting-example\sharding-readwrite-splitting-raw-jdbc-example\src\main\java\org\apache\shardingsphere\example\sharding\readwrite\splitting\raw\factory\RangeDataSourceFactory.java,0,5,1,5,0,11
 shardingsphere-master\shardingsphere-master\shardingsphere-db-protocol\shardingsphere-db-protocol-postgresql\src\main\java\org\apache\shardingsphere\db\protocol\postgresql\packet\command\query\extended\bind\protocol\PostgreSQLTextTimestampUtils.java,0,6,0,4,0,10
 shardingsphere-master\shardingsphere-master\shardingsphere-jdbc\shardingsphere-jdbc-core\src\main\java\org\apache\shardingsphere\driver\jdbc\adapter\AdaptedDatabaseMetaData.java,741,157,0,9,0,166
 shardingsphere-master\shardingsphere-master\shardingsphere-kernel\shardingsphere-data-pipeline\shardingsphere-data-pipeline-dialect\shardingsphere-data-pipeline-opengauss\src\main\java\org\apache\shardingsphere\data\pipeline\opengauss\importer\OpenGaussImporter.java,0,6,0,8,0,14
 shardingsphere-master\shardingsphere-master\shardingsphere-db-protocol\shardingsphere-db-protocol-mysql\src\main\java\org\apache\shardingsphere\db\protocol\mysql\packet\MySQLPacket.java,0,2,0,1,0,3
 shardingsphere-master\shardingsphere-master\shardingsphere-distsql\shardingsphere-distsql-statement\src\main\java\org\apache\shardingsphere\distsql\parser\statement\rdl\alter\AlterRuleStatement.java,3,0,1,2,0,3
 shardingsphere-master\shardingsphere-master\shardingsphere-kernel\shardingsphere-traffic\shardingsphere-traffic-core\src\main\java\org\apache\shardingsphere\traffic\rule\builder\TrafficRuleBuilder.java,0,5,0,3,0,8
 shardingsphere-master\shardingsphere-master\shardingsphere-test\shardingsphere-parser-test\src\main\java\org\apache\shardingsphere\test\sql\parser\parameterized\asserts\statement\dal\impl\ShowCreateUserStatementAssert.java,0,5,0,7,0,12
 shardingsphere-master\shardingsphere-master\shardingsphere-test\shardingsphere-parser-test\src\main\java\org\apache\shardingsphere\test\sql\parser\parameterized\asserts\statement\distsql\rdl\drop\impl\DropShardingBroadcastTableRulesStatementAssert.java,0,9,0,12,0,21
 shardingsphere-master\shardingsphere-master\shardingsphere-sql-parser\shardingsphere-sql-parser-statement\src\main\java\org\apache\shardingsphere\sql\parser\sql\common\segment\generic\table\TableNameSegment.java,0,6,0,2,0,8
 shardingsphere-master\shardingsphere-master\shardingsphere-proxy\shardingsphere-proxy-frontend\shardingsphere-proxy-frontend-core\src\main\java\org\apache\shardingsphere\proxy\frontend\connection\ConnectionLimitContext.java,0,12,0,4,0,16
 shardingsphere-master\shardingsphere-master\shardingsphere-features\shardingsphere-readwrite-splitting\shardingsphere-readwrite-splitting-spring\shardingsphere-readwrite-splitting-spring-boot-starter\src\main\java\org\apache\shardingsphere\readwritesplitting\spring\boot\rule\YamlReadwriteSplittingRuleSpringBootConfiguration.java,0,3,0,2,0,5
 shardingsphere-master\shardingsphere-master\shardingsphere-features\shardingsphere-sharding\shardingsphere-sharding-core\src\test\java\org\apache\shardingsphere\sharding\route\engine\validator\ddl\ShardingCreateTableStatementValidatorTest.java,0,82,0,59,0,141
 shardingsphere-master\shardingsphere-master\shardingsphere-agent\shardingsphere-agent-core\src\test\java\org\apache\shardingsphere\agent\core\mock\material\Material.java,29,4,0,1,0,5
 shardingsphere-master\shardingsphere-master\shardingsphere-db-protocol\shardingsphere-db-protocol-mysql\src\test\java\org\apache\shardingsphere\db\protocol\mysql\packet\command\MySQLMySQLCommandPacketFactoryTest.java,0,113,0,59,0,172
 shardingsphere-master\shardingsphere-master\shardingsphere-sql-parser\shardingsphere-sql-parser-dialect\shardingsphere-sql-parser-oracle\src\main\java\org\apache\shardingsphere\sql\parser\oracle\parser\OracleLexer.java,0,4,0,2,0,6
 shardingsphere-master\shardingsphere-master\shardingsphere-infra\shardingsphere-infra-common\src\main\java\org\apache\shardingsphere\infra\lock\LockContext.java,0,4,0,1,0,5
 shardingsphere-master\shardingsphere-master\shardingsphere-test\shardingsphere-parser-test\src\main\java\org\apache\shardingsphere\test\sql\parser\parameterized\asserts\statement\ddl\impl\DropTableStatementAssert.java,0,7,0,9,0,16
 shardingsphere-master\shardingsphere-master\shardingsphere-test\shardingsphere-parser-test\src\main\java\org\apache\shardingsphere\test\sql\parser\parameterized\jaxb\cases\domain\segment\impl\distsql\ExpectedAlgorithm.java,0,5,0,4,0,9
 shardingsphere-master\shardingsphere-master\shardingsphere-sql-parser\shardingsphere-sql-parser-statement\src\main\java\org\apache\shardingsphere\sql\parser\sql\dialect\statement\postgresql\ddl\PostgreSQLDropExtensionStatement.java,0,1,0,5,0,6
 shardingsphere-master\shardingsphere-master\shardingsphere-features\shardingsphere-sharding\shardingsphere-sharding-core\src\main\java\org\apache\shardingsphere\sharding\algorithm\keygen\TimeService.java,12,2,0,1,0,3
 shardingsphere-master\shardingsphere-master\shardingsphere-kernel\shardingsphere-transaction\shardingsphere-transaction-type\shardingsphere-transaction-xa\shardingsphere-transaction-xa-core\src\test\java\org\apache\shardingsphere\transaction\xa\jta\datasource\XADataSourceFactoryTest.java,0,15,0,7,0,22
 shardingsphere-master\shardingsphere-master\shardingsphere-features\shardingsphere-db-discovery\shardingsphere-db-discovery-distsql\shardingsphere-db-discovery-distsql-statement\src\main\java\org\apache\shardingsphere\dbdiscovery\distsql\parser\statement\DropDatabaseDiscoveryTypeStatement.java,0,7,0,4,0,11
 shardingsphere-master\shardingsphere-master\shardingsphere-infra\shardingsphere-infra-common\src\main\java\org\apache\shardingsphere\infra\instance\definition\InstanceId.java,0,23,0,2,0,25
 shardingsphere-master\shardingsphere-master\shardingsphere-sql-parser\shardingsphere-sql-parser-statement\src\main\java\org\apache\shardingsphere\sql\parser\sql\dialect\statement\sqlserver\ddl\SQLServerDropTableStatement.java,0,3,0,5,0,8
 shardingsphere-master\shardingsphere-master\shardingsphere-infra\shardingsphere-infra-executor\src\main\java\org\apache\shardingsphere\infra\executor\sql\execute\result\query\type\memory\AbstractMemoryQueryResult.java,54,18,1,9,0,28
 shardingsphere-master\shardingsphere-master\shardingsphere-test\shardingsphere-integration-test\shardingsphere-integration-test-suite\src\test\java\org\apache\shardingsphere\test\integration\framework\param\array\ParameterizedArrayFactory.java,0,12,0,11,0,23
 shardingsphere-master\shardingsphere-master\shardingsphere-test\shardingsphere-integration-test\shardingsphere-integration-test-suite\src\test\java\org\apache\shardingsphere\test\integration\cases\IntegrationTestCasesLoader.java,0,30,0,18,0,48
 shardingsphere-master\shardingsphere-master\shardingsphere-distsql\shardingsphere-distsql-statement\src\main\java\org\apache\shardingsphere\distsql\parser\statement\ral\common\queryable\ShowVariableStatement.java,0,2,0,2,0,4
 shardingsphere-master\shardingsphere-master\shardingsphere-infra\shardingsphere-infra-route\src\test\java\org\apache\shardingsphere\infra\route\engine\PartialSQLRouteExecutorTest.java,0,29,0,17,0,46
 shardingsphere-master\shardingsphere-master\shardingsphere-sql-parser\shardingsphere-sql-parser-statement\src\main\java\org\apache\shardingsphere\sql\parser\sql\dialect\statement\postgresql\ddl\PostgreSQLCreateSequenceStatement.java,0,1,0,5,0,6
 shardingsphere-master\shardingsphere-master\shardingsphere-sql-parser\shardingsphere-sql-parser-statement\src\main\java\org\apache\shardingsphere\sql\parser\sql\common\segment\dml\order\item\ExpressionOrderByItemSegment.java,0,16,0,5,0,21
 shardingsphere-master\shardingsphere-master\shardingsphere-test\shardingsphere-parser-test\src\main\java\org\apache\shardingsphere\test\sql\parser\parameterized\jaxb\cases\domain\statement\distsql\rdl\create\CreateDefaultShardingStrategyStatementTestCase.java,0,3,0,5,0,8
 shardingsphere-master\shardingsphere-master\shardingsphere-kernel\shardingsphere-data-pipeline\shardingsphere-data-pipeline-dialect\shardingsphere-data-pipeline-postgresql\src\main\java\org\apache\shardingsphere\data\pipeline\postgresql\ingest\wal\event\WriteRowEvent.java,0,2,0,1,0,3
 shardingsphere-master\shardingsphere-master\shardingsphere-sql-parser\shardingsphere-sql-parser-statement\src\main\java\org\apache\shardingsphere\sql\parser\sql\dialect\statement\mysql\dal\MySQLAnalyzeTableStatement.java,0,1,0,4,0,5
 shardingsphere-master\shardingsphere-master\shardingsphere-features\shardingsphere-encrypt\shardingsphere-encrypt-core\src\main\java\org\apache\shardingsphere\encrypt\merge\dal\EncryptDALResultDecorator.java,0,10,0,13,0,23
 shardingsphere-master\shardingsphere-master\shardingsphere-sql-parser\shardingsphere-sql-parser-dialect\shardingsphere-sql-parser-sqlserver\src\main\java\org\apache\shardingsphere\sql\parser\sqlserver\visitor\statement\impl\SQLServerDMLStatementSQLVisitor.java,0,3,0,3,0,6
 shardingsphere-master\shardingsphere-master\shardingsphere-kernel\shardingsphere-transaction\shardingsphere-transaction-type\shardingsphere-transaction-xa\shardingsphere-transaction-xa-spi\src\main\java\org\apache\shardingsphere\transaction\xa\spi\XATransactionManagerProvider.java,0,10,0,4,0,14
 shardingsphere-master\shardingsphere-master\shardingsphere-kernel\shardingsphere-traffic\shardingsphere-traffic-core\src\main\java\org\apache\shardingsphere\traffic\algorithm\traffic\transaction\JDBCTrafficAlgorithm.java,0,5,1,6,0,12
 shardingsphere-master\shardingsphere-master\shardingsphere-features\shardingsphere-db-discovery\shardingsphere-db-discovery-provider\shardingsphere-db-discovery-mysql\src\main\java\org\apache\shardingsphere\dbdiscovery\mysql\AbstractDatabaseDiscoveryType.java,64,24,0,15,0,39
 shardingsphere-master\shardingsphere-master\shardingsphere-features\shardingsphere-encrypt\shardingsphere-encrypt-core\src\main\java\org\apache\shardingsphere\encrypt\algorithm\SM3EncryptAlgorithm.java,0,23,0,8,0,31
 shardingsphere-master\shardingsphere-master\shardingsphere-kernel\shardingsphere-data-pipeline\shardingsphere-data-pipeline-core\src\main\java\org\apache\shardingsphere\data\pipeline\core\spi\ingest\channel\MemoryPipelineChannelFactory.java,0,19,0,8,0,27
 shardingsphere-master\shardingsphere-master\shardingsphere-infra\shardingsphere-infra-common\src\main\java\org\apache\shardingsphere\infra\metadata\schema\builder\SchemaBuilderMaterials.java,0,9,0,1,0,10
 shardingsphere-master\shardingsphere-master\shardingsphere-proxy\shardingsphere-proxy-backend\src\test\java\org\apache\shardingsphere\proxy\backend\communication\jdbc\recognizer\impl\OpenGaussRecognizerTest.java,0,8,0,5,0,13
 shardingsphere-master\shardingsphere-master\shardingsphere-infra\shardingsphere-infra-federation\shardingsphere-infra-federation-optimizer\src\main\java\org\apache\shardingsphere\infra\federation\optimizer\converter\segment\expression\impl\ListExpressionConverter.java,0,7,0,11,0,18
 shardingsphere-master\shardingsphere-master\shardingsphere-proxy\shardingsphere-proxy-backend\src\main\java\org\apache\shardingsphere\proxy\backend\text\transaction\TransactionBackendHandlerFactory.java,0,19,0,26,0,45
 shardingsphere-master\shardingsphere-master\shardingsphere-features\shardingsphere-readwrite-splitting\shardingsphere-readwrite-splitting-core\src\main\java\org\apache\shardingsphere\readwritesplitting\rule\builder\ReadwriteSplittingRuleBuilder.java,0,6,0,6,0,12
 shardingsphere-master\shardingsphere-master\shardingsphere-db-protocol\shardingsphere-db-protocol-mysql\src\test\java\org\apache\shardingsphere\db\protocol\mysql\packet\binlog\row\column\value\integer\MySQLBitBinlogProtocolValueTest.java,0,23,0,3,0,26
 shardingsphere-master\shardingsphere-master\shardingsphere-sql-parser\shardingsphere-sql-parser-statement\src\main\java\org\apache\shardingsphere\sql\parser\sql\dialect\handler\ddl\CreateViewStatementHandler.java,0,3,0,7,1,11
 shardingsphere-master\shardingsphere-master\shardingsphere-features\shardingsphere-shadow\shardingsphere-shadow-distsql\shardingsphere-shadow-distsql-handler\src\main\java\org\apache\shardingsphere\shadow\distsql\handler\update\DropShadowAlgorithmStatementUpdater.java,0,37,0,31,0,68
 shardingsphere-master\shardingsphere-master\examples\shardingsphere-example-generator\src\main\java\org\apache\shardingsphere\example\generator\core\yaml\config\YamlExampleConfiguration.java,0,13,0,1,0,14
 shardingsphere-master\shardingsphere-master\shardingsphere-kernel\shardingsphere-data-pipeline\shardingsphere-data-pipeline-core\src\main\java\org\apache\shardingsphere\data\pipeline\core\ingest\channel\memory\ManualBitSet.java,0,16,1,6,0,23
 shardingsphere-master\shardingsphere-master\shardingsphere-infra\shardingsphere-infra-rewrite\src\main\java\org\apache\shardingsphere\infra\rewrite\sql\token\generator\generic\RemoveTokenGenerator.java,0,22,0,21,0,43
 shardingsphere-master\shardingsphere-master\shardingsphere-infra\shardingsphere-infra-binder\src\test\java\org\apache\shardingsphere\infra\binder\segment\select\projection\impl\AggregationProjectionTest.java,0,13,2,5,0,20
 shardingsphere-master\shardingsphere-master\shardingsphere-test\shardingsphere-parser-test\src\main\java\org\apache\shardingsphere\test\sql\parser\parameterized\jaxb\cases\domain\statement\distsql\rql\ShowShardingKeyGeneratorsStatementTestCase.java,0,3,0,5,0,8
 shardingsphere-master\shardingsphere-master\shardingsphere-infra\shardingsphere-infra-executor\src\main\java\org\apache\shardingsphere\infra\executor\check\SQLCheckException.java,0,3,0,1,0,4
 shardingsphere-master\shardingsphere-master\shardingsphere-sql-parser\shardingsphere-sql-parser-statement\src\main\java\org\apache\shardingsphere\sql\parser\sql\common\segment\generic\DataTypeLengthSegment.java,0,9,0,1,0,10
 shardingsphere-master\shardingsphere-master\shardingsphere-db-protocol\shardingsphere-db-protocol-mysql\src\main\java\org\apache\shardingsphere\db\protocol\mysql\packet\command\MySQLCommandPacketTypeLoader.java,0,4,0,3,0,7
 shardingsphere-master\shardingsphere-master\shardingsphere-features\shardingsphere-db-discovery\shardingsphere-db-discovery-provider\shardingsphere-db-discovery-mysql\src\test\java\org\apache\shardingsphere\dbdiscovery\mysql\type\ShowSlaveStatusDatabaseDiscoveryTypeTest.java,0,19,5,8,0,32
 shardingsphere-master\shardingsphere-master\shardingsphere-mode\shardingsphere-mode-type\shardingsphere-cluster-mode\shardingsphere-cluster-mode-core\src\main\java\org\apache\shardingsphere\mode\manager\cluster\coordinator\registry\status\storage\watcher\StorageNodeStateChangedWatcher.java,0,11,2,16,0,29
 shardingsphere-master\shardingsphere-master\shardingsphere-sql-parser\shardingsphere-sql-parser-dialect\shardingsphere-sql-parser-sqlserver\src\main\java\org\apache\shardingsphere\sql\parser\sqlserver\visitor\statement\impl\SQLServerTCLStatementSQLVisitor.java,0,20,0,28,0,48
 shardingsphere-master\shardingsphere-master\shardingsphere-infra\shardingsphere-infra-common\src\test\java\org\apache\shardingsphere\infra\datasource\props\custom\CustomDataSourcePropertiesTest.java,0,12,0,6,0,18
 shardingsphere-master\shardingsphere-master\shardingsphere-features\shardingsphere-sharding\shardingsphere-sharding-core\src\test\java\org\apache\shardingsphere\sharding\route\engine\type\ignore\ShardingIgnoreRoutingEngineTest.java,0,5,0,3,0,8
 shardingsphere-master\shardingsphere-master\shardingsphere-infra\shardingsphere-infra-federation\shardingsphere-infra-federation-executor\src\main\java\org\apache\shardingsphere\infra\federation\executor\original\row\EmptyRowEnumerator.java,0,5,2,1,0,8
 shardingsphere-master\shardingsphere-master\shardingsphere-jdbc\shardingsphere-jdbc-spring\shardingsphere-jdbc-spring-infra\shardingsphere-jdbc-spring-namespace-infra\src\test\java\org\apache\shardingsphere\spring\namespace\registry\ShardingSphereAlgorithmBeanRegistryTest.java,0,8,0,7,0,15
 shardingsphere-master\shardingsphere-master\shardingsphere-test\shardingsphere-parser-test\src\main\java\org\apache\shardingsphere\test\sql\parser\parameterized\jaxb\cases\domain\statement\distsql\rql\ShowUnusedShardingAlgorithmsStatementTestCase.java,0,3,0,5,0,8
 shardingsphere-master\shardingsphere-master\shardingsphere-sql-parser\shardingsphere-sql-parser-statement\src\main\java\org\apache\shardingsphere\sql\parser\sql\dialect\statement\postgresql\dml\PostgreSQLInsertStatement.java,0,3,0,6,0,9
 shardingsphere-master\shardingsphere-master\shardingsphere-infra\shardingsphere-infra-binder\src\test\java\org\apache\shardingsphere\infra\binder\statement\ddl\AlterIndexStatementContextTest.java,0,10,0,14,0,24
 shardingsphere-master\shardingsphere-master\shardingsphere-sql-parser\shardingsphere-sql-parser-statement\src\main\java\org\apache\shardingsphere\sql\parser\sql\dialect\statement\oracle\ddl\OracleAlterSystemStatement.java,3,1,0,4,0,5
 shardingsphere-master\shardingsphere-master\shardingsphere-features\shardingsphere-encrypt\shardingsphere-encrypt-core\src\test\java\org\apache\shardingsphere\encrypt\yaml\swapper\rule\EncryptColumnRuleConfigurationYamlSwapperTest.java,0,12,0,10,0,22
 shardingsphere-master\shardingsphere-master\shardingsphere-infra\shardingsphere-infra-federation\shardingsphere-infra-federation-executor\src\main\java\org\apache\shardingsphere\infra\federation\executor\FederationExecutor.java,0,6,0,7,0,13
 shardingsphere-master\shardingsphere-master\shardingsphere-test\shardingsphere-parser-test\src\main\java\org\apache\shardingsphere\test\sql\parser\parameterized\jaxb\cases\domain\segment\impl\distsql\rdl\ExpectedShardingBindingTableRule.java,0,3,0,4,0,7
 shardingsphere-master\shardingsphere-master\shardingsphere-proxy\shardingsphere-proxy-frontend\shardingsphere-proxy-frontend-core\src\main\java\org\apache\shardingsphere\proxy\frontend\protocol\FrontDatabaseProtocolTypeFactory.java,0,14,0,9,0,23
 shardingsphere-master\shardingsphere-master\shardingsphere-proxy\shardingsphere-proxy-backend\src\main\java\org\apache\shardingsphere\proxy\backend\config\yaml\swapper\YamlProxyConfigurationSwapper.java,0,23,0,21,0,44
 shardingsphere-master\shardingsphere-master\shardingsphere-features\shardingsphere-encrypt\shardingsphere-encrypt-core\src\main\java\org\apache\shardingsphere\encrypt\merge\dql\EncryptDQLResultDecorator.java,0,8,0,7,0,15
 shardingsphere-master\shardingsphere-master\shardingsphere-mode\shardingsphere-mode-core\src\main\java\org\apache\shardingsphere\mode\metadata\MetaDataContexts.java,0,25,0,6,0,31
 shardingsphere-master\shardingsphere-master\shardingsphere-test\shardingsphere-parser-test\src\main\java\org\apache\shardingsphere\test\sql\parser\parameterized\jaxb\cases\domain\statement\dcl\SetRoleStatementTestCase.java,0,0,0,3,0,3
 shardingsphere-master\shardingsphere-master\shardingsphere-infra\shardingsphere-infra-executor\src\main\java\org\apache\shardingsphere\infra\executor\sql\prepare\driver\SQLExecutionUnitBuilder.java,0,5,0,5,0,10
 shardingsphere-master\shardingsphere-master\shardingsphere-kernel\shardingsphere-data-pipeline\shardingsphere-data-pipeline-dialect\shardingsphere-data-pipeline-mysql\src\test\java\org\apache\shardingsphere\data\pipeline\mysql\ingest\MySQLPositionInitializerTest.java,0,19,6,5,0,30
 shardingsphere-master\shardingsphere-master\shardingsphere-sql-parser\shardingsphere-sql-parser-statement\src\main\java\org\apache\shardingsphere\sql\parser\sql\common\segment\dml\expr\complex\CommonExpressionSegment.java,0,7,0,2,0,9
 shardingsphere-master\shardingsphere-master\shardingsphere-db-protocol\shardingsphere-db-protocol-mysql\src\test\java\org\apache\shardingsphere\db\protocol\mysql\packet\command\query\MySQLColumnDefinition41PacketTest.java,0,21,0,8,0,29
 shardingsphere-master\shardingsphere-master\shardingsphere-jdbc\shardingsphere-jdbc-spring\shardingsphere-jdbc-transaction-spring\src\test\java\org\apache\shardingsphere\spring\transaction\fixture\MockService.java,32,3,0,2,0,5
 shardingsphere-master\shardingsphere-master\shardingsphere-test\shardingsphere-parser-test\src\main\java\org\apache\shardingsphere\test\sql\parser\parameterized\jaxb\cases\domain\segment\impl\table\ExpectedOwner.java,0,2,0,3,0,5
 shardingsphere-master\shardingsphere-master\shardingsphere-spi\src\test\java\org\apache\shardingsphere\spi\fixture\FixtureCustomInterface.java,0,1,0,1,0,2
 shardingsphere-master\shardingsphere-master\shardingsphere-kernel\shardingsphere-transaction\shardingsphere-transaction-type\shardingsphere-transaction-xa\shardingsphere-transaction-xa-core\src\main\java\org\apache\shardingsphere\transaction\xa\jta\datasource\properties\dialect\H2XADataSourceDefinition.java,0,3,0,3,0,6
 shardingsphere-master\shardingsphere-master\shardingsphere-infra\shardingsphere-infra-federation\shardingsphere-infra-federation-optimizer\src\main\java\org\apache\shardingsphere\infra\federation\optimizer\ShardingSphereOptimizer.java,0,22,0,17,0,39
 shardingsphere-master\shardingsphere-master\shardingsphere-features\shardingsphere-sharding\shardingsphere-sharding-core\src\main\java\org\apache\shardingsphere\sharding\route\engine\condition\generator\impl\ConditionValueInOperatorGenerator.java,0,6,0,14,0,20
 shardingsphere-master\shardingsphere-master\shardingsphere-infra\shardingsphere-infra-binder\src\main\java\org\apache\shardingsphere\infra\binder\statement\ddl\DropIndexStatementContext.java,0,11,0,11,0,22
 shardingsphere-master\shardingsphere-master\shardingsphere-test\shardingsphere-parser-test\src\main\java\org\apache\shardingsphere\test\sql\parser\parameterized\jaxb\cases\domain\statement\distsql\rdl\create\AddResourceStatementTestCase.java,0,3,0,4,0,7
 shardingsphere-master\shardingsphere-master\shardingsphere-db-protocol\shardingsphere-db-protocol-opengauss\src\main\java\org\apache\shardingsphere\db\protocol\opengauss\packet\command\OpenGaussCommandPacketFactory.java,0,11,0,24,0,35
 shardingsphere-master\shardingsphere-master\shardingsphere-agent\shardingsphere-agent-core\src\test\java\org\apache\shardingsphere\agent\core\mock\material\ConstructorMaterial.java,7,3,0,1,0,4
 shardingsphere-master\shardingsphere-master\shardingsphere-features\shardingsphere-db-discovery\shardingsphere-db-discovery-distsql\shardingsphere-db-discovery-distsql-handler\src\main\java\org\apache\shardingsphere\dbdiscovery\distsql\handler\converter\DatabaseDiscoveryRuleStatementConverter.java,0,34,0,35,0,69
 shardingsphere-master\shardingsphere-master\shardingsphere-proxy\shardingsphere-proxy-backend\src\test\java\org\apache\shardingsphere\proxy\backend\text\TextProtocolBackendHandlerFactoryTest.java,0,95,0,61,0,156
 shardingsphere-master\shardingsphere-master\shardingsphere-sql-parser\shardingsphere-sql-parser-statement\src\main\java\org\apache\shardingsphere\sql\parser\sql\common\statement\tcl\BeginDistributedTransactionStatement.java,3,2,1,3,0,6
 shardingsphere-master\shardingsphere-master\shardingsphere-infra\shardingsphere-infra-common\src\test\java\org\apache\shardingsphere\infra\datasource\pool\creator\type\HikariDataSourcePoolCreatorTest.java,0,6,0,4,0,10
 shardingsphere-master\shardingsphere-master\shardingsphere-db-protocol\shardingsphere-db-protocol-postgresql\src\test\java\org\apache\shardingsphere\db\protocol\postgresql\packet\command\query\extended\bind\protocol\PostgreSQLInt2ArrayBinaryProtocolValueTest.java,0,13,0,5,0,18
 shardingsphere-master\shardingsphere-master\shardingsphere-features\shardingsphere-encrypt\shardingsphere-encrypt-core\src\test\java\org\apache\shardingsphere\encrypt\rewrite\impl\EncryptEqualConditionTest.java,0,4,0,4,0,8
 shardingsphere-master\shardingsphere-master\shardingsphere-kernel\shardingsphere-traffic\shardingsphere-traffic-api\src\main\java\org\apache\shardingsphere\traffic\api\traffic\identifier\SimplifiedTrafficAlgorithm.java,0,1,0,1,0,2
 shardingsphere-master\shardingsphere-master\shardingsphere-kernel\shardingsphere-authority\shardingsphere-authority-core\src\main\java\org\apache\shardingsphere\authority\constant\AuthorityOrder.java,0,3,0,1,0,4
 shardingsphere-master\shardingsphere-master\shardingsphere-features\shardingsphere-sharding\shardingsphere-sharding-spring\shardingsphere-sharding-spring-namespace\src\test\java\org\apache\shardingsphere\sharding\spring\namespace\util\FieldValueUtil.java,0,11,1,5,0,17
 shardingsphere-master\shardingsphere-master\shardingsphere-proxy\shardingsphere-proxy-backend\src\test\java\org\apache\shardingsphere\proxy\backend\text\admin\postgresql\executor\SelectTableExecutorTest.java,0,31,2,23,0,56
 shardingsphere-master\shardingsphere-master\shardingsphere-sql-parser\shardingsphere-sql-parser-statement\src\main\java\org\apache\shardingsphere\sql\parser\sql\common\statement\dml\MergeStatement.java,13,11,1,7,4,23
 shardingsphere-master\shardingsphere-master\shardingsphere-test\shardingsphere-parser-test\src\main\java\org\apache\shardingsphere\test\sql\parser\parameterized\asserts\statement\distsql\ral\impl\common\updatable\AlterTrafficRuleStatementAssert.java,0,12,1,16,0,29
 shardingsphere-master\shardingsphere-master\shardingsphere-features\shardingsphere-sharding\shardingsphere-sharding-core\src\test\java\org\apache\shardingsphere\sharding\merge\dal\ShardingDALResultMergerTest.java,0,43,0,38,0,81
 shardingsphere-master\shardingsphere-master\shardingsphere-agent\shardingsphere-agent-plugins\shardingsphere-agent-plugin-metrics\shardingsphere-agent-metrics-api\src\main\java\org\apache\shardingsphere\agent\metrics\api\advice\SQLRouteEngineAdvice.java,0,10,0,13,0,23
 shardingsphere-master\shardingsphere-master\shardingsphere-test\shardingsphere-parser-test\src\main\java\org\apache\shardingsphere\test\sql\parser\parameterized\asserts\statement\ddl\impl\AlterIndexStatementAssert.java,0,16,0,20,0,36
 shardingsphere-master\shardingsphere-master\shardingsphere-sql-parser\shardingsphere-sql-parser-statement\src\main\java\org\apache\shardingsphere\sql\parser\sql\dialect\statement\mysql\dal\MySQLShowPrivilegesStatement.java,0,1,0,5,0,6
 shardingsphere-master\shardingsphere-master\shardingsphere-db-protocol\shardingsphere-db-protocol-postgresql\src\test\java\org\apache\shardingsphere\db\protocol\postgresql\packet\generic\PostgreSQLComStartupPacketTest.java,0,16,0,9,0,25
 shardingsphere-master\shardingsphere-master\shardingsphere-distsql\shardingsphere-distsql-parser\src\main\java\org\apache\shardingsphere\distsql\parser\core\advanced\AdvancedDistSQLStatementVisitor.java,0,4,0,9,0,13
 shardingsphere-master\shardingsphere-master\shardingsphere-sql-parser\shardingsphere-sql-parser-statement\src\main\java\org\apache\shardingsphere\sql\parser\sql\common\segment\dml\pagination\top\TopProjectionSegment.java,0,9,0,4,0,13
 shardingsphere-master\shardingsphere-master\shardingsphere-test\shardingsphere-parser-test\src\main\java\org\apache\shardingsphere\test\sql\parser\parameterized\jaxb\cases\domain\statement\ddl\CreateTableStatementTestCase.java,0,13,0,10,0,23
 shardingsphere-master\shardingsphere-master\shardingsphere-test\shardingsphere-parser-test\src\main\java\org\apache\shardingsphere\test\sql\parser\parameterized\asserts\statement\distsql\rql\impl\rule\ShowRulesUsedResourceStatementAssert.java,0,9,0,13,0,22
 shardingsphere-master\shardingsphere-master\shardingsphere-proxy\shardingsphere-proxy-backend\src\test\java\org\apache\shardingsphere\proxy\backend\text\distsql\ral\common\queryable\ShowAuthorityRuleHandlerTest.java,0,13,0,11,0,24
 shardingsphere-master\shardingsphere-master\examples\shardingsphere-jdbc-example\mixed-feature-example\sharding-readwrite-splitting-example\sharding-readwrite-splitting-raw-jdbc-example\src\main\java\org\apache\shardingsphere\example\sharding\readwrite\splitting\raw\factory\DataSourceFactory.java,0,6,1,5,0,12
 shardingsphere-master\shardingsphere-master\shardingsphere-features\shardingsphere-encrypt\shardingsphere-encrypt-core\src\test\java\org\apache\shardingsphere\encrypt\rewrite\pojo\EncryptPredicateInRightValueTokenTest.java,0,6,0,4,0,10
 shardingsphere-master\shardingsphere-master\shardingsphere-test\shardingsphere-parser-test\src\main\java\org\apache\shardingsphere\test\sql\parser\parameterized\asserts\statement\dcl\impl\CreateRoleStatementAssert.java,0,4,1,6,0,11
 shardingsphere-master\shardingsphere-master\shardingsphere-features\shardingsphere-readwrite-splitting\shardingsphere-readwrite-splitting-spring\shardingsphere-readwrite-splitting-spring-boot-starter\src\main\java\org\apache\shardingsphere\readwritesplitting\spring\boot\algorithm\ReadwriteSplittingAlgorithmProvidedBeanRegistry.java,0,9,0,7,0,16
 shardingsphere-master\shardingsphere-master\shardingsphere-sql-parser\shardingsphere-sql-parser-statement\src\main\java\org\apache\shardingsphere\sql\parser\sql\dialect\handler\dal\FlushStatementHandler.java,0,3,0,7,1,11
 shardingsphere-master\shardingsphere-master\shardingsphere-kernel\shardingsphere-data-pipeline\shardingsphere-data-pipeline-core\src\main\java\org\apache\shardingsphere\data\pipeline\core\importer\AbstractImporter.java,169,63,3,35,0,101
 shardingsphere-master\shardingsphere-master\shardingsphere-proxy\shardingsphere-proxy-backend\src\main\java\org\apache\shardingsphere\proxy\backend\exception\BackendConnectionException.java,0,8,0,1,0,9
 shardingsphere-master\shardingsphere-master\shardingsphere-test\shardingsphere-rewrite-test\src\test\java\org\apache\shardingsphere\sharding\rewrite\parameterized\entity\RewriteAssertionsRootEntity.java,0,4,0,1,0,5
 shardingsphere-master\shardingsphere-master\shardingsphere-db-protocol\shardingsphere-db-protocol-postgresql\src\test\java\org\apache\shardingsphere\db\protocol\postgresql\packet\command\query\extended\bind\protocol\PostgreSQLStringArrayBinaryProtocolValueTest.java,0,11,0,5,0,16
 shardingsphere-master\shardingsphere-master\shardingsphere-sql-parser\shardingsphere-sql-parser-statement\src\main\java\org\apache\shardingsphere\sql\parser\sql\common\segment\ddl\constraint\alter\ModifyConstraintDefinitionSegment.java,0,7,0,5,0,12
 shardingsphere-master\shardingsphere-master\shardingsphere-infra\shardingsphere-infra-common\src\main\java\org\apache\shardingsphere\infra\metadata\ShardingSphereMetaData.java,0,34,0,15,0,49
 shardingsphere-master\shardingsphere-master\shardingsphere-spi\src\main\java\org\apache\shardingsphere\spi\ShardingSphereServiceLoader.java,0,14,0,7,0,21
 shardingsphere-master\shardingsphere-master\shardingsphere-spi\src\main\java\org\apache\shardingsphere\spi\required\RequiredSPIRegistry.java,0,6,0,5,0,11
 shardingsphere-master\shardingsphere-master\shardingsphere-features\shardingsphere-sharding\shardingsphere-sharding-core\src\main\java\org\apache\shardingsphere\sharding\merge\dql\groupby\aggregation\DistinctCountAggregationUnit.java,0,5,0,1,0,6
 shardingsphere-master\shardingsphere-master\shardingsphere-proxy\shardingsphere-proxy-frontend\shardingsphere-proxy-frontend-mysql\src\test\java\org\apache\shardingsphere\proxy\frontend\mysql\command\query\text\query\MySQLMultiStatementsHandlerTest.java,0,27,2,24,0,53
 shardingsphere-master\shardingsphere-master\shardingsphere-infra\shardingsphere-infra-federation\shardingsphere-infra-federation-optimizer\src\main\java\org\apache\shardingsphere\infra\federation\optimizer\context\planner\OptimizerPlannerContextFactory.java,0,31,0,28,0,59
 shardingsphere-master\shardingsphere-master\shardingsphere-db-protocol\shardingsphere-db-protocol-postgresql\src\main\java\org\apache\shardingsphere\db\protocol\postgresql\packet\command\query\extended\parse\PostgreSQLComParsePacket.java,0,15,1,7,0,23
 shardingsphere-master\shardingsphere-master\shardingsphere-test\shardingsphere-parser-test\src\main\java\org\apache\shardingsphere\test\sql\parser\parameterized\jaxb\cases\domain\statement\tcl\BeginTransactionStatementTestCase.java,0,1,0,3,0,4
 shardingsphere-master\shardingsphere-master\shardingsphere-test\shardingsphere-parser-test\src\main\java\org\apache\shardingsphere\test\sql\parser\parameterized\asserts\segment\distsql\SchemaAssert.java,0,4,0,8,0,12
 shardingsphere-master\shardingsphere-master\shardingsphere-infra\shardingsphere-infra-federation\shardingsphere-infra-federation-optimizer\src\main\java\org\apache\shardingsphere\infra\federation\optimizer\converter\segment\orderby\OrderByConverter.java,0,11,0,12,0,23
 shardingsphere-master\shardingsphere-master\shardingsphere-features\shardingsphere-shadow\shardingsphere-shadow-distsql\shardingsphere-shadow-distsql-parser\src\main\java\org\apache\shardingsphere\shadow\distsql\parser\core\ShadowDistSQLParser.java,0,5,0,4,0,9
 shardingsphere-master\shardingsphere-master\shardingsphere-jdbc\shardingsphere-jdbc-core\src\test\java\org\apache\shardingsphere\driver\jdbc\base\AbstractShardingSphereDataSourceForShadowTest.java,39,18,0,8,0,26
 shardingsphere-master\shardingsphere-master\shardingsphere-test\shardingsphere-parser-test\src\main\java\org\apache\shardingsphere\test\sql\parser\parameterized\asserts\statement\dal\impl\ShowBinlogEventsStatementAssert.java,0,10,0,14,0,24
 shardingsphere-master\shardingsphere-master\shardingsphere-features\shardingsphere-sharding\shardingsphere-sharding-distsql\shardingsphere-sharding-distsql-handler\src\main\java\org\apache\shardingsphere\scaling\distsql\handler\EnableShardingScalingRuleStatementUpdater.java,0,21,0,18,0,39
 shardingsphere-master\shardingsphere-master\shardingsphere-infra\shardingsphere-infra-common\src\main\java\org\apache\shardingsphere\infra\distsql\exception\rule\InvalidAlgorithmConfigurationException.java,0,16,0,7,0,23
 shardingsphere-master\shardingsphere-master\shardingsphere-features\shardingsphere-encrypt\shardingsphere-encrypt-core\src\main\java\org\apache\shardingsphere\encrypt\rewrite\token\EncryptTokenGenerateBuilder.java,0,23,0,26,0,49
 shardingsphere-master\shardingsphere-master\shardingsphere-features\shardingsphere-readwrite-splitting\shardingsphere-readwrite-splitting-distsql\shardingsphere-readwrite-splitting-distsql-handler\src\main\java\org\apache\shardingsphere\readwritesplitting\distsql\handler\update\CreateReadwriteSplittingRuleStatementUpdater.java,0,45,0,46,0,91
 shardingsphere-master\shardingsphere-master\shardingsphere-agent\shardingsphere-agent-plugins\shardingsphere-agent-plugin-metrics\shardingsphere-agent-metrics-prometheus\src\test\java\org\apache\shardingsphere\agent\metrics\prometheus\service\PrometheusPluginBootServiceTest.java,0,14,0,7,0,21
 shardingsphere-master\shardingsphere-master\shardingsphere-jdbc\shardingsphere-jdbc-core\src\main\java\org\apache\shardingsphere\driver\executor\callback\impl\StatementExecuteQueryCallback.java,0,5,0,3,0,8
 shardingsphere-master\shardingsphere-master\examples\example-core\example-raw-jdbc\src\main\java\org\apache\shardingsphere\example\core\jdbc\repository\RangeOrderRepositoryImpl.java,0,4,0,2,0,6
 shardingsphere-master\shardingsphere-master\shardingsphere-infra\shardingsphere-infra-common\src\main\java\org\apache\shardingsphere\infra\config\scope\GlobalRuleConfiguration.java,0,1,0,1,0,2
 shardingsphere-master\shardingsphere-master\shardingsphere-features\shardingsphere-sharding\shardingsphere-sharding-api\src\main\java\org\apache\shardingsphere\sharding\api\config\strategy\sharding\StandardShardingStrategyConfiguration.java,0,11,0,4,0,15
 shardingsphere-master\shardingsphere-master\shardingsphere-sql-parser\shardingsphere-sql-parser-statement\src\main\java\org\apache\shardingsphere\sql\parser\sql\dialect\statement\opengauss\tcl\OpenGaussSetConstraintsStatement.java,0,1,0,5,0,6
 shardingsphere-master\shardingsphere-master\shardingsphere-db-protocol\shardingsphere-db-protocol-postgresql\src\main\java\org\apache\shardingsphere\db\protocol\postgresql\packet\command\query\extended\sync\PostgreSQLComSyncPacket.java,0,5,1,6,0,12
 shardingsphere-master\shardingsphere-master\shardingsphere-test\shardingsphere-parser-test\src\main\java\org\apache\shardingsphere\test\sql\parser\parameterized\jaxb\cases\domain\statement\ddl\CommentStatementTestCase.java,0,6,0,6,0,12
 shardingsphere-master\shardingsphere-master\examples\example-core\example-raw-jdbc\src\main\java\org\apache\shardingsphere\example\core\jdbc\service\OrderServiceImpl.java,0,38,0,15,0,53
 shardingsphere-master\shardingsphere-master\shardingsphere-test\shardingsphere-parser-test\src\main\java\org\apache\shardingsphere\test\sql\parser\parameterized\jaxb\cases\domain\statement\dal\ShowCreateUserStatementTestCase.java,0,2,0,4,0,6
 shardingsphere-master\shardingsphere-master\shardingsphere-kernel\shardingsphere-data-pipeline\shardingsphere-data-pipeline-dialect\shardingsphere-data-pipeline-postgresql\src\main\java\org\apache\shardingsphere\data\pipeline\postgresql\PostgreSQLScalingEntry.java,0,5,0,4,0,9
 shardingsphere-master\shardingsphere-master\shardingsphere-proxy\shardingsphere-proxy-backend\src\main\java\org\apache\shardingsphere\proxy\backend\response\header\query\QueryResponseHeader.java,0,2,0,2,0,4
 shardingsphere-master\shardingsphere-master\shardingsphere-kernel\shardingsphere-transaction\shardingsphere-transaction-core\src\test\java\org\apache\shardingsphere\transaction\core\TransactionTypeHolderTest.java,0,8,0,1,0,9
 shardingsphere-master\shardingsphere-master\shardingsphere-features\shardingsphere-sharding\shardingsphere-sharding-spring\shardingsphere-sharding-spring-namespace\src\main\java\org\apache\shardingsphere\sharding\spring\namespace\tag\algorithm\ShardingAlgorithmBeanDefinitionTag.java,0,3,0,1,0,4
 shardingsphere-master\shardingsphere-master\shardingsphere-test\shardingsphere-integration-test\shardingsphere-integration-test-fixture\src\test\java\org\apache\shardingsphere\test\integration\fixture\ConstantKeyGenerateAlgorithm.java,0,5,1,2,0,8
 shardingsphere-master\shardingsphere-master\shardingsphere-sql-parser\shardingsphere-sql-parser-statement\src\main\java\org\apache\shardingsphere\sql\parser\sql\common\statement\ddl\TruncateStatement.java,5,3,1,4,1,9
 shardingsphere-master\shardingsphere-master\shardingsphere-proxy\shardingsphere-proxy-frontend\shardingsphere-proxy-frontend-mysql\src\test\java\org\apache\shardingsphere\proxy\frontend\mysql\authentication\MySQLAuthenticationHandlerTest.java,0,146,3,43,0,192
 shardingsphere-master\shardingsphere-master\shardingsphere-sql-parser\shardingsphere-sql-parser-statement\src\main\java\org\apache\shardingsphere\sql\parser\sql\dialect\statement\opengauss\dcl\OpenGaussAlterRoleStatement.java,0,2,0,5,0,7
 shardingsphere-master\shardingsphere-master\shardingsphere-proxy\shardingsphere-proxy-frontend\shardingsphere-proxy-frontend-postgresql\src\main\java\org\apache\shardingsphere\proxy\frontend\postgresql\authentication\PostgreSQLAuthenticationEngine.java,0,49,0,51,0,100
 shardingsphere-master\shardingsphere-master\examples\example-core\example-api\src\main\java\org\apache\shardingsphere\example\core\api\entity\ShadowUser.java,71,64,0,2,0,66
 shardingsphere-master\shardingsphere-master\shardingsphere-db-protocol\shardingsphere-db-protocol-postgresql\src\test\java\org\apache\shardingsphere\db\protocol\postgresql\packet\command\query\extended\bind\protocol\PostgreSQLInt8ArrayBinaryProtocolValueTest.java,0,13,0,5,0,18
 shardingsphere-master\shardingsphere-master\shardingsphere-features\shardingsphere-sharding\shardingsphere-sharding-core\src\test\java\org\apache\shardingsphere\sharding\rewrite\token\pojo\ShardingInsertValuesTokenTest.java,0,10,0,10,0,20
 shardingsphere-master\shardingsphere-master\examples\example-core\example-raw-jdbc\src\main\java\org\apache\shardingsphere\example\core\jdbc\repository\RangeOrderItemRepositoryImpl.java,0,5,0,3,0,8
 shardingsphere-master\shardingsphere-master\shardingsphere-features\shardingsphere-sharding\shardingsphere-sharding-distsql\shardingsphere-sharding-distsql-statement\src\main\java\org\apache\shardingsphere\sharding\distsql\parser\statement\hint\ShowShardingHintStatusStatement.java,0,1,0,3,0,4
 shardingsphere-master\shardingsphere-master\shardingsphere-proxy\shardingsphere-proxy-backend\src\test\java\org\apache\shardingsphere\proxy\backend\text\distsql\rdl\resource\DropResourceBackendHandlerTest.java,0,79,0,40,0,119
 shardingsphere-master\shardingsphere-master\shardingsphere-agent\shardingsphere-agent-plugins\shardingsphere-agent-plugin-tracing\shardingsphere-agent-tracing-jaeger\src\main\java\org\apache\shardingsphere\agent\plugin\tracing\jaeger\advice\CommandExecutorTaskAdvice.java,0,14,1,12,0,27
 shardingsphere-master\shardingsphere-master\shardingsphere-sql-parser\shardingsphere-sql-parser-statement\src\main\java\org\apache\shardingsphere\sql\parser\sql\common\statement\ddl\DropOwnedStatement.java,3,1,1,3,0,5
 shardingsphere-master\shardingsphere-master\shardingsphere-test\shardingsphere-parser-test\src\main\java\org\apache\shardingsphere\test\sql\parser\parameterized\jaxb\cases\domain\statement\ddl\RenameTableStatementTestCase.java,0,2,0,4,0,6
 shardingsphere-master\shardingsphere-master\shardingsphere-test\shardingsphere-parser-test\src\main\java\org\apache\shardingsphere\test\sql\parser\parameterized\jaxb\cases\domain\segment\AbstractExpectedIdentifierSQLSegment.java,6,2,1,3,0,6
 shardingsphere-master\shardingsphere-master\shardingsphere-kernel\shardingsphere-transaction\shardingsphere-transaction-type\shardingsphere-transaction-xa\shardingsphere-transaction-xa-core\src\main\java\org\apache\shardingsphere\transaction\xa\jta\datasource\properties\dialect\PostgreSQLXADataSourceDefinition.java,0,3,0,4,0,7
 shardingsphere-master\shardingsphere-master\shardingsphere-test\shardingsphere-parser-test\src\main\java\org\apache\shardingsphere\test\sql\parser\parameterized\asserts\segment\charset\CharsetAssert.java,0,7,0,10,0,17
 shardingsphere-master\shardingsphere-master\shardingsphere-db-protocol\shardingsphere-db-protocol-postgresql\src\test\java\org\apache\shardingsphere\db\protocol\postgresql\packet\command\query\extended\bind\protocol\PostgreSQLStringBinaryProtocolValueTest.java,0,9,0,4,0,13
 shardingsphere-master\shardingsphere-master\shardingsphere-sql-parser\shardingsphere-sql-parser-statement\src\main\java\org\apache\shardingsphere\sql\parser\sql\common\statement\ddl\DropTableStatement.java,5,3,1,4,1,9
 shardingsphere-master\shardingsphere-master\shardingsphere-test\shardingsphere-pipeline-test\src\test\java\org\apache\shardingsphere\data\pipeline\core\task\IncrementalTaskTest.java,0,17,0,13,0,30
 shardingsphere-master\shardingsphere-master\shardingsphere-kernel\shardingsphere-authority\shardingsphere-authority-core\src\main\java\org\apache\shardingsphere\authority\provider\natived\model\subject\TableAccessSubject.java,0,4,0,1,0,5
 shardingsphere-master\shardingsphere-master\shardingsphere-jdbc\shardingsphere-jdbc-core\src\main\java\org\apache\shardingsphere\driver\jdbc\core\statement\metadata\ShardingSphereParameterMetaData.java,0,5,0,3,0,8
 shardingsphere-master\shardingsphere-master\examples\other-example\shardingsphere-parser-example\src\main\java\org\apache\shardingsphere\example\parser\sqlserver\statement\SQLServerParserStatementExample.java,0,35,1,10,0,46
 shardingsphere-master\shardingsphere-master\shardingsphere-sql-parser\shardingsphere-sql-parser-statement\src\main\java\org\apache\shardingsphere\sql\parser\sql\dialect\statement\opengauss\dal\OpenGaussExplainStatement.java,0,1,0,5,0,6
 shardingsphere-master\shardingsphere-master\shardingsphere-infra\shardingsphere-infra-federation\shardingsphere-infra-federation-optimizer\src\main\java\org\apache\shardingsphere\infra\federation\optimizer\context\parser\dialect\impl\MySQLOptimizerBuilder.java,0,6,0,6,0,12
 shardingsphere-master\shardingsphere-master\shardingsphere-infra\shardingsphere-infra-rewrite\src\test\java\org\apache\shardingsphere\infra\rewrite\sql\token\pojo\generic\InsertValueTest.java,0,11,0,8,0,19
 shardingsphere-master\shardingsphere-master\shardingsphere-proxy\shardingsphere-proxy-frontend\shardingsphere-proxy-frontend-reactive-spi\src\main\java\org\apache\shardingsphere\proxy\frontend\reactive\spi\ReactiveDatabaseProtocolFrontendEngine.java,0,3,0,4,0,7
 shardingsphere-master\shardingsphere-master\shardingsphere-sql-parser\shardingsphere-sql-parser-statement\src\main\java\org\apache\shardingsphere\sql\parser\sql\dialect\statement\opengauss\ddl\OpenGaussDeclareStatement.java,0,1,0,5,0,6
 shardingsphere-master\shardingsphere-master\shardingsphere-proxy\shardingsphere-proxy-frontend\shardingsphere-proxy-frontend-core\src\main\java\org\apache\shardingsphere\proxy\frontend\authentication\AuthenticationResultBuilder.java,0,9,1,3,0,13
 shardingsphere-master\shardingsphere-master\shardingsphere-kernel\shardingsphere-data-pipeline\shardingsphere-data-pipeline-dialect\shardingsphere-data-pipeline-opengauss\src\main\java\org\apache\shardingsphere\data\pipeline\opengauss\ingest\wal\decode\OpenGaussTimestampUtils.java,0,6,0,4,0,10
 shardingsphere-master\shardingsphere-master\shardingsphere-features\shardingsphere-shadow\shardingsphere-shadow-spring\shardingsphere-shadow-spring-boot-starter\src\test\java\org\apache\shardingsphere\shadow\spring\boot\PropertiesShadowSpringBootStarterTest.java,43,25,0,23,0,48
 shardingsphere-master\shardingsphere-master\shardingsphere-test\shardingsphere-parser-test\src\main\java\org\apache\shardingsphere\test\sql\parser\parameterized\jaxb\cases\domain\statement\ddl\AlterForeignTableTestCase.java,0,0,0,3,0,3
 shardingsphere-master\shardingsphere-master\shardingsphere-test\shardingsphere-rewrite-test\src\test\java\org\apache\shardingsphere\sharding\rewrite\parameterized\entity\RewriteInputEntity.java,0,4,0,1,0,5
 shardingsphere-master\shardingsphere-master\shardingsphere-test\shardingsphere-parser-test\src\main\java\org\apache\shardingsphere\test\sql\parser\parameterized\asserts\segment\limit\LimitClauseAssert.java,0,14,0,18,0,32
 shardingsphere-master\shardingsphere-master\shardingsphere-sql-parser\shardingsphere-sql-parser-statement\src\main\java\org\apache\shardingsphere\sql\parser\sql\common\segment\generic\ModelSegment.java,0,12,0,4,4,20
 shardingsphere-master\shardingsphere-master\shardingsphere-infra\shardingsphere-infra-executor\src\main\java\org\apache\shardingsphere\infra\executor\check\SQLCheckResult.java,0,4,0,1,0,5
 shardingsphere-master\shardingsphere-master\shardingsphere-infra\shardingsphere-infra-common\src\main\java\org\apache\shardingsphere\infra\config\mode\ModeConfiguration.java,0,7,0,1,0,8
 shardingsphere-master\shardingsphere-master\shardingsphere-kernel\shardingsphere-transaction\shardingsphere-transaction-core\src\main\java\org\apache\shardingsphere\transaction\ConnectionSavepointManager.java,0,19,0,9,0,28
 shardingsphere-master\shardingsphere-master\shardingsphere-test\shardingsphere-parser-test\src\main\java\org\apache\shardingsphere\test\sql\parser\parameterized\asserts\statement\SQLStatementAssert.java,0,8,0,23,0,31
 shardingsphere-master\shardingsphere-master\shardingsphere-features\shardingsphere-db-discovery\shardingsphere-db-discovery-distsql\shardingsphere-db-discovery-distsql-handler\src\main\java\org\apache\shardingsphere\dbdiscovery\distsql\handler\update\CreateDatabaseDiscoveryRuleStatementUpdater.java,0,47,0,48,0,95
 shardingsphere-master\shardingsphere-master\shardingsphere-features\shardingsphere-sharding\shardingsphere-sharding-core\src\test\java\org\apache\shardingsphere\sharding\merge\dql\ShardingDQLResultMergerTest.java,0,270,0,253,0,523
 shardingsphere-master\shardingsphere-master\shardingsphere-sql-parser\shardingsphere-sql-parser-statement\src\main\java\org\apache\shardingsphere\sql\parser\sql\dialect\statement\opengauss\dml\OpenGaussCopyStatement.java,0,1,0,5,0,6
 shardingsphere-master\shardingsphere-master\shardingsphere-infra\shardingsphere-infra-binder\src\test\java\org\apache\shardingsphere\infra\binder\segment\select\pagination\engine\PaginationContextEngineTest.java,0,80,0,59,0,139
 shardingsphere-master\shardingsphere-master\shardingsphere-proxy\shardingsphere-proxy-backend\src\main\java\org\apache\shardingsphere\proxy\backend\text\distsql\ral\RALBackendHandler.java,0,22,0,6,0,28
 shardingsphere-master\shardingsphere-master\shardingsphere-infra\shardingsphere-infra-common\src\main\java\org\apache\shardingsphere\infra\yaml\config\swapper\YamlConfigurationSwapper.java,0,3,0,1,0,4
 shardingsphere-master\shardingsphere-master\shardingsphere-infra\shardingsphere-infra-federation\shardingsphere-infra-federation-optimizer\src\main\java\org\apache\shardingsphere\infra\federation\optimizer\converter\segment\from\impl\SubqueryTableConverter.java,0,12,0,18,0,30
 shardingsphere-master\shardingsphere-master\shardingsphere-test\shardingsphere-parser-test\src\main\java\org\apache\shardingsphere\test\sql\parser\parameterized\jaxb\cases\domain\statement\ddl\DropOperatorStatementTestCase.java,0,0,0,3,0,3
 shardingsphere-master\shardingsphere-master\shardingsphere-sql-parser\shardingsphere-sql-parser-statement\src\main\java\org\apache\shardingsphere\sql\parser\sql\common\segment\ddl\index\IndexSegment.java,0,8,0,4,1,13
 shardingsphere-master\shardingsphere-master\shardingsphere-proxy\shardingsphere-proxy-backend\src\test\java\org\apache\shardingsphere\proxy\backend\text\distsql\rql\DataSourceQueryResultSetTest.java,0,15,0,6,0,21
 shardingsphere-master\shardingsphere-master\shardingsphere-test\shardingsphere-parser-test\src\main\java\org\apache\shardingsphere\test\sql\parser\parameterized\jaxb\cases\domain\statement\distsql\ral\ShowReadwriteSplittingReadResourcesStatementTestCase.java,0,1,0,4,0,5
 shardingsphere-master\shardingsphere-master\shardingsphere-test\shardingsphere-parser-test\src\main\java\org\apache\shardingsphere\test\sql\parser\parameterized\jaxb\sql\SQLCase.java,0,5,0,1,0,6
 shardingsphere-master\shardingsphere-master\shardingsphere-features\shardingsphere-shadow\shardingsphere-shadow-core\src\main\java\org\apache\shardingsphere\shadow\constant\ShadowOrder.java,0,4,0,1,0,5
 shardingsphere-master\shardingsphere-master\shardingsphere-test\shardingsphere-parser-test\src\main\java\org\apache\shardingsphere\test\sql\parser\parameterized\jaxb\cases\domain\statement\SQLParserTestCase.java,21,9,0,4,0,13
 shardingsphere-master\shardingsphere-master\examples\shardingsphere-jdbc-example\single-feature-example\extension-example\custom-sharding-algortihm-example\spi-based-sharding-algorithm-example\spi-based-sharding-spring-boot-mybatis-example\src\main\java\org\apache\shardingsphere\example\extension\spibased\sharding\spring\boot\mybatis\fixture\SPIBasedOrderItemStandardShardingAlgorithmFixture.java,0,8,1,8,0,17
 shardingsphere-master\shardingsphere-master\shardingsphere-db-protocol\shardingsphere-db-protocol-postgresql\src\main\java\org\apache\shardingsphere\db\protocol\postgresql\packet\command\query\extended\bind\protocol\PostgreSQLBoolArrayBinaryProtocolValue.java,0,11,0,9,0,20
 shardingsphere-master\shardingsphere-master\shardingsphere-features\shardingsphere-shadow\shardingsphere-shadow-core\src\test\java\org\apache\shardingsphere\shadow\yaml\config\YamlShadowRuleConfigurationTest.java,0,4,0,2,0,6
 shardingsphere-master\shardingsphere-master\shardingsphere-test\shardingsphere-parser-test\src\main\java\org\apache\shardingsphere\test\sql\parser\parameterized\jaxb\cases\domain\statement\dal\SetParameterStatementTestCase.java,0,2,0,4,0,6
 shardingsphere-master\shardingsphere-master\shardingsphere-infra\shardingsphere-infra-common\src\main\java\org\apache\shardingsphere\infra\metadata\database\loader\DatabaseLoader.java,0,11,1,6,0,18
 shardingsphere-master\shardingsphere-master\shardingsphere-kernel\shardingsphere-data-pipeline\shardingsphere-data-pipeline-spi\src\main\java\org\apache\shardingsphere\data\pipeline\spi\rulealtered\RuleAlteredJobConfigurationPreparer.java,0,5,0,9,0,14
 shardingsphere-master\shardingsphere-master\shardingsphere-features\shardingsphere-shadow\shardingsphere-shadow-core\src\main\java\org\apache\shardingsphere\shadow\algorithm\shadow\validator\column\ShadowDateValueValidator.java,0,4,0,5,0,9
 shardingsphere-master\shardingsphere-master\shardingsphere-agent\shardingsphere-agent-plugins\shardingsphere-agent-plugin-tracing\shardingsphere-agent-tracing-opentracing\src\test\java\org\apache\shardingsphere\agent\plugin\tracing\opentracing\advice\JDBCExecutorCallbackAdviceTest.java,0,27,0,17,0,44
 shardingsphere-master\shardingsphere-master\shardingsphere-agent\shardingsphere-agent-plugins\shardingsphere-agent-plugin-metrics\shardingsphere-agent-metrics-api\src\test\java\org\apache\shardingsphere\agent\metrics\api\advice\TransactionAdviceTest.java,0,12,0,5,0,17
 shardingsphere-master\shardingsphere-master\shardingsphere-db-protocol\shardingsphere-db-protocol-postgresql\src\test\java\org\apache\shardingsphere\db\protocol\postgresql\packet\command\query\extended\bind\protocol\PostgreSQLFloatBinaryProtocolValueTest.java,0,13,0,6,0,19
 shardingsphere-master\shardingsphere-master\shardingsphere-sql-parser\shardingsphere-sql-parser-statement\src\main\java\org\apache\shardingsphere\sql\parser\sql\common\segment\generic\GrantLevelTypeEnum.java,0,4,0,1,0,5
 shardingsphere-master\shardingsphere-master\shardingsphere-proxy\shardingsphere-proxy-frontend\shardingsphere-proxy-frontend-mysql\src\test\java\org\apache\shardingsphere\proxy\frontend\mysql\MySQLFrontendEngineTest.java,0,58,3,33,0,94
 shardingsphere-master\shardingsphere-master\shardingsphere-proxy\shardingsphere-proxy-frontend\shardingsphere-proxy-frontend-postgresql\src\main\java\org\apache\shardingsphere\proxy\frontend\postgresql\command\PostgreSQLCommandExecutorFactory.java,0,28,0,46,0,74
 shardingsphere-master\shardingsphere-master\shardingsphere-features\shardingsphere-readwrite-splitting\shardingsphere-readwrite-splitting-spring\shardingsphere-readwrite-splitting-spring-namespace\src\test\java\org\apache\shardingsphere\readwritesplitting\spring\namespace\ReadwriteSplittingSpringNamespaceTest.java,0,29,0,18,0,47
 shardingsphere-master\shardingsphere-master\shardingsphere-features\shardingsphere-sharding\shardingsphere-sharding-distsql\shardingsphere-sharding-distsql-parser\src\main\java\org\apache\shardingsphere\scaling\distsql\parser\core\ScalingParser.java,0,5,0,3,0,8
 shardingsphere-master\shardingsphere-master\shardingsphere-db-protocol\shardingsphere-db-protocol-mysql\src\main\java\org\apache\shardingsphere\db\protocol\mysql\packet\binlog\row\column\value\decimal\MySQLDoubleBinlogProtocolValue.java,0,3,0,6,0,9
 shardingsphere-master\shardingsphere-master\examples\shardingsphere-jdbc-example\single-feature-example\extension-example\custom-sharding-algortihm-example\spi-based-sharding-algorithm-example\spi-based-sharding-spring-boot-mybatis-example\src\main\java\org\apache\shardingsphere\example\extension\spibased\sharding\spring\boot\mybatis\fixture\SPIBasedOrderStandardShardingAlgorithmFixture.java,0,8,1,8,0,17
 shardingsphere-master\shardingsphere-master\shardingsphere-agent\shardingsphere-agent-plugins\shardingsphere-agent-plugin-tracing\shardingsphere-agent-tracing-test\src\main\java\org\apache\shardingsphere\agent\plugin\tracing\advice\AdviceTestBase.java,0,1,0,1,0,2
 shardingsphere-master\shardingsphere-master\shardingsphere-test\shardingsphere-parser-test\src\main\java\org\apache\shardingsphere\test\sql\parser\parameterized\jaxb\cases\domain\segment\impl\orderby\item\ExpectedOrderByItem.java,6,5,1,4,0,10
 shardingsphere-master\shardingsphere-master\shardingsphere-features\shardingsphere-sharding\shardingsphere-sharding-core\src\main\java\org\apache\shardingsphere\sharding\rule\ShardingRule.java,0,287,14,202,0,503
 shardingsphere-master\shardingsphere-master\shardingsphere-features\shardingsphere-encrypt\shardingsphere-encrypt-core\src\main\java\org\apache\shardingsphere\encrypt\rule\builder\AlgorithmProvidedEncryptRuleBuilder.java,0,7,0,5,0,12
 shardingsphere-master\shardingsphere-master\shardingsphere-test\shardingsphere-parser-test\src\main\java\org\apache\shardingsphere\test\sql\parser\parameterized\asserts\statement\dal\impl\ShowCharacterSetStatementAssert.java,0,5,0,9,0,14
 shardingsphere-master\shardingsphere-master\shardingsphere-sql-parser\shardingsphere-sql-parser-statement\src\main\java\org\apache\shardingsphere\sql\parser\sql\common\statement\tcl\StartTransactionStatement.java,3,1,1,3,0,5
 shardingsphere-master\shardingsphere-master\shardingsphere-sql-parser\shardingsphere-sql-parser-statement\src\main\java\org\apache\shardingsphere\sql\parser\sql\dialect\statement\mysql\segment\UserResourceSegment.java,0,14,0,2,0,16
 shardingsphere-master\shardingsphere-master\shardingsphere-features\shardingsphere-sharding\shardingsphere-sharding-core\src\test\java\org\apache\shardingsphere\sharding\algorithm\sharding\cosid\CosIdIntervalShardingAlgorithmTest.java,0,267,1,75,0,343
 shardingsphere-master\shardingsphere-master\shardingsphere-test\shardingsphere-parser-test\src\main\java\org\apache\shardingsphere\test\sql\parser\parameterized\jaxb\cases\domain\segment\impl\having\ExpectedHavingClause.java,0,3,0,4,0,7
 shardingsphere-master\shardingsphere-master\shardingsphere-db-protocol\shardingsphere-db-protocol-core\src\main\java\org\apache\shardingsphere\db\protocol\netty\ChannelAttrInitializer.java,0,3,0,2,0,5
 shardingsphere-master\shardingsphere-master\shardingsphere-sql-parser\shardingsphere-sql-parser-dialect\shardingsphere-sql-parser-mysql\src\main\java\org\apache\shardingsphere\sql\parser\mysql\parser\MySQLParser.java,0,5,0,3,0,8
 shardingsphere-master\shardingsphere-master\examples\shardingsphere-jdbc-example\single-feature-example\cluster-mode-example\cluster-mode-raw-jdbc-example\src\main\java\org\apache\shardingsphere\example\cluster\mode\raw\jdbc\config\cloud\CloudShardingDatabasesAndTablesConfiguration.java,0,8,0,3,0,11
 shardingsphere-master\shardingsphere-master\shardingsphere-spi\src\main\java\org\apache\shardingsphere\spi\ordered\OrderedSPI.java,0,5,0,1,0,6
 shardingsphere-master\shardingsphere-master\shardingsphere-sql-parser\shardingsphere-sql-parser-dialect\shardingsphere-sql-parser-postgresql\src\main\java\org\apache\shardingsphere\sql\parser\postgresql\visitor\statement\impl\PostgreSQLTCLStatementSQLVisitor.java,0,17,0,25,0,42
 shardingsphere-master\shardingsphere-master\examples\example-core\example-api\src\main\java\org\apache\shardingsphere\example\core\api\repository\ShadowUserRepository.java,0,1,0,2,0,3
 shardingsphere-master\shardingsphere-master\shardingsphere-kernel\shardingsphere-data-pipeline\shardingsphere-data-pipeline-core\src\main\java\org\apache\shardingsphere\data\pipeline\core\execute\ExecuteEngine.java,0,24,0,12,0,36
 shardingsphere-master\shardingsphere-master\shardingsphere-sql-parser\shardingsphere-sql-parser-statement\src\main\java\org\apache\shardingsphere\sql\parser\sql\common\statement\ddl\DropIndexStatement.java,5,3,1,4,1,9
 shardingsphere-master\shardingsphere-master\shardingsphere-spi\src\test\java\org\apache\shardingsphere\spi\fixture\optinal\OptionalSPIFixture.java,0,1,0,1,0,2
 shardingsphere-master\shardingsphere-master\shardingsphere-test\shardingsphere-parser-test\src\main\java\org\apache\shardingsphere\test\sql\parser\parameterized\jaxb\cases\domain\statement\ddl\DropForeignDataWrapperStatementTestCase.java,0,1,0,4,0,5
 shardingsphere-master\shardingsphere-master\shardingsphere-proxy\shardingsphere-proxy-backend\src\main\java\org\apache\shardingsphere\proxy\backend\text\distsql\ral\common\queryable\ShowInstanceHandler.java,0,42,2,21,0,65
 shardingsphere-master\shardingsphere-master\shardingsphere-jdbc\shardingsphere-jdbc-core\src\main\java\org\apache\shardingsphere\driver\state\circuit\datasource\CircuitBreakerDataSource.java,0,8,2,4,0,14
 shardingsphere-master\shardingsphere-master\shardingsphere-sql-parser\shardingsphere-sql-parser-statement\src\main\java\org\apache\shardingsphere\sql\parser\sql\common\statement\dml\CopyStatement.java,3,1,1,3,0,5
 shardingsphere-master\shardingsphere-master\shardingsphere-agent\shardingsphere-agent-plugins\shardingsphere-agent-plugin-metrics\shardingsphere-agent-metrics-api\src\test\java\org\apache\shardingsphere\agent\metrics\api\advice\ChannelHandlerAdviceTest.java,0,21,0,11,0,32
 shardingsphere-master\shardingsphere-master\shardingsphere-features\shardingsphere-sharding\shardingsphere-sharding-distsql\shardingsphere-sharding-distsql-statement\src\main\java\org\apache\shardingsphere\scaling\distsql\statement\CreateShardingScalingRuleStatement.java,0,5,0,4,0,9
 shardingsphere-master\shardingsphere-master\shardingsphere-proxy\shardingsphere-proxy-backend\src\main\java\org\apache\shardingsphere\proxy\backend\text\admin\mysql\executor\ShowCreateDatabaseExecutor.java,0,23,0,16,0,39
 shardingsphere-master\shardingsphere-master\shardingsphere-db-protocol\shardingsphere-db-protocol-mysql\src\test\java\org\apache\shardingsphere\db\protocol\mysql\packet\binlog\row\column\value\string\MySQLStringBinlogProtocolValueTest.java,0,50,0,17,0,67
 shardingsphere-master\shardingsphere-master\shardingsphere-kernel\shardingsphere-data-pipeline\shardingsphere-data-pipeline-dialect\shardingsphere-data-pipeline-postgresql\src\main\java\org\apache\shardingsphere\data\pipeline\postgresql\ingest\wal\WalPosition.java,0,5,0,4,0,9
 shardingsphere-master\shardingsphere-master\shardingsphere-infra\shardingsphere-infra-binder\src\main\java\org\apache\shardingsphere\infra\binder\segment\select\orderby\OrderByItem.java,0,7,1,3,0,11
 shardingsphere-master\shardingsphere-master\shardingsphere-infra\shardingsphere-infra-binder\src\test\java\org\apache\shardingsphere\infra\binder\segment\insert\values\expression\DerivedParameterMarkerExpressionSegmentTest.java,0,7,0,5,0,12
 shardingsphere-master\shardingsphere-master\shardingsphere-sql-parser\shardingsphere-sql-parser-statement\src\main\java\org\apache\shardingsphere\sql\parser\sql\common\segment\generic\table\SimpleTableSegment.java,0,12,0,6,1,19
 shardingsphere-master\shardingsphere-master\shardingsphere-jdbc\shardingsphere-jdbc-core\src\test\java\org\apache\shardingsphere\driver\jdbc\util\JDBCTestSQL.java,0,8,0,3,0,11
 shardingsphere-master\shardingsphere-master\shardingsphere-proxy\shardingsphere-proxy-frontend\shardingsphere-proxy-frontend-opengauss\src\main\java\org\apache\shardingsphere\proxy\frontend\opengauss\OpenGaussFrontendEngine.java,0,20,0,13,0,33
 shardingsphere-master\shardingsphere-master\shardingsphere-infra\shardingsphere-infra-federation\shardingsphere-infra-federation-optimizer\src\main\java\org\apache\shardingsphere\infra\federation\optimizer\converter\segment\expression\impl\BetweenExpressionConverter.java,0,18,0,18,0,36
 shardingsphere-master\shardingsphere-master\shardingsphere-sql-parser\shardingsphere-sql-parser-statement\src\main\java\org\apache\shardingsphere\sql\parser\sql\common\statement\dml\DeleteStatement.java,17,6,0,5,0,11
 shardingsphere-master\shardingsphere-master\shardingsphere-features\shardingsphere-sharding\shardingsphere-sharding-core\src\main\java\org\apache\shardingsphere\sharding\rewrite\token\generator\impl\AggregationDistinctTokenGenerator.java,0,11,0,14,0,25
 shardingsphere-master\shardingsphere-master\shardingsphere-db-protocol\shardingsphere-db-protocol-mysql\src\main\java\org\apache\shardingsphere\db\protocol\mysql\packet\binlog\row\column\value\string\MySQLJsonBinlogProtocolValue.java,0,11,0,10,0,21
 shardingsphere-master\shardingsphere-master\shardingsphere-proxy\shardingsphere-proxy-backend\src\test\java\org\apache\shardingsphere\proxy\backend\communication\jdbc\connection\ResourceLockTest.java,0,6,0,1,0,7
 shardingsphere-master\shardingsphere-master\shardingsphere-sql-parser\shardingsphere-sql-parser-statement\src\main\java\org\apache\shardingsphere\sql\parser\sql\dialect\statement\postgresql\ddl\PostgreSQLDropProcedureStatement.java,0,1,0,5,0,6
 shardingsphere-master\shardingsphere-master\shardingsphere-proxy\shardingsphere-proxy-backend\src\main\java\org\apache\shardingsphere\proxy\backend\response\data\QueryResponseCell.java,0,3,0,1,0,4
 shardingsphere-master\shardingsphere-master\shardingsphere-proxy\shardingsphere-proxy-backend\src\main\java\org\apache\shardingsphere\proxy\backend\text\distsql\ral\common\updatable\SetInstanceStatusHandler.java,0,24,0,24,0,48
 shardingsphere-master\shardingsphere-master\shardingsphere-distsql\shardingsphere-distsql-parser\src\main\java\org\apache\shardingsphere\distsql\parser\core\advanced\AdvancedDistSQLParser.java,0,5,0,4,0,9
 shardingsphere-master\shardingsphere-master\shardingsphere-proxy\shardingsphere-proxy-backend\src\main\java\org\apache\shardingsphere\proxy\backend\text\distsql\ral\common\hint\executor\AbstractHintUpdateExecutor.java,13,4,0,5,0,9
 shardingsphere-master\shardingsphere-master\shardingsphere-db-protocol\shardingsphere-db-protocol-mysql\src\main\java\org\apache\shardingsphere\db\protocol\mysql\packet\command\query\binary\MySQLPreparedStatementParameterType.java,0,4,0,2,0,6
 shardingsphere-master\shardingsphere-master\shardingsphere-kernel\shardingsphere-data-pipeline\shardingsphere-data-pipeline-core\src\main\java\org\apache\shardingsphere\data\pipeline\core\constant\DataPipelineConstants.java,0,5,0,2,0,7
 shardingsphere-master\shardingsphere-master\examples\shardingsphere-jdbc-example\single-feature-example\sharding-example\sharding-raw-jdbc-example\src\main\java\org\apache\shardingsphere\example\sharding\raw\jdbc\config\ShardingDatabasesConfigurationPrecise.java,0,18,0,18,0,36
 shardingsphere-master\shardingsphere-master\shardingsphere-kernel\shardingsphere-transaction\shardingsphere-transaction-core\src\main\java\org\apache\shardingsphere\transaction\rule\TransactionRule.java,0,11,1,3,0,15
 shardingsphere-master\shardingsphere-master\shardingsphere-features\shardingsphere-db-discovery\shardingsphere-db-discovery-spring\shardingsphere-db-discovery-spring-boot-starter\src\main\java\org\apache\shardingsphere\dbdiscovery\spring\boot\DatabaseDiscoveryRuleSpringbootConfiguration.java,32,13,0,14,0,27
 shardingsphere-master\shardingsphere-master\shardingsphere-kernel\shardingsphere-authority\shardingsphere-authority-core\src\test\java\org\apache\shardingsphere\authority\provider\natived\builder\dialect\MySQLPrivilegeHandlerTest.java,0,66,12,45,0,123
 shardingsphere-master\shardingsphere-master\shardingsphere-features\shardingsphere-sharding\shardingsphere-sharding-distsql\shardingsphere-sharding-distsql-parser\src\main\java\org\apache\shardingsphere\sharding\distsql\parser\core\ShardingDistSQLParser.java,0,5,0,4,0,9
 shardingsphere-master\shardingsphere-master\shardingsphere-sql-parser\shardingsphere-sql-parser-statement\src\main\java\org\apache\shardingsphere\sql\parser\sql\common\statement\ddl\DropConversionStatement.java,3,1,1,3,0,5
 shardingsphere-master\shardingsphere-master\shardingsphere-sql-parser\shardingsphere-sql-parser-statement\src\main\java\org\apache\shardingsphere\sql\parser\sql\common\statement\tcl\RollbackStatement.java,14,4,0,3,0,7
 shardingsphere-master\shardingsphere-master\shardingsphere-features\shardingsphere-shadow\shardingsphere-shadow-distsql\shardingsphere-shadow-distsql-statement\src\main\java\org\apache\shardingsphere\shadow\distsql\parser\statement\DropDefaultShadowAlgorithmStatement.java,0,4,0,4,0,8
 shardingsphere-master\shardingsphere-master\shardingsphere-db-protocol\shardingsphere-db-protocol-postgresql\src\main\java\org\apache\shardingsphere\db\protocol\postgresql\packet\handshake\PostgreSQLPasswordMessagePacket.java,0,8,1,7,0,16
 shardingsphere-master\shardingsphere-master\shardingsphere-infra\shardingsphere-infra-executor\src\main\java\org\apache\shardingsphere\infra\executor\sql\prepare\driver\jdbc\StatementOption.java,0,18,0,4,0,22
 shardingsphere-master\shardingsphere-master\shardingsphere-infra\shardingsphere-infra-common\src\main\java\org\apache\shardingsphere\infra\metadata\schema\model\ColumnMetaData.java,0,11,0,1,0,12
 shardingsphere-master\shardingsphere-master\shardingsphere-sql-parser\shardingsphere-sql-parser-statement\src\main\java\org\apache\shardingsphere\sql\parser\sql\dialect\statement\postgresql\tcl\PostgreSQLReleaseSavepointStatement.java,0,1,0,5,0,6
 shardingsphere-master\shardingsphere-master\shardingsphere-db-protocol\shardingsphere-db-protocol-postgresql\src\main\java\org\apache\shardingsphere\db\protocol\postgresql\packet\command\query\extended\bind\PostgreSQLTypeUnspecifiedSQLParameter.java,0,4,0,4,0,8
 shardingsphere-master\shardingsphere-master\shardingsphere-proxy\shardingsphere-proxy-backend\src\main\java\org\apache\shardingsphere\proxy\backend\text\distsql\ral\common\hint\executor\SetReadwriteSplittingHintExecutor.java,0,5,0,9,0,14
 shardingsphere-master\shardingsphere-master\shardingsphere-proxy\shardingsphere-proxy-frontend\shardingsphere-proxy-frontend-mysql\src\test\java\org\apache\shardingsphere\proxy\frontend\mysql\err\MySQLErrPacketFactoryTest.java,0,88,0,46,0,134
 shardingsphere-master\shardingsphere-master\shardingsphere-test\shardingsphere-parser-test\src\main\java\org\apache\shardingsphere\test\sql\parser\parameterized\jaxb\cases\domain\segment\impl\index\ExpectedIndextype.java,0,2,0,5,0,7
 shardingsphere-master\shardingsphere-master\shardingsphere-db-protocol\shardingsphere-db-protocol-mysql\src\main\java\org\apache\shardingsphere\db\protocol\mysql\codec\MySQLPacketCodecEngine.java,0,20,0,10,0,30
 shardingsphere-master\shardingsphere-master\shardingsphere-spi\src\main\java\org\apache\shardingsphere\spi\optional\OptionalSPIRegistry.java,0,4,0,3,0,7
 shardingsphere-master\shardingsphere-master\shardingsphere-kernel\shardingsphere-data-pipeline\shardingsphere-data-pipeline-dialect\shardingsphere-data-pipeline-postgresql\src\main\java\org\apache\shardingsphere\data\pipeline\postgresql\ingest\wal\event\AbstractWalEvent.java,5,2,1,2,0,5
 shardingsphere-master\shardingsphere-master\shardingsphere-features\shardingsphere-db-discovery\shardingsphere-db-discovery-distsql\shardingsphere-db-discovery-distsql-handler\src\main\java\org\apache\shardingsphere\dbdiscovery\distsql\handler\update\AlterDatabaseDiscoveryTypeStatementUpdater.java,0,40,0,35,0,75
 shardingsphere-master\shardingsphere-master\shardingsphere-proxy\shardingsphere-proxy-backend\src\test\java\org\apache\shardingsphere\proxy\backend\text\distsql\ral\common\updatable\ImportSchemaConfigurationHandlerTest.java,0,62,7,39,0,108
 shardingsphere-master\shardingsphere-master\shardingsphere-test\shardingsphere-parser-test\src\main\java\org\apache\shardingsphere\test\sql\parser\parameterized\jaxb\cases\domain\statement\distsql\rdl\drop\DropDefaultSingleTableRuleStatementTestCase.java,0,4,0,4,0,8
 shardingsphere-master\shardingsphere-master\shardingsphere-features\shardingsphere-sharding\shardingsphere-sharding-core\src\main\java\org\apache\shardingsphere\sharding\algorithm\sharding\classbased\ClassBasedShardingAlgorithmStrategyType.java,0,0,0,1,0,1
 shardingsphere-master\shardingsphere-master\shardingsphere-proxy\shardingsphere-proxy-frontend\shardingsphere-proxy-frontend-core\src\main\java\org\apache\shardingsphere\proxy\frontend\state\impl\CircuitBreakProxyState.java,0,5,0,5,0,10
 shardingsphere-master\shardingsphere-master\shardingsphere-sql-parser\shardingsphere-sql-parser-statement\src\main\java\org\apache\shardingsphere\sql\parser\sql\dialect\statement\mysql\dal\MySQLShutdownStatement.java,0,1,0,5,0,6
 shardingsphere-master\shardingsphere-master\shardingsphere-features\shardingsphere-sharding\shardingsphere-sharding-core\src\main\java\org\apache\shardingsphere\sharding\yaml\engine\representer\processor\NoneYamlTupleProcessor.java,0,8,0,5,0,13
 shardingsphere-master\shardingsphere-master\shardingsphere-agent\shardingsphere-agent-plugins\shardingsphere-agent-plugin-tracing\shardingsphere-agent-tracing-opentelemetry\src\test\java\org\apache\shardingsphere\agent\plugin\tracing\opentelemetry\advice\SQLParserEngineAdviceTest.java,0,24,0,21,0,45
 shardingsphere-master\shardingsphere-master\shardingsphere-test\shardingsphere-parser-test\src\main\java\org\apache\shardingsphere\test\sql\parser\parameterized\jaxb\cases\domain\segment\impl\projection\impl\shorthand\ExpectedShorthandProjection.java,0,4,0,6,0,10
 shardingsphere-master\shardingsphere-master\shardingsphere-test\shardingsphere-integration-test\shardingsphere-integration-test-suite\src\test\java\org\apache\shardingsphere\test\integration\framework\param\model\ParameterizedArray.java,0,9,0,3,0,12
 shardingsphere-master\shardingsphere-master\shardingsphere-features\shardingsphere-shadow\shardingsphere-shadow-distsql\shardingsphere-shadow-distsql-handler\src\main\java\org\apache\shardingsphere\shadow\distsql\handler\checker\ShadowRuleStatementChecker.java,119,54,1,37,0,92
 shardingsphere-master\shardingsphere-master\shardingsphere-sql-parser\shardingsphere-sql-parser-statement\src\test\java\org\apache\shardingsphere\sql\parser\sql\common\util\ExpressionExtractUtilTest.java,0,79,0,49,0,128
 shardingsphere-master\shardingsphere-master\shardingsphere-sql-parser\shardingsphere-sql-parser-statement\src\main\java\org\apache\shardingsphere\sql\parser\sql\dialect\statement\sqlserver\dml\SQLServerUpdateStatement.java,0,2,0,6,0,8
 shardingsphere-master\shardingsphere-master\shardingsphere-infra\shardingsphere-infra-federation\shardingsphere-infra-federation-executor\src\main\java\org\apache\shardingsphere\infra\federation\executor\original\row\FilterableRowEnumerator.java,0,14,2,2,0,18
 shardingsphere-master\shardingsphere-master\shardingsphere-features\shardingsphere-encrypt\shardingsphere-encrypt-core\src\test\java\org\apache\shardingsphere\encrypt\rewrite\token\EncryptAssignmentTokenGeneratorTest.java,0,36,2,29,0,67
 shardingsphere-master\shardingsphere-master\shardingsphere-proxy\shardingsphere-proxy-backend\src\main\java\org\apache\shardingsphere\proxy\backend\text\admin\opengauss\schema\OgCatalog.java,0,5,0,1,0,6
 shardingsphere-master\shardingsphere-master\shardingsphere-jdbc\shardingsphere-jdbc-core\src\main\java\org\apache\shardingsphere\driver\jdbc\core\ShardingSphereSavepoint.java,0,10,0,1,0,11
 shardingsphere-master\shardingsphere-master\shardingsphere-sql-parser\shardingsphere-sql-parser-dialect\shardingsphere-sql-parser-opengauss\src\main\java\org\apache\shardingsphere\sql\parser\opengauss\parser\OpenGaussLexer.java,0,4,0,2,0,6
 shardingsphere-master\shardingsphere-master\shardingsphere-infra\shardingsphere-infra-binder\src\main\java\org\apache\shardingsphere\infra\binder\segment\select\projection\impl\ExpressionProjection.java,0,6,0,2,0,8
 shardingsphere-master\shardingsphere-master\shardingsphere-infra\shardingsphere-infra-common\src\main\java\org\apache\shardingsphere\infra\exception\SchemaNotExistedException.java,0,6,0,1,0,7
 shardingsphere-master\shardingsphere-master\shardingsphere-jdbc\shardingsphere-jdbc-core\src\test\java\org\apache\shardingsphere\driver\jdbc\core\statement\ShardingSphereStatementTest.java,0,40,10,23,0,73
 shardingsphere-master\shardingsphere-master\shardingsphere-mode\shardingsphere-mode-type\shardingsphere-standalone-mode\shardingsphere-standalone-mode-core\src\main\java\org\apache\shardingsphere\mode\manager\standalone\yaml\StandalonePersistRepositoryConfigurationYamlSwapper.java,0,9,0,9,0,18
 shardingsphere-master\shardingsphere-master\shardingsphere-infra\shardingsphere-infra-common\src\main\java\org\apache\shardingsphere\infra\rule\builder\schema\SchemaRuleBuilder.java,0,4,0,3,0,7
 shardingsphere-master\shardingsphere-master\shardingsphere-test\shardingsphere-parser-test\src\main\java\org\apache\shardingsphere\test\sql\parser\parameterized\jaxb\cases\domain\statement\distsql\rdl\create\CreateShardingKeyGeneratorStatementTestCase.java,0,4,0,6,0,10
 shardingsphere-master\shardingsphere-master\shardingsphere-proxy\shardingsphere-proxy-frontend\shardingsphere-proxy-frontend-mysql\src\main\java\org\apache\shardingsphere\proxy\frontend\mysql\command\query\binary\prepare\MySQLComStmtPrepareExecutor.java,0,40,0,35,0,75
 shardingsphere-master\shardingsphere-master\shardingsphere-features\shardingsphere-sharding\shardingsphere-sharding-spring\shardingsphere-sharding-spring-namespace\src\main\java\org\apache\shardingsphere\sharding\spring\namespace\tag\strategy\ShardingStrategyBeanDefinitionTag.java,0,15,0,1,0,16
 shardingsphere-master\shardingsphere-master\shardingsphere-infra\shardingsphere-infra-executor\src\main\java\org\apache\shardingsphere\infra\executor\sql\prepare\driver\vertx\builder\VertxExecutionUnitBuilder.java,0,1,0,7,0,8
 shardingsphere-master\shardingsphere-master\shardingsphere-infra\shardingsphere-infra-binder\src\test\java\org\apache\shardingsphere\infra\binder\statement\dml\DeleteStatementContextTest.java,0,19,0,19,0,38
 shardingsphere-master\shardingsphere-master\shardingsphere-proxy\shardingsphere-proxy-backend\src\test\java\org\apache\shardingsphere\proxy\backend\text\distsql\rql\UnusedDataSourceQueryResultSetTest.java,0,26,0,17,0,43
 shardingsphere-master\shardingsphere-master\shardingsphere-sql-parser\shardingsphere-sql-parser-statement\src\main\java\org\apache\shardingsphere\sql\parser\sql\dialect\statement\mysql\dal\MySQLCloneStatement.java,0,2,0,6,2,10
 shardingsphere-master\shardingsphere-master\shardingsphere-sql-parser\shardingsphere-sql-parser-statement\src\main\java\org\apache\shardingsphere\sql\parser\sql\common\segment\generic\ACLTypeEnum.java,0,5,0,1,0,6
 shardingsphere-master\shardingsphere-master\shardingsphere-db-protocol\shardingsphere-db-protocol-mysql\src\test\java\org\apache\shardingsphere\db\protocol\mysql\packet\command\admin\ping\MySQLComPingPacketTest.java,0,5,0,2,0,7
 shardingsphere-master\shardingsphere-master\shardingsphere-proxy\shardingsphere-proxy-frontend\shardingsphere-proxy-frontend-core\src\main\java\org\apache\shardingsphere\proxy\frontend\state\impl\OKProxyState.java,0,0,0,1,0,1
 shardingsphere-master\shardingsphere-master\shardingsphere-kernel\shardingsphere-authority\shardingsphere-authority-api\src\main\java\org\apache\shardingsphere\authority\model\ShardingSpherePrivileges.java,0,5,0,2,0,7
 shardingsphere-master\shardingsphere-master\shardingsphere-features\shardingsphere-shadow\shardingsphere-shadow-core\src\test\java\org\apache\shardingsphere\shadow\algorithm\shadow\hint\SimpleHintShadowAlgorithmTest.java,0,24,0,12,0,36
 shardingsphere-master\shardingsphere-master\shardingsphere-sql-parser\shardingsphere-sql-parser-statement\src\main\java\org\apache\shardingsphere\sql\parser\sql\common\statement\dal\VacuumStatement.java,3,1,1,3,0,5
 shardingsphere-master\shardingsphere-master\shardingsphere-proxy\shardingsphere-proxy-frontend\shardingsphere-proxy-frontend-spi\src\main\java\org\apache\shardingsphere\proxy\frontend\authentication\Authenticator.java,0,0,0,1,0,1
 shardingsphere-master\shardingsphere-master\shardingsphere-features\shardingsphere-sharding\shardingsphere-sharding-distsql\shardingsphere-sharding-distsql-statement\src\main\java\org\apache\shardingsphere\scaling\distsql\statement\ResetScalingStatement.java,0,2,0,2,0,4
 shardingsphere-master\shardingsphere-master\shardingsphere-test\shardingsphere-parser-test\src\main\java\org\apache\shardingsphere\test\sql\parser\parameterized\jaxb\cases\domain\statement\dal\CreateResourceGroupStatementTestCase.java,0,3,0,5,0,8
 shardingsphere-master\shardingsphere-master\shardingsphere-sql-parser\shardingsphere-sql-parser-statement\src\main\java\org\apache\shardingsphere\sql\parser\sql\dialect\statement\opengauss\ddl\OpenGaussAlterGroupStatement.java,0,1,0,5,0,6
 shardingsphere-master\shardingsphere-master\shardingsphere-features\shardingsphere-shadow\shardingsphere-shadow-distsql\shardingsphere-shadow-distsql-handler\src\test\java\org\apache\shardingsphere\shadow\distsql\update\DropShadowRuleStatementUpdaterTest.java,0,27,0,15,0,42
 shardingsphere-master\shardingsphere-master\shardingsphere-features\shardingsphere-shadow\shardingsphere-shadow-api\src\main\java\org\apache\shardingsphere\shadow\api\config\table\ShadowTableConfiguration.java,0,5,0,1,0,6
 shardingsphere-master\shardingsphere-master\shardingsphere-distsql\shardingsphere-distsql-parser\src\main\java\org\apache\shardingsphere\distsql\parser\core\common\CommonDistSQLLexer.java,0,4,0,3,0,7
 shardingsphere-master\shardingsphere-master\shardingsphere-sql-parser\shardingsphere-sql-parser-statement\src\main\java\org\apache\shardingsphere\sql\parser\sql\dialect\statement\postgresql\ddl\PostgreSQLAlterFunctionStatement.java,0,1,0,5,0,6
 shardingsphere-master\shardingsphere-master\shardingsphere-kernel\shardingsphere-data-pipeline\shardingsphere-data-pipeline-core\src\main\java\org\apache\shardingsphere\data\pipeline\scenario\rulealtered\prepare\InventoryTaskSplitter.java,0,51,2,63,0,116
 shardingsphere-master\shardingsphere-master\shardingsphere-test\shardingsphere-parser-test\src\main\java\org\apache\shardingsphere\test\sql\parser\parameterized\jaxb\cases\domain\statement\dcl\SetPasswordStatementTestCase.java,0,0,0,3,0,3
 shardingsphere-master\shardingsphere-master\shardingsphere-features\shardingsphere-readwrite-splitting\shardingsphere-readwrite-splitting-distsql\shardingsphere-readwrite-splitting-distsql-handler\src\main\java\org\apache\shardingsphere\readwritesplitting\distsql\handler\update\AlterReadwriteSplittingRuleStatementUpdater.java,0,60,0,54,0,114
 shardingsphere-master\shardingsphere-master\shardingsphere-jdbc\shardingsphere-jdbc-spring\shardingsphere-jdbc-transaction-spring\src\test\java\org\apache\shardingsphere\spring\transaction\fixture\FixtureSpringConfiguration.java,13,2,0,1,0,3
 shardingsphere-master\shardingsphere-master\shardingsphere-db-protocol\shardingsphere-db-protocol-postgresql\src\main\java\org\apache\shardingsphere\db\protocol\postgresql\packet\command\query\extended\bind\protocol\PostgreSQLTimeBinaryProtocolValue.java,0,8,0,7,0,15
 shardingsphere-master\shardingsphere-master\shardingsphere-test\shardingsphere-parser-test\src\main\java\org\apache\shardingsphere\test\sql\parser\parameterized\jaxb\cases\domain\statement\dml\CallStatementTestCase.java,0,3,0,5,0,8
 shardingsphere-master\shardingsphere-master\shardingsphere-jdbc\shardingsphere-jdbc-spring\shardingsphere-jdbc-core-spring\shardingsphere-jdbc-core-spring-boot-starter\src\main\java\org\apache\shardingsphere\spring\boot\prop\SpringBootPropertiesConfiguration.java,0,5,0,2,0,7
 shardingsphere-master\shardingsphere-master\shardingsphere-proxy\shardingsphere-proxy-frontend\shardingsphere-proxy-frontend-reactive-mysql\src\main\java\org\apache\shardingsphere\proxy\frontend\reactive\mysql\command\query\text\query\ReactiveMySQLComQueryPacketExecutor.java,0,26,0,21,0,47
 shardingsphere-master\shardingsphere-master\shardingsphere-test\shardingsphere-parser-test\src\main\java\org\apache\shardingsphere\test\sql\parser\parameterized\asserts\statement\dal\impl\CacheIndexStatementAssert.java,0,18,0,28,0,46
 shardingsphere-master\shardingsphere-master\shardingsphere-features\shardingsphere-encrypt\shardingsphere-encrypt-core\src\main\java\org\apache\shardingsphere\encrypt\checker\AbstractEncryptRuleConfigurationChecker.java,10,6,0,3,0,9
 shardingsphere-master\shardingsphere-master\shardingsphere-proxy\shardingsphere-proxy-frontend\shardingsphere-proxy-frontend-core\src\test\java\org\apache\shardingsphere\proxy\frontend\exception\UnsupportedCommandExceptionTest.java,0,3,0,2,0,5
 shardingsphere-master\shardingsphere-master\shardingsphere-test\shardingsphere-parser-test\src\main\java\org\apache\shardingsphere\test\sql\parser\parameterized\jaxb\cases\domain\statement\distsql\rql\ShowSingleTableRulesStatementTestCase.java,0,3,0,5,0,8
 shardingsphere-master\shardingsphere-master\shardingsphere-sql-parser\shardingsphere-sql-parser-statement\src\main\java\org\apache\shardingsphere\sql\parser\sql\common\segment\generic\OwnerSegment.java,0,9,0,2,1,12
 shardingsphere-master\shardingsphere-master\shardingsphere-features\shardingsphere-sharding\shardingsphere-sharding-core\src\main\java\org\apache\shardingsphere\sharding\rewrite\token\pojo\OffsetToken.java,0,10,0,2,0,12
 shardingsphere-master\shardingsphere-master\shardingsphere-db-protocol\shardingsphere-db-protocol-mysql\src\main\java\org\apache\shardingsphere\db\protocol\mysql\packet\command\query\binary\execute\protocol\MySQLDoubleBinaryProtocolValue.java,0,4,0,4,0,8
 shardingsphere-master\shardingsphere-master\examples\example-core\config-utility\src\main\java\org\apache\shardingsphere\example\config\ExampleConfiguration.java,0,3,0,1,0,4
 shardingsphere-master\shardingsphere-master\shardingsphere-test\shardingsphere-parser-test\src\main\java\org\apache\shardingsphere\test\sql\parser\parameterized\asserts\segment\distsql\DataSourceAssert.java,0,20,0,22,0,42
 shardingsphere-master\shardingsphere-master\shardingsphere-agent\shardingsphere-agent-plugins\shardingsphere-agent-plugin-tracing\shardingsphere-agent-tracing-opentracing\src\main\java\org\apache\shardingsphere\agent\plugin\tracing\opentracing\constant\ErrorLogTagKeys.java,0,10,0,1,0,11
 shardingsphere-master\shardingsphere-master\shardingsphere-test\shardingsphere-pipeline-test\src\test\java\org\apache\shardingsphere\data\pipeline\core\ingest\position\PrimaryKeyPositionTest.java,0,11,0,2,0,13
 shardingsphere-master\shardingsphere-master\shardingsphere-agent\shardingsphere-agent-plugins\shardingsphere-agent-plugin-metrics\shardingsphere-agent-metrics-prometheus\src\test\java\org\apache\shardingsphere\agent\metrics\prometheus\wrapper\SummaryWrapperTest.java,0,4,0,3,0,7
 shardingsphere-master\shardingsphere-master\shardingsphere-sql-parser\shardingsphere-sql-parser-statement\src\main\java\org\apache\shardingsphere\sql\parser\sql\dialect\statement\postgresql\ddl\PostgreSQLAlterViewStatement.java,3,1,0,5,0,6
 shardingsphere-master\shardingsphere-master\shardingsphere-features\shardingsphere-encrypt\shardingsphere-encrypt-core\src\main\java\org\apache\shardingsphere\encrypt\rewrite\condition\impl\EncryptEqualCondition.java,0,24,0,8,0,32
 shardingsphere-master\shardingsphere-master\shardingsphere-proxy\shardingsphere-proxy-backend\src\test\java\org\apache\shardingsphere\proxy\backend\text\distsql\ral\common\queryable\ShowTrafficRulesHandlerTest.java,36,18,0,16,0,34
 shardingsphere-master\shardingsphere-master\shardingsphere-sql-parser\shardingsphere-sql-parser-statement\src\main\java\org\apache\shardingsphere\sql\parser\sql\dialect\statement\sqlserver\dcl\SQLServerAlterUserStatement.java,0,3,0,6,2,11
 shardingsphere-master\shardingsphere-master\shardingsphere-sql-parser\shardingsphere-sql-parser-statement\src\main\java\org\apache\shardingsphere\sql\parser\sql\dialect\statement\postgresql\dcl\PostgreSQLCreateRoleStatement.java,0,1,0,5,0,6
 shardingsphere-master\shardingsphere-master\shardingsphere-distsql\shardingsphere-distsql-statement\src\main\java\org\apache\shardingsphere\distsql\parser\statement\rdl\create\CreateDefaultSingleTableRuleStatement.java,0,3,0,2,0,5
 shardingsphere-master\shardingsphere-master\shardingsphere-infra\shardingsphere-infra-parser\src\main\java\org\apache\shardingsphere\infra\parser\sql\SQLStatementParserExecutor.java,0,9,0,3,0,12
 shardingsphere-master\shardingsphere-master\examples\shardingsphere-jdbc-example\mixed-feature-example\sharding-readwrite-splitting-example\sharding-readwrite-splitting-raw-jdbc-example\src\main\java\org\apache\shardingsphere\example\sharding\readwrite\splitting\raw\factory\YamlDataSourceFactory.java,0,7,1,6,0,14
 shardingsphere-master\shardingsphere-master\shardingsphere-test\shardingsphere-parser-test\src\main\java\org\apache\shardingsphere\test\sql\parser\parameterized\jaxb\cases\domain\statement\ddl\DropSequenceStatementTestCase.java,0,0,0,3,0,3
 shardingsphere-master\shardingsphere-master\shardingsphere-sql-parser\shardingsphere-sql-parser-statement\src\main\java\org\apache\shardingsphere\sql\parser\sql\common\segment\dml\item\AggregationDistinctProjectionSegment.java,0,9,0,4,0,13
 shardingsphere-master\shardingsphere-master\shardingsphere-kernel\shardingsphere-single-table\shardingsphere-single-table-core\src\test\java\org\apache\shardingsphere\singletable\metadata\SingleTableSchemaBuilderTest.java,0,41,11,26,0,78
 shardingsphere-master\shardingsphere-master\shardingsphere-test\shardingsphere-parser-test\src\main\java\org\apache\shardingsphere\test\sql\parser\parameterized\jaxb\cases\domain\statement\ddl\AlterProcedureStatementTestCase.java,0,0,0,3,0,3
 shardingsphere-master\shardingsphere-master\shardingsphere-mode\shardingsphere-mode-type\shardingsphere-standalone-mode\shardingsphere-standalone-mode-repository\shardingsphere-standalone-mode-repository-provider\shardingsphere-standalone-mode-repository-file\src\main\java\org\apache\shardingsphere\mode\repository\standalone\file\FileRepository.java,0,19,1,8,0,28
 shardingsphere-master\shardingsphere-master\shardingsphere-sql-parser\shardingsphere-sql-parser-statement\src\main\java\org\apache\shardingsphere\sql\parser\sql\dialect\statement\sqlserver\ddl\SQLServerCreateFunctionStatement.java,0,1,0,5,0,6
 shardingsphere-master\shardingsphere-master\shardingsphere-sql-parser\shardingsphere-sql-parser-statement\src\main\java\org\apache\shardingsphere\sql\parser\sql\common\constant\QuoteCharacter.java,0,21,0,2,0,23
 shardingsphere-master\shardingsphere-master\shardingsphere-features\shardingsphere-sharding\shardingsphere-sharding-core\src\test\java\org\apache\shardingsphere\sharding\rewrite\parameter\ShardingPaginationParameterRewriterTest.java,0,28,0,26,0,54
 shardingsphere-master\shardingsphere-master\shardingsphere-kernel\shardingsphere-transaction\shardingsphere-transaction-type\shardingsphere-transaction-xa\shardingsphere-transaction-xa-core\src\test\java\org\apache\shardingsphere\transaction\xa\jta\datasource\properties\dialect\OracleXADataSourceDefinitionTest.java,0,3,0,3,0,6
 shardingsphere-master\shardingsphere-master\shardingsphere-infra\shardingsphere-infra-merge\src\test\java\org\apache\shardingsphere\infra\merge\fixture\decorator\ResultDecoratorFixture.java,0,7,0,9,0,16
 shardingsphere-master\shardingsphere-master\shardingsphere-infra\shardingsphere-infra-common\src\main\java\org\apache\shardingsphere\infra\yaml\schema\swapper\SchemaYamlSwapper.java,0,14,0,10,0,24
 shardingsphere-master\shardingsphere-master\shardingsphere-test\shardingsphere-parser-test\src\main\java\org\apache\shardingsphere\test\sql\parser\parameterized\jaxb\cases\domain\segment\ExpectedIdentifierSQLSegment.java,0,2,0,3,0,5
 shardingsphere-master\shardingsphere-master\shardingsphere-test\shardingsphere-parser-test\src\main\java\org\apache\shardingsphere\test\sql\parser\parameterized\jaxb\cases\domain\segment\impl\definition\ExpectedConstraintDefinition.java,0,11,0,6,0,17
 shardingsphere-master\shardingsphere-master\shardingsphere-test\shardingsphere-parser-test\src\main\java\org\apache\shardingsphere\test\sql\parser\parameterized\asserts\statement\distsql\ral\impl\common\updatable\CreateTrafficRuleStatementAssert.java,0,12,1,16,0,29
 shardingsphere-master\shardingsphere-master\shardingsphere-test\shardingsphere-parser-test\src\main\java\org\apache\shardingsphere\test\sql\parser\parameterized\asserts\statement\distsql\rdl\alter\impl\AlterShardingBroadcastTableRulesStatementAssert.java,0,8,0,11,0,19
 shardingsphere-master\shardingsphere-master\shardingsphere-infra\shardingsphere-infra-common\src\test\java\org\apache\shardingsphere\infra\database\type\dialect\PostgreSQLDatabaseTypeTest.java,0,23,1,9,0,33
 shardingsphere-master\shardingsphere-master\shardingsphere-db-protocol\shardingsphere-db-protocol-mysql\src\test\java\org\apache\shardingsphere\db\protocol\mysql\packet\command\admin\quit\MySQLComQuitPacketTest.java,0,5,0,2,0,7
 shardingsphere-master\shardingsphere-master\shardingsphere-db-protocol\shardingsphere-db-protocol-mysql\src\test\java\org\apache\shardingsphere\db\protocol\mysql\packet\binlog\row\column\value\string\MySQLVarcharBinlogProtocolValueTest.java,0,18,0,8,0,26
 shardingsphere-master\shardingsphere-master\shardingsphere-sql-parser\shardingsphere-sql-parser-statement\src\main\java\org\apache\shardingsphere\sql\parser\sql\common\SQLStats.java,0,10,0,6,2,18
 shardingsphere-master\shardingsphere-master\shardingsphere-proxy\shardingsphere-proxy-backend\src\main\java\org\apache\shardingsphere\proxy\backend\communication\jdbc\executor\callback\ProxyJDBCExecutorCallback.java,82,44,3,30,0,77
 shardingsphere-master\shardingsphere-master\shardingsphere-sql-parser\shardingsphere-sql-parser-statement\src\main\java\org\apache\shardingsphere\sql\parser\sql\common\statement\dal\ExplainStatement.java,13,4,0,3,0,7
 shardingsphere-master\shardingsphere-master\shardingsphere-sql-parser\shardingsphere-sql-parser-statement\src\main\java\org\apache\shardingsphere\sql\parser\sql\dialect\statement\mysql\dal\MySQLShowCollationStatement.java,0,4,0,6,1,11
 shardingsphere-master\shardingsphere-master\shardingsphere-kernel\shardingsphere-single-table\shardingsphere-single-table-core\src\test\java\org\apache\shardingsphere\singletable\rule\builder\SingleTableRuleBuilderTest.java,0,16,0,13,0,29
 shardingsphere-master\shardingsphere-master\shardingsphere-test\shardingsphere-parser-test\src\main\java\org\apache\shardingsphere\test\sql\parser\parameterized\jaxb\cases\domain\statement\distsql\rql\ShowShardingTableRulesUsedAlgorithmStatementTestCase.java,0,5,0,5,0,10
 shardingsphere-master\shardingsphere-master\shardingsphere-infra\shardingsphere-infra-route\src\test\java\org\apache\shardingsphere\infra\route\engine\AllSQLRouteExecutorTest.java,0,5,0,4,0,9
 shardingsphere-master\shardingsphere-master\shardingsphere-infra\shardingsphere-infra-common\src\test\java\org\apache\shardingsphere\infra\fixture\TestShardingSphereRuleBuilder.java,0,9,0,4,0,13
 shardingsphere-master\shardingsphere-master\shardingsphere-mode\shardingsphere-mode-type\shardingsphere-standalone-mode\shardingsphere-standalone-mode-repository\shardingsphere-standalone-mode-repository-api\src\main\java\org\apache\shardingsphere\mode\repository\standalone\StandalonePersistRepository.java,0,2,0,2,0,4
 shardingsphere-master\shardingsphere-master\shardingsphere-kernel\shardingsphere-transaction\shardingsphere-transaction-type\shardingsphere-transaction-base\shardingsphere-transaction-base-seata-at\src\main\java\org\apache\shardingsphere\transaction\base\seata\at\TransactionalSQLExecutionHook.java,0,11,0,5,0,16
 shardingsphere-master\shardingsphere-master\shardingsphere-infra\shardingsphere-infra-common\src\main\java\org\apache\shardingsphere\infra\database\type\dialect\H2DatabaseType.java,0,11,1,4,0,16
 shardingsphere-master\shardingsphere-master\shardingsphere-sql-parser\shardingsphere-sql-parser-statement\src\main\java\org\apache\shardingsphere\sql\parser\sql\dialect\statement\postgresql\ddl\PostgreSQLTruncateStatement.java,0,1,0,5,0,6
 shardingsphere-master\shardingsphere-master\shardingsphere-agent\shardingsphere-agent-api\src\main\java\org\apache\shardingsphere\agent\api\point\PluginInterceptorPoint.java,0,88,0,20,0,108
 shardingsphere-master\shardingsphere-master\shardingsphere-sql-parser\shardingsphere-sql-parser-statement\src\main\java\org\apache\shardingsphere\sql\parser\sql\dialect\handler\ddl\CreateFunctionStatementHandler.java,0,5,0,9,1,15
 shardingsphere-master\shardingsphere-master\examples\shardingsphere-proxy-example\shardingsphere-proxy-distsql-example\src\main\java\org\apache\shardingsphere\example\proxy\distsql\factory\DataSourceFactory.java,0,6,1,4,0,11
 shardingsphere-master\shardingsphere-master\shardingsphere-kernel\shardingsphere-data-pipeline\shardingsphere-data-pipeline-core\src\main\java\org\apache\shardingsphere\data\pipeline\core\spi\check\consistency\DataMatchSingleTableDataCalculator.java,0,45,1,25,0,71
 shardingsphere-master\shardingsphere-master\shardingsphere-infra\shardingsphere-infra-binder\src\main\java\org\apache\shardingsphere\infra\binder\statement\dml\DeleteStatementContext.java,0,19,0,12,0,31
 shardingsphere-master\shardingsphere-master\shardingsphere-infra\shardingsphere-infra-rewrite\src\main\java\org\apache\shardingsphere\infra\rewrite\sql\token\pojo\generic\InsertColumnsToken.java,0,7,0,2,0,9
 shardingsphere-master\shardingsphere-master\shardingsphere-sql-parser\shardingsphere-sql-parser-statement\src\main\java\org\apache\shardingsphere\sql\parser\sql\dialect\statement\postgresql\tcl\PostgreSQLStartTransactionStatement.java,0,1,0,5,0,6
 shardingsphere-master\shardingsphere-master\shardingsphere-db-protocol\shardingsphere-db-protocol-mysql\src\main\java\org\apache\shardingsphere\db\protocol\mysql\packet\binlog\row\column\value\string\MySQLStringBinlogProtocolValue.java,0,17,0,10,0,27
 shardingsphere-master\shardingsphere-master\shardingsphere-kernel\shardingsphere-transaction\shardingsphere-transaction-type\shardingsphere-transaction-xa\shardingsphere-transaction-xa-core\src\test\java\org\apache\shardingsphere\transaction\xa\jta\datasource\properties\dialect\PostgreSQLXADataSourceDefinitionTest.java,0,3,0,3,0,6
 shardingsphere-master\shardingsphere-master\shardingsphere-features\shardingsphere-encrypt\shardingsphere-encrypt-api\src\main\java\org\apache\shardingsphere\encrypt\spi\EncryptAlgorithm.java,0,5,0,3,0,8
 shardingsphere-master\shardingsphere-master\shardingsphere-features\shardingsphere-sharding\shardingsphere-sharding-distsql\shardingsphere-sharding-distsql-handler\src\main\java\org\apache\shardingsphere\sharding\distsql\handler\update\CreateDefaultShardingStrategyStatementUpdater.java,0,60,2,55,0,117
 shardingsphere-master\shardingsphere-master\shardingsphere-agent\shardingsphere-agent-plugins\shardingsphere-agent-plugin-tracing\shardingsphere-agent-tracing-zipkin\src\main\java\org\apache\shardingsphere\agent\plugin\tracing\zipkin\advice\CommandExecutorTaskAdvice.java,0,17,1,14,0,32
 shardingsphere-master\shardingsphere-master\shardingsphere-db-protocol\shardingsphere-db-protocol-mysql\src\main\java\org\apache\shardingsphere\db\protocol\mysql\packet\command\query\binary\prepare\MySQLComStmtPreparePacket.java,0,7,0,5,0,12
 shardingsphere-master\shardingsphere-master\shardingsphere-infra\shardingsphere-infra-common\src\main\java\org\apache\shardingsphere\infra\yaml\config\pojo\mode\YamlPersistRepositoryConfiguration.java,0,5,0,2,0,7
 shardingsphere-master\shardingsphere-master\shardingsphere-test\shardingsphere-parser-test\src\main\java\org\apache\shardingsphere\test\sql\parser\parameterized\asserts\statement\distsql\rdl\alter\impl\AlterDatabaseDiscoveryHeartbeatStatementAssert.java,0,12,0,16,0,28
 shardingsphere-master\shardingsphere-master\shardingsphere-infra\shardingsphere-infra-binder\src\test\java\org\apache\shardingsphere\infra\binder\segment\select\pagination\engine\RowNumberPaginationContextEngineTest.java,0,91,0,70,0,161
 shardingsphere-master\shardingsphere-master\shardingsphere-test\shardingsphere-parser-test\src\main\java\org\apache\shardingsphere\test\sql\parser\parameterized\jaxb\cases\domain\segment\impl\table\ExpectedSimpleTable.java,0,5,0,4,0,9
 shardingsphere-master\shardingsphere-master\shardingsphere-sql-parser\shardingsphere-sql-parser-statement\src\main\java\org\apache\shardingsphere\sql\parser\sql\common\statement\dcl\AlterRoleStatement.java,3,2,1,3,0,6
 shardingsphere-master\shardingsphere-master\shardingsphere-sql-parser\shardingsphere-sql-parser-statement\src\main\java\org\apache\shardingsphere\sql\parser\sql\dialect\statement\mysql\segment\MySQLRoleOrPrivilegeSegment.java,0,10,0,2,0,12
 shardingsphere-master\shardingsphere-master\shardingsphere-sql-parser\shardingsphere-sql-parser-statement\src\main\java\org\apache\shardingsphere\sql\parser\sql\dialect\statement\oracle\tcl\OracleRollbackStatement.java,0,1,0,4,0,5
 shardingsphere-master\shardingsphere-master\shardingsphere-test\shardingsphere-parser-test\src\main\java\org\apache\shardingsphere\test\sql\parser\parameterized\asserts\statement\distsql\rdl\alter\impl\AlterDefaultSingleTableRuleStatementAssert.java,0,12,0,13,0,25
 shardingsphere-master\shardingsphere-master\shardingsphere-features\shardingsphere-sharding\shardingsphere-sharding-core\src\main\java\org\apache\shardingsphere\sharding\yaml\config\strategy\sharding\YamlShardingStrategyConfiguration.java,0,9,0,2,0,11
 shardingsphere-master\shardingsphere-master\shardingsphere-proxy\shardingsphere-proxy-backend\src\main\java\org\apache\shardingsphere\proxy\backend\text\admin\mysql\executor\NoResourceShowExecutor.java,0,19,0,21,0,40
 shardingsphere-master\shardingsphere-master\shardingsphere-proxy\shardingsphere-proxy-backend\src\main\java\org\apache\shardingsphere\proxy\backend\communication\jdbc\executor\callback\ProxyJDBCExecutorCallbackFactory.java,0,8,0,12,0,20
 shardingsphere-master\shardingsphere-master\shardingsphere-test\shardingsphere-parser-test\src\main\java\org\apache\shardingsphere\test\sql\parser\parameterized\asserts\segment\owner\OwnerAssert.java,0,8,0,12,0,20
 shardingsphere-master\shardingsphere-master\shardingsphere-sql-parser\shardingsphere-sql-parser-statement\src\main\java\org\apache\shardingsphere\sql\parser\sql\dialect\statement\mysql\dal\MySQLShowSlaveHostsStatement.java,0,1,0,5,0,6
 shardingsphere-master\shardingsphere-master\shardingsphere-test\shardingsphere-parser-test\src\main\java\org\apache\shardingsphere\test\sql\parser\parameterized\jaxb\cases\domain\statement\dml\TableStatementTestCase.java,0,6,0,6,0,12
 shardingsphere-master\shardingsphere-master\shardingsphere-infra\shardingsphere-infra-federation\shardingsphere-infra-federation-executor\src\main\java\org\apache\shardingsphere\infra\federation\executor\original\OriginalFilterableExecutor.java,0,42,3,25,0,70
 shardingsphere-master\shardingsphere-master\shardingsphere-kernel\shardingsphere-authority\shardingsphere-authority-core\src\test\java\org\apache\shardingsphere\authority\merge\PrivilegeMergeTest.java,0,25,0,26,0,51
 shardingsphere-master\shardingsphere-master\shardingsphere-features\shardingsphere-encrypt\shardingsphere-encrypt-core\src\test\java\org\apache\shardingsphere\encrypt\yaml\swapper\rule\EncryptTableRuleConfigurationYamlSwapperTest.java,0,31,0,27,0,58
 shardingsphere-master\shardingsphere-master\shardingsphere-sql-parser\shardingsphere-sql-parser-dialect\shardingsphere-sql-parser-sql92\src\main\java\org\apache\shardingsphere\sql\parser\sql92\parser\SQL92Lexer.java,0,3,0,1,0,4
 shardingsphere-master\shardingsphere-master\shardingsphere-features\shardingsphere-sharding\shardingsphere-sharding-distsql\shardingsphere-sharding-distsql-handler\src\main\java\org\apache\shardingsphere\sharding\distsql\handler\update\DropShardingTableRuleStatementUpdater.java,0,44,0,37,0,81
 shardingsphere-master\shardingsphere-master\shardingsphere-infra\shardingsphere-infra-common\src\main\java\org\apache\shardingsphere\infra\distsql\exception\rule\RuleDisabledException.java,0,7,0,4,0,11
 shardingsphere-master\shardingsphere-master\shardingsphere-test\shardingsphere-parser-test\src\main\java\org\apache\shardingsphere\test\sql\parser\parameterized\asserts\statement\distsql\rdl\create\impl\CreateDatabaseDiscoveryHeartbeatStatementAssert.java,0,12,0,16,0,28
 shardingsphere-master\shardingsphere-master\shardingsphere-features\shardingsphere-shadow\shardingsphere-shadow-spring\shardingsphere-shadow-spring-namespace\src\main\java\org\apache\shardingsphere\shadow\spring\namespace\factorybean\ShadowAlgorithmFactoryBean.java,0,6,0,4,0,10
 shardingsphere-master\shardingsphere-master\shardingsphere-test\shardingsphere-parser-test\src\main\java\org\apache\shardingsphere\test\sql\parser\parameterized\jaxb\cases\domain\segment\impl\insert\ExpectedOnDuplicateKeyColumns.java,0,3,0,5,0,8
 shardingsphere-master\shardingsphere-master\shardingsphere-distsql\shardingsphere-distsql-statement\src\main\java\org\apache\shardingsphere\distsql\parser\statement\ral\QueryableRALStatement.java,3,0,1,1,0,2
 shardingsphere-master\shardingsphere-master\shardingsphere-infra\shardingsphere-infra-binder\src\main\java\org\apache\shardingsphere\infra\binder\segment\select\pagination\engine\RowNumberPaginationContextEngine.java,0,32,0,34,0,66
 shardingsphere-master\shardingsphere-master\shardingsphere-test\shardingsphere-parser-test\src\main\java\org\apache\shardingsphere\test\sql\parser\parameterized\jaxb\cases\domain\statement\tcl\SavepointStatementTestCase.java,0,1,0,3,0,4
 shardingsphere-master\shardingsphere-master\shardingsphere-features\shardingsphere-db-discovery\shardingsphere-db-discovery-distsql\shardingsphere-db-discovery-distsql-handler\src\main\java\org\apache\shardingsphere\dbdiscovery\distsql\handler\update\DropDatabaseDiscoveryTypeStatementUpdater.java,0,36,0,30,0,66
 shardingsphere-master\shardingsphere-master\shardingsphere-test\shardingsphere-parser-test\src\main\java\org\apache\shardingsphere\test\sql\parser\parameterized\jaxb\cases\domain\statement\ddl\CreateDatabaseStatementTestCase.java,0,0,0,3,0,3
 shardingsphere-master\shardingsphere-master\shardingsphere-kernel\shardingsphere-authority\shardingsphere-authority-api\src\main\java\org\apache\shardingsphere\authority\spi\AuthorityProvideAlgorithm.java,0,7,0,3,0,10
 shardingsphere-master\shardingsphere-master\shardingsphere-features\shardingsphere-sharding\shardingsphere-sharding-distsql\shardingsphere-sharding-distsql-handler\src\main\java\org\apache\shardingsphere\sharding\distsql\handler\update\CreateShardingAlgorithmStatementUpdater.java,0,33,0,32,0,65
 shardingsphere-master\shardingsphere-master\shardingsphere-sql-parser\shardingsphere-sql-parser-statement\src\main\java\org\apache\shardingsphere\sql\parser\sql\dialect\statement\postgresql\ddl\PostgreSQLCreateRuleStatement.java,0,1,0,5,0,6
 shardingsphere-master\shardingsphere-master\shardingsphere-jdbc\shardingsphere-jdbc-core\src\main\java\org\apache\shardingsphere\driver\jdbc\unsupported\AbstractUnsupportedOperationResultSet.java,183,57,0,8,0,65
 shardingsphere-master\shardingsphere-master\examples\shardingsphere-jdbc-example\single-feature-example\encrypt-example\encrypt-spring-namespace-jpa-example\src\main\java\org\apache\shardingsphere\example\encrypt\spring\namespace\jpa\EncryptSpringNamespaceJpaExample.java,11,9,1,4,0,14
 shardingsphere-master\shardingsphere-master\shardingsphere-features\shardingsphere-sharding\shardingsphere-sharding-core\src\main\java\org\apache\shardingsphere\sharding\algorithm\sharding\inline\InlineShardingAlgorithm.java,0,31,1,16,0,48
 shardingsphere-master\shardingsphere-master\shardingsphere-agent\shardingsphere-agent-core\src\test\java\org\apache\shardingsphere\agent\core\bytebuddy\transformer\advice\ComposeConstructorAdviceTest.java,0,9,0,2,0,11
 shardingsphere-master\shardingsphere-master\shardingsphere-test\shardingsphere-parser-test\src\main\java\org\apache\shardingsphere\test\sql\parser\parameterized\asserts\statement\ddl\impl\AlterSynonymStatementAssert.java,0,2,1,6,0,9
 shardingsphere-master\shardingsphere-master\shardingsphere-infra\shardingsphere-infra-executor\src\main\java\org\apache\shardingsphere\infra\executor\sql\prepare\driver\jdbc\builder\JDBCExecutionUnitBuilder.java,0,2,0,7,0,9
 shardingsphere-master\shardingsphere-master\shardingsphere-db-protocol\shardingsphere-db-protocol-mysql\src\test\java\org\apache\shardingsphere\db\protocol\mysql\packet\binlog\row\column\value\time\MySQLDatetime2BinlogProtocolValueTest.java,0,48,0,10,0,58
 shardingsphere-master\shardingsphere-master\shardingsphere-features\shardingsphere-shadow\shardingsphere-shadow-core\src\main\java\org\apache\shardingsphere\shadow\checker\ShadowRuleConfigurationChecker.java,0,10,0,11,0,21
 shardingsphere-master\shardingsphere-master\shardingsphere-jdbc\shardingsphere-jdbc-core\src\test\java\org\apache\shardingsphere\driver\jdbc\adapter\WrapperAdapterTest.java,0,11,0,3,0,14
 shardingsphere-master\shardingsphere-master\shardingsphere-features\shardingsphere-encrypt\shardingsphere-encrypt-core\src\test\java\org\apache\shardingsphere\encrypt\rule\builder\EncryptRuleBuilderTest.java,0,6,0,4,0,10
 shardingsphere-master\shardingsphere-master\shardingsphere-test\shardingsphere-parser-test\src\main\java\org\apache\shardingsphere\test\sql\parser\parameterized\jaxb\cases\domain\segment\impl\expr\ExpectedBinaryOperationExpression.java,0,7,0,4,0,11
 shardingsphere-master\shardingsphere-master\shardingsphere-db-protocol\shardingsphere-db-protocol-mysql\src\main\java\org\apache\shardingsphere\db\protocol\mysql\packet\binlog\row\MySQLBinlogTableMapEventPacket.java,0,26,0,12,0,38
 shardingsphere-master\shardingsphere-master\shardingsphere-infra\shardingsphere-infra-executor\src\main\java\org\apache\shardingsphere\infra\executor\sql\execute\result\query\impl\driver\jdbc\type\memory\JDBCRowsLoader.java,0,11,0,7,0,18
 shardingsphere-master\shardingsphere-master\shardingsphere-jdbc\shardingsphere-jdbc-core\src\main\java\org\apache\shardingsphere\driver\state\circuit\statement\CircuitBreakerPreparedStatement.java,0,77,43,22,0,142
 shardingsphere-master\shardingsphere-master\shardingsphere-features\shardingsphere-encrypt\shardingsphere-encrypt-core\src\main\java\org\apache\shardingsphere\encrypt\rule\EncryptRule.java,0,107,3,71,0,181
 shardingsphere-master\shardingsphere-master\shardingsphere-test\shardingsphere-parser-test\src\main\java\org\apache\shardingsphere\test\sql\parser\parameterized\jaxb\cases\domain\statement\dal\CheckTableStatementTestCase.java,0,2,0,4,0,6
 shardingsphere-master\shardingsphere-master\shardingsphere-kernel\shardingsphere-traffic\shardingsphere-traffic-core\src\main\java\org\apache\shardingsphere\traffic\executor\TrafficExecutor.java,0,15,1,6,0,22
 shardingsphere-master\shardingsphere-master\shardingsphere-sql-parser\shardingsphere-sql-parser-spi\src\main\java\org\apache\shardingsphere\sql\parser\api\visitor\type\DDLSQLVisitor.java,0,0,0,1,0,1
 shardingsphere-master\shardingsphere-master\shardingsphere-mode\shardingsphere-mode-type\shardingsphere-cluster-mode\shardingsphere-cluster-mode-core\src\main\java\org\apache\shardingsphere\mode\manager\cluster\coordinator\registry\status\compute\event\LabelsEvent.java,0,4,0,3,0,7
 shardingsphere-master\shardingsphere-master\shardingsphere-kernel\shardingsphere-transaction\shardingsphere-transaction-core\src\main\java\org\apache\shardingsphere\transaction\rule\builder\TransactionRuleBuilder.java,0,5,0,4,0,9
 shardingsphere-master\shardingsphere-master\shardingsphere-db-protocol\shardingsphere-db-protocol-postgresql\src\main\java\org\apache\shardingsphere\db\protocol\postgresql\packet\command\query\PostgreSQLParameterDescriptionPacket.java,0,5,0,7,0,12
 shardingsphere-master\shardingsphere-master\shardingsphere-features\shardingsphere-db-discovery\shardingsphere-db-discovery-distsql\shardingsphere-db-discovery-distsql-handler\src\test\java\org\apache\shardingsphere\dbdiscovery\distsql\handler\query\DatabaseDiscoveryTypeQueryResultSetTest.java,0,12,0,12,0,24
 shardingsphere-master\shardingsphere-master\shardingsphere-db-protocol\shardingsphere-db-protocol-postgresql\src\main\java\org\apache\shardingsphere\db\protocol\postgresql\packet\handshake\authentication\PostgreSQLMD5PasswordAuthenticationPacket.java,0,8,0,7,0,15
 shardingsphere-master\shardingsphere-master\shardingsphere-features\shardingsphere-readwrite-splitting\shardingsphere-readwrite-splitting-core\src\test\java\org\apache\shardingsphere\readwritesplitting\swapper\ReadwriteSplittingRuleAlgorithmProviderConfigurationYamlSwapperTest.java,0,33,0,26,0,59
 shardingsphere-master\shardingsphere-master\examples\shardingsphere-jdbc-example\single-feature-example\transaction-example\transaction-2pc-xa-spring-namespace-example\src\main\java\org\apache\shardingsphere\example\transaction\xa\spring\namspace\TransactionXaSpringNamespaceExample.java,0,7,1,5,0,13
 shardingsphere-master\shardingsphere-master\shardingsphere-infra\shardingsphere-infra-binder\src\main\java\org\apache\shardingsphere\infra\binder\type\IndexAvailable.java,0,2,0,2,0,4
 shardingsphere-master\shardingsphere-master\shardingsphere-sql-parser\shardingsphere-sql-parser-statement\src\main\java\org\apache\shardingsphere\sql\parser\sql\dialect\statement\mysql\ddl\MySQLCreateLogfileGroupStatement.java,0,1,0,5,0,6
 shardingsphere-master\shardingsphere-master\shardingsphere-agent\shardingsphere-agent-core\src\main\java\org\apache\shardingsphere\agent\core\exception\AgentServiceProviderNotFoundException.java,0,7,0,4,0,11
 shardingsphere-master\shardingsphere-master\shardingsphere-test\shardingsphere-parser-test\src\main\java\org\apache\shardingsphere\test\sql\parser\parameterized\asserts\statement\distsql\ral\impl\common\updatable\DropTrafficRuleStatementAssert.java,0,7,0,10,0,17
 shardingsphere-master\shardingsphere-master\shardingsphere-infra\shardingsphere-infra-common\src\main\java\org\apache\shardingsphere\infra\database\type\dialect\PostgreSQLDatabaseType.java,0,20,1,11,0,32
 shardingsphere-master\shardingsphere-master\shardingsphere-infra\shardingsphere-infra-federation\shardingsphere-infra-federation-optimizer\src\main\java\org\apache\shardingsphere\infra\federation\optimizer\context\parser\dialect\impl\MariaDBOptimizerBuilder.java,0,6,0,7,0,13
 shardingsphere-master\shardingsphere-master\shardingsphere-test\shardingsphere-parser-test\src\main\java\org\apache\shardingsphere\test\sql\parser\parameterized\asserts\statement\dml\impl\CopyStatementAssert.java,0,3,1,6,0,10
 shardingsphere-master\shardingsphere-master\shardingsphere-infra\shardingsphere-infra-binder\src\test\java\org\apache\shardingsphere\infra\binder\statement\dml\UpdateStatementContextTest.java,0,15,0,21,0,36
 shardingsphere-master\shardingsphere-master\shardingsphere-features\shardingsphere-sharding\shardingsphere-sharding-core\src\test\java\org\apache\shardingsphere\sharding\algorithm\keygen\UUIDKeyGenerateAlgorithmTest.java,0,7,0,3,0,10
 shardingsphere-master\shardingsphere-master\shardingsphere-infra\shardingsphere-infra-rewrite\src\test\java\org\apache\shardingsphere\infra\rewrite\parameter\builder\impl\StandardParameterBuilderTest.java,0,13,0,2,0,15
 shardingsphere-master\shardingsphere-master\shardingsphere-features\shardingsphere-encrypt\shardingsphere-encrypt-core\src\test\java\org\apache\shardingsphere\encrypt\checker\AlgorithmProvidedEncryptRuleConfigurationCheckerTest.java,0,19,0,13,0,32
 shardingsphere-master\shardingsphere-master\shardingsphere-features\shardingsphere-shadow\shardingsphere-shadow-core\src\main\java\org\apache\shardingsphere\shadow\condition\ShadowDetermineCondition.java,0,19,0,4,0,23
 shardingsphere-master\shardingsphere-master\shardingsphere-kernel\shardingsphere-data-pipeline\shardingsphere-data-pipeline-dialect\shardingsphere-data-pipeline-mysql\src\main\java\org\apache\shardingsphere\data\pipeline\mysql\ingest\client\netty\MySQLNegotiatePackageDecoder.java,0,11,2,10,0,23
 shardingsphere-master\shardingsphere-master\shardingsphere-test\shardingsphere-parser-test\src\main\java\org\apache\shardingsphere\test\sql\parser\parameterized\asserts\statement\distsql\rdl\alter\AlterResourceStatementAssert.java,0,13,0,16,0,29
 shardingsphere-master\shardingsphere-master\shardingsphere-infra\shardingsphere-infra-common\src\main\java\org\apache\shardingsphere\infra\distsql\exception\DistSQLException.java,22,6,0,2,0,8
 shardingsphere-master\shardingsphere-master\shardingsphere-sql-parser\shardingsphere-sql-parser-statement\src\main\java\org\apache\shardingsphere\sql\parser\sql\dialect\statement\opengauss\ddl\OpenGaussCreateProcedureStatement.java,0,1,0,5,0,6
 shardingsphere-master\shardingsphere-master\shardingsphere-agent\shardingsphere-agent-core\src\main\java\org\apache\shardingsphere\agent\core\config\path\AgentPathBuilder.java,0,18,1,10,0,29
 shardingsphere-master\shardingsphere-master\shardingsphere-agent\shardingsphere-agent-core\src\main\java\org\apache\shardingsphere\agent\core\plugin\interceptor\ClassStaticMethodAroundInterceptor.java,63,13,7,10,0,30
 shardingsphere-master\shardingsphere-master\shardingsphere-test\shardingsphere-parser-test\src\main\java\org\apache\shardingsphere\test\sql\parser\parameterized\jaxb\cases\domain\statement\dcl\RevokeStatementTestCase.java,0,4,0,5,0,9
 shardingsphere-master\shardingsphere-master\shardingsphere-infra\shardingsphere-infra-rewrite\src\test\java\org\apache\shardingsphere\infra\rewrite\sql\fixture\RouteUnitAwareSQLTokenFixture.java,0,9,0,3,0,12
 shardingsphere-master\shardingsphere-master\shardingsphere-features\shardingsphere-shadow\shardingsphere-shadow-distsql\shardingsphere-shadow-distsql-handler\src\test\java\org\apache\shardingsphere\shadow\distsql\query\ShadowRuleQueryResultSetTest.java,0,10,0,10,0,20
 shardingsphere-master\shardingsphere-master\shardingsphere-infra\shardingsphere-infra-common\src\test\java\org\apache\shardingsphere\infra\metadata\schema\loader\dialect\MySQLTableMetaDataLoaderTest.java,0,40,8,25,0,73
 shardingsphere-master\shardingsphere-master\shardingsphere-features\shardingsphere-db-discovery\shardingsphere-db-discovery-core\src\main\java\org\apache\shardingsphere\dbdiscovery\heartbeat\HeartbeatJob.java,0,14,0,3,0,17
 shardingsphere-master\shardingsphere-master\shardingsphere-test\shardingsphere-integration-test\shardingsphere-integration-test-suite\src\test\java\org\apache\shardingsphere\test\integration\engine\rdl\BaseRDLIT.java,92,30,2,19,0,51
 shardingsphere-master\shardingsphere-master\shardingsphere-mode\shardingsphere-mode-type\shardingsphere-cluster-mode\shardingsphere-cluster-mode-core\src\main\java\org\apache\shardingsphere\mode\manager\cluster\coordinator\registry\config\event\rule\RuleConfigurationsChangedEvent.java,0,6,0,3,0,9
 shardingsphere-master\shardingsphere-master\shardingsphere-kernel\shardingsphere-transaction\shardingsphere-transaction-type\shardingsphere-transaction-xa\shardingsphere-transaction-xa-core\src\main\java\org\apache\shardingsphere\transaction\xa\jta\datasource\swapper\impl\DefaultDataSourcePropertyProvider.java,0,6,0,3,0,9
 shardingsphere-master\shardingsphere-master\shardingsphere-agent\shardingsphere-agent-plugins\shardingsphere-agent-plugin-metrics\shardingsphere-agent-metrics-prometheus\src\main\java\org\apache\shardingsphere\agent\metrics\prometheus\collector\ProxyInfoCollector.java,0,16,0,8,0,24
 shardingsphere-master\shardingsphere-master\shardingsphere-mode\shardingsphere-mode-type\shardingsphere-cluster-mode\shardingsphere-cluster-mode-core\src\test\java\org\apache\shardingsphere\mode\manager\cluster\coordinator\registry\process\subscriber\ProcessRegistrySubscriberTest.java,0,37,0,33,0,70
 shardingsphere-master\shardingsphere-master\shardingsphere-kernel\shardingsphere-data-pipeline\shardingsphere-data-pipeline-spi\src\main\java\org\apache\shardingsphere\data\pipeline\spi\ingest\dumper\InventoryDumper.java,0,0,0,1,0,1
 shardingsphere-master\shardingsphere-master\shardingsphere-features\shardingsphere-sharding\shardingsphere-sharding-core\src\test\java\org\apache\shardingsphere\sharding\algorithm\sharding\inline\InlineExpressionParserTest.java,0,55,0,22,0,77
 shardingsphere-master\shardingsphere-master\shardingsphere-infra\shardingsphere-infra-binder\src\test\java\org\apache\shardingsphere\infra\binder\statement\dal\AnalyzeTableStatementContextTest.java,0,8,0,13,0,21
 shardingsphere-master\shardingsphere-master\shardingsphere-test\shardingsphere-pipeline-test\src\test\java\org\apache\shardingsphere\data\pipeline\core\importer\DataRecordMergerTest.java,0,79,0,30,0,109
 shardingsphere-master\shardingsphere-master\shardingsphere-kernel\shardingsphere-data-pipeline\shardingsphere-data-pipeline-spi\src\main\java\org\apache\shardingsphere\data\pipeline\api\job\progress\JobProgress.java,0,26,0,14,0,40
 shardingsphere-master\shardingsphere-master\shardingsphere-test\shardingsphere-parser-test\src\main\java\org\apache\shardingsphere\test\sql\parser\parameterized\asserts\statement\ddl\impl\CreateIndexStatementAssert.java,0,13,0,16,0,29
 shardingsphere-master\shardingsphere-master\examples\shardingsphere-jdbc-example\single-feature-example\extension-example\custom-sharding-algortihm-example\spi-based-sharding-algorithm-example\spi-based-sharding-spring-boot-mybatis-example\src\main\java\org\apache\shardingsphere\example\extension\spibased\sharding\spring\boot\mybatis\SPIBasedShardingSpringBootMybatisExample.java,9,7,1,5,0,13
 shardingsphere-master\shardingsphere-master\shardingsphere-features\shardingsphere-encrypt\shardingsphere-encrypt-distsql\shardingsphere-encrypt-distsql-statement\src\main\java\org\apache\shardingsphere\encrypt\distsql\parser\statement\DropEncryptRuleStatement.java,0,6,0,3,0,9
 shardingsphere-master\shardingsphere-master\shardingsphere-test\shardingsphere-parser-test\src\main\java\org\apache\shardingsphere\test\sql\parser\parameterized\asserts\statement\distsql\ral\impl\common\queryable\ShowSQLParserRuleStatementAssert.java,0,4,2,7,0,13
 shardingsphere-master\shardingsphere-master\shardingsphere-distsql\shardingsphere-distsql-statement\src\main\java\org\apache\shardingsphere\distsql\parser\statement\ral\RALStatement.java,3,0,1,1,0,2
 shardingsphere-master\shardingsphere-master\shardingsphere-proxy\shardingsphere-proxy-backend\src\main\java\org\apache\shardingsphere\proxy\backend\exception\DBCreateExistsException.java,0,3,0,1,0,4
 shardingsphere-master\shardingsphere-master\shardingsphere-features\shardingsphere-sharding\shardingsphere-sharding-core\src\main\java\org\apache\shardingsphere\sharding\yaml\config\strategy\sharding\YamlComplexShardingStrategyConfiguration.java,0,5,0,2,0,7
 shardingsphere-master\shardingsphere-master\shardingsphere-sql-parser\shardingsphere-sql-parser-statement\src\main\java\org\apache\shardingsphere\sql\parser\sql\common\segment\dml\expr\ExistsSubqueryExpression.java,12,8,0,2,2,12
 shardingsphere-master\shardingsphere-master\shardingsphere-infra\shardingsphere-infra-rewrite\src\main\java\org\apache\shardingsphere\infra\rewrite\SQLRewriteEntry.java,0,31,0,13,0,44
 shardingsphere-master\shardingsphere-master\shardingsphere-test\shardingsphere-parser-test\src\main\java\org\apache\shardingsphere\test\sql\parser\parameterized\jaxb\cases\domain\statement\distsql\ral\SetReadwriteSplittingHintStatementTestCase.java,0,1,0,4,0,5
 shardingsphere-master\shardingsphere-master\shardingsphere-features\shardingsphere-sharding\shardingsphere-sharding-core\src\main\java\org\apache\shardingsphere\sharding\schedule\ShardingRuleAlteredDetector.java,0,52,2,47,0,101
 shardingsphere-master\shardingsphere-master\shardingsphere-test\shardingsphere-integration-driver-test\src\test\java\org\apache\shardingsphere\driver\fixture\TestRuleConfiguration.java,0,1,0,3,0,4
 shardingsphere-master\shardingsphere-master\shardingsphere-sql-parser\shardingsphere-sql-parser-statement\src\main\java\org\apache\shardingsphere\sql\parser\sql\dialect\statement\postgresql\ddl\PostgreSQLAlterMaterializedViewStatement.java,0,1,0,5,0,6
 shardingsphere-master\shardingsphere-master\shardingsphere-kernel\shardingsphere-data-pipeline\shardingsphere-data-pipeline-spi\src\test\java\org\apache\shardingsphere\data\pipeline\api\datasource\config\impl\StandardPipelineDataSourceConfigurationTest.java,0,20,0,9,0,29
 shardingsphere-master\shardingsphere-master\shardingsphere-agent\shardingsphere-agent-plugins\shardingsphere-agent-plugin-tracing\shardingsphere-agent-tracing-zipkin\src\main\java\org\apache\shardingsphere\agent\plugin\tracing\zipkin\constant\ZipkinConstants.java,0,22,0,1,0,23
 shardingsphere-master\shardingsphere-master\shardingsphere-test\shardingsphere-pipeline-test\src\test\java\org\apache\shardingsphere\data\pipeline\core\execute\ExecuteEngineTest.java,0,17,4,2,0,23
 shardingsphere-master\shardingsphere-master\shardingsphere-features\shardingsphere-sharding\shardingsphere-sharding-distsql\shardingsphere-sharding-distsql-handler\src\main\java\org\apache\shardingsphere\scaling\distsql\handler\query\ShardingScalingRulesQueryResultSet.java,0,23,0,15,0,38
 shardingsphere-master\shardingsphere-master\shardingsphere-kernel\shardingsphere-transaction\shardingsphere-transaction-type\shardingsphere-transaction-xa\shardingsphere-transaction-xa-core\src\test\java\org\apache\shardingsphere\transaction\xa\fixture\FixtureXATransactionManagerProvider.java,0,10,5,5,0,20
 shardingsphere-master\shardingsphere-master\examples\shardingsphere-jdbc-example\single-feature-example\shadow-example\shadow-spring-namespace-mybatis-example\src\main\java\org\apache\shardingsphere\example\shadow\spring\namespace\mybatis\ShadowSpringNamespaceMybatisExample.java,0,12,1,7,0,20
 shardingsphere-master\shardingsphere-master\shardingsphere-kernel\shardingsphere-transaction\shardingsphere-transaction-type\shardingsphere-transaction-xa\shardingsphere-transaction-xa-core\src\main\java\org\apache\shardingsphere\transaction\xa\jta\connection\dialect\H2XAConnectionWrapper.java,0,27,7,8,0,42
 shardingsphere-master\shardingsphere-master\shardingsphere-kernel\shardingsphere-transaction\shardingsphere-transaction-core\src\test\java\org\apache\shardingsphere\transaction\ConnectionTransactionTest.java,0,37,0,26,0,63
 shardingsphere-master\shardingsphere-master\shardingsphere-kernel\shardingsphere-authority\shardingsphere-authority-core\src\test\java\org\apache\shardingsphere\authority\checker\AuthorityCheckerTest.java,0,54,7,42,0,103
 shardingsphere-master\shardingsphere-master\shardingsphere-kernel\shardingsphere-transaction\shardingsphere-transaction-type\shardingsphere-transaction-xa\shardingsphere-transaction-xa-provider\shardingsphere-transaction-xa-narayana\src\test\java\org\apache\shardingsphere\transaction\xa\narayana\manager\fixture\ReflectiveUtil.java,0,6,1,2,0,9
 shardingsphere-master\shardingsphere-master\shardingsphere-kernel\shardingsphere-data-pipeline\shardingsphere-data-pipeline-core\src\main\java\org\apache\shardingsphere\data\pipeline\core\exception\PipelineJobExecutionException.java,0,8,0,2,0,10
 shardingsphere-master\shardingsphere-master\shardingsphere-db-protocol\shardingsphere-db-protocol-mysql\src\test\java\org\apache\shardingsphere\db\protocol\mysql\packet\binlog\row\column\value\integer\MySQLLongLongBinlogProtocolValueTest.java,0,7,0,4,0,11
 shardingsphere-master\shardingsphere-master\shardingsphere-sql-parser\shardingsphere-sql-parser-statement\src\main\java\org\apache\shardingsphere\sql\parser\sql\dialect\statement\oracle\ddl\OracleAlterDatabaseStatement.java,3,2,0,4,0,6
 shardingsphere-master\shardingsphere-master\shardingsphere-features\shardingsphere-sharding\shardingsphere-sharding-core\src\test\java\org\apache\shardingsphere\sharding\algorithm\sharding\inline\InlineShardingAlgorithmTest.java,0,35,0,17,0,52
 shardingsphere-master\shardingsphere-master\shardingsphere-features\shardingsphere-sharding\shardingsphere-sharding-core\src\main\java\org\apache\shardingsphere\sharding\merge\dal\ShardingDALResultMerger.java,0,12,0,18,0,30
 shardingsphere-master\shardingsphere-master\examples\shardingsphere-example-generator\src\main\java\org\apache\shardingsphere\example\generator\scenario\framework\type\SpringBootStarterMyBatisExampleScenario.java,0,16,0,11,0,27
 shardingsphere-master\shardingsphere-master\examples\example-core\example-spring-jpa\src\main\java\org\apache\shardingsphere\example\core\jpa\entity\OrderEntity.java,0,5,0,1,0,6
 shardingsphere-master\shardingsphere-master\shardingsphere-infra\shardingsphere-infra-merge\src\main\java\org\apache\shardingsphere\infra\merge\engine\decorator\impl\TransparentResultDecorator.java,0,6,0,6,0,12
 shardingsphere-master\shardingsphere-master\shardingsphere-infra\shardingsphere-infra-executor\src\main\java\org\apache\shardingsphere\infra\executor\sql\execute\result\query\impl\raw\metadata\RawQueryResultColumnMetaData.java,0,31,0,3,0,34
 shardingsphere-master\shardingsphere-master\shardingsphere-sql-parser\shardingsphere-sql-parser-statement\src\main\java\org\apache\shardingsphere\sql\parser\sql\dialect\statement\postgresql\ddl\PostgreSQLAlterSequenceStatement.java,0,1,0,5,0,6
 shardingsphere-master\shardingsphere-master\shardingsphere-features\shardingsphere-sharding\shardingsphere-sharding-core\src\test\java\org\apache\shardingsphere\sharding\rewrite\token\IndexTokenGeneratorTest.java,0,12,1,16,0,29
 shardingsphere-master\shardingsphere-master\shardingsphere-spi\src\test\java\org\apache\shardingsphere\spi\singleton\TypedSingletonSPIHolderTest.java,0,6,0,3,0,9
 shardingsphere-master\shardingsphere-master\shardingsphere-test\shardingsphere-parser-test\src\main\java\org\apache\shardingsphere\test\sql\parser\parameterized\asserts\statement\tcl\impl\LockStatementAssert.java,0,8,0,13,0,21
 shardingsphere-master\shardingsphere-master\shardingsphere-sql-parser\shardingsphere-sql-parser-statement\src\main\java\org\apache\shardingsphere\sql\parser\sql\common\segment\dml\expr\simple\LiteralExpressionSegment.java,9,7,0,1,0,8
 shardingsphere-master\shardingsphere-master\shardingsphere-kernel\shardingsphere-data-pipeline\shardingsphere-data-pipeline-dialect\shardingsphere-data-pipeline-mysql\src\test\java\org\apache\shardingsphere\data\pipeline\mysql\importer\MySQLImporterTest.java,0,16,0,11,0,27
 shardingsphere-master\shardingsphere-master\shardingsphere-agent\shardingsphere-agent-core\src\main\java\org\apache\shardingsphere\agent\core\spi\AgentTypedSPIRegistry.java,0,11,0,8,0,19
 shardingsphere-master\shardingsphere-master\shardingsphere-features\shardingsphere-shadow\shardingsphere-shadow-core\src\main\java\org\apache\shardingsphere\shadow\route\engine\dml\ShadowInsertStatementRoutingEngine.java,0,33,0,14,0,47
 shardingsphere-master\shardingsphere-master\shardingsphere-sql-parser\shardingsphere-sql-parser-statement\src\main\java\org\apache\shardingsphere\sql\parser\sql\dialect\statement\mysql\dal\MySQLShowProcessListStatement.java,0,1,0,5,0,6
 shardingsphere-master\shardingsphere-master\shardingsphere-infra\shardingsphere-infra-rewrite\src\main\java\org\apache\shardingsphere\infra\rewrite\parameter\builder\ParameterBuilder.java,0,2,0,1,0,3
 shardingsphere-master\shardingsphere-master\shardingsphere-features\shardingsphere-sharding\shardingsphere-sharding-core\src\main\java\org\apache\shardingsphere\sharding\route\engine\validator\ddl\ShardingDDLStatementValidator.java,72,19,0,17,0,36
 shardingsphere-master\shardingsphere-master\shardingsphere-infra\shardingsphere-infra-common\src\main\java\org\apache\shardingsphere\infra\datasource\config\ConnectionConfiguration.java,0,7,0,1,0,8
 shardingsphere-master\shardingsphere-master\shardingsphere-mode\shardingsphere-mode-type\shardingsphere-cluster-mode\shardingsphere-cluster-mode-core\src\main\java\org\apache\shardingsphere\mode\manager\cluster\coordinator\registry\status\compute\event\WorkerIdEvent.java,0,5,0,3,0,8
 shardingsphere-master\shardingsphere-master\shardingsphere-infra\shardingsphere-infra-federation\shardingsphere-infra-federation-optimizer\src\main\java\org\apache\shardingsphere\infra\federation\optimizer\context\parser\dialect\impl\OracleOptimizerBuilder.java,0,6,0,7,0,13
 shardingsphere-master\shardingsphere-master\shardingsphere-features\shardingsphere-shadow\shardingsphere-shadow-distsql\shardingsphere-shadow-distsql-handler\src\test\java\org\apache\shardingsphere\shadow\distsql\update\AlterShadowRuleStatementUpdaterTest.java,0,53,0,39,0,92
 shardingsphere-master\shardingsphere-master\shardingsphere-mode\shardingsphere-mode-type\shardingsphere-cluster-mode\shardingsphere-cluster-mode-core\src\main\java\org\apache\shardingsphere\mode\manager\cluster\coordinator\ClusterContextManagerCoordinator.java,0,67,1,53,0,121
 shardingsphere-master\shardingsphere-master\shardingsphere-infra\shardingsphere-infra-executor\src\main\java\org\apache\shardingsphere\infra\executor\kernel\model\ExecutorCallback.java,0,4,0,2,0,6
 shardingsphere-master\shardingsphere-master\shardingsphere-db-protocol\shardingsphere-db-protocol-mysql\src\main\java\org\apache\shardingsphere\db\protocol\mysql\packet\binlog\row\column\value\integer\MySQLLongLongBinlogProtocolValue.java,0,3,0,6,0,9
 shardingsphere-master\shardingsphere-master\shardingsphere-sql-parser\shardingsphere-sql-parser-statement\src\main\java\org\apache\shardingsphere\sql\parser\sql\common\constant\TransactionIsolationLevel.java,0,7,0,1,0,8
 shardingsphere-master\shardingsphere-master\examples\example-core\example-spring-jpa\src\main\java\org\apache\shardingsphere\example\core\jpa\repository\ShadowUserRepositoryImpl.java,47,17,0,5,0,22
 shardingsphere-master\shardingsphere-master\shardingsphere-jdbc\shardingsphere-jdbc-spring\shardingsphere-jdbc-core-spring\shardingsphere-jdbc-core-spring-boot-starter\src\test\java\org\apache\shardingsphere\spring\boot\jndi\fixture\InitialDataSourceInitialContextFactory.java,0,15,1,2,0,18
 shardingsphere-master\shardingsphere-master\shardingsphere-test\shardingsphere-integration-agent-test\shardingsphere-integration-agent-test-plugins\shardingsphere-integration-agent-test-opentelemetry\src\test\java\org\apache\shardingsphere\integration\agent\test\opentelemetry\result\TracingResult.java,17,8,0,1,0,9
 shardingsphere-master\shardingsphere-master\shardingsphere-sql-parser\shardingsphere-sql-parser-statement\src\test\java\org\apache\shardingsphere\sql\parser\sql\common\segment\generic\table\SimpleTableSegmentTest.java,0,15,0,5,0,20
 shardingsphere-master\shardingsphere-master\shardingsphere-proxy\shardingsphere-proxy-backend\src\main\java\org\apache\shardingsphere\proxy\backend\text\admin\opengauss\OpenGaussSelectDatabaseExecutor.java,0,23,0,16,0,39
 shardingsphere-master\shardingsphere-master\shardingsphere-db-protocol\shardingsphere-db-protocol-mysql\src\test\java\org\apache\shardingsphere\db\protocol\mysql\packet\binlog\row\column\value\integer\MySQLTinyBinlogProtocolValueTest.java,0,9,0,4,0,13
 shardingsphere-master\shardingsphere-master\shardingsphere-infra\shardingsphere-infra-common\src\main\java\org\apache\shardingsphere\infra\state\StateType.java,0,4,0,1,0,5
 shardingsphere-master\shardingsphere-master\shardingsphere-features\shardingsphere-encrypt\shardingsphere-encrypt-core\src\main\java\org\apache\shardingsphere\encrypt\rewrite\token\generator\EncryptAssignmentTokenGenerator.java,0,60,1,52,0,113
 shardingsphere-master\shardingsphere-master\shardingsphere-proxy\shardingsphere-proxy-backend\src\main\java\org\apache\shardingsphere\proxy\backend\text\distsql\ral\common\updatable\UnlabelInstanceHandler.java,0,10,0,14,0,24
 shardingsphere-master\shardingsphere-master\shardingsphere-sql-parser\shardingsphere-sql-parser-engine\src\test\java\org\apache\shardingsphere\sql\parser\core\ParseASTNodeTest.java,0,3,0,2,0,5
 shardingsphere-master\shardingsphere-master\shardingsphere-proxy\shardingsphere-proxy-backend\src\main\java\org\apache\shardingsphere\proxy\backend\reactive\context\ReactiveProxyContext.java,0,8,0,4,0,12
 shardingsphere-master\shardingsphere-master\shardingsphere-jdbc\shardingsphere-jdbc-core\src\main\java\org\apache\shardingsphere\driver\executor\callback\ExecuteQueryCallback.java,20,10,1,12,0,23
 shardingsphere-master\shardingsphere-master\shardingsphere-mode\shardingsphere-mode-type\shardingsphere-cluster-mode\shardingsphere-cluster-mode-repository\shardingsphere-cluster-mode-repository-provider\shardingsphere-cluster-mode-repository-zookeeper-curator\src\main\java\org\apache\shardingsphere\mode\repository\cluster\zookeeper\listener\SessionConnectionListener.java,0,14,1,7,0,22
 shardingsphere-master\shardingsphere-master\shardingsphere-infra\shardingsphere-infra-common\src\main\java\org\apache\shardingsphere\infra\metadata\user\yaml\swapper\UserYamlSwapper.java,0,5,0,7,0,12
 shardingsphere-master\shardingsphere-master\shardingsphere-db-protocol\shardingsphere-db-protocol-mysql\src\main\java\org\apache\shardingsphere\db\protocol\mysql\packet\binlog\row\column\value\time\MySQLDateBinlogProtocolValue.java,0,11,0,8,0,19
 shardingsphere-master\shardingsphere-master\shardingsphere-sql-parser\shardingsphere-sql-parser-statement\src\main\java\org\apache\shardingsphere\sql\parser\sql\dialect\statement\mysql\ddl\MySQLCreateFunctionStatement.java,0,4,0,5,0,9
 shardingsphere-master\shardingsphere-master\shardingsphere-db-protocol\shardingsphere-db-protocol-mysql\src\test\java\org\apache\shardingsphere\db\protocol\mysql\packet\command\MySQLMySQLCommandPacketTypeTest.java,0,5,0,2,0,7
 shardingsphere-master\shardingsphere-master\shardingsphere-sql-parser\shardingsphere-sql-parser-statement\src\main\java\org\apache\shardingsphere\sql\parser\sql\dialect\statement\postgresql\tcl\PostgreSQLRollbackStatement.java,0,1,0,5,0,6
 shardingsphere-master\shardingsphere-master\shardingsphere-agent\shardingsphere-agent-plugins\shardingsphere-agent-plugin-tracing\shardingsphere-agent-tracing-jaeger\src\test\java\org\apache\shardingsphere\agent\plugin\tracing\jaeger\definition\JaegerPluginDefinitionServiceTest.java,0,10,0,3,0,13
 shardingsphere-master\shardingsphere-master\shardingsphere-infra\shardingsphere-infra-common\src\main\java\org\apache\shardingsphere\infra\rule\identifier\scope\GlobalRule.java,0,1,0,1,0,2
 shardingsphere-master\shardingsphere-master\shardingsphere-proxy\shardingsphere-proxy-frontend\shardingsphere-proxy-frontend-postgresql\src\test\java\org\apache\shardingsphere\proxy\frontend\postgresql\err\PostgreSQLErrPacketFactoryTest.java,0,27,3,23,0,53
 shardingsphere-master\shardingsphere-master\shardingsphere-kernel\shardingsphere-authority\shardingsphere-authority-core\src\main\java\org\apache\shardingsphere\authority\provider\natived\model\privilege\database\SchemaPrivileges.java,0,20,0,11,0,31
 shardingsphere-master\shardingsphere-master\shardingsphere-agent\shardingsphere-agent-core\src\main\java\org\apache\shardingsphere\agent\core\config\yaml\YamlAgentConfiguration.java,0,8,0,2,0,10
 shardingsphere-master\shardingsphere-master\shardingsphere-proxy\shardingsphere-proxy-backend\src\test\java\org\apache\shardingsphere\proxy\backend\text\admin\postgresql\executor\SelectDatabaseExecutorTest.java,0,77,2,54,0,133
 shardingsphere-master\shardingsphere-master\shardingsphere-kernel\shardingsphere-data-pipeline\shardingsphere-data-pipeline-spi\src\main\java\org\apache\shardingsphere\data\pipeline\spi\check\consistency\DataConsistencyCheckAlgorithm.java,0,7,0,4,0,11
 shardingsphere-master\shardingsphere-master\shardingsphere-jdbc\shardingsphere-jdbc-core\src\main\java\org\apache\shardingsphere\driver\jdbc\adapter\AbstractStatementAdapter.java,173,63,3,35,0,101
 shardingsphere-master\shardingsphere-master\shardingsphere-sql-parser\shardingsphere-sql-parser-statement\src\main\java\org\apache\shardingsphere\sql\parser\sql\dialect\statement\sqlserver\tcl\SQLServerBeginDistributedTransactionStatement.java,0,2,0,5,0,7
 shardingsphere-master\shardingsphere-master\shardingsphere-proxy\shardingsphere-proxy-backend\src\test\java\org\apache\shardingsphere\proxy\backend\text\distsql\ral\common\updatable\CreateTrafficRuleHandlerTest.java,0,43,0,37,0,80
 shardingsphere-master\shardingsphere-master\shardingsphere-features\shardingsphere-sharding\shardingsphere-sharding-core\src\main\java\org\apache\shardingsphere\sharding\route\engine\validator\ddl\impl\ShardingRenameTableStatementValidator.java,0,21,0,21,0,42
 shardingsphere-master\shardingsphere-master\shardingsphere-sql-parser\shardingsphere-sql-parser-statement\src\main\java\org\apache\shardingsphere\sql\parser\sql\common\statement\ddl\DropPolicyStatement.java,3,1,1,3,0,5
 shardingsphere-master\shardingsphere-master\shardingsphere-features\shardingsphere-sharding\shardingsphere-sharding-core\src\main\java\org\apache\shardingsphere\sharding\metadata\ShardingTableMetaDataBuilder.java,0,63,0,48,0,111
 shardingsphere-master\shardingsphere-master\shardingsphere-features\shardingsphere-db-discovery\shardingsphere-db-discovery-distsql\shardingsphere-db-discovery-distsql-statement\src\main\java\org\apache\shardingsphere\dbdiscovery\distsql\parser\statement\CreateDatabaseDiscoveryRuleStatement.java,0,3,0,4,0,7
 shardingsphere-master\shardingsphere-master\shardingsphere-kernel\shardingsphere-data-pipeline\shardingsphere-data-pipeline-dialect\shardingsphere-data-pipeline-postgresql\src\test\java\org\apache\shardingsphere\data\pipeline\postgresql\ingest\PostgreSQLJdbcDumperTest.java,0,23,0,17,0,40
 shardingsphere-master\shardingsphere-master\shardingsphere-proxy\shardingsphere-proxy-backend\src\main\java\org\apache\shardingsphere\proxy\backend\text\distsql\rql\rule\SingleTableRulesQueryResultSet.java,0,11,0,7,0,18
 shardingsphere-master\shardingsphere-master\shardingsphere-infra\shardingsphere-infra-binder\src\main\java\org\apache\shardingsphere\infra\binder\statement\ddl\DropDatabaseStatementContext.java,0,4,0,5,0,9
 shardingsphere-master\shardingsphere-master\shardingsphere-sql-parser\shardingsphere-sql-parser-statement\src\test\java\org\apache\shardingsphere\sql\parser\sql\dialect\handler\ddl\AlterIndexStatementHandlerTest.java,0,23,0,21,0,44
 shardingsphere-master\shardingsphere-master\shardingsphere-features\shardingsphere-sharding\shardingsphere-sharding-core\src\test\java\org\apache\shardingsphere\sharding\swapper\ShardingRuleConfigurationConverterTest.java,0,7,0,5,0,12
 shardingsphere-master\shardingsphere-master\shardingsphere-features\shardingsphere-sharding\shardingsphere-sharding-core\src\test\java\org\apache\shardingsphere\sharding\swapper\strategy\KeyGenerateStrategyConfigurationYamlSwapperTest.java,0,8,0,7,0,15
 shardingsphere-master\shardingsphere-master\shardingsphere-features\shardingsphere-shadow\shardingsphere-shadow-core\src\test\java\org\apache\shardingsphere\shadow\checker\ShadowRuleConfigurationCheckerTest.java,0,25,0,13,0,38
 shardingsphere-master\shardingsphere-master\shardingsphere-test\shardingsphere-parser-test\src\main\java\org\apache\shardingsphere\test\sql\parser\parameterized\jaxb\cases\domain\segment\impl\projection\ExpectedProjections.java,0,29,0,20,0,49
 shardingsphere-master\shardingsphere-master\shardingsphere-infra\shardingsphere-infra-common\src\main\java\org\apache\shardingsphere\infra\rule\event\DataSourceStatusChangedEvent.java,0,1,0,1,0,2
 shardingsphere-master\shardingsphere-master\shardingsphere-test\shardingsphere-parser-test\src\main\java\org\apache\shardingsphere\test\sql\parser\parameterized\jaxb\cases\domain\statement\ddl\CreateProcedureStatementTestCase.java,0,0,0,3,0,3
 shardingsphere-master\shardingsphere-master\shardingsphere-kernel\shardingsphere-data-pipeline\shardingsphere-data-pipeline-core\src\main\java\org\apache\shardingsphere\data\pipeline\core\spi\check\consistency\AbstractSingleTableDataCalculator.java,19,9,1,3,0,13
 shardingsphere-master\shardingsphere-master\shardingsphere-sql-parser\shardingsphere-sql-parser-statement\src\main\java\org\apache\shardingsphere\sql\parser\sql\common\segment\dml\expr\ListExpression.java,0,6,0,1,1,8
 shardingsphere-master\shardingsphere-master\shardingsphere-test\shardingsphere-parser-test\src\main\java\org\apache\shardingsphere\test\sql\parser\parameterized\jaxb\cases\domain\statement\distsql\ral\ApplyDistSQLStatementTestCase.java,0,0,0,3,0,3
 shardingsphere-master\shardingsphere-master\shardingsphere-spi\src\main\java\org\apache\shardingsphere\spi\singleton\SingletonSPI.java,0,1,0,1,0,2
 shardingsphere-master\shardingsphere-master\shardingsphere-sql-parser\shardingsphere-sql-parser-statement\src\main\java\org\apache\shardingsphere\sql\parser\sql\common\segment\dml\item\ProjectionsSegment.java,0,9,0,2,1,12
 shardingsphere-master\shardingsphere-master\shardingsphere-sql-parser\shardingsphere-sql-parser-statement\src\main\java\org\apache\shardingsphere\sql\parser\sql\dialect\statement\postgresql\ddl\PostgreSQLCreateConversionStatement.java,0,1,0,5,0,6
 shardingsphere-master\shardingsphere-master\shardingsphere-test\shardingsphere-parser-test\src\main\java\org\apache\shardingsphere\test\sql\parser\parameterized\jaxb\cases\domain\statement\ddl\PreparedStatementTestCase.java,0,0,0,3,0,3
 shardingsphere-master\shardingsphere-master\shardingsphere-test\shardingsphere-integration-test\shardingsphere-integration-test-suite\src\test\java\org\apache\shardingsphere\test\integration\framework\container\atomic\storage\DockerStorageContainer.java,45,28,1,14,0,43
 shardingsphere-master\shardingsphere-master\shardingsphere-infra\shardingsphere-infra-common\src\main\java\org\apache\shardingsphere\infra\yaml\config\swapper\mode\PersistRepositoryConfigurationYamlSwapper.java,0,2,0,5,0,7
 shardingsphere-master\shardingsphere-master\shardingsphere-test\shardingsphere-parser-test\src\main\java\org\apache\shardingsphere\test\sql\parser\parameterized\jaxb\cases\domain\segment\impl\lock\ExpectedLockClause.java,0,4,0,5,0,9
 shardingsphere-master\shardingsphere-master\shardingsphere-mode\shardingsphere-mode-type\shardingsphere-cluster-mode\shardingsphere-cluster-mode-core\src\test\java\org\apache\shardingsphere\mode\manager\cluster\coordinator\registry\status\compute\watcher\ComputeNodeStateChangedWatcherTest.java,0,36,0,27,0,63
 shardingsphere-master\shardingsphere-master\shardingsphere-kernel\shardingsphere-transaction\shardingsphere-transaction-type\shardingsphere-transaction-base\shardingsphere-transaction-base-seata-at\src\test\java\org\apache\shardingsphere\transaction\base\seata\at\TransactionalSQLExecutionHookTest.java,0,20,0,7,0,27
 shardingsphere-master\shardingsphere-master\shardingsphere-db-protocol\shardingsphere-db-protocol-postgresql\src\main\java\org\apache\shardingsphere\db\protocol\postgresql\packet\handshake\PostgreSQLRandomGenerator.java,0,5,0,2,0,7
 shardingsphere-master\shardingsphere-master\shardingsphere-infra\shardingsphere-infra-common\src\main\java\org\apache\shardingsphere\infra\distsql\exception\rule\RuleEnabledException.java,0,7,0,4,0,11
 shardingsphere-master\shardingsphere-master\shardingsphere-agent\shardingsphere-agent-plugins\shardingsphere-agent-plugin-metrics\shardingsphere-agent-metrics-prometheus\src\main\java\org\apache\shardingsphere\agent\metrics\prometheus\collector\MetaDataInfoCollector.java,0,26,0,15,0,41
 shardingsphere-master\shardingsphere-master\shardingsphere-sql-parser\shardingsphere-sql-parser-statement\src\main\java\org\apache\shardingsphere\sql\parser\sql\dialect\statement\mysql\segment\TableIndexSegment.java,9,6,1,3,2,12
 shardingsphere-master\shardingsphere-master\shardingsphere-features\shardingsphere-encrypt\shardingsphere-encrypt-core\src\main\java\org\apache\shardingsphere\encrypt\yaml\swapper\rule\EncryptTableRuleConfigurationYamlSwapper.java,0,14,0,16,0,30
 shardingsphere-master\shardingsphere-master\shardingsphere-test\shardingsphere-parser-test\src\main\java\org\apache\shardingsphere\test\sql\parser\parameterized\jaxb\cases\domain\statement\ddl\DropExtensionStatementTestCase.java,0,0,0,3,0,3
 shardingsphere-master\shardingsphere-master\shardingsphere-test\shardingsphere-parser-test\src\main\java\org\apache\shardingsphere\test\sql\parser\parameterized\jaxb\cases\domain\statement\ddl\CreateTriggerStatementTestCase.java,0,0,0,3,0,3
 shardingsphere-master\shardingsphere-master\shardingsphere-infra\shardingsphere-infra-common\src\main\java\org\apache\shardingsphere\infra\config\checker\RuleConfigurationCheckerFactory.java,0,6,0,3,0,9
 shardingsphere-master\shardingsphere-master\shardingsphere-features\shardingsphere-sharding\shardingsphere-sharding-distsql\shardingsphere-sharding-distsql-handler\src\main\java\org\apache\shardingsphere\scaling\distsql\handler\converter\ShardingScalingRuleStatementConverter.java,0,20,0,21,0,41
 shardingsphere-master\shardingsphere-master\shardingsphere-agent\shardingsphere-agent-core\src\main\java\org\apache\shardingsphere\agent\core\plugin\interceptor\ConstructorInterceptor.java,25,7,2,5,0,14
 shardingsphere-master\shardingsphere-master\shardingsphere-distsql\shardingsphere-distsql-parser\src\main\java\org\apache\shardingsphere\distsql\parser\engine\api\DistSQLStatementParserEngine.java,0,3,0,5,0,8
 shardingsphere-master\shardingsphere-master\shardingsphere-distsql\shardingsphere-distsql-statement\src\main\java\org\apache\shardingsphere\distsql\parser\statement\ral\common\queryable\CountInstanceRulesStatement.java,0,1,0,2,0,3
 shardingsphere-master\shardingsphere-master\shardingsphere-test\shardingsphere-parser-test\src\main\java\org\apache\shardingsphere\test\sql\parser\parameterized\asserts\statement\dal\impl\ShowTriggersStatementAssert.java,0,5,0,12,0,17
 shardingsphere-master\shardingsphere-master\shardingsphere-jdbc\shardingsphere-jdbc-spring\shardingsphere-jdbc-spring-infra\shardingsphere-jdbc-spring-boot-starter-infra\src\main\java\org\apache\shardingsphere\spring\boot\util\PropertyUtil.java,0,33,0,25,0,58
 shardingsphere-master\shardingsphere-master\shardingsphere-sql-parser\shardingsphere-sql-parser-dialect\shardingsphere-sql-parser-mysql\src\main\java\org\apache\shardingsphere\sql\parser\mysql\visitor\format\impl\MySQLDDLFormatSQLVisitor.java,0,3,0,3,0,6
 shardingsphere-master\shardingsphere-master\shardingsphere-test\shardingsphere-parser-test\src\main\java\org\apache\shardingsphere\test\sql\parser\parameterized\asserts\statement\distsql\rql\impl\rule\ShowEncryptRulesStatementAssert.java,0,7,0,11,0,18
 shardingsphere-master\shardingsphere-master\shardingsphere-test\shardingsphere-parser-test\src\main\java\org\apache\shardingsphere\test\sql\parser\parameterized\asserts\statement\distsql\ral\impl\scaling\query\ShowScalingCheckAlgorithmsStatementAssert.java,0,7,1,10,0,18
 shardingsphere-master\shardingsphere-master\shardingsphere-sql-parser\shardingsphere-sql-parser-statement\src\main\java\org\apache\shardingsphere\sql\parser\sql\dialect\statement\mysql\ddl\MySQLAlterViewStatement.java,0,4,0,5,1,10
 shardingsphere-master\shardingsphere-master\examples\shardingsphere-jdbc-example\single-feature-example\shadow-example\shadow-raw-jdbc-example\src\main\java\org\apache\shardingsphere\example\shadow\raw\jdbc\config\ShadowDefaultAlgorithmConfiguration.java,0,14,0,10,0,24
 shardingsphere-master\shardingsphere-master\shardingsphere-agent\shardingsphere-agent-plugins\shardingsphere-agent-plugin-tracing\shardingsphere-agent-tracing-opentracing\src\main\java\org\apache\shardingsphere\agent\plugin\tracing\opentracing\constant\ShardingSphereTags.java,0,6,0,3,0,9
 shardingsphere-master\shardingsphere-master\shardingsphere-features\shardingsphere-db-discovery\shardingsphere-db-discovery-core\src\main\java\org\apache\shardingsphere\dbdiscovery\datanode\DatabaseDiscoveryDataNodeBuilder.java,0,7,0,4,0,11
 shardingsphere-master\shardingsphere-master\shardingsphere-infra\shardingsphere-infra-binder\src\test\java\org\apache\shardingsphere\infra\binder\statement\ddl\DropViewStatementContextTest.java,0,6,0,12,0,18
 shardingsphere-master\shardingsphere-master\shardingsphere-mode\shardingsphere-mode-type\shardingsphere-cluster-mode\shardingsphere-cluster-mode-core\src\main\java\org\apache\shardingsphere\mode\manager\cluster\coordinator\RegistryCenter.java,0,17,0,11,0,28
 shardingsphere-master\shardingsphere-master\shardingsphere-test\shardingsphere-parser-test\src\main\java\org\apache\shardingsphere\test\sql\parser\parameterized\asserts\statement\dal\impl\ShowCreateTriggerStatementAssert.java,0,6,0,8,0,14
 shardingsphere-master\shardingsphere-master\shardingsphere-test\shardingsphere-parser-test\src\main\java\org\apache\shardingsphere\test\sql\parser\parameterized\asserts\segment\groupby\GroupByClauseAssert.java,0,6,0,8,0,14
 shardingsphere-master\shardingsphere-master\shardingsphere-features\shardingsphere-sharding\shardingsphere-sharding-distsql\shardingsphere-sharding-distsql-statement\src\main\java\org\apache\shardingsphere\sharding\distsql\parser\segment\TableRuleSegment.java,0,14,0,5,0,19
 shardingsphere-master\shardingsphere-master\shardingsphere-features\shardingsphere-readwrite-splitting\shardingsphere-readwrite-splitting-spring\shardingsphere-readwrite-splitting-spring-namespace\src\main\java\org\apache\shardingsphere\readwritesplitting\spring\namespace\handler\ReadwriteSplittingNamespaceHandler.java,0,5,0,9,0,14
 shardingsphere-master\shardingsphere-master\shardingsphere-features\shardingsphere-shadow\shardingsphere-shadow-api\src\main\java\org\apache\shardingsphere\shadow\api\shadow\hint\HintShadowAlgorithm.java,0,4,0,3,0,7
 shardingsphere-master\shardingsphere-master\shardingsphere-features\shardingsphere-sharding\shardingsphere-sharding-core\src\main\java\org\apache\shardingsphere\sharding\merge\dql\groupby\aggregation\AccumulationAggregationUnit.java,0,5,1,1,0,7
 shardingsphere-master\shardingsphere-master\shardingsphere-jdbc\shardingsphere-jdbc-core\src\main\java\org\apache\shardingsphere\driver\jdbc\core\datasource\ShardingSphereDataSource.java,0,43,0,24,0,67
 shardingsphere-master\shardingsphere-master\shardingsphere-sql-parser\shardingsphere-sql-parser-statement\src\main\java\org\apache\shardingsphere\sql\parser\sql\common\statement\tcl\ReleaseSavepointStatement.java,5,3,1,3,0,7
 shardingsphere-master\shardingsphere-master\shardingsphere-proxy\shardingsphere-proxy-frontend\shardingsphere-proxy-frontend-core\src\main\java\org\apache\shardingsphere\proxy\frontend\exception\UnsupportedPreparedStatementException.java,0,2,0,2,0,4
 shardingsphere-master\shardingsphere-master\shardingsphere-test\shardingsphere-integration-scaling-test\shardingsphere-integration-scaling-test-mysql\src\test\java\org\apache\shardingsphere\integration\scaling\test\mysql\env\IntegrationTestEnvironment.java,0,17,0,8,0,25
 shardingsphere-master\shardingsphere-master\shardingsphere-test\shardingsphere-parser-test\src\main\java\org\apache\shardingsphere\test\sql\parser\parameterized\asserts\statement\distsql\rql\impl\rule\ShowShadowTableRulesStatementAssert.java,0,7,0,11,0,18
 shardingsphere-master\shardingsphere-master\shardingsphere-infra\shardingsphere-infra-common\src\test\java\org\apache\shardingsphere\infra\yaml\engine\fixture\ShardingSphereYamlObjectFixture.java,0,12,0,1,0,13
 shardingsphere-master\shardingsphere-master\shardingsphere-db-protocol\shardingsphere-db-protocol-mysql\src\main\java\org\apache\shardingsphere\db\protocol\mysql\packet\binlog\row\MySQLBinlogRowsEventPacket.java,0,36,0,18,0,54
 shardingsphere-master\shardingsphere-master\shardingsphere-infra\shardingsphere-infra-binder\src\main\java\org\apache\shardingsphere\infra\binder\statement\dml\CallStatementContext.java,0,4,0,4,0,8
 shardingsphere-master\shardingsphere-master\shardingsphere-test\shardingsphere-parser-test\src\main\java\org\apache\shardingsphere\test\sql\parser\parameterized\jaxb\cases\domain\segment\impl\call\ExpectedProcedureParameters.java,0,2,0,4,0,6
 shardingsphere-master\shardingsphere-master\shardingsphere-sql-parser\shardingsphere-sql-parser-statement\src\main\java\org\apache\shardingsphere\sql\parser\sql\dialect\statement\postgresql\ddl\PostgreSQLAlterTextSearchStatement.java,0,1,0,5,0,6
 shardingsphere-master\shardingsphere-master\shardingsphere-test\shardingsphere-parser-test\src\main\java\org\apache\shardingsphere\test\sql\parser\parameterized\jaxb\cases\domain\segment\impl\expr\ExpectedExpressionSegment.java,0,0,0,2,0,2
 shardingsphere-master\shardingsphere-master\shardingsphere-features\shardingsphere-db-discovery\shardingsphere-db-discovery-api\src\main\java\org\apache\shardingsphere\dbdiscovery\spi\DatabaseDiscoveryType.java,0,8,0,4,0,12
 shardingsphere-master\shardingsphere-master\shardingsphere-kernel\shardingsphere-data-pipeline\shardingsphere-data-pipeline-core\src\main\java\org\apache\shardingsphere\data\pipeline\core\util\ReflectionUtil.java,0,16,2,10,0,28
 shardingsphere-master\shardingsphere-master\shardingsphere-test\shardingsphere-parser-test\src\main\java\org\apache\shardingsphere\test\sql\parser\parameterized\asserts\segment\insert\OnDuplicateKeyColumnsAssert.java,0,8,0,13,0,21
 shardingsphere-master\shardingsphere-master\shardingsphere-features\shardingsphere-sharding\shardingsphere-sharding-core\src\main\java\org\apache\shardingsphere\sharding\schedule\ShardingRuleAlteredJobConfigurationPreparer.java,0,74,1,82,0,157
 shardingsphere-master\shardingsphere-master\shardingsphere-sql-parser\shardingsphere-sql-parser-statement\src\main\java\org\apache\shardingsphere\sql\parser\sql\dialect\statement\mysql\ddl\MySQLRenameTableStatement.java,0,1,0,4,0,5
 shardingsphere-master\shardingsphere-master\shardingsphere-proxy\shardingsphere-proxy-backend\src\main\java\org\apache\shardingsphere\proxy\backend\text\distsql\rdl\resource\AlterResourceBackendHandler.java,0,44,1,39,0,84
 shardingsphere-master\shardingsphere-master\shardingsphere-sql-parser\shardingsphere-sql-parser-statement\src\main\java\org\apache\shardingsphere\sql\parser\sql\common\segment\dml\expr\CollateExpression.java,0,6,0,2,0,8
 shardingsphere-master\shardingsphere-master\shardingsphere-infra\shardingsphere-infra-common\src\main\java\org\apache\shardingsphere\infra\metadata\rule\ShardingSphereRuleMetaData.java,0,15,0,7,0,22
 shardingsphere-master\shardingsphere-master\shardingsphere-sql-parser\shardingsphere-sql-parser-statement\src\main\java\org\apache\shardingsphere\sql\parser\sql\common\statement\ddl\AlterLanguageStatement.java,3,1,1,3,0,5
 shardingsphere-master\shardingsphere-master\shardingsphere-features\shardingsphere-sharding\shardingsphere-sharding-api\src\main\java\org\apache\shardingsphere\sharding\api\config\rule\ShardingAutoTableRuleConfiguration.java,0,18,0,5,0,23
 shardingsphere-master\shardingsphere-master\shardingsphere-test\shardingsphere-pipeline-test\src\test\java\org\apache\shardingsphere\data\pipeline\scenario\rulealtered\IdleRuleAlteredJobCompletionDetectAlgorithmTest.java,0,52,0,33,0,85
 shardingsphere-master\shardingsphere-master\shardingsphere-jdbc\shardingsphere-jdbc-spring\shardingsphere-jdbc-core-spring\shardingsphere-jdbc-core-spring-namespace\src\main\java\org\apache\shardingsphere\spring\namespace\parser\DataSourceBeanDefinitionParser.java,0,32,0,27,0,59
 shardingsphere-master\shardingsphere-master\examples\shardingsphere-proxy-example\shardingsphere-proxy-distsql-example\src\main\java\org\apache\shardingsphere\example\proxy\distsql\feature\readwritesplitting\ReadWriteSplittingExecutor.java,0,28,2,7,0,37
 shardingsphere-master\shardingsphere-master\shardingsphere-kernel\shardingsphere-data-pipeline\shardingsphere-data-pipeline-core\src\main\java\org\apache\shardingsphere\data\pipeline\scenario\rulealtered\spi\DefaultMetadataCheckoutLockAlgorithm.java,0,3,2,3,0,8
 shardingsphere-master\shardingsphere-master\shardingsphere-kernel\shardingsphere-transaction\shardingsphere-transaction-type\shardingsphere-transaction-xa\shardingsphere-transaction-xa-provider\shardingsphere-transaction-xa-atomikos\src\test\java\org\apache\shardingsphere\transaction\xa\atomikos\manager\AtomikosTransactionManagerProviderTest.java,0,29,0,10,0,39
 shardingsphere-master\shardingsphere-master\shardingsphere-features\shardingsphere-sharding\shardingsphere-sharding-distsql\shardingsphere-sharding-distsql-handler\src\test\java\org\apache\shardingsphere\sharding\distsql\update\AlterShardingKeyGeneratorStatementUpdaterTest.java,0,26,0,21,0,47
 shardingsphere-master\shardingsphere-master\shardingsphere-sql-parser\shardingsphere-sql-parser-statement\src\main\java\org\apache\shardingsphere\sql\parser\sql\common\constant\SubqueryType.java,0,7,0,2,0,9
 shardingsphere-master\shardingsphere-master\shardingsphere-infra\shardingsphere-infra-common\src\main\java\org\apache\shardingsphere\infra\distsql\exception\rule\RuleInUsedException.java,0,11,0,5,0,16
 shardingsphere-master\shardingsphere-master\shardingsphere-test\shardingsphere-parser-test\src\main\java\org\apache\shardingsphere\test\sql\parser\parameterized\jaxb\cases\domain\segment\impl\schema\ExpectedSchema.java,0,1,0,3,0,4
 shardingsphere-master\shardingsphere-master\shardingsphere-infra\shardingsphere-infra-binder\src\test\java\org\apache\shardingsphere\infra\binder\segment\select\projection\ProjectionsContextTest.java,0,49,0,27,0,76
 shardingsphere-master\shardingsphere-master\shardingsphere-db-protocol\shardingsphere-db-protocol-core\src\main\java\org\apache\shardingsphere\db\protocol\binary\BinaryColumnType.java,0,2,0,1,0,3
 shardingsphere-master\shardingsphere-master\shardingsphere-test\shardingsphere-parser-test\src\main\java\org\apache\shardingsphere\test\sql\parser\parameterized\jaxb\cases\domain\statement\distsql\rql\ShowShadowTableRulesStatementTestCase.java,0,3,0,5,0,8
 shardingsphere-master\shardingsphere-master\shardingsphere-kernel\shardingsphere-traffic\shardingsphere-traffic-core\src\test\java\org\apache\shardingsphere\traffic\rule\builder\DefaultTrafficRuleConfigurationBuilderTest.java,0,11,0,2,0,13
 shardingsphere-master\shardingsphere-master\shardingsphere-test\shardingsphere-parser-test\src\main\java\org\apache\shardingsphere\test\sql\parser\parameterized\jaxb\cases\domain\statement\ddl\AlterDomainStatementTestCase.java,0,0,0,3,0,3
 shardingsphere-master\shardingsphere-master\shardingsphere-features\shardingsphere-encrypt\shardingsphere-encrypt-distsql\shardingsphere-encrypt-distsql-statement\src\main\java\org\apache\shardingsphere\encrypt\distsql\parser\statement\ShowEncryptRulesStatement.java,0,6,0,4,0,10
 shardingsphere-master\shardingsphere-master\shardingsphere-sql-parser\shardingsphere-sql-parser-statement\src\main\java\org\apache\shardingsphere\sql\parser\sql\dialect\statement\postgresql\ddl\PostgreSQLExecuteStatement.java,0,1,0,5,0,6
 shardingsphere-master\shardingsphere-master\shardingsphere-test\shardingsphere-parser-test\src\main\java\org\apache\shardingsphere\test\sql\parser\parameterized\jaxb\cases\domain\statement\dal\RepairTableStatementTestCase.java,0,2,0,4,0,6
 shardingsphere-master\shardingsphere-master\shardingsphere-features\shardingsphere-encrypt\shardingsphere-encrypt-core\src\main\java\org\apache\shardingsphere\encrypt\algorithm\RC4EncryptAlgorithm.java,0,35,0,9,0,44
 shardingsphere-master\shardingsphere-master\shardingsphere-proxy\shardingsphere-proxy-backend\src\main\java\org\apache\shardingsphere\proxy\backend\communication\jdbc\connection\ResourceLock.java,0,9,0,2,0,11
 shardingsphere-master\shardingsphere-master\shardingsphere-features\shardingsphere-encrypt\shardingsphere-encrypt-core\src\main\java\org\apache\shardingsphere\encrypt\rewrite\token\pojo\EncryptConfigDataTypeToken.java,0,23,0,4,0,27
 shardingsphere-master\shardingsphere-master\shardingsphere-infra\shardingsphere-infra-binder\src\test\java\org\apache\shardingsphere\infra\binder\segment\select\pagination\engine\TopPaginationContextEngineTest.java,0,58,0,43,0,101
 shardingsphere-master\shardingsphere-master\shardingsphere-proxy\shardingsphere-proxy-backend\src\test\java\org\apache\shardingsphere\proxy\backend\config\ProxyConfigurationLoaderTest.java,0,55,0,47,0,102
 shardingsphere-master\shardingsphere-master\shardingsphere-features\shardingsphere-sharding\shardingsphere-sharding-distsql\shardingsphere-sharding-distsql-statement\src\main\java\org\apache\shardingsphere\sharding\distsql\parser\segment\ShardingAlgorithmSegment.java,0,4,0,1,0,5
 shardingsphere-master\shardingsphere-master\shardingsphere-test\shardingsphere-parser-test\src\main\java\org\apache\shardingsphere\test\sql\parser\parameterized\jaxb\cases\domain\statement\ddl\DropConversionStatementTestCase.java,0,0,0,3,0,3
 shardingsphere-master\shardingsphere-master\shardingsphere-infra\shardingsphere-infra-common\src\test\java\org\apache\shardingsphere\infra\config\checker\RuleConfigurationCheckerFactoryTest.java,0,7,0,4,0,11
 shardingsphere-master\shardingsphere-master\shardingsphere-db-protocol\shardingsphere-db-protocol-postgresql\src\main\java\org\apache\shardingsphere\db\protocol\postgresql\packet\command\query\PostgreSQLNoDataPacket.java,0,8,0,5,0,13
 shardingsphere-master\shardingsphere-master\shardingsphere-infra\shardingsphere-infra-executor\src\main\java\org\apache\shardingsphere\infra\executor\kernel\thread\ExecutorThreadFactoryBuilder.java,0,11,0,4,0,15
 shardingsphere-master\shardingsphere-master\shardingsphere-jdbc\shardingsphere-jdbc-core\src\main\java\org\apache\shardingsphere\driver\executor\callback\ExecuteCallback.java,0,3,0,1,0,4
 shardingsphere-master\shardingsphere-master\shardingsphere-proxy\shardingsphere-proxy-backend\src\main\java\org\apache\shardingsphere\proxy\backend\text\TextProtocolBackendHandler.java,0,5,1,1,0,7
 shardingsphere-master\shardingsphere-master\shardingsphere-sql-parser\shardingsphere-sql-parser-statement\src\main\java\org\apache\shardingsphere\sql\parser\sql\common\segment\dml\expr\NotExpression.java,0,6,0,1,0,7
 shardingsphere-master\shardingsphere-master\shardingsphere-db-protocol\shardingsphere-db-protocol-postgresql\src\main\java\org\apache\shardingsphere\db\protocol\postgresql\packet\command\query\extended\PostgreSQLAggregatedResponsesPacket.java,0,5,0,6,0,11
 shardingsphere-master\shardingsphere-master\shardingsphere-infra\shardingsphere-infra-executor\src\main\java\org\apache\shardingsphere\infra\executor\sql\execute\result\query\impl\driver\vertx\VertxMySQLQueryResultMetaData.java,0,18,0,8,0,26
 shardingsphere-master\shardingsphere-master\shardingsphere-sql-parser\shardingsphere-sql-parser-statement\src\main\java\org\apache\shardingsphere\sql\parser\sql\common\statement\tcl\UnlockStatement.java,3,1,1,3,0,5
 shardingsphere-master\shardingsphere-master\shardingsphere-sql-parser\shardingsphere-sql-parser-spi\src\main\java\org\apache\shardingsphere\sql\parser\api\visitor\operation\SQLStatementVisitor.java,0,0,0,1,0,1
 shardingsphere-master\shardingsphere-master\shardingsphere-test\shardingsphere-integration-test\shardingsphere-integration-test-suite\src\test\java\org\apache\shardingsphere\test\integration\cases\assertion\IntegrationTestCaseAssertion.java,0,16,0,4,0,20
 shardingsphere-master\shardingsphere-master\shardingsphere-sql-parser\shardingsphere-sql-parser-statement\src\main\java\org\apache\shardingsphere\sql\parser\sql\dialect\statement\oracle\ddl\OracleAlterSessionStatement.java,0,1,0,5,0,6
 shardingsphere-master\shardingsphere-master\shardingsphere-features\shardingsphere-readwrite-splitting\shardingsphere-readwrite-splitting-spring\shardingsphere-readwrite-splitting-spring-boot-starter\src\main\java\org\apache\shardingsphere\readwritesplitting\spring\boot\ReadwriteSplittingRuleSpringbootConfiguration.java,32,13,0,15,0,28
 shardingsphere-master\shardingsphere-master\shardingsphere-features\shardingsphere-shadow\shardingsphere-shadow-distsql\shardingsphere-shadow-distsql-statement\src\main\java\org\apache\shardingsphere\shadow\distsql\parser\statement\DropShadowAlgorithmStatement.java,0,6,0,3,0,9
 shardingsphere-master\shardingsphere-master\shardingsphere-features\shardingsphere-sharding\shardingsphere-sharding-core\src\test\java\org\apache\shardingsphere\sharding\algorithm\keygen\CosIdSnowflakeKeyGenerateAlgorithmTest.java,0,39,0,26,0,65
 shardingsphere-master\shardingsphere-master\shardingsphere-kernel\shardingsphere-authority\shardingsphere-authority-core\src\test\java\org\apache\shardingsphere\authority\rule\builder\DefaultAuthorityRuleConfigurationBuilderTest.java,0,11,0,3,0,14
 shardingsphere-master\shardingsphere-master\shardingsphere-sql-parser\shardingsphere-sql-parser-statement\src\main\java\org\apache\shardingsphere\sql\parser\sql\common\segment\dcl\LoginSegment.java,0,7,0,2,0,9
 shardingsphere-master\shardingsphere-master\examples\shardingsphere-example-generator\src\main\java\org\apache\shardingsphere\example\generator\core\impl\JDBCExampleGenerator.java,0,13,0,10,0,23
 shardingsphere-master\shardingsphere-master\shardingsphere-features\shardingsphere-db-discovery\shardingsphere-db-discovery-spring\shardingsphere-db-discovery-spring-boot-starter\src\main\java\org\apache\shardingsphere\dbdiscovery\spring\boot\algorithm\DatabaseDiscoveryAlgorithmProvidedBeanRegistry.java,0,9,0,6,0,15
 shardingsphere-master\shardingsphere-master\shardingsphere-infra\shardingsphere-infra-rewrite\src\main\java\org\apache\shardingsphere\infra\rewrite\sql\token\generator\aware\ParametersAware.java,0,3,0,1,0,4
 shardingsphere-master\shardingsphere-master\shardingsphere-features\shardingsphere-db-discovery\shardingsphere-db-discovery-distsql\shardingsphere-db-discovery-distsql-handler\src\test\java\org\apache\shardingsphere\dbdiscovery\distsql\handler\update\AlterDatabaseDiscoveryHeartbeatStatementUpdaterTest.java,0,29,0,23,0,52
 shardingsphere-master\shardingsphere-master\shardingsphere-proxy\shardingsphere-proxy-frontend\shardingsphere-proxy-frontend-mysql\src\main\java\org\apache\shardingsphere\proxy\frontend\mysql\command\query\binary\execute\MySQLComStmtExecuteExecutor.java,0,47,1,41,0,89
 shardingsphere-master\shardingsphere-master\shardingsphere-proxy\shardingsphere-proxy-frontend\shardingsphere-proxy-frontend-postgresql\src\test\java\org\apache\shardingsphere\proxy\frontend\postgresql\command\query\extended\close\PostgreSQLComCloseExecutorTest.java,0,18,0,11,0,29
 shardingsphere-master\shardingsphere-master\shardingsphere-test\shardingsphere-parser-test\src\main\java\org\apache\shardingsphere\test\sql\parser\parameterized\asserts\statement\distsql\ral\impl\common\queryable\ShowReadwriteSplittingReadResourcesStatementAssert.java,0,9,1,11,0,21
 shardingsphere-master\shardingsphere-master\shardingsphere-sql-parser\shardingsphere-sql-parser-statement\src\main\java\org\apache\shardingsphere\sql\parser\sql\dialect\statement\opengauss\dcl\OpenGaussAlterUserStatement.java,0,1,0,5,0,6
 shardingsphere-master\shardingsphere-master\shardingsphere-kernel\shardingsphere-authority\shardingsphere-authority-core\src\main\java\org\apache\shardingsphere\authority\yaml\config\YamlAuthorityRuleConfiguration.java,0,7,0,3,0,10
 shardingsphere-master\shardingsphere-master\shardingsphere-mode\shardingsphere-mode-type\shardingsphere-cluster-mode\shardingsphere-cluster-mode-core\src\main\java\org\apache\shardingsphere\mode\manager\cluster\coordinator\registry\status\compute\event\StateEvent.java,0,4,0,3,0,7
 shardingsphere-master\shardingsphere-master\shardingsphere-test\shardingsphere-parser-test\src\main\java\org\apache\shardingsphere\test\sql\parser\parameterized\jaxb\cases\domain\segment\impl\reset\ExpectedResetOptionSegment.java,0,7,0,4,0,11
 shardingsphere-master\shardingsphere-master\shardingsphere-infra\shardingsphere-infra-merge\src\main\java\org\apache\shardingsphere\infra\merge\result\impl\transparent\TransparentMergedResult.java,0,11,0,5,0,16
 shardingsphere-master\shardingsphere-master\shardingsphere-test\shardingsphere-parser-test\src\main\java\org\apache\shardingsphere\test\sql\parser\parameterized\jaxb\cases\domain\segment\impl\index\ExpectedIndex.java,0,1,0,4,0,5
 shardingsphere-master\shardingsphere-master\shardingsphere-jdbc\shardingsphere-jdbc-core\src\test\java\org\apache\shardingsphere\driver\jdbc\core\connection\ShardingSphereConnectionTest.java,0,67,7,32,0,106
 shardingsphere-master\shardingsphere-master\shardingsphere-sql-parser\shardingsphere-sql-parser-statement\src\main\java\org\apache\shardingsphere\sql\parser\sql\common\statement\dal\ShowStatement.java,3,1,1,3,0,5
 shardingsphere-master\shardingsphere-master\shardingsphere-infra\shardingsphere-infra-federation\shardingsphere-infra-federation-optimizer\src\main\java\org\apache\shardingsphere\infra\federation\optimizer\converter\segment\from\TableConverter.java,0,15,0,21,0,36
 shardingsphere-master\shardingsphere-master\shardingsphere-sql-parser\shardingsphere-sql-parser-statement\src\main\java\org\apache\shardingsphere\sql\parser\sql\dialect\statement\mysql\tcl\MySQLSetTransactionStatement.java,0,1,0,4,0,5
 shardingsphere-master\shardingsphere-master\shardingsphere-test\shardingsphere-parser-test\src\main\java\org\apache\shardingsphere\test\sql\parser\parameterized\jaxb\cases\domain\statement\distsql\rdl\drop\DropShardingTableRuleStatementTestCase.java,0,3,0,4,0,7
 shardingsphere-master\shardingsphere-master\shardingsphere-agent\shardingsphere-agent-plugins\shardingsphere-agent-plugin-metrics\shardingsphere-agent-metrics-api\src\main\java\org\apache\shardingsphere\agent\metrics\api\constant\MetricIds.java,0,58,0,5,0,63
 shardingsphere-master\shardingsphere-master\shardingsphere-kernel\shardingsphere-data-pipeline\shardingsphere-data-pipeline-dialect\shardingsphere-data-pipeline-mysql\src\test\java\org\apache\shardingsphere\data\pipeline\mysql\ingest\client\netty\MySQLNegotiateHandlerTest.java,0,37,0,17,0,54
 shardingsphere-master\shardingsphere-master\shardingsphere-infra\shardingsphere-infra-executor\src\main\java\org\apache\shardingsphere\infra\executor\sql\execute\engine\raw\RawSQLRuntimeContext.java,0,8,0,1,0,9
 shardingsphere-master\shardingsphere-master\shardingsphere-test\shardingsphere-parser-test\src\main\java\org\apache\shardingsphere\test\sql\parser\parameterized\jaxb\cases\domain\segment\impl\distsql\ExpectedDataSource.java,0,15,0,4,0,19
 shardingsphere-master\shardingsphere-master\shardingsphere-features\shardingsphere-sharding\shardingsphere-sharding-core\src\main\java\org\apache\shardingsphere\sharding\route\engine\condition\value\AlwaysFalseShardingConditionValue.java,0,4,0,2,0,6
 shardingsphere-master\shardingsphere-master\shardingsphere-features\shardingsphere-sharding\shardingsphere-sharding-core\src\test\java\org\apache\shardingsphere\sharding\swapper\strategy\ShardingStrategyConfigurationYamlSwapperTest.java,0,55,0,41,0,96
 shardingsphere-master\shardingsphere-master\shardingsphere-test\shardingsphere-parser-test\src\main\java\org\apache\shardingsphere\test\sql\parser\parameterized\asserts\segment\assignment\AssignmentAssert.java,0,10,0,13,0,23
 shardingsphere-master\shardingsphere-master\shardingsphere-db-protocol\shardingsphere-db-protocol-postgresql\src\main\java\org\apache\shardingsphere\db\protocol\postgresql\packet\command\query\extended\bind\protocol\PostgreSQLDateBinaryProtocolValue.java,0,7,0,6,0,13
 shardingsphere-master\shardingsphere-master\shardingsphere-kernel\shardingsphere-parser\shardingsphere-parser-core\src\test\java\org\apache\shardingsphere\parser\SQLParserRuleTest.java,0,5,0,4,0,9
 shardingsphere-master\shardingsphere-master\shardingsphere-features\shardingsphere-shadow\shardingsphere-shadow-core\src\main\java\org\apache\shardingsphere\shadow\yaml\swapper\ShadowRuleConfigurationYamlSwapper.java,0,37,0,25,0,62
 shardingsphere-master\shardingsphere-master\shardingsphere-mode\shardingsphere-mode-type\shardingsphere-cluster-mode\shardingsphere-cluster-mode-repository\shardingsphere-cluster-mode-repository-api\src\main\java\org\apache\shardingsphere\mode\repository\cluster\listener\DataChangedEvent.java,0,13,0,1,0,14
 shardingsphere-master\shardingsphere-master\shardingsphere-proxy\shardingsphere-proxy-backend\src\main\java\org\apache\shardingsphere\proxy\backend\response\header\update\ClientEncodingResponseHeader.java,17,6,0,1,0,7
 shardingsphere-master\shardingsphere-master\shardingsphere-kernel\shardingsphere-traffic\shardingsphere-traffic-core\src\test\java\org\apache\shardingsphere\traffic\rule\builder\TrafficRuleBuilderTest.java,0,8,0,2,0,10
 shardingsphere-master\shardingsphere-master\shardingsphere-features\shardingsphere-sharding\shardingsphere-sharding-core\src\main\java\org\apache\shardingsphere\sharding\rewrite\token\pojo\TableToken.java,0,22,3,10,0,35
 shardingsphere-master\shardingsphere-master\shardingsphere-infra\shardingsphere-infra-binder\src\main\java\org\apache\shardingsphere\infra\binder\statement\ddl\AlterIndexStatementContext.java,0,13,0,12,0,25
 shardingsphere-master\shardingsphere-master\examples\shardingsphere-example-generator\src\main\java\org\apache\shardingsphere\example\generator\scenario\framework\type\SpringBootStarterJdbcExampleScenario.java,0,12,0,8,0,20
 shardingsphere-master\shardingsphere-master\shardingsphere-agent\shardingsphere-agent-core\src\main\java\org\apache\shardingsphere\agent\core\bytebuddy\transformer\ShardingSphereTransformer.java,0,82,6,78,0,166
 shardingsphere-master\shardingsphere-master\shardingsphere-mode\shardingsphere-mode-type\shardingsphere-cluster-mode\shardingsphere-cluster-mode-core\src\main\java\org\apache\shardingsphere\mode\manager\cluster\coordinator\registry\status\storage\service\StorageNodeStatusService.java,0,8,0,8,0,16
 shardingsphere-master\shardingsphere-master\shardingsphere-db-protocol\shardingsphere-db-protocol-postgresql\src\test\java\org\apache\shardingsphere\db\protocol\postgresql\packet\command\query\PostgreSQLColumnDescriptionTest.java,0,16,0,4,0,20
 shardingsphere-master\shardingsphere-master\shardingsphere-spi\src\test\java\org\apache\shardingsphere\spi\fixture\typed\TypedSPIFixtureImpl.java,0,4,0,1,0,5
 shardingsphere-master\shardingsphere-master\shardingsphere-test\shardingsphere-parser-test\src\main\java\org\apache\shardingsphere\test\sql\parser\parameterized\jaxb\sql\loader\UnsupportedSQLCasesRegistry.java,0,8,0,2,0,10
 shardingsphere-master\shardingsphere-master\shardingsphere-kernel\shardingsphere-traffic\shardingsphere-traffic-core\src\test\java\org\apache\shardingsphere\traffic\algorithm\traffic\segment\SQLMatchTrafficAlgorithmTest.java,0,21,0,13,0,34
 shardingsphere-master\shardingsphere-master\shardingsphere-test\shardingsphere-parser-test\src\main\java\org\apache\shardingsphere\test\sql\parser\parameterized\jaxb\cases\domain\statement\dcl\SetUserStatementTestCase.java,0,2,0,4,0,6
 shardingsphere-master\shardingsphere-master\shardingsphere-kernel\shardingsphere-authority\shardingsphere-authority-core\src\main\java\org\apache\shardingsphere\authority\provider\natived\builder\dialect\MySQLPrivilegeHandler.java,0,119,0,88,0,207
 shardingsphere-master\shardingsphere-master\shardingsphere-mode\shardingsphere-mode-type\shardingsphere-cluster-mode\shardingsphere-cluster-mode-core\src\main\java\org\apache\shardingsphere\mode\manager\cluster\coordinator\registry\status\compute\service\ComputeNodeStatusService.java,0,6,0,4,0,10
 shardingsphere-master\shardingsphere-master\shardingsphere-test\shardingsphere-parser-test\src\main\java\org\apache\shardingsphere\test\sql\parser\parameterized\jaxb\Cases.java,3,0,1,1,0,2
 shardingsphere-master\shardingsphere-master\shardingsphere-infra\shardingsphere-infra-merge\src\test\java\org\apache\shardingsphere\infra\merge\result\impl\transparent\TransparentMergedResultTest.java,0,18,1,9,0,28
 shardingsphere-master\shardingsphere-master\shardingsphere-test\shardingsphere-parser-test\src\main\java\org\apache\shardingsphere\test\sql\parser\parameterized\asserts\statement\ddl\impl\CreateTableStatementAssert.java,0,28,0,35,0,63
 shardingsphere-master\shardingsphere-master\shardingsphere-infra\shardingsphere-infra-rewrite\src\main\java\org\apache\shardingsphere\infra\rewrite\sql\token\generator\aware\PreviousSQLTokensAware.java,0,2,0,1,0,3
 shardingsphere-master\shardingsphere-master\shardingsphere-features\shardingsphere-readwrite-splitting\shardingsphere-readwrite-splitting-distsql\shardingsphere-readwrite-splitting-distsql-statement\src\main\java\org\apache\shardingsphere\readwritesplitting\distsql\parser\statement\hint\ClearReadwriteSplittingHintStatement.java,0,2,0,4,0,6
 shardingsphere-master\shardingsphere-master\shardingsphere-infra\shardingsphere-infra-common\src\main\java\org\apache\shardingsphere\infra\rule\identifier\type\ExportableRule.java,0,5,0,2,0,7
 shardingsphere-master\shardingsphere-master\examples\shardingsphere-proxy-example\shardingsphere-proxy-boot-mybatis-example\src\main\java\org\apache\shardingsphere\example\proxy\spring\boot\mybatis\ProxySpringBootStarterExample.java,27,14,1,8,0,23
 shardingsphere-master\shardingsphere-master\shardingsphere-test\shardingsphere-integration-scaling-test\shardingsphere-integration-scaling-test-mysql\src\test\java\org\apache\shardingsphere\integration\scaling\test\mysql\util\Executor.java,0,1,0,1,0,2
 shardingsphere-master\shardingsphere-master\shardingsphere-sql-parser\shardingsphere-sql-parser-statement\src\main\java\org\apache\shardingsphere\sql\parser\sql\dialect\statement\opengauss\dal\OpenGaussResetParameterStatement.java,0,1,0,5,0,6
 shardingsphere-master\shardingsphere-master\shardingsphere-test\shardingsphere-integration-test\shardingsphere-integration-test-suite\src\test\java\org\apache\shardingsphere\test\integration\cases\value\SQLValueGroup.java,0,10,0,5,0,15
 shardingsphere-master\shardingsphere-master\shardingsphere-test\shardingsphere-parser-test\src\main\java\org\apache\shardingsphere\test\sql\parser\parameterized\jaxb\cases\domain\segment\impl\definition\ExpectedConvertTableDefinition.java,0,5,0,6,0,11
 shardingsphere-master\shardingsphere-master\shardingsphere-features\shardingsphere-sharding\shardingsphere-sharding-api\src\main\java\org\apache\shardingsphere\sharding\api\config\strategy\sharding\ShardingStrategyConfiguration.java,0,2,0,1,0,3
 shardingsphere-master\shardingsphere-master\shardingsphere-infra\shardingsphere-infra-executor\src\main\java\org\apache\shardingsphere\infra\executor\sql\prepare\driver\ExecutorStatementManager.java,0,6,0,5,0,11
 shardingsphere-master\shardingsphere-master\shardingsphere-sql-parser\shardingsphere-sql-parser-dialect\shardingsphere-sql-parser-sqlserver\src\main\java\org\apache\shardingsphere\sql\parser\sqlserver\visitor\statement\facade\SQLServerStatementSQLVisitorFacade.java,0,10,0,7,0,17
 shardingsphere-master\shardingsphere-master\shardingsphere-infra\shardingsphere-infra-binder\src\main\java\org\apache\shardingsphere\infra\binder\segment\select\pagination\engine\LimitPaginationContextEngine.java,0,5,0,5,0,10
 shardingsphere-master\shardingsphere-master\shardingsphere-kernel\shardingsphere-data-pipeline\shardingsphere-data-pipeline-spi\src\main\java\org\apache\shardingsphere\data\pipeline\spi\ingest\dumper\IncrementalDumper.java,0,0,0,1,0,1
 shardingsphere-master\shardingsphere-master\shardingsphere-db-protocol\shardingsphere-db-protocol-mysql\src\main\java\org\apache\shardingsphere\db\protocol\mysql\packet\command\query\text\fieldlist\MySQLComFieldListPacket.java,0,10,0,5,0,15
 shardingsphere-master\shardingsphere-master\shardingsphere-infra\shardingsphere-infra-executor\src\main\java\org\apache\shardingsphere\infra\executor\sql\context\SQLUnit.java,0,10,0,1,0,11
 shardingsphere-master\shardingsphere-master\shardingsphere-db-protocol\shardingsphere-db-protocol-mysql\src\main\java\org\apache\shardingsphere\db\protocol\mysql\packet\command\query\binary\close\MySQLComStmtClosePacket.java,0,6,0,5,0,11
 shardingsphere-master\shardingsphere-master\shardingsphere-sql-parser\shardingsphere-sql-parser-statement\src\main\java\org\apache\shardingsphere\sql\parser\sql\dialect\handler\ddl\CreateProcedureStatementHandler.java,0,5,0,9,1,15
 shardingsphere-master\shardingsphere-master\shardingsphere-infra\shardingsphere-infra-common\src\test\java\org\apache\shardingsphere\infra\instance\InstanceContextTest.java,0,27,0,18,0,45
 shardingsphere-master\shardingsphere-master\shardingsphere-mode\shardingsphere-mode-type\shardingsphere-cluster-mode\shardingsphere-cluster-mode-core\src\main\java\org\apache\shardingsphere\mode\manager\cluster\coordinator\registry\status\compute\watcher\ComputeNodeStateChangedWatcher.java,0,20,0,27,0,47
 shardingsphere-master\shardingsphere-master\shardingsphere-kernel\shardingsphere-data-pipeline\shardingsphere-data-pipeline-dialect\shardingsphere-data-pipeline-postgresql\src\main\java\org\apache\shardingsphere\data\pipeline\postgresql\importer\PostgreSQLImporter.java,0,6,0,8,0,14
 shardingsphere-master\shardingsphere-master\shardingsphere-test\shardingsphere-parser-test\src\main\java\org\apache\shardingsphere\test\sql\parser\parameterized\jaxb\cases\domain\statement\tcl\LockStatementTestCase.java,0,2,0,4,0,6
 shardingsphere-master\shardingsphere-master\shardingsphere-proxy\shardingsphere-proxy-backend\src\test\java\org\apache\shardingsphere\proxy\backend\communication\jdbc\statement\impl\OpenGaussStatementMemoryStrictlyFetchSizeSetterTest.java,0,18,2,9,0,29
 shardingsphere-master\shardingsphere-master\shardingsphere-infra\shardingsphere-infra-executor\src\test\java\org\apache\shardingsphere\infra\executor\sql\execute\result\query\impl\driver\jdbc\metadata\JDBCQueryResultMetaDataTest.java,0,31,0,3,0,34
 shardingsphere-master\shardingsphere-master\shardingsphere-test\shardingsphere-integration-scaling-test\shardingsphere-integration-scaling-test-mysql\src\test\java\org\apache\shardingsphere\integration\scaling\test\mysql\env\cases\Type.java,0,11,0,1,0,12
 shardingsphere-master\shardingsphere-master\shardingsphere-sql-parser\shardingsphere-sql-parser-statement\src\main\java\org\apache\shardingsphere\sql\parser\sql\dialect\statement\mysql\dml\MySQLUpdateStatement.java,0,7,0,6,0,13
 shardingsphere-master\shardingsphere-master\shardingsphere-features\shardingsphere-sharding\shardingsphere-sharding-distsql\shardingsphere-sharding-distsql-handler\src\main\java\org\apache\shardingsphere\sharding\distsql\handler\query\UnusedShardingAlgorithmsQueryResultSet.java,0,38,0,22,0,60
 shardingsphere-master\shardingsphere-master\shardingsphere-features\shardingsphere-sharding\shardingsphere-sharding-core\src\main\java\org\apache\shardingsphere\sharding\route\engine\validator\ddl\impl\ShardingCreateViewStatementValidator.java,0,10,1,11,0,22
 shardingsphere-master\shardingsphere-master\shardingsphere-sql-parser\shardingsphere-sql-parser-statement\src\main\java\org\apache\shardingsphere\sql\parser\sql\dialect\statement\mysql\dal\MySQLUninstallPluginStatement.java,0,3,0,5,0,8
 shardingsphere-master\shardingsphere-master\shardingsphere-features\shardingsphere-sharding\shardingsphere-sharding-api\src\main\java\org\apache\shardingsphere\sharding\api\sharding\hint\HintShardingValue.java,0,8,0,2,0,10
 shardingsphere-master\shardingsphere-master\shardingsphere-features\shardingsphere-db-discovery\shardingsphere-db-discovery-distsql\shardingsphere-db-discovery-distsql-statement\src\main\java\org\apache\shardingsphere\dbdiscovery\distsql\parser\segment\DatabaseDiscoveryDefinitionSegment.java,0,10,0,3,0,13
 shardingsphere-master\shardingsphere-master\shardingsphere-features\shardingsphere-sharding\shardingsphere-sharding-core\src\test\java\org\apache\shardingsphere\sharding\route\engine\validator\dml\ShardingDeleteStatementValidatorTest.java,0,21,0,20,0,41
 shardingsphere-master\shardingsphere-master\shardingsphere-sql-parser\shardingsphere-sql-parser-statement\src\main\java\org\apache\shardingsphere\sql\parser\sql\common\statement\dml\SelectStatement.java,64,22,0,11,4,37
 shardingsphere-master\shardingsphere-master\shardingsphere-sql-parser\shardingsphere-sql-parser-statement\src\main\java\org\apache\shardingsphere\sql\parser\sql\dialect\statement\oracle\tcl\OracleCommitStatement.java,0,2,0,4,0,6
 shardingsphere-master\shardingsphere-master\shardingsphere-features\shardingsphere-sharding\shardingsphere-sharding-core\src\main\java\org\apache\shardingsphere\sharding\yaml\config\YamlShardingRuleConfiguration.java,0,31,0,13,0,44
 shardingsphere-master\shardingsphere-master\shardingsphere-sql-parser\shardingsphere-sql-parser-statement\src\main\java\org\apache\shardingsphere\sql\parser\sql\common\util\ExpressionExtractUtil.java,0,25,0,21,0,46
 shardingsphere-master\shardingsphere-master\shardingsphere-mode\shardingsphere-mode-type\shardingsphere-memory-mode\shardingsphere-memory-mode-core\src\main\java\org\apache\shardingsphere\mode\manager\memory\lock\MemoryLockContext.java,0,10,0,5,0,15
 shardingsphere-master\shardingsphere-master\shardingsphere-test\shardingsphere-parser-test\src\main\java\org\apache\shardingsphere\test\sql\parser\parameterized\asserts\statement\dal\impl\KillStatementAssert.java,0,4,0,7,0,11
 shardingsphere-master\shardingsphere-master\shardingsphere-sql-parser\shardingsphere-sql-parser-statement\src\main\java\org\apache\shardingsphere\sql\parser\sql\common\statement\SQLStatementType.java,0,7,0,1,0,8
 shardingsphere-master\shardingsphere-master\shardingsphere-db-protocol\shardingsphere-db-protocol-postgresql\src\test\java\org\apache\shardingsphere\db\protocol\postgresql\constant\PostgreSQLColumnTypeTest.java,0,21,0,9,0,30
 shardingsphere-master\shardingsphere-master\shardingsphere-sql-parser\shardingsphere-sql-parser-statement\src\main\java\org\apache\shardingsphere\sql\parser\sql\dialect\statement\postgresql\ddl\PostgreSQLCreateFunctionStatement.java,0,1,0,5,0,6
 shardingsphere-master\shardingsphere-master\shardingsphere-sql-parser\shardingsphere-sql-parser-statement\src\main\java\org\apache\shardingsphere\sql\parser\sql\common\segment\ddl\packages\PackageSegment.java,0,5,0,4,1,10
 shardingsphere-master\shardingsphere-master\shardingsphere-sql-parser\shardingsphere-sql-parser-dialect\shardingsphere-sql-parser-sqlserver\src\main\java\org\apache\shardingsphere\sql\parser\sqlserver\parser\SQLServerLexer.java,0,4,0,2,0,6
 shardingsphere-master\shardingsphere-master\shardingsphere-sql-parser\shardingsphere-sql-parser-statement\src\main\java\org\apache\shardingsphere\sql\parser\sql\dialect\statement\oracle\ddl\OracleAnalyzeStatement.java,0,4,0,7,4,15
 shardingsphere-master\shardingsphere-master\shardingsphere-test\shardingsphere-parser-test\src\main\java\org\apache\shardingsphere\test\sql\parser\parameterized\jaxb\cases\domain\statement\ddl\DropViewStatementTestCase.java,0,0,0,3,0,3
 shardingsphere-master\shardingsphere-master\shardingsphere-sql-parser\shardingsphere-sql-parser-statement\src\main\java\org\apache\shardingsphere\sql\parser\sql\dialect\statement\oracle\ddl\OracleCreateDatabaseStatement.java,0,1,0,4,0,5
 shardingsphere-master\shardingsphere-master\examples\example-core\example-api\src\main\java\org\apache\shardingsphere\example\core\api\repository\AddressRepository.java,0,0,0,1,0,1
 shardingsphere-master\shardingsphere-master\shardingsphere-sql-parser\shardingsphere-sql-parser-dialect\shardingsphere-sql-parser-oracle\src\main\java\org\apache\shardingsphere\sql\parser\oracle\visitor\statement\impl\OracleDCLStatementSQLVisitor.java,0,16,0,27,0,43
 shardingsphere-master\shardingsphere-master\shardingsphere-spi\src\main\java\org\apache\shardingsphere\spi\typed\TypedSPIRegistry.java,0,11,0,7,0,18
 shardingsphere-master\shardingsphere-master\shardingsphere-infra\shardingsphere-infra-executor\src\main\java\org\apache\shardingsphere\infra\executor\sql\process\ExecuteProcessStrategyEvaluator.java,0,5,0,8,0,13
 shardingsphere-master\shardingsphere-master\shardingsphere-distsql\shardingsphere-distsql-statement\src\main\java\org\apache\shardingsphere\distsql\parser\statement\DistSQLStatement.java,3,1,1,2,0,4
 shardingsphere-master\shardingsphere-master\shardingsphere-kernel\shardingsphere-data-pipeline\shardingsphere-data-pipeline-core\src\main\java\org\apache\shardingsphere\data\pipeline\core\record\RecordUtil.java,0,10,0,6,0,16
 shardingsphere-master\shardingsphere-master\shardingsphere-kernel\shardingsphere-parser\shardingsphere-parser-spring\shardingsphere-parser-spring-boot-starter\src\main\java\org\apache\shardingsphere\parser\spring\boot\SQLParserRuleSpringBootConfiguration.java,17,7,0,7,0,14
 shardingsphere-master\shardingsphere-master\shardingsphere-kernel\shardingsphere-data-pipeline\shardingsphere-data-pipeline-core\src\main\java\org\apache\shardingsphere\scaling\core\job\importer\ImporterFactory.java,0,8,0,9,0,17
 shardingsphere-master\shardingsphere-master\shardingsphere-features\shardingsphere-sharding\shardingsphere-sharding-spring\shardingsphere-sharding-spring-boot-starter\src\main\java\org\apache\shardingsphere\sharding\spring\boot\condition\ShardingSpringBootCondition.java,0,8,0,5,0,13
 shardingsphere-master\shardingsphere-master\shardingsphere-infra\shardingsphere-infra-merge\src\test\java\org\apache\shardingsphere\infra\merge\engine\decorator\impl\TransparentResultDecoratorTest.java,0,7,0,4,0,11
 shardingsphere-master\shardingsphere-master\shardingsphere-kernel\shardingsphere-data-pipeline\shardingsphere-data-pipeline-spi\src\main\java\org\apache\shardingsphere\data\pipeline\spi\lock\JobLock.java,0,3,0,1,0,4
 shardingsphere-master\shardingsphere-master\shardingsphere-test\shardingsphere-parser-test\src\main\java\org\apache\shardingsphere\test\sql\parser\parameterized\jaxb\cases\domain\segment\impl\distsql\ral\ExpectedTrafficRule.java,0,8,0,5,0,13
 shardingsphere-master\shardingsphere-master\shardingsphere-distsql\shardingsphere-distsql-statement\src\main\java\org\apache\shardingsphere\distsql\parser\segment\TrafficRuleSegment.java,0,8,0,1,0,9
 shardingsphere-master\shardingsphere-master\examples\shardingsphere-jdbc-example\single-feature-example\sharding-example\sharding-spring-namespace-mybatis-example\src\main\java\org\apache\shardingsphere\example\sharding\spring\namespace\mybatis\ShardingSpringNamespaceMybatisExample.java,0,11,1,6,0,18
 shardingsphere-master\shardingsphere-master\shardingsphere-infra\shardingsphere-infra-common\src\main\java\org\apache\shardingsphere\infra\storage\StorageNodeStatus.java,0,3,0,1,0,4
 shardingsphere-master\shardingsphere-master\shardingsphere-features\shardingsphere-encrypt\shardingsphere-encrypt-core\src\main\java\org\apache\shardingsphere\encrypt\algorithm\config\AlgorithmProvidedEncryptRuleConfiguration.java,0,9,0,5,0,14
 shardingsphere-master\shardingsphere-master\shardingsphere-sql-parser\shardingsphere-sql-parser-engine\src\main\java\org\apache\shardingsphere\sql\parser\api\SQLParserEngine.java,0,9,0,5,0,14
 shardingsphere-master\shardingsphere-master\shardingsphere-sql-parser\shardingsphere-sql-parser-statement\src\main\java\org\apache\shardingsphere\sql\parser\sql\dialect\statement\oracle\dcl\OracleDropUserStatement.java,0,1,0,4,0,5
 shardingsphere-master\shardingsphere-master\shardingsphere-sql-parser\shardingsphere-sql-parser-statement\src\main\java\org\apache\shardingsphere\sql\parser\sql\dialect\statement\sqlserver\ddl\SQLServerDropDatabaseStatement.java,0,1,0,5,0,6
 shardingsphere-master\shardingsphere-master\shardingsphere-features\shardingsphere-encrypt\shardingsphere-encrypt-core\src\main\java\org\apache\shardingsphere\encrypt\context\EncryptContextBuilder.java,0,10,1,6,0,17
 shardingsphere-master\shardingsphere-master\shardingsphere-kernel\shardingsphere-transaction\shardingsphere-transaction-type\shardingsphere-transaction-xa\shardingsphere-transaction-xa-provider\shardingsphere-transaction-xa-narayana\src\main\java\org\apache\shardingsphere\transaction\xa\narayana\config\NarayanaConfiguration.java,0,2,0,1,0,3
 shardingsphere-master\shardingsphere-master\shardingsphere-test\shardingsphere-parser-test\src\main\java\org\apache\shardingsphere\test\sql\parser\parameterized\jaxb\cases\domain\statement\dal\ChecksumTableStatementTestCase.java,0,2,0,4,0,6
 shardingsphere-master\shardingsphere-master\shardingsphere-test\shardingsphere-parser-test\src\main\java\org\apache\shardingsphere\test\sql\parser\parameterized\jaxb\cases\domain\segment\impl\projection\impl\aggregation\ExpectedAggregationDistinctProjection.java,0,4,0,3,0,7
 shardingsphere-master\shardingsphere-master\shardingsphere-features\shardingsphere-shadow\shardingsphere-shadow-api\src\main\java\org\apache\shardingsphere\shadow\api\shadow\hint\PreciseHintShadowValue.java,0,7,0,2,0,9
 shardingsphere-master\shardingsphere-master\shardingsphere-sql-parser\shardingsphere-sql-parser-engine\src\main\java\org\apache\shardingsphere\sql\parser\core\database\cache\ParseTreeCacheBuilder.java,0,6,0,3,0,9
 shardingsphere-master\shardingsphere-master\shardingsphere-db-protocol\shardingsphere-db-protocol-postgresql\src\main\java\org\apache\shardingsphere\db\protocol\postgresql\packet\command\query\extended\bind\protocol\PostgreSQLNumericBinaryProtocolValue.java,0,8,0,8,0,16
 shardingsphere-master\shardingsphere-master\shardingsphere-infra\shardingsphere-infra-common\src\test\java\org\apache\shardingsphere\infra\metadata\user\GranteeTest.java,0,12,6,2,0,20
 shardingsphere-master\shardingsphere-master\shardingsphere-test\shardingsphere-pipeline-test\src\test\java\org\apache\shardingsphere\data\pipeline\core\fixture\FixtureImporter.java,0,6,6,5,0,17
 shardingsphere-master\shardingsphere-master\shardingsphere-features\shardingsphere-sharding\shardingsphere-sharding-core\src\test\java\org\apache\shardingsphere\sharding\route\engine\validator\ddl\ShardingAlterTableStatementValidatorTest.java,0,66,0,52,0,118
 shardingsphere-master\shardingsphere-master\examples\example-core\example-raw-jdbc\src\main\java\org\apache\shardingsphere\example\core\jdbc\repository\AddressRepositoryImpl.java,0,17,0,6,0,23
 shardingsphere-master\shardingsphere-master\shardingsphere-kernel\shardingsphere-single-table\shardingsphere-single-table-core\src\main\java\org\apache\shardingsphere\singletable\route\SingleTableSQLRouter.java,0,30,0,23,0,53
 shardingsphere-master\shardingsphere-master\shardingsphere-infra\shardingsphere-infra-federation\shardingsphere-infra-federation-optimizer\src\main\java\org\apache\shardingsphere\infra\federation\optimizer\converter\segment\expression\impl\BinaryOperationExpressionConverter.java,0,22,0,20,0,42
 shardingsphere-master\shardingsphere-master\shardingsphere-features\shardingsphere-readwrite-splitting\shardingsphere-readwrite-splitting-core\src\test\java\org\apache\shardingsphere\readwritesplitting\algorithm\loadbalance\RandomReplicaLoadBalanceAlgorithmTest.java,0,10,0,6,0,16
 shardingsphere-master\shardingsphere-master\shardingsphere-features\shardingsphere-sharding\shardingsphere-sharding-api\src\main\java\org\apache\shardingsphere\sharding\spi\KeyGenerateAlgorithm.java,0,4,0,3,0,7
 shardingsphere-master\shardingsphere-master\shardingsphere-proxy\shardingsphere-proxy-backend\src\test\java\org\apache\shardingsphere\proxy\backend\config\yaml\swapper\YamlProxyDataSourceConfigurationSwapperTest.java,0,15,0,11,0,26
 shardingsphere-master\shardingsphere-master\shardingsphere-sql-parser\shardingsphere-sql-parser-statement\src\main\java\org\apache\shardingsphere\sql\parser\sql\dialect\statement\oracle\ddl\OracleDisassociateStatisticsStatement.java,0,15,0,12,14,41
 shardingsphere-master\shardingsphere-master\shardingsphere-sql-parser\shardingsphere-sql-parser-statement\src\main\java\org\apache\shardingsphere\sql\parser\sql\dialect\statement\sqlserver\tcl\SQLServerBeginTransactionStatement.java,0,1,0,5,0,6
 shardingsphere-master\shardingsphere-master\shardingsphere-features\shardingsphere-readwrite-splitting\shardingsphere-readwrite-splitting-distsql\shardingsphere-readwrite-splitting-distsql-parser\src\main\java\org\apache\shardingsphere\readwritesplitting\distsql\parser\core\ReadwriteSplittingDistSQLStatementVisitor.java,0,52,2,65,0,119
 shardingsphere-master\shardingsphere-master\shardingsphere-spi\src\test\java\org\apache\shardingsphere\spi\fixture\required\NoImplRequiredSPIFixture.java,0,1,0,1,0,2
 shardingsphere-master\shardingsphere-master\shardingsphere-sql-parser\shardingsphere-sql-parser-statement\src\main\java\org\apache\shardingsphere\sql\parser\sql\dialect\statement\sqlserver\ddl\SQLServerDropSchemaStatement.java,0,1,0,6,0,7
 shardingsphere-master\shardingsphere-master\shardingsphere-test\shardingsphere-parser-test\src\main\java\org\apache\shardingsphere\test\sql\parser\parameterized\jaxb\cases\domain\statement\dal\ShowProcedureCodeStatementTestCase.java,0,3,0,5,0,8
 shardingsphere-master\shardingsphere-master\shardingsphere-sql-parser\shardingsphere-sql-parser-statement\src\main\java\org\apache\shardingsphere\sql\parser\sql\dialect\statement\sqlserver\ddl\SQLServerDropTriggerStatement.java,0,1,0,6,0,7
 shardingsphere-master\shardingsphere-master\shardingsphere-features\shardingsphere-db-discovery\shardingsphere-db-discovery-provider\shardingsphere-db-discovery-opengauss\src\test\java\org\apache\shardingsphere\dbdiscovery\opengauss\OpenGaussDatabaseDiscoveryTypeTest.java,0,28,4,13,0,45
 shardingsphere-master\shardingsphere-master\shardingsphere-features\shardingsphere-sharding\shardingsphere-sharding-core\src\main\java\org\apache\shardingsphere\sharding\merge\dql\groupby\GroupByStreamMergedResult.java,0,36,0,27,0,63
 shardingsphere-master\shardingsphere-master\shardingsphere-features\shardingsphere-encrypt\shardingsphere-encrypt-core\src\test\java\org\apache\shardingsphere\encrypt\rule\EncryptRuleTest.java,0,83,1,49,0,133
 shardingsphere-master\shardingsphere-master\shardingsphere-sql-parser\shardingsphere-sql-parser-statement\src\main\java\org\apache\shardingsphere\sql\parser\sql\dialect\statement\mysql\ddl\MySQLCreateEventStatement.java,0,1,0,5,0,6
 shardingsphere-master\shardingsphere-master\shardingsphere-sql-parser\shardingsphere-sql-parser-statement\src\main\java\org\apache\shardingsphere\sql\parser\sql\dialect\statement\opengauss\dml\OpenGaussCallStatement.java,0,2,0,5,0,7
 shardingsphere-master\shardingsphere-master\shardingsphere-features\shardingsphere-sharding\shardingsphere-sharding-core\src\main\java\org\apache\shardingsphere\sharding\route\engine\type\broadcast\ShardingInstanceBroadcastRoutingEngine.java,0,6,0,4,0,10
 shardingsphere-master\shardingsphere-master\shardingsphere-test\shardingsphere-parser-test\src\main\java\org\apache\shardingsphere\test\sql\parser\parameterized\jaxb\cases\domain\statement\distsql\rdl\alter\AlterShadowAlgorithmStatementTestCase.java,0,4,0,6,0,10
 shardingsphere-master\shardingsphere-master\shardingsphere-proxy\shardingsphere-proxy-frontend\shardingsphere-proxy-frontend-postgresql\src\main\java\org\apache\shardingsphere\proxy\frontend\postgresql\command\query\extended\PostgreSQLBatchedStatementsExecutor.java,0,72,1,54,0,127
 shardingsphere-master\shardingsphere-master\shardingsphere-infra\shardingsphere-infra-common\src\main\java\org\apache\shardingsphere\infra\metadata\schema\loader\common\ColumnMetaDataLoader.java,0,22,0,12,0,34
 shardingsphere-master\shardingsphere-master\shardingsphere-db-protocol\shardingsphere-db-protocol-postgresql\src\main\java\org\apache\shardingsphere\db\protocol\postgresql\packet\command\query\extended\describe\PostgreSQLComDescribePacket.java,0,9,1,6,0,16
 shardingsphere-master\shardingsphere-master\shardingsphere-db-protocol\shardingsphere-db-protocol-postgresql\src\test\java\org\apache\shardingsphere\db\protocol\postgresql\packet\command\query\extended\bind\protocol\PostgreSQLDoubleBinaryProtocolValueTest.java,0,13,0,6,0,19
 shardingsphere-master\shardingsphere-master\shardingsphere-infra\shardingsphere-infra-common\src\test\java\org\apache\shardingsphere\infra\metadata\schema\loader\common\ColumnMetaDataLoaderTest.java,0,26,0,11,0,37
 shardingsphere-master\shardingsphere-master\shardingsphere-infra\shardingsphere-infra-executor\src\main\java\org\apache\shardingsphere\infra\executor\sql\prepare\AbstractExecutionPrepareEngine.java,57,27,0,16,0,43
 shardingsphere-master\shardingsphere-master\examples\example-core\example-api\src\main\java\org\apache\shardingsphere\example\core\api\service\ExampleService.java,0,11,0,1,0,12
 shardingsphere-master\shardingsphere-master\shardingsphere-mode\shardingsphere-mode-type\shardingsphere-cluster-mode\shardingsphere-cluster-mode-core\src\main\java\org\apache\shardingsphere\mode\manager\cluster\coordinator\registry\config\watcher\PropertiesChangedWatcher.java,0,6,0,9,0,15
 shardingsphere-master\shardingsphere-master\shardingsphere-db-protocol\shardingsphere-db-protocol-mysql\src\main\java\org\apache\shardingsphere\db\protocol\mysql\packet\generic\MySQLEofPacket.java,0,18,0,4,0,22
 shardingsphere-master\shardingsphere-master\shardingsphere-mode\shardingsphere-mode-type\shardingsphere-cluster-mode\shardingsphere-cluster-mode-core\src\test\java\org\apache\shardingsphere\mode\manager\cluster\process\GovernanceExecuteProcessReporterSubscriberFixture.java,0,16,0,9,0,25
 shardingsphere-master\shardingsphere-master\shardingsphere-sql-parser\shardingsphere-sql-parser-statement\src\main\java\org\apache\shardingsphere\sql\parser\sql\dialect\statement\postgresql\dcl\PostgreSQLAlterRoleStatement.java,0,2,0,5,0,7
 shardingsphere-master\shardingsphere-master\shardingsphere-test\shardingsphere-parser-test\src\main\java\org\apache\shardingsphere\test\sql\parser\parameterized\asserts\segment\definition\ConstraintDefinitionAssert.java,0,19,0,24,0,43
 shardingsphere-master\shardingsphere-master\shardingsphere-infra\shardingsphere-infra-rewrite\src\main\java\org\apache\shardingsphere\infra\rewrite\sql\token\generator\SQLTokenGenerator.java,0,1,0,1,0,2
 shardingsphere-master\shardingsphere-master\shardingsphere-sql-parser\shardingsphere-sql-parser-statement\src\main\java\org\apache\shardingsphere\sql\parser\sql\dialect\statement\oracle\ddl\OracleDropIndexStatement.java,0,1,0,4,0,5
 shardingsphere-master\shardingsphere-master\shardingsphere-features\shardingsphere-sharding\shardingsphere-sharding-core\src\test\java\org\apache\shardingsphere\sharding\algorithm\sharding\mod\HashModShardingAlgorithmTest.java,0,21,0,9,0,30
 shardingsphere-master\shardingsphere-master\shardingsphere-infra\shardingsphere-infra-binder\src\main\java\org\apache\shardingsphere\infra\binder\statement\dml\UpdateStatementContext.java,0,14,0,8,0,22
 shardingsphere-master\shardingsphere-master\shardingsphere-features\shardingsphere-sharding\shardingsphere-sharding-core\src\test\java\org\apache\shardingsphere\sharding\merge\dql\orderby\OrderByValueTest.java,0,73,0,69,0,142
 shardingsphere-master\shardingsphere-master\shardingsphere-sql-parser\shardingsphere-sql-parser-statement\src\main\java\org\apache\shardingsphere\sql\parser\sql\dialect\statement\opengauss\dcl\OpenGaussCreateUserStatement.java,0,1,0,5,0,6
 shardingsphere-master\shardingsphere-master\shardingsphere-features\shardingsphere-sharding\shardingsphere-sharding-core\src\main\java\org\apache\shardingsphere\sharding\checker\ShardingRuleConfigurationChecker.java,0,6,0,4,0,10
 shardingsphere-master\shardingsphere-master\shardingsphere-test\shardingsphere-parser-test\src\main\java\org\apache\shardingsphere\test\sql\parser\parameterized\asserts\statement\dcl\impl\CreateUserStatementAssert.java,0,4,1,6,0,11
 shardingsphere-master\shardingsphere-master\shardingsphere-sql-parser\shardingsphere-sql-parser-dialect\shardingsphere-sql-parser-mysql\src\main\java\org\apache\shardingsphere\sql\parser\mysql\visitor\format\impl\MySQLRLFormatSQLVisitor.java,0,3,0,3,0,6
 shardingsphere-master\shardingsphere-master\shardingsphere-features\shardingsphere-shadow\shardingsphere-shadow-distsql\shardingsphere-shadow-distsql-handler\src\main\java\org\apache\shardingsphere\shadow\distsql\handler\update\AlterShadowAlgorithmStatementUpdater.java,0,28,0,24,0,52
 shardingsphere-master\shardingsphere-master\shardingsphere-features\shardingsphere-sharding\shardingsphere-sharding-distsql\shardingsphere-sharding-distsql-handler\src\main\java\org\apache\shardingsphere\scaling\distsql\handler\StopScalingSourceWritingUpdater.java,0,7,0,5,0,12
 shardingsphere-master\shardingsphere-master\shardingsphere-proxy\shardingsphere-proxy-frontend\shardingsphere-proxy-frontend-mysql\src\main\java\org\apache\shardingsphere\proxy\frontend\mysql\authentication\MySQLAuthenticationEngine.java,0,48,0,43,0,91
 shardingsphere-master\shardingsphere-master\shardingsphere-sql-parser\shardingsphere-sql-parser-statement\src\main\java\org\apache\shardingsphere\sql\parser\sql\dialect\statement\oracle\dcl\OracleRevokeStatement.java,0,1,0,4,0,5
 shardingsphere-master\shardingsphere-master\shardingsphere-kernel\shardingsphere-traffic\shardingsphere-traffic-core\src\main\java\org\apache\shardingsphere\traffic\yaml\config\YamlTrafficRuleConfiguration.java,0,12,0,6,0,18
 shardingsphere-master\shardingsphere-master\shardingsphere-features\shardingsphere-sharding\shardingsphere-sharding-core\src\main\java\org\apache\shardingsphere\sharding\route\engine\validator\dml\ShardingDMLStatementValidator.java,107,41,0,42,0,83
 shardingsphere-master\shardingsphere-master\shardingsphere-sql-parser\shardingsphere-sql-parser-statement\src\main\java\org\apache\shardingsphere\sql\parser\sql\dialect\statement\mysql\dal\MySQLShowBinaryLogsStatement.java,0,1,0,5,0,6
 shardingsphere-master\shardingsphere-master\examples\shardingsphere-jdbc-example\single-feature-example\extension-example\custom-sharding-algortihm-example\class-based-sharding-algorithm-example\class-based-sharding-spring-boot-mybatis-example\src\main\java\org\apache\shardingsphere\example\extension\classbased\sharding\spring\boot\mybatis\fixture\ClassBasedDatasourceStandardShardingAlgorithmFixture.java,0,17,0,11,0,28
 shardingsphere-master\shardingsphere-master\shardingsphere-kernel\shardingsphere-data-pipeline\shardingsphere-data-pipeline-dialect\shardingsphere-data-pipeline-mysql\src\test\java\org\apache\shardingsphere\data\pipeline\mysql\sqlbuilder\MySQLPipelineSQLBuilderTest.java,0,15,0,6,0,21
 shardingsphere-master\shardingsphere-master\shardingsphere-features\shardingsphere-shadow\shardingsphere-shadow-core\src\test\java\org\apache\shardingsphere\shadow\route\engine\impl\ShadowNonDMLStatementRoutingEngineTest.java,0,26,0,20,0,46
 shardingsphere-master\shardingsphere-master\shardingsphere-features\shardingsphere-readwrite-splitting\shardingsphere-readwrite-splitting-distsql\shardingsphere-readwrite-splitting-distsql-statement\src\main\java\org\apache\shardingsphere\readwritesplitting\distsql\parser\statement\ShowReadwriteSplittingReadResourcesStatement.java,0,4,0,5,0,9
 shardingsphere-master\shardingsphere-master\shardingsphere-test\shardingsphere-parser-test\src\main\java\org\apache\shardingsphere\test\sql\parser\parameterized\asserts\statement\distsql\rdl\create\impl\CreateDatabaseDiscoveryTypeStatementAssert.java,0,11,0,16,0,27
 shardingsphere-master\shardingsphere-master\shardingsphere-sql-parser\shardingsphere-sql-parser-statement\src\main\java\org\apache\shardingsphere\sql\parser\sql\dialect\statement\sqlserver\dml\SQLServerInsertStatement.java,0,7,0,7,1,15
 shardingsphere-master\shardingsphere-master\shardingsphere-sql-parser\shardingsphere-sql-parser-statement\src\main\java\org\apache\shardingsphere\sql\parser\sql\dialect\statement\opengauss\ddl\OpenGaussDropDomainStatement.java,0,1,0,5,0,6
 shardingsphere-master\shardingsphere-master\shardingsphere-features\shardingsphere-sharding\shardingsphere-sharding-core\src\main\java\org\apache\shardingsphere\sharding\rewrite\token\pojo\ConstraintToken.java,0,25,1,10,0,36
 shardingsphere-master\shardingsphere-master\shardingsphere-sql-parser\shardingsphere-sql-parser-statement\src\main\java\org\apache\shardingsphere\sql\parser\sql\common\segment\ddl\routine\ValidStatementSegment.java,90,24,0,18,0,42
 shardingsphere-master\shardingsphere-master\shardingsphere-sql-parser\shardingsphere-sql-parser-statement\src\main\java\org\apache\shardingsphere\sql\parser\sql\dialect\statement\mysql\ddl\MySQLAlterServerStatement.java,0,1,0,5,0,6
 shardingsphere-master\shardingsphere-master\examples\other-example\shardingsphere-parser-example\src\main\java\org\apache\shardingsphere\example\parser\mysql\format\MySQLParserFormatExample.java,0,36,1,10,0,47
 shardingsphere-master\shardingsphere-master\shardingsphere-infra\shardingsphere-infra-binder\src\main\java\org\apache\shardingsphere\infra\binder\segment\select\projection\impl\AggregationProjection.java,37,18,0,7,0,25
 shardingsphere-master\shardingsphere-master\shardingsphere-test\shardingsphere-parser-test\src\main\java\org\apache\shardingsphere\test\sql\parser\parameterized\jaxb\cases\domain\segment\impl\distsql\rdl\ExpectedDatabaseDiscoveryConstructionRule.java,0,9,0,4,0,13
 shardingsphere-master\shardingsphere-master\shardingsphere-sql-parser\shardingsphere-sql-parser-dialect\shardingsphere-sql-parser-mysql\src\main\java\org\apache\shardingsphere\sql\parser\mysql\visitor\statement\facade\MySQLStatementSQLVisitorFacade.java,0,9,0,7,0,16
 shardingsphere-master\shardingsphere-master\shardingsphere-proxy\shardingsphere-proxy-backend\src\test\java\org\apache\shardingsphere\proxy\backend\text\distsql\rdl\resource\AlterResourceBackendHandlerTest.java,0,52,1,30,0,83
 shardingsphere-master\shardingsphere-master\shardingsphere-test\shardingsphere-integration-test\shardingsphere-integration-test-suite\src\test\java\org\apache\shardingsphere\test\integration\framework\container\atomic\DockerITContainer.java,43,19,4,10,0,33
 shardingsphere-master\shardingsphere-master\shardingsphere-infra\shardingsphere-infra-common\src\test\java\org\apache\shardingsphere\infra\database\type\dialect\OracleDatabaseTypeTest.java,0,15,1,5,0,21
 shardingsphere-master\shardingsphere-master\shardingsphere-features\shardingsphere-encrypt\shardingsphere-encrypt-core\src\main\java\org\apache\shardingsphere\encrypt\rewrite\parameter\rewriter\EncryptInsertOnDuplicateKeyUpdateValueParameterRewriter.java,0,28,0,30,0,58
 shardingsphere-master\shardingsphere-master\shardingsphere-db-protocol\shardingsphere-db-protocol-mysql\src\main\java\org\apache\shardingsphere\db\protocol\mysql\packet\command\query\binary\execute\MySQLBinaryResultSetRowPacket.java,0,17,0,6,0,23
 shardingsphere-master\shardingsphere-master\shardingsphere-kernel\shardingsphere-transaction\shardingsphere-transaction-api\src\main\java\org\apache\shardingsphere\transaction\config\TransactionRuleConfiguration.java,0,9,0,2,0,11
 shardingsphere-master\shardingsphere-master\shardingsphere-infra\shardingsphere-infra-common\src\main\java\org\apache\shardingsphere\infra\rule\builder\global\GlobalRuleBuilder.java,0,4,0,3,0,7
 shardingsphere-master\shardingsphere-master\shardingsphere-proxy\shardingsphere-proxy-backend\src\main\java\org\apache\shardingsphere\proxy\backend\communication\jdbc\recognizer\impl\P6SpyDriverRecognizer.java,0,14,0,9,0,23
 shardingsphere-master\shardingsphere-master\shardingsphere-db-protocol\shardingsphere-db-protocol-postgresql\src\main\java\org\apache\shardingsphere\db\protocol\postgresql\packet\command\query\extended\close\PostgreSQLComClosePacket.java,0,17,1,7,0,25
 shardingsphere-master\shardingsphere-master\shardingsphere-infra\shardingsphere-infra-binder\src\main\java\org\apache\shardingsphere\infra\binder\statement\dal\OptimizeTableStatementContext.java,0,8,0,7,0,15
 shardingsphere-master\shardingsphere-master\shardingsphere-sql-parser\shardingsphere-sql-parser-engine\src\main\java\org\apache\shardingsphere\sql\parser\core\database\visitor\SQLVisitorFacadeRegistry.java,0,16,0,7,0,23
 shardingsphere-master\shardingsphere-master\shardingsphere-sql-parser\shardingsphere-sql-parser-statement\src\main\java\org\apache\shardingsphere\sql\parser\sql\common\segment\dal\ShowFilterSegment.java,0,10,0,2,0,12
 shardingsphere-master\shardingsphere-master\shardingsphere-db-protocol\shardingsphere-db-protocol-mysql\src\main\java\org\apache\shardingsphere\db\protocol\mysql\constant\MySQLCapabilityFlag.java,0,63,0,5,0,68
 shardingsphere-master\shardingsphere-master\shardingsphere-test\shardingsphere-parser-test\src\main\java\org\apache\shardingsphere\test\sql\parser\parameterized\jaxb\cases\domain\segment\impl\definition\ExpectedRenameDefinition.java,0,4,0,4,0,8
 shardingsphere-master\shardingsphere-master\shardingsphere-features\shardingsphere-sharding\shardingsphere-sharding-core\src\test\java\org\apache\shardingsphere\sharding\route\engine\condition\value\ListShardingConditionValueTest.java,0,10,0,3,0,13
 shardingsphere-master\shardingsphere-master\shardingsphere-mode\shardingsphere-mode-type\shardingsphere-cluster-mode\shardingsphere-cluster-mode-core\src\main\java\org\apache\shardingsphere\mode\manager\cluster\coordinator\registry\status\storage\node\StorageStatusNode.java,0,17,0,10,0,27
 shardingsphere-master\shardingsphere-master\shardingsphere-sql-parser\shardingsphere-sql-parser-statement\src\main\java\org\apache\shardingsphere\sql\parser\sql\dialect\statement\mysql\dal\MySQLShowCreateUserStatement.java,0,2,0,5,0,7
 shardingsphere-master\shardingsphere-master\shardingsphere-test\shardingsphere-parser-test\src\main\java\org\apache\shardingsphere\test\sql\parser\parameterized\jaxb\cases\domain\statement\dcl\DropRoleStatementTestCase.java,0,0,0,3,0,3
 shardingsphere-master\shardingsphere-master\shardingsphere-features\shardingsphere-shadow\shardingsphere-shadow-distsql\shardingsphere-shadow-distsql-statement\src\main\java\org\apache\shardingsphere\shadow\distsql\parser\statement\DropShadowRuleStatement.java,0,5,0,3,0,8
 shardingsphere-master\shardingsphere-master\shardingsphere-test\shardingsphere-pipeline-test\src\test\java\org\apache\shardingsphere\data\pipeline\core\fixture\FixtureIncrementalDumper.java,0,7,2,10,0,19
 shardingsphere-master\shardingsphere-master\shardingsphere-distsql\shardingsphere-distsql-parser\src\main\java\org\apache\shardingsphere\distsql\parser\core\advanced\AdvancedDistSQLLexer.java,0,4,0,3,0,7
 shardingsphere-master\shardingsphere-master\shardingsphere-sql-parser\shardingsphere-sql-parser-statement\src\main\java\org\apache\shardingsphere\sql\parser\sql\common\segment\ddl\column\position\ColumnPositionSegment.java,0,8,0,4,2,14
 shardingsphere-master\shardingsphere-master\shardingsphere-kernel\shardingsphere-data-pipeline\shardingsphere-data-pipeline-dialect\shardingsphere-data-pipeline-opengauss\src\main\java\org\apache\shardingsphere\data\pipeline\opengauss\OpenGaussEnvironmentChecker.java,0,2,0,2,0,4
 shardingsphere-master\shardingsphere-master\shardingsphere-features\shardingsphere-sharding\shardingsphere-sharding-distsql\shardingsphere-sharding-distsql-handler\src\main\java\org\apache\shardingsphere\sharding\distsql\handler\query\ShardingBroadcastTableRuleQueryResultSet.java,0,12,0,7,0,19
 shardingsphere-master\shardingsphere-master\shardingsphere-sql-parser\shardingsphere-sql-parser-dialect\shardingsphere-sql-parser-oracle\src\main\java\org\apache\shardingsphere\sql\parser\oracle\visitor\statement\impl\OracleTCLStatementSQLVisitor.java,0,9,0,16,0,25
 shardingsphere-master\shardingsphere-master\shardingsphere-kernel\shardingsphere-traffic\shardingsphere-traffic-core\src\main\java\org\apache\shardingsphere\traffic\algorithm\traffic\segment\SQLRegexTrafficAlgorithm.java,0,10,0,4,0,14
 shardingsphere-master\shardingsphere-master\shardingsphere-db-protocol\shardingsphere-db-protocol-postgresql\src\test\java\org\apache\shardingsphere\db\protocol\postgresql\packet\command\query\extended\bind\protocol\PostgreSQLFloat4ArrayBinaryProtocolValueTest.java,0,13,0,5,0,18
 shardingsphere-master\shardingsphere-master\shardingsphere-sql-parser\shardingsphere-sql-parser-statement\src\main\java\org\apache\shardingsphere\sql\parser\sql\dialect\statement\oracle\ddl\OracleCreateTableStatement.java,0,1,0,4,0,5
 shardingsphere-master\shardingsphere-master\shardingsphere-infra\shardingsphere-infra-rewrite\src\test\java\org\apache\shardingsphere\infra\rewrite\sql\token\pojo\generic\InsertColumnsTokenTest.java,0,6,0,3,0,9
 shardingsphere-master\shardingsphere-master\shardingsphere-agent\shardingsphere-agent-plugins\shardingsphere-agent-plugin-tracing\shardingsphere-agent-tracing-opentracing\src\test\java\org\apache\shardingsphere\agent\plugin\tracing\opentracing\advice\MockAdviceTargetObject.java,0,4,0,1,0,5
 shardingsphere-master\shardingsphere-master\shardingsphere-proxy\shardingsphere-proxy-backend\src\main\java\org\apache\shardingsphere\proxy\backend\text\admin\mysql\executor\ShowProcessListExecutor.java,0,41,0,31,0,72
 shardingsphere-master\shardingsphere-master\shardingsphere-infra\shardingsphere-infra-common\src\main\java\org\apache\shardingsphere\infra\yaml\engine\representer\processor\ShardingSphereYamlTupleProcessor.java,0,2,0,1,0,3
 shardingsphere-master\shardingsphere-master\shardingsphere-test\shardingsphere-parser-test\src\main\java\org\apache\shardingsphere\test\sql\parser\parameterized\jaxb\cases\domain\statement\distsql\ral\ShowVariableStatementTestCase.java,0,2,0,3,0,5
 shardingsphere-master\shardingsphere-master\shardingsphere-features\shardingsphere-encrypt\shardingsphere-encrypt-spring\shardingsphere-encrypt-spring-boot-starter\src\test\java\org\apache\shardingsphere\encrypt\spring\boot\EncryptSpringBootStarterTest.java,51,21,0,16,0,37
 shardingsphere-master\shardingsphere-master\shardingsphere-sql-parser\shardingsphere-sql-parser-dialect\shardingsphere-sql-parser-mysql\src\main\java\org\apache\shardingsphere\sql\parser\mysql\visitor\statement\impl\MySQLTCLStatementSQLVisitor.java,0,27,1,42,0,70
 shardingsphere-master\shardingsphere-master\shardingsphere-kernel\shardingsphere-parser\shardingsphere-parser-core\src\main\java\org\apache\shardingsphere\parser\constant\SQLParserOrder.java,0,2,0,1,0,3
 shardingsphere-master\shardingsphere-master\shardingsphere-infra\shardingsphere-infra-rewrite\src\test\java\org\apache\shardingsphere\infra\rewrite\context\SQLRewriteContextTest.java,0,45,0,27,0,72
 shardingsphere-master\shardingsphere-master\shardingsphere-proxy\shardingsphere-proxy-backend\src\main\java\org\apache\shardingsphere\proxy\backend\config\yaml\YamlProxyDataSourceConfiguration.java,0,22,0,2,0,24
 shardingsphere-master\shardingsphere-master\shardingsphere-kernel\shardingsphere-data-pipeline\shardingsphere-data-pipeline-core\src\main\java\org\apache\shardingsphere\data\pipeline\core\importer\DataRecordMerger.java,0,31,2,25,0,58
 shardingsphere-master\shardingsphere-master\shardingsphere-kernel\shardingsphere-traffic\shardingsphere-traffic-core\src\main\java\org\apache\shardingsphere\traffic\yaml\config\YamlTrafficStrategyConfiguration.java,0,9,0,2,0,11
 shardingsphere-master\shardingsphere-master\shardingsphere-proxy\shardingsphere-proxy-backend\src\main\java\org\apache\shardingsphere\proxy\backend\text\skip\SkipBackendHandler.java,0,4,0,2,0,6
 shardingsphere-master\shardingsphere-master\shardingsphere-sql-parser\shardingsphere-sql-parser-statement\src\main\java\org\apache\shardingsphere\sql\parser\sql\common\segment\dml\order\item\TextOrderByItemSegment.java,14,4,0,2,0,6
 shardingsphere-master\shardingsphere-master\shardingsphere-test\shardingsphere-integration-test\shardingsphere-integration-test-suite\src\test\java\org\apache\shardingsphere\test\integration\framework\database\impl\PostgreSQLDatabaseAssertionMetaData.java,0,7,0,7,0,14
 shardingsphere-master\shardingsphere-master\shardingsphere-features\shardingsphere-encrypt\shardingsphere-encrypt-core\src\main\java\org\apache\shardingsphere\encrypt\yaml\swapper\EncryptRuleConfigurationYamlSwapper.java,0,34,0,32,0,66
 shardingsphere-master\shardingsphere-master\shardingsphere-test\shardingsphere-parser-test\src\main\java\org\apache\shardingsphere\test\sql\parser\parameterized\asserts\segment\index\IndexAssert.java,0,8,0,13,0,21
 shardingsphere-master\shardingsphere-master\shardingsphere-test\shardingsphere-parser-test\src\main\java\org\apache\shardingsphere\test\sql\parser\parameterized\jaxb\cases\domain\statement\distsql\rql\ShowSingleTableStatementTestCase.java,0,4,0,4,0,8
 shardingsphere-master\shardingsphere-master\shardingsphere-infra\shardingsphere-infra-executor\src\main\java\org\apache\shardingsphere\infra\executor\sql\process\spi\ExecuteProcessReporter.java,0,6,0,6,0,12
 shardingsphere-master\shardingsphere-master\shardingsphere-infra\shardingsphere-infra-rewrite\src\test\java\org\apache\shardingsphere\infra\rewrite\sql\token\pojo\generic\SubstitutableColumnNameTokenTest.java,0,8,0,6,0,14
 shardingsphere-master\shardingsphere-master\shardingsphere-kernel\shardingsphere-data-pipeline\shardingsphere-data-pipeline-dialect\shardingsphere-data-pipeline-postgresql\src\test\java\org\apache\shardingsphere\data\pipeline\postgresql\ingest\wal\WalPositionTest.java,0,10,0,5,0,15
 shardingsphere-master\shardingsphere-master\shardingsphere-kernel\shardingsphere-data-pipeline\shardingsphere-data-pipeline-dialect\shardingsphere-data-pipeline-opengauss\src\test\java\org\apache\shardingsphere\data\pipeline\opengauss\OpenGaussScalingEntryTest.java,0,6,0,7,0,13
 shardingsphere-master\shardingsphere-master\shardingsphere-test\shardingsphere-parser-test\src\main\java\org\apache\shardingsphere\test\sql\parser\parameterized\asserts\statement\distsql\rdl\drop\impl\DropShardingScalingRuleStatementAssert.java,0,9,0,11,0,20
 shardingsphere-master\shardingsphere-master\shardingsphere-db-protocol\shardingsphere-db-protocol-mysql\src\main\java\org\apache\shardingsphere\db\protocol\mysql\packet\command\query\binary\prepare\MySQLComStmtPrepareOKPacket.java,0,17,0,4,0,21
 shardingsphere-master\shardingsphere-master\shardingsphere-proxy\shardingsphere-proxy-backend\src\main\java\org\apache\shardingsphere\proxy\backend\text\admin\mysql\executor\ShowCurrentDatabaseExecutor.java,0,10,0,9,0,19
 shardingsphere-master\shardingsphere-master\shardingsphere-sql-parser\shardingsphere-sql-parser-statement\src\main\java\org\apache\shardingsphere\sql\parser\sql\dialect\statement\postgresql\ddl\PostgreSQLDropDatabaseStatement.java,0,1,0,5,0,6
 shardingsphere-master\shardingsphere-master\shardingsphere-kernel\shardingsphere-transaction\shardingsphere-transaction-type\shardingsphere-transaction-xa\shardingsphere-transaction-xa-core\src\main\java\org\apache\shardingsphere\transaction\xa\jta\connection\dialect\MariaDBXAConnectionWrapper.java,0,15,3,5,0,23
 shardingsphere-master\shardingsphere-master\shardingsphere-infra\shardingsphere-infra-common\src\main\java\org\apache\shardingsphere\infra\metadata\schema\builder\TableMetaDataBuilder.java,0,15,0,13,0,28
 shardingsphere-master\shardingsphere-master\shardingsphere-mode\shardingsphere-mode-type\shardingsphere-cluster-mode\shardingsphere-cluster-mode-core\src\main\java\org\apache\shardingsphere\mode\manager\cluster\coordinator\registry\status\storage\subscriber\StorageNodeStatusSubscriber.java,0,11,0,8,0,19
 shardingsphere-master\shardingsphere-master\shardingsphere-test\shardingsphere-integration-test\shardingsphere-integration-test-suite\src\test\java\org\apache\shardingsphere\test\integration\engine\dcl\BaseDCLIT.java,20,10,0,5,0,15
 shardingsphere-master\shardingsphere-master\shardingsphere-proxy\shardingsphere-proxy-frontend\shardingsphere-proxy-frontend-mysql\src\test\java\org\apache\shardingsphere\proxy\frontend\mysql\command\query\binary\reset\MySQLComStmtResetExecutorTest.java,0,7,0,5,0,12
 shardingsphere-master\shardingsphere-master\shardingsphere-test\shardingsphere-parser-test\src\main\java\org\apache\shardingsphere\test\sql\parser\parameterized\asserts\statement\ddl\impl\AlterSessionStatementAssert.java,0,3,1,6,0,10
 shardingsphere-master\shardingsphere-master\shardingsphere-test\shardingsphere-parser-test\src\main\java\org\apache\shardingsphere\test\sql\parser\parameterized\asserts\statement\ddl\impl\FlashbackTableStatementAssert.java,0,9,0,11,0,20
 shardingsphere-master\shardingsphere-master\shardingsphere-infra\shardingsphere-infra-common\src\test\java\org\apache\shardingsphere\infra\database\metadata\dialect\PostgreSQLDataSourceMetaDataTest.java,0,11,2,5,0,18
 shardingsphere-master\shardingsphere-master\shardingsphere-test\shardingsphere-rewrite-test\src\test\java\org\apache\shardingsphere\sharding\rewrite\parameterized\entity\RewriteOutputEntity.java,0,4,0,1,0,5
 shardingsphere-master\shardingsphere-master\shardingsphere-kernel\shardingsphere-data-pipeline\shardingsphere-data-pipeline-dialect\shardingsphere-data-pipeline-mysql\src\main\java\org\apache\shardingsphere\data\pipeline\mysql\ingest\MySQLPositionInitializer.java,0,11,0,9,0,20
 shardingsphere-master\shardingsphere-master\shardingsphere-sql-parser\shardingsphere-sql-parser-statement\src\main\java\org\apache\shardingsphere\sql\parser\sql\dialect\statement\mysql\segment\UserSegment.java,0,30,0,2,2,34
 shardingsphere-master\shardingsphere-master\shardingsphere-kernel\shardingsphere-transaction\shardingsphere-transaction-core\src\test\java\org\apache\shardingsphere\transaction\core\fixture\OtherShardingSphereTransactionManagerFixture.java,0,10,6,4,0,20
 shardingsphere-master\shardingsphere-master\shardingsphere-infra\shardingsphere-infra-common\src\main\java\org\apache\shardingsphere\infra\exception\ImportSchemaNotExistedException.java,0,6,0,2,0,8
 shardingsphere-master\shardingsphere-master\shardingsphere-test\shardingsphere-pipeline-test\src\test\java\org\apache\shardingsphere\data\pipeline\core\fixture\FixtureJobCompletionDetectAlgorithm.java,0,4,1,3,0,8
 shardingsphere-master\shardingsphere-master\shardingsphere-sql-parser\shardingsphere-sql-parser-dialect\shardingsphere-sql-parser-postgresql\src\main\java\org\apache\shardingsphere\sql\parser\postgresql\visitor\format\facade\PostgreSQLFormatSQLVisitorFacade.java,0,10,0,2,0,12
 shardingsphere-master\shardingsphere-master\shardingsphere-sql-parser\shardingsphere-sql-parser-statement\src\main\java\org\apache\shardingsphere\sql\parser\sql\dialect\statement\postgresql\ddl\PostgreSQLAlterIndexStatement.java,0,4,0,6,1,11
 shardingsphere-master\shardingsphere-master\shardingsphere-kernel\shardingsphere-data-pipeline\shardingsphere-data-pipeline-core\src\main\java\org\apache\shardingsphere\data\pipeline\core\prepare\datasource\AbstractDataSourcePreparer.java,64,33,0,23,0,56
 shardingsphere-master\shardingsphere-master\shardingsphere-test\shardingsphere-parser-test\src\main\java\org\apache\shardingsphere\test\sql\parser\parameterized\jaxb\cases\domain\segment\impl\projection\impl\top\ExpectedTopProjection.java,0,6,0,5,0,11
 shardingsphere-master\shardingsphere-master\shardingsphere-test\shardingsphere-integration-agent-test\shardingsphere-integration-agent-test-plugins\shardingsphere-integration-agent-test-opentelemetry\src\test\java\org\apache\shardingsphere\integration\agent\test\opentelemetry\OpenTelemetryPluginIT.java,0,17,1,8,0,26
 shardingsphere-master\shardingsphere-master\shardingsphere-kernel\shardingsphere-transaction\shardingsphere-transaction-type\shardingsphere-transaction-xa\shardingsphere-transaction-xa-core\src\test\java\org\apache\shardingsphere\transaction\xa\jta\connection\dialect\PostgreSQLXAConnectionWrapperTest.java,0,10,0,7,0,17
 shardingsphere-master\shardingsphere-master\shardingsphere-features\shardingsphere-encrypt\shardingsphere-encrypt-spring\shardingsphere-encrypt-spring-namespace\src\main\java\org\apache\shardingsphere\encrypt\spring\namespace\tag\EncryptRuleBeanDefinitionTag.java,0,22,0,4,0,26
 shardingsphere-master\shardingsphere-master\examples\shardingsphere-jdbc-example\single-feature-example\sharding-example\sharding-raw-jdbc-example\src\main\java\org\apache\shardingsphere\example\sharding\raw\jdbc\ShardingRawYamlRangeConfigurationExample.java,0,9,1,6,0,16
 shardingsphere-master\shardingsphere-master\shardingsphere-infra\shardingsphere-infra-common\src\main\java\org\apache\shardingsphere\infra\config\algorithm\ShardingSphereAlgorithmPropertiesAware.java,0,2,0,1,0,3
 shardingsphere-master\shardingsphere-master\shardingsphere-infra\shardingsphere-infra-executor\src\main\java\org\apache\shardingsphere\infra\executor\sql\execute\engine\driver\vertx\VertxExecutionUnit.java,0,8,0,5,0,13
 shardingsphere-master\shardingsphere-master\shardingsphere-test\shardingsphere-parser-test\src\main\java\org\apache\shardingsphere\test\sql\parser\parameterized\asserts\statement\dal\DALStatementAssert.java,0,55,0,206,0,261
 shardingsphere-master\shardingsphere-master\shardingsphere-test\shardingsphere-integration-test\shardingsphere-integration-test-suite\src\test\java\org\apache\shardingsphere\test\integration\engine\dal\BaseDALIT.java,70,21,2,15,0,38
 shardingsphere-master\shardingsphere-master\shardingsphere-features\shardingsphere-sharding\shardingsphere-sharding-core\src\main\java\org\apache\shardingsphere\sharding\rewrite\token\generator\impl\ShardingInsertValuesTokenGenerator.java,0,17,1,21,0,39
 shardingsphere-master\shardingsphere-master\shardingsphere-kernel\shardingsphere-data-pipeline\shardingsphere-data-pipeline-dialect\shardingsphere-data-pipeline-postgresql\src\main\java\org\apache\shardingsphere\data\pipeline\postgresql\ingest\wal\decode\PostgreSQLTimestampUtils.java,0,4,0,3,0,7
 shardingsphere-master\shardingsphere-master\shardingsphere-db-protocol\shardingsphere-db-protocol-postgresql\src\test\java\org\apache\shardingsphere\db\protocol\postgresql\packet\command\query\extended\bind\protocol\PostgreSQLTimeBinaryProtocolValueTest.java,0,8,0,5,0,13
 shardingsphere-master\shardingsphere-master\shardingsphere-sql-parser\shardingsphere-sql-parser-statement\src\main\java\org\apache\shardingsphere\sql\parser\sql\common\segment\dml\expr\BinaryOperationExpression.java,0,12,0,1,0,13
 shardingsphere-master\shardingsphere-master\shardingsphere-mode\shardingsphere-mode-type\shardingsphere-cluster-mode\shardingsphere-cluster-mode-repository\shardingsphere-cluster-mode-repository-api\src\main\java\org\apache\shardingsphere\mode\repository\cluster\ClusterPersistRepositoryException.java,0,3,0,1,0,4
 shardingsphere-master\shardingsphere-master\shardingsphere-infra\shardingsphere-infra-federation\shardingsphere-infra-federation-optimizer\src\main\java\org\apache\shardingsphere\infra\federation\optimizer\converter\SQLNodeConverterEngine.java,0,26,1,18,0,45
 shardingsphere-master\shardingsphere-master\shardingsphere-features\shardingsphere-encrypt\shardingsphere-encrypt-core\src\test\java\org\apache\shardingsphere\encrypt\algorithm\RC4EncryptAlgorithmTest.java,0,22,0,7,0,29
 shardingsphere-master\shardingsphere-master\shardingsphere-features\shardingsphere-shadow\shardingsphere-shadow-distsql\shardingsphere-shadow-distsql-handler\src\test\java\org\apache\shardingsphere\shadow\distsql\update\DropDefaultShadowAlgorithmStatementUpdaterTest.java,0,18,0,10,0,28
 shardingsphere-master\shardingsphere-master\shardingsphere-infra\shardingsphere-infra-common\src\test\java\org\apache\shardingsphere\infra\metadata\schema\builder\SystemSchemaBuilderRuleTest.java,0,13,0,8,0,21
 shardingsphere-master\shardingsphere-master\shardingsphere-agent\shardingsphere-agent-plugins\shardingsphere-agent-plugin-tracing\shardingsphere-agent-tracing-test\src\main\java\org\apache\shardingsphere\agent\plugin\tracing\MockDataSourceMetaData.java,0,7,0,1,0,8
 shardingsphere-master\shardingsphere-master\shardingsphere-test\shardingsphere-parser-test\src\main\java\org\apache\shardingsphere\test\sql\parser\parameterized\jaxb\cases\domain\statement\distsql\rdl\create\CreateShardingBindingTableRulesStatementTestCase.java,0,4,0,6,0,10
 shardingsphere-master\shardingsphere-master\shardingsphere-jdbc\shardingsphere-jdbc-spring\shardingsphere-jdbc-spring-infra\shardingsphere-jdbc-spring-boot-starter-infra\src\main\java\org\apache\shardingsphere\spring\boot\datasource\DataSourceMapSetter.java,0,27,0,13,0,40
 shardingsphere-master\shardingsphere-master\shardingsphere-agent\shardingsphere-agent-plugins\shardingsphere-agent-plugin-metrics\shardingsphere-agent-metrics-prometheus\src\main\java\org\apache\shardingsphere\agent\metrics\prometheus\collector\BuildInfoCollector.java,0,14,0,9,0,23
 shardingsphere-master\shardingsphere-master\shardingsphere-sql-parser\shardingsphere-sql-parser-statement\src\main\java\org\apache\shardingsphere\sql\parser\sql\dialect\statement\oracle\ddl\OracleDropDimensionStatement.java,0,1,0,5,0,6
 shardingsphere-master\shardingsphere-master\shardingsphere-agent\shardingsphere-agent-core\src\main\java\org\apache\shardingsphere\agent\core\plugin\PluginBootServiceManager.java,0,9,3,8,0,20
 shardingsphere-master\shardingsphere-master\shardingsphere-infra\shardingsphere-infra-rewrite\src\main\java\org\apache\shardingsphere\infra\rewrite\sql\token\generator\aware\SchemaMetaDataAware.java,0,2,0,1,0,3
 shardingsphere-master\shardingsphere-master\shardingsphere-features\shardingsphere-shadow\shardingsphere-shadow-core\src\test\java\org\apache\shardingsphere\shadow\rule\builder\ShadowRuleBuilderTest.java,0,6,0,3,0,9
 shardingsphere-master\shardingsphere-master\shardingsphere-features\shardingsphere-shadow\shardingsphere-shadow-spring\shardingsphere-shadow-spring-boot-starter\src\main\java\org\apache\shardingsphere\shadow\spring\boot\rule\YamlShadowRuleSpringBootConfiguration.java,0,3,0,1,0,4
 shardingsphere-master\shardingsphere-master\shardingsphere-infra\shardingsphere-infra-common\src\main\java\org\apache\shardingsphere\infra\eventbus\ShardingSphereEventBus.java,0,5,0,1,0,6
 shardingsphere-master\shardingsphere-master\shardingsphere-distsql\shardingsphere-distsql-statement\src\main\java\org\apache\shardingsphere\distsql\parser\statement\rdl\create\CreateRuleStatement.java,3,0,1,2,0,3
 shardingsphere-master\shardingsphere-master\shardingsphere-sql-parser\shardingsphere-sql-parser-statement\src\main\java\org\apache\shardingsphere\sql\parser\sql\dialect\statement\mysql\dcl\MySQLAlterUserStatement.java,0,2,0,4,0,6
 shardingsphere-master\shardingsphere-master\shardingsphere-sql-parser\shardingsphere-sql-parser-statement\src\main\java\org\apache\shardingsphere\sql\parser\sql\dialect\statement\opengauss\ddl\OpenGaussDeallocateStatement.java,0,1,0,5,0,6
 shardingsphere-master\shardingsphere-master\shardingsphere-infra\shardingsphere-infra-executor\src\main\java\org\apache\shardingsphere\infra\executor\sql\execute\engine\driver\vertx\VertxExecutor.java,0,5,0,6,0,11
 shardingsphere-master\shardingsphere-master\shardingsphere-test\shardingsphere-parser-test\src\main\java\org\apache\shardingsphere\test\sql\parser\parameterized\jaxb\cases\domain\statement\dcl\CreateRoleStatementTestCase.java,0,0,0,3,0,3
 shardingsphere-master\shardingsphere-master\shardingsphere-test\shardingsphere-parser-test\src\main\java\org\apache\shardingsphere\test\sql\parser\parameterized\asserts\statement\distsql\ral\impl\common\updatable\UnlabelInstanceStatementAssert.java,0,5,0,8,0,13
 shardingsphere-master\shardingsphere-master\shardingsphere-test\shardingsphere-parser-test\src\main\java\org\apache\shardingsphere\test\sql\parser\parameterized\asserts\segment\distsql\PropertyAssert.java,0,6,0,8,0,14
 shardingsphere-master\shardingsphere-master\shardingsphere-features\shardingsphere-sharding\shardingsphere-sharding-core\src\main\java\org\apache\shardingsphere\sharding\rewrite\context\ShardingSQLRewriteContextDecorator.java,0,13,0,12,0,25
 shardingsphere-master\shardingsphere-master\shardingsphere-kernel\shardingsphere-data-pipeline\shardingsphere-data-pipeline-core\src\main\java\org\apache\shardingsphere\data\pipeline\core\check\consistency\DataConsistencyCheckerImpl.java,0,88,0,78,0,166
 shardingsphere-master\shardingsphere-master\shardingsphere-features\shardingsphere-sharding\shardingsphere-sharding-core\src\test\java\org\apache\shardingsphere\sharding\algorithm\sharding\cosid\PropertiesUtilTest.java,0,4,0,1,0,5
 shardingsphere-master\shardingsphere-master\shardingsphere-infra\shardingsphere-infra-parser\src\main\java\org\apache\shardingsphere\infra\parser\ShardingSphereSQLParserEngine.java,0,13,0,9,0,22
 shardingsphere-master\shardingsphere-master\shardingsphere-db-protocol\shardingsphere-db-protocol-mysql\src\main\java\org\apache\shardingsphere\db\protocol\mysql\constant\MySQLStatusFlag.java,0,34,0,3,0,37
 shardingsphere-master\shardingsphere-master\shardingsphere-sql-parser\shardingsphere-sql-parser-statement\src\main\java\org\apache\shardingsphere\sql\parser\sql\dialect\statement\oracle\ddl\OracleDropDatabaseLinkStatement.java,0,1,0,5,0,6
 shardingsphere-master\shardingsphere-master\shardingsphere-test\shardingsphere-integration-test\shardingsphere-integration-test-suite\src\test\java\org\apache\shardingsphere\test\integration\engine\dql\AdditionalDQLIT.java,0,104,0,89,0,193
 shardingsphere-master\shardingsphere-master\shardingsphere-proxy\shardingsphere-proxy-backend\src\main\java\org\apache\shardingsphere\proxy\backend\text\distsql\rdl\rule\DropDefaultSingleTableRuleStatementUpdater.java,0,16,0,14,0,30
 shardingsphere-master\shardingsphere-master\shardingsphere-proxy\shardingsphere-proxy-frontend\shardingsphere-proxy-frontend-postgresql\src\main\java\org\apache\shardingsphere\proxy\frontend\postgresql\command\query\extended\PostgreSQLAggregatedCommandExecutor.java,0,5,0,6,0,11
 shardingsphere-master\shardingsphere-master\shardingsphere-sql-parser\shardingsphere-sql-parser-statement\src\main\java\org\apache\shardingsphere\sql\parser\sql\dialect\statement\oracle\ddl\OracleDropTableStatement.java,0,1,0,4,0,5
 shardingsphere-master\shardingsphere-master\shardingsphere-sql-parser\shardingsphere-sql-parser-dialect\shardingsphere-sql-parser-sql92\src\main\java\org\apache\shardingsphere\sql\parser\sql92\parser\SQL92Parser.java,0,5,0,3,0,8
 shardingsphere-master\shardingsphere-master\shardingsphere-proxy\shardingsphere-proxy-backend\src\main\java\org\apache\shardingsphere\proxy\backend\exception\TableLockWaitTimeoutException.java,0,7,0,1,0,8
 shardingsphere-master\shardingsphere-master\shardingsphere-agent\shardingsphere-agent-plugins\shardingsphere-agent-plugin-tracing\shardingsphere-agent-tracing-jaeger\src\test\java\org\apache\shardingsphere\agent\plugin\tracing\jaeger\advice\CommandExecutorTaskAdviceTest.java,0,22,0,13,0,35
 shardingsphere-master\shardingsphere-master\shardingsphere-test\shardingsphere-parser-test\src\main\java\org\apache\shardingsphere\test\sql\parser\parameterized\jaxb\cases\domain\statement\CommonStatementTestCase.java,0,5,0,3,0,8
 shardingsphere-master\shardingsphere-master\shardingsphere-kernel\shardingsphere-data-pipeline\shardingsphere-data-pipeline-spi\src\main\java\org\apache\shardingsphere\data\pipeline\spi\check\consistency\SingleTableDataCalculator.java,0,6,0,2,0,8
 shardingsphere-master\shardingsphere-master\shardingsphere-test\shardingsphere-parser-test\src\main\java\org\apache\shardingsphere\test\sql\parser\parameterized\asserts\statement\dal\impl\ShowRelaylogEventsStatementAssert.java,0,6,0,9,0,15
 shardingsphere-master\shardingsphere-master\shardingsphere-kernel\shardingsphere-data-pipeline\shardingsphere-data-pipeline-spi\src\main\java\org\apache\shardingsphere\data\pipeline\api\prepare\datasource\ActualTableDefinition.java,0,7,0,2,0,9
 shardingsphere-master\shardingsphere-master\shardingsphere-infra\shardingsphere-infra-binder\src\main\java\org\apache\shardingsphere\infra\binder\segment\insert\values\OnDuplicateUpdateContext.java,0,30,0,20,0,50
 shardingsphere-master\shardingsphere-master\shardingsphere-features\shardingsphere-sharding\shardingsphere-sharding-distsql\shardingsphere-sharding-distsql-handler\src\main\java\org\apache\shardingsphere\scaling\distsql\handler\DisableShardingScalingRuleStatementUpdater.java,0,20,0,17,0,37
 shardingsphere-master\shardingsphere-master\shardingsphere-distsql\shardingsphere-distsql-statement\src\main\java\org\apache\shardingsphere\distsql\parser\statement\rdl\ResourceDefinitionStatement.java,3,0,1,1,0,2
 shardingsphere-master\shardingsphere-master\shardingsphere-features\shardingsphere-db-discovery\shardingsphere-db-discovery-api\src\main\java\org\apache\shardingsphere\dbdiscovery\api\config\DatabaseDiscoveryRuleConfiguration.java,0,11,0,9,0,20
 shardingsphere-master\shardingsphere-master\shardingsphere-infra\shardingsphere-infra-common\src\main\java\org\apache\shardingsphere\infra\datasource\pool\metadata\type\DefaultDataSourcePoolFieldMetaData.java,0,6,0,3,0,9
 shardingsphere-master\shardingsphere-master\shardingsphere-sql-parser\shardingsphere-sql-parser-statement\src\main\java\org\apache\shardingsphere\sql\parser\sql\dialect\statement\postgresql\ddl\PostgreSQLDeclareStatement.java,0,1,0,5,0,6
 shardingsphere-master\shardingsphere-master\shardingsphere-features\shardingsphere-shadow\shardingsphere-shadow-core\src\test\java\org\apache\shardingsphere\shadow\route\ShadowSQLRouterTest.java,0,28,2,15,0,45
 shardingsphere-master\shardingsphere-master\shardingsphere-jdbc\shardingsphere-jdbc-core\src\main\java\org\apache\shardingsphere\driver\jdbc\core\connection\ConnectionManager.java,0,119,8,80,0,207
 shardingsphere-master\shardingsphere-master\shardingsphere-mode\shardingsphere-mode-type\shardingsphere-cluster-mode\shardingsphere-cluster-mode-core\src\main\java\org\apache\shardingsphere\mode\manager\cluster\coordinator\registry\cache\subscriber\ScalingRegistrySubscriber.java,0,25,1,23,0,49
 shardingsphere-master\shardingsphere-master\shardingsphere-features\shardingsphere-db-discovery\shardingsphere-db-discovery-core\src\main\java\org\apache\shardingsphere\dbdiscovery\rule\DatabaseDiscoveryDataSourceRule.java,0,28,0,8,0,36
 shardingsphere-master\shardingsphere-master\shardingsphere-features\shardingsphere-shadow\shardingsphere-shadow-spring\shardingsphere-shadow-spring-namespace\src\test\java\org\apache\shardingsphere\shadow\spring\namespace\ShadowDefaultAlgorithmSpringNamespaceTest.java,0,20,0,17,0,37
 shardingsphere-master\shardingsphere-master\shardingsphere-kernel\shardingsphere-data-pipeline\shardingsphere-data-pipeline-spi\src\main\java\org\apache\shardingsphere\data\pipeline\api\executor\LifecycleExecutor.java,0,2,0,1,0,3
 shardingsphere-master\shardingsphere-master\shardingsphere-kernel\shardingsphere-transaction\shardingsphere-transaction-type\shardingsphere-transaction-xa\shardingsphere-transaction-xa-provider\shardingsphere-transaction-xa-bitronix\src\test\java\org\apache\shardingsphere\transaction\xa\bitronix\manager\BitronixRecoveryResourceTest.java,0,21,0,5,0,26
 shardingsphere-master\shardingsphere-master\shardingsphere-features\shardingsphere-sharding\shardingsphere-sharding-distsql\shardingsphere-sharding-distsql-handler\src\test\java\org\apache\shardingsphere\sharding\distsql\update\AlterShardingBindingTableRulesStatementUpdaterTest.java,0,21,0,18,0,39
 shardingsphere-master\shardingsphere-master\shardingsphere-test\shardingsphere-parser-test\src\main\java\org\apache\shardingsphere\test\sql\parser\parameterized\jaxb\cases\domain\statement\distsql\rdl\drop\DropShardingBindingTableRulesStatementTestCase.java,0,3,0,4,0,7
 shardingsphere-master\shardingsphere-master\shardingsphere-features\shardingsphere-sharding\shardingsphere-sharding-core\src\main\java\org\apache\shardingsphere\sharding\algorithm\sharding\cosid\CosIdSnowflakeIntervalShardingAlgorithm.java,0,15,1,8,0,24
 shardingsphere-master\shardingsphere-master\shardingsphere-infra\shardingsphere-infra-common\src\main\java\org\apache\shardingsphere\infra\distsql\constant\ExportableConstants.java,0,24,0,7,0,31
 shardingsphere-master\shardingsphere-master\shardingsphere-test\shardingsphere-integration-test\shardingsphere-integration-test-suite\src\test\java\org\apache\shardingsphere\test\integration\cases\SQLCommandType.java,0,29,0,18,0,47
 shardingsphere-master\shardingsphere-master\shardingsphere-features\shardingsphere-sharding\shardingsphere-sharding-distsql\shardingsphere-sharding-distsql-statement\src\main\java\org\apache\shardingsphere\scaling\distsql\statement\ShowShardingScalingRulesStatement.java,0,3,0,4,0,7
 shardingsphere-master\shardingsphere-master\shardingsphere-test\shardingsphere-parser-test\src\main\java\org\apache\shardingsphere\test\sql\parser\parameterized\jaxb\cases\domain\statement\dcl\CreateUserStatementTestCase.java,0,0,0,3,0,3
 shardingsphere-master\shardingsphere-master\shardingsphere-test\shardingsphere-parser-test\src\main\java\org\apache\shardingsphere\test\sql\parser\parameterized\jaxb\cases\domain\segment\impl\distsql\rdl\ExpectedDefaultShardingStrategy.java,0,9,0,4,0,13
 shardingsphere-master\shardingsphere-master\shardingsphere-db-protocol\shardingsphere-db-protocol-postgresql\src\main\java\org\apache\shardingsphere\db\protocol\postgresql\packet\command\query\extended\close\PostgreSQLCloseCompletePacket.java,0,9,0,6,0,15
 shardingsphere-master\shardingsphere-master\shardingsphere-infra\shardingsphere-infra-common\src\test\java\org\apache\shardingsphere\infra\metadata\schema\fixture\rule\DataNodeContainedFixtureRule.java,0,21,0,10,0,31
 shardingsphere-master\shardingsphere-master\shardingsphere-test\shardingsphere-parser-test\src\main\java\org\apache\shardingsphere\test\sql\parser\parameterized\jaxb\cases\domain\statement\ddl\DropAggregateStatementTestCase.java,0,0,0,3,0,3
 shardingsphere-master\shardingsphere-master\shardingsphere-test\shardingsphere-integration-driver-test\src\test\java\org\apache\shardingsphere\driver\AbstractYamlDataSourceTest.java,40,10,0,3,0,13
 shardingsphere-master\shardingsphere-master\shardingsphere-infra\shardingsphere-infra-common\src\test\java\org\apache\shardingsphere\infra\database\type\DatabaseTypeRecognizerTest.java,0,38,1,27,0,66
 shardingsphere-master\shardingsphere-master\shardingsphere-sql-parser\shardingsphere-sql-parser-statement\src\main\java\org\apache\shardingsphere\sql\parser\sql\common\segment\generic\ParameterMarkerSegment.java,0,0,0,1,0,1
 shardingsphere-master\shardingsphere-master\shardingsphere-test\shardingsphere-parser-test\src\main\java\org\apache\shardingsphere\test\sql\parser\parameterized\jaxb\cases\domain\segment\impl\distsql\ExpectedSQLParserRule.java,0,5,0,4,0,9
 shardingsphere-master\shardingsphere-master\shardingsphere-features\shardingsphere-readwrite-splitting\shardingsphere-readwrite-splitting-core\src\main\java\org\apache\shardingsphere\readwritesplitting\algorithm\loadbalance\WeightReplicaLoadBalanceAlgorithm.java,0,23,1,12,0,36
 shardingsphere-master\shardingsphere-master\shardingsphere-sql-parser\shardingsphere-sql-parser-statement\src\main\java\org\apache\shardingsphere\sql\parser\sql\dialect\statement\sqlserver\dcl\SQLServerDropRoleStatement.java,0,1,0,5,0,6
 shardingsphere-master\shardingsphere-master\shardingsphere-infra\shardingsphere-infra-common\src\main\java\org\apache\shardingsphere\infra\rule\builder\global\GlobalRulesBuilder.java,0,20,0,15,0,35
 shardingsphere-master\shardingsphere-master\examples\shardingsphere-jdbc-example\single-feature-example\sharding-example\sharding-spring-boot-jpa-example\src\main\java\org\apache\shardingsphere\example\sharding\spring\boot\jpa\ShardingSpringBootJpaExample.java,9,6,1,4,0,11
 shardingsphere-master\shardingsphere-master\shardingsphere-sql-parser\shardingsphere-sql-parser-statement\src\main\java\org\apache\shardingsphere\sql\parser\sql\common\segment\dml\order\item\ColumnOrderByItemSegment.java,0,14,0,6,3,23
 shardingsphere-master\shardingsphere-master\shardingsphere-sql-parser\shardingsphere-sql-parser-statement\src\main\java\org\apache\shardingsphere\sql\parser\sql\dialect\statement\oracle\ddl\OracleCommentStatement.java,0,4,0,8,6,18
 shardingsphere-master\shardingsphere-master\shardingsphere-features\shardingsphere-sharding\shardingsphere-sharding-core\src\main\java\org\apache\shardingsphere\sharding\checker\AbstractShardingRuleConfigurationChecker.java,10,6,0,3,0,9
 shardingsphere-master\shardingsphere-master\shardingsphere-infra\shardingsphere-infra-executor\src\test\java\org\apache\shardingsphere\infra\executor\sql\execute\result\query\impl\driver\jdbc\type\memory\JDBCMemoryQueryResultTest.java,0,77,36,13,0,126
 shardingsphere-master\shardingsphere-master\shardingsphere-features\shardingsphere-db-discovery\shardingsphere-db-discovery-distsql\shardingsphere-db-discovery-distsql-statement\src\main\java\org\apache\shardingsphere\dbdiscovery\distsql\parser\segment\DatabaseDiscoveryHeartbeatSegment.java,0,4,0,1,0,5
 shardingsphere-master\shardingsphere-master\shardingsphere-test\shardingsphere-pipeline-test\src\test\java\org\apache\shardingsphere\data\pipeline\core\lock\PipelineSimpleLockTest.java,0,8,0,3,0,11
 shardingsphere-master\shardingsphere-master\shardingsphere-sql-parser\shardingsphere-sql-parser-statement\src\main\java\org\apache\shardingsphere\sql\parser\sql\common\segment\ddl\column\ColumnDefinitionSegment.java,0,22,0,7,7,36
 shardingsphere-master\shardingsphere-master\shardingsphere-sql-parser\shardingsphere-sql-parser-spi\src\main\java\org\apache\shardingsphere\sql\parser\api\visitor\type\TCLSQLVisitor.java,0,0,0,1,0,1
 shardingsphere-master\shardingsphere-master\shardingsphere-features\shardingsphere-sharding\shardingsphere-sharding-distsql\shardingsphere-sharding-distsql-handler\src\test\java\org\apache\shardingsphere\scaling\distsql\util\PipelineContextUtil.java,0,5,1,3,0,9
 shardingsphere-master\shardingsphere-master\shardingsphere-test\shardingsphere-parser-test\src\main\java\org\apache\shardingsphere\test\sql\parser\parameterized\jaxb\cases\domain\statement\distsql\ral\UnlabelInstanceStatementTestCase.java,0,6,0,3,0,9
 shardingsphere-master\shardingsphere-master\shardingsphere-db-protocol\shardingsphere-db-protocol-mysql\src\test\java\org\apache\shardingsphere\db\protocol\mysql\packet\binlog\row\column\value\time\MySQLTimeBinlogProtocolValueTest.java,0,18,0,6,0,24
 shardingsphere-master\shardingsphere-master\shardingsphere-test\shardingsphere-parser-test\src\main\java\org\apache\shardingsphere\test\sql\parser\parameterized\jaxb\cases\domain\segment\impl\insert\ExpectedInsertValue.java,0,3,0,5,0,8
 shardingsphere-master\shardingsphere-master\shardingsphere-sql-parser\shardingsphere-sql-parser-statement\src\main\java\org\apache\shardingsphere\sql\parser\sql\common\segment\dml\predicate\HavingSegment.java,0,6,0,2,0,8
 shardingsphere-master\shardingsphere-master\shardingsphere-agent\shardingsphere-agent-core\src\test\java\org\apache\shardingsphere\agent\core\bytebuddy\transformer\advice\ComposeClassStaticMethodAroundAdviceTest.java,0,19,0,7,0,26
 shardingsphere-master\shardingsphere-master\shardingsphere-db-protocol\shardingsphere-db-protocol-postgresql\src\test\java\org\apache\shardingsphere\db\protocol\postgresql\packet\command\query\extended\bind\PostgreSQLComBindPacketTest.java,0,12,0,11,0,23
 shardingsphere-master\shardingsphere-master\shardingsphere-features\shardingsphere-db-discovery\shardingsphere-db-discovery-provider\shardingsphere-db-discovery-mysql\src\main\java\org\apache\shardingsphere\dbdiscovery\mysql\type\MGRDatabaseDiscoveryType.java,0,65,1,41,0,107
 shardingsphere-master\shardingsphere-master\shardingsphere-sql-parser\shardingsphere-sql-parser-dialect\shardingsphere-sql-parser-postgresql\src\test\java\org\apache\shardingsphere\sql\parser\postgresql\UnsupportedPostgreSQLParserParameterizedTest.java,0,7,0,6,0,13
 shardingsphere-master\shardingsphere-master\examples\example-core\example-spring-jpa\src\main\java\org\apache\shardingsphere\example\core\jpa\repository\AddressRepositoryImpl.java,40,17,0,4,0,21
 shardingsphere-master\shardingsphere-master\shardingsphere-infra\shardingsphere-infra-federation\shardingsphere-infra-federation-optimizer\src\main\java\org\apache\shardingsphere\infra\federation\optimizer\context\OptimizerContextFactory.java,0,8,0,12,0,20
 shardingsphere-master\shardingsphere-master\shardingsphere-test\shardingsphere-parser-test\src\main\java\org\apache\shardingsphere\test\sql\parser\parameterized\jaxb\cases\domain\statement\distsql\ral\scaling\StopScalingStatementTestCase.java,0,2,0,3,0,5
 shardingsphere-master\shardingsphere-master\shardingsphere-proxy\shardingsphere-proxy-bootstrap\src\test\java\org\apache\shardingsphere\proxy\fixture\RuleConfigurationFixtureChecker.java,0,3,1,3,0,7
 shardingsphere-master\shardingsphere-master\shardingsphere-kernel\shardingsphere-data-pipeline\shardingsphere-data-pipeline-core\src\main\java\org\apache\shardingsphere\data\pipeline\core\task\PipelineTask.java,0,2,0,1,0,3
 shardingsphere-master\shardingsphere-master\shardingsphere-test\shardingsphere-integration-test\shardingsphere-integration-test-suite\src\test\java\org\apache\shardingsphere\test\integration\engine\dml\AdditionalDMLIT.java,0,82,0,55,0,137
 shardingsphere-master\shardingsphere-master\shardingsphere-proxy\shardingsphere-proxy-backend\src\test\java\org\apache\shardingsphere\proxy\backend\communication\jdbc\statement\impl\PostgreSQLStatementMemoryStrictlyFetchSizeSetterTest.java,0,18,2,9,0,29
 shardingsphere-master\shardingsphere-master\examples\example-core\example-raw-jdbc\src\main\java\org\apache\shardingsphere\example\core\jdbc\service\ShadowUserServiceImpl.java,0,21,0,9,0,30
 shardingsphere-master\shardingsphere-master\shardingsphere-proxy\shardingsphere-proxy-backend\src\main\java\org\apache\shardingsphere\proxy\backend\text\admin\mysql\MySQLAdminExecutorFactory.java,0,53,0,70,0,123
 shardingsphere-master\shardingsphere-master\shardingsphere-infra\shardingsphere-infra-executor\src\main\java\org\apache\shardingsphere\infra\executor\sql\prepare\driver\vertx\builder\PreparedQueryExecutionUnitBuilder.java,0,8,0,10,0,18
 shardingsphere-master\shardingsphere-master\shardingsphere-test\shardingsphere-parser-test\src\main\java\org\apache\shardingsphere\test\sql\parser\parameterized\jaxb\cases\domain\segment\impl\expr\ExpectedNotExpression.java,6,3,0,4,0,7
 shardingsphere-master\shardingsphere-master\shardingsphere-test\shardingsphere-parser-test\src\main\java\org\apache\shardingsphere\test\sql\parser\parameterized\jaxb\cases\domain\statement\DropRuleStatementTestCase.java,6,2,1,2,0,5
 shardingsphere-master\shardingsphere-master\shardingsphere-proxy\shardingsphere-proxy-frontend\shardingsphere-proxy-frontend-reactive-mysql\src\main\java\org\apache\shardingsphere\proxy\frontend\reactive\mysql\command\query\text\fieldlist\ReactiveMySQLComFieldListPacketExecutor.java,0,32,0,22,0,54
 shardingsphere-master\shardingsphere-master\shardingsphere-features\shardingsphere-shadow\shardingsphere-shadow-spring\shardingsphere-shadow-spring-boot-starter\src\main\java\org\apache\shardingsphere\shadow\spring\boot\algorithm\ShadowAlgorithmProvidedBeanRegistry.java,0,9,0,5,0,14
 shardingsphere-master\shardingsphere-master\shardingsphere-db-protocol\shardingsphere-db-protocol-mysql\src\main\java\org\apache\shardingsphere\db\protocol\mysql\packet\binlog\row\column\value\blob\MySQLBlobBinlogProtocolValue.java,0,10,0,9,0,19
 shardingsphere-master\shardingsphere-master\shardingsphere-features\shardingsphere-sharding\shardingsphere-sharding-distsql\shardingsphere-sharding-distsql-statement\src\main\java\org\apache\shardingsphere\sharding\distsql\parser\statement\CreateShardingBroadcastTableRulesStatement.java,0,3,0,3,0,6
 shardingsphere-master\shardingsphere-master\shardingsphere-test\shardingsphere-parser-test\src\main\java\org\apache\shardingsphere\test\sql\parser\parameterized\jaxb\cases\domain\statement\dal\RestartStatementTestCase.java,0,0,0,3,0,3
 shardingsphere-master\shardingsphere-master\shardingsphere-db-protocol\shardingsphere-db-protocol-mysql\src\main\java\org\apache\shardingsphere\db\protocol\mysql\constant\MySQLConnectionPhase.java,0,5,0,2,0,7
 shardingsphere-master\shardingsphere-master\shardingsphere-kernel\shardingsphere-data-pipeline\shardingsphere-data-pipeline-spi\src\main\java\org\apache\shardingsphere\data\pipeline\spi\check\datasource\DataSourceChecker.java,0,6,0,2,0,8
 shardingsphere-master\shardingsphere-master\shardingsphere-features\shardingsphere-sharding\shardingsphere-sharding-core\src\test\java\org\apache\shardingsphere\sharding\route\engine\condition\engine\ShardingConditionEngineFactoryTest.java,0,17,0,9,0,26
 shardingsphere-master\shardingsphere-master\shardingsphere-kernel\shardingsphere-data-pipeline\shardingsphere-data-pipeline-spi\src\main\java\org\apache\shardingsphere\data\pipeline\api\datasource\PipelineDataSourceWrapper.java,0,18,0,4,0,22
 shardingsphere-master\shardingsphere-master\shardingsphere-infra\shardingsphere-infra-rewrite\src\main\java\org\apache\shardingsphere\infra\rewrite\sql\token\generator\builder\SQLTokenGeneratorBuilder.java,0,2,0,2,0,4
 shardingsphere-master\shardingsphere-master\shardingsphere-proxy\shardingsphere-proxy-backend\src\main\java\org\apache\shardingsphere\proxy\backend\text\distsql\ral\common\queryable\ShowTableMetadataHandler.java,0,29,0,19,0,48
 shardingsphere-master\shardingsphere-master\shardingsphere-infra\shardingsphere-infra-federation\shardingsphere-infra-federation-optimizer\src\main\java\org\apache\shardingsphere\infra\federation\optimizer\metadata\calcite\FederationTable.java,0,6,0,4,0,10
 shardingsphere-master\shardingsphere-master\shardingsphere-test\shardingsphere-parser-test\src\main\java\org\apache\shardingsphere\test\sql\parser\parameterized\asserts\segment\expression\ExpressionAssert.java,0,103,0,137,0,240
 shardingsphere-master\shardingsphere-master\shardingsphere-features\shardingsphere-readwrite-splitting\shardingsphere-readwrite-splitting-core\src\main\java\org\apache\shardingsphere\readwritesplitting\algorithm\DynamicReadwriteSplittingType.java,64,32,0,16,0,48
 shardingsphere-master\shardingsphere-master\shardingsphere-test\shardingsphere-parser-test\src\main\java\org\apache\shardingsphere\test\sql\parser\parameterized\jaxb\cases\domain\statement\distsql\ral\ShowTrafficRulesStatementTestCase.java,0,2,0,3,0,5
 shardingsphere-master\shardingsphere-master\shardingsphere-infra\shardingsphere-infra-common\src\test\java\org\apache\shardingsphere\infra\datasource\pool\destroyer\detector\DataSourcePoolActiveDetectorFactoryTest.java,0,7,0,5,0,12
 shardingsphere-master\shardingsphere-master\shardingsphere-features\shardingsphere-sharding\shardingsphere-sharding-spring\shardingsphere-sharding-spring-boot-starter\src\test\java\org\apache\shardingsphere\sharding\spring\boot\condition\ShardingSpringBootConditionTest.java,0,11,0,7,0,18
 shardingsphere-master\shardingsphere-master\shardingsphere-infra\shardingsphere-infra-common\src\test\java\org\apache\shardingsphere\infra\datasource\props\DataSourcePropertiesCreatorTest.java,0,15,0,8,0,23
 shardingsphere-master\shardingsphere-master\shardingsphere-features\shardingsphere-db-discovery\shardingsphere-db-discovery-core\src\main\java\org\apache\shardingsphere\dbdiscovery\route\DatabaseDiscoverySQLRouter.java,0,14,0,12,0,26
 shardingsphere-master\shardingsphere-master\shardingsphere-infra\shardingsphere-infra-common\src\main\java\org\apache\shardingsphere\infra\metadata\schema\loader\dialect\OpenGaussTableMetaDataLoader.java,0,48,0,32,0,80
 shardingsphere-master\shardingsphere-master\shardingsphere-mode\shardingsphere-mode-type\shardingsphere-cluster-mode\shardingsphere-cluster-mode-core\src\main\java\org\apache\shardingsphere\mode\manager\cluster\coordinator\registry\GovernanceWatcher.java,0,5,0,3,0,8
 shardingsphere-master\shardingsphere-master\shardingsphere-proxy\shardingsphere-proxy-backend\src\main\java\org\apache\shardingsphere\proxy\backend\response\data\QueryResponseRow.java,0,5,0,2,0,7
 shardingsphere-master\shardingsphere-master\shardingsphere-test\shardingsphere-parser-test\src\main\java\org\apache\shardingsphere\test\sql\parser\parameterized\jaxb\cases\domain\segment\impl\orderby\item\impl\ExpectedIndexOrderByItem.java,0,2,0,3,0,5
 shardingsphere-master\shardingsphere-master\shardingsphere-features\shardingsphere-sharding\shardingsphere-sharding-core\src\test\java\org\apache\shardingsphere\sharding\algorithm\keygen\fixture\IncrementKeyGenerateAlgorithm.java,0,6,1,2,0,9
 shardingsphere-master\shardingsphere-master\shardingsphere-test\shardingsphere-parser-test\src\main\java\org\apache\shardingsphere\test\sql\parser\parameterized\jaxb\cases\domain\statement\dal\FlushStatementTestCase.java,0,4,0,4,0,8
 shardingsphere-master\shardingsphere-master\shardingsphere-proxy\shardingsphere-proxy-backend\src\test\java\org\apache\shardingsphere\proxy\backend\text\admin\DatabaseOperateBackendHandlerFactoryTest.java,0,54,0,35,0,89
 shardingsphere-master\shardingsphere-master\shardingsphere-features\shardingsphere-sharding\shardingsphere-sharding-core\src\main\java\org\apache\shardingsphere\sharding\route\engine\exception\TableExistsException.java,0,6,0,1,0,7
 shardingsphere-master\shardingsphere-master\shardingsphere-sql-parser\shardingsphere-sql-parser-statement\src\main\java\org\apache\shardingsphere\sql\parser\sql\common\segment\dml\order\item\OrderByItemSegment.java,11,8,1,1,0,10
 shardingsphere-master\shardingsphere-master\shardingsphere-test\shardingsphere-parser-test\src\main\java\org\apache\shardingsphere\test\sql\parser\parameterized\jaxb\cases\domain\statement\distsql\rdl\create\CreateDefaultSingleTableRuleStatementTestCase.java,0,3,0,4,0,7
 shardingsphere-master\shardingsphere-master\examples\shardingsphere-jdbc-example\single-feature-example\sharding-example\sharding-raw-jdbc-example\src\main\java\org\apache\shardingsphere\example\sharding\raw\jdbc\config\ShardingTablesConfigurationRange.java,0,16,0,16,0,32
 shardingsphere-master\shardingsphere-master\shardingsphere-sql-parser\shardingsphere-sql-parser-statement\src\main\java\org\apache\shardingsphere\sql\parser\sql\dialect\statement\oracle\OracleStatement.java,0,1,0,1,0,2
 shardingsphere-master\shardingsphere-master\shardingsphere-kernel\shardingsphere-data-pipeline\shardingsphere-data-pipeline-spi\src\main\java\org\apache\shardingsphere\data\pipeline\api\pojo\JobInfo.java,0,14,0,1,0,15
 shardingsphere-master\shardingsphere-master\shardingsphere-features\shardingsphere-sharding\shardingsphere-sharding-distsql\shardingsphere-sharding-distsql-statement\src\main\java\org\apache\shardingsphere\sharding\distsql\parser\statement\ShowShardingTableRulesUsedKeyGeneratorStatement.java,0,8,0,5,0,13
 shardingsphere-master\shardingsphere-master\shardingsphere-proxy\shardingsphere-proxy-frontend\shardingsphere-proxy-frontend-core\src\main\java\org\apache\shardingsphere\proxy\frontend\constant\LogMDCConstants.java,0,6,0,1,0,7
 shardingsphere-master\shardingsphere-master\shardingsphere-features\shardingsphere-sharding\shardingsphere-sharding-spring\shardingsphere-sharding-spring-namespace\src\main\java\org\apache\shardingsphere\sharding\spring\namespace\tag\strategy\KeyGenerateStrategyBeanDefinitionTag.java,0,8,0,1,0,9
 shardingsphere-master\shardingsphere-master\shardingsphere-test\shardingsphere-parser-test\src\main\java\org\apache\shardingsphere\test\sql\parser\parameterized\jaxb\cases\domain\segment\impl\expr\simple\ExpectedBaseSimpleExpression.java,3,2,1,4,0,7
 shardingsphere-master\shardingsphere-master\shardingsphere-jdbc\shardingsphere-jdbc-spring\shardingsphere-jdbc-core-spring\shardingsphere-jdbc-core-spring-namespace\src\main\java\org\apache\shardingsphere\spring\namespace\handler\mode\ClusterPersistRepositoryNamespaceHandler.java,0,4,0,5,0,9
 shardingsphere-master\shardingsphere-master\shardingsphere-infra\shardingsphere-infra-federation\shardingsphere-infra-federation-optimizer\src\main\java\org\apache\shardingsphere\infra\federation\optimizer\converter\segment\expression\impl\ParameterMarkerExpressionConverter.java,0,7,0,10,0,17
 shardingsphere-master\shardingsphere-master\shardingsphere-features\shardingsphere-encrypt\shardingsphere-encrypt-core\src\test\java\org\apache\shardingsphere\encrypt\rewrite\impl\EncryptProjectionTokenGeneratorTest.java,0,49,0,51,0,100
 shardingsphere-master\shardingsphere-master\shardingsphere-test\shardingsphere-parser-test\src\main\java\org\apache\shardingsphere\test\sql\parser\parameterized\jaxb\cases\domain\statement\ddl\DropTableStatementTestCase.java,0,2,0,4,0,6
 shardingsphere-master\shardingsphere-master\shardingsphere-jdbc\shardingsphere-jdbc-spring\shardingsphere-jdbc-core-spring\shardingsphere-jdbc-core-spring-namespace\src\main\java\org\apache\shardingsphere\spring\namespace\parser\mode\StandalonePersistRepositoryConfigurationBeanDefinitionParser.java,0,9,0,10,0,19
 shardingsphere-master\shardingsphere-master\shardingsphere-db-protocol\shardingsphere-db-protocol-postgresql\src\test\java\org\apache\shardingsphere\db\protocol\postgresql\packet\command\query\extended\close\PostgreSQLComClosePacketTest.java,0,12,0,7,0,19
 shardingsphere-master\shardingsphere-master\shardingsphere-infra\shardingsphere-infra-common\src\test\java\org\apache\shardingsphere\infra\database\metadata\dialect\SQLServerDataSourceMetaDataTest.java,0,25,6,9,0,40
 shardingsphere-master\shardingsphere-master\shardingsphere-test\shardingsphere-parser-test\src\main\java\org\apache\shardingsphere\test\sql\parser\parameterized\jaxb\cases\domain\statement\ddl\AlterServerStatementTestCase.java,0,0,0,3,0,3
 shardingsphere-master\shardingsphere-master\shardingsphere-sql-parser\shardingsphere-sql-parser-dialect\shardingsphere-sql-parser-mysql\src\main\java\org\apache\shardingsphere\sql\parser\mysql\visitor\statement\impl\MySQLDCLStatementSQLVisitor.java,0,226,1,254,0,481
 shardingsphere-master\shardingsphere-master\shardingsphere-sql-parser\shardingsphere-sql-parser-statement\src\main\java\org\apache\shardingsphere\sql\parser\sql\dialect\statement\opengauss\ddl\OpenGaussExecuteStatement.java,0,1,0,5,0,6
 shardingsphere-master\shardingsphere-master\shardingsphere-sql-parser\shardingsphere-sql-parser-dialect\shardingsphere-sql-parser-mysql\src\main\java\org\apache\shardingsphere\sql\parser\mysql\visitor\format\impl\MySQLDCLFormatSQLVisitor.java,0,3,0,3,0,6
 shardingsphere-master\shardingsphere-master\shardingsphere-agent\shardingsphere-agent-api\src\main\java\org\apache\shardingsphere\agent\api\advice\InstanceMethodAroundAdvice.java,0,12,3,9,0,24
 shardingsphere-master\shardingsphere-master\shardingsphere-test\shardingsphere-integration-test\shardingsphere-integration-test-suite\src\test\java\org\apache\shardingsphere\test\integration\framework\runner\parallel\annotaion\ParallelLevel.java,0,4,0,2,0,6
 shardingsphere-master\shardingsphere-master\shardingsphere-jdbc\shardingsphere-jdbc-spring\shardingsphere-jdbc-spring-infra\shardingsphere-jdbc-spring-namespace-infra\src\main\java\org\apache\shardingsphere\spring\namespace\registry\ShardingSphereAlgorithmBeanRegistry.java,0,13,0,10,0,23
 shardingsphere-master\shardingsphere-master\shardingsphere-kernel\shardingsphere-authority\shardingsphere-authority-api\src\main\java\org\apache\shardingsphere\authority\model\PrivilegeType.java,0,83,0,1,0,84
 shardingsphere-master\shardingsphere-master\shardingsphere-db-protocol\shardingsphere-db-protocol-postgresql\src\test\java\org\apache\shardingsphere\db\protocol\postgresql\packet\command\query\extended\parse\PostgreSQLComParsePacketTest.java,0,7,0,7,0,14
 shardingsphere-master\shardingsphere-master\shardingsphere-test\shardingsphere-parser-test\src\main\java\org\apache\shardingsphere\test\sql\parser\parameterized\jaxb\cases\domain\statement\ddl\CreateTextSearchStatementTestCase.java,0,0,0,3,0,3
 shardingsphere-master\shardingsphere-master\shardingsphere-mode\shardingsphere-mode-type\shardingsphere-cluster-mode\shardingsphere-cluster-mode-repository\shardingsphere-cluster-mode-repository-provider\shardingsphere-cluster-mode-repository-etcd\src\main\java\org\apache\shardingsphere\mode\repository\cluster\etcd\props\EtcdProperties.java,0,3,0,1,0,4
 shardingsphere-master\shardingsphere-master\shardingsphere-sql-parser\shardingsphere-sql-parser-statement\src\test\java\org\apache\shardingsphere\sql\parser\sql\common\util\ColumnExtractorParameterizedTest.java,0,10,0,11,1,22
 shardingsphere-master\shardingsphere-master\shardingsphere-test\shardingsphere-parser-test\src\main\java\org\apache\shardingsphere\test\sql\parser\parameterized\jaxb\cases\domain\statement\distsql\rdl\alter\AlterShardingAlgorithmStatementTestCase.java,0,4,0,6,0,10
 shardingsphere-master\shardingsphere-master\shardingsphere-test\shardingsphere-parser-test\src\main\java\org\apache\shardingsphere\test\sql\parser\parameterized\jaxb\cases\domain\statement\ddl\DropDatabaseStatementTestCase.java,0,0,0,3,0,3
 shardingsphere-master\shardingsphere-master\shardingsphere-mode\shardingsphere-mode-type\shardingsphere-standalone-mode\shardingsphere-standalone-mode-repository\shardingsphere-standalone-mode-repository-provider\shardingsphere-standalone-mode-repository-file\src\main\java\org\apache\shardingsphere\mode\repository\standalone\file\FileRepositoryPropertyKey.java,0,8,0,1,0,9
 shardingsphere-master\shardingsphere-master\shardingsphere-infra\shardingsphere-infra-rewrite\src\main\java\org\apache\shardingsphere\infra\rewrite\sql\token\pojo\Substitutable.java,0,4,0,1,0,5
 shardingsphere-master\shardingsphere-master\shardingsphere-sql-parser\shardingsphere-sql-parser-statement\src\main\java\org\apache\shardingsphere\sql\parser\sql\dialect\handler\dml\UpdateStatementHandler.java,0,5,0,9,2,16
 shardingsphere-master\shardingsphere-master\shardingsphere-db-protocol\shardingsphere-db-protocol-postgresql\src\main\java\org\apache\shardingsphere\db\protocol\postgresql\payload\PostgreSQLPacketPayload.java,0,31,0,5,0,36
 shardingsphere-master\shardingsphere-master\shardingsphere-test\shardingsphere-parser-test\src\main\java\org\apache\shardingsphere\test\sql\parser\parameterized\jaxb\cases\domain\segment\impl\clone\ExpectedDataDirectory.java,0,3,0,3,0,6
 shardingsphere-master\shardingsphere-master\shardingsphere-sql-parser\shardingsphere-sql-parser-statement\src\main\java\org\apache\shardingsphere\sql\parser\sql\common\segment\dml\column\OnDuplicateKeyColumnsSegment.java,0,6,0,2,2,10
 shardingsphere-master\shardingsphere-master\shardingsphere-db-protocol\shardingsphere-db-protocol-mysql\src\main\java\org\apache\shardingsphere\db\protocol\mysql\packet\command\query\binary\execute\protocol\MySQLInt4BinaryProtocolValue.java,0,3,0,3,0,6
 shardingsphere-master\shardingsphere-master\shardingsphere-kernel\shardingsphere-authority\shardingsphere-authority-core\src\main\java\org\apache\shardingsphere\authority\provider\schema\model\privilege\SchemaPrivilegesPermittedShardingSpherePrivileges.java,27,13,1,5,0,19
 shardingsphere-master\shardingsphere-master\shardingsphere-infra\shardingsphere-infra-common\src\test\java\org\apache\shardingsphere\infra\yaml\engine\YamlEngineTest.java,0,33,0,18,0,51
 shardingsphere-master\shardingsphere-master\shardingsphere-features\shardingsphere-sharding\shardingsphere-sharding-core\src\test\java\org\apache\shardingsphere\sharding\merge\dql\pagination\RowNumberDecoratorMergedResultTest.java,0,50,0,54,0,104
 shardingsphere-master\shardingsphere-master\shardingsphere-kernel\shardingsphere-parser\shardingsphere-parser-spring\shardingsphere-parser-spring-namespace\src\main\java\org\apache\shardingsphere\parser\spring\namespace\parser\SQLParserRuleBeanDefinitionParser.java,0,19,0,16,0,35
 shardingsphere-master\shardingsphere-master\shardingsphere-test\shardingsphere-parser-test\src\main\java\org\apache\shardingsphere\test\sql\parser\parameterized\jaxb\cases\domain\statement\distsql\rdl\alter\AlterDatabaseDiscoveryTypeStatementTestCase.java,0,4,0,6,0,10
 shardingsphere-master\shardingsphere-master\shardingsphere-infra\shardingsphere-infra-common\src\main\java\org\apache\shardingsphere\infra\metadata\schema\loader\common\IndexMetaDataLoader.java,0,10,0,4,0,14
 shardingsphere-master\shardingsphere-master\shardingsphere-test\shardingsphere-parser-test\src\main\java\org\apache\shardingsphere\test\sql\parser\parameterized\jaxb\cases\domain\statement\distsql\ral\PrepareDistSQLStatementTestCase.java,0,0,0,3,0,3
 shardingsphere-master\shardingsphere-master\shardingsphere-features\shardingsphere-readwrite-splitting\shardingsphere-readwrite-splitting-distsql\shardingsphere-readwrite-splitting-distsql-handler\src\test\java\org\apache\shardingsphere\readwritesplitting\distsql\handler\query\ReadwriteSplittingRuleQueryResultSetTest.java,0,46,0,34,0,80
 shardingsphere-master\shardingsphere-master\shardingsphere-mode\shardingsphere-mode-type\shardingsphere-cluster-mode\shardingsphere-cluster-mode-core\src\main\java\org\apache\shardingsphere\mode\manager\cluster\coordinator\registry\status\StatusNode.java,0,4,0,2,0,6
 shardingsphere-master\shardingsphere-master\shardingsphere-features\shardingsphere-sharding\shardingsphere-sharding-distsql\shardingsphere-sharding-distsql-statement\src\main\java\org\apache\shardingsphere\scaling\distsql\statement\StartScalingStatement.java,0,2,0,2,0,4
 shardingsphere-master\shardingsphere-master\shardingsphere-proxy\shardingsphere-proxy-backend\src\main\java\org\apache\shardingsphere\proxy\backend\text\distsql\ral\common\hint\HintShardingType.java,0,3,0,1,0,4
 shardingsphere-master\shardingsphere-master\shardingsphere-kernel\shardingsphere-data-pipeline\shardingsphere-data-pipeline-core\src\main\java\org\apache\shardingsphere\data\pipeline\core\spi\check\consistency\DataMatchDataConsistencyCheckAlgorithm.java,0,9,0,3,0,12
 shardingsphere-master\shardingsphere-master\shardingsphere-kernel\shardingsphere-data-pipeline\shardingsphere-data-pipeline-spi\src\main\java\org\apache\shardingsphere\data\pipeline\api\datasource\config\yaml\YamlPipelineDataSourceConfiguration.java,0,5,0,2,0,7
 shardingsphere-master\shardingsphere-master\shardingsphere-proxy\shardingsphere-proxy-backend\src\main\java\org\apache\shardingsphere\proxy\backend\config\YamlProxyConfiguration.java,0,5,0,4,0,9
 shardingsphere-master\shardingsphere-master\shardingsphere-agent\shardingsphere-agent-plugins\shardingsphere-agent-plugin-metrics\shardingsphere-agent-metrics-api\src\main\java\org\apache\shardingsphere\agent\metrics\api\MetricsPool.java,0,10,1,2,0,13
 shardingsphere-master\shardingsphere-master\shardingsphere-infra\shardingsphere-infra-federation\shardingsphere-infra-federation-optimizer\src\main\java\org\apache\shardingsphere\infra\federation\optimizer\converter\segment\projection\impl\AggregationProjectionConverter.java,0,55,1,44,0,100
 shardingsphere-master\shardingsphere-master\shardingsphere-sql-parser\shardingsphere-sql-parser-statement\src\main\java\org\apache\shardingsphere\sql\parser\sql\common\segment\ddl\column\alter\RenameColumnSegment.java,0,8,0,3,4,15
 shardingsphere-master\shardingsphere-master\shardingsphere-infra\shardingsphere-infra-common\src\main\java\org\apache\shardingsphere\infra\exception\ShardingSphereException.java,34,9,0,3,0,12
 shardingsphere-master\shardingsphere-master\shardingsphere-features\shardingsphere-readwrite-splitting\shardingsphere-readwrite-splitting-distsql\shardingsphere-readwrite-splitting-distsql-parser\src\main\java\org\apache\shardingsphere\readwritesplitting\distsql\parser\core\ReadwriteSplittingDistSQLParser.java,0,5,0,4,0,9
 shardingsphere-master\shardingsphere-master\shardingsphere-test\shardingsphere-parser-test\src\main\java\org\apache\shardingsphere\test\sql\parser\parameterized\asserts\statement\distsql\rdl\alter\impl\AlterDatabaseDiscoveryTypeStatementAssert.java,0,11,0,16,0,27
 shardingsphere-master\shardingsphere-master\shardingsphere-features\shardingsphere-sharding\shardingsphere-sharding-distsql\shardingsphere-sharding-distsql-handler\src\test\java\org\apache\shardingsphere\sharding\distsql\fixture\BoundaryRangeShardingAlgorithmFixture.java,0,11,2,8,0,21
 shardingsphere-master\shardingsphere-master\shardingsphere-db-protocol\shardingsphere-db-protocol-mysql\src\test\java\org\apache\shardingsphere\db\protocol\mysql\packet\command\query\binary\execute\protocol\MySQLDateBinaryProtocolValueTest.java,0,70,0,8,0,78
 shardingsphere-master\shardingsphere-master\shardingsphere-infra\shardingsphere-infra-binder\src\main\java\org\apache\shardingsphere\infra\binder\aware\ParameterAware.java,0,3,0,1,0,4
 shardingsphere-master\shardingsphere-master\shardingsphere-features\shardingsphere-sharding\shardingsphere-sharding-core\src\main\java\org\apache\shardingsphere\sharding\route\strategy\ShardingStrategyFactory.java,0,11,0,20,0,31
 shardingsphere-master\shardingsphere-master\shardingsphere-test\shardingsphere-parser-test\src\main\java\org\apache\shardingsphere\test\sql\parser\parameterized\asserts\statement\distsql\DistSQLStatementAssert.java,0,7,0,11,0,18
 shardingsphere-master\shardingsphere-master\shardingsphere-kernel\shardingsphere-authority\shardingsphere-authority-core\src\main\java\org\apache\shardingsphere\authority\checker\AuthorityChecker.java,0,25,0,30,0,55
 shardingsphere-master\shardingsphere-master\shardingsphere-db-protocol\shardingsphere-db-protocol-core\src\main\java\org\apache\shardingsphere\db\protocol\codec\DatabasePacketCodecEngine.java,0,8,0,1,0,9
 shardingsphere-master\shardingsphere-master\shardingsphere-agent\shardingsphere-agent-core\src\test\java\org\apache\shardingsphere\agent\core\mock\material\InstanceMaterial.java,24,3,0,2,0,5
 shardingsphere-master\shardingsphere-master\shardingsphere-infra\shardingsphere-infra-common\src\main\java\org\apache\shardingsphere\infra\datasource\pool\destroyer\detector\type\DefaultDataSourcePoolActiveDetector.java,0,5,0,3,0,8
 shardingsphere-master\shardingsphere-master\shardingsphere-infra\shardingsphere-infra-common\src\main\java\org\apache\shardingsphere\infra\database\type\DatabaseTypeRegistry.java,0,26,0,9,0,35
 shardingsphere-master\shardingsphere-master\shardingsphere-test\shardingsphere-integration-test\shardingsphere-integration-test-suite\src\test\java\org\apache\shardingsphere\test\integration\engine\dql\BaseDQLIT.java,81,38,5,29,0,72
 shardingsphere-master\shardingsphere-master\shardingsphere-features\shardingsphere-shadow\shardingsphere-shadow-distsql\shardingsphere-shadow-distsql-handler\src\test\java\org\apache\shardingsphere\shadow\distsql\converter\ShadowRuleStatementConverterTest.java,0,9,0,9,0,18
 shardingsphere-master\shardingsphere-master\shardingsphere-features\shardingsphere-sharding\shardingsphere-sharding-distsql\shardingsphere-sharding-distsql-handler\src\main\java\org\apache\shardingsphere\sharding\distsql\handler\query\ShardingTableRuleQueryResultSet.java,0,101,0,83,0,184
 shardingsphere-master\shardingsphere-master\shardingsphere-mode\shardingsphere-mode-type\shardingsphere-cluster-mode\shardingsphere-cluster-mode-core\src\test\java\org\apache\shardingsphere\mode\manager\cluster\coordinator\registry\status\storage\subscriber\StorageNodeStatusSubscriberTest.java,0,20,0,16,0,36
 shardingsphere-master\shardingsphere-master\shardingsphere-infra\shardingsphere-infra-common\src\test\java\org\apache\shardingsphere\infra\aware\DataSourceNameAwareFactoryTest.java,0,3,0,2,0,5
 shardingsphere-master\shardingsphere-master\shardingsphere-sql-parser\shardingsphere-sql-parser-engine\src\test\java\org\apache\shardingsphere\sql\parser\core\database\visitor\SQLVisitorRuleTest.java,0,5,0,2,0,7
 shardingsphere-master\shardingsphere-master\shardingsphere-proxy\shardingsphere-proxy-backend\src\main\java\org\apache\shardingsphere\proxy\backend\text\distsql\ral\common\exception\InvalidValueException.java,0,3,0,2,0,5
 shardingsphere-master\shardingsphere-master\shardingsphere-db-protocol\shardingsphere-db-protocol-mysql\src\main\java\org\apache\shardingsphere\db\protocol\mysql\packet\binlog\row\column\value\time\MySQLFractionalSeconds.java,0,15,0,4,0,19
 shardingsphere-master\shardingsphere-master\shardingsphere-features\shardingsphere-readwrite-splitting\shardingsphere-readwrite-splitting-core\src\main\java\org\apache\shardingsphere\readwritesplitting\rule\builder\AlgorithmProvidedReadwriteSplittingRuleBuilder.java,0,8,0,7,0,15
 shardingsphere-master\shardingsphere-master\examples\shardingsphere-jdbc-example\single-feature-example\extension-example\custom-sharding-algortihm-example\spi-based-sharding-algorithm-example\spi-based-sharding-spring-namespace-jpa-example\src\main\java\org\apache\shardingsphere\example\extension\spibased\sharding\spring\namespace\jpa\fixture\SPIBasedOrderStandardShardingAlgorithmFixture.java,0,8,1,8,0,17
 shardingsphere-master\shardingsphere-master\shardingsphere-infra\shardingsphere-infra-executor\src\test\java\org\apache\shardingsphere\infra\executor\kernel\thread\ExecutorThreadFactoryBuilderTest.java,0,6,0,2,0,8
 shardingsphere-master\shardingsphere-master\shardingsphere-agent\shardingsphere-agent-plugins\shardingsphere-agent-plugin-tracing\shardingsphere-agent-tracing-test\src\main\java\org\apache\shardingsphere\agent\plugin\tracing\AgentRunner.java,0,21,1,6,0,28
 shardingsphere-master\shardingsphere-master\shardingsphere-features\shardingsphere-db-discovery\shardingsphere-db-discovery-distsql\shardingsphere-db-discovery-distsql-handler\src\test\java\org\apache\shardingsphere\dbdiscovery\distsql\handler\update\CreateDatabaseDiscoveryRuleStatementUpdaterTest.java,0,73,0,56,0,129
 shardingsphere-master\shardingsphere-master\shardingsphere-features\shardingsphere-sharding\shardingsphere-sharding-distsql\shardingsphere-sharding-distsql-handler\src\test\java\org\apache\shardingsphere\sharding\distsql\update\DropShardingBroadcastTableRuleStatementUpdaterTest.java,0,45,0,30,0,75
 shardingsphere-master\shardingsphere-master\shardingsphere-infra\shardingsphere-infra-datetime\shardingsphere-infra-datetime-type\shardingsphere-database-datetime\src\main\java\org\apache\shardingsphere\datetime\database\config\DatabaseDatetimeServiceConfiguration.java,0,18,0,8,0,26
 shardingsphere-master\shardingsphere-master\shardingsphere-test\shardingsphere-integration-driver-test\src\test\java\org\apache\shardingsphere\driver\fixture\TestRuleConfigurationChecker.java,0,6,1,3,0,10
 shardingsphere-master\shardingsphere-master\shardingsphere-features\shardingsphere-sharding\shardingsphere-sharding-core\src\main\java\org\apache\shardingsphere\sharding\rewrite\token\generator\impl\ConstraintTokenGenerator.java,0,10,0,10,0,20
 shardingsphere-master\shardingsphere-master\shardingsphere-features\shardingsphere-sharding\shardingsphere-sharding-core\src\main\java\org\apache\shardingsphere\sharding\route\engine\type\broadcast\ShardingDataSourceGroupBroadcastRoutingEngine.java,0,13,0,9,0,22
 shardingsphere-master\shardingsphere-master\shardingsphere-proxy\shardingsphere-proxy-frontend\shardingsphere-proxy-frontend-core\src\test\java\org\apache\shardingsphere\proxy\frontend\state\impl\JDBCOKProxyStateTest.java,0,53,2,31,0,86
 shardingsphere-master\shardingsphere-master\shardingsphere-features\shardingsphere-db-discovery\shardingsphere-db-discovery-distsql\shardingsphere-db-discovery-distsql-statement\src\main\java\org\apache\shardingsphere\dbdiscovery\distsql\parser\statement\DropDatabaseDiscoveryRuleStatement.java,0,7,0,4,0,11
 shardingsphere-master\shardingsphere-master\shardingsphere-infra\shardingsphere-infra-federation\shardingsphere-infra-federation-optimizer\src\main\java\org\apache\shardingsphere\infra\federation\optimizer\converter\segment\projection\impl\ShorthandProjectionConverter.java,0,11,0,13,0,24
 shardingsphere-master\shardingsphere-master\shardingsphere-features\shardingsphere-sharding\shardingsphere-sharding-distsql\shardingsphere-sharding-distsql-statement\src\main\java\org\apache\shardingsphere\sharding\distsql\parser\statement\ShowUnusedShardingAlgorithmsStatement.java,0,3,0,4,0,7
 shardingsphere-master\shardingsphere-master\shardingsphere-features\shardingsphere-sharding\shardingsphere-sharding-core\src\main\java\org\apache\shardingsphere\sharding\yaml\config\strategy\sharding\YamlBaseShardingStrategyConfiguration.java,0,2,0,2,0,4
 shardingsphere-master\shardingsphere-master\shardingsphere-test\shardingsphere-parser-test\src\main\java\org\apache\shardingsphere\test\sql\parser\parameterized\jaxb\cases\domain\statement\distsql\ral\scaling\StartScalingStatementTestCase.java,0,2,0,3,0,5
 shardingsphere-master\shardingsphere-master\shardingsphere-sql-parser\shardingsphere-sql-parser-statement\src\main\java\org\apache\shardingsphere\sql\parser\sql\common\segment\ddl\constraint\alter\AddConstraintDefinitionSegment.java,0,8,0,5,2,15
 shardingsphere-master\shardingsphere-master\shardingsphere-sql-parser\shardingsphere-sql-parser-statement\src\main\java\org\apache\shardingsphere\sql\parser\sql\dialect\statement\mysql\dal\MySQLShowEnginesStatement.java,0,1,0,5,0,6
 shardingsphere-master\shardingsphere-master\shardingsphere-test\shardingsphere-parser-test\src\main\java\org\apache\shardingsphere\test\sql\parser\parameterized\asserts\statement\ddl\impl\AnalyzeStatementAssert.java,0,10,0,12,0,22
 shardingsphere-master\shardingsphere-master\shardingsphere-db-protocol\shardingsphere-db-protocol-postgresql\src\main\java\org\apache\shardingsphere\db\protocol\postgresql\constant\PostgreSQLMessageSeverityLevel.java,0,15,0,2,0,17
 shardingsphere-master\shardingsphere-master\shardingsphere-sql-parser\shardingsphere-sql-parser-statement\src\main\java\org\apache\shardingsphere\sql\parser\sql\common\segment\dml\order\OrderBySegment.java,0,6,0,2,2,10
 shardingsphere-master\shardingsphere-master\shardingsphere-infra\shardingsphere-infra-common\src\main\java\org\apache\shardingsphere\infra\distsql\exception\resource\InvalidResourcesException.java,0,6,0,3,0,9
 shardingsphere-master\shardingsphere-master\shardingsphere-test\shardingsphere-parser-test\src\main\java\org\apache\shardingsphere\test\sql\parser\parameterized\jaxb\cases\domain\statement\ddl\DropSchemaStatementTestCase.java,0,0,0,3,0,3
 shardingsphere-master\shardingsphere-master\shardingsphere-proxy\shardingsphere-proxy-bootstrap\src\main\java\org\apache\shardingsphere\proxy\version\ShardingSphereProxyVersion.java,0,14,2,10,0,26
 shardingsphere-master\shardingsphere-master\shardingsphere-mode\shardingsphere-mode-type\shardingsphere-cluster-mode\shardingsphere-cluster-mode-core\src\main\java\org\apache\shardingsphere\mode\manager\cluster\coordinator\lock\watcher\GlobalLocksChangedWatcher.java,0,10,0,15,0,25
 shardingsphere-master\shardingsphere-master\shardingsphere-features\shardingsphere-encrypt\shardingsphere-encrypt-core\src\test\java\org\apache\shardingsphere\encrypt\yaml\swapper\EncryptRuleAlgorithmProviderConfigurationYamlSwapperTest.java,0,21,0,17,0,38
 shardingsphere-master\shardingsphere-master\shardingsphere-kernel\shardingsphere-data-pipeline\shardingsphere-data-pipeline-dialect\shardingsphere-data-pipeline-opengauss\src\main\java\org\apache\shardingsphere\data\pipeline\opengauss\prepare\datasource\OpenGaussDataSourcePreparer.java,0,40,2,40,0,82
 shardingsphere-master\shardingsphere-master\shardingsphere-features\shardingsphere-sharding\shardingsphere-sharding-core\src\test\java\org\apache\shardingsphere\sharding\route\engine\condition\generator\ConditionValueGeneratorFactoryTest.java,0,23,0,31,0,54
 shardingsphere-master\shardingsphere-master\shardingsphere-distsql\shardingsphere-distsql-statement\src\main\java\org\apache\shardingsphere\distsql\parser\statement\rdl\alter\AlterResourceStatement.java,0,2,0,2,0,4
 shardingsphere-master\shardingsphere-master\shardingsphere-db-protocol\shardingsphere-db-protocol-postgresql\src\main\java\org\apache\shardingsphere\db\protocol\postgresql\packet\command\query\extended\PostgreSQLPreparedStatement.java,0,11,0,3,0,14
 shardingsphere-master\shardingsphere-master\shardingsphere-infra\shardingsphere-infra-common\src\main\java\org\apache\shardingsphere\infra\distsql\exception\rule\DuplicateKeyGeneratorException.java,0,7,0,4,0,11
 shardingsphere-master\shardingsphere-master\shardingsphere-features\shardingsphere-sharding\shardingsphere-sharding-core\src\main\java\org\apache\shardingsphere\sharding\yaml\swapper\strategy\KeyGenerateStrategyConfigurationYamlSwapper.java,0,8,0,9,0,17
 shardingsphere-master\shardingsphere-master\shardingsphere-test\shardingsphere-parser-test\src\main\java\org\apache\shardingsphere\test\sql\parser\parameterized\asserts\statement\dal\impl\ShowDatabasesStatementAssert.java,0,5,0,8,0,13
 shardingsphere-master\shardingsphere-master\shardingsphere-features\shardingsphere-sharding\shardingsphere-sharding-core\src\main\java\org\apache\shardingsphere\sharding\merge\dal\show\LogicTablesMergedResult.java,38,17,1,15,0,33
 shardingsphere-master\shardingsphere-master\shardingsphere-kernel\shardingsphere-data-pipeline\shardingsphere-data-pipeline-spi\src\main\java\org\apache\shardingsphere\data\pipeline\api\config\rulealtered\ImporterConfiguration.java,0,8,0,2,0,10
 shardingsphere-master\shardingsphere-master\shardingsphere-sql-parser\shardingsphere-sql-parser-statement\src\main\java\org\apache\shardingsphere\sql\parser\sql\dialect\statement\mysql\dml\MySQLDoStatement.java,0,1,0,4,0,5
 shardingsphere-master\shardingsphere-master\shardingsphere-infra\shardingsphere-infra-route\src\main\java\org\apache\shardingsphere\infra\route\SQLRouter.java,0,7,0,3,0,10
 shardingsphere-master\shardingsphere-master\shardingsphere-features\shardingsphere-sharding\shardingsphere-sharding-core\src\main\java\org\apache\shardingsphere\sharding\yaml\config\rule\YamlShardingAutoTableRuleConfiguration.java,0,10,0,4,0,14
 shardingsphere-master\shardingsphere-master\shardingsphere-sql-parser\shardingsphere-sql-parser-statement\src\main\java\org\apache\shardingsphere\sql\parser\sql\dialect\statement\opengauss\dml\OpenGaussDeleteStatement.java,0,1,0,5,0,6
 shardingsphere-master\shardingsphere-master\shardingsphere-sql-parser\shardingsphere-sql-parser-statement\src\main\java\org\apache\shardingsphere\sql\parser\sql\dialect\statement\opengauss\ddl\OpenGaussAlterConversionStatement.java,0,1,0,5,0,6
 shardingsphere-master\shardingsphere-master\shardingsphere-kernel\shardingsphere-data-pipeline\shardingsphere-data-pipeline-dialect\shardingsphere-data-pipeline-opengauss\src\main\java\org\apache\shardingsphere\data\pipeline\opengauss\ingest\wal\decode\MppdbDecodingPlugin.java,0,37,1,24,0,62
 shardingsphere-master\shardingsphere-master\shardingsphere-sql-parser\shardingsphere-sql-parser-statement\src\main\java\org\apache\shardingsphere\sql\parser\sql\common\segment\dml\expr\complex\CommonTableExpressionSegment.java,0,10,0,6,3,19
 shardingsphere-master\shardingsphere-master\shardingsphere-infra\shardingsphere-infra-binder\src\main\java\org\apache\shardingsphere\infra\binder\statement\ddl\CreateTableStatementContext.java,0,13,0,15,0,28
 shardingsphere-master\shardingsphere-master\shardingsphere-infra\shardingsphere-infra-common\src\main\java\org\apache\shardingsphere\infra\distsql\exception\rule\DuplicateAlgorithmException.java,0,7,0,4,0,11
 shardingsphere-master\shardingsphere-master\shardingsphere-infra\shardingsphere-infra-binder\src\main\java\org\apache\shardingsphere\infra\binder\segment\table\TablesContext.java,0,98,0,75,0,173
 shardingsphere-master\shardingsphere-master\shardingsphere-infra\shardingsphere-infra-common\src\test\java\org\apache\shardingsphere\infra\datasource\pool\metadata\DataSourcePoolMetaDataFactoryTest.java,0,5,0,4,0,9
 shardingsphere-master\shardingsphere-master\shardingsphere-infra\shardingsphere-infra-rewrite\src\main\java\org\apache\shardingsphere\infra\rewrite\parameter\builder\impl\GroupedParameterBuilder.java,0,16,0,4,0,20
 shardingsphere-master\shardingsphere-master\shardingsphere-db-protocol\shardingsphere-db-protocol-mysql\src\main\java\org\apache\shardingsphere\db\protocol\mysql\packet\handshake\MySQLRandomGenerator.java,0,12,0,4,0,16
 shardingsphere-master\shardingsphere-master\shardingsphere-infra\shardingsphere-infra-binder\src\main\java\org\apache\shardingsphere\infra\binder\segment\select\orderby\engine\OrderByContextEngine.java,0,15,0,22,0,37
 shardingsphere-master\shardingsphere-master\shardingsphere-features\shardingsphere-encrypt\shardingsphere-encrypt-distsql\shardingsphere-encrypt-distsql-handler\src\main\java\org\apache\shardingsphere\encrypt\distsql\handler\update\AlterEncryptRuleStatementUpdater.java,0,44,0,38,0,82
 shardingsphere-master\shardingsphere-master\shardingsphere-infra\shardingsphere-infra-federation\shardingsphere-infra-federation-optimizer\src\main\java\org\apache\shardingsphere\infra\federation\optimizer\converter\segment\orderby\item\ExpressionOrderByItemConverter.java,0,6,0,7,0,13
 shardingsphere-master\shardingsphere-master\shardingsphere-sql-parser\shardingsphere-sql-parser-statement\src\main\java\org\apache\shardingsphere\sql\parser\sql\dialect\statement\postgresql\dal\PostgreSQLLoadStatement.java,0,1,0,5,0,6
 shardingsphere-master\shardingsphere-master\shardingsphere-infra\shardingsphere-infra-executor\src\test\java\org\apache\shardingsphere\infra\executor\sql\hook\SPISQLExecutionHookTest.java,0,12,0,3,0,15
 shardingsphere-master\shardingsphere-master\shardingsphere-features\shardingsphere-encrypt\shardingsphere-encrypt-core\src\test\java\org\apache\shardingsphere\encrypt\yaml\swapper\EncryptRuleConfigurationYamlSwapperTest.java,0,29,0,22,0,51
 shardingsphere-master\shardingsphere-master\shardingsphere-db-protocol\shardingsphere-db-protocol-postgresql\src\main\java\org\apache\shardingsphere\db\protocol\postgresql\packet\command\query\extended\bind\protocol\PostgreSQLArrayParameterDecoder.java,0,27,0,18,0,45
 shardingsphere-master\shardingsphere-master\shardingsphere-infra\shardingsphere-infra-common\src\main\java\org\apache\shardingsphere\infra\distsql\exception\rule\DuplicateRuleException.java,0,16,0,7,0,23
 shardingsphere-master\shardingsphere-master\shardingsphere-sql-parser\shardingsphere-sql-parser-statement\src\main\java\org\apache\shardingsphere\sql\parser\sql\common\segment\dml\item\SubqueryProjectionSegment.java,0,11,0,6,2,19
 shardingsphere-master\shardingsphere-master\shardingsphere-sql-parser\shardingsphere-sql-parser-statement\src\main\java\org\apache\shardingsphere\sql\parser\sql\dialect\statement\mysql\ddl\MySQLAlterTableStatement.java,0,1,0,4,0,5
 shardingsphere-master\shardingsphere-master\shardingsphere-distsql\shardingsphere-distsql-statement\src\main\java\org\apache\shardingsphere\distsql\parser\statement\ral\common\updatable\CreateTrafficRuleStatement.java,0,2,0,2,0,4
 shardingsphere-master\shardingsphere-master\shardingsphere-mode\shardingsphere-mode-type\shardingsphere-cluster-mode\shardingsphere-cluster-mode-repository\shardingsphere-cluster-mode-repository-provider\shardingsphere-cluster-mode-repository-zookeeper-curator\src\main\java\org\apache\shardingsphere\mode\repository\cluster\zookeeper\props\ZookeeperPropertyKey.java,0,13,0,3,0,16
 shardingsphere-master\shardingsphere-master\shardingsphere-infra\shardingsphere-infra-common\src\main\java\org\apache\shardingsphere\infra\hint\SQLHintUtils.java,0,15,1,4,0,20
 shardingsphere-master\shardingsphere-master\shardingsphere-features\shardingsphere-sharding\shardingsphere-sharding-spring\shardingsphere-sharding-spring-boot-starter\src\main\java\org\apache\shardingsphere\sharding\spring\boot\rule\YamlShardingRuleSpringBootConfiguration.java,0,3,0,2,0,5
 shardingsphere-master\shardingsphere-master\shardingsphere-infra\shardingsphere-infra-rewrite\src\test\java\org\apache\shardingsphere\infra\rewrite\sql\impl\DefaultSQLBuilderTest.java,0,10,0,4,0,14
 shardingsphere-master\shardingsphere-master\shardingsphere-test\shardingsphere-parser-test\src\main\java\org\apache\shardingsphere\test\sql\parser\parameterized\asserts\statement\distsql\rql\impl\ShowRulesStatementAssert.java,0,30,0,97,0,127
 shardingsphere-master\shardingsphere-master\shardingsphere-kernel\shardingsphere-transaction\shardingsphere-transaction-type\shardingsphere-transaction-xa\shardingsphere-transaction-xa-core\src\test\java\org\apache\shardingsphere\transaction\xa\jta\connection\dialect\MariaDBXAConnectionWrapperTest.java,0,10,0,7,0,17
 shardingsphere-master\shardingsphere-master\shardingsphere-features\shardingsphere-shadow\shardingsphere-shadow-distsql\shardingsphere-shadow-distsql-statement\src\main\java\org\apache\shardingsphere\shadow\distsql\parser\segment\ShadowAlgorithmSegment.java,0,7,0,2,0,9
 shardingsphere-master\shardingsphere-master\shardingsphere-proxy\shardingsphere-proxy-backend\src\test\java\org\apache\shardingsphere\proxy\backend\text\distsql\fixture\FixtureRuleDefinitionCreateUpdater.java,0,9,2,6,0,17
 shardingsphere-master\shardingsphere-master\shardingsphere-sql-parser\shardingsphere-sql-parser-statement\src\main\java\org\apache\shardingsphere\sql\parser\sql\common\value\props\PropertiesValue.java,0,3,0,1,1,5
 shardingsphere-master\shardingsphere-master\shardingsphere-test\shardingsphere-parser-test\src\main\java\org\apache\shardingsphere\test\sql\parser\parameterized\jaxb\cases\domain\statement\distsql\rdl\drop\DropDataBaseDiscoveryRuleStatementTestCase.java,0,5,0,4,0,9
 shardingsphere-master\shardingsphere-master\shardingsphere-test\shardingsphere-integration-test\shardingsphere-integration-test-suite\src\test\java\org\apache\shardingsphere\test\integration\framework\runner\ShardingSphereIntegrationTestParameterized.java,0,8,0,10,0,18
 shardingsphere-master\shardingsphere-master\shardingsphere-infra\shardingsphere-infra-common\src\test\java\org\apache\shardingsphere\infra\datanode\DataNodesTest.java,0,35,0,15,0,50
 shardingsphere-master\shardingsphere-master\shardingsphere-db-protocol\shardingsphere-db-protocol-mysql\src\test\java\org\apache\shardingsphere\db\protocol\mysql\packet\command\query\binary\execute\protocol\MySQLInt4BinaryProtocolValueTest.java,0,6,0,2,0,8
 shardingsphere-master\shardingsphere-master\shardingsphere-sql-parser\shardingsphere-sql-parser-spi\src\main\java\org\apache\shardingsphere\sql\parser\spi\DatabaseTypedSQLParserFacade.java,0,2,0,1,0,3
 shardingsphere-master\shardingsphere-master\shardingsphere-proxy\shardingsphere-proxy-frontend\shardingsphere-proxy-frontend-core\src\main\java\org\apache\shardingsphere\proxy\frontend\state\ProxyState.java,0,3,0,3,0,6
 shardingsphere-master\shardingsphere-master\examples\example-core\example-spring-jpa\src\main\java\org\apache\shardingsphere\example\core\jpa\repository\AccountRepositoryImpl.java,40,18,0,4,0,22
 shardingsphere-master\shardingsphere-master\examples\shardingsphere-example-generator\src\main\java\org\apache\shardingsphere\example\generator\core\impl\ProxyExampleGenerator.java,0,13,0,9,0,22
 shardingsphere-master\shardingsphere-master\shardingsphere-infra\shardingsphere-infra-executor\src\main\java\org\apache\shardingsphere\infra\executor\sql\prepare\driver\vertx\ExecutorVertxStatementManager.java,0,1,0,3,0,4
 shardingsphere-master\shardingsphere-master\shardingsphere-db-protocol\shardingsphere-db-protocol-mysql\src\main\java\org\apache\shardingsphere\db\protocol\mysql\packet\command\query\binary\execute\protocol\MySQLInt2BinaryProtocolValue.java,0,3,0,3,0,6
 shardingsphere-master\shardingsphere-master\shardingsphere-features\shardingsphere-sharding\shardingsphere-sharding-distsql\shardingsphere-sharding-distsql-statement\src\main\java\org\apache\shardingsphere\scaling\distsql\statement\DropScalingStatement.java,0,2,0,2,0,4
 shardingsphere-master\shardingsphere-master\shardingsphere-infra\shardingsphere-infra-common\src\test\java\org\apache\shardingsphere\infra\database\type\DatabaseTypeRegistryTest.java,0,29,0,11,0,40
 shardingsphere-master\shardingsphere-master\shardingsphere-features\shardingsphere-readwrite-splitting\shardingsphere-readwrite-splitting-core\src\main\java\org\apache\shardingsphere\readwritesplitting\algorithm\loadbalance\RoundRobinReplicaLoadBalanceAlgorithm.java,0,10,0,7,0,17
 shardingsphere-master\shardingsphere-master\shardingsphere-features\shardingsphere-sharding\shardingsphere-sharding-core\src\test\java\org\apache\shardingsphere\sharding\rewrite\context\ShardingSQLRewriteContextDecoratorTest.java,0,14,0,10,0,24
 shardingsphere-master\shardingsphere-master\shardingsphere-proxy\shardingsphere-proxy-frontend\shardingsphere-proxy-frontend-postgresql\src\test\java\org\apache\shardingsphere\proxy\frontend\postgresql\command\query\extended\sync\PostgreSQLComSyncExecutorTest.java,0,8,0,7,0,15
 shardingsphere-master\shardingsphere-master\shardingsphere-test\shardingsphere-parser-test\src\main\java\org\apache\shardingsphere\test\sql\parser\parameterized\jaxb\cases\domain\statement\dal\ShowCollationStatementTestCase.java,0,2,0,4,0,6
 shardingsphere-master\shardingsphere-master\shardingsphere-test\shardingsphere-integration-test\shardingsphere-integration-test-suite\src\test\java\org\apache\shardingsphere\test\integration\cases\value\SQLValue.java,0,24,0,11,0,35
 shardingsphere-master\shardingsphere-master\shardingsphere-kernel\shardingsphere-data-pipeline\shardingsphere-data-pipeline-core\src\main\java\org\apache\shardingsphere\data\pipeline\core\sqlbuilder\AbstractPipelineSQLBuilder.java,140,67,0,27,0,94
 shardingsphere-master\shardingsphere-master\shardingsphere-test\shardingsphere-pipeline-test\src\test\java\org\apache\shardingsphere\data\pipeline\core\metadata\model\PipelineTableMetaDataTest.java,0,9,0,4,0,13
 shardingsphere-master\shardingsphere-master\shardingsphere-features\shardingsphere-sharding\shardingsphere-sharding-distsql\shardingsphere-sharding-distsql-handler\src\main\java\org\apache\shardingsphere\sharding\distsql\handler\query\UnusedShardingKeyGeneratorsQueryResultSet.java,0,34,0,18,0,52
 shardingsphere-master\shardingsphere-master\shardingsphere-kernel\shardingsphere-data-pipeline\shardingsphere-data-pipeline-core\src\main\java\org\apache\shardingsphere\data\pipeline\core\datasource\PipelineDataSourceManager.java,0,11,0,8,0,19
 shardingsphere-master\shardingsphere-master\shardingsphere-sql-parser\shardingsphere-sql-parser-statement\src\main\java\org\apache\shardingsphere\sql\parser\sql\dialect\statement\mysql\dal\MySQLCreateResourceGroupStatement.java,0,2,0,5,0,7
 shardingsphere-master\shardingsphere-master\shardingsphere-kernel\shardingsphere-traffic\shardingsphere-traffic-core\src\test\java\org\apache\shardingsphere\traffic\algorithm\loadbalance\RoundRobinTrafficLoadBalanceAlgorithmTest.java,0,16,1,7,0,24
 shardingsphere-master\shardingsphere-master\shardingsphere-db-protocol\shardingsphere-db-protocol-mysql\src\main\java\org\apache\shardingsphere\db\protocol\mysql\packet\binlog\row\column\value\time\MySQLTime2BinlogProtocolValue.java,0,12,0,9,0,21
 shardingsphere-master\shardingsphere-master\shardingsphere-sql-parser\shardingsphere-sql-parser-statement\src\main\java\org\apache\shardingsphere\sql\parser\sql\dialect\statement\opengauss\dal\OpenGaussLoadStatement.java,0,1,0,5,0,6
 shardingsphere-master\shardingsphere-master\shardingsphere-test\shardingsphere-parser-test\src\main\java\org\apache\shardingsphere\test\sql\parser\parameterized\asserts\statement\dal\impl\MySQLUseStatementAssert.java,0,6,0,8,0,14
 shardingsphere-master\shardingsphere-master\shardingsphere-infra\shardingsphere-infra-common\src\test\java\org\apache\shardingsphere\infra\metadata\schema\loader\common\DataTypeLoaderTest.java,0,6,2,1,0,9
 shardingsphere-master\shardingsphere-master\shardingsphere-proxy\shardingsphere-proxy-frontend\shardingsphere-proxy-frontend-postgresql\src\test\java\org\apache\shardingsphere\proxy\frontend\postgresql\command\query\extended\PostgreSQLBatchedStatementsExecutorTest.java,0,38,3,29,0,70
 shardingsphere-master\shardingsphere-master\shardingsphere-test\shardingsphere-integration-test\shardingsphere-integration-test-suite\src\test\java\org\apache\shardingsphere\test\integration\framework\runner\parallel\annotaion\ParallelRuntimeStrategy.java,0,2,0,2,0,4
 shardingsphere-master\shardingsphere-master\shardingsphere-mode\shardingsphere-mode-type\shardingsphere-cluster-mode\shardingsphere-cluster-mode-core\src\test\java\org\apache\shardingsphere\mode\manager\cluster\coordinator\registry\process\ProcessListClusterPersistRepositoryFixture.java,0,21,4,10,0,35
 shardingsphere-master\shardingsphere-master\shardingsphere-mode\shardingsphere-mode-type\shardingsphere-standalone-mode\shardingsphere-standalone-mode-repository\shardingsphere-standalone-mode-repository-provider\shardingsphere-standalone-mode-repository-file\src\main\java\org\apache\shardingsphere\mode\repository\standalone\file\FileRepositoryDeleteVisitor.java,0,8,0,5,0,13
 shardingsphere-master\shardingsphere-master\shardingsphere-test\shardingsphere-integration-scaling-test\shardingsphere-integration-scaling-test-mysql\src\test\java\org\apache\shardingsphere\integration\scaling\test\mysql\util\ScalingUtil.java,0,5,0,1,0,6
 shardingsphere-master\shardingsphere-master\shardingsphere-sql-parser\shardingsphere-sql-parser-statement\src\main\java\org\apache\shardingsphere\sql\parser\sql\dialect\statement\mysql\dal\MySQLShowColumnsStatement.java,0,9,0,8,3,20
 shardingsphere-master\shardingsphere-master\shardingsphere-infra\shardingsphere-infra-binder\src\main\java\org\apache\shardingsphere\infra\binder\statement\ddl\AlterViewStatementContext.java,0,6,0,8,0,14
 shardingsphere-master\shardingsphere-master\shardingsphere-mode\shardingsphere-mode-type\shardingsphere-cluster-mode\shardingsphere-cluster-mode-core\src\test\java\org\apache\shardingsphere\mode\manager\cluster\coordinator\lock\service\LockNodeTest.java,0,5,0,2,0,7
 shardingsphere-master\shardingsphere-master\shardingsphere-sql-parser\shardingsphere-sql-parser-statement\src\main\java\org\apache\shardingsphere\sql\parser\sql\common\statement\ddl\DDLStatement.java,0,0,0,1,0,1
 shardingsphere-master\shardingsphere-master\shardingsphere-infra\shardingsphere-infra-rewrite\src\test\java\org\apache\shardingsphere\infra\rewrite\sql\token\pojo\SQLTokenTest.java,0,18,0,4,0,22
 shardingsphere-master\shardingsphere-master\shardingsphere-test\shardingsphere-parser-test\src\main\java\org\apache\shardingsphere\test\sql\parser\parameterized\asserts\statement\dal\impl\MySQLChecksumTableStatementAssert.java,0,6,0,9,0,15
 shardingsphere-master\shardingsphere-master\shardingsphere-test\shardingsphere-parser-test\src\main\java\org\apache\shardingsphere\test\sql\parser\parameterized\asserts\statement\dal\impl\ShowCreateTableStatementAssert.java,0,5,1,7,0,13
 shardingsphere-master\shardingsphere-master\shardingsphere-infra\shardingsphere-infra-route\src\main\java\org\apache\shardingsphere\infra\route\engine\impl\PartialSQLRouteExecutor.java,0,24,0,16,0,40
 shardingsphere-master\shardingsphere-master\shardingsphere-features\shardingsphere-encrypt\shardingsphere-encrypt-distsql\shardingsphere-encrypt-distsql-handler\src\test\java\org\apache\shardingsphere\encrypt\distsql\handler\fixture\TestEncryptAlgorithm.java,0,8,1,4,0,13
 shardingsphere-master\shardingsphere-master\shardingsphere-features\shardingsphere-sharding\shardingsphere-sharding-distsql\shardingsphere-sharding-distsql-parser\src\main\java\org\apache\shardingsphere\sharding\distsql\parser\core\ShardingDistSQLLexer.java,0,4,0,3,0,7
 shardingsphere-master\shardingsphere-master\shardingsphere-features\shardingsphere-db-discovery\shardingsphere-db-discovery-core\src\main\java\org\apache\shardingsphere\dbdiscovery\yaml\swapper\DatabaseDiscoveryRuleConfigurationYamlSwapper.java,0,36,0,35,0,71
 shardingsphere-master\shardingsphere-master\shardingsphere-mode\shardingsphere-mode-type\shardingsphere-standalone-mode\shardingsphere-standalone-mode-core\src\test\java\org\apache\shardingsphere\mode\manager\standalone\yaml\PersistRepositoryConfigurationYamlSwapperEngineTest.java,0,10,1,12,0,23
 shardingsphere-master\shardingsphere-master\shardingsphere-infra\shardingsphere-infra-common\src\test\java\org\apache\shardingsphere\infra\datasource\props\DataSourcePropertiesValidatorTest.java,0,9,0,5,0,14
 shardingsphere-master\shardingsphere-master\shardingsphere-db-protocol\shardingsphere-db-protocol-postgresql\src\test\java\org\apache\shardingsphere\db\protocol\postgresql\packet\command\query\extended\bind\protocol\PostgreSQLUnspecifiedBinaryProtocolValueTest.java,0,11,0,7,0,18
 shardingsphere-master\shardingsphere-master\shardingsphere-jdbc\shardingsphere-jdbc-spring\shardingsphere-jdbc-spring-infra\shardingsphere-jdbc-spring-namespace-infra\src\main\java\org\apache\shardingsphere\spring\namespace\parser\ShardingSphereAlgorithmBeanDefinitionParser.java,0,31,0,32,0,63
 shardingsphere-master\shardingsphere-master\shardingsphere-infra\shardingsphere-infra-binder\src\main\java\org\apache\shardingsphere\infra\binder\statement\ddl\RenameTableStatementContext.java,0,9,0,9,0,18
 shardingsphere-master\shardingsphere-master\shardingsphere-test\shardingsphere-integration-driver-test\src\test\java\org\apache\shardingsphere\driver\sharding\YamlShardingIntegrateTest.java,36,18,0,11,0,29
 shardingsphere-master\shardingsphere-master\shardingsphere-sql-parser\shardingsphere-sql-parser-statement\src\main\java\org\apache\shardingsphere\sql\parser\sql\dialect\statement\postgresql\ddl\PostgreSQLAlterExtensionStatement.java,0,1,0,5,0,6
 shardingsphere-master\shardingsphere-master\shardingsphere-sql-parser\shardingsphere-sql-parser-statement\src\main\java\org\apache\shardingsphere\sql\parser\sql\dialect\statement\mysql\ddl\MySQLCreateTablespaceStatement.java,0,1,0,4,0,5
 shardingsphere-master\shardingsphere-master\shardingsphere-infra\shardingsphere-infra-merge\src\main\java\org\apache\shardingsphere\infra\merge\engine\merger\impl\TransparentResultMerger.java,0,3,0,4,0,7
 shardingsphere-master\shardingsphere-master\shardingsphere-features\shardingsphere-sharding\shardingsphere-sharding-core\src\main\java\org\apache\shardingsphere\sharding\yaml\swapper\rule\ShardingAutoTableRuleConfigurationYamlSwapper.java,0,19,0,18,0,37
 shardingsphere-master\shardingsphere-master\examples\shardingsphere-jdbc-example\single-feature-example\extension-example\custom-sharding-algortihm-example\class-based-sharding-algorithm-example\class-based-sharding-spring-boot-mybatis-example\src\main\java\org\apache\shardingsphere\example\extension\classbased\sharding\spring\boot\mybatis\fixture\ClassBasedOrderStandardShardingAlgorithmFixture.java,0,16,0,11,0,27
 shardingsphere-master\shardingsphere-master\shardingsphere-db-protocol\shardingsphere-db-protocol-postgresql\src\main\java\org\apache\shardingsphere\db\protocol\postgresql\packet\command\query\extended\bind\protocol\PostgreSQLInt8ArrayBinaryProtocolValue.java,0,11,0,9,0,20
 shardingsphere-master\shardingsphere-master\shardingsphere-infra\shardingsphere-infra-common\src\test\java\org\apache\shardingsphere\infra\metadata\rule\ShardingSphereRuleMetaDataTest.java,0,12,1,6,0,19
 shardingsphere-master\shardingsphere-master\shardingsphere-mode\shardingsphere-mode-core\src\test\java\org\apache\shardingsphere\mode\metadata\persist\service\ComputeNodePersistServiceTest.java,0,65,0,32,0,97
 shardingsphere-master\shardingsphere-master\shardingsphere-test\shardingsphere-parser-test\src\main\java\org\apache\shardingsphere\test\sql\parser\parameterized\jaxb\cases\domain\statement\ddl\DropProcedureStatementTestCase.java,0,0,0,3,0,3
 shardingsphere-master\shardingsphere-master\shardingsphere-mode\shardingsphere-mode-type\shardingsphere-standalone-mode\shardingsphere-standalone-mode-core\src\main\java\org\apache\shardingsphere\mode\manager\standalone\lock\StandaloneLockContext.java,0,9,0,5,0,14
 shardingsphere-master\shardingsphere-master\shardingsphere-features\shardingsphere-encrypt\shardingsphere-encrypt-core\src\main\java\org\apache\shardingsphere\encrypt\rewrite\token\generator\InsertCipherNameTokenGenerator.java,0,14,1,17,0,32
 shardingsphere-master\shardingsphere-master\shardingsphere-mode\shardingsphere-mode-core\src\main\java\org\apache\shardingsphere\mode\metadata\persist\service\SchemaVersionPersistService.java,0,20,0,9,0,29
 shardingsphere-master\shardingsphere-master\shardingsphere-kernel\shardingsphere-traffic\shardingsphere-traffic-core\src\test\java\org\apache\shardingsphere\traffic\algorithm\traffic\segment\SQLRegexTrafficAlgorithmTest.java,0,20,0,13,0,33
 shardingsphere-master\shardingsphere-master\shardingsphere-sql-parser\shardingsphere-sql-parser-statement\src\main\java\org\apache\shardingsphere\sql\parser\sql\dialect\statement\opengauss\ddl\OpenGaussAlterFunctionStatement.java,0,1,0,5,0,6
 shardingsphere-master\shardingsphere-master\shardingsphere-kernel\shardingsphere-data-pipeline\shardingsphere-data-pipeline-dialect\shardingsphere-data-pipeline-mysql\src\main\java\org\apache\shardingsphere\data\pipeline\mysql\ingest\binlog\event\PlaceholderEvent.java,0,1,0,2,0,3
 shardingsphere-master\shardingsphere-master\shardingsphere-test\shardingsphere-parser-test\src\main\java\org\apache\shardingsphere\test\sql\parser\parameterized\jaxb\cases\domain\statement\dal\AlterResourceGroupStatementTestCase.java,0,4,0,5,0,9
 shardingsphere-master\shardingsphere-master\shardingsphere-kernel\shardingsphere-authority\shardingsphere-authority-core\src\main\java\org\apache\shardingsphere\authority\provider\schema\SchemaPrivilegesPermittedAuthorityProviderAlgorithm.java,0,23,0,11,0,34
 shardingsphere-master\shardingsphere-master\shardingsphere-test\shardingsphere-integration-test\shardingsphere-integration-test-suite\src\test\java\org\apache\shardingsphere\test\integration\framework\runner\parallel\ParallelRunnerExecutorFactory.java,0,11,0,8,0,19
 shardingsphere-master\shardingsphere-master\shardingsphere-features\shardingsphere-sharding\shardingsphere-sharding-core\src\test\java\org\apache\shardingsphere\sharding\route\engine\validator\ddl\ShardingDropIndexStatementValidatorTest.java,0,70,6,54,0,130
 shardingsphere-master\shardingsphere-master\shardingsphere-infra\shardingsphere-infra-federation\shardingsphere-infra-federation-optimizer\src\main\java\org\apache\shardingsphere\infra\federation\optimizer\converter\segment\from\impl\JoinTableConverter.java,0,23,0,18,0,41
 shardingsphere-master\shardingsphere-master\shardingsphere-jdbc\shardingsphere-jdbc-core\src\test\java\org\apache\shardingsphere\driver\jdbc\core\statement\ShadowPreparedStatementTest.java,0,70,19,31,0,120
 shardingsphere-master\shardingsphere-master\shardingsphere-proxy\shardingsphere-proxy-backend\src\main\java\org\apache\shardingsphere\proxy\backend\text\database\DatabaseOperateBackendHandlerFactory.java,0,9,0,8,0,17
 shardingsphere-master\shardingsphere-master\shardingsphere-agent\shardingsphere-agent-api\src\main\java\org\apache\shardingsphere\agent\spi\boot\PluginBootService.java,0,2,0,1,0,3
 shardingsphere-master\shardingsphere-master\shardingsphere-kernel\shardingsphere-traffic\shardingsphere-traffic-core\src\main\java\org\apache\shardingsphere\traffic\yaml\swapper\TrafficStrategyConfigurationYamlSwapper.java,0,7,0,9,0,16
 shardingsphere-master\shardingsphere-master\shardingsphere-infra\shardingsphere-infra-common\src\test\java\org\apache\shardingsphere\infra\database\metadata\url\JdbcUrlAppenderTest.java,0,8,0,3,0,11
 shardingsphere-master\shardingsphere-master\examples\shardingsphere-jdbc-example\single-feature-example\readwrite-splitting-example\readwrite-splitting-spring-boot-mybatis-example\src\main\java\org\apache\shardingsphere\example\readwrite\splitting\spring\boot\mybatis\ReadwriteSplittingSpringBootMybatisExample.java,9,7,1,6,0,14
 shardingsphere-master\shardingsphere-master\shardingsphere-jdbc\shardingsphere-jdbc-core\src\main\java\org\apache\shardingsphere\driver\jdbc\unsupported\AbstractUnsupportedGeneratedKeysResultSet.java,193,58,0,21,0,79
 shardingsphere-master\shardingsphere-master\shardingsphere-features\shardingsphere-sharding\shardingsphere-sharding-distsql\shardingsphere-sharding-distsql-handler\src\main\java\org\apache\shardingsphere\sharding\distsql\handler\enums\ShardingStrategyLevelType.java,0,4,0,1,0,5
 shardingsphere-master\shardingsphere-master\shardingsphere-test\shardingsphere-parser-test\src\main\java\org\apache\shardingsphere\test\sql\parser\parameterized\asserts\statement\distsql\ral\impl\common\updatable\LabelInstanceStatementAssert.java,0,5,0,8,0,13
 shardingsphere-master\shardingsphere-master\shardingsphere-test\shardingsphere-parser-test\src\main\java\org\apache\shardingsphere\test\sql\parser\parameterized\jaxb\cases\domain\statement\distsql\ral\scaling\StopScalingSourceWritingStatementTestCase.java,0,3,0,4,0,7
 shardingsphere-master\shardingsphere-master\examples\shardingsphere-jdbc-example\single-feature-example\extension-example\custom-sharding-algortihm-example\spi-based-sharding-algorithm-example\spi-based-sharding-spring-namespace-jpa-example\src\main\java\org\apache\shardingsphere\example\extension\spibased\sharding\spring\namespace\jpa\fixture\SPIBasedDatasourceStandardShardingAlgorithmFixture.java,0,8,1,8,0,17
 shardingsphere-master\shardingsphere-master\shardingsphere-db-protocol\shardingsphere-db-protocol-postgresql\src\main\java\org\apache\shardingsphere\db\protocol\postgresql\packet\generic\PostgreSQLCommandCompletePacket.java,0,11,0,7,0,18
 shardingsphere-master\shardingsphere-master\shardingsphere-infra\shardingsphere-infra-common\src\main\java\org\apache\shardingsphere\infra\yaml\engine\YamlEngine.java,0,21,0,17,0,38
 shardingsphere-master\shardingsphere-master\shardingsphere-test\shardingsphere-parser-test\src\main\java\org\apache\shardingsphere\test\sql\parser\parameterized\jaxb\cases\domain\segment\impl\function\ExpectedFunction.java,0,10,0,7,0,17
 shardingsphere-master\shardingsphere-master\shardingsphere-test\shardingsphere-parser-test\src\main\java\org\apache\shardingsphere\test\sql\parser\parameterized\jaxb\cases\domain\statement\ddl\DropTriggerStatementTestCase.java,0,0,0,3,0,3
 shardingsphere-master\shardingsphere-master\examples\shardingsphere-jdbc-example\single-feature-example\cluster-mode-example\cluster-mode-raw-jdbc-example\src\main\java\org\apache\shardingsphere\example\cluster\mode\raw\jdbc\config\local\LocalShardingDatabasesAndTablesConfiguration.java,0,23,0,17,0,40
 shardingsphere-master\shardingsphere-master\shardingsphere-proxy\shardingsphere-proxy-backend\src\main\java\org\apache\shardingsphere\proxy\backend\response\header\query\impl\OpenGaussQueryHeaderBuilder.java,0,9,0,9,0,18
 shardingsphere-master\shardingsphere-master\shardingsphere-test\shardingsphere-parser-test\src\main\java\org\apache\shardingsphere\test\sql\parser\parameterized\jaxb\cases\domain\statement\distsql\rdl\drop\DropShadowRuleStatementTestCase.java,0,4,0,3,0,7
 shardingsphere-master\shardingsphere-master\shardingsphere-sql-parser\shardingsphere-sql-parser-statement\src\main\java\org\apache\shardingsphere\sql\parser\sql\dialect\statement\mysql\ddl\MySQLCreateViewStatement.java,0,4,0,5,1,10
 shardingsphere-master\shardingsphere-master\shardingsphere-sql-parser\shardingsphere-sql-parser-statement\src\main\java\org\apache\shardingsphere\sql\parser\sql\dialect\statement\opengauss\ddl\OpenGaussCreateDatabaseStatement.java,0,1,0,5,0,6
 shardingsphere-master\shardingsphere-master\examples\example-core\example-api\src\main\java\org\apache\shardingsphere\example\core\api\entity\Address.java,25,19,0,1,0,20
 shardingsphere-master\shardingsphere-master\shardingsphere-infra\shardingsphere-infra-common\src\main\java\org\apache\shardingsphere\infra\rule\builder\DefaultRuleConfigurationBuilder.java,0,4,0,2,0,6
 shardingsphere-master\shardingsphere-master\shardingsphere-mode\shardingsphere-mode-core\src\test\java\org\apache\shardingsphere\mode\metadata\persist\fixture\YamlRuleConfigurationSwapperFixture.java,0,10,0,6,0,16
 shardingsphere-master\shardingsphere-master\shardingsphere-sql-parser\shardingsphere-sql-parser-statement\src\main\java\org\apache\shardingsphere\sql\parser\sql\dialect\statement\oracle\dcl\OracleGrantStatement.java,0,1,0,4,0,5
 shardingsphere-master\shardingsphere-master\shardingsphere-proxy\shardingsphere-proxy-backend\src\main\java\org\apache\shardingsphere\proxy\backend\exception\DBDropNotExistsException.java,0,3,0,1,0,4
 shardingsphere-master\shardingsphere-master\shardingsphere-features\shardingsphere-shadow\shardingsphere-shadow-core\src\main\java\org\apache\shardingsphere\shadow\checker\AbstractShadowRuleConfigurationChecker.java,70,45,0,28,0,73
 shardingsphere-master\shardingsphere-master\shardingsphere-kernel\shardingsphere-data-pipeline\shardingsphere-data-pipeline-dialect\shardingsphere-data-pipeline-mysql\src\main\java\org\apache\shardingsphere\data\pipeline\mysql\ingest\client\ServerInfo.java,0,2,0,1,0,3
 shardingsphere-master\shardingsphere-master\shardingsphere-jdbc\shardingsphere-jdbc-spring\shardingsphere-jdbc-core-spring\shardingsphere-jdbc-core-spring-namespace\src\main\java\org\apache\shardingsphere\spring\namespace\tag\TransactionTypeScannerBeanDefinitionTag.java,0,3,0,1,0,4
 shardingsphere-master\shardingsphere-master\shardingsphere-features\shardingsphere-shadow\shardingsphere-shadow-core\src\main\java\org\apache\shardingsphere\shadow\route\engine\dml\ShadowDeleteStatementRoutingEngine.java,0,27,0,16,0,43
 shardingsphere-master\shardingsphere-master\shardingsphere-db-protocol\shardingsphere-db-protocol-postgresql\src\test\java\org\apache\shardingsphere\db\protocol\postgresql\packet\command\query\extended\bind\protocol\PostgreSQLInt8BinaryProtocolValueTest.java,0,7,0,4,0,11
 shardingsphere-master\shardingsphere-master\shardingsphere-kernel\shardingsphere-data-pipeline\shardingsphere-data-pipeline-core\src\main\java\org\apache\shardingsphere\data\pipeline\core\execute\FinishedCheckJobExecutor.java,0,9,1,5,0,15
 shardingsphere-master\shardingsphere-master\shardingsphere-db-protocol\shardingsphere-db-protocol-postgresql\src\test\java\org\apache\shardingsphere\db\protocol\postgresql\packet\generic\PostgreSQLCommandCompletePacketTest.java,0,10,0,9,0,19
 shardingsphere-master\shardingsphere-master\shardingsphere-sql-parser\shardingsphere-sql-parser-statement\src\main\java\org\apache\shardingsphere\sql\parser\sql\dialect\statement\sqlserver\ddl\SQLServerDropProcedureStatement.java,0,1,0,5,0,6
 shardingsphere-master\shardingsphere-master\shardingsphere-features\shardingsphere-sharding\shardingsphere-sharding-core\src\test\java\org\apache\shardingsphere\sharding\rule\builder\ShardingRuleBuilderTest.java,0,18,0,5,0,23
 shardingsphere-master\shardingsphere-master\shardingsphere-test\shardingsphere-parser-test\src\main\java\org\apache\shardingsphere\test\sql\parser\parameterized\jaxb\cases\domain\statement\distsql\ral\RefreshTableMetadataStatementTestCase.java,0,5,0,4,0,9
 shardingsphere-master\shardingsphere-master\shardingsphere-proxy\shardingsphere-proxy-backend\src\main\java\org\apache\shardingsphere\proxy\backend\exception\BackendException.java,5,1,1,1,0,3
 shardingsphere-master\shardingsphere-master\shardingsphere-kernel\shardingsphere-authority\shardingsphere-authority-core\src\test\java\org\apache\shardingsphere\authority\yaml\swapper\AuthorityRuleConfigurationYamlSwapperTest.java,0,31,0,19,0,50
 shardingsphere-master\shardingsphere-master\shardingsphere-db-protocol\shardingsphere-db-protocol-postgresql\src\test\java\org\apache\shardingsphere\db\protocol\postgresql\packet\command\query\extended\describe\PostgreSQLComDescribePacketTest.java,0,10,0,7,0,17
 shardingsphere-master\shardingsphere-master\shardingsphere-sql-parser\shardingsphere-sql-parser-statement\src\main\java\org\apache\shardingsphere\sql\parser\sql\common\constant\OrderDirection.java,0,2,0,1,0,3
 shardingsphere-master\shardingsphere-master\examples\example-core\example-api\src\main\java\org\apache\shardingsphere\example\core\api\DataSourceUtil.java,0,13,1,2,0,16
 shardingsphere-master\shardingsphere-master\shardingsphere-proxy\shardingsphere-proxy-backend\src\main\java\org\apache\shardingsphere\proxy\backend\text\admin\postgresql\executor\PostgreSQLSetCharsetExecutor.java,0,14,0,9,0,23
 shardingsphere-master\shardingsphere-master\shardingsphere-proxy\shardingsphere-proxy-bootstrap\src\test\java\org\apache\shardingsphere\proxy\fixture\YamlRuleConfigurationSwapperFixture.java,0,9,0,6,0,15
 shardingsphere-master\shardingsphere-master\shardingsphere-infra\shardingsphere-infra-binder\src\main\java\org\apache\shardingsphere\infra\binder\statement\dal\ShowIndexStatementContext.java,0,10,0,8,0,18
 shardingsphere-master\shardingsphere-master\shardingsphere-proxy\shardingsphere-proxy-backend\src\main\java\org\apache\shardingsphere\proxy\backend\text\admin\mysql\executor\ShowVersionExecutor.java,0,9,0,8,0,17
 shardingsphere-master\shardingsphere-master\shardingsphere-test\shardingsphere-parser-test\src\main\java\org\apache\shardingsphere\test\sql\parser\parameterized\asserts\segment\packages\PackageAssert.java,0,7,0,13,0,20
 shardingsphere-master\shardingsphere-master\shardingsphere-features\shardingsphere-db-discovery\shardingsphere-db-discovery-core\src\main\java\org\apache\shardingsphere\dbdiscovery\yaml\config\rule\YamlDatabaseDiscoveryHeartBeatConfiguration.java,0,3,0,2,0,5
 shardingsphere-master\shardingsphere-master\shardingsphere-kernel\shardingsphere-data-pipeline\shardingsphere-data-pipeline-spi\src\main\java\org\apache\shardingsphere\data\pipeline\spi\ingest\channel\PipelineChannelFactory.java,0,4,0,5,0,9
 shardingsphere-master\shardingsphere-master\shardingsphere-jdbc\shardingsphere-jdbc-spring\shardingsphere-jdbc-spring-infra\shardingsphere-jdbc-spring-namespace-infra\src\main\java\org\apache\shardingsphere\spring\namespace\factorybean\ShardingSphereAlgorithmFactoryBean.java,24,12,0,4,0,16
 shardingsphere-master\shardingsphere-master\shardingsphere-test\shardingsphere-parser-test\src\main\java\org\apache\shardingsphere\test\sql\parser\parameterized\jaxb\cases\domain\statement\dal\ShowColumnsStatementTestCase.java,0,6,0,6,0,12
 shardingsphere-master\shardingsphere-master\shardingsphere-kernel\shardingsphere-data-pipeline\shardingsphere-data-pipeline-dialect\shardingsphere-data-pipeline-mysql\src\main\java\org\apache\shardingsphere\data\pipeline\mysql\check\datasource\MySQLDataSourceChecker.java,0,32,1,16,0,49
 shardingsphere-master\shardingsphere-master\shardingsphere-features\shardingsphere-sharding\shardingsphere-sharding-distsql\shardingsphere-sharding-distsql-statement\src\main\java\org\apache\shardingsphere\sharding\distsql\parser\statement\AlterDefaultShardingStrategyStatement.java,0,12,0,3,0,15
 shardingsphere-master\shardingsphere-master\shardingsphere-jdbc\shardingsphere-jdbc-core\src\main\java\org\apache\shardingsphere\driver\jdbc\core\resultset\ShardingSphereResultSet.java,0,138,0,66,0,204
 shardingsphere-master\shardingsphere-master\shardingsphere-features\shardingsphere-sharding\shardingsphere-sharding-core\src\main\java\org\apache\shardingsphere\sharding\route\engine\condition\Column.java,0,14,6,2,0,22
 shardingsphere-master\shardingsphere-master\shardingsphere-mode\shardingsphere-mode-core\src\test\java\org\apache\shardingsphere\mode\metadata\persist\MetaDataPersistServiceTest.java,0,45,1,23,0,69
 shardingsphere-master\shardingsphere-master\shardingsphere-features\shardingsphere-encrypt\shardingsphere-encrypt-core\src\test\java\org\apache\shardingsphere\encrypt\fixture\TestQueryAssistedEncryptAlgorithm.java,0,9,1,5,0,15
 shardingsphere-master\shardingsphere-master\shardingsphere-features\shardingsphere-readwrite-splitting\shardingsphere-readwrite-splitting-distsql\shardingsphere-readwrite-splitting-distsql-handler\src\main\java\org\apache\shardingsphere\readwritesplitting\distsql\handler\converter\ReadwriteSplittingRuleStatementConverter.java,0,25,0,23,0,48
 shardingsphere-master\shardingsphere-master\shardingsphere-test\shardingsphere-pipeline-test\src\test\java\org\apache\shardingsphere\data\pipeline\api\impl\RuleAlteredJobAPIImplTest.java,0,76,1,52,0,129
 shardingsphere-master\shardingsphere-master\shardingsphere-features\shardingsphere-shadow\shardingsphere-shadow-core\src\main\java\org\apache\shardingsphere\shadow\route\engine\ShadowRouteEngineFactory.java,0,18,0,25,0,43
 shardingsphere-master\shardingsphere-master\shardingsphere-infra\shardingsphere-infra-common\src\main\java\org\apache\shardingsphere\infra\datanode\DataNodes.java,0,20,0,10,0,30
 shardingsphere-master\shardingsphere-master\shardingsphere-features\shardingsphere-sharding\shardingsphere-sharding-core\src\main\java\org\apache\shardingsphere\sharding\route\engine\condition\value\RangeShardingConditionValue.java,0,8,0,2,0,10
 shardingsphere-master\shardingsphere-master\shardingsphere-infra\shardingsphere-infra-executor\src\main\java\org\apache\shardingsphere\infra\executor\sql\context\ExecutionContext.java,0,8,0,1,0,9
 shardingsphere-master\shardingsphere-master\shardingsphere-features\shardingsphere-sharding\shardingsphere-sharding-core\src\main\java\org\apache\shardingsphere\sharding\algorithm\sharding\classbased\ClassBasedShardingAlgorithm.java,0,24,1,22,0,47
 shardingsphere-master\shardingsphere-master\shardingsphere-features\shardingsphere-sharding\shardingsphere-sharding-core\src\test\java\org\apache\shardingsphere\sharding\route\engine\condition\generator\impl\ConditionValueInOperatorGeneratorTest.java,0,22,0,20,0,42
 shardingsphere-master\shardingsphere-master\shardingsphere-test\shardingsphere-parser-test\src\main\java\org\apache\shardingsphere\test\sql\parser\parameterized\jaxb\cases\domain\statement\dal\ShowOpenTablesStatementTestCase.java,0,4,0,5,0,9
 shardingsphere-master\shardingsphere-master\shardingsphere-kernel\shardingsphere-authority\shardingsphere-authority-core\src\main\java\org\apache\shardingsphere\authority\provider\natived\model\privilege\NativePrivileges.java,0,26,0,19,0,45
 shardingsphere-master\shardingsphere-master\shardingsphere-features\shardingsphere-sharding\shardingsphere-sharding-distsql\shardingsphere-sharding-distsql-handler\src\main\java\org\apache\shardingsphere\scaling\distsql\handler\ShowScalingListQueryResultSet.java,0,12,0,5,0,17
 shardingsphere-master\shardingsphere-master\shardingsphere-infra\shardingsphere-infra-common\src\main\java\org\apache\shardingsphere\infra\yaml\config\swapper\YamlRuleConfigurationSwapperEngine.java,0,26,0,19,0,45
 shardingsphere-master\shardingsphere-master\shardingsphere-proxy\shardingsphere-proxy-backend\src\main\java\org\apache\shardingsphere\proxy\backend\text\distsql\ral\common\queryable\ShowInstanceModeHandler.java,0,21,0,14,0,35
 shardingsphere-master\shardingsphere-master\shardingsphere-kernel\shardingsphere-data-pipeline\shardingsphere-data-pipeline-dialect\shardingsphere-data-pipeline-mysql\src\main\java\org\apache\shardingsphere\data\pipeline\mysql\ingest\MySQLIncrementalDumper.java,0,63,3,49,0,115
 shardingsphere-master\shardingsphere-master\shardingsphere-features\shardingsphere-shadow\shardingsphere-shadow-core\src\main\java\org\apache\shardingsphere\shadow\yaml\config\table\YamlShadowTableConfiguration.java,0,5,0,1,0,6
 shardingsphere-master\shardingsphere-master\shardingsphere-mode\shardingsphere-mode-type\shardingsphere-cluster-mode\shardingsphere-cluster-mode-repository\shardingsphere-cluster-mode-repository-api\src\main\java\org\apache\shardingsphere\mode\repository\cluster\ClusterPersistRepository.java,0,9,0,2,0,11
 shardingsphere-master\shardingsphere-master\.mvn\wrapper\MavenWrapperDownloader.java,98,31,6,16,0,53
 shardingsphere-master\shardingsphere-master\shardingsphere-db-protocol\shardingsphere-db-protocol-mysql\src\main\java\org\apache\shardingsphere\db\protocol\mysql\packet\command\query\MySQLColumnFieldDetailFlag.java,0,19,0,2,0,21
 shardingsphere-master\shardingsphere-master\shardingsphere-features\shardingsphere-encrypt\shardingsphere-encrypt-core\src\test\java\org\apache\shardingsphere\encrypt\rewrite\token\EncryptTokenGenerateBuilderTest.java,0,23,1,20,0,44
 shardingsphere-master\shardingsphere-master\shardingsphere-kernel\shardingsphere-data-pipeline\shardingsphere-data-pipeline-spi\src\main\java\org\apache\shardingsphere\data\pipeline\api\prepare\datasource\TableDefinitionSQLType.java,0,4,0,1,0,5
 shardingsphere-master\shardingsphere-master\shardingsphere-db-protocol\shardingsphere-db-protocol-mysql\src\test\java\org\apache\shardingsphere\db\protocol\mysql\packet\command\query\binary\execute\MySQLComStmtExecutePacketTest.java,0,19,0,9,0,28
 shardingsphere-master\shardingsphere-master\examples\shardingsphere-jdbc-example\single-feature-example\transaction-example\transaction-base-seata-raw-jdbc-example\src\test\java\org\apache\shardingsphere\example\transaction\base\seata\raw\jdbc\SeataATOrderServiceTest.java,0,13,1,2,0,16
 shardingsphere-master\shardingsphere-master\shardingsphere-proxy\shardingsphere-proxy-frontend\shardingsphere-proxy-frontend-postgresql\src\main\java\org\apache\shardingsphere\proxy\frontend\postgresql\command\query\extended\execute\PostgreSQLComExecuteExecutor.java,0,9,0,10,0,19
 shardingsphere-master\shardingsphere-master\shardingsphere-db-protocol\shardingsphere-db-protocol-postgresql\src\test\java\org\apache\shardingsphere\db\protocol\postgresql\payload\PostgreSQLPacketPayloadTest.java,31,8,0,3,0,11
 shardingsphere-master\shardingsphere-master\shardingsphere-infra\shardingsphere-infra-federation\shardingsphere-infra-federation-executor\src\main\java\org\apache\shardingsphere\infra\federation\executor\original\table\FilterableTableScanExecutor.java,0,92,0,71,0,163
 shardingsphere-master\shardingsphere-master\shardingsphere-features\shardingsphere-shadow\shardingsphere-shadow-distsql\shardingsphere-shadow-distsql-handler\src\main\java\org\apache\shardingsphere\shadow\distsql\handler\supporter\ShadowRuleStatementSupporter.java,0,27,1,20,0,48
 shardingsphere-master\shardingsphere-master\shardingsphere-test\shardingsphere-integration-test\shardingsphere-integration-test-suite\src\test\java\org\apache\shardingsphere\test\integration\env\DataSourceEnvironment.java,0,14,1,10,0,25
 shardingsphere-master\shardingsphere-master\shardingsphere-features\shardingsphere-sharding\shardingsphere-sharding-core\src\test\java\org\apache\shardingsphere\sharding\route\engine\validator\dml\ShardingInsertStatementValidatorTest.java,0,121,0,93,0,214
 shardingsphere-master\shardingsphere-master\shardingsphere-infra\shardingsphere-infra-rewrite\src\main\java\org\apache\shardingsphere\infra\rewrite\sql\SQLBuilder.java,0,2,0,1,0,3
 shardingsphere-master\shardingsphere-master\shardingsphere-features\shardingsphere-sharding\shardingsphere-sharding-distsql\shardingsphere-sharding-distsql-handler\src\test\java\org\apache\shardingsphere\sharding\distsql\update\DropShardingKeyGeneratorStatementUpdaterTest.java,0,36,0,27,0,63
 shardingsphere-master\shardingsphere-master\shardingsphere-features\shardingsphere-shadow\shardingsphere-shadow-spring\shardingsphere-shadow-spring-namespace\src\test\java\org\apache\shardingsphere\shadow\spring\namespace\ShadowAlgorithmSpringNamespaceTest.java,0,32,0,31,0,63
 shardingsphere-master\shardingsphere-master\shardingsphere-proxy\shardingsphere-proxy-backend\src\main\java\org\apache\shardingsphere\proxy\backend\text\distsql\ral\common\updatable\RefreshTableMetadataHandler.java,0,10,0,11,0,21
 shardingsphere-master\shardingsphere-master\shardingsphere-features\shardingsphere-db-discovery\shardingsphere-db-discovery-spring\shardingsphere-db-discovery-spring-namespace\src\main\java\org\apache\shardingsphere\dbdiscovery\spring\namespace\factorybean\DatabaseDiscoveryAlgorithmFactoryBean.java,0,6,0,4,0,10
 shardingsphere-master\shardingsphere-master\shardingsphere-proxy\shardingsphere-proxy-frontend\shardingsphere-proxy-frontend-postgresql\src\test\java\org\apache\shardingsphere\proxy\frontend\postgresql\PostgreSQLFrontendEngineTest.java,0,12,1,11,0,24
 shardingsphere-master\shardingsphere-master\shardingsphere-kernel\shardingsphere-data-pipeline\shardingsphere-data-pipeline-core\src\main\java\org\apache\shardingsphere\data\pipeline\core\exception\PipelineUnexpectedDataRecordOrderException.java,0,6,0,4,0,10
 shardingsphere-master\shardingsphere-master\shardingsphere-jdbc\shardingsphere-jdbc-spring\shardingsphere-jdbc-core-spring\shardingsphere-jdbc-core-spring-namespace\src\test\java\org\apache\shardingsphere\spring\namespace\MemoryModeSpringNamespaceTest.java,0,2,0,3,0,5
 shardingsphere-master\shardingsphere-master\shardingsphere-sql-parser\shardingsphere-sql-parser-statement\src\main\java\org\apache\shardingsphere\sql\parser\sql\dialect\statement\oracle\ddl\OracleAssociateStatisticsStatement.java,0,15,0,12,14,41
 shardingsphere-master\shardingsphere-master\shardingsphere-sql-parser\shardingsphere-sql-parser-statement\src\main\java\org\apache\shardingsphere\sql\parser\sql\dialect\statement\oracle\ddl\OracleCreateIndexStatement.java,0,1,0,4,0,5
 shardingsphere-master\shardingsphere-master\shardingsphere-kernel\shardingsphere-data-pipeline\shardingsphere-data-pipeline-dialect\shardingsphere-data-pipeline-mysql\src\main\java\org\apache\shardingsphere\data\pipeline\mysql\ingest\client\MySQLClient.java,0,71,0,41,0,112
 shardingsphere-master\shardingsphere-master\shardingsphere-infra\shardingsphere-infra-rewrite\src\test\java\org\apache\shardingsphere\infra\rewrite\SQLRewriteEntryTest.java,0,18,0,12,0,30
 shardingsphere-master\shardingsphere-master\shardingsphere-db-protocol\shardingsphere-db-protocol-postgresql\src\test\java\org\apache\shardingsphere\db\protocol\postgresql\packet\command\query\extended\parse\PostgreSQLParseCompletePacketTest.java,0,4,0,4,0,8
 shardingsphere-master\shardingsphere-master\shardingsphere-mode\shardingsphere-mode-type\shardingsphere-cluster-mode\shardingsphere-cluster-mode-repository\shardingsphere-cluster-mode-repository-api\src\main\java\org\apache\shardingsphere\mode\repository\cluster\ClusterPersistRepositoryConfiguration.java,0,9,0,3,0,12
 shardingsphere-master\shardingsphere-master\shardingsphere-features\shardingsphere-sharding\shardingsphere-sharding-core\src\main\java\org\apache\shardingsphere\sharding\yaml\swapper\ShardingRuleConfigurationYamlSwapper.java,0,54,0,44,0,98
 shardingsphere-master\shardingsphere-master\shardingsphere-kernel\shardingsphere-data-pipeline\shardingsphere-data-pipeline-dialect\shardingsphere-data-pipeline-postgresql\src\main\java\org\apache\shardingsphere\data\pipeline\postgresql\PostgreSQLEnvironmentChecker.java,0,2,0,2,0,4
 shardingsphere-master\shardingsphere-master\shardingsphere-sql-parser\shardingsphere-sql-parser-statement\src\main\java\org\apache\shardingsphere\sql\parser\sql\dialect\statement\opengauss\dcl\OpenGaussDropRoleStatement.java,0,1,0,5,0,6
 shardingsphere-master\shardingsphere-master\shardingsphere-features\shardingsphere-sharding\shardingsphere-sharding-spring\shardingsphere-sharding-spring-namespace\src\main\java\org\apache\shardingsphere\sharding\spring\namespace\factorybean\ShardingAlgorithmFactoryBean.java,0,4,0,4,0,8
 shardingsphere-master\shardingsphere-master\shardingsphere-sql-parser\shardingsphere-sql-parser-statement\src\main\java\org\apache\shardingsphere\sql\parser\sql\common\statement\ddl\RenameTableStatement.java,5,4,1,5,2,12
 shardingsphere-master\shardingsphere-master\shardingsphere-test\shardingsphere-integration-agent-test\shardingsphere-integration-agent-test-plugins\shardingsphere-integration-agent-test-common\src\test\java\org\apache\shardingsphere\integration\agent\test\common\util\OkHttpUtils.java,0,13,0,2,0,15
 shardingsphere-master\shardingsphere-master\shardingsphere-sql-parser\shardingsphere-sql-parser-statement\src\main\java\org\apache\shardingsphere\sql\parser\sql\common\segment\ddl\column\alter\ModifyColumnDefinitionSegment.java,0,10,0,6,2,18
 shardingsphere-master\shardingsphere-master\shardingsphere-kernel\shardingsphere-data-pipeline\shardingsphere-data-pipeline-dialect\shardingsphere-data-pipeline-postgresql\src\main\java\org\apache\shardingsphere\data\pipeline\postgresql\ingest\wal\event\AbstractRowEvent.java,7,5,1,1,0,7
 shardingsphere-master\shardingsphere-master\shardingsphere-kernel\shardingsphere-traffic\shardingsphere-traffic-api\src\main\java\org\apache\shardingsphere\traffic\api\traffic\segment\SegmentTrafficAlgorithm.java,0,3,0,1,0,4
 shardingsphere-master\shardingsphere-master\shardingsphere-features\shardingsphere-shadow\shardingsphere-shadow-distsql\shardingsphere-shadow-distsql-handler\src\test\java\org\apache\shardingsphere\shadow\distsql\fixture\HintShadowAlgorithmFixture.java,0,3,1,1,0,5
 shardingsphere-master\shardingsphere-master\shardingsphere-test\shardingsphere-parser-test\src\main\java\org\apache\shardingsphere\test\sql\parser\parameterized\jaxb\cases\domain\segment\impl\expr\complex\ExpectedComplexExpressionSegment.java,0,2,0,4,0,6
 shardingsphere-master\shardingsphere-master\shardingsphere-db-protocol\shardingsphere-db-protocol-postgresql\src\main\java\org\apache\shardingsphere\db\protocol\postgresql\packet\command\query\extended\bind\protocol\PostgreSQLFloat8ArrayBinaryProtocolValue.java,0,12,0,10,0,22
 shardingsphere-master\shardingsphere-master\shardingsphere-proxy\shardingsphere-proxy-backend\src\main\java\org\apache\shardingsphere\proxy\backend\text\distsql\ral\common\updatable\AlterSQLParserRuleHandler.java,0,29,0,28,0,57
 shardingsphere-master\shardingsphere-master\shardingsphere-sql-parser\shardingsphere-sql-parser-statement\src\main\java\org\apache\shardingsphere\sql\parser\sql\dialect\statement\opengauss\ddl\OpenGaussCreateTypeStatement.java,0,1,0,5,0,6
 shardingsphere-master\shardingsphere-master\shardingsphere-proxy\shardingsphere-proxy-backend\src\test\java\org\apache\shardingsphere\proxy\backend\text\distsql\ral\common\updatable\AlterInstanceHandlerTest.java,0,14,0,13,0,27
 shardingsphere-master\shardingsphere-master\shardingsphere-proxy\shardingsphere-proxy-backend\src\main\java\org\apache\shardingsphere\proxy\backend\text\data\impl\BroadcastDatabaseBackendHandler.java,0,20,0,13,0,33
 shardingsphere-master\shardingsphere-master\shardingsphere-distsql\shardingsphere-distsql-statement\src\main\java\org\apache\shardingsphere\distsql\parser\statement\ral\common\queryable\ShowTransactionRuleStatement.java,0,0,0,2,0,2
 shardingsphere-master\shardingsphere-master\shardingsphere-features\shardingsphere-sharding\shardingsphere-sharding-distsql\shardingsphere-sharding-distsql-handler\src\main\java\org\apache\shardingsphere\sharding\distsql\handler\query\ShardingKeyGeneratorsQueryResultSet.java,0,14,0,10,0,24
 shardingsphere-master\shardingsphere-master\shardingsphere-jdbc\shardingsphere-jdbc-core\src\main\java\org\apache\shardingsphere\driver\executor\DriverJDBCExecutor.java,0,46,0,33,0,79
 shardingsphere-master\shardingsphere-master\shardingsphere-infra\shardingsphere-infra-binder\src\test\java\org\apache\shardingsphere\infra\binder\segment\insert\keygen\engine\GeneratedKeyContextEngineTest.java,0,87,0,63,0,150
 shardingsphere-master\shardingsphere-master\shardingsphere-test\shardingsphere-parser-test\src\main\java\org\apache\shardingsphere\test\sql\parser\parameterized\jaxb\cases\domain\statement\ddl\NoAuditStatementTestCase.java,0,0,0,3,0,3
 shardingsphere-master\shardingsphere-master\shardingsphere-jdbc\shardingsphere-jdbc-spring\shardingsphere-jdbc-spring-infra\shardingsphere-jdbc-spring-namespace-infra\src\main\java\org\apache\shardingsphere\spring\namespace\tag\ShardingSphereAlgorithmBeanDefinitionTag.java,0,6,0,1,0,7
 shardingsphere-master\shardingsphere-master\shardingsphere-proxy\shardingsphere-proxy-backend\src\main\java\org\apache\shardingsphere\proxy\backend\config\yaml\swapper\YamlProxyDataSourceConfigurationSwapper.java,0,10,0,11,0,21
 shardingsphere-master\shardingsphere-master\shardingsphere-features\shardingsphere-sharding\shardingsphere-sharding-core\src\test\java\org\apache\shardingsphere\sharding\merge\dql\groupby\aggregation\BitXorAggregationUnitTest.java,0,8,2,6,0,16
 shardingsphere-master\shardingsphere-master\shardingsphere-db-protocol\shardingsphere-db-protocol-postgresql\src\main\java\org\apache\shardingsphere\db\protocol\postgresql\packet\command\query\extended\bind\protocol\PostgreSQLStringArrayBinaryProtocolValue.java,0,12,0,10,0,22
 shardingsphere-master\shardingsphere-master\shardingsphere-sql-parser\shardingsphere-sql-parser-statement\src\main\java\org\apache\shardingsphere\sql\parser\sql\common\segment\generic\table\SubqueryTableSegment.java,0,8,0,4,2,14
 shardingsphere-master\shardingsphere-master\shardingsphere-sql-parser\shardingsphere-sql-parser-statement\src\main\java\org\apache\shardingsphere\sql\parser\sql\dialect\statement\mysql\dal\MySQLShowCreateProcedureStatement.java,0,3,0,5,0,8
 shardingsphere-master\shardingsphere-master\shardingsphere-sql-parser\shardingsphere-sql-parser-statement\src\main\java\org\apache\shardingsphere\sql\parser\sql\dialect\statement\sql92\dml\SQL92DeleteStatement.java,0,2,0,4,0,6
 shardingsphere-master\shardingsphere-master\shardingsphere-test\shardingsphere-parser-test\src\main\java\org\apache\shardingsphere\test\sql\parser\parameterized\jaxb\cases\domain\statement\dal\DelimiterStatementTestCase.java,0,2,0,3,0,5
 shardingsphere-master\shardingsphere-master\shardingsphere-proxy\shardingsphere-proxy-frontend\shardingsphere-proxy-frontend-core\src\main\java\org\apache\shardingsphere\proxy\frontend\exception\ExpectedExceptions.java,0,8,0,5,0,13
 shardingsphere-master\shardingsphere-master\shardingsphere-kernel\shardingsphere-data-pipeline\shardingsphere-data-pipeline-core\src\main\java\org\apache\shardingsphere\data\pipeline\core\datasource\creator\impl\StandardPipelineDataSourceCreator.java,0,6,0,7,0,13
 shardingsphere-master\shardingsphere-master\shardingsphere-features\shardingsphere-shadow\shardingsphere-shadow-distsql\shardingsphere-shadow-distsql-statement\src\main\java\org\apache\shardingsphere\shadow\distsql\parser\statement\AlterShadowAlgorithmStatement.java,0,2,0,3,0,5
 shardingsphere-master\shardingsphere-master\examples\shardingsphere-jdbc-example\single-feature-example\extension-example\custom-sharding-algortihm-example\spi-based-sharding-algorithm-example\spi-based-sharding-spring-namespace-jpa-example\src\main\java\org\apache\shardingsphere\example\extension\spibased\sharding\spring\namespace\jpa\fixture\SPIBasedAccountStandardShardingAlgorithmFixture.java,0,9,1,8,0,18
 shardingsphere-master\shardingsphere-master\shardingsphere-db-protocol\shardingsphere-db-protocol-mysql\src\main\java\org\apache\shardingsphere\db\protocol\mysql\constant\MySQLBinaryColumnType.java,0,86,0,10,0,96
 shardingsphere-master\shardingsphere-master\shardingsphere-features\shardingsphere-encrypt\shardingsphere-encrypt-spring\shardingsphere-encrypt-spring-boot-starter\src\test\java\org\apache\shardingsphere\encrypt\spring\boot\condition\EncryptSpringBootConditionTest.java,0,9,0,5,0,14
 shardingsphere-master\shardingsphere-master\shardingsphere-sql-parser\shardingsphere-sql-parser-statement\src\test\java\org\apache\shardingsphere\sql\parser\sql\dialect\handler\ddl\CreateViewStatementHandlerTest.java,0,8,0,8,0,16
 shardingsphere-master\shardingsphere-master\shardingsphere-sql-parser\shardingsphere-sql-parser-spi\src\main\java\org\apache\shardingsphere\sql\parser\api\visitor\type\SQLTypeVisitor.java,0,0,0,1,0,1
 shardingsphere-master\shardingsphere-master\shardingsphere-test\shardingsphere-parser-test\src\main\java\org\apache\shardingsphere\test\sql\parser\parameterized\asserts\statement\dcl\impl\GrantStatementAssert.java,0,6,0,12,0,18
 shardingsphere-master\shardingsphere-master\shardingsphere-features\shardingsphere-encrypt\shardingsphere-encrypt-core\src\main\java\org\apache\shardingsphere\encrypt\rewrite\token\pojo\EncryptAlterTableToken.java,0,15,0,3,0,18
 shardingsphere-master\shardingsphere-master\shardingsphere-features\shardingsphere-shadow\shardingsphere-shadow-core\src\test\java\org\apache\shardingsphere\shadow\route\engine\dml\ShadowDeleteStatementRoutingEngineTest.java,0,42,0,37,0,79
 shardingsphere-master\shardingsphere-master\shardingsphere-sql-parser\shardingsphere-sql-parser-statement\src\main\java\org\apache\shardingsphere\sql\parser\sql\dialect\statement\oracle\ddl\OracleFlashbackTableStatement.java,0,4,0,6,4,14
 shardingsphere-master\shardingsphere-master\shardingsphere-test\shardingsphere-pipeline-test\src\test\java\org\apache\shardingsphere\data\pipeline\core\fixture\FixtureEnvironmentChecker.java,0,1,0,2,0,3
 shardingsphere-master\shardingsphere-master\shardingsphere-sql-parser\shardingsphere-sql-parser-engine\src\main\java\org\apache\shardingsphere\sql\parser\core\database\parser\DatabaseTypedSQLParserFacadeRegistry.java,0,11,0,5,0,16
 shardingsphere-master\shardingsphere-master\shardingsphere-proxy\shardingsphere-proxy-backend\src\test\java\org\apache\shardingsphere\proxy\backend\text\distsql\ral\common\queryable\ShowSQLParserRuleHandlerTest.java,0,16,0,9,0,25
 shardingsphere-master\shardingsphere-master\shardingsphere-test\shardingsphere-parser-test\src\main\java\org\apache\shardingsphere\test\sql\parser\parameterized\jaxb\cases\domain\segment\impl\with\ExpectedWithClause.java,0,3,0,4,0,7
 shardingsphere-master\shardingsphere-master\shardingsphere-features\shardingsphere-encrypt\shardingsphere-encrypt-spring\shardingsphere-encrypt-spring-namespace\src\test\java\org\apache\shardingsphere\encrypt\spring\namespace\EncryptSpringNamespaceTest.java,0,30,0,17,0,47
 shardingsphere-master\shardingsphere-master\shardingsphere-sql-parser\shardingsphere-sql-parser-statement\src\main\java\org\apache\shardingsphere\sql\parser\sql\common\segment\ddl\routine\RoutineBodySegment.java,9,8,0,2,1,11
 shardingsphere-master\shardingsphere-master\shardingsphere-sql-parser\shardingsphere-sql-parser-statement\src\main\java\org\apache\shardingsphere\sql\parser\sql\dialect\statement\sqlserver\tcl\SQLServerSavepointStatement.java,0,1,0,5,0,6
 shardingsphere-master\shardingsphere-master\shardingsphere-infra\shardingsphere-infra-common\src\main\java\org\apache\shardingsphere\infra\instance\ComputeNodeInstance.java,0,15,0,2,0,17
 shardingsphere-master\shardingsphere-master\shardingsphere-distsql\shardingsphere-distsql-statement\src\main\java\org\apache\shardingsphere\distsql\parser\statement\ral\CommonDistSQLStatement.java,3,0,1,1,0,2
 shardingsphere-master\shardingsphere-master\shardingsphere-features\shardingsphere-db-discovery\shardingsphere-db-discovery-core\src\test\java\org\apache\shardingsphere\dbdiscovery\rule\DatabaseDiscoveryRuleTest.java,0,29,0,18,0,47
 shardingsphere-master\shardingsphere-master\shardingsphere-db-protocol\shardingsphere-db-protocol-mysql\src\test\java\org\apache\shardingsphere\db\protocol\mysql\packet\handshake\MySQLHandshakeResponse41PacketTest.java,0,76,0,36,0,112
 shardingsphere-master\shardingsphere-master\shardingsphere-features\shardingsphere-sharding\shardingsphere-sharding-core\src\test\java\org\apache\shardingsphere\sharding\algorithm\keygen\fixture\FixedTimeService.java,0,8,0,2,0,10
 shardingsphere-master\shardingsphere-master\shardingsphere-features\shardingsphere-sharding\shardingsphere-sharding-distsql\shardingsphere-sharding-distsql-handler\src\main\java\org\apache\shardingsphere\scaling\distsql\handler\DropScalingUpdater.java,0,6,0,3,0,9
 shardingsphere-master\shardingsphere-master\shardingsphere-db-protocol\shardingsphere-db-protocol-mysql\src\main\java\org\apache\shardingsphere\db\protocol\mysql\packet\binlog\row\column\value\integer\MySQLShortBinlogProtocolValue.java,0,3,0,6,0,9
 shardingsphere-master\shardingsphere-master\shardingsphere-proxy\shardingsphere-proxy-backend\src\test\java\org\apache\shardingsphere\proxy\backend\communication\jdbc\connection\MockConnectionUtil.java,0,6,1,4,0,11
 shardingsphere-master\shardingsphere-master\shardingsphere-proxy\shardingsphere-proxy-backend\src\main\java\org\apache\shardingsphere\proxy\backend\text\admin\mysql\executor\ShowDatabasesExecutor.java,0,17,0,14,0,31
 shardingsphere-master\shardingsphere-master\shardingsphere-features\shardingsphere-sharding\shardingsphere-sharding-core\src\test\java\org\apache\shardingsphere\sharding\route\strategy\type\none\NoneShardingStrategyTest.java,0,11,0,2,0,13
 shardingsphere-master\shardingsphere-master\shardingsphere-kernel\shardingsphere-traffic\shardingsphere-traffic-api\src\main\java\org\apache\shardingsphere\traffic\api\traffic\TrafficValue.java,0,1,0,1,0,2
 shardingsphere-master\shardingsphere-master\shardingsphere-features\shardingsphere-sharding\shardingsphere-sharding-core\src\test\java\org\apache\shardingsphere\sharding\algorithm\sharding\mod\ModShardingAlgorithmTest.java,0,28,0,11,0,39
 shardingsphere-master\shardingsphere-master\shardingsphere-test\shardingsphere-rewrite-test\src\test\java\org\apache\shardingsphere\sharding\rewrite\fixture\NormalEncryptAlgorithmFixture.java,0,7,1,4,0,12
 shardingsphere-master\shardingsphere-master\examples\other-example\shardingsphere-parser-example\src\main\java\org\apache\shardingsphere\example\parser\oracle\statement\OracleParserStatementExample.java,0,32,1,10,0,43
 shardingsphere-master\shardingsphere-master\shardingsphere-infra\shardingsphere-infra-federation\shardingsphere-infra-federation-executor\src\main\java\org\apache\shardingsphere\infra\federation\executor\original\table\FilterableTableScanContext.java,0,6,0,1,0,7
 shardingsphere-master\shardingsphere-master\shardingsphere-infra\shardingsphere-infra-common\src\main\java\org\apache\shardingsphere\infra\yaml\config\swapper\mode\ModeConfigurationYamlSwapper.java,0,10,0,11,0,21
 shardingsphere-master\shardingsphere-master\shardingsphere-sql-parser\shardingsphere-sql-parser-engine\src\main\java\org\apache\shardingsphere\sql\parser\core\database\cache\ParseTreeCacheLoader.java,0,6,0,3,0,9
 shardingsphere-master\shardingsphere-master\shardingsphere-test\shardingsphere-parser-test\src\main\java\org\apache\shardingsphere\test\sql\parser\parameterized\asserts\segment\SQLSegmentAssert.java,0,14,0,12,0,26
 shardingsphere-master\shardingsphere-master\shardingsphere-features\shardingsphere-encrypt\shardingsphere-encrypt-distsql\shardingsphere-encrypt-distsql-parser\src\main\java\org\apache\shardingsphere\encrypt\distsql\parser\core\EncryptDistSQLParser.java,0,5,0,4,0,9
 shardingsphere-master\shardingsphere-master\shardingsphere-features\shardingsphere-db-discovery\shardingsphere-db-discovery-api\src\main\java\org\apache\shardingsphere\dbdiscovery\api\config\rule\DatabaseDiscoveryHeartBeatConfiguration.java,0,2,0,1,0,3
 shardingsphere-master\shardingsphere-master\shardingsphere-sql-parser\shardingsphere-sql-parser-statement\src\main\java\org\apache\shardingsphere\sql\parser\sql\dialect\statement\postgresql\ddl\PostgreSQLAlterTableStatement.java,0,1,0,5,0,6
 shardingsphere-master\shardingsphere-master\shardingsphere-test\shardingsphere-parser-test\src\main\java\org\apache\shardingsphere\test\sql\parser\parameterized\jaxb\cases\domain\statement\distsql\rql\ShowShardingBindingTableRulesStatementTestCase.java,0,3,0,5,0,8
 shardingsphere-master\shardingsphere-master\shardingsphere-kernel\shardingsphere-data-pipeline\shardingsphere-data-pipeline-dialect\shardingsphere-data-pipeline-mysql\src\main\java\org\apache\shardingsphere\data\pipeline\mysql\ingest\column\value\UnsignedBigintHandler.java,0,7,0,3,0,10
 shardingsphere-master\shardingsphere-master\shardingsphere-features\shardingsphere-sharding\shardingsphere-sharding-core\src\test\java\org\apache\shardingsphere\sharding\merge\dql\groupby\aggregation\ComparableAggregationUnitTest.java,0,11,0,3,0,14
 shardingsphere-master\shardingsphere-master\shardingsphere-features\shardingsphere-sharding\shardingsphere-sharding-core\src\test\java\org\apache\shardingsphere\sharding\rewrite\token\RowCountTokenGeneratorTest.java,0,26,0,29,0,55
 shardingsphere-master\shardingsphere-master\shardingsphere-proxy\shardingsphere-proxy-frontend\shardingsphere-proxy-frontend-postgresql\src\test\java\org\apache\shardingsphere\proxy\frontend\postgresql\command\query\extended\JDBCPortalTest.java,0,79,1,61,0,141
 shardingsphere-master\shardingsphere-master\shardingsphere-test\shardingsphere-parser-test\src\main\java\org\apache\shardingsphere\test\sql\parser\parameterized\jaxb\cases\domain\statement\dcl\CreateLoginStatementTestCase.java,0,2,0,4,0,6
 shardingsphere-master\shardingsphere-master\shardingsphere-test\shardingsphere-parser-test\src\main\java\org\apache\shardingsphere\test\sql\parser\parameterized\jaxb\cases\domain\statement\ddl\CreateLanguageStatementTestCase.java,0,0,0,3,0,3
 shardingsphere-master\shardingsphere-master\shardingsphere-mode\shardingsphere-mode-type\shardingsphere-standalone-mode\shardingsphere-standalone-mode-repository\shardingsphere-standalone-mode-repository-api\src\main\java\org\apache\shardingsphere\mode\repository\standalone\StandalonePersistRepositoryConfiguration.java,0,5,0,3,0,8
 shardingsphere-master\shardingsphere-master\shardingsphere-kernel\shardingsphere-single-table\shardingsphere-single-table-core\src\main\java\org\apache\shardingsphere\singletable\route\SingleTableRouteEngine.java,0,39,0,30,0,69
 shardingsphere-master\shardingsphere-master\shardingsphere-sql-parser\shardingsphere-sql-parser-statement\src\main\java\org\apache\shardingsphere\sql\parser\sql\common\statement\ddl\DropDatabaseStatement.java,7,5,1,3,0,9
 shardingsphere-master\shardingsphere-master\shardingsphere-proxy\shardingsphere-proxy-backend\src\main\java\org\apache\shardingsphere\proxy\backend\util\SystemPropertyUtil.java,0,5,0,2,0,7
 shardingsphere-master\shardingsphere-master\shardingsphere-infra\shardingsphere-infra-federation\shardingsphere-infra-federation-optimizer\src\main\java\org\apache\shardingsphere\infra\federation\optimizer\context\planner\OptimizerPlannerContext.java,0,5,0,1,0,6
 shardingsphere-master\shardingsphere-master\shardingsphere-jdbc\shardingsphere-jdbc-core\src\test\java\org\apache\shardingsphere\driver\state\circuit\datasource\CircuitBreakerDataSourceTest.java,0,15,0,5,0,20
 shardingsphere-master\shardingsphere-master\shardingsphere-mode\shardingsphere-mode-type\shardingsphere-standalone-mode\shardingsphere-standalone-mode-core\src\test\java\org\apache\shardingsphere\mode\manager\standalone\fixture\StandalonePersistRepositoryFixture.java,0,4,2,4,0,10
 shardingsphere-master\shardingsphere-master\shardingsphere-features\shardingsphere-sharding\shardingsphere-sharding-core\src\test\java\org\apache\shardingsphere\sharding\route\engine\type\ShardingRouteEngineFactoryTest.java,0,159,0,115,0,274
 shardingsphere-master\shardingsphere-master\shardingsphere-features\shardingsphere-encrypt\shardingsphere-encrypt-core\src\main\java\org\apache\shardingsphere\encrypt\rewrite\token\generator\EncryptCreateTableTokenGenerator.java,0,66,0,54,0,120
 shardingsphere-master\shardingsphere-master\shardingsphere-agent\shardingsphere-agent-core\src\main\java\org\apache\shardingsphere\agent\core\exception\ShardingSphereAgentException.java,0,6,0,3,0,9
 shardingsphere-master\shardingsphere-master\examples\shardingsphere-jdbc-example\single-feature-example\transaction-example\transaction-base-seata-spring-boot-example\src\main\java\org\apache\shardingsphere\example\transaction\base\seata\spring\boot\TransactionBaseSeataSpringBootExample.java,17,8,0,2,0,10
 shardingsphere-master\shardingsphere-master\shardingsphere-kernel\shardingsphere-transaction\shardingsphere-transaction-core\src\main\java\org\apache\shardingsphere\transaction\annotation\ShardingSphereTransactionType.java,0,2,0,1,0,3
 shardingsphere-master\shardingsphere-master\shardingsphere-features\shardingsphere-readwrite-splitting\shardingsphere-readwrite-splitting-core\src\test\java\org\apache\shardingsphere\readwritesplitting\checker\AlgorithmProvidedReadwriteSplittingRuleConfigurationCheckerTest.java,0,24,0,18,0,42
 shardingsphere-master\shardingsphere-master\shardingsphere-sql-parser\shardingsphere-sql-parser-statement\src\main\java\org\apache\shardingsphere\sql\parser\sql\common\segment\generic\DataTypeSegment.java,0,8,0,2,2,12
 shardingsphere-master\shardingsphere-master\shardingsphere-test\shardingsphere-pipeline-test\src\test\java\org\apache\shardingsphere\data\pipeline\scenario\rulealtered\prepare\InventoryTaskSplitterTest.java,0,63,0,34,0,97
 shardingsphere-master\shardingsphere-master\shardingsphere-sql-parser\shardingsphere-sql-parser-statement\src\test\java\org\apache\shardingsphere\sql\parser\sql\dialect\handler\ddl\CreateFunctionStatementHandlerTest.java,0,8,0,7,0,15
 shardingsphere-master\shardingsphere-master\shardingsphere-features\shardingsphere-sharding\shardingsphere-sharding-core\src\main\java\org\apache\shardingsphere\sharding\merge\dal\show\ShowCreateTableMergedResult.java,0,15,0,14,0,29
 shardingsphere-master\shardingsphere-master\shardingsphere-sql-parser\shardingsphere-sql-parser-statement\src\main\java\org\apache\shardingsphere\sql\parser\sql\common\statement\dal\AnalyzeTableStatement.java,5,4,1,4,1,10
 shardingsphere-master\shardingsphere-master\shardingsphere-proxy\shardingsphere-proxy-frontend\shardingsphere-proxy-frontend-postgresql\src\test\java\org\apache\shardingsphere\proxy\frontend\postgresql\authentication\PostgreSQLAuthenticationEngineTest.java,0,81,6,45,0,132
 shardingsphere-master\shardingsphere-master\shardingsphere-kernel\shardingsphere-data-pipeline\shardingsphere-data-pipeline-dialect\shardingsphere-data-pipeline-postgresql\src\main\java\org\apache\shardingsphere\data\pipeline\postgresql\ingest\wal\decode\TestDecodingPlugin.java,0,33,1,17,0,51
 shardingsphere-master\shardingsphere-master\shardingsphere-proxy\shardingsphere-proxy-backend\src\main\java\org\apache\shardingsphere\proxy\backend\text\admin\mysql\executor\ShowTablesExecutor.java,0,27,0,21,0,48
 shardingsphere-master\shardingsphere-master\shardingsphere-infra\shardingsphere-infra-common\src\main\java\org\apache\shardingsphere\infra\yaml\schema\pojo\YamlConstraintMetaData.java,0,4,0,1,0,5
 shardingsphere-master\shardingsphere-master\shardingsphere-test\shardingsphere-parser-test\src\main\java\org\apache\shardingsphere\test\sql\parser\parameterized\asserts\statement\dcl\impl\DropLoginStatementAssert.java,0,4,1,6,0,11
 shardingsphere-master\shardingsphere-master\examples\shardingsphere-jdbc-example\single-feature-example\extension-example\custom-sharding-algortihm-example\spi-based-sharding-algorithm-example\spi-based-sharding-spring-namespace-jpa-example\src\main\java\org\apache\shardingsphere\example\extension\spibased\sharding\spring\namespace\jpa\fixture\SPIBasedOrderItemStandardShardingAlgorithmFixture.java,0,8,1,8,0,17
 shardingsphere-master\shardingsphere-master\shardingsphere-proxy\shardingsphere-proxy-backend\src\test\java\org\apache\shardingsphere\proxy\backend\text\distsql\ral\common\updatable\DropTrafficRuleHandlerTest.java,0,47,0,39,0,86
 shardingsphere-master\shardingsphere-master\shardingsphere-test\shardingsphere-parser-test\src\main\java\org\apache\shardingsphere\test\sql\parser\parameterized\jaxb\cases\domain\segment\ExpectedDelimiterSQLSegment.java,0,2,0,2,0,4
 shardingsphere-master\shardingsphere-master\shardingsphere-features\shardingsphere-readwrite-splitting\shardingsphere-readwrite-splitting-core\src\main\java\org\apache\shardingsphere\readwritesplitting\datanode\ReadwriteSplittingDataNodeBuilder.java,0,7,0,5,0,12
 shardingsphere-master\shardingsphere-master\shardingsphere-features\shardingsphere-shadow\shardingsphere-shadow-core\src\main\java\org\apache\shardingsphere\shadow\yaml\config\datasource\YamlShadowDataSourceConfiguration.java,0,6,0,2,0,8
 shardingsphere-master\shardingsphere-master\shardingsphere-jdbc\shardingsphere-jdbc-spring\shardingsphere-jdbc-core-spring\shardingsphere-jdbc-core-spring-namespace\src\main\java\org\apache\shardingsphere\spring\namespace\parser\mode\ClusterPersistRepositoryConfigurationBeanDefinitionParser.java,0,12,0,12,0,24
 shardingsphere-master\shardingsphere-master\shardingsphere-test\shardingsphere-parser-test\src\main\java\org\apache\shardingsphere\test\sql\parser\parameterized\jaxb\cases\domain\statement\dal\InstallComponentStatementTestCase.java,0,2,0,4,0,6
 shardingsphere-master\shardingsphere-master\shardingsphere-features\shardingsphere-readwrite-splitting\shardingsphere-readwrite-splitting-core\src\main\java\org\apache\shardingsphere\readwritesplitting\algorithm\StaticReadwriteSplittingType.java,52,24,0,7,0,31
 shardingsphere-master\shardingsphere-master\shardingsphere-proxy\shardingsphere-proxy-backend\src\main\java\org\apache\shardingsphere\proxy\backend\text\distsql\ral\common\hint\executor\SetShardingHintDatabaseValueExecutor.java,0,5,0,8,0,13
 shardingsphere-master\shardingsphere-master\shardingsphere-test\shardingsphere-integration-driver-test\src\test\java\org\apache\shardingsphere\driver\fixture\algorithm\StandardAlgorithm.java,0,9,1,8,0,18
 shardingsphere-master\shardingsphere-master\shardingsphere-kernel\shardingsphere-data-pipeline\shardingsphere-data-pipeline-core\src\main\java\org\apache\shardingsphere\data\pipeline\core\datasource\creator\PipelineDataSourceCreatorFactory.java,0,6,1,2,0,9
 shardingsphere-master\shardingsphere-master\shardingsphere-test\shardingsphere-parser-test\src\main\java\org\apache\shardingsphere\test\sql\parser\parameterized\jaxb\cases\domain\segment\impl\definition\ExpectedChangeColumnDefinition.java,0,7,0,5,0,12
 shardingsphere-master\shardingsphere-master\shardingsphere-test\shardingsphere-parser-test\src\main\java\org\apache\shardingsphere\test\sql\parser\parameterized\jaxb\cases\domain\segment\impl\distsql\ExpectedProperties.java,0,3,0,4,0,7
 shardingsphere-master\shardingsphere-master\shardingsphere-jdbc\shardingsphere-jdbc-core\src\test\java\org\apache\shardingsphere\driver\jdbc\adapter\ResultSetAdapterTest.java,0,22,9,5,0,36
 shardingsphere-master\shardingsphere-master\shardingsphere-db-protocol\shardingsphere-db-protocol-opengauss\src\main\java\org\apache\shardingsphere\db\protocol\opengauss\packet\command\generic\OpenGaussErrorResponsePacket.java,0,44,0,9,0,53
 shardingsphere-master\shardingsphere-master\examples\shardingsphere-proxy-example\shardingsphere-proxy-distsql-example\src\main\java\org\apache\shardingsphere\example\proxy\distsql\hint\impl\AddShardingExecutor.java,0,15,3,5,0,23
 shardingsphere-master\shardingsphere-master\shardingsphere-sql-parser\shardingsphere-sql-parser-statement\src\main\java\org\apache\shardingsphere\sql\parser\sql\dialect\statement\opengauss\ddl\OpenGaussAlterForeignTableStatement.java,0,1,0,5,0,6
 shardingsphere-master\shardingsphere-master\examples\shardingsphere-jdbc-example\single-feature-example\transaction-example\transaction-2pc-xa-spring-namespace-example\src\test\java\org\apache\shardingsphere\example\transaction\xa\spring\namspace\XAOrderServiceTest.java,33,14,1,1,0,16
 shardingsphere-master\shardingsphere-master\shardingsphere-features\shardingsphere-db-discovery\shardingsphere-db-discovery-distsql\shardingsphere-db-discovery-distsql-statement\src\main\java\org\apache\shardingsphere\dbdiscovery\distsql\parser\statement\ShowDatabaseDiscoveryHeartbeatsStatement.java,0,4,0,5,0,9
 shardingsphere-master\shardingsphere-master\shardingsphere-sql-parser\shardingsphere-sql-parser-statement\src\main\java\org\apache\shardingsphere\sql\parser\sql\dialect\statement\postgresql\ddl\PostgreSQLAlterTablespaceStatement.java,0,1,0,5,0,6
 shardingsphere-master\shardingsphere-master\shardingsphere-infra\shardingsphere-infra-rewrite\src\main\java\org\apache\shardingsphere\infra\rewrite\parameter\rewriter\ParameterRewriterBuilder.java,0,2,0,1,0,3
 shardingsphere-master\shardingsphere-master\shardingsphere-kernel\shardingsphere-data-pipeline\shardingsphere-data-pipeline-core\src\main\java\org\apache\shardingsphere\data\pipeline\core\datasource\creator\PipelineDataSourceCreator.java,0,3,0,2,0,5
 shardingsphere-master\shardingsphere-master\shardingsphere-infra\shardingsphere-infra-common\src\test\java\org\apache\shardingsphere\infra\metadata\schema\loader\dialect\OracleTableMetaDataLoaderTest.java,0,137,23,78,0,238
 shardingsphere-master\shardingsphere-master\shardingsphere-sql-parser\shardingsphere-sql-parser-statement\src\main\java\org\apache\shardingsphere\sql\parser\sql\dialect\statement\mysql\dal\MySQLShowProfilesStatement.java,0,1,0,5,0,6
 shardingsphere-master\shardingsphere-master\shardingsphere-test\shardingsphere-parser-test\src\main\java\org\apache\shardingsphere\test\sql\parser\parameterized\jaxb\cases\domain\statement\dal\ShowDatabasesStatementTestCase.java,0,2,0,4,0,6
 shardingsphere-master\shardingsphere-master\shardingsphere-features\shardingsphere-sharding\shardingsphere-sharding-core\src\main\java\org\apache\shardingsphere\sharding\yaml\swapper\rule\ShardingTableRuleConfigurationYamlSwapper.java,0,19,0,19,0,38
 shardingsphere-master\shardingsphere-master\shardingsphere-features\shardingsphere-sharding\shardingsphere-sharding-core\src\main\java\org\apache\shardingsphere\sharding\rule\builder\ShardingRuleBuilder.java,0,7,0,5,0,12
 shardingsphere-master\shardingsphere-master\shardingsphere-proxy\shardingsphere-proxy-backend\src\main\java\org\apache\shardingsphere\proxy\backend\text\distsql\ral\common\exception\CommonDistSQLErrorCode.java,0,15,0,4,0,19
 shardingsphere-master\shardingsphere-master\shardingsphere-sql-parser\shardingsphere-sql-parser-statement\src\main\java\org\apache\shardingsphere\sql\parser\sql\dialect\handler\ddl\DropIndexStatementHandler.java,0,9,0,18,5,32
 shardingsphere-master\shardingsphere-master\shardingsphere-db-protocol\shardingsphere-db-protocol-mysql\src\main\java\org\apache\shardingsphere\db\protocol\mysql\packet\command\admin\MySQLComSetOptionPacket.java,0,10,0,4,0,14
 shardingsphere-master\shardingsphere-master\shardingsphere-proxy\shardingsphere-proxy-frontend\shardingsphere-proxy-frontend-opengauss\src\main\java\org\apache\shardingsphere\proxy\frontend\opengauss\authentication\OpenGaussAuthenticationEngine.java,0,52,0,44,0,96
 shardingsphere-master\shardingsphere-master\shardingsphere-sql-parser\shardingsphere-sql-parser-statement\src\main\java\org\apache\shardingsphere\sql\parser\sql\common\statement\tcl\LockStatement.java,3,1,1,3,0,5
 shardingsphere-master\shardingsphere-master\shardingsphere-test\shardingsphere-pipeline-test\src\test\java\org\apache\shardingsphere\data\pipeline\core\metadata\loader\PipelineTableMetaDataLoaderTest.java,0,59,7,17,0,83
 shardingsphere-master\shardingsphere-master\shardingsphere-features\shardingsphere-shadow\shardingsphere-shadow-api\src\main\java\org\apache\shardingsphere\shadow\api\config\ShadowRuleConfiguration.java,0,15,0,11,0,26
 shardingsphere-master\shardingsphere-master\shardingsphere-infra\shardingsphere-infra-context\src\test\java\org\apache\shardingsphere\infra\context\kernel\KernelProcessorTest.java,0,13,0,11,0,24
 shardingsphere-master\shardingsphere-master\shardingsphere-sql-parser\shardingsphere-sql-parser-statement\src\main\java\org\apache\shardingsphere\sql\parser\sql\dialect\statement\mysql\dal\MySQLShowReplicasStatement.java,0,1,0,5,0,6
 shardingsphere-master\shardingsphere-master\shardingsphere-sql-parser\shardingsphere-sql-parser-statement\src\main\java\org\apache\shardingsphere\sql\parser\sql\dialect\statement\mysql\dal\MySQLShowOtherStatement.java,0,1,0,5,0,6
 shardingsphere-master\shardingsphere-master\shardingsphere-sql-parser\shardingsphere-sql-parser-statement\src\test\java\org\apache\shardingsphere\sql\parser\sql\common\util\SafeNumberOperationUtilTest.java,0,178,0,34,0,212
 shardingsphere-master\shardingsphere-master\shardingsphere-infra\shardingsphere-infra-common\src\main\java\org\apache\shardingsphere\infra\config\mode\PersistRepositoryConfiguration.java,0,4,0,1,0,5
 shardingsphere-master\shardingsphere-master\shardingsphere-infra\shardingsphere-infra-rewrite\src\test\java\org\apache\shardingsphere\infra\rewrite\engine\GenericSQLRewriteEngineTest.java,0,6,0,4,0,10
 shardingsphere-master\shardingsphere-master\examples\shardingsphere-jdbc-example\single-feature-example\transaction-example\transaction-base-seata-raw-jdbc-example\src\main\java\org\apache\shardingsphere\example\transaction\base\seata\raw\jdbc\SeataATOrderService.java,0,19,6,9,0,34
 shardingsphere-master\shardingsphere-master\shardingsphere-features\shardingsphere-encrypt\shardingsphere-encrypt-core\src\main\java\org\apache\shardingsphere\encrypt\checker\AlgorithmProvidedEncryptRuleConfigurationChecker.java,0,5,0,4,0,9
 shardingsphere-master\shardingsphere-master\shardingsphere-sql-parser\shardingsphere-sql-parser-statement\src\main\java\org\apache\shardingsphere\sql\parser\sql\dialect\statement\postgresql\ddl\PostgreSQLDropConversionStatement.java,0,1,0,5,0,6
 shardingsphere-master\shardingsphere-master\shardingsphere-features\shardingsphere-shadow\shardingsphere-shadow-core\src\test\java\org\apache\shardingsphere\shadow\rule\ShadowRuleTest.java,0,58,0,39,0,97
 shardingsphere-master\shardingsphere-master\shardingsphere-test\shardingsphere-parser-test\src\main\java\org\apache\shardingsphere\test\sql\parser\parameterized\jaxb\cases\domain\statement\distsql\ral\DiscardDistSQLStatementTestCase.java,0,0,0,3,0,3
 shardingsphere-master\shardingsphere-master\shardingsphere-proxy\shardingsphere-proxy-frontend\shardingsphere-proxy-frontend-reactive-core\src\test\java\org\apache\shardingsphere\proxy\frontend\reactive\wrap\WrappedReactiveCommandExecutorTest.java,0,16,0,5,0,21
 shardingsphere-master\shardingsphere-master\examples\shardingsphere-jdbc-example\single-feature-example\shadow-example\shadow-spring-namespace-jpa-example\src\main\java\org\apache\shardingsphere\example\shadow\spring\namespace\jpa\ShadowSpringNamespaceJpaExample.java,11,8,1,3,0,12
 shardingsphere-master\shardingsphere-master\shardingsphere-test\shardingsphere-integration-test\shardingsphere-integration-test-suite\src\test\java\org\apache\shardingsphere\test\integration\env\scenario\path\ScenarioDataPath.java,0,48,4,21,0,73
 shardingsphere-master\shardingsphere-master\shardingsphere-features\shardingsphere-db-discovery\shardingsphere-db-discovery-spring\shardingsphere-db-discovery-spring-boot-starter\src\test\java\org\apache\shardingsphere\dbdiscovery\spring\boot\condition\DatabaseDiscoverySpringBootConditionTest.java,0,12,0,8,0,20
 shardingsphere-master\shardingsphere-master\shardingsphere-features\shardingsphere-sharding\shardingsphere-sharding-core\src\test\java\org\apache\shardingsphere\sharding\algorithm\sharding\range\BoundaryBasedRangeShardingAlgorithmTest.java,0,36,0,15,0,51
 shardingsphere-master\shardingsphere-master\shardingsphere-features\shardingsphere-db-discovery\shardingsphere-db-discovery-distsql\shardingsphere-db-discovery-distsql-handler\src\test\java\org\apache\shardingsphere\dbdiscovery\distsql\handler\update\AlterDatabaseDiscoveryTypeStatementUpdaterTest.java,0,40,0,34,0,74
 shardingsphere-master\shardingsphere-master\shardingsphere-features\shardingsphere-encrypt\shardingsphere-encrypt-core\src\test\java\org\apache\shardingsphere\encrypt\rule\EncryptColumnTest.java,0,6,0,3,0,9
 shardingsphere-master\shardingsphere-master\shardingsphere-features\shardingsphere-encrypt\shardingsphere-encrypt-core\src\test\java\org\apache\shardingsphere\encrypt\rewrite\pojo\EncryptPredicateEqualRightValueTokenTest.java,0,6,0,4,0,10
 shardingsphere-master\shardingsphere-master\shardingsphere-features\shardingsphere-encrypt\shardingsphere-encrypt-core\src\test\java\org\apache\shardingsphere\encrypt\algorithm\SM4EncryptAlgorithmTest.java,0,22,0,8,0,30
 shardingsphere-master\shardingsphere-master\shardingsphere-features\shardingsphere-sharding\shardingsphere-sharding-core\src\main\java\org\apache\shardingsphere\sharding\route\engine\validator\ddl\impl\ShardingAlterTableStatementValidator.java,0,20,0,19,0,39
 shardingsphere-master\shardingsphere-master\shardingsphere-mode\shardingsphere-mode-type\shardingsphere-cluster-mode\shardingsphere-cluster-mode-core\src\main\java\org\apache\shardingsphere\mode\manager\cluster\coordinator\registry\GovernanceWatcherFactory.java,0,10,0,6,0,16
 shardingsphere-master\shardingsphere-master\shardingsphere-agent\shardingsphere-agent-core\src\test\java\org\apache\shardingsphere\agent\core\bytebuddy\transformer\ShardingSphereTransformerTest.java,0,42,0,26,0,68
 shardingsphere-master\shardingsphere-master\examples\example-core\example-api\src\main\java\org\apache\shardingsphere\example\core\api\repository\CommonRepository.java,0,12,0,1,0,13
 shardingsphere-master\shardingsphere-master\shardingsphere-mode\shardingsphere-mode-type\shardingsphere-cluster-mode\shardingsphere-cluster-mode-core\src\test\java\org\apache\shardingsphere\mode\manager\cluster\coordinator\ClusterPersistRepositoryFactoryTest.java,0,4,0,8,0,12
 shardingsphere-master\shardingsphere-master\shardingsphere-infra\shardingsphere-infra-federation\shardingsphere-infra-federation-optimizer\src\main\java\org\apache\shardingsphere\infra\federation\optimizer\context\parser\OptimizerParserContextFactory.java,0,10,1,9,0,20
 shardingsphere-master\shardingsphere-master\shardingsphere-test\shardingsphere-parser-test\src\main\java\org\apache\shardingsphere\test\sql\parser\parameterized\jaxb\cases\domain\statement\distsql\ral\CountInstanceRulesStatementTestCase.java,0,1,0,4,0,5
 shardingsphere-master\shardingsphere-master\shardingsphere-db-protocol\shardingsphere-db-protocol-core\src\main\java\org\apache\shardingsphere\db\protocol\binary\BinaryCell.java,0,5,0,1,0,6
 shardingsphere-master\shardingsphere-master\shardingsphere-features\shardingsphere-sharding\shardingsphere-sharding-core\src\test\java\org\apache\shardingsphere\sharding\algorithm\sharding\classbased\ClassBasedShardingAlgorithmTest.java,0,64,0,39,0,103
 shardingsphere-master\shardingsphere-master\shardingsphere-db-protocol\shardingsphere-db-protocol-mysql\src\test\java\org\apache\shardingsphere\db\protocol\mysql\constant\MySQLBinlogEventTypeTest.java,0,7,0,3,0,10
 shardingsphere-master\shardingsphere-master\shardingsphere-proxy\shardingsphere-proxy-backend\src\main\java\org\apache\shardingsphere\proxy\backend\text\distsql\ral\common\updatable\ImportSchemaConfigurationHandler.java,0,49,2,62,0,113
 shardingsphere-master\shardingsphere-master\shardingsphere-sql-parser\shardingsphere-sql-parser-dialect\shardingsphere-sql-parser-opengauss\src\test\java\org\apache\shardingsphere\sql\parser\opengauss\UnsupportedOpenGaussParserParameterizedTest.java,0,7,0,6,0,13
 shardingsphere-master\shardingsphere-master\shardingsphere-features\shardingsphere-readwrite-splitting\shardingsphere-readwrite-splitting-distsql\shardingsphere-readwrite-splitting-distsql-handler\src\test\java\org\apache\shardingsphere\readwritesplitting\distsql\handler\update\DropReadwriteSplittingRuleStatementUpdaterTest.java,0,51,0,41,0,92
 shardingsphere-master\shardingsphere-master\shardingsphere-db-protocol\shardingsphere-db-protocol-mysql\src\test\java\org\apache\shardingsphere\db\protocol\mysql\packet\command\query\binary\reset\MySQLComStmtResetPacketTest.java,0,5,0,2,0,7
 shardingsphere-master\shardingsphere-master\shardingsphere-sql-parser\shardingsphere-sql-parser-statement\src\main\java\org\apache\shardingsphere\sql\parser\sql\dialect\statement\mysql\segment\ResetSlaveOptionSegment.java,0,3,0,3,0,6
 shardingsphere-master\shardingsphere-master\shardingsphere-test\shardingsphere-parser-test\src\main\java\org\apache\shardingsphere\test\sql\parser\parameterized\asserts\statement\dal\impl\ShowTablesStatementAssert.java,0,7,0,12,0,19
 shardingsphere-master\shardingsphere-master\shardingsphere-infra\shardingsphere-infra-merge\src\test\java\org\apache\shardingsphere\infra\merge\result\impl\decorator\fixture\TestDecoratorMergedResult.java,0,4,0,2,0,6
 shardingsphere-master\shardingsphere-master\shardingsphere-proxy\shardingsphere-proxy-frontend\shardingsphere-proxy-frontend-opengauss\src\main\java\org\apache\shardingsphere\proxy\frontend\opengauss\command\query\extended\bind\OpenGaussComBatchBindExecutor.java,0,12,0,15,0,27
 shardingsphere-master\shardingsphere-master\shardingsphere-agent\shardingsphere-agent-plugins\shardingsphere-agent-plugin-metrics\shardingsphere-agent-metrics-prometheus\src\main\java\org\apache\shardingsphere\agent\metrics\prometheus\wrapper\PrometheusWrapperFactory.java,161,44,3,25,0,72
 shardingsphere-master\shardingsphere-master\shardingsphere-jdbc\shardingsphere-jdbc-spring\shardingsphere-jdbc-core-spring\shardingsphere-jdbc-core-spring-namespace\src\test\java\org\apache\shardingsphere\spring\namespace\ClusterModeSpringNamespaceTest.java,0,2,0,3,0,5
 shardingsphere-master\shardingsphere-master\shardingsphere-features\shardingsphere-encrypt\shardingsphere-encrypt-core\src\test\java\org\apache\shardingsphere\encrypt\merge\dql\EncryptAlgorithmMetaDataTest.java,0,47,0,28,0,75
 shardingsphere-master\shardingsphere-master\shardingsphere-test\shardingsphere-integration-driver-test\src\test\java\org\apache\shardingsphere\driver\fixture\algorithm\IncrementKeyGenerateAlgorithm.java,0,6,1,2,0,9
 shardingsphere-master\shardingsphere-master\shardingsphere-infra\shardingsphere-infra-binder\src\main\java\org\apache\shardingsphere\infra\binder\segment\select\projection\DerivedColumn.java,0,20,0,3,0,23
 shardingsphere-master\shardingsphere-master\shardingsphere-features\shardingsphere-db-discovery\shardingsphere-db-discovery-distsql\shardingsphere-db-discovery-distsql-statement\src\main\java\org\apache\shardingsphere\dbdiscovery\distsql\parser\statement\DropDatabaseDiscoveryHeartbeatStatement.java,0,7,0,4,0,11
 shardingsphere-master\shardingsphere-master\shardingsphere-features\shardingsphere-db-discovery\shardingsphere-db-discovery-spring\shardingsphere-db-discovery-spring-namespace\src\main\java\org\apache\shardingsphere\dbdiscovery\spring\namespace\tag\DatabaseDiscoveryRuleBeanDefinitionTag.java,0,16,0,4,0,20
 shardingsphere-master\shardingsphere-master\shardingsphere-sql-parser\shardingsphere-sql-parser-statement\src\main\java\org\apache\shardingsphere\sql\parser\sql\dialect\statement\sqlserver\ddl\SQLServerAlterFunctionStatement.java,0,1,0,5,0,6
 shardingsphere-master\shardingsphere-master\shardingsphere-test\shardingsphere-parser-test\src\main\java\org\apache\shardingsphere\test\sql\parser\parameterized\loader\CasesLoader.java,67,24,0,12,0,36
 shardingsphere-master\shardingsphere-master\shardingsphere-test\shardingsphere-parser-test\src\main\java\org\apache\shardingsphere\test\sql\parser\parameterized\asserts\statement\dal\impl\CheckTableStatementAssert.java,0,4,0,8,0,12
 shardingsphere-master\shardingsphere-master\shardingsphere-jdbc\shardingsphere-jdbc-spring\shardingsphere-jdbc-transaction-spring\src\test\java\org\apache\shardingsphere\spring\transaction\TransactionTypeScannerTest.java,0,7,0,2,0,9
