Class_Location,Class_Length,CheckStyle_Amount,PMD_Amount,SCAX_Amount,SpotBugs_Amount,Total_Amount
 skywalking-master\skywalking-master\oap-server\server-core\src\main\java\org\apache\skywalking\oap\server\core\config\group\openapi\EndpointGroupingRule4Openapi.java,92,40,0,18,0,58
 skywalking-master\skywalking-master\oap-server\server-storage-plugin\storage-influxdb-plugin\src\main\java\org\apache\skywalking\oap\server\storage\plugin\influxdb\base\MetricsDAO.java,115,45,0,31,0,76
skywalking-master\skywalking-master\test\e2e-v2\java-test-service\e2e-service-consumer\src\main\java\org\apache\skywalking\e2e\Service1Application.java,6,3,1,1,0,5
 skywalking-master\skywalking-master\oap-server\server-core\src\main\java\org\apache\skywalking\oap\server\core\storage\query\IMetricsQueryDAO.java,0,43,4,13,0,60
 skywalking-master\skywalking-master\oap-server\server-core\src\main\java\org\apache\skywalking\oap\server\core\config\group\EndpointNameGroupingRuleWatcher.java,31,10,1,3,0,14
 skywalking-master\skywalking-master\oap-server\exporter\src\main\java\org\apache\skywalking\oap\server\exporter\provider\grpc\GRPCExporter.java,0,50,13,23,0,86
 skywalking-master\skywalking-master\oap-server\server-core\src\main\java\org\apache\skywalking\oap\server\core\analysis\MetricsExtension.java,0,5,0,6,0,11
 skywalking-master\skywalking-master\oap-server\server-core\src\main\java\org\apache\skywalking\oap\server\core\analysis\meter\function\HistogramFunction.java,145,33,3,12,0,48
 skywalking-master\skywalking-master\oap-server\server-alarm-plugin\src\main\java\org\apache\skywalking\oap\server\core\alarm\provider\expression\Expression.java,47,29,1,3,0,33
 skywalking-master\skywalking-master\oap-server\server-query-plugin\query-graphql-plugin\src\main\java\org\apache\skywalking\oap\query\graphql\type\BatchMetricConditions.java,5,3,0,1,0,4
 skywalking-master\skywalking-master\oap-server\server-core\src\test\java\org\apache\skywalking\oap\server\core\analysis\metrics\CountMetricsTest.java,65,19,1,1,0,21
 skywalking-master\skywalking-master\oap-server\server-library\library-module\src\main\java\org\apache\skywalking\oap\server\library\module\ModuleConfig.java,3,0,1,1,0,2
 skywalking-master\skywalking-master\oap-server\server-receiver-plugin\envoy-metrics-receiver-plugin\src\main\java\org\apache\skywalking\oap\server\receiver\envoy\EnvoyMetricReceiverModule.java,13,4,0,1,0,5
 skywalking-master\skywalking-master\oap-server\server-storage-plugin\storage-influxdb-plugin\src\main\java\org\apache\skywalking\oap\server\storage\plugin\influxdb\query\AggregationQuery.java,70,20,0,13,0,33
 skywalking-master\skywalking-master\oap-server\server-core\src\main\java\org\apache\skywalking\oap\server\core\CoreModuleConfig.java,0,62,0,15,0,77
 skywalking-master\skywalking-master\oap-server\server-query-plugin\query-graphql-plugin\src\main\java\org\apache\skywalking\oap\query\graphql\type\TopNRecordsCondition.java,8,5,0,1,0,6
 skywalking-master\skywalking-master\oap-server\server-core\src\test\java\org\apache\skywalking\oap\server\core\analysis\metrics\expression\NotContainMatchTest.java,12,4,0,3,0,7
 skywalking-master\skywalking-master\oap-server\server-core\src\main\java\org\apache\skywalking\oap\server\core\cache\ProfileTaskCache.java,93,41,2,14,0,57
 skywalking-master\skywalking-master\oap-server\server-alarm-plugin\src\test\java\org\apache\skywalking\oap\server\core\alarm\provider\grpc\AlarmMockReceiver.java,43,14,2,4,0,20
 skywalking-master\skywalking-master\oap-server\server-core\src\main\java\org\apache\skywalking\oap\server\core\analysis\metrics\expression\StringMatch.java,19,8,0,2,0,10
 skywalking-master\skywalking-master\oap-server\server-receiver-plugin\otel-receiver-plugin\src\main\java\org\apache\skywalking\oap\server\receiver\otel\Handler.java,0,10,0,7,0,17
 skywalking-master\skywalking-master\oap-server\server-core\src\main\java\org\apache\skywalking\oap\server\core\analysis\manual\endpoint\EndpointTraffic.java,86,20,1,7,0,28
 skywalking-master\skywalking-master\oap-server\server-core\src\main\java\org\apache\skywalking\oap\server\core\worker\WorkerInstancesService.java,0,15,1,7,0,23
 skywalking-master\skywalking-master\oap-server\server-storage-plugin\storage-zipkin-elasticsearch-plugin\src\main\java\org\apache\skywalking\oap\server\storage\plugin\zipkin\ZipkinSpanRecordDispatcher.java,24,3,0,3,0,6
 skywalking-master\skywalking-master\oap-server\analyzer\meter-analyzer\src\main\java\org\apache\skywalking\oap\meter\analyzer\dsl\EntityDescription\EndpointEntityDescription.java,13,8,1,2,0,11
 skywalking-master\skywalking-master\oap-server\server-fetcher-plugin\prometheus-fetcher-plugin\src\main\java\org\apache\skywalking\oap\server\fetcher\prometheus\http\HTTPClient.java,47,11,1,7,0,19
 skywalking-master\skywalking-master\oap-server\server-core\src\main\java\org\apache\skywalking\oap\server\core\analysis\manual\relation\service\ServiceRelationClientSideMetrics.java,123,37,1,17,0,55
 skywalking-master\skywalking-master\oap-server\server-core\src\main\java\org\apache\skywalking\oap\server\core\query\PointOfTime.java,20,7,0,1,0,8
 skywalking-master\skywalking-master\oap-server\server-receiver-plugin\configuration-discovery-receiver-plugin\src\main\java\org\apache\skywalking\oap\server\recevier\configuration\discovery\ConfigurationDiscoveryModuleConfig.java,10,4,0,3,0,7
 skywalking-master\skywalking-master\oap-server\server-storage-plugin\storage-jdbc-hikaricp-plugin\src\main\java\org\apache\skywalking\oap\server\storage\plugin\jdbc\h2\dao\H2AggregationQueryDAO.java,59,15,0,7,0,22
 skywalking-master\skywalking-master\oap-server\server-library\library-module\src\test\java\org\apache\skywalking\oap\server\library\module\ModuleAProviderConfig.java,7,4,0,1,4,9
 skywalking-master\skywalking-master\oap-server\server-core\src\main\java\org\apache\skywalking\oap\server\core\query\AggregationQueryService.java,69,30,1,23,0,54
 skywalking-master\skywalking-master\oap-server\server-core\src\main\java\org\apache\skywalking\oap\server\core\storage\cache\INetworkAddressAliasDAO.java,0,1,0,2,0,3
 skywalking-master\skywalking-master\oap-server\server-core\src\main\java\org\apache\skywalking\oap\server\core\worker\AbstractWorker.java,15,8,1,3,0,12
 skywalking-master\skywalking-master\oap-server\server-core\src\main\java\org\apache\skywalking\oap\server\core\query\type\Thermodynamic.java,18,11,0,1,0,12
 skywalking-master\skywalking-master\oap-server\server-core\src\main\java\org\apache\skywalking\oap\server\core\analysis\FunctionCategory.java,0,11,2,6,0,19
 skywalking-master\skywalking-master\oap-server\server-storage-plugin\storage-jdbc-hikaricp-plugin\src\main\java\org\apache\skywalking\oap\server\storage\plugin\jdbc\h2\dao\H2MetricsDAO.java,32,23,0,9,0,32
 skywalking-master\skywalking-master\oap-server\server-receiver-plugin\envoy-metrics-receiver-plugin\src\main\java\org\apache\skywalking\oap\server\receiver\envoy\als\mx\ServiceMetaInfoAdapter.java,69,13,1,14,0,28
 skywalking-master\skywalking-master\oap-server\analyzer\event-analyzer\src\main\java\org\apache\skywalking\oap\server\analyzer\event\listener\EventAnalyzerListenerFactoryManager.java,0,2,0,1,0,3
 skywalking-master\skywalking-master\oap-server\server-core\src\test\java\org\apache\skywalking\oap\server\core\analysis\ApdexThresholdConfigTest.java,49,23,0,4,0,27
 skywalking-master\skywalking-master\oap-server\server-receiver-plugin\skywalking-browser-receiver-plugin\src\main\java\org\apache\skywalking\oap\server\receiver\browser\provider\handler\grpc\BrowserPerfServiceHandlerCompat.java,0,6,0,5,0,11
 skywalking-master\skywalking-master\oap-server\server-storage-plugin\storage-influxdb-plugin\src\main\java\org\apache\skywalking\oap\server\storage\plugin\influxdb\query\MetadataQuery.java,232,56,3,38,0,97
 skywalking-master\skywalking-master\oap-server\server-core\src\main\java\org\apache\skywalking\oap\server\core\storage\annotation\MultipleQueryUnifiedIndex.java,0,1,0,1,0,2
 skywalking-master\skywalking-master\oap-server\server-core\src\main\java\org\apache\skywalking\oap\server\core\analysis\worker\MetricsPersistentWorker.java,320,125,11,55,0,191
 skywalking-master\skywalking-master\oap-server\server-library\library-elasticsearch-client\src\main\java\org\apache\skywalking\library\elasticsearch\response\search\SearchHits.java,0,5,0,3,2,10
 skywalking-master\skywalking-master\oap-server\server-library\library-elasticsearch-client\src\main\java\org\apache\skywalking\library\elasticsearch\requests\factory\TemplateFactory.java,0,12,0,2,0,14
 skywalking-master\skywalking-master\oap-server\server-core\src\main\java\org\apache\skywalking\oap\server\core\analysis\metrics\annotation\FilterMatcher.java,0,4,0,5,0,9
 skywalking-master\skywalking-master\oap-server\server-library\library-datacarrier-queue\src\test\java\org\apache\skywalking\oap\server\library\datacarrier\partition\ProducerThreadPartitionerTest.java,11,10,0,5,0,15
 skywalking-master\skywalking-master\oap-server\server-configuration\configuration-api\src\main\java\org\apache\skywalking\oap\server\configuration\api\DynamicConfigurationService.java,0,1,0,1,0,2
 skywalking-master\skywalking-master\oap-server\analyzer\agent-analyzer\src\main\java\org\apache\skywalking\oap\server\analyzer\provider\trace\parser\ISegmentParserService.java,0,1,0,1,0,2
 skywalking-master\skywalking-master\oap-server\server-library\library-module\src\test\java\org\apache\skywalking\oap\server\library\module\ModuleAProvider.java,41,8,2,3,0,13
 skywalking-master\skywalking-master\oap-server\server-storage-plugin\storage-influxdb-plugin\src\main\java\org\apache\skywalking\oap\server\storage\plugin\influxdb\base\NoneStreamDAO.java,24,15,0,7,0,22
 skywalking-master\skywalking-master\oap-server\server-core\src\main\java\org\apache\skywalking\oap\server\core\alarm\AlarmMessage.java,14,11,0,1,0,12
 skywalking-master\skywalking-master\oap-server\server-core\src\main\java\org\apache\skywalking\oap\server\core\query\input\LogQueryCondition.java,13,10,0,1,0,11
 skywalking-master\skywalking-master\oap-server\server-fetcher-plugin\kafka-fetcher-plugin\src\test\java\org\apache\skywalking\oap\server\analyzer\agent\kafka\provider\handler\LogHandlerTest.java,27,9,1,3,0,13
 skywalking-master\skywalking-master\oap-server\server-library\library-datacarrier-queue\src\main\java\org\apache\skywalking\oap\server\library\datacarrier\buffer\Channels.java,68,33,0,7,0,40
 skywalking-master\skywalking-master\oap-server\exporter\src\main\java\org\apache\skywalking\oap\server\exporter\provider\grpc\GRPCExporterSetting.java,7,5,0,1,0,6
 skywalking-master\skywalking-master\oap-server\analyzer\meter-analyzer\src\main\java\org\apache\skywalking\oap\meter\analyzer\dsl\DSL.java,0,2,1,2,0,5
 skywalking-master\skywalking-master\oap-server\analyzer\meter-analyzer\src\main\java\org\apache\skywalking\oap\meter\analyzer\dsl\counter\ID.java,0,2,0,1,0,3
 skywalking-master\skywalking-master\oap-server\server-receiver-plugin\envoy-metrics-receiver-plugin\src\main\java\org\apache\skywalking\oap\server\receiver\envoy\als\AbstractALSAnalyzer.java,19,4,0,3,0,7
 skywalking-master\skywalking-master\oap-server\server-core\src\main\java\org\apache\skywalking\oap\server\core\analysis\metrics\expression\InMatch.java,36,12,0,2,0,14
 skywalking-master\skywalking-master\oap-server\server-configuration\configuration-nacos\src\main\java\org\apache\skywalking\oap\server\configuration\nacos\NacosConfigurationProvider.java,40,12,0,8,0,20
 skywalking-master\skywalking-master\oap-server\server-core\src\main\java\org\apache\skywalking\oap\server\core\query\type\Service.java,25,11,0,2,0,13
 skywalking-master\skywalking-master\oap-server\server-configuration\configuration-consul\src\test\java\org\apache\skywalking\oap\server\configuration\consul\ConsulConfigurationTestProvider.java,89,18,2,10,0,30
 skywalking-master\skywalking-master\oap-server\server-receiver-plugin\skywalking-management-receiver-plugin\src\main\java\org\apache\skywalking\oap\server\receiver\register\provider\handler\v8\grpc\ManagementServiceGRPCHandler.java,0,9,0,6,0,15
 skywalking-master\skywalking-master\oap-server\server-receiver-plugin\skywalking-browser-receiver-plugin\src\main\java\org\apache\skywalking\oap\server\receiver\browser\provider\parser\errorlog\listener\ErrorLogListenerFactory.java,0,4,1,4,0,9
 skywalking-master\skywalking-master\oap-server\server-receiver-plugin\skywalking-browser-receiver-plugin\src\main\java\org\apache\skywalking\oap\server\receiver\browser\provider\parser\errorlog\listener\ErrorLogAnalysisListener.java,0,4,0,5,0,9
 skywalking-master\skywalking-master\oap-server\server-core\src\main\java\org\apache\skywalking\oap\server\core\browser\manual\service\BrowserAppTrafficDispatcher.java,11,3,0,5,0,8
 skywalking-master\skywalking-master\oap-server\server-core\src\main\java\org\apache\skywalking\oap\server\core\query\type\BrowserErrorLogs.java,10,3,0,1,0,4
 skywalking-master\skywalking-master\oap-server\server-core\src\main\java\org\apache\skywalking\oap\server\core\oal\rt\DisableOALDefine.java,11,2,1,1,0,4
 skywalking-master\skywalking-master\oap-server\server-storage-plugin\storage-jdbc-hikaricp-plugin\src\main\java\org\apache\skywalking\oap\server\storage\plugin\jdbc\postgresql\PostgreSQLStorageProvider.java,134,48,1,70,0,119
 skywalking-master\skywalking-master\oap-server\server-library\library-datacarrier-queue\src\main\java\org\apache\skywalking\oap\server\library\datacarrier\buffer\ArrayBlockingQueueBuffer.java,39,18,1,2,1,22
 skywalking-master\skywalking-master\oap-server\server-core\src\main\java\org\apache\skywalking\oap\server\core\analysis\manual\relation\instance\ServiceInstanceRelationServerSideMetrics.java,139,47,1,21,0,69
 skywalking-master\skywalking-master\oap-server\server-receiver-plugin\envoy-metrics-receiver-plugin\src\main\java\org\apache\skywalking\oap\server\receiver\envoy\EnvoyMetricReceiverConfig.java,35,19,0,7,0,26
 skywalking-master\skywalking-master\oap-server\server-core\src\main\java\org\apache\skywalking\oap\server\core\analysis\IDManager.java,273,79,5,30,0,114
 skywalking-master\skywalking-master\oap-server\server-library\library-client\src\main\java\org\apache\skywalking\oap\server\library\client\Client.java,0,3,0,1,0,4
 skywalking-master\skywalking-master\apm-protocol\apm-network\src\main\java\org\apache\skywalking\oap\server\network\trace\component\command\TraceIgnoreCommand.java,19,7,0,2,0,9
 skywalking-master\skywalking-master\oap-server\server-library\library-util\src\main\java\org\apache\skywalking\oap\server\library\util\yaml\ClassFilterConstructor.java,0,5,0,3,1,9
 skywalking-master\skywalking-master\oap-server\server-library\library-elasticsearch-client\src\main\java\org\apache\skywalking\library\elasticsearch\requests\factory\v7\V7DocumentFactory.java,0,24,0,8,0,32
 skywalking-master\skywalking-master\oap-server\analyzer\meter-analyzer\src\test\java\org\apache\skywalking\oap\meter\analyzer\dsl\ScopeTest.java,529,172,32,77,0,281
 skywalking-master\skywalking-master\oap-server\server-storage-plugin\storage-jdbc-hikaricp-plugin\src\main\java\org\apache\skywalking\oap\server\storage\plugin\jdbc\mysql\MysqlBrowserLogQueryDAO.java,16,7,0,3,0,10
 skywalking-master\skywalking-master\oap-server\server-core\src\test\java\org\apache\skywalking\oap\server\core\config\group\EndpointGroupingRuleReaderTest.java,21,7,0,6,0,13
 skywalking-master\skywalking-master\oap-server\analyzer\agent-analyzer\src\test\java\org\apache\skywalking\oap\server\analyzer\provider\trace\parser\listener\strategy\SegmentStatusAnalyzerTest.java,43,17,0,12,0,29
 skywalking-master\skywalking-master\oap-server\server-configuration\configuration-zookeeper\src\main\java\org\apache\skywalking\oap\server\configuration\zookeeper\ZookeeperConfigurationProvider.java,34,10,0,6,0,16
 skywalking-master\skywalking-master\oap-server\analyzer\agent-analyzer\src\main\java\org\apache\skywalking\oap\server\analyzer\provider\meter\config\MeterConfig.java,14,7,0,1,0,8
 skywalking-master\skywalking-master\oap-server\exporter\src\test\java\org\apache\skywalking\oap\server\exporter\provider\grpc\ExporterMockReceiver.java,53,20,3,8,0,31
 skywalking-master\skywalking-master\oap-server\microbench\src\main\java\org\apache\skywalking\oap\server\microbench\library\datacarrier\common\AtomicRangeIntegerV2.java,46,18,0,1,0,19
 skywalking-master\skywalking-master\oap-server\server-telemetry\telemetry-api\src\main\java\org\apache\skywalking\oap\server\telemetry\api\TelemetryRelatedContext.java,0,6,2,1,2,11
 skywalking-master\skywalking-master\oap-server\server-receiver-plugin\skywalking-browser-receiver-plugin\src\main\java\org\apache\skywalking\oap\server\receiver\browser\provider\parser\errorlog\ErrorLogParserListenerManager.java,9,4,0,4,0,8
 skywalking-master\skywalking-master\oap-server\server-library\library-util\src\test\java\org\apache\skywalking\oap\server\library\util\PropertyPlaceholderHelperTest.java,79,23,2,15,0,40
 skywalking-master\skywalking-master\oap-server\server-receiver-plugin\skywalking-event-receiver-plugin\src\main\java\org\apache\skywalking\oap\server\receiver\event\rest\EventRestServiceHandler.java,38,8,0,2,0,10
 skywalking-master\skywalking-master\oap-server\server-library\library-util\src\main\java\org\apache\skywalking\oap\server\library\util\prometheus\Parser.java,0,2,0,2,0,4
 skywalking-master\skywalking-master\oap-server\server-core\src\main\java\org\apache\skywalking\oap\server\core\analysis\Stream.java,0,10,0,10,0,20
 skywalking-master\skywalking-master\oap-server\server-library\library-elasticsearch-client\src\main\java\org\apache\skywalking\library\elasticsearch\requests\search\ScrollBuilder.java,0,10,0,2,0,12
 skywalking-master\skywalking-master\oap-server\server-receiver-plugin\skywalking-browser-receiver-plugin\src\main\java\org\apache\skywalking\oap\server\receiver\browser\module\BrowserModule.java,13,4,0,1,0,5
 skywalking-master\skywalking-master\oap-server\server-library\library-elasticsearch-client\src\main\java\org\apache\skywalking\library\elasticsearch\requests\search\MatchPhaseQuery.java,0,5,0,2,0,7
 skywalking-master\skywalking-master\oap-server\analyzer\agent-analyzer\src\main\java\org\apache\skywalking\oap\server\analyzer\provider\trace\parser\listener\strategy\SegmentStatusAnalyzer.java,0,3,0,4,0,7
 skywalking-master\skywalking-master\oap-server\server-core\src\main\java\org\apache\skywalking\oap\server\core\analysis\metrics\expression\ContainMatch.java,12,4,0,2,0,6
 skywalking-master\skywalking-master\oap-server\microbench\src\main\java\org\apache\skywalking\oap\server\microbench\library\datacarrier\LinkedArrayBenchmark.java,286,186,2,130,0,318
 skywalking-master\skywalking-master\oap-server\server-core\src\main\java\org\apache\skywalking\oap\server\core\browser\source\BrowserAppTrafficCategory.java,0,0,0,1,0,1
 skywalking-master\skywalking-master\oap-server\server-alarm-plugin\src\main\java\org\apache\skywalking\oap\server\core\alarm\provider\dingtalk\DingtalkHookCallback.java,107,44,4,16,0,64
 skywalking-master\skywalking-master\oap-server\server-receiver-plugin\skywalking-trace-receiver-plugin\src\test\java\org\apache\skywalking\oap\server\receiver\trace\provider\parser\listener\segment\ProtoBufJsonUtilsTest.java,78,61,0,5,0,66
 skywalking-master\skywalking-master\oap-server\server-query-plugin\query-graphql-plugin\src\main\java\org\apache\skywalking\oap\query\graphql\resolver\TopNRecordsQuery.java,31,10,0,5,0,15
 skywalking-master\skywalking-master\oap-server\server-query-plugin\query-graphql-plugin\src\main\java\org\apache\skywalking\oap\query\graphql\resolver\ProfileMutation.java,26,14,0,9,0,23
 skywalking-master\skywalking-master\oap-server\analyzer\agent-analyzer\src\main\java\org\apache\skywalking\oap\server\analyzer\provider\trace\parser\listener\RPCTrafficSourceBuilder.java,0,34,0,24,0,58
 skywalking-master\skywalking-master\oap-server\server-alarm-plugin\src\main\java\org\apache\skywalking\oap\server\core\alarm\provider\slack\SlackhookCallback.java,75,23,4,11,0,38
 skywalking-master\skywalking-master\oap-server\server-core\src\main\java\org\apache\skywalking\oap\server\core\cluster\ClusterNodesQuery.java,0,1,0,1,0,2
 skywalking-master\skywalking-master\oap-server\server-library\library-util\src\main\java\org\apache\skywalking\oap\server\library\util\ConnectStringParseException.java,7,2,0,1,0,3
 skywalking-master\skywalking-master\oap-server\server-library\library-util\src\main\java\org\apache\skywalking\oap\server\library\util\HealthChecker.java,0,0,0,1,0,1
 skywalking-master\skywalking-master\oap-server\server-core\src\main\java\org\apache\skywalking\oap\server\core\analysis\StreamDefinition.java,12,7,0,2,0,9
 skywalking-master\skywalking-master\oap-server\server-library\library-datacarrier-queue\src\test\java\org\apache\skywalking\oap\server\library\datacarrier\consumer\ConsumerTest.java,107,41,3,13,5,62
 skywalking-master\skywalking-master\oap-server\server-core\src\main\java\org\apache\skywalking\oap\server\core\query\type\ContentType.java,0,11,0,1,0,12
 skywalking-master\skywalking-master\oap-server\server-core\src\main\java\org\apache\skywalking\oap\server\core\query\input\ProfileTaskCreationRequest.java,13,9,0,1,0,10
 skywalking-master\skywalking-master\oap-server\server-cluster-plugin\cluster-consul-plugin\src\main\java\org\apache\skywalking\oap\server\cluster\plugin\consul\ClusterModuleConsulProvider.java,70,19,2,12,0,33
 skywalking-master\skywalking-master\oap-server\server-alarm-plugin\src\test\java\org\apache\skywalking\oap\server\core\alarm\provider\dingtalk\DingtalkHookCallbackTest.java,88,27,2,19,0,48
 skywalking-master\skywalking-master\oap-server\server-core\src\main\java\org\apache\skywalking\oap\server\core\query\type\Bucket.java,60,26,1,1,0,28
 skywalking-master\skywalking-master\oap-server\server-library\library-elasticsearch-client\src\main\java\org\apache\skywalking\library\elasticsearch\requests\factory\DocumentFactory.java,0,26,0,4,0,30
 skywalking-master\skywalking-master\oap-server\server-core\src\main\java\org\apache\skywalking\oap\server\core\analysis\metrics\MetricsRegister.java,3,1,0,1,0,2
 skywalking-master\skywalking-master\oap-server\server-library\library-elasticsearch-client\src\main\java\org\apache\skywalking\library\elasticsearch\requests\factory\v6\V6RequestFactory.java,0,7,0,10,3,20
 skywalking-master\skywalking-master\oap-server\analyzer\agent-analyzer\src\main\java\org\apache\skywalking\oap\server\analyzer\provider\trace\parser\listener\DatabaseSlowStatementBuilder.java,41,11,0,3,0,14
 skywalking-master\skywalking-master\oap-server\server-receiver-plugin\skywalking-browser-receiver-plugin\src\main\java\org\apache\skywalking\oap\server\receiver\browser\provider\handler\grpc\BrowserPerfServiceHandler.java,0,32,5,19,0,56
 skywalking-master\skywalking-master\oap-server\server-storage-plugin\storage-jdbc-hikaricp-plugin\src\main\java\org\apache\skywalking\oap\server\storage\plugin\jdbc\h2\dao\H2ProfileTaskLogQueryDAO.java,39,13,0,12,0,25
 skywalking-master\skywalking-master\oap-server\server-core\src\main\java\org\apache\skywalking\oap\server\core\browser\source\BrowserAppPagePerf.java,25,9,0,6,0,15
 skywalking-master\skywalking-master\oap-server\server-core\src\test\java\org\apache\skywalking\oap\server\core\remote\client\GRPCRemoteClientTestCase.java,103,31,5,11,0,47
 skywalking-master\skywalking-master\oap-server\server-alarm-plugin\src\main\java\org\apache\skywalking\oap\server\core\alarm\provider\WebhookCallback.java,67,17,5,7,0,29
 skywalking-master\skywalking-master\oap-server\server-query-plugin\query-graphql-plugin\src\main\java\org\apache\skywalking\oap\query\graphql\type\TimeInfo.java,11,2,0,1,0,3
 skywalking-master\skywalking-master\test\e2e-v2\java-test-service\e2e-service-consumer\src\main\java\org\apache\skywalking\e2e\controller\HealthController.java,9,2,1,1,0,4
 skywalking-master\skywalking-master\oap-server\server-configuration\configuration-consul\src\main\java\org\apache\skywalking\oap\server\configuration\consul\ConsulConfigurationProvider.java,29,7,0,4,0,11
 skywalking-master\skywalking-master\oap-server\server-core\src\main\java\org\apache\skywalking\oap\server\core\exporter\ExportData.java,6,5,0,1,0,6
 skywalking-master\skywalking-master\oap-server\server-storage-plugin\storage-influxdb-plugin\src\main\java\org\apache\skywalking\oap\server\storage\plugin\influxdb\query\AlarmQuery.java,83,28,1,14,0,43
 skywalking-master\skywalking-master\oap-server\server-core\src\main\java\org\apache\skywalking\oap\server\core\source\MemoryPoolType.java,0,7,0,2,0,9
 skywalking-master\skywalking-master\oap-server\server-library\library-client\src\main\java\org\apache\skywalking\oap\server\library\client\elasticsearch\UpdateRequestWrapper.java,14,13,0,8,0,21
 skywalking-master\skywalking-master\oap-server\server-core\src\main\java\org\apache\skywalking\oap\server\core\oal\rt\OALEngine.java,0,8,0,5,0,13
 skywalking-master\skywalking-master\oap-server\server-core\src\main\java\org\apache\skywalking\oap\server\core\profiling\trace\ProfileTaskQueryService.java,197,53,1,30,0,84
 skywalking-master\skywalking-master\oap-server\server-storage-plugin\storage-iotdb-plugin\src\main\java\org\apache\skywalking\oap\server\storage\plugin\iotdb\profile\IoTDBProfileTaskLogQueryDAO.java,38,18,0,16,0,34
 skywalking-master\skywalking-master\oap-server\server-library\library-elasticsearch-client\src\main\java\org\apache\skywalking\library\elasticsearch\requests\factory\v6\codec\V6UpdateRequestSerializer.java,0,4,0,2,0,6
 skywalking-master\skywalking-master\oap-server\server-core\src\main\java\org\apache\skywalking\oap\server\core\source\NetworkAddressAliasSetup.java,32,12,0,5,0,17
 skywalking-master\skywalking-master\oap-server\server-library\library-module\src\main\java\org\apache\skywalking\oap\server\library\module\ModuleStartException.java,10,5,0,1,0,6
 skywalking-master\skywalking-master\oap-server\server-library\library-util\src\test\java\org\apache\skywalking\oap\server\library\util\ResourceUtilsTest.java,24,5,0,2,0,7
 skywalking-master\skywalking-master\oap-server\server-receiver-plugin\skywalking-trace-receiver-plugin\src\test\java\org\apache\skywalking\oap\server\receiver\trace\provider\parser\listener\MockReceiver.java,19,6,0,4,0,10
 skywalking-master\skywalking-master\oap-server\server-core\src\main\java\org\apache\skywalking\oap\server\core\query\type\AlarmMessage.java,15,10,0,1,0,11
 skywalking-master\skywalking-master\oap-server\server-library\library-elasticsearch-client\src\main\java\org\apache\skywalking\library\elasticsearch\response\IndexTemplate.java,0,6,0,1,8,15
 skywalking-master\skywalking-master\oap-server\analyzer\agent-analyzer\src\test\java\org\apache\skywalking\oap\server\analyzer\provider\meter\process\MeterProcessorTest.java,70,29,1,15,0,45
 skywalking-master\skywalking-master\oap-server\server-storage-plugin\storage-influxdb-plugin\src\main\java\org\apache\skywalking\oap\server\storage\plugin\influxdb\query\TopologyQuery.java,261,63,0,50,0,113
 skywalking-master\skywalking-master\oap-server\server-alarm-plugin\src\main\java\org\apache\skywalking\oap\server\core\alarm\provider\AlarmRule.java,46,26,4,7,0,37
 skywalking-master\skywalking-master\oap-server\server-core\src\main\java\org\apache\skywalking\oap\server\core\analysis\metrics\DoubleAvgMetrics.java,49,18,0,9,0,27
 skywalking-master\skywalking-master\oap-server\analyzer\meter-analyzer\src\test\java\org\apache\skywalking\oap\meter\analyzer\dsl\FunctionTest.java,112,61,3,31,0,95
 skywalking-master\skywalking-master\oap-server\server-tools\profile-exporter\tool-profile-snapshot-bootstrap\src\test\java\org\apache\skywalking\oap\server\tool\profile\exporter\ProfileAnalyzeSnapshotDAO.java,45,33,1,15,0,49
 skywalking-master\skywalking-master\oap-server\server-library\library-elasticsearch-client\src\main\java\org\apache\skywalking\library\elasticsearch\requests\factory\v7\V7TemplateFactory.java,0,7,0,3,0,10
 skywalking-master\skywalking-master\oap-server\server-core\src\test\java\org\apache\skywalking\oap\server\core\remote\client\GRPCRemoteClientRealServer.java,18,6,1,2,0,9
 skywalking-master\skywalking-master\oap-server\server-storage-plugin\storage-influxdb-plugin\src\main\java\org\apache\skywalking\oap\server\storage\plugin\influxdb\query\BrowserLogQuery.java,75,15,0,15,0,30
 skywalking-master\skywalking-master\oap-server\server-receiver-plugin\skywalking-sharing-server-plugin\src\main\java\org\apache\skywalking\oap\server\receiver\sharing\server\SharingServerConfig.java,33,18,0,1,0,19
 skywalking-master\skywalking-master\oap-server\server-core\src\main\java\org\apache\skywalking\oap\server\core\query\sql\Where.java,4,1,0,1,0,2
 skywalking-master\skywalking-master\oap-server\server-storage-plugin\storage-jdbc-hikaricp-plugin\src\main\java\org\apache\skywalking\oap\server\storage\plugin\jdbc\postgresql\PostgreSQLTableInstaller.java,67,21,0,11,0,32
 skywalking-master\skywalking-master\oap-server\server-receiver-plugin\skywalking-profile-receiver-plugin\src\main\java\org\apache\skywalking\oap\server\receiver\profile\module\ProfileModule.java,14,5,0,1,0,6
 skywalking-master\skywalking-master\oap-server\server-core\src\test\java\org\apache\skywalking\oap\server\core\analysis\metrics\expression\InMatchTest.java,51,7,0,1,0,8
 skywalking-master\skywalking-master\oap-server\server-core\src\main\java\org\apache\skywalking\oap\server\core\analysis\metrics\RateMetrics.java,59,17,0,6,0,23
 skywalking-master\skywalking-master\oap-server\server-core\src\test\java\org\apache\skywalking\oap\server\core\profiling\ebpf\analyze\EBPFProfilingAnalyzeContext.java,101,29,0,19,0,48
 skywalking-master\skywalking-master\oap-server\server-configuration\configuration-apollo\src\main\java\org\apache\skywalking\oap\server\configuration\apollo\ApolloConfigurationProvider.java,47,6,0,3,0,9
 skywalking-master\skywalking-master\oap-server\server-core\src\main\java\org\apache\skywalking\oap\server\core\alarm\AlarmStandardPersistence.java,49,13,0,6,0,19
 skywalking-master\skywalking-master\oap-server\server-core\src\main\java\org\apache\skywalking\oap\server\core\server\auth\AuthenticationInterceptor.java,40,18,0,5,0,23
 skywalking-master\skywalking-master\oap-server\server-core\src\main\java\org\apache\skywalking\oap\server\core\query\input\TraceQueryCondition.java,14,11,0,1,0,12
 skywalking-master\skywalking-master\oap-server\server-query-plugin\query-graphql-plugin\src\main\java\org\apache\skywalking\oap\query\graphql\GraphQLQueryHandler.java,30,6,1,3,0,10
 skywalking-master\skywalking-master\oap-server\server-library\library-module\src\test\java\org\apache\skywalking\oap\server\library\module\BaseModuleA.java,22,3,0,1,0,4
 skywalking-master\skywalking-master\oap-server\oal-rt\src\main\java\org\apache\skywalking\oal\rt\OALRuntime.java,467,140,22,80,0,242
 skywalking-master\skywalking-master\oap-server\server-core\src\main\java\org\apache\skywalking\oap\server\core\oal\rt\OALCompileException.java,10,6,0,1,0,7
 skywalking-master\skywalking-master\oap-server\server-tools\profile-exporter\tool-profile-snapshot-bootstrap\src\test\java\org\apache\skywalking\oap\server\tool\profile\exporter\test\ProfileSnapshotExporterTest.java,74,24,1,23,0,48
 skywalking-master\skywalking-master\oap-server\analyzer\agent-analyzer\src\main\java\org\apache\skywalking\oap\server\analyzer\provider\trace\sampling\SamplingPolicySettings.java,25,13,0,4,0,17
 skywalking-master\skywalking-master\oap-server\server-alarm-plugin\src\main\java\org\apache\skywalking\oap\server\core\alarm\provider\Rules.java,18,10,0,6,0,16
 skywalking-master\skywalking-master\oap-server\server-telemetry\telemetry-prometheus\src\main\java\org\apache\skywalking\oap\server\telemetry\prometheus\PrometheusMetricsCreator.java,19,20,0,5,0,25
 skywalking-master\skywalking-master\oap-server\server-core\src\main\java\org\apache\skywalking\oap\server\core\browser\manual\BrowserAppTrafficSourceDispatcher.java,13,4,1,5,0,10
 skywalking-master\skywalking-master\oap-server\server-core\src\main\java\org\apache\skywalking\oap\server\core\analysis\metrics\MultiIntValuesHolder.java,0,1,0,1,0,2
 skywalking-master\skywalking-master\oap-server\server-telemetry\telemetry-api\src\main\java\org\apache\skywalking\oap\server\telemetry\api\MetricsCreator.java,0,34,0,10,0,44
 skywalking-master\skywalking-master\oap-server\oal-rt\src\main\java\org\apache\skywalking\oal\rt\output\DispatcherContext.java,8,4,0,1,0,5
 skywalking-master\skywalking-master\oap-server\server-alarm-plugin\src\main\java\org\apache\skywalking\oap\server\core\alarm\provider\MetricsValueType.java,0,5,0,1,0,6
 skywalking-master\skywalking-master\apm-protocol\apm-network\src\main\java\org\apache\skywalking\oap\server\network\trace\component\command\EBPFProfilingTaskCommand.java,47,40,0,12,0,52
 skywalking-master\skywalking-master\oap-server\oal-rt\src\main\java\org\apache\skywalking\oal\rt\output\AllDispatcherContext.java,4,2,0,1,0,3
 skywalking-master\skywalking-master\oap-server\server-core\src\main\java\org\apache\skywalking\oap\server\core\storage\profiling\ebpf\IEBPFProfilingDataDAO.java,0,5,0,3,0,8
 skywalking-master\skywalking-master\oap-server\server-core\src\main\java\org\apache\skywalking\oap\server\core\query\type\BrowserErrorLog.java,15,12,0,1,0,13
 skywalking-master\skywalking-master\oap-server\server-telemetry\telemetry-api\src\main\java\org\apache\skywalking\oap\server\telemetry\api\HistogramMetrics.java,35,13,0,2,0,15
 skywalking-master\skywalking-master\oap-server\server-core\src\main\java\org\apache\skywalking\oap\server\core\query\MetadataQueryService.java,0,45,1,21,0,67
 skywalking-master\skywalking-master\oap-server\analyzer\meter-analyzer\src\test\java\org\apache\skywalking\oap\meter\analyzer\dsl\counter\CounterWindowTest.java,68,30,0,5,0,35
 skywalking-master\skywalking-master\oap-server\server-core\src\main\java\org\apache\skywalking\oap\server\core\query\type\EBPFProfilingAnalyzeTimeRange.java,7,4,0,1,0,5
 skywalking-master\skywalking-master\oap-server\server-receiver-plugin\envoy-metrics-receiver-plugin\src\main\java\org\apache\skywalking\oap\server\receiver\envoy\metrics\adapters\ProtoMetricFamily2MetricsAdapter.java,92,28,0,14,0,42
 skywalking-master\skywalking-master\oap-server\server-library\library-module\src\main\java\org\apache\skywalking\oap\server\library\module\ModuleProvider.java,103,27,3,15,0,45
 skywalking-master\skywalking-master\oap-server\server-alarm-plugin\src\main\java\org\apache\skywalking\oap\server\core\alarm\provider\AlarmRulesWatcher.java,100,39,4,15,0,58
 skywalking-master\skywalking-master\oap-server\exporter\src\test\java\org\apache\skywalking\oap\server\exporter\provider\grpc\GRPCExporterTest.java,75,24,1,12,0,37
 skywalking-master\skywalking-master\oap-server\server-core\src\main\java\org\apache\skywalking\oap\server\core\source\ServiceMeta.java,16,5,1,3,0,9
 skywalking-master\skywalking-master\oap-server\server-core\src\main\java\org\apache\skywalking\oap\server\core\query\type\ProfiledSegment.java,10,2,0,1,0,3
 skywalking-master\skywalking-master\oap-server\server-alarm-plugin\src\test\java\org\apache\skywalking\oap\server\core\alarm\provider\OPTest.java,21,26,0,1,0,27
 skywalking-master\skywalking-master\oap-server\server-query-plugin\query-graphql-plugin\src\main\java\org\apache\skywalking\oap\query\graphql\resolver\MetadataQuery.java,69,41,0,19,0,60
 skywalking-master\skywalking-master\oap-server\oal-rt\src\main\java\org\apache\skywalking\oal\rt\parser\AnalysisResult.java,114,21,0,13,0,34
 skywalking-master\skywalking-master\oap-server\server-telemetry\telemetry-api\src\main\java\org\apache\skywalking\oap\server\telemetry\none\NoneTelemetryProvider.java,39,10,2,7,1,20
 skywalking-master\skywalking-master\oap-server\server-library\library-client\src\main\java\org\apache\skywalking\oap\server\library\client\request\InsertRequest.java,0,1,0,1,0,2
 skywalking-master\skywalking-master\oap-server\analyzer\log-analyzer\src\main\java\org\apache\skywalking\oap\log\analyzer\provider\log\ILogAnalysisListenerFactoryManager.java,0,3,0,2,0,5
 skywalking-master\skywalking-master\oap-server\analyzer\meter-analyzer\src\main\java\org\apache\skywalking\oap\meter\analyzer\MetricConvert.java,50,16,1,7,0,24
 skywalking-master\skywalking-master\oap-server\server-receiver-plugin\skywalking-mesh-receiver-plugin\src\main\java\org\apache\skywalking\aop\server\receiver\mesh\MeshModuleConfig.java,3,0,0,1,0,1
 skywalking-master\skywalking-master\oap-server\server-core\src\main\java\org\apache\skywalking\oap\server\core\query\type\QueryOrder.java,0,2,0,1,0,3
 skywalking-master\skywalking-master\oap-server\server-configuration\configuration-nacos\src\main\java\org\apache\skywalking\oap\server\configuration\nacos\NacosConfigWatcherRegister.java,133,30,0,15,0,45
 skywalking-master\skywalking-master\oap-server\server-library\library-module\src\test\java\org\apache\skywalking\oap\server\library\module\ModuleABusiness1Impl.java,0,0,1,1,0,2
 skywalking-master\skywalking-master\test\e2e-v2\java-test-service\e2e-service-consumer\src\main\java\org\apache\skywalking\e2e\controller\UserController.java,50,21,3,9,0,33
 skywalking-master\skywalking-master\test\e2e-v2\java-test-service\e2e-service-provider\src\main\java\test\apache\skywalking\e2e\profile\ProfileController.java,13,5,0,2,0,7
 skywalking-master\skywalking-master\oap-server\server-core\src\main\java\org\apache\skywalking\oap\server\core\analysis\metrics\CPMMetrics.java,0,11,0,5,0,16
 skywalking-master\skywalking-master\oap-server\server-library\library-elasticsearch-client\src\main\java\org\apache\skywalking\library\elasticsearch\requests\search\TermsQuery.java,0,6,0,2,1,9
 skywalking-master\skywalking-master\oap-server\server-core\src\main\java\org\apache\skywalking\oap\server\core\query\type\TopNRecord.java,6,3,0,1,0,4
 skywalking-master\skywalking-master\oap-server\server-core\src\main\java\org\apache\skywalking\oap\server\core\storage\query\ITopNRecordsQueryDAO.java,0,6,1,3,0,10
 skywalking-master\skywalking-master\oap-server\server-core\src\main\java\org\apache\skywalking\oap\server\core\remote\data\StreamData.java,0,2,0,1,0,3
 skywalking-master\skywalking-master\oap-server\server-cluster-plugin\cluster-etcd-plugin\src\main\java\org\apache\skywalking\oap\server\cluster\plugin\etcd\EtcdEndpoint.java,48,22,0,1,0,23
 skywalking-master\skywalking-master\oap-server\server-library\library-elasticsearch-client\src\main\java\org\apache\skywalking\library\elasticsearch\response\Mappings.java,0,4,0,1,10,15
 skywalking-master\skywalking-master\oap-server\server-storage-plugin\storage-iotdb-plugin\src\main\java\org\apache\skywalking\oap\server\storage\plugin\iotdb\utils\IoTDBDataConverter.java,151,57,0,32,0,89
 skywalking-master\skywalking-master\oap-server\server-core\src\main\java\org\apache\skywalking\oap\server\core\analysis\metrics\P50Metrics.java,6,3,0,2,0,5
 skywalking-master\skywalking-master\oap-server\analyzer\meter-analyzer\src\main\java\org\apache\skywalking\oap\meter\analyzer\dsl\SampleFamilyBuilder.java,32,17,0,2,0,19
 skywalking-master\skywalking-master\oap-server\server-storage-plugin\storage-elasticsearch-plugin\src\main\java\org\apache\skywalking\oap\server\storage\plugin\elasticsearch\query\AlarmQueryEsDAO.java,62,11,0,15,0,26
 skywalking-master\skywalking-master\oap-server\server-core\src\main\java\org\apache\skywalking\oap\server\core\source\Log.java,15,3,0,1,0,4
 skywalking-master\skywalking-master\oap-server\server-storage-plugin\storage-influxdb-plugin\src\main\java\org\apache\skywalking\oap\server\storage\plugin\influxdb\query\ProfileTaskLogQuery.java,44,20,0,12,0,32
 skywalking-master\skywalking-master\oap-server\server-configuration\configuration-zookeeper\src\main\java\org\apache\skywalking\oap\server\configuration\zookeeper\ZookeeperConfigWatcherRegister.java,55,16,2,9,0,27
 skywalking-master\skywalking-master\oap-server\server-configuration\configuration-apollo\src\test\java\org\apache\skywalking\oap\server\configuration\apollo\ApolloConfigurationTestProvider.java,89,16,2,8,0,26
 skywalking-master\skywalking-master\oap-server\exporter\src\test\java\org\apache\skywalking\oap\server\exporter\provider\grpc\MockLongValueMetrics.java,7,3,0,2,0,5
 skywalking-master\skywalking-master\oap-server\server-tools\profile-exporter\tool-profile-snapshot-server-mock\src\main\java\org\apache\skywalking\oap\server\tool\profile\core\MockCoreModuleConfig.java,3,1,0,1,0,2
 skywalking-master\skywalking-master\oap-server\server-library\library-elasticsearch-client\src\test\java\org\apache\skywalking\library\elasticsearch\requests\search\SearchBuilderTest.java,38,9,0,5,0,14
 skywalking-master\skywalking-master\oap-server\server-core\src\main\java\org\apache\skywalking\oap\server\core\remote\selector\HashCodeSelector.java,10,4,0,2,0,6
 skywalking-master\skywalking-master\oap-server\server-library\library-util\src\main\java\org\apache\skywalking\oap\server\library\util\prometheus\metrics\MetricFamily.java,0,38,0,5,1,44
 skywalking-master\skywalking-master\oap-server\server-core\src\main\java\org\apache\skywalking\oap\server\core\query\type\ServiceInstanceNode.java,10,6,0,1,0,7
 skywalking-master\skywalking-master\oap-server\server-core\src\test\java\org\apache\skywalking\oap\server\core\WorkPathTest.java,7,1,0,1,0,2
 skywalking-master\skywalking-master\oap-server\server-receiver-plugin\skywalking-browser-receiver-plugin\src\main\java\org\apache\skywalking\oap\server\receiver\browser\provider\handler\rest\BrowserPerfServiceHTTPHandler.java,88,36,4,17,0,57
 skywalking-master\skywalking-master\oap-server\oal-rt\src\main\java\org\apache\skywalking\oal\rt\util\ClassMethodUtil.java,63,19,4,5,0,28
 skywalking-master\skywalking-master\oap-server\server-storage-plugin\storage-jdbc-hikaricp-plugin\src\main\java\org\apache\skywalking\oap\server\storage\plugin\jdbc\h2\dao\H2TraceQueryDAO.java,209,86,2,36,0,124
 skywalking-master\skywalking-master\oap-server\server-core\src\main\java\org\apache\skywalking\oap\server\core\query\input\BrowserErrorLogQueryCondition.java,9,7,0,1,0,8
 skywalking-master\skywalking-master\oap-server\server-core\src\main\java\org\apache\skywalking\oap\server\core\query\input\EBPFProfilingTaskCondition.java,11,5,0,2,0,7
 skywalking-master\skywalking-master\oap-server\server-core\src\main\java\org\apache\skywalking\oap\server\core\analysis\meter\function\MeterFunction.java,0,3,0,3,0,6
 skywalking-master\skywalking-master\oap-server\server-core\src\main\java\org\apache\skywalking\oap\server\core\analysis\manual\relation\service\ServiceCallRelationDispatcher.java,35,9,1,5,0,15
 skywalking-master\skywalking-master\oap-server\server-library\library-elasticsearch-client\src\main\java\org\apache\skywalking\library\elasticsearch\requests\search\aggregation\MaxAggregationBuilder.java,0,7,0,1,0,8
 skywalking-master\skywalking-master\oap-server\server-core\src\main\java\org\apache\skywalking\oap\server\core\analysis\metrics\DataTable.java,122,47,1,5,0,53
 skywalking-master\skywalking-master\oap-server\server-storage-plugin\storage-elasticsearch-plugin\src\main\java\org\apache\skywalking\oap\server\storage\plugin\elasticsearch\query\TopNRecordsQueryEsDAO.java,51,9,0,11,0,20
 skywalking-master\skywalking-master\oap-server\server-library\library-elasticsearch-client\src\main\java\org\apache\skywalking\library\elasticsearch\requests\factory\v6\codec\V6MappingsDeserializer.java,0,6,0,7,1,14
 skywalking-master\skywalking-master\oap-server\server-testing\src\main\java\org\apache\skywalking\oap\server\testing\module\ModuleManagerTesting.java,19,11,0,4,0,15
 skywalking-master\skywalking-master\oap-server\server-cluster-plugin\cluster-kubernetes-plugin\src\main\java\org\apache\skywalking\oap\server\cluster\plugin\kubernetes\UidEnvSupplier.java,14,4,0,1,0,5
 skywalking-master\skywalking-master\oap-server\server-core\src\main\java\org\apache\skywalking\oap\server\core\storage\annotation\Column.java,0,38,0,26,0,64
 skywalking-master\skywalking-master\oap-server\server-core\src\main\java\org\apache\skywalking\oap\server\core\exporter\ExporterModule.java,13,3,0,1,0,4
 skywalking-master\skywalking-master\oap-server\server-storage-plugin\storage-jdbc-hikaricp-plugin\src\main\java\org\apache\skywalking\oap\server\storage\plugin\jdbc\mysql\MySQLStorageProvider.java,135,52,1,68,0,121
 skywalking-master\skywalking-master\oap-server\server-cluster-plugin\cluster-etcd-plugin\src\main\java\org\apache\skywalking\oap\server\cluster\plugin\etcd\ClusterModuleEtcdConfig.java,30,15,0,2,0,17
 skywalking-master\skywalking-master\oap-server\server-receiver-plugin\envoy-metrics-receiver-plugin\src\main\java\org\apache\skywalking\oap\server\receiver\envoy\als\ALSHTTPAnalysis.java,0,1,0,1,0,2
 skywalking-master\skywalking-master\oap-server\analyzer\agent-analyzer\src\test\java\org\apache\skywalking\oap\server\analyzer\provider\trace\sampling\SamplingPolicySettingsReaderTest.java,20,16,0,9,0,25
 skywalking-master\skywalking-master\oap-server\server-receiver-plugin\skywalking-sharing-server-plugin\src\main\java\org\apache\skywalking\oap\server\receiver\sharing\server\SharingServerModuleProvider.java,138,37,3,26,0,66
 skywalking-master\skywalking-master\oap-server\analyzer\event-analyzer\src\main\java\org\apache\skywalking\oap\server\analyzer\event\listener\EventAnalyzerListener.java,0,6,1,3,0,10
 skywalking-master\skywalking-master\oap-server\server-receiver-plugin\skywalking-browser-receiver-plugin\src\main\java\org\apache\skywalking\oap\server\receiver\browser\provider\parser\errorlog\listener\SourceBuilder.java,0,16,0,8,0,24
 skywalking-master\skywalking-master\oap-server\analyzer\log-analyzer\src\main\java\org\apache\skywalking\oap\log\analyzer\dsl\spec\extractor\ExtractorSpec.java,186,39,0,14,0,53
 skywalking-master\skywalking-master\oap-server\server-core\src\main\java\org\apache\skywalking\oap\server\core\source\ScopeDeclaration.java,0,7,0,3,0,10
 skywalking-master\skywalking-master\oap-server\server-core\src\main\java\org\apache\skywalking\oap\server\core\analysis\metrics\MinDoubleMetrics.java,39,9,1,6,0,16
 skywalking-master\skywalking-master\oap-server\server-receiver-plugin\skywalking-ebpf-receiver-plugin\src\main\java\org\apache\skywalking\oap\server\receiver\ebpf\provider\handler\EBPFProcessServiceHandler.java,0,34,0,33,0,67
 skywalking-master\skywalking-master\oap-server\server-library\library-module\src\main\java\org\apache\skywalking\oap\server\library\module\CycleDependencyException.java,6,2,0,1,0,3
 skywalking-master\skywalking-master\oap-server\server-core\src\main\java\org\apache\skywalking\oap\server\core\analysis\meter\dynamic\MeterClassPackageHolder.java,3,2,0,2,0,4
 skywalking-master\skywalking-master\oap-server\server-core\src\main\java\org\apache\skywalking\oap\server\core\query\input\Duration.java,43,21,0,5,0,26
 skywalking-master\skywalking-master\oap-server\server-core\src\main\java\org\apache\skywalking\oap\server\core\storage\StorageDAO.java,0,5,0,2,0,7
 skywalking-master\skywalking-master\oap-server\server-storage-plugin\storage-influxdb-plugin\src\main\java\org\apache\skywalking\oap\server\storage\plugin\influxdb\InfluxConstants.java,0,17,24,1,0,42
 skywalking-master\skywalking-master\oap-server\server-core\src\main\java\org\apache\skywalking\oap\server\core\alarm\ServiceInstanceMetaInAlarm.java,27,7,0,1,0,8
 skywalking-master\skywalking-master\oap-server\server-core\src\main\java\org\apache\skywalking\oap\server\core\source\AbstractLog.java,20,15,0,2,0,17
 skywalking-master\skywalking-master\oap-server\server-core\src\main\java\org\apache\skywalking\oap\server\core\alarm\AlarmRecord.java,73,29,1,9,0,39
 skywalking-master\skywalking-master\oap-server\server-receiver-plugin\otel-receiver-plugin\src\main\java\org\apache\skywalking\oap\server\receiver\otel\HandlerInitializationException.java,10,5,0,1,0,6
 skywalking-master\skywalking-master\oap-server\server-core\src\main\java\org\apache\skywalking\oap\server\core\exporter\ExportEvent.java,24,8,0,3,0,11
 skywalking-master\skywalking-master\oap-server\server-library\library-datacarrier-queue\src\test\java\org\apache\skywalking\oap\server\library\datacarrier\DataCarrierTest.java,119,40,4,22,2,68
 skywalking-master\skywalking-master\oap-server\server-cluster-plugin\cluster-kubernetes-plugin\src\test\java\org\apache\skywalking\oap\server\cluster\plugin\kubernetes\KubernetesCoordinatorTest.java,76,27,2,15,0,44
 skywalking-master\skywalking-master\oap-server\server-receiver-plugin\skywalking-zabbix-receiver-plugin\src\main\java\org\apache\skywalking\oap\server\receiver\zabbix\provider\ZabbixReceiverProvider.java,58,16,1,12,0,29
 skywalking-master\skywalking-master\oap-server\server-library\library-util\src\main\java\org\apache\skywalking\oap\server\library\util\prometheus\metrics\MetricType.java,0,5,0,1,0,6
 skywalking-master\skywalking-master\oap-server\server-library\library-datacarrier-queue\src\main\java\org\apache\skywalking\oap\server\library\datacarrier\consumer\IConsumer.java,0,6,2,2,0,10
 skywalking-master\skywalking-master\oap-server\server-receiver-plugin\skywalking-clr-receiver-plugin\src\main\java\org\apache\skywalking\oap\server\receiver\clr\provider\handler\CLRSourceDispatcher.java,51,19,1,11,0,31
 skywalking-master\skywalking-master\oap-server\server-receiver-plugin\skywalking-event-receiver-plugin\src\main\java\org\apache\skywalking\oap\server\receiver\event\grpc\EventGrpcServiceHandler.java,0,14,2,6,0,22
 skywalking-master\skywalking-master\oap-server\server-configuration\configuration-etcd\src\main\java\org\apache\skywalking\oap\server\configuration\etcd\EtcdServerSettings.java,25,12,0,2,0,14
 skywalking-master\skywalking-master\oap-server\analyzer\agent-analyzer\src\main\java\org\apache\skywalking\oap\server\analyzer\provider\meter\process\MeterProcessService.java,31,11,0,4,0,15
 skywalking-master\skywalking-master\oap-server\server-core\src\main\java\org\apache\skywalking\oap\server\core\config\DownSamplingConfigService.java,25,10,4,3,0,17
 skywalking-master\skywalking-master\oap-server\server-core\src\main\java\org\apache\skywalking\oap\server\core\query\PaginationUtils.java,0,6,0,2,0,8
 skywalking-master\skywalking-master\oap-server\server-storage-plugin\storage-iotdb-plugin\src\main\java\org\apache\skywalking\oap\server\storage\plugin\iotdb\IoTDBTableInstaller.java,17,7,0,1,0,8
 skywalking-master\skywalking-master\oap-server\server-library\library-module\src\main\java\org\apache\skywalking\oap\server\library\module\ApplicationConfiguration.java,61,29,2,5,0,36
 skywalking-master\skywalking-master\oap-server\server-core\src\main\java\org\apache\skywalking\oap\server\core\profiling\trace\analyze\ProfileStackNode.java,0,67,1,24,0,92
 skywalking-master\skywalking-master\oap-server\server-storage-plugin\storage-iotdb-plugin\src\main\java\org\apache\skywalking\oap\server\storage\plugin\iotdb\base\IoTDBHistoryDeleteDAO.java,13,8,0,4,0,12
 skywalking-master\skywalking-master\oap-server\server-core\src\main\java\org\apache\skywalking\oap\server\core\storage\BlockingBatchQueue.java,0,2,0,2,0,4
 skywalking-master\skywalking-master\oap-server\oal-rt\src\main\java\org\apache\skywalking\oal\rt\parser\FilterStmts.java,25,7,0,2,0,9
 skywalking-master\skywalking-master\oap-server\server-cluster-plugin\cluster-nacos-plugin\src\main\java\org\apache\skywalking\oap\server\cluster\plugin\nacos\ClusterModuleNacosConfig.java,12,10,0,1,0,11
 skywalking-master\skywalking-master\oap-server\server-configuration\configuration-zookeeper\src\test\java\org\apache\skywalking\oap\server\configuration\zookeeper\it\ITZookeeperConfigurationTest.java,117,46,12,25,0,83
 skywalking-master\skywalking-master\oap-server\server-storage-plugin\storage-elasticsearch-plugin\src\main\java\org\apache\skywalking\oap\server\storage\plugin\elasticsearch\query\EBPFProfilingScheduleEsDAO.java,37,19,0,19,0,38
 skywalking-master\skywalking-master\oap-server\server-storage-plugin\storage-influxdb-plugin\src\main\java\org\apache\skywalking\oap\server\storage\plugin\influxdb\InfluxStorageConfig.java,14,10,0,1,0,11
 skywalking-master\skywalking-master\oap-server\server-receiver-plugin\configuration-discovery-receiver-plugin\src\main\java\org\apache\skywalking\oap\server\recevier\configuration\discovery\AgentConfigurationsTable.java,8,3,0,2,0,5
 skywalking-master\skywalking-master\oap-server\server-library\library-elasticsearch-client\src\test\java\org\apache\skywalking\library\elasticsearch\ITElasticSearchTest.java,227,41,0,28,0,69
 skywalking-master\skywalking-master\oap-server\server-fetcher-plugin\kafka-fetcher-plugin\src\main\java\org\apache\skywalking\oap\server\analyzer\agent\kafka\provider\handler\JsonLogHandler.java,27,11,0,4,0,15
 skywalking-master\skywalking-master\oap-server\server-core\src\main\java\org\apache\skywalking\oap\server\core\analysis\DownSampling.java,0,12,0,2,0,14
 skywalking-master\skywalking-master\oap-server\server-core\src\main\java\org\apache\skywalking\oap\server\core\analysis\manual\service\ServiceMetaDispatcher.java,11,2,0,2,0,4
 skywalking-master\skywalking-master\oap-server\server-alarm-plugin\src\main\java\org\apache\skywalking\oap\server\core\alarm\provider\AlarmSettings.java,3,0,0,1,0,1
 skywalking-master\skywalking-master\oap-server\server-core\src\test\java\org\apache\skywalking\oap\server\core\storage\BlockingBatchQueueWithReentrantLock.java,70,17,1,2,0,20
 skywalking-master\skywalking-master\oap-server\server-receiver-plugin\envoy-metrics-receiver-plugin\src\main\java\org\apache\skywalking\oap\server\receiver\envoy\MetricServiceGRPCHandlerV3.java,0,4,0,3,0,7
 skywalking-master\skywalking-master\oap-server\server-core\src\main\java\org\apache\skywalking\oap\server\core\query\type\ServiceInstance.java,18,7,0,1,0,8
 skywalking-master\skywalking-master\oap-server\server-core\src\main\java\org\apache\skywalking\oap\server\core\analysis\worker\MetricsAggregateWorker.java,100,31,3,12,0,46
 skywalking-master\skywalking-master\oap-server\server-core\src\test\java\org\apache\skywalking\oap\server\core\remote\client\RemoteClientManagerTestCase.java,196,59,7,36,0,102
 skywalking-master\skywalking-master\oap-server\server-receiver-plugin\skywalking-profile-receiver-plugin\src\main\java\org\apache\skywalking\oap\server\receiver\profile\provider\handler\ProfileTaskServiceHandler.java,0,41,1,29,0,71
 skywalking-master\skywalking-master\oap-server\analyzer\event-analyzer\src\main\java\org\apache\skywalking\oap\server\analyzer\event\EventAnalyzerModule.java,15,3,0,1,0,4
 skywalking-master\skywalking-master\oap-server\server-storage-plugin\storage-elasticsearch-plugin\src\main\java\org\apache\skywalking\oap\server\storage\plugin\elasticsearch\StorageModuleElasticsearchConfig.java,112,42,0,16,0,58
 skywalking-master\skywalking-master\oap-server\analyzer\agent-analyzer\src\main\java\org\apache\skywalking\oap\server\analyzer\provider\meter\process\IMeterProcessService.java,0,2,0,1,0,3
 skywalking-master\skywalking-master\oap-server\server-receiver-plugin\configuration-discovery-receiver-plugin\src\main\java\org\apache\skywalking\oap\server\recevier\configuration\discovery\AgentConfigurationsWatcher.java,52,16,2,8,0,26
 skywalking-master\skywalking-master\oap-server\server-core\src\main\java\org\apache\skywalking\oap\server\core\query\enumeration\MetricsType.java,0,8,0,4,0,12
 skywalking-master\skywalking-master\oap-server\server-core\src\main\java\org\apache\skywalking\oap\server\core\analysis\meter\function\avg\AvgLabeledFunction.java,0,39,0,15,0,54
 skywalking-master\skywalking-master\oap-server\server-storage-plugin\storage-elasticsearch-plugin\src\main\java\org\apache\skywalking\oap\server\storage\plugin\elasticsearch\cache\NetworkAddressAliasEsDAO.java,49,18,2,14,0,34
 skywalking-master\skywalking-master\oap-server\server-receiver-plugin\skywalking-meter-receiver-plugin\src\main\java\org\apache\skywalking\oap\server\receiver\meter\provider\handler\MeterServiceHandlerCompat.java,0,4,0,4,0,8
 skywalking-master\skywalking-master\test\e2e-v2\java-test-service\e2e-service-provider\src\main\java\org\apache\skywalking\e2e\lua\LuaController.java,21,6,3,3,0,12
 skywalking-master\skywalking-master\oap-server\server-testing\src\main\java\org\apache\skywalking\oap\server\testing\module\ModuleDefineTesting.java,14,4,0,1,0,5
 skywalking-master\skywalking-master\oap-server\server-storage-plugin\storage-elasticsearch-plugin\src\main\java\org\apache\skywalking\oap\server\storage\plugin\elasticsearch\base\StorageEsDAO.java,27,14,0,6,0,20
 skywalking-master\skywalking-master\oap-server\server-core\src\main\java\org\apache\skywalking\oap\server\core\config\group\EndpointGroupingRuleReader.java,48,12,0,8,0,20
 skywalking-master\skywalking-master\oap-server\server-library\library-elasticsearch-client\src\main\java\org\apache\skywalking\library\elasticsearch\response\search\SearchResponse.java,0,3,0,1,4,8
 skywalking-master\skywalking-master\oap-server\server-core\src\main\java\org\apache\skywalking\oap\server\core\analysis\worker\AlarmNotifyWorker.java,16,7,0,2,0,9
 skywalking-master\skywalking-master\oap-server\server-core\src\main\java\org\apache\skywalking\oap\server\core\storage\IMetricsDAO.java,0,13,0,10,0,23
 skywalking-master\skywalking-master\oap-server\server-receiver-plugin\envoy-metrics-receiver-plugin\src\main\java\org\apache\skywalking\oap\server\receiver\envoy\als\tcp\AbstractTCPAccessLogAnalyzer.java,19,7,0,5,0,12
 skywalking-master\skywalking-master\oap-server\server-receiver-plugin\skywalking-browser-receiver-plugin\src\main\java\org\apache\skywalking\oap\server\receiver\browser\provider\parser\performance\listener\PerfDataListenerFactory.java,0,3,0,5,0,8
 skywalking-master\skywalking-master\oap-server\server-core\src\main\java\org\apache\skywalking\oap\server\core\oal\rt\CoreOALDefine.java,11,3,1,1,0,5
 skywalking-master\skywalking-master\oap-server\analyzer\agent-analyzer\src\main\java\org\apache\skywalking\oap\server\analyzer\provider\trace\parser\ISegmentParserListenerManager.java,0,2,0,2,0,4
 skywalking-master\skywalking-master\oap-server\server-receiver-plugin\skywalking-zabbix-receiver-plugin\src\main\java\org\apache\skywalking\oap\server\receiver\zabbix\provider\protocol\bean\ZabbixRequest.java,37,11,0,1,0,12
 skywalking-master\skywalking-master\oap-server\server-storage-plugin\storage-influxdb-plugin\src\main\java\org\apache\skywalking\oap\server\storage\plugin\influxdb\query\MetricsQuery.java,166,32,1,26,0,59
 skywalking-master\skywalking-master\oap-server\server-core\src\main\java\org\apache\skywalking\oap\server\core\analysis\record\Record.java,13,7,1,4,0,12
 skywalking-master\skywalking-master\oap-server\server-core\src\test\java\org\apache\skywalking\oap\server\core\analysis\metrics\PxxMetricsTest.java,147,64,1,2,0,67
 skywalking-master\skywalking-master\oap-server\server-configuration\configuration-apollo\src\main\java\org\apache\skywalking\oap\server\configuration\apollo\ApolloConfigWatcherRegister.java,58,15,0,9,0,24
 skywalking-master\skywalking-master\oap-server\server-library\library-server\src\main\java\org\apache\skywalking\oap\server\library\server\http\HTTPServerConfig.java,18,11,0,1,0,12
 skywalking-master\skywalking-master\oap-server\analyzer\log-analyzer\src\main\java\org\apache\skywalking\oap\log\analyzer\dsl\spec\parser\YamlParserSpec.java,15,5,0,2,0,7
 skywalking-master\skywalking-master\oap-server\server-core\src\main\java\org\apache\skywalking\oap\server\core\storage\type\HashMapConverter.java,79,18,0,6,0,24
 skywalking-master\skywalking-master\oap-server\server-core\src\main\java\org\apache\skywalking\oap\server\core\query\type\Log.java,18,12,0,1,0,13
 skywalking-master\skywalking-master\oap-server\server-library\library-elasticsearch-client\src\main\java\org\apache\skywalking\library\elasticsearch\requests\factory\v7\V7RequestFactory.java,0,7,0,10,3,20
 skywalking-master\skywalking-master\oap-server\server-starter\src\main\java\org\apache\skywalking\oap\server\starter\config\ConfigLoader.java,0,1,0,1,0,2
 skywalking-master\skywalking-master\oap-server\server-library\library-util\src\main\java\org\apache\skywalking\oap\server\library\util\PropertyPlaceholderHelper.java,0,65,0,43,1,109
 skywalking-master\skywalking-master\oap-server\server-core\src\main\java\org\apache\skywalking\oap\server\core\source\ServiceInstanceJVMMemoryPool.java,43,15,1,7,0,23
 skywalking-master\skywalking-master\oap-server\server-core\src\main\java\org\apache\skywalking\oap\server\core\analysis\manual\service\ServiceTraffic.java,0,29,1,10,0,40
 skywalking-master\skywalking-master\oap-server\server-core\src\main\java\org\apache\skywalking\oap\server\core\remote\client\RemoteClientManager.java,228,59,4,31,0,94
 skywalking-master\skywalking-master\oap-server\server-receiver-plugin\configuration-discovery-receiver-plugin\src\test\java\org\apache\skywalking\oap\server\recevier\configuration\discovery\AgentConfigurationsReaderTest.java,33,13,0,12,0,25
 skywalking-master\skywalking-master\oap-server\server-testing\src\test\java\org\apache\skywalking\oap\server\testing\module\ModuleManagerTestCase.java,29,4,0,3,0,7
 skywalking-master\skywalking-master\oap-server\server-core\src\main\java\org\apache\skywalking\oap\server\core\server\GRPCHandlerRegisterImpl.java,24,10,0,1,0,11
 skywalking-master\skywalking-master\oap-server\server-alarm-plugin\src\main\java\org\apache\skywalking\oap\server\core\alarm\provider\NotifyHandler.java,142,47,0,42,0,89
 skywalking-master\skywalking-master\oap-server\server-core\src\main\java\org\apache\skywalking\oap\server\core\profiling\ebpf\storage\EBPFProfilingDataRecord.java,60,30,0,13,0,43
 skywalking-master\skywalking-master\oap-server\server-telemetry\telemetry-prometheus\src\main\java\org\apache\skywalking\oap\server\telemetry\prometheus\BaseMetrics.java,0,32,1,7,1,41
 skywalking-master\skywalking-master\oap-server\server-storage-plugin\storage-zipkin-elasticsearch-plugin\src\main\java\org\apache\skywalking\oap\server\storage\plugin\zipkin\elasticsearch\ZipkinStorageModuleElasticsearchProvider.java,21,6,0,5,0,11
 skywalking-master\skywalking-master\oap-server\server-core\src\main\java\org\apache\skywalking\oap\server\core\analysis\metrics\expression\BooleanNotEqualMatch.java,10,8,1,2,0,11
 skywalking-master\skywalking-master\oap-server\server-telemetry\telemetry-prometheus\src\main\java\org\apache\skywalking\oap\server\telemetry\prometheus\httpserver\HttpServerHandler.java,58,16,1,7,1,25
 skywalking-master\skywalking-master\oap-server\server-core\src\main\java\org\apache\skywalking\oap\server\core\analysis\meter\MeterSystem.java,0,88,8,62,0,158
 skywalking-master\skywalking-master\oap-server\server-core\src\main\java\org\apache\skywalking\oap\server\core\analysis\meter\function\sum\SumFunction.java,0,34,1,14,0,49
 skywalking-master\skywalking-master\oap-server\server-receiver-plugin\skywalking-clr-receiver-plugin\src\main\java\org\apache\skywalking\oap\server\receiver\clr\provider\handler\CLRMetricReportServiceHandlerCompat.java,0,4,0,4,0,8
 skywalking-master\skywalking-master\oap-server\server-cluster-plugin\cluster-nacos-plugin\src\test\java\org\apache\skywalking\oap\server\cluster\plugin\nacos\NacosCoordinatorTest.java,104,30,3,10,0,43
 skywalking-master\skywalking-master\oap-server\server-core\src\main\java\org\apache\skywalking\oap\server\core\storage\management\UITemplateManagementDAO.java,0,9,0,4,0,13
 skywalking-master\skywalking-master\oap-server\server-receiver-plugin\skywalking-zabbix-receiver-plugin\src\main\java\org\apache\skywalking\oap\server\receiver\zabbix\provider\protocol\bean\ZabbixResponse.java,27,8,0,1,0,9
 skywalking-master\skywalking-master\oap-server\microbench\src\main\java\org\apache\skywalking\oap\server\microbench\base\AbstractMicrobenchmark.java,64,15,1,7,0,23
 skywalking-master\skywalking-master\oap-server\server-storage-plugin\storage-elasticsearch-plugin\src\test\java\org\apache\skywalking\oap\server\storage\plugin\elasticsearch\base\TimeSeriesUtilsTest.java,66,35,0,9,0,44
 skywalking-master\skywalking-master\oap-server\server-library\library-elasticsearch-client\src\main\java\org\apache\skywalking\library\elasticsearch\requests\factory\v7\codec\V7IndexRequestSerializer.java,0,3,0,2,0,5
 skywalking-master\skywalking-master\oap-server\server-storage-plugin\storage-iotdb-plugin\src\main\java\org\apache\skywalking\oap\server\storage\plugin\iotdb\base\IoTDBManagementDAO.java,12,7,0,3,0,10
 skywalking-master\skywalking-master\oap-server\server-tools\profile-exporter\tool-profile-snapshot-bootstrap\src\main\java\org\apache\skywalking\oap\server\tool\profile\exporter\ProfiledBasicInfo.java,111,45,0,18,0,63
 skywalking-master\skywalking-master\oap-server\server-query-plugin\query-graphql-plugin\src\main\java\org\apache\skywalking\oap\query\graphql\resolver\Query.java,5,1,1,1,0,3
 skywalking-master\skywalking-master\oap-server\server-library\library-elasticsearch-client\src\main\java\org\apache\skywalking\library\elasticsearch\ElasticSearchBuilder.java,0,74,1,18,0,93
 skywalking-master\skywalking-master\oap-server\server-core\src\main\java\org\apache\skywalking\oap\server\core\annotation\AnnotationScan.java,64,12,0,2,0,14
 skywalking-master\skywalking-master\oap-server\server-storage-plugin\storage-iotdb-plugin\src\main\java\org\apache\skywalking\oap\server\storage\plugin\iotdb\profile\IoTDBProfileThreadSnapshotQueryDAO.java,145,77,2,58,0,137
 skywalking-master\skywalking-master\oap-server\server-query-plugin\query-graphql-plugin\src\test\java\org\apache\skywalking\oap\query\graphql\resolver\LogTestQueryTest.java,87,36,1,6,0,43
 skywalking-master\skywalking-master\oap-server\server-configuration\configuration-zookeeper\src\test\java\org\apache\skywalking\oap\server\configuration\zookeeper\ut\ZookeeperConfigWatcherRegisterTestCase.java,25,8,1,8,0,17
 skywalking-master\skywalking-master\oap-server\server-core\src\main\java\org\apache\skywalking\oap\server\core\analysis\meter\function\PercentileArgument.java,5,2,0,1,0,3
 skywalking-master\skywalking-master\oap-server\server-core\src\main\java\org\apache\skywalking\oap\server\core\cluster\ClusterModule.java,17,3,0,1,0,4
 skywalking-master\skywalking-master\oap-server\server-storage-plugin\storage-iotdb-plugin\src\main\java\org\apache\skywalking\oap\server\storage\plugin\iotdb\IoTDBIndexes.java,0,15,9,4,0,28
 skywalking-master\skywalking-master\oap-server\server-receiver-plugin\skywalking-clr-receiver-plugin\src\main\java\org\apache\skywalking\oap\server\receiver\clr\provider\CLRModuleProvider.java,52,13,2,12,0,27
 skywalking-master\skywalking-master\oap-server\server-receiver-plugin\envoy-metrics-receiver-plugin\src\main\java\org\apache\skywalking\oap\server\receiver\envoy\als\k8s\K8SServiceRegistry.java,276,60,1,30,0,91
 skywalking-master\skywalking-master\oap-server\server-core\src\main\java\org\apache\skywalking\oap\server\core\storage\model\ModelManipulator.java,0,1,0,1,0,2
 skywalking-master\skywalking-master\oap-server\server-storage-plugin\storage-elasticsearch-plugin\src\main\java\org\apache\skywalking\oap\server\storage\plugin\elasticsearch\base\RecordEsDAO.java,20,12,0,6,0,18
 skywalking-master\skywalking-master\oap-server\server-telemetry\telemetry-prometheus\src\main\java\org\apache\skywalking\oap\server\telemetry\prometheus\PrometheusTelemetryProvider.java,50,13,2,8,1,24
 skywalking-master\skywalking-master\oap-server\server-core\src\main\java\org\apache\skywalking\oap\server\core\browser\source\BrowserAppSingleVersionTraffic.java,25,8,0,6,0,14
 skywalking-master\skywalking-master\oap-server\server-receiver-plugin\envoy-metrics-receiver-plugin\src\main\java\org\apache\skywalking\oap\server\receiver\envoy\AccessLogServiceGRPCHandler.java,0,48,3,31,0,82
 skywalking-master\skywalking-master\oap-server\server-tools\profile-exporter\tool-profile-snapshot-server-mock\src\main\java\org\apache\skywalking\oap\server\tool\profile\core\mock\MockRemoteClientManager.java,11,5,1,2,0,8
 skywalking-master\skywalking-master\oap-server\server-telemetry\telemetry-prometheus\src\main\java\org\apache\skywalking\oap\server\telemetry\prometheus\PrometheusHistogramMetrics.java,34,19,0,3,2,24
 skywalking-master\skywalking-master\oap-server\analyzer\agent-analyzer\src\main\java\org\apache\skywalking\oap\server\analyzer\provider\trace\parser\listener\EndpointSourceBuilder.java,0,35,0,7,0,42
 skywalking-master\skywalking-master\oap-server\server-storage-plugin\storage-jdbc-hikaricp-plugin\src\main\java\org\apache\skywalking\oap\server\storage\plugin\jdbc\h2\dao\H2HistoryDeleteDAO.java,46,19,0,9,0,28
 skywalking-master\skywalking-master\oap-server\server-library\library-datacarrier-queue\src\test\java\org\apache\skywalking\oap\server\library\datacarrier\partition\SimpleRollingPartitionerTest.java,10,5,0,2,0,7
 skywalking-master\skywalking-master\oap-server\server-tools\profile-exporter\tool-profile-snapshot-server-mock\src\main\java\org\apache\skywalking\oap\server\tool\profile\core\mock\MockStreamAnnotationListener.java,30,12,0,6,0,18
 skywalking-master\skywalking-master\oap-server\server-core\src\main\java\org\apache\skywalking\oap\server\core\storage\type\StorageBuilder.java,0,1,0,2,0,3
 skywalking-master\skywalking-master\oap-server\server-storage-plugin\storage-iotdb-plugin\src\main\java\org\apache\skywalking\oap\server\storage\plugin\iotdb\base\IoTDBStorageDAO.java,24,9,0,1,0,10
 skywalking-master\skywalking-master\oap-server\analyzer\meter-analyzer\src\test\java\org\apache\skywalking\oap\meter\analyzer\dsl\IncreaseTest.java,217,150,1,97,0,248
 skywalking-master\skywalking-master\oap-server\server-receiver-plugin\skywalking-zabbix-receiver-plugin\src\test\java\org\apache\skywalking\oap\server\receiver\zabbix\provider\ZabbixMetricsTest.java,90,38,0,26,0,64
 skywalking-master\skywalking-master\oap-server\server-library\library-util\src\main\java\org\apache\skywalking\oap\server\library\util\prometheus\parser\Context.java,147,39,7,19,1,66
 skywalking-master\skywalking-master\oap-server\server-core\src\main\java\org\apache\skywalking\oap\server\core\analysis\manual\log\AbstractLogRecord.java,108,41,0,12,0,53
 skywalking-master\skywalking-master\oap-server\server-core\src\main\java\org\apache\skywalking\oap\server\core\query\type\Span.java,46,21,0,1,0,22
 skywalking-master\skywalking-master\oap-server\server-core\src\main\java\org\apache\skywalking\oap\server\core\query\sql\KeyValues.java,8,2,0,1,0,3
 skywalking-master\skywalking-master\apm-protocol\apm-network\src\main\java\org\apache\skywalking\oap\server\network\trace\component\command\BaseCommand.java,32,13,0,1,0,14
 skywalking-master\skywalking-master\oap-server\server-receiver-plugin\skywalking-trace-receiver-plugin\src\test\java\org\apache\skywalking\oap\server\receiver\trace\mock\ServiceCMock.java,0,27,0,6,0,33
 skywalking-master\skywalking-master\oap-server\server-library\library-datacarrier-queue\src\test\java\org\apache\skywalking\oap\server\library\datacarrier\consumer\SampleConsumer.java,27,6,3,1,1,11
 skywalking-master\skywalking-master\oap-server\analyzer\agent-analyzer\src\main\java\org\apache\skywalking\oap\server\analyzer\provider\trace\DBLatencyThresholdsAndWatcher.java,52,16,3,3,0,22
 skywalking-master\skywalking-master\oap-server\server-core\src\main\java\org\apache\skywalking\oap\server\core\storage\model\ModelColumn.java,68,32,0,7,0,39
 skywalking-master\skywalking-master\oap-server\server-configuration\configuration-k8s-configmap\src\main\java\org\apache\skywalking\oap\server\configuration\configmap\ConfigmapConfigurationWatcherRegister.java,43,13,0,6,0,19
 skywalking-master\skywalking-master\oap-server\server-core\src\test\java\org\apache\skywalking\oap\server\core\profiling\trace\analyze\ProfileAnalyzerTest.java,20,7,0,3,0,10
 skywalking-master\skywalking-master\oap-server\server-receiver-plugin\skywalking-zabbix-receiver-plugin\src\main\java\org\apache\skywalking\oap\server\receiver\zabbix\provider\protocol\ZabbixProtocolDataCodec.java,0,2,0,2,0,4
 skywalking-master\skywalking-master\oap-server\server-core\src\main\java\org\apache\skywalking\oap\server\core\browser\source\BrowserErrorCategory.java,0,12,0,2,0,14
 skywalking-master\skywalking-master\oap-server\server-core\src\main\java\org\apache\skywalking\oap\server\core\worker\IWorkerInstanceSetter.java,0,3,0,3,0,6
 skywalking-master\skywalking-master\oap-server\server-core\src\main\java\org\apache\skywalking\oap\server\core\analysis\metrics\expression\NumberMatch.java,12,8,0,2,0,10
 skywalking-master\skywalking-master\oap-server\server-configuration\configuration-k8s-configmap\src\main\java\org\apache\skywalking\oap\server\configuration\configmap\ConfigmapConfigurationProvider.java,29,11,0,7,0,18
 skywalking-master\skywalking-master\oap-server\server-alarm-plugin\src\test\java\org\apache\skywalking\oap\server\core\alarm\provider\AlarmRulesWatcherTest.java,154,53,5,41,0,99
 skywalking-master\skywalking-master\oap-server\analyzer\log-analyzer\src\main\java\org\apache\skywalking\oap\log\analyzer\dsl\spec\filter\FilterSpec.java,143,27,0,9,0,36
 skywalking-master\skywalking-master\oap-server\server-cluster-plugin\cluster-zookeeper-plugin\src\test\java\org\apache\skywalking\oap\server\cluster\plugin\zookeeper\NodeNameBuilderTest.java,11,2,0,1,0,3
 skywalking-master\skywalking-master\oap-server\server-core\src\test\java\org\apache\skywalking\oap\server\core\analysis\metrics\HeatMapMetricsTest.java,97,44,1,1,0,46
 skywalking-master\skywalking-master\oap-server\server-core\src\main\java\org\apache\skywalking\oap\server\core\analysis\metrics\IntList.java,56,18,0,2,0,20
 skywalking-master\skywalking-master\oap-server\server-receiver-plugin\skywalking-browser-receiver-plugin\src\main\java\org\apache\skywalking\oap\server\receiver\browser\provider\BrowserOALDefine.java,11,2,1,1,0,4
 skywalking-master\skywalking-master\oap-server\server-core\src\test\java\org\apache\skywalking\oap\server\core\analysis\metrics\MinLongMetricsTest.java,68,17,1,1,0,19
 skywalking-master\skywalking-master\oap-server\server-core\src\main\java\org\apache\skywalking\oap\server\core\server\HTTPHandlerRegisterImpl.java,14,6,0,1,0,7
 skywalking-master\skywalking-master\oap-server\server-core\src\test\java\org\apache\skywalking\oap\server\core\analysis\manual\relation\endpoint\EndpointCallRelationTest.java,32,15,0,9,0,24
 skywalking-master\skywalking-master\oap-server\server-configuration\configuration-nacos\src\test\java\org\apache\skywalking\oap\server\configuration\nacos\NacosConfigurationTestProvider.java,89,18,2,10,0,30
 skywalking-master\skywalking-master\oap-server\server-core\src\test\java\org\apache\skywalking\oap\server\core\config\group\openapi\EndpointGroupingRuleReader4OpenapiTest.java,73,13,0,12,0,25
 skywalking-master\skywalking-master\oap-server\server-library\library-server\src\main\java\org\apache\skywalking\oap\server\library\server\grpc\GRPCServer.java,106,75,4,14,0,93
 skywalking-master\skywalking-master\oap-server\server-core\src\main\java\org\apache\skywalking\oap\server\core\alarm\EndpointMetaInAlarm.java,27,7,0,1,0,8
 skywalking-master\skywalking-master\oap-server\server-core\src\main\java\org\apache\skywalking\oap\server\core\analysis\metrics\LongAvgMetrics.java,48,19,0,8,0,27
 skywalking-master\skywalking-master\oap-server\server-library\library-elasticsearch-client\src\main\java\org\apache\skywalking\library\elasticsearch\requests\search\aggregation\AggregationBuilder.java,0,1,0,1,0,2
 skywalking-master\skywalking-master\oap-server\server-library\library-module\src\main\java\org\apache\skywalking\oap\server\library\module\ModuleNotFoundException.java,11,4,0,1,0,5
 skywalking-master\skywalking-master\oap-server\analyzer\log-analyzer\src\main\java\org\apache\skywalking\oap\log\analyzer\dsl\LALPrecompiledExtension.java,0,4,2,2,0,8
 skywalking-master\skywalking-master\oap-server\server-storage-plugin\storage-jdbc-hikaricp-plugin\src\main\java\org\apache\skywalking\oap\server\storage\plugin\jdbc\h2\dao\H2NetworkAddressAliasDAO.java,39,13,2,10,0,25
 skywalking-master\skywalking-master\oap-server\server-receiver-plugin\skywalking-trace-receiver-plugin\src\main\java\org\apache\skywalking\oap\server\receiver\trace\provider\TraceModuleProvider.java,56,13,2,13,0,28
 skywalking-master\skywalking-master\oap-server\server-configuration\configuration-zookeeper\src\test\java\org\apache\skywalking\oap\server\configuration\zookeeper\it\MockZookeeperConfigurationProvider.java,89,18,2,8,0,28
 skywalking-master\skywalking-master\oap-server\server-receiver-plugin\skywalking-browser-receiver-plugin\src\main\java\org\apache\skywalking\oap\server\receiver\browser\provider\BrowserModuleProvider.java,82,24,2,28,0,54
 skywalking-master\skywalking-master\oap-server\server-storage-plugin\storage-jdbc-hikaricp-plugin\src\main\java\org\apache\skywalking\oap\server\storage\plugin\jdbc\h2\dao\H2LogRecordBuilder.java,22,5,0,3,0,8
 skywalking-master\skywalking-master\oap-server\server-core\src\main\java\org\apache\skywalking\oap\server\core\alarm\MetaInAlarm.java,39,14,2,4,0,20
 skywalking-master\skywalking-master\oap-server\server-core\src\test\java\org\apache\skywalking\oap\server\core\analysis\metrics\expression\NumberMatchTest.java,73,28,0,1,0,29
 skywalking-master\skywalking-master\oap-server\server-core\src\main\java\org\apache\skywalking\oap\server\core\query\input\MetricCondition.java,5,2,0,1,0,3
 skywalking-master\skywalking-master\oap-server\server-library\library-util\src\test\java\org\apache\skywalking\oap\server\library\util\BooleanUtilsTest.java,20,6,0,1,1,8
 skywalking-master\skywalking-master\oap-server\server-storage-plugin\storage-jdbc-hikaricp-plugin\src\main\java\org\apache\skywalking\oap\server\storage\plugin\jdbc\h2\dao\H2ProfileThreadSnapshotQueryDAO.java,192,70,2,51,0,123
 skywalking-master\skywalking-master\oap-server\server-cluster-plugin\cluster-etcd-plugin\src\main\java\org\apache\skywalking\oap\server\cluster\plugin\etcd\EtcdCoordinator.java,0,37,4,20,0,61
 skywalking-master\skywalking-master\oap-server\server-receiver-plugin\skywalking-clr-receiver-plugin\src\main\java\org\apache\skywalking\oap\server\receiver\clr\provider\CLROALDefine.java,11,3,1,1,0,5
 skywalking-master\skywalking-master\oap-server\server-receiver-plugin\skywalking-management-receiver-plugin\src\main\java\org\apache\skywalking\oap\server\receiver\register\provider\handler\v8\grpc\ManagementServiceGrpcHandlerCompat.java,0,6,0,6,0,12
 skywalking-master\skywalking-master\oap-server\server-cluster-plugin\cluster-consul-plugin\src\test\java\org\apache\skywalking\oap\server\cluster\plugin\consul\ConsulCoordinatorTest.java,161,35,3,9,0,47
 skywalking-master\skywalking-master\oap-server\server-core\src\main\java\org\apache\skywalking\oap\server\core\cache\NetworkAddressAliasCache.java,31,14,0,7,0,21
 skywalking-master\skywalking-master\oap-server\server-cluster-plugin\cluster-kubernetes-plugin\src\main\java\org\apache\skywalking\oap\server\cluster\plugin\kubernetes\NamespacedPodListInformer.java,0,14,1,7,0,22
 skywalking-master\skywalking-master\oap-server\server-storage-plugin\storage-zipkin-elasticsearch-plugin\src\main\java\org\apache\skywalking\oap\server\storage\plugin\zipkin\elasticsearch\ZipkinTraceQueryEsDAO.java,187,44,3,35,0,82
 skywalking-master\skywalking-master\oap-server\server-core\src\main\java\org\apache\skywalking\oap\server\core\analysis\data\ReadWriteSafeCache.java,69,9,2,3,0,14
 skywalking-master\skywalking-master\oap-server\server-receiver-plugin\skywalking-management-receiver-plugin\src\main\java\org\apache\skywalking\oap\server\receiver\register\provider\handler\v8\ManagementServiceHandler.java,0,23,0,15,0,38
 skywalking-master\skywalking-master\oap-server\server-core\src\main\java\org\apache\skywalking\oap\server\core\version\VersionLogConverter.java,15,6,0,1,0,7
 skywalking-master\skywalking-master\oap-server\server-core\src\main\java\org\apache\skywalking\oap\server\core\storage\AbstractDAO.java,12,6,0,1,0,7
 skywalking-master\skywalking-master\test\e2e-v2\java-test-service\e2e-service-provider\src\main\java\org\apache\skywalking\e2e\controller\HealthController.java,7,2,0,1,0,3
 skywalking-master\skywalking-master\oap-server\server-receiver-plugin\skywalking-jvm-receiver-plugin\src\main\java\org\apache\skywalking\oap\server\receiver\jvm\provider\JVMModuleProvider.java,51,11,2,8,0,21
 skywalking-master\skywalking-master\oap-server\server-library\library-util\src\main\java\org\apache\skywalking\oap\server\library\util\prometheus\metrics\Counter.java,20,12,0,2,2,16
 skywalking-master\skywalking-master\oap-server\server-storage-plugin\storage-jdbc-hikaricp-plugin\src\main\java\org\apache\skywalking\oap\server\storage\plugin\jdbc\h2\dao\H2RecordDAO.java,66,26,3,16,0,45
 skywalking-master\skywalking-master\oap-server\server-core\src\main\java\org\apache\skywalking\oap\server\core\profiling\ebpf\analyze\EBPFProfilingStack.java,36,14,0,9,0,23
 skywalking-master\skywalking-master\oap-server\server-storage-plugin\storage-iotdb-plugin\src\main\java\org\apache\skywalking\oap\server\storage\plugin\iotdb\base\IoTDBNoneStreamDAO.java,13,7,0,3,0,10
 skywalking-master\skywalking-master\oap-server\server-core\src\main\java\org\apache\skywalking\oap\server\core\browser\source\BrowserAppPageTraffic.java,25,8,0,6,0,14
 skywalking-master\skywalking-master\oap-server\server-core\src\main\java\org\apache\skywalking\oap\server\core\storage\DAO.java,0,0,0,1,0,1
 skywalking-master\skywalking-master\oap-server\server-library\library-elasticsearch-client\src\main\java\org\apache\skywalking\library\elasticsearch\requests\factory\SearchFactory.java,0,10,0,2,0,12
 skywalking-master\skywalking-master\oap-server\server-library\library-util\src\test\java\org\apache\skywalking\oap\server\library\util\CollectionUtilsTest.java,32,4,0,3,0,7
 skywalking-master\skywalking-master\oap-server\server-configuration\configuration-api\src\main\java\org\apache\skywalking\oap\server\configuration\api\ConfigTable.java,22,11,0,1,1,13
 skywalking-master\skywalking-master\oap-server\server-core\src\main\java\org\apache\skywalking\oap\server\core\source\Event.java,0,57,1,18,0,76
 skywalking-master\skywalking-master\oap-server\analyzer\log-analyzer\src\main\java\org\apache\skywalking\oap\log\analyzer\provider\LogAnalyzerModuleProvider.java,50,14,1,10,0,25
 skywalking-master\skywalking-master\oap-server\server-library\library-datacarrier-queue\src\main\java\org\apache\skywalking\oap\server\library\datacarrier\consumer\BulkConsumePool.java,87,29,1,5,0,35
 skywalking-master\skywalking-master\oap-server\server-alarm-plugin\src\main\java\org\apache\skywalking\oap\server\core\alarm\provider\welink\WeLinkHookCallback.java,119,50,3,21,0,74
 skywalking-master\skywalking-master\oap-server\server-core\src\main\java\org\apache\skywalking\oap\server\core\source\ISource.java,0,6,1,2,0,9
 skywalking-master\skywalking-master\oap-server\server-storage-plugin\storage-zipkin-elasticsearch-plugin\src\main\java\org\apache\skywalking\oap\server\storage\plugin\zipkin\ZipkinSpan.java,53,16,1,2,0,19
 skywalking-master\skywalking-master\oap-server\server-storage-plugin\storage-elasticsearch-plugin\src\main\java\org\apache\skywalking\oap\server\storage\plugin\elasticsearch\query\EBPFProfilingTaskEsDAO.java,67,36,0,39,0,75
 skywalking-master\skywalking-master\oap-server\server-storage-plugin\storage-jdbc-hikaricp-plugin\src\main\java\org\apache\skywalking\oap\server\storage\plugin\jdbc\postgresql\PostgreSQLStorageConfig.java,3,1,0,2,0,3
 skywalking-master\skywalking-master\oap-server\analyzer\meter-analyzer\src\main\java\org\apache\skywalking\oap\meter\analyzer\k8s\K8sInfoRegistry.java,186,40,0,18,0,58
 skywalking-master\skywalking-master\oap-server\server-core\src\main\java\org\apache\skywalking\oap\server\core\storage\profiling\ebpf\EBPFProfilingProcessFinder.java,7,6,0,2,0,8
 skywalking-master\skywalking-master\oap-server\server-alarm-plugin\src\main\java\org\apache\skywalking\oap\server\core\alarm\provider\AlarmModuleProvider.java,60,16,3,11,0,30
 skywalking-master\skywalking-master\oap-server\server-core\src\test\java\org\apache\skywalking\oap\server\core\analysis\metrics\expression\StringMatchTest.java,42,14,0,1,0,15
 skywalking-master\skywalking-master\oap-server\analyzer\meter-analyzer\src\test\java\org\apache\skywalking\oap\meter\analyzer\dsl\ValueFilterTest.java,127,45,1,31,0,77
 skywalking-master\skywalking-master\oap-server\server-receiver-plugin\skywalking-log-recevier-plugin\src\main\java\org\apache\skywalking\oap\server\recevier\log\module\LogModule.java,12,3,0,1,0,4
 skywalking-master\skywalking-master\oap-server\server-storage-plugin\storage-jdbc-hikaricp-plugin\src\main\java\org\apache\skywalking\oap\server\storage\plugin\jdbc\h2\dao\AbstractSearchTagBuilder.java,51,15,0,5,0,20
 skywalking-master\skywalking-master\oap-server\server-cluster-plugin\cluster-zookeeper-plugin\src\main\java\org\apache\skywalking\oap\server\cluster\plugin\zookeeper\NodeNameBuilder.java,7,4,1,1,0,6
 skywalking-master\skywalking-master\oap-server\microbench\src\main\java\org\apache\skywalking\oap\server\microbench\library\util\StringFormatGroupBenchmark.java,92,24,0,20,0,44
 skywalking-master\skywalking-master\oap-server\server-library\library-util\src\test\java\org\apache\skywalking\oap\server\library\util\MultipleFilesChangeMonitorTest.java,61,9,3,4,4,20
 skywalking-master\skywalking-master\oap-server\server-storage-plugin\storage-jdbc-hikaricp-plugin\src\main\java\org\apache\skywalking\oap\server\storage\plugin\jdbc\h2\dao\H2TableInstaller.java,103,45,1,15,0,61
 skywalking-master\skywalking-master\oap-server\server-core\src\test\java\org\apache\skywalking\oap\server\core\analysis\data\LimitedSizeBufferedDataTest.java,56,20,0,2,0,22
 skywalking-master\skywalking-master\oap-server\server-core\src\main\java\org\apache\skywalking\oap\server\core\analysis\manual\database\TopNDatabaseStatement.java,53,20,2,9,0,31
 skywalking-master\skywalking-master\oap-server\server-core\src\main\java\org\apache\skywalking\oap\server\core\analysis\metrics\MaxDoubleMetrics.java,39,9,1,6,0,16
 skywalking-master\skywalking-master\oap-server\server-receiver-plugin\envoy-metrics-receiver-plugin\src\test\java\org\apache\skywalking\oap\server\receiver\envoy\als\k8s\ServiceNameFormatterTest.java,82,16,0,10,0,26
 skywalking-master\skywalking-master\oap-server\server-library\library-elasticsearch-client\src\main\java\org\apache\skywalking\library\elasticsearch\response\Index.java,0,3,0,1,6,10
 skywalking-master\skywalking-master\oap-server\server-receiver-plugin\skywalking-log-recevier-plugin\src\main\java\org\apache\skywalking\oap\server\recevier\log\provider\handler\rest\LogReportServiceHTTPHandler.java,38,11,2,4,0,17
 skywalking-master\skywalking-master\oap-server\server-telemetry\telemetry-api\src\main\java\org\apache\skywalking\oap\server\telemetry\api\MetricsTag.java,37,17,1,1,2,21
 skywalking-master\skywalking-master\oap-server\server-library\library-util\src\main\java\org\apache\skywalking\oap\server\library\util\GRPCStreamStatus.java,9,5,1,2,0,8
 skywalking-master\skywalking-master\oap-server\analyzer\meter-analyzer\src\main\java\org\apache\skywalking\oap\meter\analyzer\dsl\EntityDescription\ServiceEntityDescription.java,12,5,1,1,0,7
 skywalking-master\skywalking-master\oap-server\server-core\src\main\java\org\apache\skywalking\oap\server\core\source\EnvoyInstanceMetric.java,36,12,0,7,0,19
 skywalking-master\skywalking-master\oap-server\analyzer\agent-analyzer\src\main\java\org\apache\skywalking\oap\server\analyzer\provider\trace\parser\listener\ExitAnalysisListener.java,0,1,0,2,0,3
 skywalking-master\skywalking-master\oap-server\server-storage-plugin\storage-iotdb-plugin\src\main\java\org\apache\skywalking\oap\server\storage\plugin\iotdb\query\IoTDBAggregationQueryDAO.java,90,23,0,17,0,40
 skywalking-master\skywalking-master\oap-server\server-telemetry\telemetry-api\src\main\java\org\apache\skywalking\oap\server\telemetry\api\GaugeMetrics.java,0,11,0,2,0,13
 skywalking-master\skywalking-master\oap-server\server-storage-plugin\storage-influxdb-plugin\src\main\java\org\apache\skywalking\oap\server\storage\plugin\influxdb\query\EBPFProfilingTaskQuery.java,83,28,0,20,0,48
 skywalking-master\skywalking-master\oap-server\server-core\src\main\java\org\apache\skywalking\oap\server\core\remote\client\SelfRemoteClient.java,60,21,3,7,0,31
 skywalking-master\skywalking-master\oap-server\server-core\src\main\java\org\apache\skywalking\oap\server\core\remote\RemoteSenderService.java,49,20,2,9,0,31
 skywalking-master\skywalking-master\oap-server\server-query-plugin\query-graphql-plugin\src\main\java\org\apache\skywalking\oap\query\graphql\resolver\EBPFProcessProfilingMutation.java,23,12,0,5,0,17
 skywalking-master\skywalking-master\oap-server\server-core\src\main\java\org\apache\skywalking\oap\server\core\analysis\worker\NoneStreamPersistentWorker.java,20,13,1,3,0,17
 skywalking-master\skywalking-master\oap-server\server-core\src\main\java\org\apache\skywalking\oap\server\core\analysis\data\MergableBufferedData.java,38,7,1,4,0,12
 skywalking-master\skywalking-master\oap-server\server-core\src\main\java\org\apache\skywalking\oap\server\core\alarm\ServiceMetaInAlarm.java,27,7,0,1,0,8
 skywalking-master\skywalking-master\oap-server\server-core\src\main\java\org\apache\skywalking\oap\server\core\storage\query\IBrowserLogQueryDAO.java,0,6,1,4,0,11
 skywalking-master\skywalking-master\oap-server\server-core\src\main\java\org\apache\skywalking\oap\server\core\query\type\EBPFProfilingProcessFinderType.java,0,14,0,4,0,18
 skywalking-master\skywalking-master\oap-server\server-configuration\configuration-k8s-configmap\src\test\java\org\apache\skywalking\oap\server\configuration\configmap\ConfigmapConfigurationProviderTest.java,17,6,0,3,0,9
 skywalking-master\skywalking-master\test\e2e-v2\java-test-service\e2e-service-provider\src\main\java\org\apache\skywalking\e2e\UserRepo.java,0,0,0,1,0,1
 skywalking-master\skywalking-master\oap-server\server-core\src\main\java\org\apache\skywalking\oap\server\core\config\group\EndpointNameGrouping.java,49,16,4,8,0,28
 skywalking-master\skywalking-master\oap-server\oal-rt\src\main\java\org\apache\skywalking\oal\rt\parser\OALListener.java,249,107,3,28,0,138
 skywalking-master\skywalking-master\oap-server\server-core\src\main\java\org\apache\skywalking\oap\server\core\source\ServiceInstanceJVMMemory.java,43,15,1,7,0,23
 skywalking-master\skywalking-master\oap-server\server-core\src\test\java\org\apache\skywalking\oap\server\core\analysis\manual\relation\service\ServiceRelationTest.java,54,29,0,17,0,46
 skywalking-master\skywalking-master\oap-server\server-library\library-module\src\test\java\org\apache\skywalking\oap\server\library\module\TestModuleProvider.java,40,4,3,1,0,8
 skywalking-master\skywalking-master\oap-server\server-receiver-plugin\envoy-metrics-receiver-plugin\src\main\java\org\apache\skywalking\oap\server\receiver\envoy\als\tcp\TCPLogEntry2MetricsAdapter.java,82,20,0,16,0,36
 skywalking-master\skywalking-master\oap-server\server-library\library-server\src\main\java\org\apache\skywalking\oap\server\library\server\ssl\AbstractSslContext.java,73,18,2,5,0,25
 skywalking-master\skywalking-master\oap-server\server-storage-plugin\storage-iotdb-plugin\src\main\java\org\apache\skywalking\oap\server\storage\plugin\iotdb\query\IoTDBTraceQueryDAO.java,129,53,2,30,0,85
 skywalking-master\skywalking-master\oap-server\server-testing\src\main\java\org\apache\skywalking\oap\server\testing\module\ModuleProviderTesting.java,20,11,0,7,0,18
 skywalking-master\skywalking-master\oap-server\server-core\src\main\java\org\apache\skywalking\oap\server\core\analysis\metrics\DoubleValueHolder.java,0,1,0,1,0,2
 skywalking-master\skywalking-master\oap-server\server-core\src\main\java\org\apache\skywalking\oap\server\core\analysis\worker\MetricsRemoteWorker.java,20,9,2,4,0,15
 skywalking-master\skywalking-master\oap-server\analyzer\meter-analyzer\src\main\java\org\apache\skywalking\oap\meter\analyzer\dsl\Result.java,50,9,0,4,0,13
 skywalking-master\skywalking-master\oap-server\server-configuration\configuration-nacos\src\main\java\org\apache\skywalking\oap\server\configuration\nacos\NacosServerSettings.java,12,11,0,1,0,12
 skywalking-master\skywalking-master\apm-protocol\apm-network\src\test\java\org\apache\skywalking\oap\server\network\trace\proto\GRPCNoServerTest.java,35,17,4,8,0,29
 skywalking-master\skywalking-master\oap-server\server-core\src\main\java\org\apache\skywalking\oap\server\core\storage\model\ModelInstaller.java,0,18,3,6,0,27
 skywalking-master\skywalking-master\oap-server\server-fetcher-plugin\kafka-fetcher-plugin\src\main\java\org\apache\skywalking\oap\server\analyzer\agent\kafka\provider\handler\ServiceManagementHandler.java,84,29,2,21,0,52
 skywalking-master\skywalking-master\oap-server\server-core\src\main\java\org\apache\skywalking\oap\server\core\analysis\metrics\P99Metrics.java,6,3,0,2,0,5
 skywalking-master\skywalking-master\oap-server\server-tools\profile-exporter\tool-profile-snapshot-exporter\src\main\java\org\apache\skywalking\oap\server\tool\profile\exporter\ProfileSnapshotExporter.java,6,4,1,1,0,6
 skywalking-master\skywalking-master\oap-server\server-core\src\main\java\org\apache\skywalking\oap\server\core\query\type\Logs.java,9,3,0,1,0,4
 skywalking-master\skywalking-master\oap-server\analyzer\agent-analyzer\src\main\java\org\apache\skywalking\oap\server\analyzer\provider\trace\parser\listener\AnalysisListener.java,0,10,0,4,0,14
 skywalking-master\skywalking-master\oap-server\server-core\src\main\java\org\apache\skywalking\oap\server\core\analysis\management\ManagementData.java,3,1,1,1,0,3
 skywalking-master\skywalking-master\oap-server\server-core\src\main\java\org\apache\skywalking\oap\server\core\query\type\Database.java,6,3,0,1,0,4
 skywalking-master\skywalking-master\oap-server\server-core\src\main\java\org\apache\skywalking\oap\server\core\query\QueryModule.java,14,3,0,1,0,4
 skywalking-master\skywalking-master\oap-server\server-core\src\main\java\org\apache\skywalking\oap\server\core\storage\StorageException.java,11,5,0,1,0,6
 skywalking-master\skywalking-master\oap-server\server-receiver-plugin\skywalking-zabbix-receiver-plugin\src\main\java\org\apache\skywalking\oap\server\receiver\zabbix\provider\config\ZabbixConfigs.java,34,6,1,3,0,10
 skywalking-master\skywalking-master\oap-server\server-storage-plugin\storage-elasticsearch-plugin\src\main\java\org\apache\skywalking\oap\server\storage\plugin\elasticsearch\base\IndexStructures.java,123,42,1,9,0,52
 skywalking-master\skywalking-master\oap-server\server-library\library-client\src\main\java\org\apache\skywalking\oap\server\library\client\elasticsearch\ElasticSearchClient.java,0,150,3,14,0,167
 skywalking-master\skywalking-master\oap-server\server-core\src\main\java\org\apache\skywalking\oap\server\core\storage\model\IModelManager.java,0,1,0,1,0,2
 skywalking-master\skywalking-master\oap-server\server-core\src\main\java\org\apache\skywalking\oap\server\core\analysis\metrics\PxxMetrics.java,83,28,0,8,0,36
 skywalking-master\skywalking-master\oap-server\server-core\src\main\java\org\apache\skywalking\oap\server\core\query\TopologyQueryService.java,179,55,0,38,0,93
 skywalking-master\skywalking-master\apm-protocol\apm-network\src\main\java\org\apache\skywalking\oap\server\network\trace\component\command\Serializable.java,0,1,0,1,0,2
 skywalking-master\skywalking-master\oap-server\server-core\src\main\java\org\apache\skywalking\oap\server\core\remote\Serializable.java,0,2,0,2,0,4
 skywalking-master\skywalking-master\oap-server\server-alarm-plugin\src\main\java\org\apache\skywalking\oap\server\core\alarm\provider\AlarmMessageFormatter.java,65,11,2,2,0,15
 skywalking-master\skywalking-master\oap-server\server-fetcher-plugin\kafka-fetcher-plugin\src\test\java\org\apache\skywalking\oap\server\analyzer\agent\kafka\mock\MockModuleProvider.java,21,9,0,6,0,15
 skywalking-master\skywalking-master\oap-server\server-cluster-plugin\cluster-nacos-plugin\src\test\java\org\apache\skywalking\oap\server\cluster\plugin\nacos\ITClusterModuleNacosProviderFunctionalTest.java,227,53,11,18,0,82
 skywalking-master\skywalking-master\oap-server\oal-rt\src\main\java\org\apache\skywalking\oal\rt\parser\AggregationFuncStmt.java,44,20,0,2,0,22
 skywalking-master\skywalking-master\oap-server\server-core\src\main\java\org\apache\skywalking\oap\server\core\cluster\ClusterRegister.java,0,2,0,2,0,4
 skywalking-master\skywalking-master\oap-server\server-core\src\main\java\org\apache\skywalking\oap\server\core\analysis\metrics\WithMetadata.java,0,2,0,2,0,4
 skywalking-master\skywalking-master\oap-server\server-library\library-elasticsearch-client\src\main\java\org\apache\skywalking\library\elasticsearch\requests\search\aggregation\AvgAggregationBuilder.java,0,7,0,1,0,8
 skywalking-master\skywalking-master\oap-server\server-storage-plugin\storage-elasticsearch-plugin\src\main\java\org\apache\skywalking\oap\server\storage\plugin\elasticsearch\base\MatchCNameBuilder.java,0,3,0,1,0,4
 skywalking-master\skywalking-master\oap-server\server-core\src\test\java\org\apache\skywalking\oap\server\core\analysis\manual\endpoint\EndpointTrafficTest.java,38,7,2,3,0,12
 skywalking-master\skywalking-master\oap-server\server-storage-plugin\storage-iotdb-plugin\src\main\java\org\apache\skywalking\oap\server\storage\plugin\iotdb\query\IoTDBBrowserLogQueryDAO.java,99,31,1,19,0,51
 skywalking-master\skywalking-master\oap-server\server-core\src\test\java\org\apache\skywalking\oap\server\core\storage\query\MetricsQueryUtilTest.java,79,36,1,23,0,60
 skywalking-master\skywalking-master\oap-server\server-core\src\main\java\org\apache\skywalking\oap\server\core\query\type\Endpoint.java,5,2,0,1,0,3
 skywalking-master\skywalking-master\oap-server\analyzer\agent-analyzer\src\main\java\org\apache\skywalking\oap\server\analyzer\provider\trace\parser\listener\EndpointDepFromCrossThreadAnalysisListener.java,0,41,0,28,0,69
 skywalking-master\skywalking-master\oap-server\server-core\src\main\java\org\apache\skywalking\oap\server\core\analysis\DispatcherManager.java,89,24,1,16,0,41
 skywalking-master\skywalking-master\oap-server\server-storage-plugin\storage-jdbc-hikaricp-plugin\src\main\java\org\apache\skywalking\oap\server\storage\plugin\jdbc\SQLExecutor.java,0,18,1,4,0,23
 skywalking-master\skywalking-master\oap-server\server-core\src\main\java\org\apache\skywalking\oap\server\core\oal\rt\OALDefine.java,40,19,0,6,0,25
 skywalking-master\skywalking-master\oap-server\microbench\src\main\java\org\apache\skywalking\oap\server\microbench\library\datacarrier\common\AtomicRangeIntegerBenchmark.java,141,46,0,31,0,77
 skywalking-master\skywalking-master\oap-server\server-storage-plugin\storage-jdbc-hikaricp-plugin\src\main\java\org\apache\skywalking\oap\server\storage\plugin\jdbc\mysql\MySQLAlarmQueryDAO.java,19,9,0,4,0,13
 skywalking-master\skywalking-master\oap-server\server-storage-plugin\storage-iotdb-plugin\src\main\java\org\apache\skywalking\oap\server\storage\plugin\iotdb\query\IoTDBLogQueryDAO.java,110,38,0,20,0,58
 skywalking-master\skywalking-master\oap-server\server-library\library-elasticsearch-client\src\main\java\org\apache\skywalking\library\elasticsearch\requests\factory\v7\codec\V78IndexTemplatesDeserializer.java,0,8,1,6,0,15
 skywalking-master\skywalking-master\oap-server\server-cluster-plugin\cluster-kubernetes-plugin\src\test\java\org\apache\skywalking\oap\server\cluster\plugin\kubernetes\ClusterModuleKubernetesProviderTest.java,52,16,0,5,0,21
 skywalking-master\skywalking-master\oap-server\server-configuration\grpc-configuration-sync\src\main\java\org\apache\skywalking\oap\server\configuration\grpc\RemoteEndpointSettings.java,13,7,0,2,0,9
 skywalking-master\skywalking-master\oap-server\server-library\library-elasticsearch-client\src\main\java\org\apache\skywalking\library\elasticsearch\requests\factory\common\CommonAliasFactory.java,0,4,0,3,1,8
 skywalking-master\skywalking-master\oap-server\analyzer\event-analyzer\src\main\java\org\apache\skywalking\oap\server\analyzer\event\EventAnalyzerModuleConfig.java,3,0,0,1,0,1
 skywalking-master\skywalking-master\oap-server\server-fetcher-plugin\prometheus-fetcher-plugin\src\main\java\org\apache\skywalking\oap\server\fetcher\prometheus\provider\PrometheusFetcherProvider.java,123,34,1,26,0,61
 skywalking-master\skywalking-master\oap-server\server-storage-plugin\storage-jdbc-hikaricp-plugin\src\main\java\org\apache\skywalking\oap\server\storage\plugin\jdbc\h2\dao\H2UITemplateManagementDAO.java,110,23,2,19,0,44
 skywalking-master\skywalking-master\oap-server\server-core\src\main\java\org\apache\skywalking\oap\server\core\query\type\event\EventQueryCondition.java,16,7,0,1,0,8
 skywalking-master\skywalking-master\oap-server\server-receiver-plugin\skywalking-browser-receiver-plugin\src\main\java\org\apache\skywalking\oap\server\receiver\browser\provider\parser\errorlog\BrowserErrorLogDecorator.java,76,39,0,5,0,44
 skywalking-master\skywalking-master\oap-server\server-receiver-plugin\skywalking-browser-receiver-plugin\src\main\java\org\apache\skywalking\oap\server\receiver\browser\provider\parser\errorlog\listener\ErrorLogRecordSampler.java,12,7,0,3,0,10
 skywalking-master\skywalking-master\oap-server\server-starter\src\main\java\org\apache\skywalking\oap\server\starter\OAPServerBootstrap.java,31,8,3,5,0,16
 skywalking-master\skywalking-master\oap-server\server-core\src\main\java\org\apache\skywalking\oap\server\core\query\type\Node.java,7,4,0,1,0,5
 skywalking-master\skywalking-master\oap-server\server-storage-plugin\storage-jdbc-hikaricp-plugin\src\main\java\org\apache\skywalking\oap\server\storage\plugin\jdbc\JDBCConverter.java,31,7,0,5,0,12
 skywalking-master\skywalking-master\oap-server\server-alarm-plugin\src\main\java\org\apache\skywalking\oap\server\core\alarm\provider\OP.java,0,15,1,6,0,22
 skywalking-master\skywalking-master\oap-server\server-core\src\main\java\org\apache\skywalking\oap\server\core\browser\source\BrowserAppPerfSource.java,19,19,1,1,0,21
 skywalking-master\skywalking-master\oap-server\server-receiver-plugin\skywalking-trace-receiver-plugin\src\test\java\org\apache\skywalking\oap\server\receiver\trace\provider\parser\listener\EndpointDepFromCrossThreadAnalysisListenerTest.java,91,38,1,27,0,66
 skywalking-master\skywalking-master\oap-server\analyzer\meter-analyzer\src\test\java\org\apache\skywalking\oap\meter\analyzer\dsl\AggregationTest.java,156,109,13,48,0,170
 skywalking-master\skywalking-master\oap-server\server-library\library-datacarrier-queue\src\main\java\org\apache\skywalking\oap\server\library\datacarrier\buffer\Buffer.java,51,19,0,2,0,21
 skywalking-master\skywalking-master\oap-server\server-storage-plugin\storage-jdbc-hikaricp-plugin\src\main\java\org\apache\skywalking\oap\server\storage\plugin\jdbc\h2\dao\H2TopNRecordsQueryDAO.java,55,11,0,7,0,18
 skywalking-master\skywalking-master\oap-server\server-core\src\main\java\org\apache\skywalking\oap\server\core\storage\StorageBuilderFactory.java,0,14,0,11,0,25
 skywalking-master\skywalking-master\oap-server\server-core\src\main\java\org\apache\skywalking\oap\server\core\exporter\MetricValuesExportService.java,0,3,0,4,0,7
 skywalking-master\skywalking-master\oap-server\server-library\library-server\src\main\java\org\apache\skywalking\oap\server\library\server\pool\CustomThreadFactory.java,23,14,3,3,0,20
 skywalking-master\skywalking-master\oap-server\server-query-plugin\query-graphql-plugin\src\main\java\org\apache\skywalking\oap\query\graphql\GraphQLQueryConfig.java,6,5,0,1,0,6
 skywalking-master\skywalking-master\oap-server\server-library\library-client\src\test\java\org\apache\skywalking\library\elasticsearch\bulk\ITElasticSearch.java,205,38,2,23,0,63
 skywalking-master\skywalking-master\oap-server\server-core\src\main\java\org\apache\skywalking\oap\server\core\alarm\EndpointRelationMetaInAlarm.java,33,11,0,5,0,16
 skywalking-master\skywalking-master\oap-server\analyzer\agent-analyzer\src\main\java\org\apache\skywalking\oap\server\analyzer\provider\meter\process\SampleBuilder.java,21,11,0,1,0,12
 skywalking-master\skywalking-master\oap-server\server-storage-plugin\storage-elasticsearch-plugin\src\main\java\org\apache\skywalking\oap\server\storage\plugin\elasticsearch\base\AnalyzerSetting.java,0,26,2,7,0,35
 skywalking-master\skywalking-master\oap-server\server-core\src\test\java\org\apache\skywalking\oap\server\core\analysis\metrics\MetricsTest.java,92,17,2,1,0,20
 skywalking-master\skywalking-master\oap-server\server-storage-plugin\storage-jdbc-hikaricp-plugin\src\main\java\org\apache\skywalking\oap\server\storage\plugin\jdbc\h2\dao\H2AlarmQueryDAO.java,116,39,1,16,0,56
 skywalking-master\skywalking-master\oap-server\server-storage-plugin\storage-elasticsearch-plugin\src\main\java\org\apache\skywalking\oap\server\storage\plugin\elasticsearch\query\ProfileTaskLogEsDAO.java,45,15,0,16,0,31
 skywalking-master\skywalking-master\oap-server\server-core\src\main\java\org\apache\skywalking\oap\server\core\source\EndpointMeta.java,30,9,0,3,0,12
 skywalking-master\skywalking-master\oap-server\server-core\src\main\java\org\apache\skywalking\oap\server\core\analysis\manual\segment\SegmentDispatcher.java,22,3,0,2,0,5
 skywalking-master\skywalking-master\oap-server\server-core\src\main\java\org\apache\skywalking\oap\server\core\storage\query\IAggregationQueryDAO.java,0,4,0,3,0,7
 skywalking-master\skywalking-master\oap-server\server-configuration\configuration-consul\src\test\java\org\apache\skywalking\oap\server\configuration\consul\ConsulConfigurationWatcherRegisterTest.java,89,19,2,13,0,34
 skywalking-master\skywalking-master\oap-server\server-storage-plugin\storage-influxdb-plugin\src\main\java\org\apache\skywalking\oap\server\storage\plugin\influxdb\query\EBPFProfilingScheduleQuery.java,46,14,0,8,0,22
 skywalking-master\skywalking-master\oap-server\server-receiver-plugin\envoy-metrics-receiver-plugin\src\main\java\org\apache\skywalking\oap\server\receiver\envoy\als\LogEntry2MetricsAdapter.java,194,42,0,24,0,66
 skywalking-master\skywalking-master\oap-server\server-core\src\main\java\org\apache\skywalking\oap\server\core\source\EBPFProfilingData.java,25,11,1,3,0,15
 skywalking-master\skywalking-master\oap-server\server-library\library-client\src\main\java\org\apache\skywalking\oap\server\library\client\healthcheck\DelegatedHealthChecker.java,21,11,0,2,0,13
 skywalking-master\skywalking-master\oap-server\analyzer\meter-analyzer\src\main\java\org\apache\skywalking\oap\meter\analyzer\prometheus\rule\MetricsRule.java,0,3,0,1,0,4
 skywalking-master\skywalking-master\oap-server\server-receiver-plugin\skywalking-event-receiver-plugin\src\main\java\org\apache\skywalking\oap\server\receiver\event\EventModule.java,13,4,0,1,0,5
 skywalking-master\skywalking-master\oap-server\server-core\src\main\java\org\apache\skywalking\oap\server\core\analysis\manual\endpoint\EndpointMetaDispatcher.java,12,2,0,2,0,4
 skywalking-master\skywalking-master\oap-server\oal-rt\src\main\java\org\apache\skywalking\oal\rt\parser\PersistenceColumns.java,48,31,0,1,0,32
 skywalking-master\skywalking-master\oap-server\server-receiver-plugin\envoy-metrics-receiver-plugin\src\main\java\org\apache\skywalking\oap\server\receiver\envoy\als\tcp\TCPAccessLogAnalyzer.java,0,1,0,2,0,3
 skywalking-master\skywalking-master\oap-server\server-core\src\main\java\org\apache\skywalking\oap\server\core\storage\StorageData.java,0,0,0,1,0,1
 skywalking-master\skywalking-master\oap-server\server-query-plugin\query-graphql-plugin\src\main\java\org\apache\skywalking\oap\query\graphql\resolver\MetadataQueryV2.java,71,36,0,10,0,46
 skywalking-master\skywalking-master\oap-server\server-core\src\main\java\org\apache\skywalking\oap\server\core\profiling\trace\analyze\ProfileAnalyzeCollector.java,0,8,0,3,0,11
 skywalking-master\skywalking-master\oap-server\server-storage-plugin\storage-jdbc-hikaricp-plugin\src\main\java\org\apache\skywalking\oap\server\storage\plugin\jdbc\SQLBuilder.java,34,16,1,1,0,18
 skywalking-master\skywalking-master\oap-server\oal-rt\src\main\java\org\apache\skywalking\oal\rt\parser\SourceColumnsFactory.java,14,6,1,4,0,11
 skywalking-master\skywalking-master\oap-server\server-storage-plugin\storage-iotdb-plugin\src\main\java\org\apache\skywalking\oap\server\storage\plugin\iotdb\query\IoTDBEBPFProfilingScheduleDAO.java,41,24,0,16,0,40
 skywalking-master\skywalking-master\oap-server\server-core\src\main\java\org\apache\skywalking\oap\server\core\source\EndpointRelation.java,0,29,1,12,0,42
 skywalking-master\skywalking-master\oap-server\server-core\src\main\java\org\apache\skywalking\oap\server\core\query\type\KeyValue.java,13,8,1,1,0,10
 skywalking-master\skywalking-master\oap-server\server-core\src\main\java\org\apache\skywalking\oap\server\core\storage\model\StorageModels.java,0,53,3,29,0,85
 skywalking-master\skywalking-master\oap-server\server-core\src\main\java\org\apache\skywalking\oap\server\core\storage\annotation\Storage.java,6,3,0,1,0,4
 skywalking-master\skywalking-master\oap-server\server-core\src\main\java\org\apache\skywalking\oap\server\core\source\SourceReceiver.java,0,4,0,4,0,8
 skywalking-master\skywalking-master\oap-server\server-library\library-datacarrier-queue\src\main\java\org\apache\skywalking\oap\server\library\datacarrier\EnvUtil.java,28,7,3,1,0,11
 skywalking-master\skywalking-master\oap-server\server-storage-plugin\storage-jdbc-hikaricp-plugin\src\main\java\org\apache\skywalking\oap\server\storage\plugin\jdbc\h2\dao\H2StorageDAO.java,27,16,0,6,0,22
 skywalking-master\skywalking-master\oap-server\server-core\src\test\java\org\apache\skywalking\oap\server\core\analysis\meter\function\HistogramFunctionTest.java,205,47,0,7,0,54
 skywalking-master\skywalking-master\oap-server\analyzer\agent-analyzer\src\main\java\org\apache\skywalking\oap\server\analyzer\provider\trace\parser\listener\EntryAnalysisListener.java,0,2,0,2,0,4
 skywalking-master\skywalking-master\oap-server\server-library\library-elasticsearch-client\src\main\java\org\apache\skywalking\library\elasticsearch\requests\factory\AliasFactory.java,0,3,0,1,0,4
 skywalking-master\skywalking-master\oap-server\server-telemetry\telemetry-prometheus\src\main\java\org\apache\skywalking\oap\server\telemetry\prometheus\httpserver\HttpServerInitializer.java,16,3,0,1,0,4
 skywalking-master\skywalking-master\oap-server\server-core\src\main\java\org\apache\skywalking\oap\server\core\remote\selector\RemoteClientSelector.java,0,1,0,1,0,2
 skywalking-master\skywalking-master\oap-server\server-receiver-plugin\skywalking-zabbix-receiver-plugin\src\main\java\org\apache\skywalking\oap\server\receiver\zabbix\provider\protocol\bean\ZabbixRequestJsonDeserializer.java,30,12,0,8,0,20
 skywalking-master\skywalking-master\oap-server\server-library\library-util\src\main\java\org\apache\skywalking\oap\server\library\util\prometheus\parser\sample\Context.java,0,11,4,1,0,16
 skywalking-master\skywalking-master\oap-server\analyzer\agent-analyzer\src\test\java\org\apache\skywalking\oap\server\analyzer\provider\trace\UninstrumentedGatewaysConfigTest.java,49,5,3,6,0,14
 skywalking-master\skywalking-master\oap-server\server-alarm-plugin\src\main\java\org\apache\skywalking\oap\server\core\alarm\provider\wechat\WechatHookCallback.java,69,22,4,10,0,36
 skywalking-master\skywalking-master\oap-server\server-core\src\main\java\org\apache\skywalking\oap\server\core\query\enumeration\Step.java,0,4,0,1,0,5
 skywalking-master\skywalking-master\oap-server\server-core\src\main\java\org\apache\skywalking\oap\server\core\source\TCPInfo.java,10,2,0,1,0,3
 skywalking-master\skywalking-master\oap-server\server-receiver-plugin\skywalking-meter-receiver-plugin\src\main\java\org\apache\skywalking\oap\server\receiver\meter\provider\MeterReceiverProvider.java,51,11,3,11,0,25
 skywalking-master\skywalking-master\oap-server\server-receiver-plugin\skywalking-browser-receiver-plugin\src\main\java\org\apache\skywalking\oap\server\receiver\browser\provider\BrowserServiceModuleConfig.java,7,1,0,1,0,2
 skywalking-master\skywalking-master\oap-server\server-core\src\main\java\org\apache\skywalking\oap\server\core\analysis\TimeBucket.java,145,60,2,9,0,71
 skywalking-master\skywalking-master\oap-server\server-tools\profile-exporter\tool-profile-snapshot-server-mock\src\main\java\org\apache\skywalking\oap\server\tool\profile\core\mock\MockSourceReceiver.java,11,3,1,2,0,6
 skywalking-master\skywalking-master\oap-server\server-core\src\main\java\org\apache\skywalking\oap\server\core\remote\selector\ForeverFirstSelector.java,13,7,0,3,0,10
 skywalking-master\skywalking-master\oap-server\exporter\src\test\java\org\apache\skywalking\oap\server\exporter\provider\grpc\MockMetrics.java,43,8,2,1,0,11
 skywalking-master\skywalking-master\oap-server\server-configuration\configuration-consul\src\main\java\org\apache\skywalking\oap\server\configuration\consul\ConsulConfigurationCenterSettings.java,14,4,0,1,0,5
 skywalking-master\skywalking-master\oap-server\server-core\src\main\java\org\apache\skywalking\oap\server\core\source\DefaultScopeDefine.java,350,134,3,39,0,176
 skywalking-master\skywalking-master\oap-server\server-core\src\main\java\org\apache\skywalking\oap\server\core\storage\query\ILogQueryDAO.java,0,14,1,5,0,20
 skywalking-master\skywalking-master\oap-server\server-core\src\main\java\org\apache\skywalking\oap\server\core\storage\model\ColumnName.java,29,20,0,3,0,23
 skywalking-master\skywalking-master\oap-server\server-core\src\main\java\org\apache\skywalking\oap\server\core\storage\model\DataTypeMapping.java,0,3,0,1,0,4
 skywalking-master\skywalking-master\oap-server\server-alarm-plugin\src\test\java\org\apache\skywalking\oap\server\core\alarm\provider\AlarmMessageFormatterTest.java,0,4,0,3,0,7
 skywalking-master\skywalking-master\oap-server\analyzer\meter-analyzer\src\test\java\org\apache\skywalking\oap\meter\analyzer\dsl\AnalyzerTest.java,197,67,13,33,0,113
 skywalking-master\skywalking-master\oap-server\server-cluster-plugin\cluster-zookeeper-plugin\src\main\java\org\apache\skywalking\oap\server\cluster\plugin\zookeeper\ClusterModuleZookeeperConfig.java,0,18,0,1,0,19
 skywalking-master\skywalking-master\oap-server\server-receiver-plugin\envoy-metrics-receiver-plugin\src\main\java\org\apache\skywalking\oap\server\receiver\envoy\persistence\TCPLogsPersistence.java,56,12,0,9,0,21
 skywalking-master\skywalking-master\oap-server\server-core\src\test\java\org\apache\skywalking\oap\server\core\cluster\OAPNodeCheckerTest.java,87,40,10,18,0,68
 skywalking-master\skywalking-master\oap-server\server-core\src\main\java\org\apache\skywalking\oap\server\core\profiling\trace\ProfileTaskRecord.java,66,33,0,15,0,48
 skywalking-master\skywalking-master\oap-server\analyzer\agent-analyzer\src\main\java\org\apache\skywalking\oap\server\analyzer\provider\trace\sampling\SamplingPolicy.java,5,4,0,1,0,5
 skywalking-master\skywalking-master\oap-server\server-core\src\test\java\org\apache\skywalking\oap\server\core\profiling\ebpf\analyze\EBPFProfilingAnalyzerHolder.java,4,2,0,1,0,3
 skywalking-master\skywalking-master\oap-server\server-telemetry\telemetry-api\src\main\java\org\apache\skywalking\oap\server\telemetry\none\MetricsCollectorNoop.java,7,2,0,1,0,3
 skywalking-master\skywalking-master\oap-server\server-core\src\main\java\org\apache\skywalking\oap\server\core\analysis\metrics\ApdexMetrics.java,71,29,0,9,0,38
 skywalking-master\skywalking-master\oap-server\server-receiver-plugin\skywalking-trace-receiver-plugin\src\test\java\org\apache\skywalking\oap\server\receiver\trace\mock\Component.java,0,3,0,2,0,5
 skywalking-master\skywalking-master\oap-server\server-core\src\test\java\org\apache\skywalking\oap\server\core\profiling\ebpf\analyze\EBPFProfilingAnalyzerTest.java,21,6,0,3,0,9
 skywalking-master\skywalking-master\oap-server\server-library\library-datacarrier-queue\src\main\java\org\apache\skywalking\oap\server\library\datacarrier\buffer\QueueBuffer.java,0,6,0,1,0,7
 skywalking-master\skywalking-master\oap-server\server-core\src\main\java\org\apache\skywalking\oap\server\core\query\type\RefType.java,0,2,0,1,0,3
 skywalking-master\skywalking-master\oap-server\server-receiver-plugin\skywalking-zabbix-receiver-plugin\src\main\java\org\apache\skywalking\oap\server\receiver\zabbix\provider\protocol\ZabbixServer.java,56,15,3,4,0,22
 skywalking-master\skywalking-master\oap-server\server-core\src\main\java\org\apache\skywalking\oap\server\core\analysis\manual\process\ProcessDispatcher.java,21,2,0,2,0,4
 skywalking-master\skywalking-master\oap-server\server-core\src\main\java\org\apache\skywalking\oap\server\core\analysis\ApdexThresholdConfig.java,66,17,0,6,0,23
 skywalking-master\skywalking-master\oap-server\server-core\src\test\java\org\apache\skywalking\oap\server\core\profiling\trace\analyze\ProfileStackElementMatcher.java,61,22,0,8,0,30
 skywalking-master\skywalking-master\oap-server\server-core\src\main\java\org\apache\skywalking\oap\server\core\query\type\EBPFProfilingStackElement.java,8,6,0,2,0,8
 skywalking-master\skywalking-master\oap-server\server-core\src\main\java\org\apache\skywalking\oap\server\core\query\type\ErrorCategory.java,0,7,0,1,0,8
 skywalking-master\skywalking-master\oap-server\server-core\src\main\java\org\apache\skywalking\oap\server\core\analysis\topn\TopN.java,26,12,0,2,0,14
 skywalking-master\skywalking-master\oap-server\server-alarm-plugin\src\main\java\org\apache\skywalking\oap\server\core\alarm\provider\feishu\FeishuHookCallback.java,129,48,4,16,0,68
 skywalking-master\skywalking-master\oap-server\server-storage-plugin\storage-iotdb-plugin\src\main\java\org\apache\skywalking\oap\server\storage\plugin\iotdb\base\IoTDBBatchDAO.java,31,9,2,4,0,15
 skywalking-master\skywalking-master\oap-server\server-core\src\main\java\org\apache\skywalking\oap\server\core\alarm\AlarmModule.java,13,3,0,1,0,4
 skywalking-master\skywalking-master\oap-server\analyzer\agent-analyzer\src\main\java\org\apache\skywalking\oap\server\analyzer\provider\trace\parser\listener\LocalAnalysisListener.java,0,2,0,2,0,4
 skywalking-master\skywalking-master\oap-server\server-core\src\test\java\org\apache\skywalking\oap\server\core\analysis\meter\function\PercentileFunctionTest.java,195,46,0,8,0,54
 skywalking-master\skywalking-master\oap-server\server-core\src\main\java\org\apache\skywalking\oap\server\core\config\InitialComponentCatalogException.java,0,1,0,1,0,2
 skywalking-master\skywalking-master\oap-server\analyzer\log-analyzer\src\main\java\org\apache\skywalking\oap\log\analyzer\dsl\Binding.java,0,65,4,10,0,79
 skywalking-master\skywalking-master\oap-server\server-core\src\main\java\org\apache\skywalking\oap\server\core\browser\manual\instance\BrowserAppSingleVersionTrafficDispatcher.java,13,4,0,7,0,11
 skywalking-master\skywalking-master\oap-server\server-core\src\test\java\org\apache\skywalking\oap\server\core\analysis\meter\function\avg\AvgHistogramFunctionTest.java,233,53,0,12,0,65
 skywalking-master\skywalking-master\oap-server\server-core\src\main\java\org\apache\skywalking\oap\server\core\profiling\ebpf\analyze\EBPFProfilingAnalyzeCollector.java,0,10,0,4,0,14
 skywalking-master\skywalking-master\oap-server\analyzer\meter-analyzer\src\main\java\org\apache\skywalking\oap\meter\analyzer\dsl\counter\CounterWindow.java,47,25,0,7,0,32
 skywalking-master\skywalking-master\oap-server\server-cluster-plugin\cluster-zookeeper-plugin\src\test\java\org\apache\skywalking\oap\server\cluster\plugin\zookeeper\ClusterModuleZookeeperProviderTest.java,27,7,0,2,0,9
 skywalking-master\skywalking-master\oap-server\server-receiver-plugin\otel-receiver-plugin\src\main\java\org\apache\skywalking\oap\server\receiver\otel\OtelMetricReceiverProvider.java,48,13,2,9,0,24
 skywalking-master\skywalking-master\oap-server\server-core\src\main\java\org\apache\skywalking\oap\server\core\storage\query\ITraceQueryDAO.java,0,8,1,3,0,12
 skywalking-master\skywalking-master\oap-server\server-core\src\main\java\org\apache\skywalking\oap\server\core\analysis\metrics\LongValueHolder.java,0,1,0,1,0,2
 skywalking-master\skywalking-master\oap-server\server-storage-plugin\storage-iotdb-plugin\src\main\java\org\apache\skywalking\oap\server\storage\plugin\iotdb\query\IoTDBEBPFProfilingTaskDAO.java,78,30,0,26,0,56
 skywalking-master\skywalking-master\oap-server\server-storage-plugin\storage-iotdb-plugin\src\main\java\org\apache\skywalking\oap\server\storage\plugin\iotdb\IoTDBClient.java,0,69,1,37,0,107
 skywalking-master\skywalking-master\oap-server\server-core\src\main\java\org\apache\skywalking\oap\server\core\profiling\ebpf\storage\EBPFProfilingStackType.java,0,32,0,13,0,45
 skywalking-master\skywalking-master\oap-server\server-library\library-server\src\main\java\org\apache\skywalking\oap\server\library\server\grpc\GRPCServerException.java,11,5,0,1,0,6
 skywalking-master\skywalking-master\oap-server\exporter\src\test\java\org\apache\skywalking\oap\server\exporter\provider\grpc\GRPCExporterProviderTest.java,66,13,0,6,0,19
 skywalking-master\skywalking-master\oap-server\server-receiver-plugin\skywalking-zabbix-receiver-plugin\src\main\java\org\apache\skywalking\oap\server\receiver\zabbix\provider\protocol\ZabbixErrorProtocolException.java,8,4,0,1,0,5
 skywalking-master\skywalking-master\oap-server\analyzer\meter-analyzer\src\main\java\org\apache\skywalking\oap\meter\analyzer\dsl\tagOpt\K8sRetagType.java,0,6,2,5,0,13
 skywalking-master\skywalking-master\oap-server\server-core\src\main\java\org\apache\skywalking\oap\server\core\command\CommandService.java,33,21,6,14,0,41
 skywalking-master\skywalking-master\oap-server\analyzer\agent-analyzer\src\main\java\org\apache\skywalking\oap\server\analyzer\provider\trace\parser\listener\strategy\SegmentStatusStrategy.java,0,7,0,6,0,13
 skywalking-master\skywalking-master\oap-server\server-library\library-elasticsearch-client\src\main\java\org\apache\skywalking\library\elasticsearch\requests\factory\v7\V78TemplateFactory.java,0,7,0,3,0,10
 skywalking-master\skywalking-master\oap-server\server-library\library-util\src\main\java\org\apache\skywalking\oap\server\library\util\StringUtil.java,0,25,2,2,0,29
 skywalking-master\skywalking-master\oap-server\server-core\src\test\java\org\apache\skywalking\oap\server\core\remote\RemoteServiceHandlerTestCase.java,141,31,7,14,0,52
 skywalking-master\skywalking-master\test\e2e-v2\java-test-service\e2e-service-provider\src\main\java\org\apache\skywalking\e2e\User.java,9,2,0,1,0,3
 skywalking-master\skywalking-master\oap-server\server-core\src\main\java\org\apache\skywalking\oap\server\core\source\ServiceInstanceJVMClass.java,37,13,0,7,0,20
 skywalking-master\skywalking-master\oap-server\server-core\src\test\java\org\apache\skywalking\oap\server\core\analysis\metrics\PercentMetricsTest.java,75,11,1,2,0,14
 skywalking-master\skywalking-master\oap-server\server-library\library-elasticsearch-client\src\main\java\org\apache\skywalking\library\elasticsearch\requests\search\QueryBuilder.java,0,1,0,1,0,2
 skywalking-master\skywalking-master\oap-server\server-receiver-plugin\skywalking-mesh-receiver-plugin\src\main\java\org\apache\skywalking\aop\server\receiver\mesh\MeshReceiverProvider.java,58,12,2,8,0,22
 skywalking-master\skywalking-master\oap-server\analyzer\agent-analyzer\src\test\java\org\apache\skywalking\oap\server\analyzer\provider\trace\TraceSamplingPolicyWatcherTest.java,331,186,0,57,0,243
 skywalking-master\skywalking-master\oap-server\server-alarm-plugin\src\main\java\org\apache\skywalking\oap\server\core\alarm\provider\CompositeAlarmRule.java,7,4,0,1,0,5
 skywalking-master\skywalking-master\oap-server\server-core\src\main\java\org\apache\skywalking\oap\server\core\query\type\ProfiledSpan.java,23,15,0,1,0,16
 skywalking-master\skywalking-master\oap-server\analyzer\log-analyzer\src\main\java\org\apache\skywalking\oap\log\analyzer\provider\log\listener\LogAnalysisListenerFactory.java,0,2,0,2,0,4
 skywalking-master\skywalking-master\test\e2e-v2\java-test-service\e2e-service-provider\src\main\java\org\apache\skywalking\e2e\controller\FileLogController.java,15,10,4,6,0,20
 skywalking-master\skywalking-master\oap-server\server-receiver-plugin\skywalking-sharing-server-plugin\src\main\java\org\apache\skywalking\oap\server\receiver\sharing\server\SharingServerModule.java,17,10,0,8,0,18
 skywalking-master\skywalking-master\oap-server\server-core\src\main\java\org\apache\skywalking\oap\server\core\analysis\metrics\HavingDefaultValue.java,0,3,0,4,0,7
 skywalking-master\skywalking-master\oap-server\server-core\src\main\java\org\apache\skywalking\oap\server\core\query\TraceQueryService.java,199,35,1,20,0,56
 skywalking-master\skywalking-master\oap-server\server-storage-plugin\storage-elasticsearch-plugin\src\main\java\org\apache\skywalking\oap\server\storage\plugin\elasticsearch\base\MetricsEsDAO.java,101,40,1,29,0,70
 skywalking-master\skywalking-master\oap-server\server-query-plugin\query-graphql-plugin\src\main\java\org\apache\skywalking\oap\query\graphql\resolver\EventQuery.java,25,9,0,3,0,12
 skywalking-master\skywalking-master\oap-server\server-storage-plugin\storage-jdbc-hikaricp-plugin\src\main\java\org\apache\skywalking\oap\server\storage\plugin\jdbc\h2\dao\H2NoneStreamDAO.java,21,13,0,4,0,17
 skywalking-master\skywalking-master\oap-server\server-receiver-plugin\skywalking-event-receiver-plugin\src\main\java\org\apache\skywalking\oap\server\receiver\event\EventModuleConfig.java,3,0,0,1,0,1
 skywalking-master\skywalking-master\oap-server\server-core\src\main\java\org\apache\skywalking\oap\server\core\storage\IRecordDAO.java,0,4,0,3,0,7
 skywalking-master\skywalking-master\oap-server\server-library\library-util\src\test\java\org\apache\skywalking\oap\server\library\util\ConnectUtilTestCase.java,67,15,11,3,7,36
 skywalking-master\skywalking-master\oap-server\server-core\src\main\java\org\apache\skywalking\oap\server\core\analysis\meter\function\latest\LatestFunction.java,0,36,1,14,0,51
 skywalking-master\skywalking-master\oap-server\server-storage-plugin\storage-jdbc-hikaricp-plugin\src\main\java\org\apache\skywalking\oap\server\storage\plugin\jdbc\postgresql\dao\PostgreSQLMetricsQueryDAO.java,13,10,0,5,0,15
 skywalking-master\skywalking-master\oap-server\server-storage-plugin\storage-jdbc-hikaricp-plugin\src\main\java\org\apache\skywalking\oap\server\storage\plugin\jdbc\postgresql\dao\PostgreSQLAggregationQueryDAO.java,20,9,0,4,0,13
 skywalking-master\skywalking-master\oap-server\server-core\src\main\java\org\apache\skywalking\oap\server\core\analysis\metrics\P90Metrics.java,6,3,0,2,0,5
 skywalking-master\skywalking-master\oap-server\server-core\src\main\java\org\apache\skywalking\oap\server\core\analysis\metrics\MetricsEntityMetaInfo.java,52,36,0,9,0,45
 skywalking-master\skywalking-master\oap-server\server-core\src\test\java\org\apache\skywalking\oap\server\core\analysis\meter\function\latest\LatestFunctionTest.java,63,27,0,11,0,38
 skywalking-master\skywalking-master\oap-server\server-configuration\configuration-etcd\src\test\java\org\apache\skywalking\oap\server\configuration\etcd\EtcdConfigurationTestProvider.java,87,15,2,7,0,24
 skywalking-master\skywalking-master\oap-server\server-receiver-plugin\skywalking-trace-receiver-plugin\src\test\java\org\apache\skywalking\oap\server\receiver\trace\mock\ServiceAMock.java,0,36,0,7,0,43
 skywalking-master\skywalking-master\oap-server\server-core\src\main\java\org\apache\skywalking\oap\server\core\analysis\metrics\annotation\Expression.java,0,0,0,1,0,1
 skywalking-master\skywalking-master\oap-server\server-core\src\main\java\org\apache\skywalking\oap\server\core\source\ServiceInstanceCLRCPU.java,31,12,1,7,0,20
 skywalking-master\skywalking-master\oap-server\analyzer\event-analyzer\src\main\java\org\apache\skywalking\oap\server\analyzer\event\EventAnalyzer.java,27,7,0,4,0,11
 skywalking-master\skywalking-master\oap-server\server-core\src\main\java\org\apache\skywalking\oap\server\core\profiling\trace\analyze\ProfileAnalyzer.java,160,72,5,30,0,107
 skywalking-master\skywalking-master\oap-server\server-core\src\main\java\org\apache\skywalking\oap\server\core\source\ServiceInstanceUpdate.java,27,8,0,4,0,12
 skywalking-master\skywalking-master\oap-server\server-core\src\main\java\org\apache\skywalking\oap\server\core\query\input\EBPFProfilingProcessFinder.java,7,3,0,2,0,5
 skywalking-master\skywalking-master\oap-server\server-core\src\main\java\org\apache\skywalking\oap\server\core\analysis\metrics\SumMetrics.java,36,8,1,5,0,14
 skywalking-master\skywalking-master\oap-server\server-library\library-module\src\main\java\org\apache\skywalking\oap\server\library\module\ModuleManager.java,55,17,2,8,0,27
 skywalking-master\skywalking-master\oap-server\server-library\library-util\src\main\java\org\apache\skywalking\oap\server\library\util\BooleanUtils.java,24,7,1,1,0,9
 skywalking-master\skywalking-master\oap-server\server-storage-plugin\storage-iotdb-plugin\src\main\java\org\apache\skywalking\oap\server\storage\plugin\iotdb\query\IoTDBEventQueryDAO.java,173,32,0,27,0,59
 skywalking-master\skywalking-master\oap-server\server-cluster-plugin\cluster-zookeeper-plugin\src\test\java\org\apache\skywalking\oap\server\cluster\plugin\zookeeper\ITClusterModuleZookeeperProviderFunctionalTest.java,211,57,9,19,0,85
 skywalking-master\skywalking-master\oap-server\server-library\library-datacarrier-queue\src\main\java\org\apache\skywalking\oap\server\library\datacarrier\common\AtomicRangeInteger.java,54,17,0,2,0,19
 skywalking-master\skywalking-master\oap-server\server-receiver-plugin\zipkin-receiver-plugin\src\main\java\org\apache\skywalking\oap\server\receiver\zipkin\handler\ZipkinSpanHTTPHandler.java,80,48,0,15,0,63
 skywalking-master\skywalking-master\oap-server\server-core\src\main\java\org\apache\skywalking\oap\server\core\query\type\Attribute.java,13,8,1,1,0,10
 skywalking-master\skywalking-master\oap-server\analyzer\log-analyzer\src\main\java\org\apache\skywalking\oap\log\analyzer\provider\LALConfig.java,6,3,0,1,0,4
 skywalking-master\skywalking-master\oap-server\server-starter\src\main\java\org\apache\skywalking\oap\server\starter\config\ConfigFileNotFoundException.java,11,5,0,1,0,6
 skywalking-master\skywalking-master\oap-server\server-fetcher-plugin\kafka-fetcher-plugin\src\test\java\org\apache\skywalking\oap\server\analyzer\agent\kafka\provider\handler\SourceReceiverRule.java,22,6,0,3,0,9
 skywalking-master\skywalking-master\oap-server\server-alarm-plugin\src\main\java\org\apache\skywalking\oap\server\core\alarm\provider\EventHookCallback.java,115,30,1,21,0,52
 skywalking-master\skywalking-master\oap-server\analyzer\meter-analyzer\src\main\java\org\apache\skywalking\oap\meter\analyzer\dsl\DownsamplingType.java,0,5,0,1,0,6
 skywalking-master\skywalking-master\oap-server\server-core\src\main\java\org\apache\skywalking\oap\server\core\config\ConfigService.java,16,7,0,1,0,8
 skywalking-master\skywalking-master\oap-server\server-core\src\main\java\org\apache\skywalking\oap\server\core\storage\IHistoryDeleteDAO.java,0,8,1,7,0,16
 skywalking-master\skywalking-master\oap-server\analyzer\agent-analyzer\src\main\java\org\apache\skywalking\oap\server\analyzer\provider\trace\parser\listener\strategy\FromFirstSpan.java,8,3,0,4,0,7
 skywalking-master\skywalking-master\oap-server\server-library\library-elasticsearch-client\src\main\java\org\apache\skywalking\library\elasticsearch\requests\factory\v6\codec\V6MappingsSerializer.java,0,3,0,2,0,5
 skywalking-master\skywalking-master\oap-server\server-receiver-plugin\skywalking-trace-receiver-plugin\src\test\java\org\apache\skywalking\oap\server\receiver\trace\mock\AgentDataMock.java,99,28,3,17,0,48
 skywalking-master\skywalking-master\oap-server\exporter\src\main\java\org\apache\skywalking\oap\server\exporter\provider\grpc\GRPCExporterProvider.java,42,12,1,6,0,19
 skywalking-master\skywalking-master\oap-server\server-core\src\main\java\org\apache\skywalking\oap\server\core\analysis\manual\relation\service\ServiceRelationServerSideMetrics.java,115,34,1,14,0,49
 skywalking-master\skywalking-master\oap-server\server-cluster-plugin\cluster-nacos-plugin\src\main\java\org\apache\skywalking\oap\server\cluster\plugin\nacos\NacosCoordinator.java,0,21,5,10,0,36
 skywalking-master\skywalking-master\oap-server\server-core\src\main\java\org\apache\skywalking\oap\server\core\query\type\event\Events.java,6,2,0,1,0,3
 skywalking-master\skywalking-master\oap-server\server-query-plugin\query-graphql-plugin\src\main\java\org\apache\skywalking\oap\query\graphql\resolver\MetricQuery.java,132,31,0,17,0,48
 skywalking-master\skywalking-master\oap-server\analyzer\log-analyzer\src\main\java\org\apache\skywalking\oap\log\analyzer\dsl\spec\sink\sampler\Sampler.java,0,4,1,1,0,6
 skywalking-master\skywalking-master\oap-server\server-storage-plugin\storage-tidb-plugin\src\main\java\org\apache\skywalking\oap\server\storage\plugin\jdbc\tidb\TiDBStorageProvider.java,137,52,1,73,0,126
 skywalking-master\skywalking-master\oap-server\server-library\library-util\src\main\java\org\apache\skywalking\oap\server\library\util\prometheus\parser\sample\TextSample.java,23,9,0,3,1,13
 skywalking-master\skywalking-master\oap-server\server-core\src\main\java\org\apache\skywalking\oap\server\core\Const.java,24,23,0,1,0,24
 skywalking-master\skywalking-master\oap-server\server-core\src\test\java\org\apache\skywalking\oap\server\core\config\group\EndpointNameGroupingRuleWatcherTest.java,84,51,3,23,0,77
 skywalking-master\skywalking-master\oap-server\server-core\src\main\java\org\apache\skywalking\oap\server\core\cluster\ServiceRegisterException.java,11,4,0,1,0,5
 skywalking-master\skywalking-master\oap-server\server-core\src\test\java\org\apache\skywalking\oap\server\core\analysis\meter\MeterSystemTest.java,51,14,3,8,0,25
 skywalking-master\skywalking-master\oap-server\server-core\src\main\java\org\apache\skywalking\oap\server\core\storage\profiling\ebpf\IEBPFProfilingScheduleDAO.java,0,6,1,2,0,9
 skywalking-master\skywalking-master\oap-server\server-storage-plugin\storage-jdbc-hikaricp-plugin\src\main\java\org\apache\skywalking\oap\server\storage\plugin\jdbc\h2\dao\H2AlarmRecordBuilder.java,22,5,0,3,0,8
 skywalking-master\skywalking-master\oap-server\server-storage-plugin\storage-influxdb-plugin\src\main\java\org\apache\skywalking\oap\server\storage\plugin\influxdb\query\ProfileTaskQuery.java,102,17,0,5,0,22
 skywalking-master\skywalking-master\oap-server\server-storage-plugin\storage-elasticsearch-plugin\src\main\java\org\apache\skywalking\oap\server\storage\plugin\elasticsearch\query\LogQueryEsDAO.java,124,25,0,28,0,53
 skywalking-master\skywalking-master\oap-server\server-core\src\main\java\org\apache\skywalking\oap\server\core\analysis\Layer.java,0,30,0,4,0,34
 skywalking-master\skywalking-master\oap-server\server-storage-plugin\storage-jdbc-hikaricp-plugin\src\main\java\org\apache\skywalking\oap\server\storage\plugin\jdbc\TableMetaInfo.java,12,7,1,1,0,9
 skywalking-master\skywalking-master\oap-server\server-core\src\main\java\org\apache\skywalking\oap\server\core\cache\CacheUpdateTimer.java,0,41,0,25,0,66
 skywalking-master\skywalking-master\oap-server\analyzer\log-analyzer\src\test\java\org\apache\skywalking\oap\log\analyzer\dsl\DSLTest.java,0,132,0,29,0,161
 skywalking-master\skywalking-master\oap-server\microbench\src\main\java\org\apache\skywalking\oap\server\microbench\core\profiling\ebpf\EBPFProfilingAnalyzerBenchmark.java,0,130,0,42,0,172
 skywalking-master\skywalking-master\oap-server\server-storage-plugin\storage-jdbc-hikaricp-plugin\src\main\java\org\apache\skywalking\oap\server\storage\plugin\jdbc\h2\dao\H2MetadataQueryDAO.java,275,74,6,46,0,126
 skywalking-master\skywalking-master\oap-server\server-core\src\main\java\org\apache\skywalking\oap\server\core\query\type\LogEntity.java,10,3,0,1,0,4
 skywalking-master\skywalking-master\oap-server\server-receiver-plugin\skywalking-profile-receiver-plugin\src\main\java\org\apache\skywalking\oap\server\receiver\profile\provider\ProfileModuleProvider.java,43,14,2,12,0,28
 skywalking-master\skywalking-master\oap-server\server-storage-plugin\storage-jdbc-hikaricp-plugin\src\main\java\org\apache\skywalking\oap\server\storage\plugin\jdbc\h2\H2StorageProvider.java,138,50,1,72,0,123
 skywalking-master\skywalking-master\oap-server\server-core\src\main\java\org\apache\skywalking\oap\server\core\storage\annotation\ValueColumnMetadata.java,0,38,1,5,0,44
 skywalking-master\skywalking-master\oap-server\server-storage-plugin\storage-iotdb-plugin\src\main\java\org\apache\skywalking\oap\server\storage\plugin\iotdb\query\IoTDBTopologyQueryDAO.java,227,103,1,57,0,161
 skywalking-master\skywalking-master\oap-server\server-library\library-elasticsearch-client\src\main\java\org\apache\skywalking\library\elasticsearch\requests\factory\v7\codec\V7Codec.java,0,7,0,6,0,13
 skywalking-master\skywalking-master\oap-server\server-alarm-plugin\src\main\java\org\apache\skywalking\oap\server\core\alarm\provider\dingtalk\DingtalkSettings.java,16,4,0,1,0,5
 skywalking-master\skywalking-master\oap-server\server-library\library-module\src\test\java\org\apache\skywalking\oap\server\library\module\ModuleA2Provider.java,39,7,2,3,0,12
 skywalking-master\skywalking-master\oap-server\analyzer\agent-analyzer\src\main\java\org\apache\skywalking\oap\server\analyzer\provider\trace\UninstrumentedGatewaysConfig.java,126,27,1,11,0,39
 skywalking-master\skywalking-master\oap-server\server-core\src\main\java\org\apache\skywalking\oap\server\core\analysis\StreamAnnotationListener.java,43,15,0,14,0,29
 skywalking-master\skywalking-master\oap-server\analyzer\meter-analyzer\src\test\java\org\apache\skywalking\oap\meter\analyzer\dsl\TagFilterTest.java,57,19,1,3,0,23
 skywalking-master\skywalking-master\oap-server\server-receiver-plugin\skywalking-browser-receiver-plugin\src\main\java\org\apache\skywalking\oap\server\receiver\browser\provider\parser\performance\PerfDataParserListenerManager.java,9,4,0,4,0,8
 skywalking-master\skywalking-master\test\e2e-v2\java-test-service\e2e-service-provider\src\main\java\org\apache\skywalking\e2e\controller\AlarmController.java,47,18,0,1,0,19
 skywalking-master\skywalking-master\oap-server\server-library\library-elasticsearch-client\src\main\java\org\apache\skywalking\library\elasticsearch\requests\factory\v6\V6DocumentFactory.java,0,25,0,8,0,33
 skywalking-master\skywalking-master\oap-server\server-core\src\main\java\org\apache\skywalking\oap\server\core\storage\model\ExtraQueryIndex.java,29,9,0,4,0,13
 skywalking-master\skywalking-master\oap-server\server-library\library-util\src\main\java\org\apache\skywalking\oap\server\library\util\prometheus\Parsers.java,6,2,1,2,0,5
 skywalking-master\skywalking-master\oap-server\analyzer\meter-analyzer\src\main\java\org\apache\skywalking\oap\meter\analyzer\prometheus\rule\Target.java,5,2,0,1,0,3
 skywalking-master\skywalking-master\oap-server\analyzer\meter-analyzer\src\main\java\org\apache\skywalking\oap\meter\analyzer\dsl\NumberClosure.java,0,13,0,6,0,19
 skywalking-master\skywalking-master\oap-server\server-storage-plugin\storage-jdbc-hikaricp-plugin\src\test\java\org\apache\skywalking\oap\server\storage\plugin\jdbc\mysql\PreventRedistributionMySQLDriverTest.java,7,4,1,2,0,7
 skywalking-master\skywalking-master\oap-server\server-storage-plugin\storage-elasticsearch-plugin\src\main\java\org\apache\skywalking\oap\server\storage\plugin\elasticsearch\query\ProfileThreadSnapshotQueryEsDAO.java,0,54,0,38,0,92
 skywalking-master\skywalking-master\oap-server\server-storage-plugin\storage-jdbc-hikaricp-plugin\src\main\java\org\apache\skywalking\oap\server\storage\plugin\jdbc\h2\dao\H2SQLExecutor.java,142,65,0,33,0,98
 skywalking-master\skywalking-master\oap-server\server-tools\profile-exporter\tool-profile-snapshot-bootstrap\src\main\java\org\apache\skywalking\oap\server\tool\profile\exporter\ProfileSnapshotDumper.java,74,40,4,18,0,62
 skywalking-master\skywalking-master\oap-server\server-core\src\main\java\org\apache\skywalking\oap\server\core\analysis\manual\networkalias\NetworkAddressAlias.java,109,33,1,16,0,50
 skywalking-master\skywalking-master\oap-server\server-library\library-elasticsearch-client\src\main\java\org\apache\skywalking\library\elasticsearch\response\IndexTemplates.java,0,4,0,1,2,7
 skywalking-master\skywalking-master\oap-server\server-core\src\main\java\org\apache\skywalking\oap\server\core\remote\selector\RollingSelector.java,17,5,0,2,0,7
 skywalking-master\skywalking-master\oap-server\server-receiver-plugin\skywalking-zabbix-receiver-plugin\src\main\java\org\apache\skywalking\oap\server\receiver\zabbix\provider\ZabbixModuleConfig.java,21,5,1,1,0,7
 skywalking-master\skywalking-master\oap-server\server-core\src\test\java\org\apache\skywalking\oap\server\core\analysis\meter\function\avg\AvgLabeledFunctionTest.java,91,51,0,25,0,76
 skywalking-master\skywalking-master\oap-server\server-configuration\configuration-etcd\src\main\java\org\apache\skywalking\oap\server\configuration\etcd\EtcdConfigurationProvider.java,31,7,0,4,0,11
 skywalking-master\skywalking-master\oap-server\server-core\src\main\java\org\apache\skywalking\oap\server\core\profiling\ebpf\analyze\EBPFProfilingAnalyzer.java,138,56,2,22,0,80
 skywalking-master\skywalking-master\oap-server\server-library\library-client\src\main\java\org\apache\skywalking\oap\server\library\client\elasticsearch\IndexRequestWrapper.java,14,6,0,1,0,7
 skywalking-master\skywalking-master\oap-server\server-core\src\main\java\org\apache\skywalking\oap\server\core\annotation\AnnotationListener.java,0,3,0,1,0,4
 skywalking-master\skywalking-master\oap-server\server-core\src\main\java\org\apache\skywalking\oap\server\core\server\GRPCHandlerRegister.java,0,4,0,1,0,5
 skywalking-master\skywalking-master\oap-server\server-core\src\main\java\org\apache\skywalking\oap\server\core\remote\RemoteServiceHandler.java,0,37,3,26,0,66
 skywalking-master\skywalking-master\oap-server\server-core\src\main\java\org\apache\skywalking\oap\server\core\alarm\ProcessMetaInAlarm.java,27,7,0,1,0,8
 skywalking-master\skywalking-master\oap-server\server-library\library-elasticsearch-client\src\main\java\org\apache\skywalking\library\elasticsearch\client\SearchClient.java,0,14,4,4,3,25
 skywalking-master\skywalking-master\apm-protocol\apm-network\src\main\java\org\apache\skywalking\oap\server\network\trace\component\command\ProfileTaskCommand.java,0,69,0,14,0,83
 skywalking-master\skywalking-master\oap-server\server-library\library-module\src\test\java\org\apache\skywalking\oap\server\library\module\BaseModuleB.java,23,2,0,1,0,3
 skywalking-master\skywalking-master\oap-server\server-core\src\main\java\org\apache\skywalking\oap\server\core\WorkPath.java,48,13,3,9,0,25
 skywalking-master\skywalking-master\oap-server\server-library\library-elasticsearch-client\src\main\java\org\apache\skywalking\library\elasticsearch\requests\search\aggregation\MaxAggregation.java,0,6,0,3,0,9
 skywalking-master\skywalking-master\oap-server\server-library\library-module\src\test\java\org\apache\skywalking\oap\server\library\module\ModuleB3Provider.java,40,7,2,3,0,12
 skywalking-master\skywalking-master\oap-server\server-tools\profile-exporter\tool-profile-snapshot-bootstrap\src\test\java\org\apache\skywalking\oap\server\tool\profile\exporter\test\ProfileExportSnapshotDAO.java,61,29,0,13,0,42
 skywalking-master\skywalking-master\oap-server\server-core\src\main\java\org\apache\skywalking\oap\server\core\analysis\metrics\annotation\BooleanValueFilterMatcher.java,0,1,0,2,0,3
 skywalking-master\skywalking-master\oap-server\server-library\library-module\src\main\java\org\apache\skywalking\oap\server\library\module\ServiceNotProvidedRuntimeException.java,6,2,0,1,0,3
 skywalking-master\skywalking-master\oap-server\server-cluster-plugin\cluster-consul-plugin\src\test\java\org\apache\skywalking\oap\server\cluster\plugin\consul\ClusterModuleConsulProviderTest.java,109,30,5,13,0,48
 skywalking-master\skywalking-master\oap-server\server-alarm-plugin\src\main\java\org\apache\skywalking\oap\server\core\alarm\provider\grpc\GRPCCallback.java,130,31,1,16,0,48
 skywalking-master\skywalking-master\oap-server\server-storage-plugin\storage-influxdb-plugin\src\main\java\org\apache\skywalking\oap\server\storage\plugin\influxdb\query\EventQueryDAO.java,202,61,0,48,0,109
 skywalking-master\skywalking-master\oap-server\server-storage-plugin\storage-elasticsearch-plugin\src\main\java\org\apache\skywalking\oap\server\storage\plugin\elasticsearch\query\ESEventQueryDAO.java,137,33,0,33,0,66
 skywalking-master\skywalking-master\oap-server\server-core\src\main\java\org\apache\skywalking\oap\server\core\storage\annotation\QueryUnifiedIndex.java,0,2,0,3,0,5
 skywalking-master\skywalking-master\oap-server\server-library\library-elasticsearch-client\src\main\java\org\apache\skywalking\library\elasticsearch\client\DocumentClient.java,0,32,2,15,2,51
 skywalking-master\skywalking-master\oap-server\server-receiver-plugin\skywalking-ebpf-receiver-plugin\src\main\java\org\apache\skywalking\oap\server\receiver\ebpf\module\EBPFReceiverModule.java,14,4,0,1,0,5
 skywalking-master\skywalking-master\oap-server\server-storage-plugin\storage-elasticsearch-plugin\src\main\java\org\apache\skywalking\oap\server\storage\plugin\elasticsearch\base\ColumnTypeEsMapping.java,27,6,0,5,0,11
 skywalking-master\skywalking-master\oap-server\server-storage-plugin\storage-elasticsearch-plugin\src\test\java\org\apache\skywalking\oap\server\storage\plugin\elasticsearch\base\MockEsInstallTest.java,238,66,0,38,0,104
 skywalking-master\skywalking-master\oap-server\server-core\src\test\java\org\apache\skywalking\oap\server\core\storage\PersistenceTimerTest.java,78,18,1,13,0,32
 skywalking-master\skywalking-master\oap-server\server-core\src\main\java\org\apache\skywalking\oap\server\core\source\EBPFProcessProfilingSchedule.java,24,10,1,5,0,16
 skywalking-master\skywalking-master\oap-server\server-core\src\main\java\org\apache\skywalking\oap\server\core\browser\manual\endpoint\BrowserAppPageTrafficDispatcher.java,11,3,0,6,0,9
 skywalking-master\skywalking-master\oap-server\server-library\library-elasticsearch-client\src\main\java\org\apache\skywalking\library\elasticsearch\requests\search\aggregation\TermsAggregation.java,0,12,0,5,0,17
 skywalking-master\skywalking-master\oap-server\analyzer\agent-analyzer\src\main\java\org\apache\skywalking\oap\server\analyzer\provider\trace\parser\listener\NetworkAddressAliasMappingListener.java,70,32,1,19,0,52
 skywalking-master\skywalking-master\oap-server\server-library\library-datacarrier-queue\src\main\java\org\apache\skywalking\oap\server\library\datacarrier\consumer\ConsumerPool.java,0,3,0,2,0,5
 skywalking-master\skywalking-master\oap-server\server-storage-plugin\storage-elasticsearch-plugin\src\main\java\org\apache\skywalking\oap\server\storage\plugin\elasticsearch\query\TraceQueryEsDAO.java,135,44,2,28,0,74
 skywalking-master\skywalking-master\oap-server\oal-rt\src\test\java\org\apache\skywalking\oal\rt\parser\ScriptParserTest.java,304,96,0,80,0,176
 skywalking-master\skywalking-master\oap-server\server-configuration\configuration-k8s-configmap\src\test\java\org\apache\skywalking\oap\server\configuration\configmap\ConfigmapConfigWatcherRegisterTest.java,128,35,9,23,0,67
 skywalking-master\skywalking-master\oap-server\server-core\src\main\java\org\apache\skywalking\oap\server\core\analysis\manual\relation\endpoint\EndpointCallRelationDispatcher.java,25,8,0,6,0,14
 skywalking-master\skywalking-master\oap-server\server-core\src\main\java\org\apache\skywalking\oap\server\core\query\type\event\Source.java,6,3,0,1,0,4
 skywalking-master\skywalking-master\oap-server\server-alarm-plugin\src\test\java\org\apache\skywalking\oap\server\core\alarm\provider\RulesReaderTest.java,65,19,1,21,0,41
 skywalking-master\skywalking-master\oap-server\analyzer\meter-analyzer\src\main\java\org\apache\skywalking\oap\meter\analyzer\dsl\EntityDescription\EntityDescription.java,0,2,1,1,0,4
 skywalking-master\skywalking-master\oap-server\server-receiver-plugin\skywalking-browser-receiver-plugin\src\main\java\org\apache\skywalking\oap\server\receiver\browser\provider\parser\errorlog\listener\ErrorLogRecordListener.java,80,31,0,20,0,51
 skywalking-master\skywalking-master\oap-server\server-configuration\configuration-consul\src\test\java\org\apache\skywalking\oap\server\configuration\consul\ITConsulConfigurationTest.java,115,39,2,22,0,63
 skywalking-master\skywalking-master\oap-server\server-core\src\main\java\org\apache\skywalking\oap\server\core\alarm\MetricsNotify.java,0,4,0,4,0,8
 skywalking-master\skywalking-master\oap-server\server-core\src\main\java\org\apache\skywalking\oap\server\core\query\MetricsQueryService.java,52,38,0,12,0,50
 skywalking-master\skywalking-master\oap-server\server-core\src\main\java\org\apache\skywalking\oap\server\core\storage\query\IAlarmQueryDAO.java,0,17,1,5,0,23
 skywalking-master\skywalking-master\oap-server\server-library\library-module\src\main\java\org\apache\skywalking\oap\server\library\module\ModuleConfigException.java,11,5,0,1,0,6
 skywalking-master\skywalking-master\oap-server\server-core\src\main\java\org\apache\skywalking\oap\server\core\oal\rt\OALEngineLoaderService.java,45,19,0,11,0,30
 skywalking-master\skywalking-master\apm-protocol\apm-network\src\main\java\org\apache\skywalking\oap\server\network\trace\component\command\CommandDeserializer.java,14,3,1,2,0,6
 skywalking-master\skywalking-master\oap-server\server-library\library-module\src\main\java\org\apache\skywalking\oap\server\library\module\Service.java,0,2,0,3,0,5
 skywalking-master\skywalking-master\oap-server\server-core\src\main\java\org\apache\skywalking\oap\server\core\remote\client\RemoteClient.java,0,4,0,1,0,5
 skywalking-master\skywalking-master\oap-server\server-core\src\main\java\org\apache\skywalking\oap\server\core\remote\health\HealthCheckServiceHandler.java,0,10,0,7,0,17
 skywalking-master\skywalking-master\oap-server\server-library\library-elasticsearch-client\src\main\java\org\apache\skywalking\library\elasticsearch\requests\factory\v7\V78RequestFactory.java,0,8,0,10,3,21
 skywalking-master\skywalking-master\oap-server\server-core\src\main\java\org\apache\skywalking\oap\server\core\storage\IBatchDAO.java,0,6,0,6,0,12
 skywalking-master\skywalking-master\oap-server\server-core\src\main\java\org\apache\skywalking\oap\server\core\analysis\metrics\expression\LessMatch.java,34,32,0,2,0,34
 skywalking-master\skywalking-master\oap-server\server-core\src\main\java\org\apache\skywalking\oap\server\core\storage\query\IMetadataQueryDAO.java,0,26,7,9,0,42
 skywalking-master\skywalking-master\oap-server\server-core\src\main\java\org\apache\skywalking\oap\server\core\source\SideCar.java,9,3,0,4,0,7
 skywalking-master\skywalking-master\oap-server\oal-rt\src\main\java\org\apache\skywalking\oap\server\core\source\oal\rt\metrics\builder\MetricBuilderClassPackageHolder.java,3,3,0,3,0,6
 skywalking-master\skywalking-master\test\e2e-v2\java-test-service\e2e-mock-sender\src\main\java\org\apache\skywalking\e2e\controller\ServiceMeshMetricSenderController.java,71,24,1,14,0,39
 skywalking-master\skywalking-master\oap-server\server-storage-plugin\storage-iotdb-plugin\src\main\java\org\apache\skywalking\oap\server\storage\plugin\iotdb\query\IoTDBEBPFProfilingDataDAO.java,32,20,0,14,0,34
 skywalking-master\skywalking-master\oap-server\server-receiver-plugin\skywalking-ebpf-receiver-plugin\src\main\java\org\apache\skywalking\oap\server\receiver\ebpf\provider\EBPFReceiverProvider.java,44,12,2,11,0,25
 skywalking-master\skywalking-master\oap-server\server-configuration\configuration-api\src\main\java\org\apache\skywalking\oap\server\configuration\api\GroupConfigTable.java,25,12,0,2,3,17
 skywalking-master\skywalking-master\oap-server\server-alarm-plugin\src\main\java\org\apache\skywalking\oap\server\core\alarm\provider\grpc\GRPCAlarmSetting.java,9,5,0,1,0,6
 skywalking-master\skywalking-master\oap-server\server-library\library-elasticsearch-client\src\main\java\org\apache\skywalking\library\elasticsearch\requests\search\Search.java,0,6,0,2,0,8
 skywalking-master\skywalking-master\oap-server\server-fetcher-plugin\kafka-fetcher-plugin\src\main\java\org\apache\skywalking\oap\server\analyzer\agent\kafka\KafkaFetcherHandlerRegister.java,120,41,2,17,0,60
 skywalking-master\skywalking-master\oap-server\server-library\library-module\src\main\java\org\apache\skywalking\oap\server\library\module\ModuleDefineHolder.java,0,3,0,2,0,5
 skywalking-master\skywalking-master\oap-server\server-core\src\main\java\org\apache\skywalking\oap\server\core\query\type\ServiceInstanceTopology.java,11,3,0,1,0,4
 skywalking-master\skywalking-master\oap-server\server-receiver-plugin\envoy-metrics-receiver-plugin\src\main\java\org\apache\skywalking\oap\server\receiver\envoy\als\tcp\mx\MetaExchangeTCPAccessLogAnalyzer.java,98,29,2,23,0,54
 skywalking-master\skywalking-master\oap-server\server-receiver-plugin\envoy-metrics-receiver-plugin\src\test\java\org\apache\skywalking\oap\server\receiver\envoy\als\k8s\K8SALSServiceMeshHTTPAnalysisTest.java,135,39,4,30,0,73
 skywalking-master\skywalking-master\oap-server\server-alarm-plugin\src\test\java\org\apache\skywalking\oap\server\core\alarm\provider\AlarmCoreTest.java,72,14,2,5,0,21
 skywalking-master\skywalking-master\oap-server\server-receiver-plugin\envoy-metrics-receiver-plugin\src\main\java\org\apache\skywalking\oap\server\receiver\envoy\metrics\adapters\ClusterManagerMetricsAdapter.java,75,23,0,14,0,37
 skywalking-master\skywalking-master\oap-server\server-receiver-plugin\zipkin-receiver-plugin\src\main\java\org\apache\skywalking\oap\server\receiver\zipkin\handler\ConsumesThrift.java,0,1,0,1,0,2
 skywalking-master\skywalking-master\oap-server\server-storage-plugin\storage-iotdb-plugin\src\main\java\org\apache\skywalking\oap\server\storage\plugin\iotdb\query\IoTDBMetadataQueryDAO.java,220,78,2,59,0,139
 skywalking-master\skywalking-master\oap-server\server-alarm-plugin\src\test\java\org\apache\skywalking\oap\server\core\alarm\provider\EventHookCallbackTest.java,92,30,0,15,0,45
 skywalking-master\skywalking-master\oap-server\server-library\library-module\src\test\java\org\apache\skywalking\oap\server\library\module\TestModule.java,12,2,0,1,0,3
 skywalking-master\skywalking-master\oap-server\server-receiver-plugin\skywalking-clr-receiver-plugin\src\main\java\org\apache\skywalking\oap\server\receiver\clr\module\CLRModule.java,12,3,0,1,0,4
 skywalking-master\skywalking-master\oap-server\oal-rt\src\main\java\org\apache\skywalking\oal\rt\parser\ScriptParser.java,42,13,2,3,0,18
 skywalking-master\skywalking-master\oap-server\server-storage-plugin\storage-jdbc-hikaricp-plugin\src\main\java\org\apache\skywalking\oap\server\storage\plugin\jdbc\mysql\MySQLStorageConfig.java,29,12,0,3,0,15
 skywalking-master\skywalking-master\oap-server\server-library\library-elasticsearch-client\src\main\java\org\apache\skywalking\library\elasticsearch\requests\search\aggregation\SumAggregation.java,0,6,0,3,0,9
 skywalking-master\skywalking-master\oap-server\analyzer\meter-analyzer\src\main\java\org\apache\skywalking\oap\meter\analyzer\dsl\SampleFamily.java,628,268,14,97,0,379
 skywalking-master\skywalking-master\oap-server\server-library\library-elasticsearch-client\src\main\java\org\apache\skywalking\library\elasticsearch\requests\UpdateRequest.java,0,4,0,1,2,7
 skywalking-master\skywalking-master\oap-server\server-library\library-elasticsearch-client\src\main\java\org\apache\skywalking\library\elasticsearch\response\NodeInfo.java,0,3,0,1,2,6
 skywalking-master\skywalking-master\oap-server\server-storage-plugin\storage-jdbc-hikaricp-plugin\src\main\java\org\apache\skywalking\oap\server\storage\plugin\jdbc\h2\dao\H2ManagementDAO.java,27,16,0,7,0,23
 skywalking-master\skywalking-master\oap-server\server-core\src\main\java\org\apache\skywalking\oap\server\core\profiling\ebpf\analyze\EBPFProfilingStackNode.java,167,44,0,17,0,61
 skywalking-master\skywalking-master\oap-server\server-fetcher-plugin\kafka-fetcher-plugin\src\test\java\org\apache\skywalking\oap\server\analyzer\agent\kafka\mock\MockModuleManager.java,27,13,0,5,0,18
 skywalking-master\skywalking-master\oap-server\oal-rt\src\main\java\org\apache\skywalking\oal\rt\parser\ConditionExpression.java,38,23,0,2,0,25
 skywalking-master\skywalking-master\oap-server\server-core\src\main\java\org\apache\skywalking\oap\server\core\analysis\metrics\expression\GreaterEqualMatch.java,34,32,0,2,0,34
 skywalking-master\skywalking-master\oap-server\analyzer\event-analyzer\src\main\java\org\apache\skywalking\oap\server\analyzer\event\EventAnalyzerService.java,0,2,1,1,0,4
 skywalking-master\skywalking-master\oap-server\server-telemetry\telemetry-prometheus\src\main\java\org\apache\skywalking\oap\server\telemetry\prometheus\httpserver\HttpServer.java,0,6,1,4,1,12
 skywalking-master\skywalking-master\oap-server\server-storage-plugin\storage-jdbc-hikaricp-plugin\src\main\java\org\apache\skywalking\oap\server\storage\plugin\jdbc\h2\dao\H2BatchDAO.java,80,31,5,11,0,47
 skywalking-master\skywalking-master\oap-server\server-core\src\main\java\org\apache\skywalking\oap\server\core\source\ServiceInstanceCLRThread.java,40,15,1,7,0,23
 skywalking-master\skywalking-master\oap-server\analyzer\agent-analyzer\src\main\java\org\apache\skywalking\oap\server\analyzer\provider\trace\parser\listener\EndpointDependencyBuilder.java,21,8,0,6,0,14
 skywalking-master\skywalking-master\oap-server\server-storage-plugin\storage-tidb-plugin\src\main\java\org\apache\skywalking\oap\server\storage\plugin\jdbc\tidb\TiDBHistoryDeleteDAO.java,48,21,1,9,0,31
 skywalking-master\skywalking-master\oap-server\server-receiver-plugin\skywalking-management-receiver-plugin\src\main\java\org\apache\skywalking\oap\server\receiver\register\module\RegisterModule.java,12,3,0,1,0,4
 skywalking-master\skywalking-master\oap-server\server-core\src\main\java\org\apache\skywalking\oap\server\core\analysis\manual\instance\InstanceUpdateDispatcher.java,14,2,0,3,0,5
 skywalking-master\skywalking-master\oap-server\server-library\library-elasticsearch-client\src\main\java\org\apache\skywalking\library\elasticsearch\requests\factory\Codec.java,0,5,0,2,1,8
 skywalking-master\skywalking-master\oap-server\analyzer\meter-analyzer\src\main\java\org\apache\skywalking\oap\meter\analyzer\prometheus\rule\StaticConfig.java,5,2,0,1,0,3
 skywalking-master\skywalking-master\oap-server\server-cluster-plugin\cluster-etcd-plugin\src\test\java\org\apache\skywalking\oap\server\cluster\plugin\etcd\ITClusterModuleEtcdProviderFunctionalTest.java,217,55,9,20,0,84
 skywalking-master\skywalking-master\oap-server\server-core\src\main\java\org\apache\skywalking\oap\server\core\profiling\trace\ProfileThreadSnapshotRecord.java,57,26,0,15,0,41
 skywalking-master\skywalking-master\oap-server\server-library\library-datacarrier-queue\src\main\java\org\apache\skywalking\oap\server\library\datacarrier\consumer\ConsumerCannotBeCreatedException.java,6,1,0,1,0,2
 skywalking-master\skywalking-master\oap-server\server-configuration\grpc-configuration-sync\src\test\java\org\apache\skywalking\oap\server\configuration\grpc\GRPCConfigurationTest.java,140,38,5,15,0,58
 skywalking-master\skywalking-master\oap-server\server-receiver-plugin\skywalking-zabbix-receiver-plugin\src\test\java\org\apache\skywalking\oap\server\receiver\zabbix\provider\ZabbixBaseTest.java,259,100,0,36,0,136
 skywalking-master\skywalking-master\oap-server\server-core\src\main\java\org\apache\skywalking\oap\server\core\analysis\manual\searchtag\Tag.java,19,7,1,2,0,10
 skywalking-master\skywalking-master\oap-server\server-configuration\grpc-configuration-sync\src\test\java\org\apache\skywalking\oap\server\configuration\grpc\MockGRPCConfigService.java,0,21,2,15,0,38
 skywalking-master\skywalking-master\oap-server\server-library\library-module\src\test\java\org\apache\skywalking\oap\server\library\module\ModuleBProvider.java,40,7,2,3,0,12
 skywalking-master\skywalking-master\oap-server\server-alarm-plugin\src\main\java\org\apache\skywalking\oap\server\core\alarm\provider\feishu\FeishuSettings.java,16,4,0,1,0,5
 skywalking-master\skywalking-master\oap-server\server-storage-plugin\storage-elasticsearch-plugin\src\main\java\org\apache\skywalking\oap\server\storage\plugin\elasticsearch\base\EsDAO.java,8,4,0,3,0,7
 skywalking-master\skywalking-master\oap-server\server-core\src\main\java\org\apache\skywalking\oap\server\core\query\type\TopNEntity.java,15,6,1,1,0,8
 skywalking-master\skywalking-master\oap-server\server-storage-plugin\storage-jdbc-hikaricp-plugin\src\main\java\org\apache\skywalking\oap\server\storage\plugin\jdbc\ArrayParamBuilder.java,14,4,1,1,0,6
 skywalking-master\skywalking-master\oap-server\server-library\library-client\src\main\java\org\apache\skywalking\oap\server\library\client\request\PrepareRequest.java,0,0,0,1,0,1
 skywalking-master\skywalking-master\oap-server\server-core\src\main\java\org\apache\skywalking\oap\server\core\storage\model\Model.java,34,22,0,1,0,23
 skywalking-master\skywalking-master\oap-server\analyzer\agent-analyzer\src\main\java\org\apache\skywalking\oap\server\analyzer\provider\trace\parser\listener\RPCAnalysisListener.java,0,115,1,85,0,201
 skywalking-master\skywalking-master\oap-server\server-library\library-module\src\main\java\org\apache\skywalking\oap\server\library\module\ModuleDefine.java,111,33,3,18,1,55
 skywalking-master\skywalking-master\oap-server\server-storage-plugin\storage-jdbc-hikaricp-plugin\src\main\java\org\apache\skywalking\oap\server\storage\plugin\jdbc\h2\dao\H2MetricsQueryDAO.java,194,40,1,29,0,70
 skywalking-master\skywalking-master\oap-server\server-query-plugin\query-graphql-plugin\src\main\java\org\apache\skywalking\oap\query\graphql\resolver\HealthQuery.java,19,5,0,4,0,9
 skywalking-master\skywalking-master\oap-server\server-core\src\test\java\org\apache\skywalking\oap\server\core\analysis\manual\searchtag\TagTest.java,13,2,0,1,0,3
 skywalking-master\skywalking-master\oap-server\server-receiver-plugin\configuration-discovery-receiver-plugin\src\main\java\org\apache\skywalking\oap\server\recevier\configuration\discovery\ConfigurationDiscoveryProvider.java,62,22,1,18,0,41
 skywalking-master\skywalking-master\test\e2e-v2\java-test-service\e2e-service-provider\src\main\java\org\apache\skywalking\e2e\controller\LogController.java,16,11,4,7,0,22
 skywalking-master\skywalking-master\oap-server\analyzer\log-analyzer\src\main\java\org\apache\skywalking\oap\log\analyzer\provider\log\ILogAnalyzerService.java,0,2,0,1,0,3
 skywalking-master\skywalking-master\oap-server\server-core\src\main\java\org\apache\skywalking\oap\server\core\analysis\metrics\MetricsMetaInfo.java,40,28,0,3,0,31
 skywalking-master\skywalking-master\oap-server\server-storage-plugin\storage-iotdb-plugin\src\main\java\org\apache\skywalking\oap\server\storage\plugin\iotdb\base\IoTDBInsertRequest.java,0,21,0,6,0,27
 skywalking-master\skywalking-master\oap-server\oal-rt\src\main\java\org\apache\skywalking\oal\rt\parser\FromStmt.java,19,4,0,1,0,5
 skywalking-master\skywalking-master\oap-server\server-library\library-datacarrier-queue\src\test\java\org\apache\skywalking\oap\server\library\datacarrier\SampleData.java,24,14,0,1,0,15
 skywalking-master\skywalking-master\oap-server\server-configuration\configuration-zookeeper\src\test\java\org\apache\skywalking\oap\server\configuration\zookeeper\it\MockZookeeperConfigurationModule.java,13,3,0,1,0,4
 skywalking-master\skywalking-master\oap-server\server-core\src\main\java\org\apache\skywalking\oap\server\core\storage\model\ModelCreator.java,0,8,0,2,0,10
 skywalking-master\skywalking-master\oap-server\server-receiver-plugin\skywalking-jvm-receiver-plugin\src\main\java\org\apache\skywalking\oap\server\receiver\jvm\provider\handler\JVMMetricReportServiceHandler.java,0,15,0,9,0,24
 skywalking-master\skywalking-master\oap-server\server-library\library-datacarrier-queue\src\test\java\org\apache\skywalking\oap\server\library\datacarrier\consumer\ConsumerPoolFactoryTest.java,22,10,1,6,0,17
 skywalking-master\skywalking-master\oap-server\server-core\src\main\java\org\apache\skywalking\oap\server\core\query\type\EBPFProfilingTask.java,19,15,0,3,0,18
 skywalking-master\skywalking-master\oap-server\server-core\src\main\java\org\apache\skywalking\oap\server\core\query\type\Alarms.java,11,3,0,1,0,4
 skywalking-master\skywalking-master\oap-server\server-core\src\main\java\org\apache\skywalking\oap\server\core\analysis\Disable.java,0,1,0,1,0,2
 skywalking-master\skywalking-master\oap-server\server-core\src\main\java\org\apache\skywalking\oap\server\core\analysis\metrics\annotation\Entrance.java,0,0,0,1,0,1
 skywalking-master\skywalking-master\oap-server\server-receiver-plugin\skywalking-trace-receiver-plugin\src\main\java\org\apache\skywalking\oap\server\receiver\trace\provider\handler\v8\grpc\TraceSegmentReportServiceHandler.java,0,18,3,11,0,32
 skywalking-master\skywalking-master\oap-server\server-core\src\main\java\org\apache\skywalking\oap\server\core\analysis\metrics\IntValueHolder.java,0,1,0,1,0,2
 skywalking-master\skywalking-master\oap-server\server-cluster-plugin\cluster-kubernetes-plugin\src\main\java\org\apache\skywalking\oap\server\cluster\plugin\kubernetes\ClusterModuleKubernetesConfig.java,6,5,0,1,0,6
 skywalking-master\skywalking-master\oap-server\server-core\src\main\java\org\apache\skywalking\oap\server\core\query\type\MetricsValues.java,5,2,0,1,0,3
 skywalking-master\skywalking-master\oap-server\server-core\src\main\java\org\apache\skywalking\oap\server\core\version\Version.java,0,8,0,2,0,10
 skywalking-master\skywalking-master\oap-server\server-core\src\main\java\org\apache\skywalking\oap\server\core\query\EventQueryService.java,37,18,1,10,0,29
 skywalking-master\skywalking-master\oap-server\server-receiver-plugin\skywalking-trace-receiver-plugin\src\main\java\org\apache\skywalking\oap\server\receiver\trace\provider\handler\v8\rest\TraceSegmentReportHandler.java,46,12,0,5,0,17
 skywalking-master\skywalking-master\oap-server\server-core\src\main\java\org\apache\skywalking\oap\server\core\server\HTTPHandlerRegister.java,0,1,0,1,0,2
 skywalking-master\skywalking-master\oap-server\server-core\src\main\java\org\apache\skywalking\oap\server\core\analysis\manual\networkalias\NetworkAddressAliasSetupDispatcher.java,13,5,0,6,0,11
 skywalking-master\skywalking-master\oap-server\server-storage-plugin\storage-jdbc-hikaricp-plugin\src\main\java\org\apache\skywalking\oap\server\storage\plugin\jdbc\mysql\MySQLAggregationQueryDAO.java,7,3,0,3,0,6
 skywalking-master\skywalking-master\oap-server\analyzer\meter-analyzer\src\main\java\org\apache\skywalking\oap\meter\analyzer\dsl\HistogramType.java,0,1,0,1,0,2
 skywalking-master\skywalking-master\oap-server\server-core\src\main\java\org\apache\skywalking\oap\server\core\storage\annotation\Query.java,0,2,0,1,0,3
 skywalking-master\skywalking-master\oap-server\analyzer\agent-analyzer\src\main\java\org\apache\skywalking\oap\server\analyzer\provider\trace\parser\listener\SegmentListener.java,0,2,0,3,0,5
 skywalking-master\skywalking-master\oap-server\server-core\src\main\java\org\apache\skywalking\oap\server\core\analysis\meter\Meter.java,27,12,0,7,0,19
 skywalking-master\skywalking-master\oap-server\server-fetcher-plugin\prometheus-fetcher-plugin\src\main\java\org\apache\skywalking\oap\server\fetcher\prometheus\http\HTTPClientInitializer.java,28,11,0,3,0,14
 skywalking-master\skywalking-master\oap-server\analyzer\event-analyzer\src\main\java\org\apache\skywalking\oap\server\analyzer\event\EventOALDefine.java,11,2,1,1,0,4
 skywalking-master\skywalking-master\oap-server\server-receiver-plugin\envoy-metrics-receiver-plugin\src\main\java\org\apache\skywalking\oap\server\receiver\envoy\als\mx\MetaExchangeALSHTTPAnalyzer.java,103,29,4,18,0,51
 skywalking-master\skywalking-master\oap-server\server-cluster-plugin\cluster-kubernetes-plugin\src\main\java\org\apache\skywalking\oap\server\cluster\plugin\kubernetes\KubernetesCoordinator.java,0,17,6,10,0,33
 skywalking-master\skywalking-master\oap-server\server-core\src\main\java\org\apache\skywalking\oap\server\core\analysis\metrics\Metrics.java,0,30,1,11,0,42
 skywalking-master\skywalking-master\oap-server\server-core\src\main\java\org\apache\skywalking\oap\server\core\source\DatabaseSlowStatement.java,29,8,1,4,0,13
 skywalking-master\skywalking-master\oap-server\server-receiver-plugin\skywalking-zabbix-receiver-plugin\src\main\java\org\apache\skywalking\oap\server\receiver\zabbix\module\ZabbixReceiverModule.java,13,4,0,1,0,5
 skywalking-master\skywalking-master\oap-server\server-storage-plugin\storage-elasticsearch-plugin\src\main\java\org\apache\skywalking\oap\server\storage\plugin\elasticsearch\base\TimeSeriesUtils.java,124,68,1,29,0,98
 skywalking-master\skywalking-master\oap-server\server-core\src\main\java\org\apache\skywalking\oap\server\core\source\Segment.java,44,12,1,2,0,15
 skywalking-master\skywalking-master\oap-server\server-library\library-elasticsearch-client\src\main\java\org\apache\skywalking\library\elasticsearch\requests\search\Sorts.java,0,5,0,2,0,7
 skywalking-master\skywalking-master\oap-server\server-core\src\main\java\org\apache\skywalking\oap\server\core\query\type\SelectedRecord.java,19,3,0,3,0,6
 skywalking-master\skywalking-master\oap-server\server-core\src\main\java\org\apache\skywalking\oap\server\core\analysis\metrics\HistogramMetrics.java,54,16,1,11,0,28
 skywalking-master\skywalking-master\oap-server\microbench\src\main\java\org\apache\skywalking\oap\server\microbench\core\config\group\openapi\EndpointGrouping4OpenapiBenchmark.java,0,72,0,42,0,114
 skywalking-master\skywalking-master\oap-server\server-fetcher-plugin\kafka-fetcher-plugin\src\main\java\org\apache\skywalking\oap\server\analyzer\agent\kafka\provider\KafkaFetcherProvider.java,62,14,1,15,0,30
 skywalking-master\skywalking-master\oap-server\server-storage-plugin\storage-jdbc-hikaricp-plugin\src\main\java\org\apache\skywalking\oap\server\storage\plugin\jdbc\postgresql\dao\PostgreSQLLogQueryDAO.java,14,11,0,4,0,15
 skywalking-master\skywalking-master\oap-server\server-core\src\main\java\org\apache\skywalking\oap\server\core\cluster\ServiceQueryException.java,7,3,0,1,0,4
 skywalking-master\skywalking-master\oap-server\server-storage-plugin\storage-iotdb-plugin\src\main\java\org\apache\skywalking\oap\server\storage\plugin\iotdb\base\IoTDBRecordDAO.java,45,7,0,5,0,12
 skywalking-master\skywalking-master\oap-server\analyzer\log-analyzer\src\main\java\org\apache\skywalking\oap\log\analyzer\provider\log\listener\TrafficAnalysisListener.java,78,21,1,9,0,31
 skywalking-master\skywalking-master\oap-server\server-storage-plugin\storage-iotdb-plugin\src\main\java\org\apache\skywalking\oap\server\storage\plugin\iotdb\cache\IoTDBNetworkAddressAliasDAO.java,26,12,1,10,0,23
 skywalking-master\skywalking-master\oap-server\server-fetcher-plugin\kafka-fetcher-plugin\src\main\java\org\apache\skywalking\oap\server\analyzer\agent\kafka\provider\handler\AbstractKafkaHandler.java,30,11,1,4,0,16
 skywalking-master\skywalking-master\oap-server\server-receiver-plugin\skywalking-browser-receiver-plugin\src\main\java\org\apache\skywalking\oap\server\receiver\browser\provider\parser\performance\BrowserPerfDataDecorator.java,92,51,0,9,0,60
 skywalking-master\skywalking-master\oap-server\server-core\src\main\java\org\apache\skywalking\oap\server\core\storage\ttl\DataTTLKeeperTimer.java,0,24,4,14,0,42
 skywalking-master\skywalking-master\oap-server\server-receiver-plugin\skywalking-meter-receiver-plugin\src\main\java\org\apache\skywalking\oap\server\receiver\meter\module\MeterReceiverModule.java,14,4,0,1,0,5
 skywalking-master\skywalking-master\oap-server\server-storage-plugin\storage-elasticsearch-plugin\src\main\java\org\apache\skywalking\oap\server\storage\plugin\elasticsearch\query\AggregationQueryEsDAO.java,85,16,0,21,0,37
 skywalking-master\skywalking-master\oap-server\server-core\src\main\java\org\apache\skywalking\oap\server\core\browser\manual\errorlog\BrowserErrorLogRecord.java,79,29,0,12,0,41
 skywalking-master\skywalking-master\oap-server\server-storage-plugin\storage-iotdb-plugin\src\main\java\org\apache\skywalking\oap\server\storage\plugin\iotdb\query\IoTDBAlarmQueryDAO.java,71,24,0,12,0,36
 skywalking-master\skywalking-master\oap-server\server-library\library-client\src\main\java\org\apache\skywalking\oap\server\library\client\jdbc\JDBCClientException.java,0,6,0,1,0,7
 skywalking-master\skywalking-master\oap-server\analyzer\meter-analyzer\src\main\java\org\apache\skywalking\oap\meter\analyzer\MetricRuleConfig.java,0,11,0,1,0,12
 skywalking-master\skywalking-master\oap-server\analyzer\agent-analyzer\src\main\java\org\apache\skywalking\oap\server\analyzer\provider\AnalyzerModuleProvider.java,104,32,1,35,0,68
 skywalking-master\skywalking-master\oap-server\server-receiver-plugin\skywalking-trace-receiver-plugin\src\test\java\org\apache\skywalking\oap\server\receiver\trace\mock\OfficialComponent.java,20,9,0,1,0,10
 skywalking-master\skywalking-master\oap-server\server-fetcher-plugin\kafka-fetcher-plugin\src\main\java\org\apache\skywalking\oap\server\analyzer\agent\kafka\provider\handler\MeterServiceHandler.java,57,14,1,9,0,24
 skywalking-master\skywalking-master\oap-server\server-library\library-util\src\test\java\org\apache\skywalking\oap\server\library\util\TimestampUtils.java,11,6,2,2,0,10
 skywalking-master\skywalking-master\test\e2e-v2\java-test-service\e2e-mock-sender\src\main\java\org\apache\skywalking\e2e\controller\HealthController.java,9,2,1,1,0,4
 skywalking-master\skywalking-master\oap-server\server-query-plugin\query-graphql-plugin\src\main\java\org\apache\skywalking\oap\query\graphql\resolver\EBPFProcessProfilingQuery.java,35,25,1,11,0,37
 skywalking-master\skywalking-master\oap-server\analyzer\meter-analyzer\src\main\java\org\apache\skywalking\oap\meter\analyzer\dsl\ExpressionParsingContext.java,63,25,0,5,0,30
 skywalking-master\skywalking-master\oap-server\server-configuration\configuration-api\src\main\java\org\apache\skywalking\oap\server\configuration\api\ConfigurationModule.java,13,5,0,3,0,8
 skywalking-master\skywalking-master\oap-server\server-core\src\main\java\org\apache\skywalking\oap\server\core\query\type\AlarmTrend.java,9,2,0,1,0,3
 skywalking-master\skywalking-master\oap-server\server-storage-plugin\storage-influxdb-plugin\src\main\java\org\apache\skywalking\oap\server\storage\plugin\influxdb\query\NetworkAddressAliasDAO.java,47,13,1,11,0,25
 skywalking-master\skywalking-master\oap-server\analyzer\meter-analyzer\src\test\java\org\apache\skywalking\oap\meter\analyzer\dsl\FilterTest.java,70,18,2,6,0,26
 skywalking-master\skywalking-master\oap-server\server-core\src\main\java\org\apache\skywalking\oap\server\core\query\LogQueryService.java,69,25,0,8,0,33
 skywalking-master\skywalking-master\oap-server\oal-rt\src\main\java\org\apache\skywalking\oal\rt\parser\Expression.java,15,11,0,1,0,12
 skywalking-master\skywalking-master\oap-server\server-core\src\main\java\org\apache\skywalking\oap\server\core\query\input\EBPFProfilingTaskFixedTimeCreationRequest.java,13,6,0,3,0,9
 skywalking-master\skywalking-master\oap-server\server-core\src\main\java\org\apache\skywalking\oap\server\core\query\type\KVInt.java,5,2,0,1,0,3
 skywalking-master\skywalking-master\oap-server\oal-rt\src\main\java\org\apache\skywalking\oal\rt\parser\OALScripts.java,10,3,0,1,0,4
 skywalking-master\skywalking-master\oap-server\server-receiver-plugin\skywalking-browser-receiver-plugin\src\main\java\org\apache\skywalking\oap\server\receiver\browser\provider\parser\performance\listener\PerfDataAnalysisListener.java,0,3,0,5,0,8
 skywalking-master\skywalking-master\oap-server\server-library\library-client\src\main\java\org\apache\skywalking\oap\server\library\client\grpc\GRPCClient.java,52,25,2,4,0,31
 skywalking-master\skywalking-master\apm-protocol\apm-network\src\main\java\org\apache\skywalking\oap\server\network\trace\component\command\Deserializable.java,0,1,0,1,0,2
 skywalking-master\skywalking-master\oap-server\server-alarm-plugin\src\main\java\org\apache\skywalking\oap\server\core\alarm\provider\expression\ExpressionContext.java,30,12,0,2,0,14
 skywalking-master\skywalking-master\oap-server\server-alarm-plugin\src\test\java\org\apache\skywalking\oap\server\core\alarm\provider\CompositeRuleEvaluatorTest.java,0,30,3,24,0,57
 skywalking-master\skywalking-master\oap-server\server-query-plugin\query-graphql-plugin\src\main\java\org\apache\skywalking\oap\query\graphql\GraphQLQueryProvider.java,87,20,1,15,0,36
 skywalking-master\skywalking-master\oap-server\server-alarm-plugin\src\test\java\org\apache\skywalking\oap\server\core\alarm\provider\AlarmModuleProviderTest.java,47,8,0,2,0,10
 skywalking-master\skywalking-master\oap-server\server-core\src\test\java\org\apache\skywalking\oap\server\core\analysis\meter\function\avg\AvgHistogramPercentileFunctionTest.java,225,51,2,14,0,67
 skywalking-master\skywalking-master\oap-server\analyzer\meter-analyzer\src\main\java\org\apache\skywalking\oap\meter\analyzer\prometheus\PrometheusMetricConverter.java,117,33,0,20,0,53
 skywalking-master\skywalking-master\oap-server\server-library\library-elasticsearch-client\src\main\java\org\apache\skywalking\library\elasticsearch\requests\search\aggregation\TermsAggregationBuilder.java,0,21,0,2,0,23
 skywalking-master\skywalking-master\oap-server\server-storage-plugin\storage-elasticsearch-plugin\src\test\java\org\apache\skywalking\oap\server\storage\plugin\elasticsearch\base\TimeSeriesUtilsTestCase.java,26,24,0,9,0,33
 skywalking-master\skywalking-master\oap-server\server-library\library-util\src\main\java\org\apache\skywalking\oap\server\library\util\prometheus\metrics\Histogram.java,30,20,0,4,8,32
 skywalking-master\skywalking-master\oap-server\server-cluster-plugin\cluster-etcd-plugin\src\main\java\org\apache\skywalking\oap\server\cluster\plugin\etcd\ClusterModuleEtcdProvider.java,49,12,2,7,0,21
 skywalking-master\skywalking-master\oap-server\server-core\src\main\java\org\apache\skywalking\oap\server\core\analysis\metrics\expression\LikeMatch.java,18,7,2,4,0,13
 skywalking-master\skywalking-master\oap-server\server-fetcher-plugin\kafka-fetcher-plugin\src\main\java\org\apache\skywalking\oap\server\analyzer\agent\kafka\provider\handler\LogHandler.java,60,13,1,5,0,19
 skywalking-master\skywalking-master\oap-server\analyzer\log-analyzer\src\main\java\org\apache\skywalking\oap\log\analyzer\dsl\spec\sink\sampler\RateLimitingSampler.java,74,13,3,2,0,18
 skywalking-master\skywalking-master\oap-server\server-receiver-plugin\skywalking-meter-receiver-plugin\src\test\java\org\apache\skywalking\oap\server\receiver\meter\module\MeterReceiverModuleTest.java,10,2,0,1,0,3
 skywalking-master\skywalking-master\oap-server\analyzer\meter-analyzer\src\test\java\org\apache\skywalking\oap\meter\analyzer\dsl\ExpressionParsingTest.java,91,30,1,14,0,45
 skywalking-master\skywalking-master\oap-server\server-library\library-util\src\main\java\org\apache\skywalking\oap\server\library\util\ProtoBufJsonUtils.java,32,10,1,6,0,17
 skywalking-master\skywalking-master\oap-server\server-library\library-elasticsearch-client\src\main\java\org\apache\skywalking\library\elasticsearch\requests\factory\v7\codec\V7UpdateRequestSerializer.java,0,4,0,2,0,6
 skywalking-master\skywalking-master\oap-server\server-library\library-datacarrier-queue\src\main\java\org\apache\skywalking\oap\server\library\datacarrier\partition\SimpleRollingPartitioner.java,15,7,1,1,0,9
 skywalking-master\skywalking-master\oap-server\server-core\src\main\java\org\apache\skywalking\oap\server\core\source\ServiceInstanceJVMGC.java,37,13,1,7,0,21
 skywalking-master\skywalking-master\oap-server\server-core\src\main\java\org\apache\skywalking\oap\server\core\config\IComponentLibraryCatalogService.java,0,4,0,1,0,5
 skywalking-master\skywalking-master\oap-server\server-receiver-plugin\skywalking-log-recevier-plugin\src\main\java\org\apache\skywalking\oap\server\recevier\log\provider\handler\grpc\LogReportServiceGrpcHandler.java,0,15,2,8,0,25
 skywalking-master\skywalking-master\oap-server\server-core\src\main\java\org\apache\skywalking\oap\server\core\analysis\manual\process\ProcessDetectType.java,0,15,0,3,0,18
 skywalking-master\skywalking-master\oap-server\analyzer\meter-analyzer\src\test\java\org\apache\skywalking\oap\meter\analyzer\dsl\BasicTest.java,57,19,1,3,0,23
 skywalking-master\skywalking-master\oap-server\analyzer\agent-analyzer\src\main\java\org\apache\skywalking\oap\server\analyzer\provider\AnalyzerModuleConfig.java,108,23,2,15,0,40
 skywalking-master\skywalking-master\oap-server\server-storage-plugin\storage-jdbc-hikaricp-plugin\src\main\java\org\apache\skywalking\oap\server\storage\plugin\jdbc\h2\dao\H2SegmentRecordBuilder.java,22,7,0,6,0,13
 skywalking-master\skywalking-master\oap-server\server-storage-plugin\storage-zipkin-elasticsearch-plugin\src\main\java\org\apache\skywalking\oap\server\storage\plugin\zipkin\ZipkinSpanRecord.java,115,37,0,9,0,46
 skywalking-master\skywalking-master\oap-server\server-core\src\main\java\org\apache\skywalking\oap\server\core\query\enumeration\Order.java,0,2,0,1,0,3
 skywalking-master\skywalking-master\oap-server\server-query-plugin\query-graphql-plugin\src\main\java\org\apache\skywalking\oap\query\graphql\type\Metrics.java,10,4,0,1,0,5
 skywalking-master\skywalking-master\oap-server\server-core\src\main\java\org\apache\skywalking\oap\server\core\query\MetricsMetadataQueryService.java,41,14,1,9,0,24
 skywalking-master\skywalking-master\oap-server\server-library\library-module\src\test\java\org\apache\skywalking\oap\server\library\module\ModuleBBusiness1Impl.java,0,0,0,1,0,1
 skywalking-master\skywalking-master\oap-server\server-core\src\main\java\org\apache\skywalking\oap\server\core\remote\client\Address.java,41,20,4,1,0,25
 skywalking-master\skywalking-master\oap-server\server-core\src\main\java\org\apache\skywalking\oap\server\core\storage\type\StorageDataComplexObject.java,0,4,0,2,0,6
 skywalking-master\skywalking-master\oap-server\server-library\library-elasticsearch-client\src\main\java\org\apache\skywalking\library\elasticsearch\requests\factory\v7\codec\V7MappingsDeserializer.java,0,3,1,4,1,9
 skywalking-master\skywalking-master\oap-server\server-query-plugin\query-graphql-plugin\src\main\java\org\apache\skywalking\oap\query\graphql\resolver\LogQuery.java,57,15,0,6,0,21
 skywalking-master\skywalking-master\oap-server\server-library\library-datacarrier-queue\src\main\java\org\apache\skywalking\oap\server\library\datacarrier\consumer\IDriver.java,0,3,0,1,0,4
 skywalking-master\skywalking-master\oap-server\server-core\src\main\java\org\apache\skywalking\oap\server\core\analysis\meter\MeterEntity.java,104,54,1,13,0,68
 skywalking-master\skywalking-master\oap-server\server-core\src\main\java\org\apache\skywalking\oap\server\core\analysis\DispatcherDetectorListener.java,0,2,0,2,0,4
 skywalking-master\skywalking-master\oap-server\server-core\src\main\java\org\apache\skywalking\oap\server\core\analysis\metrics\expression\BooleanMatch.java,10,9,1,2,0,12
 skywalking-master\skywalking-master\oap-server\server-storage-plugin\storage-jdbc-hikaricp-plugin\src\main\java\org\apache\skywalking\oap\server\storage\plugin\jdbc\h2\dao\H2TopologyQueryDAO.java,238,125,1,66,0,192
 skywalking-master\skywalking-master\oap-server\server-alarm-plugin\src\main\java\org\apache\skywalking\oap\server\core\alarm\provider\RunningRule.java,433,113,7,50,0,170
 skywalking-master\skywalking-master\oap-server\server-storage-plugin\storage-influxdb-plugin\src\main\java\org\apache\skywalking\oap\server\storage\plugin\influxdb\query\LogQuery.java,118,22,0,28,0,50
 skywalking-master\skywalking-master\oap-server\server-core\src\main\java\org\apache\skywalking\oap\server\core\analysis\metrics\PercentileMetrics.java,92,25,0,11,0,36
 skywalking-master\skywalking-master\oap-server\server-receiver-plugin\envoy-metrics-receiver-plugin\src\main\java\org\apache\skywalking\oap\server\receiver\envoy\als\ServiceMetaInfo.java,25,10,0,1,0,11
 skywalking-master\skywalking-master\oap-server\server-core\src\test\java\org\apache\skywalking\oap\server\core\analysis\manual\relation\instance\ServiceInstanceRelationTest.java,62,29,0,17,0,46
 skywalking-master\skywalking-master\oap-server\server-library\library-datacarrier-queue\src\main\java\org\apache\skywalking\oap\server\library\datacarrier\DataCarrier.java,134,77,0,26,0,103
 skywalking-master\skywalking-master\oap-server\server-core\src\main\java\org\apache\skywalking\oap\server\core\profiling\ebpf\storage\EBPFProfilingTaskRecord.java,85,48,0,22,0,70
 skywalking-master\skywalking-master\oap-server\server-receiver-plugin\otel-receiver-plugin\src\main\java\org\apache\skywalking\oap\server\receiver\otel\oc\OCMetricHandler.java,0,47,1,31,0,79
 skywalking-master\skywalking-master\oap-server\server-core\src\main\java\org\apache\skywalking\oap\server\core\browser\manual\errorlog\BrowserErrorLogRecordDispatcher.java,16,2,0,3,0,5
 skywalking-master\skywalking-master\oap-server\server-core\src\main\java\org\apache\skywalking\oap\server\core\source\Source.java,7,1,1,1,0,3
 skywalking-master\skywalking-master\oap-server\server-core\src\main\java\org\apache\skywalking\oap\server\core\logging\LoggingConfigWatcher.java,56,10,2,4,0,16
 skywalking-master\skywalking-master\oap-server\server-core\src\main\java\org\apache\skywalking\oap\server\core\query\input\MetricsCondition.java,11,2,0,1,0,3
 skywalking-master\skywalking-master\oap-server\server-receiver-plugin\skywalking-mesh-receiver-plugin\src\main\java\org\apache\skywalking\aop\server\receiver\mesh\TelemetryDataDispatcher.java,223,71,2,41,0,114
 skywalking-master\skywalking-master\oap-server\server-alarm-plugin\src\test\java\org\apache\skywalking\oap\server\core\alarm\provider\WebhookCallbackTest.java,47,10,0,7,0,17
 skywalking-master\skywalking-master\oap-server\server-core\src\main\java\org\apache\skywalking\oap\server\core\query\type\Topology.java,10,3,0,1,0,4
 skywalking-master\skywalking-master\oap-server\server-storage-plugin\storage-elasticsearch-plugin\src\main\java\org\apache\skywalking\oap\server\storage\plugin\elasticsearch\base\StorageEsInstaller.java,231,75,3,53,0,131
 skywalking-master\skywalking-master\test\e2e-v2\java-test-service\e2e-service-consumer\src\main\java\org\apache\skywalking\e2e\User.java,5,2,0,1,0,3
 skywalking-master\skywalking-master\oap-server\server-library\library-util\src\main\java\org\apache\skywalking\oap\server\library\util\prometheus\metrics\Metric.java,17,12,0,1,1,14
 skywalking-master\skywalking-master\oap-server\server-library\library-module\src\test\java\org\apache\skywalking\oap\server\library\module\ModuleManagerTest.java,61,22,0,15,1,38
 skywalking-master\skywalking-master\oap-server\server-storage-plugin\storage-jdbc-hikaricp-plugin\src\main\java\org\apache\skywalking\oap\server\storage\plugin\jdbc\h2\dao\H2LogQueryDAO.java,153,41,2,28,0,71
 skywalking-master\skywalking-master\oap-server\server-core\src\main\java\org\apache\skywalking\oap\server\core\storage\PersistenceTimer.java,0,24,6,16,0,46
 skywalking-master\skywalking-master\oap-server\server-library\library-elasticsearch-client\src\main\java\org\apache\skywalking\library\elasticsearch\requests\factory\RequestFactory.java,0,12,0,7,0,19
 skywalking-master\skywalking-master\oap-server\server-core\src\main\java\org\apache\skywalking\oap\server\core\source\DatabaseAccess.java,27,9,1,6,0,16
 skywalking-master\skywalking-master\oap-server\server-cluster-plugin\cluster-standalone-plugin\src\main\java\org\apache\skywalking\oap\server\cluster\plugin\standalone\StandaloneManager.java,0,6,1,2,0,9
 skywalking-master\skywalking-master\oap-server\server-core\src\main\java\org\apache\skywalking\oap\server\core\profiling\trace\ProfileTaskLogRecord.java,45,22,0,11,0,33
 skywalking-master\skywalking-master\oap-server\server-telemetry\telemetry-api\src\main\java\org\apache\skywalking\oap\server\telemetry\api\MetricsCollector.java,0,0,0,1,0,1
 skywalking-master\skywalking-master\oap-server\server-core\src\main\java\org\apache\skywalking\oap\server\core\profiling\ebpf\storage\EBPFProfilingTargetType.java,0,15,0,4,0,19
 skywalking-master\skywalking-master\oap-server\server-health-checker\src\main\java\org\apache\skywalking\oap\server\health\checker\provider\HealthCheckerConfig.java,4,3,0,1,0,4
 skywalking-master\skywalking-master\oap-server\server-library\library-server\src\main\java\org\apache\skywalking\oap\server\library\server\grpc\ssl\DynamicSslContext.java,51,16,0,7,0,23
 skywalking-master\skywalking-master\oap-server\server-storage-plugin\storage-elasticsearch-plugin\src\main\java\org\apache\skywalking\oap\server\storage\plugin\elasticsearch\base\TimeRangeIndexNameGenerator.java,20,10,0,2,0,12
 skywalking-master\skywalking-master\oap-server\server-configuration\configuration-zookeeper\src\test\java\org\apache\skywalking\oap\server\configuration\zookeeper\ut\MockZookeeperConfigWatcherRegister.java,25,11,0,4,0,15
 skywalking-master\skywalking-master\oap-server\server-storage-plugin\storage-iotdb-plugin\src\main\java\org\apache\skywalking\oap\server\storage\plugin\iotdb\IoTDBStorageConfig.java,11,7,0,1,0,8
 skywalking-master\skywalking-master\oap-server\server-core\src\main\java\org\apache\skywalking\oap\server\core\query\type\EndpointTopology.java,10,3,0,1,0,4
 skywalking-master\skywalking-master\oap-server\server-configuration\configuration-k8s-configmap\src\main\java\org\apache\skywalking\oap\server\configuration\configmap\ConfigurationConfigmapInformer.java,66,17,0,10,0,27
 skywalking-master\skywalking-master\oap-server\server-fetcher-plugin\kafka-fetcher-plugin\src\test\java\org\apache\skywalking\oap\server\analyzer\agent\kafka\provider\KafkaFetcherProviderTest.java,25,7,1,3,0,11
 skywalking-master\skywalking-master\oap-server\analyzer\agent-analyzer\src\main\java\org\apache\skywalking\oap\server\analyzer\module\AnalyzerModule.java,16,4,0,3,0,7
 skywalking-master\skywalking-master\oap-server\server-core\src\main\java\org\apache\skywalking\oap\server\core\CoreModule.java,90,12,0,7,0,19
 skywalking-master\skywalking-master\oap-server\server-fetcher-plugin\kafka-fetcher-plugin\src\main\java\org\apache\skywalking\oap\server\analyzer\agent\kafka\provider\handler\ProfileTaskHandler.java,56,12,0,9,0,21
 skywalking-master\skywalking-master\test\e2e-v2\java-test-service\e2e-service-provider\src\main\java\org\apache\skywalking\e2e\Service0Application.java,12,3,0,1,0,4
 skywalking-master\skywalking-master\oap-server\server-library\library-elasticsearch-client\src\main\java\org\apache\skywalking\library\elasticsearch\requests\IndexRequest.java,0,5,0,1,2,8
 skywalking-master\skywalking-master\oap-server\server-configuration\configuration-nacos\src\test\java\org\apache\skywalking\oap\server\configuration\nacos\ITNacosConfigurationTest.java,125,40,1,23,0,64
 skywalking-master\skywalking-master\oap-server\server-fetcher-plugin\kafka-fetcher-plugin\src\test\java\org\apache\skywalking\oap\server\analyzer\agent\kafka\provider\handler\JVMMetricsHandlerTest.java,71,31,1,19,0,51
 skywalking-master\skywalking-master\oap-server\server-core\src\main\java\org\apache\skywalking\oap\server\core\management\ui\template\UITemplate.java,44,16,0,6,0,22
 skywalking-master\skywalking-master\oap-server\server-receiver-plugin\zipkin-receiver-plugin\src\main\java\org\apache\skywalking\oap\server\receiver\zipkin\trace\SpanForward.java,74,17,0,7,0,24
 skywalking-master\skywalking-master\oap-server\server-storage-plugin\storage-jdbc-hikaricp-plugin\src\main\java\org\apache\skywalking\oap\server\storage\plugin\jdbc\postgresql\dao\PostgreSQLTraceQueryDAO.java,14,12,0,5,0,17
 skywalking-master\skywalking-master\oap-server\server-library\library-elasticsearch-client\src\main\java\org\apache\skywalking\library\elasticsearch\requests\search\aggregation\Aggregation.java,28,12,0,1,0,13
 skywalking-master\skywalking-master\oap-server\server-receiver-plugin\skywalking-trace-receiver-plugin\src\main\java\org\apache\skywalking\oap\server\receiver\trace\module\TraceModule.java,13,4,0,1,0,5
 skywalking-master\skywalking-master\oap-server\server-core\src\main\java\org\apache\skywalking\oap\server\core\source\Process.java,52,16,1,5,0,22
 skywalking-master\skywalking-master\oap-server\server-core\src\main\java\org\apache\skywalking\oap\server\core\query\type\ProfileStackElement.java,20,6,0,1,0,7
 skywalking-master\skywalking-master\oap-server\server-configuration\configuration-consul\src\main\java\org\apache\skywalking\oap\server\configuration\consul\ConsulConfigurationWatcherRegister.java,114,25,0,13,0,38
 skywalking-master\skywalking-master\oap-server\server-alarm-plugin\src\test\java\org\apache\skywalking\oap\server\core\alarm\provider\wechat\WechatHookCallbackTest.java,52,15,1,10,0,26
 skywalking-master\skywalking-master\oap-server\server-core\src\main\java\org\apache\skywalking\oap\server\core\storage\profiling\ebpf\IEBPFProfilingTaskDAO.java,0,7,0,5,0,12
 skywalking-master\skywalking-master\oap-server\server-health-checker\src\main\java\org\apache\skywalking\oap\server\health\checker\module\HealthCheckerModule.java,13,5,0,3,0,8
 skywalking-master\skywalking-master\oap-server\server-receiver-plugin\skywalking-ebpf-receiver-plugin\src\main\java\org\apache\skywalking\oap\server\receiver\ebpf\provider\handler\EBPFProfilingServiceHandler.java,0,45,1,35,0,81
 skywalking-master\skywalking-master\oap-server\server-receiver-plugin\envoy-metrics-receiver-plugin\src\test\java\org\apache\skywalking\oap\server\receiver\envoy\als\mx\FieldsHelperTest.java,68,20,1,11,0,32
 skywalking-master\skywalking-master\oap-server\server-core\src\main\java\org\apache\skywalking\oap\server\core\analysis\meter\function\BucketedValues.java,51,14,0,10,0,24
 skywalking-master\skywalking-master\oap-server\server-receiver-plugin\skywalking-management-receiver-plugin\src\main\java\org\apache\skywalking\oap\server\receiver\register\provider\handler\v8\rest\ManagementServiceHTTPHandler.java,18,8,0,3,0,11
 skywalking-master\skywalking-master\oap-server\server-core\src\main\java\org\apache\skywalking\oap\server\core\analysis\metrics\PercentMetrics.java,54,15,0,5,0,20
 skywalking-master\skywalking-master\oap-server\server-configuration\grpc-configuration-sync\src\main\java\org\apache\skywalking\oap\server\configuration\grpc\GRPCConfigWatcherRegister.java,78,21,0,16,0,37
 skywalking-master\skywalking-master\oap-server\server-core\src\main\java\org\apache\skywalking\oap\server\core\analysis\metrics\P75Metrics.java,6,3,0,2,0,5
 skywalking-master\skywalking-master\oap-server\server-alarm-plugin\src\test\java\org\apache\skywalking\oap\server\core\alarm\provider\ThresholdTest.java,36,10,0,1,0,11
 skywalking-master\skywalking-master\oap-server\server-core\src\main\java\org\apache\skywalking\oap\server\core\query\type\ProfileAnalyzeTimeRange.java,7,2,0,1,0,3
 skywalking-master\skywalking-master\oap-server\server-core\src\main\java\org\apache\skywalking\oap\server\core\storage\profiling\trace\IProfileTaskQueryDAO.java,0,13,2,2,0,17
 skywalking-master\skywalking-master\oap-server\server-telemetry\telemetry-api\src\main\java\org\apache\skywalking\oap\server\telemetry\none\MetricsCreatorNoop.java,64,24,8,4,3,39
 skywalking-master\skywalking-master\oap-server\server-core\src\main\java\org\apache\skywalking\oap\server\core\storage\query\IEventQueryDAO.java,0,6,2,3,0,11
 skywalking-master\skywalking-master\oap-server\server-configuration\configuration-consul\src\test\java\org\apache\skywalking\oap\server\configuration\consul\ConsulConfigurationTestModule.java,13,3,0,1,0,4
 skywalking-master\skywalking-master\oap-server\server-telemetry\telemetry-prometheus\src\main\java\org\apache\skywalking\oap\server\telemetry\prometheus\PrometheusCounterMetrics.java,0,13,0,4,0,17
 skywalking-master\skywalking-master\oap-server\server-library\library-elasticsearch-client\src\main\java\org\apache\skywalking\library\elasticsearch\requests\search\Query.java,62,27,0,2,0,29
 skywalking-master\skywalking-master\oap-server\server-core\src\main\java\org\apache\skywalking\oap\server\core\query\type\DashboardConfiguration.java,16,6,0,2,0,8
 skywalking-master\skywalking-master\oap-server\server-library\library-util\src\main\java\org\apache\skywalking\oap\server\library\util\PlaceholderConfigurerSupport.java,19,4,0,1,0,5
 skywalking-master\skywalking-master\oap-server\server-configuration\configuration-api\src\main\java\org\apache\skywalking\oap\server\configuration\api\ConfigChangeWatcher.java,51,28,0,4,2,34
 skywalking-master\skywalking-master\oap-server\server-storage-plugin\storage-jdbc-hikaricp-plugin\src\main\java\org\apache\skywalking\oap\server\storage\plugin\jdbc\mysql\MySQLTableInstaller.java,105,24,3,13,0,40
 skywalking-master\skywalking-master\oap-server\analyzer\log-analyzer\src\main\java\org\apache\skywalking\oap\log\analyzer\provider\log\analyzer\LogAnalyzerFactory.java,4,1,0,1,0,2
 skywalking-master\skywalking-master\oap-server\server-receiver-plugin\skywalking-jvm-receiver-plugin\src\main\java\org\apache\skywalking\oap\server\receiver\jvm\provider\JVMOALDefine.java,11,2,1,1,0,4
 skywalking-master\skywalking-master\oap-server\server-core\src\main\java\org\apache\skywalking\oap\server\core\storage\type\Convert2Entity.java,0,6,0,2,0,8
 skywalking-master\skywalking-master\oap-server\server-core\src\main\java\org\apache\skywalking\oap\server\core\analysis\meter\function\AcceptableValue.java,0,6,0,2,0,8
 skywalking-master\skywalking-master\oap-server\server-library\library-elasticsearch-client\src\main\java\org\apache\skywalking\library\elasticsearch\requests\factory\v6\V6IndexFactory.java,0,16,0,9,0,25
 skywalking-master\skywalking-master\oap-server\server-core\src\main\java\org\apache\skywalking\oap\server\core\query\type\TraceState.java,0,3,0,1,0,4
 skywalking-master\skywalking-master\oap-server\server-storage-plugin\storage-jdbc-hikaricp-plugin\src\main\java\org\apache\skywalking\oap\server\storage\plugin\jdbc\BatchSQLExecutor.java,0,13,1,6,0,20
 skywalking-master\skywalking-master\oap-server\server-fetcher-plugin\prometheus-fetcher-plugin\src\main\java\org\apache\skywalking\oap\server\fetcher\prometheus\module\PrometheusFetcherModule.java,13,4,0,1,0,5
 skywalking-master\skywalking-master\oap-server\server-fetcher-plugin\kafka-fetcher-plugin\src\main\java\org\apache\skywalking\oap\server\analyzer\agent\kafka\module\KafkaFetcherConfig.java,75,23,0,5,0,28
 skywalking-master\skywalking-master\oap-server\server-receiver-plugin\envoy-metrics-receiver-plugin\src\main\java\org\apache\skywalking\oap\server\receiver\envoy\AccessLogServiceGRPCHandlerV3.java,0,4,0,3,0,7
 skywalking-master\skywalking-master\apm-webapp\src\main\java\org\apache\skywalking\oap\server\webapp\GlobalErrorWebExceptionHandler.java,19,6,0,3,0,9
 skywalking-master\skywalking-master\oap-server\server-receiver-plugin\skywalking-zabbix-receiver-plugin\src\main\java\org\apache\skywalking\oap\server\receiver\zabbix\provider\protocol\ZabbixProtocolDecoder.java,85,50,0,15,0,65
 skywalking-master\skywalking-master\oap-server\server-receiver-plugin\skywalking-mesh-receiver-plugin\src\main\java\org\apache\skywalking\aop\server\receiver\mesh\MeshGRPCHandlerCompat.java,0,4,0,4,0,8
 skywalking-master\skywalking-master\oap-server\server-core\src\main\java\org\apache\skywalking\oap\server\core\source\ServiceInstanceJVMCPU.java,31,11,1,7,0,19
 skywalking-master\skywalking-master\oap-server\server-core\src\main\java\org\apache\skywalking\oap\server\core\analysis\manual\instance\InstanceTrafficDispatcher.java,13,2,0,3,0,5
 skywalking-master\skywalking-master\oap-server\analyzer\log-analyzer\src\main\java\org\apache\skywalking\oap\log\analyzer\provider\log\LogAnalyzer.java,37,11,0,4,0,15
 skywalking-master\skywalking-master\oap-server\server-core\src\main\java\org\apache\skywalking\oap\server\core\query\type\EndpointInfo.java,7,4,0,1,0,5
 skywalking-master\skywalking-master\oap-server\server-storage-plugin\storage-elasticsearch-plugin\src\main\java\org\apache\skywalking\oap\server\storage\plugin\elasticsearch\base\HistoryDeleteEsDAO.java,79,16,0,10,0,26
 skywalking-master\skywalking-master\oap-server\server-core\src\main\java\org\apache\skywalking\oap\server\core\analysis\manual\relation\instance\ServiceInstanceRelationClientSideMetrics.java,139,47,1,21,0,69
 skywalking-master\skywalking-master\oap-server\server-library\library-server\src\main\java\org\apache\skywalking\oap\server\library\server\grpc\GRPCHandler.java,0,1,0,1,0,2
 skywalking-master\skywalking-master\test\e2e-v2\java-test-service\e2e-service-provider\src\main\java\org\apache\skywalking\e2e\KeyValue.java,6,3,0,1,0,4
 skywalking-master\skywalking-master\oap-server\server-library\library-elasticsearch-client\src\main\java\org\apache\skywalking\library\elasticsearch\requests\search\aggregation\MinAggregation.java,0,6,0,3,0,9
 skywalking-master\skywalking-master\oap-server\server-core\src\main\java\org\apache\skywalking\oap\server\core\analysis\DisableRegister.java,45,16,0,4,0,20
 skywalking-master\skywalking-master\oap-server\server-storage-plugin\storage-elasticsearch-plugin\src\test\java\org\apache\skywalking\oap\server\storage\plugin\elasticsearch\base\IndexStructuresTest.java,195,11,0,9,0,20
 skywalking-master\skywalking-master\oap-server\server-alarm-plugin\src\main\java\org\apache\skywalking\oap\server\core\alarm\provider\CompositeRuleEvaluator.java,93,27,0,11,0,38
 skywalking-master\skywalking-master\oap-server\server-fetcher-plugin\kafka-fetcher-plugin\src\main\java\org\apache\skywalking\oap\server\analyzer\agent\kafka\provider\handler\JVMMetricsHandler.java,73,18,1,10,0,29
 skywalking-master\skywalking-master\oap-server\server-core\src\main\java\org\apache\skywalking\oap\server\core\analysis\worker\MetricsStreamProcessor.java,177,68,0,44,0,112
 skywalking-master\skywalking-master\oap-server\server-library\library-client\src\main\java\org\apache\skywalking\oap\server\library\client\healthcheck\HealthCheckable.java,0,1,0,2,0,3
 skywalking-master\skywalking-master\oap-server\server-core\src\main\java\org\apache\skywalking\oap\server\core\query\type\EBPFProfilingTree.java,4,2,0,1,0,3
 skywalking-master\skywalking-master\oap-server\server-library\library-util\src\main\java\org\apache\skywalking\oap\server\library\util\prometheus\metrics\Gauge.java,20,11,0,2,2,15
 skywalking-master\skywalking-master\oap-server\server-query-plugin\query-graphql-plugin\src\main\java\org\apache\skywalking\oap\query\graphql\type\LogTestRequest.java,6,2,0,1,0,3
 skywalking-master\skywalking-master\oap-server\server-configuration\grpc-configuration-sync\src\main\java\org\apache\skywalking\oap\server\configuration\grpc\GRPCConfigurationProvider.java,30,7,0,3,0,10
 skywalking-master\skywalking-master\oap-server\server-receiver-plugin\skywalking-mesh-receiver-plugin\src\main\java\org\apache\skywalking\aop\server\receiver\mesh\MeshGRPCHandler.java,0,12,3,6,0,21
 skywalking-master\skywalking-master\oap-server\server-alarm-plugin\src\test\java\org\apache\skywalking\oap\server\core\alarm\provider\expression\ExpressionTest.java,55,7,0,1,0,8
 skywalking-master\skywalking-master\oap-server\server-core\src\main\java\org\apache\skywalking\oap\server\core\management\ui\template\UITemplateInitializer.java,75,24,0,10,0,34
 skywalking-master\skywalking-master\oap-server\analyzer\event-analyzer\src\main\java\org\apache\skywalking\oap\server\analyzer\event\EventAnalyzerModuleProvider.java,49,9,1,5,0,15
 skywalking-master\skywalking-master\oap-server\server-receiver-plugin\envoy-metrics-receiver-plugin\src\main\java\org\apache\skywalking\oap\server\receiver\envoy\als\tcp\k8s\K8sALSServiceMeshTCPAnalysis.java,140,46,1,35,0,82
 skywalking-master\skywalking-master\oap-server\server-storage-plugin\storage-elasticsearch-plugin\src\main\java\org\apache\skywalking\oap\server\storage\plugin\elasticsearch\query\MetadataQueryEsDAO.java,259,67,1,56,0,124
 skywalking-master\skywalking-master\oap-server\server-storage-plugin\storage-influxdb-plugin\src\main\java\org\apache\skywalking\oap\server\storage\plugin\influxdb\base\InfluxStorageDAO.java,28,15,0,4,0,19
 skywalking-master\skywalking-master\oap-server\server-cluster-plugin\cluster-etcd-plugin\src\test\java\org\apache\skywalking\oap\server\cluster\plugin\etcd\ITClusterEtcdPluginTest.java,130,36,4,14,0,54
 skywalking-master\skywalking-master\oap-server\server-core\src\main\java\org\apache\skywalking\oap\server\core\source\Service.java,61,22,2,6,0,30
 skywalking-master\skywalking-master\oap-server\server-fetcher-plugin\prometheus-fetcher-plugin\src\main\java\org\apache\skywalking\oap\server\fetcher\prometheus\http\HTTPClientHandler.java,32,8,1,1,0,10
 skywalking-master\skywalking-master\oap-server\server-core\src\main\java\org\apache\skywalking\oap\server\core\analysis\manual\process\ProcessTraffic.java,179,47,1,12,0,60
 skywalking-master\skywalking-master\oap-server\analyzer\meter-analyzer\src\main\java\org\apache\skywalking\oap\meter\analyzer\dsl\EntityDescription\ServiceRelationEntityDescription.java,14,8,1,2,0,11
 skywalking-master\skywalking-master\oap-server\analyzer\agent-analyzer\src\main\java\org\apache\skywalking\oap\server\analyzer\provider\trace\parser\SpanTags.java,36,9,0,5,0,14
 skywalking-master\skywalking-master\oap-server\server-telemetry\telemetry-api\src\main\java\org\apache\skywalking\oap\server\telemetry\api\MetricFamily.java,27,25,0,3,0,28
 skywalking-master\skywalking-master\oap-server\server-core\src\main\java\org\apache\skywalking\oap\server\core\query\type\ProfileTaskLog.java,15,7,0,1,0,8
 skywalking-master\skywalking-master\oap-server\server-storage-plugin\storage-influxdb-plugin\src\main\java\org\apache\skywalking\oap\server\storage\plugin\influxdb\query\TopNRecordsQuery.java,63,16,0,9,0,25
 skywalking-master\skywalking-master\oap-server\server-core\src\test\java\org\apache\skywalking\oap\server\core\profiling\trace\analyze\ProfileStackData.java,38,10,0,5,0,15
 skywalking-master\skywalking-master\oap-server\analyzer\agent-analyzer\src\main\java\org\apache\skywalking\oap\server\analyzer\provider\meter\process\MeterProcessor.java,108,15,0,9,0,24
 skywalking-master\skywalking-master\oap-server\server-library\library-elasticsearch-client\src\main\java\org\apache\skywalking\library\elasticsearch\requests\search\MatchQuery.java,0,4,0,1,0,5
 skywalking-master\skywalking-master\oap-server\oal-rt\src\main\java\org\apache\skywalking\oap\server\core\source\oal\rt\metrics\MetricClassPackageHolder.java,3,2,0,2,0,4
 skywalking-master\skywalking-master\oap-server\server-library\library-datacarrier-queue\src\test\java\org\apache\skywalking\oap\server\library\datacarrier\consumer\ConsumeDriverTest.java,31,17,0,12,0,29
 skywalking-master\skywalking-master\oap-server\server-storage-plugin\storage-jdbc-hikaricp-plugin\src\main\java\org\apache\skywalking\oap\server\storage\plugin\jdbc\h2\dao\H2BrowserLogQueryDAO.java,85,29,0,15,0,44
 skywalking-master\skywalking-master\oap-server\server-core\src\test\java\org\apache\skywalking\oap\server\core\storage\model\ModelColumnTest.java,43,13,2,6,0,21
 skywalking-master\skywalking-master\oap-server\server-core\src\main\java\org\apache\skywalking\oap\server\core\query\type\ProfileTask.java,17,11,0,1,0,12
 skywalking-master\skywalking-master\test\e2e-v2\java-test-service\e2e-mock-sender\src\main\java\org\apache\skywalking\e2e\ServiceApplication.java,7,3,1,1,0,5
 skywalking-master\skywalking-master\oap-server\server-core\src\main\java\org\apache\skywalking\oap\server\core\alarm\AlarmEntrance.java,25,9,0,2,0,11
 skywalking-master\skywalking-master\oap-server\server-library\library-util\src\main\java\org\apache\skywalking\oap\server\library\util\prometheus\parser\sample\State.java,0,18,0,2,0,20
 skywalking-master\skywalking-master\oap-server\server-core\src\main\java\org\apache\skywalking\oap\server\core\analysis\metrics\LabeledValueHolder.java,0,1,0,1,0,2
 skywalking-master\skywalking-master\test\e2e-v2\java-test-service\e2e-mock-sender\src\main\java\org\apache\skywalking\e2e\controller\MeterMetricSenderController.java,82,30,1,21,0,52
 skywalking-master\skywalking-master\oap-server\server-core\src\main\java\org\apache\skywalking\oap\server\core\analysis\worker\RecordStreamProcessor.java,44,25,0,16,0,41
 skywalking-master\skywalking-master\oap-server\server-library\library-elasticsearch-client\src\main\java\org\apache\skywalking\library\elasticsearch\requests\factory\v6\codec\V6IndexRequestSerializer.java,0,3,0,2,0,5
 skywalking-master\skywalking-master\oap-server\server-core\src\main\java\org\apache\skywalking\oap\server\core\CoreModuleProvider.java,287,98,0,93,0,191
 skywalking-master\skywalking-master\oap-server\server-core\src\test\java\org\apache\skywalking\oap\server\core\storage\model\StorageModelsTest.java,64,12,5,6,0,23
 skywalking-master\skywalking-master\oap-server\server-core\src\main\java\org\apache\skywalking\oap\server\core\profiling\ebpf\storage\EBPFProfilingTriggerType.java,0,14,0,4,0,18
 skywalking-master\skywalking-master\oap-server\server-telemetry\telemetry-prometheus\src\main\java\org\apache\skywalking\oap\server\telemetry\prometheus\PrometheusMetricsCollector.java,18,7,0,7,0,14
 skywalking-master\skywalking-master\oap-server\analyzer\log-analyzer\src\main\java\org\apache\skywalking\oap\log\analyzer\dsl\spec\sink\sampler\PossibilitySampler.java,26,7,1,1,0,9
 skywalking-master\skywalking-master\oap-server\server-library\library-elasticsearch-client\src\main\java\org\apache\skywalking\library\elasticsearch\requests\factory\IndexFactory.java,0,15,0,2,0,17
 skywalking-master\skywalking-master\oap-server\server-receiver-plugin\skywalking-jvm-receiver-plugin\src\main\java\org\apache\skywalking\oap\server\receiver\jvm\module\JVMModule.java,12,3,0,1,0,4
 skywalking-master\skywalking-master\oap-server\server-core\src\main\java\org\apache\skywalking\oap\server\core\analysis\metrics\MinLongMetrics.java,38,8,1,5,0,14
 skywalking-master\skywalking-master\oap-server\server-library\library-elasticsearch-client\src\main\java\org\apache\skywalking\library\elasticsearch\response\Documents.java,0,1,0,1,1,3
 skywalking-master\skywalking-master\oap-server\server-receiver-plugin\envoy-metrics-receiver-plugin\src\main\java\org\apache\skywalking\oap\server\receiver\envoy\SatelliteAccessLogServiceGRPCHandlerV3.java,0,5,0,4,0,9
 skywalking-master\skywalking-master\oap-server\server-tools\profile-exporter\tool-profile-snapshot-bootstrap\src\test\java\org\apache\skywalking\oap\server\tool\profile\exporter\test\ExportedData.java,20,13,0,1,0,14
 skywalking-master\skywalking-master\oap-server\server-core\src\main\java\org\apache\skywalking\oap\server\core\source\ScopeDefaultColumn.java,59,27,0,5,0,32
 skywalking-master\skywalking-master\oap-server\server-core\src\main\java\org\apache\skywalking\oap\server\core\worker\RemoteHandleWorker.java,5,2,0,1,0,3
 skywalking-master\skywalking-master\oap-server\server-core\src\main\java\org\apache\skywalking\oap\server\core\analysis\metrics\expression\LessEqualMatch.java,34,32,0,2,0,34
 skywalking-master\skywalking-master\oap-server\server-receiver-plugin\skywalking-browser-receiver-plugin\src\main\java\org\apache\skywalking\oap\server\receiver\browser\provider\parser\performance\PerfDataAnalyzer.java,34,11,0,7,0,18
 skywalking-master\skywalking-master\oap-server\server-core\src\main\java\org\apache\skywalking\oap\server\core\source\DetectPoint.java,0,10,0,1,0,11
 skywalking-master\skywalking-master\oap-server\server-core\src\main\java\org\apache\skywalking\oap\server\core\analysis\worker\NoneStreamProcessor.java,43,26,0,18,0,44
 skywalking-master\skywalking-master\oap-server\server-library\library-client\src\main\java\org\apache\skywalking\oap\server\library\client\grpc\GRPCClientConfig.java,22,14,0,1,0,15
 skywalking-master\skywalking-master\oap-server\analyzer\agent-analyzer\src\main\java\org\apache\skywalking\oap\server\analyzer\provider\trace\parser\listener\strategy\FromEntrySpan.java,8,4,0,4,0,8
 skywalking-master\skywalking-master\oap-server\server-core\src\main\java\org\apache\skywalking\oap\server\core\remote\client\GRPCRemoteClient.java,210,49,9,16,0,74
 skywalking-master\skywalking-master\oap-server\server-storage-plugin\storage-influxdb-plugin\src\main\java\org\apache\skywalking\oap\server\storage\plugin\influxdb\query\EBPFProfilingDataQuery.java,54,11,0,5,0,16
 skywalking-master\skywalking-master\oap-server\server-library\library-module\src\test\java\org\apache\skywalking\oap\server\library\module\ModuleB2Provider.java,40,7,2,3,0,12
 skywalking-master\skywalking-master\oap-server\server-core\src\main\java\org\apache\skywalking\oap\server\core\source\SourceReceiverImpl.java,23,8,0,3,0,11
 skywalking-master\skywalking-master\oap-server\server-core\src\main\java\org\apache\skywalking\oap\server\core\storage\type\Convert2Storage.java,0,9,0,2,0,11
 skywalking-master\skywalking-master\oap-server\server-core\src\main\java\org\apache\skywalking\oap\server\core\query\MetricDefinition.java,10,5,0,3,0,8
 skywalking-master\skywalking-master\oap-server\server-fetcher-plugin\kafka-fetcher-plugin\src\test\java\org\apache\skywalking\oap\server\analyzer\agent\kafka\provider\handler\ServiceManagementHandlerTest.java,63,23,1,13,0,37
 skywalking-master\skywalking-master\oap-server\server-core\src\main\java\org\apache\skywalking\oap\server\core\analysis\metrics\annotation\SourceFrom.java,0,0,0,1,0,1
 skywalking-master\skywalking-master\oap-server\oal-rt\src\test\java\org\apache\skywalking\oal\rt\parser\DeepAnalysisTest.java,139,28,19,23,0,70
 skywalking-master\skywalking-master\oap-server\server-core\src\test\java\org\apache\skywalking\oap\server\core\storage\model\ExtraQueryIndexTest.java,16,5,1,3,0,9
 skywalking-master\skywalking-master\oap-server\server-core\src\main\java\org\apache\skywalking\oap\server\core\query\type\event\Event.java,32,17,0,3,0,20
 skywalking-master\skywalking-master\oap-server\microbench\src\main\java\org\apache\skywalking\oap\server\microbench\library\datacarrier\common\AtomicRangeIntegerV1.java,46,18,0,1,0,19
 skywalking-master\skywalking-master\oap-server\analyzer\log-analyzer\src\main\java\org\apache\skywalking\oap\log\analyzer\dsl\spec\parser\AbstractParserSpec.java,24,8,0,2,0,10
 skywalking-master\skywalking-master\oap-server\server-receiver-plugin\configuration-discovery-receiver-plugin\src\test\java\org\apache\skywalking\oap\server\recevier\configuration\discovery\AgentConfigurationsWatcherTest.java,77,26,2,20,0,48
 skywalking-master\skywalking-master\oap-server\oal-rt\src\main\java\org\apache\skywalking\oal\rt\parser\DeepAnalysis.java,119,26,1,27,0,54
 skywalking-master\skywalking-master\oap-server\server-core\src\main\java\org\apache\skywalking\oap\server\core\analysis\data\LimitedSizeBufferedData.java,0,13,3,4,0,20
 skywalking-master\skywalking-master\oap-server\server-configuration\configuration-etcd\src\test\java\org\apache\skywalking\oap\server\configuration\etcd\EtcdConfigurationTestModule.java,14,4,0,1,0,5
 skywalking-master\skywalking-master\oap-server\analyzer\agent-analyzer\src\main\java\org\apache\skywalking\oap\server\analyzer\provider\trace\parser\SegmentParserListenerManager.java,18,6,0,3,0,9
 skywalking-master\skywalking-master\oap-server\server-library\library-module\src\main\java\org\apache\skywalking\oap\server\library\module\ModuleNotFoundRuntimeException.java,11,4,0,1,0,5
 skywalking-master\skywalking-master\oap-server\server-configuration\configuration-nacos\src\test\java\org\apache\skywalking\oap\server\configuration\nacos\NacosConfigurationTestModule.java,13,3,0,1,0,4
 skywalking-master\skywalking-master\oap-server\server-tools\profile-exporter\tool-profile-snapshot-bootstrap\src\test\java\org\apache\skywalking\oap\server\tool\profile\exporter\test\ProfileTraceDAO.java,54,26,1,6,0,33
 skywalking-master\skywalking-master\oap-server\server-library\library-datacarrier-queue\src\test\java\org\apache\skywalking\oap\server\library\datacarrier\EnvUtilTest.java,27,13,0,2,0,15
 skywalking-master\skywalking-master\oap-server\server-core\src\main\java\org\apache\skywalking\oap\server\core\management\ui\template\UITemplateManagementService.java,47,27,1,9,0,37
 skywalking-master\skywalking-master\oap-server\server-configuration\configuration-api\src\main\java\org\apache\skywalking\oap\server\configuration\api\ConfigWatcherRegister.java,237,70,7,41,1,119
 skywalking-master\skywalking-master\oap-server\server-storage-plugin\storage-iotdb-plugin\src\main\java\org\apache\skywalking\oap\server\storage\plugin\iotdb\profile\IoTDBProfileTaskQueryDAO.java,83,27,0,16,0,43
 skywalking-master\skywalking-master\oap-server\server-core\src\main\java\org\apache\skywalking\oap\server\core\source\ServiceInstanceJVMThread.java,49,17,0,7,0,24
 skywalking-master\skywalking-master\oap-server\server-core\src\main\java\org\apache\skywalking\oap\server\core\analysis\meter\function\PercentileFunction.java,0,59,3,26,0,88
 skywalking-master\skywalking-master\oap-server\server-storage-plugin\storage-elasticsearch-plugin\src\main\java\org\apache\skywalking\oap\server\storage\plugin\elasticsearch\base\BatchProcessEsDAO.java,44,22,0,10,0,32
 skywalking-master\skywalking-master\oap-server\server-library\library-util\src\main\java\org\apache\skywalking\oap\server\library\util\prometheus\metrics\Summary.java,28,19,0,2,8,29
 skywalking-master\skywalking-master\oap-server\server-starter\src\test\java\org\apache\skywalking\oap\server\starter\config\ApplicationConfigLoaderTestCase.java,66,22,1,12,0,35
 skywalking-master\skywalking-master\oap-server\server-configuration\configuration-api\src\main\java\org\apache\skywalking\oap\server\configuration\api\AbstractConfigurationProvider.java,33,12,1,8,1,22
 skywalking-master\skywalking-master\oap-server\oal-rt\src\main\java\org\apache\skywalking\oap\server\core\source\oal\rt\dispatcher\DispatcherClassPackageHolder.java,3,2,0,2,0,4
 skywalking-master\skywalking-master\oap-server\server-fetcher-plugin\kafka-fetcher-plugin\src\main\java\org\apache\skywalking\oap\server\analyzer\agent\kafka\module\KafkaFetcherModule.java,13,4,0,1,0,5
 skywalking-master\skywalking-master\oap-server\analyzer\log-analyzer\src\main\java\org\apache\skywalking\oap\log\analyzer\provider\log\LogAnalyzerServiceImpl.java,0,10,0,5,0,15
 skywalking-master\skywalking-master\oap-server\analyzer\meter-analyzer\src\main\java\org\apache\skywalking\oap\meter\analyzer\dsl\Expression.java,109,23,2,12,0,37
 skywalking-master\skywalking-master\oap-server\server-receiver-plugin\skywalking-browser-receiver-plugin\src\main\java\org\apache\skywalking\oap\server\receiver\browser\provider\parser\performance\listener\MultiScopesPerfDataAnalysisListener.java,78,23,1,15,0,39
 skywalking-master\skywalking-master\oap-server\server-receiver-plugin\envoy-metrics-receiver-plugin\src\main\java\org\apache\skywalking\oap\server\receiver\envoy\ServiceMetaInfoFactory.java,0,5,1,3,0,9
 skywalking-master\skywalking-master\oap-server\server-receiver-plugin\skywalking-meter-receiver-plugin\src\main\java\org\apache\skywalking\oap\server\receiver\meter\provider\handler\MeterServiceHandler.java,0,23,4,11,0,38
 skywalking-master\skywalking-master\oap-server\server-storage-plugin\storage-jdbc-hikaricp-plugin\src\main\java\org\apache\skywalking\oap\server\storage\plugin\jdbc\h2\dao\H2ProfileTaskQueryDAO.java,96,31,0,18,0,49
 skywalking-master\skywalking-master\oap-server\server-storage-plugin\storage-elasticsearch-plugin\src\main\java\org\apache\skywalking\oap\server\storage\plugin\elasticsearch\StorageModuleElasticsearchProvider.java,157,47,3,66,0,116
 skywalking-master\skywalking-master\oap-server\server-configuration\configuration-api\src\main\java\org\apache\skywalking\oap\server\configuration\api\NoneConfigurationProvider.java,42,11,3,7,1,22
 skywalking-master\skywalking-master\oap-server\exporter\src\main\java\org\apache\skywalking\oap\server\exporter\provider\MetricFormatter.java,62,23,0,22,0,45
 skywalking-master\skywalking-master\oap-server\server-storage-plugin\storage-elasticsearch-plugin\src\test\java\org\apache\skywalking\oap\server\storage\plugin\elasticsearch\base\ElasticSearchColumnTypeMappingTestCase.java,23,9,0,7,0,16
 skywalking-master\skywalking-master\oap-server\server-core\src\main\java\org\apache\skywalking\oap\server\core\analysis\manual\segment\SegmentRecord.java,102,35,0,11,0,46
 skywalking-master\skywalking-master\oap-server\server-storage-plugin\storage-jdbc-hikaricp-plugin\src\main\java\org\apache\skywalking\oap\server\storage\plugin\jdbc\mysql\MySQLTraceQueryDAO.java,20,10,0,4,0,14
 skywalking-master\skywalking-master\oap-server\server-cluster-plugin\cluster-standalone-plugin\src\test\java\org\apache\skywalking\oap\server\cluster\plugin\standalone\StandaloneManagerTest.java,14,8,0,5,0,13
 skywalking-master\skywalking-master\oap-server\server-storage-plugin\storage-influxdb-plugin\src\main\java\org\apache\skywalking\oap\server\storage\plugin\influxdb\query\ProfileThreadSnapshotQuery.java,167,58,0,26,0,84
 skywalking-master\skywalking-master\oap-server\server-core\src\main\java\org\apache\skywalking\oap\server\core\source\Endpoint.java,67,25,1,8,0,34
 skywalking-master\skywalking-master\oap-server\server-core\src\main\java\org\apache\skywalking\oap\server\core\query\type\IntValues.java,21,12,0,2,0,14
 skywalking-master\skywalking-master\oap-server\server-core\src\main\java\org\apache\skywalking\oap\server\core\analysis\metrics\expression\NotContainMatch.java,12,4,0,2,0,6
 skywalking-master\skywalking-master\oap-server\server-core\src\main\java\org\apache\skywalking\oap\server\core\analysis\manual\relation\instance\ServiceInstanceCallRelationDispatcher.java,39,9,1,5,0,15
 skywalking-master\skywalking-master\oap-server\server-core\src\main\java\org\apache\skywalking\oap\server\core\query\type\TemplateChangeStatus.java,6,3,0,1,0,4
 skywalking-master\skywalking-master\oap-server\oal-rt\src\main\java\org\apache\skywalking\oal\rt\parser\Argument.java,14,7,0,1,0,8
 skywalking-master\skywalking-master\oap-server\server-core\src\main\java\org\apache\skywalking\oap\server\core\analysis\manual\relation\endpoint\EndpointRelationServerSideMetrics.java,119,32,1,12,0,45
 skywalking-master\skywalking-master\apm-protocol\apm-network\src\main\java\org\apache\skywalking\oap\server\network\constants\ProfileConstants.java,24,7,0,1,0,8
 skywalking-master\skywalking-master\oap-server\server-receiver-plugin\skywalking-management-receiver-plugin\src\main\java\org\apache\skywalking\oap\server\receiver\register\provider\RegisterModuleProvider.java,50,13,2,12,0,27
 skywalking-master\skywalking-master\oap-server\server-tools\profile-exporter\tool-profile-snapshot-server-mock\src\main\java\org\apache\skywalking\oap\server\tool\profile\core\MockCoreModuleProvider.java,122,45,1,46,0,92
 skywalking-master\skywalking-master\oap-server\server-library\library-elasticsearch-client\src\main\java\org\apache\skywalking\library\elasticsearch\requests\search\SearchParams.java,0,13,0,1,2,16
 skywalking-master\skywalking-master\oap-server\server-core\src\main\java\org\apache\skywalking\oap\server\core\query\type\EBPFProfilingTaskCreationResult.java,6,5,0,1,0,6
 skywalking-master\skywalking-master\oap-server\server-configuration\configuration-apollo\src\test\java\org\apache\skywalking\oap\server\configuration\apollo\ITApolloConfigurationTest.java,189,80,5,50,0,135
 skywalking-master\skywalking-master\oap-server\server-configuration\configuration-nacos\src\test\java\org\apache\skywalking\oap\server\configuration\nacos\NacosConfigWatcherRegisterTest.java,32,9,0,7,0,16
 skywalking-master\skywalking-master\oap-server\server-core\src\main\java\org\apache\skywalking\oap\server\core\analysis\worker\ManagementPersistentWorker.java,20,11,1,2,0,14
 skywalking-master\skywalking-master\oap-server\server-configuration\configuration-zookeeper\src\main\java\org\apache\skywalking\oap\server\configuration\zookeeper\ZookeeperServerSettings.java,8,8,0,1,0,9
 skywalking-master\skywalking-master\oap-server\server-library\library-module\src\main\java\org\apache\skywalking\oap\server\library\module\BootstrapFlow.java,0,16,2,12,0,30
 skywalking-master\skywalking-master\oap-server\server-core\src\main\java\org\apache\skywalking\oap\server\core\analysis\metrics\expression\GreaterMatch.java,34,32,0,2,0,34
 skywalking-master\skywalking-master\test\e2e-v2\java-test-service\e2e-service-consumer\src\main\java\org\apache\skywalking\e2e\E2EConfiguration.java,4,2,0,1,0,3
 skywalking-master\skywalking-master\oap-server\server-core\src\main\java\org\apache\skywalking\oap\server\core\cluster\RemoteInstance.java,19,7,0,1,0,8
 skywalking-master\skywalking-master\oap-server\server-receiver-plugin\skywalking-mesh-receiver-plugin\src\main\java\org\apache\skywalking\aop\server\receiver\mesh\MeshReceiverModule.java,13,3,0,1,0,4
 skywalking-master\skywalking-master\oap-server\server-library\library-module\src\main\java\org\apache\skywalking\oap\server\library\module\DuplicateProviderException.java,6,2,0,1,0,3
 skywalking-master\skywalking-master\oap-server\server-receiver-plugin\configuration-discovery-receiver-plugin\src\main\java\org\apache\skywalking\oap\server\recevier\configuration\discovery\handler\grpc\ConfigurationDiscoveryServiceHandler.java,0,25,0,19,0,44
 skywalking-master\skywalking-master\oap-server\server-configuration\configuration-etcd\src\main\java\org\apache\skywalking\oap\server\configuration\etcd\EtcdConfigException.java,8,4,0,1,0,5
 skywalking-master\skywalking-master\oap-server\server-library\library-util\src\main\java\org\apache\skywalking\oap\server\library\util\ConnectUtils.java,41,9,2,7,0,18
 skywalking-master\skywalking-master\oap-server\server-core\src\test\java\org\apache\skywalking\oap\server\core\analysis\metrics\DataTableTestCase.java,40,19,0,3,0,22
 skywalking-master\skywalking-master\oap-server\server-library\library-server\src\main\java\org\apache\skywalking\oap\server\library\server\http\HTTPServer.java,54,13,1,3,1,18
 skywalking-master\skywalking-master\oap-server\server-receiver-plugin\skywalking-browser-receiver-plugin\src\main\java\org\apache\skywalking\oap\server\receiver\browser\provider\parser\errorlog\ErrorLogAnalyzer.java,38,11,2,7,0,20
 skywalking-master\skywalking-master\oap-server\analyzer\agent-analyzer\src\main\java\org\apache\skywalking\oap\server\analyzer\provider\trace\sampling\SamplingPolicySettingsReader.java,57,19,0,11,0,30
 skywalking-master\skywalking-master\oap-server\server-query-plugin\query-graphql-plugin\src\main\java\org\apache\skywalking\oap\query\graphql\type\LogTestResponse.java,5,2,1,1,0,4
 skywalking-master\skywalking-master\oap-server\server-query-plugin\query-graphql-plugin\src\main\java\org\apache\skywalking\oap\query\graphql\resolver\AlarmQuery.java,152,37,2,27,0,66
 skywalking-master\skywalking-master\oap-server\server-core\src\main\java\org\apache\skywalking\oap\server\core\query\AlarmQueryService.java,23,10,0,4,0,14
 skywalking-master\skywalking-master\oap-server\server-receiver-plugin\skywalking-jvm-receiver-plugin\src\main\java\org\apache\skywalking\oap\server\receiver\jvm\provider\handler\JVMMetricReportServiceHandlerCompat.java,0,4,0,4,0,8
 skywalking-master\skywalking-master\oap-server\analyzer\agent-analyzer\src\main\java\org\apache\skywalking\oap\server\analyzer\provider\jvm\JVMSourceDispatcher.java,184,77,2,32,0,111
 skywalking-master\skywalking-master\oap-server\server-core\src\main\java\org\apache\skywalking\oap\server\core\storage\profiling\trace\IProfileThreadSnapshotQueryDAO.java,0,20,0,7,0,27
 skywalking-master\skywalking-master\oap-server\server-library\library-util\src\main\java\org\apache\skywalking\oap\server\library\util\Address.java,5,3,0,1,0,4
 skywalking-master\skywalking-master\oap-server\server-core\src\main\java\org\apache\skywalking\oap\server\core\query\DurationUtils.java,0,74,7,20,0,101
 skywalking-master\skywalking-master\oap-server\server-storage-plugin\storage-tidb-plugin\src\main\java\org\apache\skywalking\oap\server\storage\plugin\jdbc\tidb\TiDBStorageConfig.java,3,0,0,2,0,2
 skywalking-master\skywalking-master\oap-server\server-core\src\main\java\org\apache\skywalking\oap\server\core\analysis\worker\TopNWorker.java,81,26,7,9,0,42
 skywalking-master\skywalking-master\oap-server\server-receiver-plugin\skywalking-trace-receiver-plugin\src\test\java\org\apache\skywalking\oap\server\receiver\trace\mock\ComponentsDefine.java,13,11,0,6,0,17
 skywalking-master\skywalking-master\oap-server\server-query-plugin\query-graphql-plugin\src\main\java\org\apache\skywalking\oap\query\graphql\resolver\BrowserLogQuery.java,27,10,1,6,0,17
 skywalking-master\skywalking-master\oap-server\server-core\src\test\java\org\apache\skywalking\oap\server\core\profiling\trace\analyze\ProfileStackAnalyze.java,74,30,1,12,0,43
 skywalking-master\skywalking-master\oap-server\server-storage-plugin\storage-iotdb-plugin\src\main\java\org\apache\skywalking\oap\server\storage\plugin\iotdb\utils\IoTDBUtils.java,44,23,1,4,0,28
 skywalking-master\skywalking-master\oap-server\analyzer\agent-analyzer\src\main\java\org\apache\skywalking\oap\server\analyzer\provider\trace\parser\listener\AnalysisListenerFactory.java,0,3,0,4,0,7
 skywalking-master\skywalking-master\oap-server\server-core\src\main\java\org\apache\skywalking\oap\server\core\query\sql\Function.java,0,5,0,1,0,6
 skywalking-master\skywalking-master\oap-server\server-core\src\main\java\org\apache\skywalking\oap\server\core\analysis\data\BufferedData.java,0,6,0,4,0,10
 skywalking-master\skywalking-master\oap-server\server-receiver-plugin\envoy-metrics-receiver-plugin\src\test\java\org\apache\skywalking\oap\server\receiver\envoy\MetricServiceGRPCHandlerTestMain.java,66,21,5,13,0,39
 skywalking-master\skywalking-master\oap-server\server-library\library-util\src\main\java\org\apache\skywalking\oap\server\library\util\CollectionUtils.java,39,19,4,1,0,24
 skywalking-master\skywalking-master\oap-server\server-library\library-client\src\main\java\org\apache\skywalking\oap\server\library\client\request\UpdateRequest.java,0,0,0,1,0,1
 skywalking-master\skywalking-master\oap-server\server-library\library-elasticsearch-client\src\main\java\org\apache\skywalking\library\elasticsearch\requests\search\TermQuery.java,0,6,0,2,0,8
 skywalking-master\skywalking-master\oap-server\server-library\library-elasticsearch-client\src\main\java\org\apache\skywalking\library\elasticsearch\ElasticSearch.java,0,46,2,8,3,59
 skywalking-master\skywalking-master\oap-server\server-alarm-plugin\src\main\java\org\apache\skywalking\oap\server\core\alarm\provider\welink\WeLinkSettings.java,38,13,0,4,0,17
 skywalking-master\skywalking-master\oap-server\analyzer\agent-analyzer\src\main\java\org\apache\skywalking\oap\server\analyzer\provider\trace\parser\TraceAnalyzer.java,87,27,1,18,0,46
 skywalking-master\skywalking-master\oap-server\server-library\library-server\src\main\java\org\apache\skywalking\oap\server\library\server\ServerException.java,11,5,0,1,0,6
 skywalking-master\skywalking-master\oap-server\server-library\library-datacarrier-queue\src\main\java\org\apache\skywalking\oap\server\library\datacarrier\consumer\ConsumerThread.java,81,21,2,2,0,25
 skywalking-master\skywalking-master\oap-server\server-library\library-elasticsearch-client\src\main\java\org\apache\skywalking\library\elasticsearch\requests\factory\v7\codec\V78Codec.java,0,8,0,6,0,14
 skywalking-master\skywalking-master\oap-server\server-query-plugin\query-graphql-plugin\src\main\java\org\apache\skywalking\oap\query\graphql\resolver\LogTestQuery.java,83,18,0,14,0,32
 skywalking-master\skywalking-master\oap-server\server-core\src\main\java\org\apache\skywalking\oap\server\core\remote\Deserializable.java,0,3,0,2,0,5
 skywalking-master\skywalking-master\oap-server\server-fetcher-plugin\kafka-fetcher-plugin\src\main\java\org\apache\skywalking\oap\server\analyzer\agent\kafka\provider\handler\KafkaHandler.java,0,8,0,5,0,13
 skywalking-master\skywalking-master\oap-server\server-storage-plugin\storage-elasticsearch-plugin\src\main\java\org\apache\skywalking\oap\server\storage\plugin\elasticsearch\query\TopologyQueryEsDAO.java,291,108,0,69,0,177
 skywalking-master\skywalking-master\oap-server\analyzer\meter-analyzer\src\main\java\org\apache\skywalking\oap\meter\analyzer\prometheus\rule\Rules.java,37,8,1,4,0,13
 skywalking-master\skywalking-master\oap-server\server-fetcher-plugin\prometheus-fetcher-plugin\src\test\java\org\apache\skywalking\oap\server\fetcher\prometheus\provider\rule\RulesTest.java,11,4,0,2,0,6
 skywalking-master\skywalking-master\oap-server\server-library\library-util\src\test\java\org\apache\skywalking\oap\server\library\util\RunnableWithExceptionProtectionTest.java,21,3,0,2,2,7
 skywalking-master\skywalking-master\oap-server\server-receiver-plugin\envoy-metrics-receiver-plugin\src\main\java\org\apache\skywalking\oap\server\receiver\envoy\MetricServiceGRPCHandler.java,0,31,2,23,0,56
 skywalking-master\skywalking-master\oap-server\server-storage-plugin\storage-influxdb-plugin\src\main\java\org\apache\skywalking\oap\server\storage\plugin\influxdb\query\UITemplateManagementDAOImpl.java,129,30,0,25,0,55
 skywalking-master\skywalking-master\oap-server\server-receiver-plugin\skywalking-zabbix-receiver-plugin\src\main\java\org\apache\skywalking\oap\server\receiver\zabbix\provider\protocol\bean\ZabbixProtocolType.java,0,13,0,1,0,14
 skywalking-master\skywalking-master\oap-server\server-receiver-plugin\configuration-discovery-receiver-plugin\src\main\java\org\apache\skywalking\oap\server\recevier\configuration\discovery\AgentConfigurationsReader.java,47,12,0,6,0,18
 skywalking-master\skywalking-master\oap-server\server-core\src\main\java\org\apache\skywalking\oap\server\core\query\type\Call.java,96,59,1,10,0,70
 skywalking-master\skywalking-master\oap-server\server-storage-plugin\storage-iotdb-plugin\src\main\java\org\apache\skywalking\oap\server\storage\plugin\iotdb\base\IoTDBMetricsDAO.java,33,18,0,8,0,26
 skywalking-master\skywalking-master\oap-server\analyzer\meter-analyzer\src\main\java\org\apache\skywalking\oap\meter\analyzer\prometheus\rule\Rule.java,12,9,0,1,0,10
 skywalking-master\skywalking-master\oap-server\server-library\library-elasticsearch-client\src\main\java\org\apache\skywalking\library\elasticsearch\client\IndexClient.java,0,25,2,8,3,38
 skywalking-master\skywalking-master\oap-server\server-core\src\main\java\org\apache\skywalking\oap\server\core\storage\INoneStreamDAO.java,0,2,0,1,0,3
 skywalking-master\skywalking-master\oap-server\server-health-checker\src\main\java\org\apache\skywalking\oap\server\health\checker\provider\HealthCheckerProvider.java,55,22,0,12,0,34
 skywalking-master\skywalking-master\oap-server\server-library\library-elasticsearch-client\src\main\java\org\apache\skywalking\library\elasticsearch\requests\search\IdsQuery.java,0,4,0,1,0,5
 skywalking-master\skywalking-master\oap-server\analyzer\agent-analyzer\src\main\java\org\apache\skywalking\oap\server\analyzer\provider\trace\parser\listener\TraceSegmentSampler.java,11,8,0,5,0,13
 skywalking-master\skywalking-master\oap-server\server-receiver-plugin\skywalking-mesh-receiver-plugin\src\test\java\org\apache\skywalking\oap\server\receiver\mesh\MeshDataMock.java,57,28,4,15,0,47
 skywalking-master\skywalking-master\oap-server\server-storage-plugin\storage-influxdb-plugin\src\main\java\org\apache\skywalking\oap\server\storage\plugin\influxdb\base\RecordDAO.java,42,15,0,9,0,24
 skywalking-master\skywalking-master\oap-server\server-cluster-plugin\cluster-zookeeper-plugin\src\test\java\org\apache\skywalking\oap\server\cluster\plugin\zookeeper\ZookeeperCoordinatorTest.java,70,24,4,7,0,35
 skywalking-master\skywalking-master\oap-server\server-storage-plugin\storage-elasticsearch-plugin\src\main\java\org\apache\skywalking\oap\server\storage\plugin\elasticsearch\query\UITemplateManagementEsDAO.java,122,32,2,32,0,66
 skywalking-master\skywalking-master\oap-server\analyzer\meter-analyzer\src\main\java\org\apache\skywalking\oap\meter\analyzer\dsl\FilterExpression.java,25,7,1,2,0,10
 skywalking-master\skywalking-master\oap-server\server-core\src\main\java\org\apache\skywalking\oap\server\core\query\type\ProfileStackTree.java,6,1,0,1,0,2
 skywalking-master\skywalking-master\oap-server\server-tools\profile-exporter\tool-profile-snapshot-server-mock\src\main\java\org\apache\skywalking\oap\server\tool\profile\core\mock\MockWorkerInstancesService.java,0,9,1,3,0,13
 skywalking-master\skywalking-master\oap-server\server-storage-plugin\storage-jdbc-hikaricp-plugin\src\test\java\org\apache\skywalking\oap\server\storage\plugin\jdbc\ArrayParamBuilderTestCase.java,22,2,0,1,0,3
 skywalking-master\skywalking-master\oap-server\analyzer\agent-analyzer\src\main\java\org\apache\skywalking\oap\server\analyzer\provider\trace\parser\listener\SegmentAnalysisListener.java,0,64,1,24,0,89
 skywalking-master\skywalking-master\oap-server\server-library\library-datacarrier-queue\src\main\java\org\apache\skywalking\oap\server\library\datacarrier\consumer\MultipleChannelsConsumer.java,148,43,5,12,0,60
 skywalking-master\skywalking-master\oap-server\server-core\src\main\java\org\apache\skywalking\oap\server\core\analysis\metrics\expression\NotEqualMatch.java,11,8,0,2,0,10
 skywalking-master\skywalking-master\oap-server\server-storage-plugin\storage-iotdb-plugin\src\main\java\org\apache\skywalking\oap\server\storage\plugin\iotdb\management\IoTDBUITemplateManagementDAO.java,107,38,3,28,0,69
 skywalking-master\skywalking-master\oap-server\server-core\src\main\java\org\apache\skywalking\oap\server\core\source\ServiceInstanceCLRGC.java,40,15,1,7,0,23
 skywalking-master\skywalking-master\oap-server\server-library\library-elasticsearch-client\src\main\java\org\apache\skywalking\library\elasticsearch\requests\search\aggregation\MinAggregationBuilder.java,0,7,0,1,0,8
 skywalking-master\skywalking-master\oap-server\server-storage-plugin\storage-elasticsearch-plugin\src\main\java\org\apache\skywalking\oap\server\storage\plugin\elasticsearch\base\IndexController.java,0,38,1,11,0,50
 skywalking-master\skywalking-master\oap-server\server-telemetry\telemetry-api\src\main\java\org\apache\skywalking\oap\server\telemetry\api\CounterMetrics.java,0,6,0,3,0,9
 skywalking-master\skywalking-master\oap-server\server-library\library-elasticsearch-client\src\main\java\org\apache\skywalking\library\elasticsearch\requests\factory\v6\codec\V6IndexTemplatesDeserializer.java,0,4,0,4,0,8
 skywalking-master\skywalking-master\oap-server\server-core\src\main\java\org\apache\skywalking\oap\server\core\query\input\NewDashboardSetting.java,10,3,0,1,0,4
 skywalking-master\skywalking-master\oap-server\server-receiver-plugin\envoy-metrics-receiver-plugin\src\main\java\org\apache\skywalking\oap\server\receiver\envoy\als\k8s\Addresses.java,8,3,1,2,0,6
 skywalking-master\skywalking-master\oap-server\server-library\library-datacarrier-queue\src\main\java\org\apache\skywalking\oap\server\library\datacarrier\partition\IDataPartitioner.java,0,4,0,3,0,7
 skywalking-master\skywalking-master\oap-server\server-starter\src\main\java\org\apache\skywalking\oap\server\starter\config\ApplicationConfigLoader.java,186,54,5,40,0,99
 skywalking-master\skywalking-master\oap-server\server-core\src\main\java\org\apache\skywalking\oap\server\core\config\group\openapi\EndpointGroupingRuleReader4Openapi.java,155,55,2,28,0,85
 skywalking-master\skywalking-master\oap-server\server-storage-plugin\storage-jdbc-hikaricp-plugin\src\main\java\org\apache\skywalking\oap\server\storage\plugin\jdbc\h2\dao\H2EBPFProfilingDataDAO.java,56,27,0,18,0,45
 skywalking-master\skywalking-master\oap-server\server-core\src\main\java\org\apache\skywalking\oap\server\core\query\type\Process.java,26,11,0,1,0,12
 skywalking-master\skywalking-master\oap-server\server-library\library-util\src\test\java\org\apache\skywalking\oap\server\library\util\prometheus\parser\TextParserTest.java,94,54,0,10,3,67
 skywalking-master\skywalking-master\oap-server\server-core\src\main\java\org\apache\skywalking\oap\server\core\query\type\Ref.java,7,4,0,1,0,5
 skywalking-master\skywalking-master\oap-server\server-receiver-plugin\envoy-metrics-receiver-plugin\src\main\java\org\apache\skywalking\oap\server\receiver\envoy\als\mx\FieldsHelper.java,0,39,1,31,0,71
 skywalking-master\skywalking-master\oap-server\server-cluster-plugin\cluster-standalone-plugin\src\main\java\org\apache\skywalking\oap\server\cluster\plugin\standalone\ClusterModuleStandaloneProvider.java,41,9,3,4,0,16
 skywalking-master\skywalking-master\oap-server\server-core\src\main\java\org\apache\skywalking\oap\server\core\analysis\metrics\MaxLongMetrics.java,38,8,1,5,0,14
 skywalking-master\skywalking-master\oap-server\server-receiver-plugin\zipkin-receiver-plugin\src\main\java\org\apache\skywalking\oap\server\receiver\zipkin\handler\UnzippingBytesRequestConverter.java,0,8,1,6,0,15
 skywalking-master\skywalking-master\oap-server\server-core\src\main\java\org\apache\skywalking\oap\server\core\analysis\MultipleDisable.java,0,1,0,1,0,2
 skywalking-master\skywalking-master\oap-server\server-core\src\main\java\org\apache\skywalking\oap\server\core\query\type\BasicTrace.java,18,7,0,1,0,8
 skywalking-master\skywalking-master\oap-server\server-storage-plugin\storage-iotdb-plugin\src\main\java\org\apache\skywalking\oap\server\storage\plugin\iotdb\IoTDBStorageProvider.java,88,37,1,58,0,96
 skywalking-master\skywalking-master\oap-server\analyzer\agent-analyzer\src\main\java\org\apache\skywalking\oap\server\analyzer\provider\trace\parser\SegmentParserServiceImpl.java,13,6,0,2,0,8
 skywalking-master\skywalking-master\oap-server\server-receiver-plugin\skywalking-event-receiver-plugin\src\main\java\org\apache\skywalking\oap\server\receiver\event\EventModuleProvider.java,50,11,2,11,0,24
 skywalking-master\skywalking-master\oap-server\analyzer\agent-analyzer\src\main\java\org\apache\skywalking\oap\server\analyzer\provider\trace\parser\listener\strategy\FromSpanStatus.java,8,2,0,3,0,5
 skywalking-master\skywalking-master\oap-server\server-query-plugin\query-graphql-plugin\src\main\java\org\apache\skywalking\oap\query\graphql\resolver\Mutation.java,5,1,1,1,0,3
 skywalking-master\skywalking-master\oap-server\server-receiver-plugin\envoy-metrics-receiver-plugin\src\main\java\org\apache\skywalking\oap\server\receiver\envoy\persistence\LogsPersistence.java,56,12,0,7,0,19
 skywalking-master\skywalking-master\oap-server\server-core\src\test\java\org\apache\skywalking\oap\server\core\config\group\openapi\EndpointNameGroupingRule4OpenapiWatcherTest.java,229,180,3,16,0,199
 skywalking-master\skywalking-master\oap-server\analyzer\log-analyzer\src\test\java\org\apache\skywalking\oap\log\analyzer\dsl\DSLSecurityTest.java,97,42,0,7,0,49
 skywalking-master\skywalking-master\oap-server\server-core\src\test\java\org\apache\skywalking\oap\server\core\profiling\trace\analyze\ProfileStackAnalyzeHolder.java,6,1,0,1,0,2
 skywalking-master\skywalking-master\oap-server\analyzer\agent-analyzer\src\main\java\org\apache\skywalking\oap\server\analyzer\provider\trace\parser\listener\FirstAnalysisListener.java,0,2,0,3,0,5
 skywalking-master\skywalking-master\oap-server\server-library\library-server\src\main\java\org\apache\skywalking\oap\server\library\server\ssl\HTTPDynamicSslContext.java,39,17,0,7,0,24
 skywalking-master\skywalking-master\test\e2e-v2\java-test-service\e2e-service-provider\src\main\java\test\apache\skywalking\e2e\profile\CreateUser.java,9,5,0,1,0,6
 skywalking-master\skywalking-master\oap-server\analyzer\meter-analyzer\src\main\java\org\apache\skywalking\oap\meter\analyzer\dsl\EntityDescription\InstanceEntityDescription.java,13,7,1,2,0,10
 skywalking-master\skywalking-master\oap-server\server-library\library-module\src\main\java\org\apache\skywalking\oap\server\library\module\ServiceNotProvidedException.java,6,2,0,1,0,3
 skywalking-master\skywalking-master\oap-server\server-core\src\main\java\org\apache\skywalking\oap\server\core\analysis\manual\log\LogRecordDispatcher.java,24,1,0,2,0,3
 skywalking-master\skywalking-master\oap-server\server-core\src\main\java\org\apache\skywalking\oap\server\core\config\ComponentLibraryCatalogService.java,82,25,1,11,0,37
 skywalking-master\skywalking-master\oap-server\server-configuration\configuration-consul\src\test\java\org\apache\skywalking\oap\server\configuration\consul\ConsulConfigurationProviderTest.java,9,4,0,2,0,6
 skywalking-master\skywalking-master\oap-server\server-alarm-plugin\src\test\java\org\apache\skywalking\oap\server\core\alarm\provider\expression\ExpressionContextTest.java,28,6,1,1,0,8
 skywalking-master\skywalking-master\oap-server\server-library\library-elasticsearch-client\src\main\java\org\apache\skywalking\library\elasticsearch\response\Document.java,0,4,0,1,2,7
 skywalking-master\skywalking-master\oap-server\server-library\library-util\src\test\java\org\apache\skywalking\oap\server\library\util\StringUtilTest.java,53,16,0,5,0,21
 skywalking-master\skywalking-master\oap-server\server-library\library-elasticsearch-client\src\main\java\org\apache\skywalking\library\elasticsearch\client\AliasClient.java,0,9,2,3,3,17
 skywalking-master\skywalking-master\oap-server\server-core\src\main\java\org\apache\skywalking\oap\server\core\query\type\ProfileAnalyzation.java,14,3,0,1,0,4
 skywalking-master\skywalking-master\oap-server\server-alarm-plugin\src\main\java\org\apache\skywalking\oap\server\core\alarm\provider\Threshold.java,62,28,2,4,0,34
 skywalking-master\skywalking-master\apm-protocol\apm-network\src\main\java\org\apache\skywalking\oap\server\network\trace\component\command\UnsupportedCommandException.java,12,5,0,1,0,6
 skywalking-master\skywalking-master\oap-server\server-core\src\main\java\org\apache\skywalking\oap\server\core\source\ServiceInstanceRelation.java,98,36,1,13,0,50
 skywalking-master\skywalking-master\oap-server\server-core\src\main\java\org\apache\skywalking\oap\server\core\analysis\config\NoneStream.java,0,1,1,1,0,3
 skywalking-master\skywalking-master\oap-server\server-core\src\main\java\org\apache\skywalking\oap\server\core\analysis\metrics\P95Metrics.java,6,3,0,2,0,5
 skywalking-master\skywalking-master\oap-server\server-storage-plugin\storage-influxdb-plugin\src\main\java\org\apache\skywalking\oap\server\storage\plugin\influxdb\base\BatchDAO.java,30,11,0,3,0,14
 skywalking-master\skywalking-master\oap-server\server-tools\profile-exporter\tool-profile-snapshot-server-mock\src\main\java\org\apache\skywalking\oap\server\tool\profile\core\mock\MockHTTPHandlerRegister.java,6,2,1,1,0,4
 skywalking-master\skywalking-master\oap-server\server-core\src\main\java\org\apache\skywalking\oap\server\core\query\enumeration\Scope.java,0,15,2,3,0,20
 skywalking-master\skywalking-master\oap-server\server-receiver-plugin\skywalking-sharing-server-plugin\src\main\java\org\apache\skywalking\oap\server\receiver\sharing\server\ReceiverGRPCHandlerRegister.java,38,13,0,4,0,17
 skywalking-master\skywalking-master\oap-server\oal-rt\src\main\java\org\apache\skywalking\oal\rt\parser\DisableCollection.java,8,4,0,1,0,5
 skywalking-master\skywalking-master\oap-server\server-core\src\main\java\org\apache\skywalking\oap\server\core\analysis\metrics\CountMetrics.java,36,8,1,5,0,14
 skywalking-master\skywalking-master\oap-server\server-receiver-plugin\skywalking-profile-receiver-plugin\src\main\java\org\apache\skywalking\oap\server\receiver\profile\provider\handler\ProfileTaskServiceHandlerCompat.java,0,8,0,8,0,16
 skywalking-master\skywalking-master\oap-server\server-receiver-plugin\envoy-metrics-receiver-plugin\src\main\java\org\apache\skywalking\oap\server\receiver\envoy\als\Role.java,0,3,0,1,0,4
 skywalking-master\skywalking-master\oap-server\analyzer\log-analyzer\src\main\java\org\apache\skywalking\oap\log\analyzer\dsl\spec\parser\JsonParserSpec.java,17,6,0,3,0,9
 skywalking-master\skywalking-master\oap-server\server-receiver-plugin\skywalking-clr-receiver-plugin\src\main\java\org\apache\skywalking\oap\server\receiver\clr\provider\handler\CLRMetricReportServiceHandler.java,0,15,0,9,0,24
 skywalking-master\skywalking-master\oap-server\server-receiver-plugin\configuration-discovery-receiver-plugin\src\main\java\org\apache\skywalking\oap\server\recevier\configuration\discovery\AgentConfigurations.java,15,9,1,3,0,13
 skywalking-master\skywalking-master\oap-server\server-alarm-plugin\src\main\java\org\apache\skywalking\oap\server\core\alarm\provider\RulesReader.java,242,64,0,36,0,100
 skywalking-master\skywalking-master\oap-server\server-telemetry\telemetry-api\src\main\java\org\apache\skywalking\oap\server\telemetry\api\HealthCheckMetrics.java,27,9,0,1,1,11
 skywalking-master\skywalking-master\oap-server\server-tools\profile-exporter\tool-profile-snapshot-bootstrap\src\main\java\org\apache\skywalking\oap\server\tool\profile\exporter\ExporterConfig.java,44,12,0,3,0,15
 skywalking-master\skywalking-master\oap-server\server-library\library-elasticsearch-client\src\main\java\org\apache\skywalking\library\elasticsearch\requests\factory\common\CommonSearchFactory.java,0,6,0,3,2,11
 skywalking-master\skywalking-master\oap-server\server-core\src\test\java\org\apache\skywalking\oap\server\core\management\ui\template\UITemplateTest.java,21,4,0,3,0,7
 skywalking-master\skywalking-master\oap-server\analyzer\meter-analyzer\src\main\java\org\apache\skywalking\oap\meter\analyzer\Analyzer.java,250,56,5,41,0,102
 skywalking-master\skywalking-master\oap-server\server-alarm-plugin\src\test\java\org\apache\skywalking\oap\server\core\alarm\provider\welink\WeLinkHookCallbackTest.java,63,16,0,11,0,27
 skywalking-master\skywalking-master\oap-server\server-configuration\configuration-etcd\src\test\java\org\apache\skywalking\oap\server\configuration\etcd\ITEtcdConfigurationTest.java,142,48,7,32,0,87
 skywalking-master\skywalking-master\oap-server\server-configuration\configuration-etcd\src\main\java\org\apache\skywalking\oap\server\configuration\etcd\EtcdConfigWatcherRegister.java,80,21,0,17,0,38
 skywalking-master\skywalking-master\oap-server\server-core\src\main\java\org\apache\skywalking\oap\server\core\browser\source\BrowserAppPerf.java,12,4,0,5,0,9
 skywalking-master\skywalking-master\oap-server\server-storage-plugin\storage-elasticsearch-plugin\src\main\java\org\apache\skywalking\oap\server\storage\plugin\elasticsearch\query\EBPFProfilingDataEsDAO.java,44,22,0,21,0,43
 skywalking-master\skywalking-master\oap-server\server-receiver-plugin\skywalking-trace-receiver-plugin\src\test\java\org\apache\skywalking\oap\server\receiver\trace\mock\ServiceBMock.java,0,45,0,9,0,54
 skywalking-master\skywalking-master\oap-server\server-receiver-plugin\envoy-metrics-receiver-plugin\src\main\java\org\apache\skywalking\oap\server\receiver\envoy\ServiceMetaInfoFactoryImpl.java,19,5,0,3,0,8
 skywalking-master\skywalking-master\oap-server\server-receiver-plugin\skywalking-trace-receiver-plugin\src\test\java\org\apache\skywalking\oap\server\receiver\trace\provider\parser\listener\RPCAnalysisListenerTest.java,410,110,4,91,0,205
 skywalking-master\skywalking-master\oap-server\server-library\library-datacarrier-queue\src\main\java\org\apache\skywalking\oap\server\library\datacarrier\consumer\ConsumeDriver.java,110,42,3,8,0,53
 skywalking-master\skywalking-master\oap-server\server-core\src\main\java\org\apache\skywalking\oap\server\core\source\GCPhase.java,0,3,0,1,0,4
 skywalking-master\skywalking-master\oap-server\server-library\library-elasticsearch-client\src\main\java\org\apache\skywalking\library\elasticsearch\requests\factory\v7\codec\V7IndexTemplatesDeserializer.java,0,4,0,4,0,8
 skywalking-master\skywalking-master\oap-server\server-core\src\main\java\org\apache\skywalking\oap\server\core\analysis\meter\function\avg\AvgHistogramPercentileFunction.java,0,75,2,40,0,117
 skywalking-master\skywalking-master\oap-server\oal-rt\src\main\java\org\apache\skywalking\oal\rt\parser\EntryMethod.java,45,21,0,4,0,25
 skywalking-master\skywalking-master\oap-server\server-storage-plugin\storage-jdbc-hikaricp-plugin\src\main\java\org\apache\skywalking\oap\server\storage\plugin\jdbc\h2\dao\H2EBPFProfilingTaskDAO.java,111,43,0,29,0,72
 skywalking-master\skywalking-master\oap-server\server-core\src\main\java\org\apache\skywalking\oap\server\core\analysis\worker\PersistenceWorker.java,0,12,1,6,0,19
 skywalking-master\skywalking-master\oap-server\server-library\library-elasticsearch-client\src\main\java\org\apache\skywalking\library\elasticsearch\requests\factory\v6\codec\V6Codec.java,0,8,0,6,0,14
 skywalking-master\skywalking-master\oap-server\server-library\library-elasticsearch-client\src\main\java\org\apache\skywalking\library\elasticsearch\requests\factory\v6\V6TemplateFactory.java,0,10,0,6,0,16
 skywalking-master\skywalking-master\oap-server\server-storage-plugin\storage-elasticsearch-plugin\src\main\java\org\apache\skywalking\oap\server\storage\plugin\elasticsearch\base\ManagementEsDAO.java,25,12,0,6,0,18
 skywalking-master\skywalking-master\oap-server\server-library\library-elasticsearch-client\src\main\java\org\apache\skywalking\library\elasticsearch\client\TemplateClient.java,0,23,2,9,2,36
 skywalking-master\skywalking-master\oap-server\server-library\library-util\src\main\java\org\apache\skywalking\oap\server\library\util\ResourceUtils.java,78,28,1,14,4,47
 skywalking-master\skywalking-master\oap-server\server-core\src\main\java\org\apache\skywalking\oap\server\core\analysis\manual\instance\InstanceTraffic.java,146,37,1,13,0,51
 skywalking-master\skywalking-master\oap-server\server-core\src\main\java\org\apache\skywalking\oap\server\core\storage\annotation\SuperDataset.java,0,1,0,2,0,3
 skywalking-master\skywalking-master\test\e2e-v2\java-test-service\e2e-mock-sender\src\main\java\org\apache\skywalking\e2e\E2EConfiguration.java,5,3,0,1,0,4
 skywalking-master\skywalking-master\oap-server\server-receiver-plugin\envoy-metrics-receiver-plugin\src\test\java\org\apache\skywalking\oap\server\receiver\envoy\ClusterManagerMetricsAdapterTest.java,46,23,0,16,0,39
 skywalking-master\skywalking-master\oap-server\server-core\src\main\java\org\apache\skywalking\oap\server\core\query\input\TopNCondition.java,0,7,0,4,0,11
 skywalking-master\skywalking-master\oap-server\server-core\src\test\java\org\apache\skywalking\oap\server\core\config\ComponentLibraryCatalogFileTest.java,11,8,0,2,0,10
 skywalking-master\skywalking-master\oap-server\server-starter\src\main\java\org\apache\skywalking\oap\server\starter\OAPServerStartUp.java,6,3,1,1,0,5
 skywalking-master\skywalking-master\oap-server\server-alarm-plugin\src\main\java\org\apache\skywalking\oap\server\core\alarm\provider\wechat\WechatSettings.java,8,2,0,1,0,3
 skywalking-master\skywalking-master\oap-server\server-core\src\main\java\org\apache\skywalking\oap\server\core\analysis\worker\RecordPersistentWorker.java,26,15,1,5,0,21
 skywalking-master\skywalking-master\oap-server\server-library\library-datacarrier-queue\src\main\java\org\apache\skywalking\oap\server\library\datacarrier\consumer\ConsumerPoolFactory.java,0,8,0,2,0,10
 skywalking-master\skywalking-master\oap-server\server-receiver-plugin\skywalking-zabbix-receiver-plugin\src\main\java\org\apache\skywalking\oap\server\receiver\zabbix\provider\config\ZabbixConfig.java,34,15,0,1,0,16
 skywalking-master\skywalking-master\oap-server\server-core\src\test\java\org\apache\skywalking\oap\server\core\analysis\metrics\PercentileMetricsTest.java,127,55,1,5,0,61
 skywalking-master\skywalking-master\oap-server\server-library\library-elasticsearch-client\src\main\java\org\apache\skywalking\library\elasticsearch\requests\search\Sort.java,0,7,0,1,0,8
 skywalking-master\skywalking-master\oap-server\server-library\library-elasticsearch-client\src\main\java\org\apache\skywalking\library\elasticsearch\requests\search\aggregation\AvgAggregation.java,0,6,0,3,0,9
 skywalking-master\skywalking-master\oap-server\server-core\src\main\java\org\apache\skywalking\oap\server\core\query\input\TraceScopeCondition.java,7,3,0,1,0,4
 skywalking-master\skywalking-master\oap-server\analyzer\event-analyzer\src\main\java\org\apache\skywalking\oap\server\analyzer\event\listener\EventRecordAnalyzerListener.java,61,18,0,10,0,28
 skywalking-master\skywalking-master\oap-server\server-core\src\test\java\org\apache\skywalking\oap\server\core\CoreModuleConfigTest.java,21,10,0,7,0,17
 skywalking-master\skywalking-master\oap-server\server-core\src\main\java\org\apache\skywalking\oap\server\core\query\type\HealthStatus.java,6,2,0,1,0,3
 skywalking-master\skywalking-master\oap-server\server-core\src\main\java\org\apache\skywalking\oap\server\core\storage\StorageModule.java,37,5,0,11,0,16
 skywalking-master\skywalking-master\oap-server\server-core\src\test\java\org\apache\skywalking\oap\server\core\analysis\metrics\LongAvgMetricsTest.java,61,18,1,1,0,20
 skywalking-master\skywalking-master\oap-server\server-core\src\test\java\org\apache\skywalking\oap\server\core\analysis\metrics\expression\LikeMatchTest.java,15,1,0,1,0,2
 skywalking-master\skywalking-master\oap-server\server-library\library-elasticsearch-client\src\main\java\org\apache\skywalking\library\elasticsearch\bulk\BulkProcessor.java,0,22,2,9,1,34
 skywalking-master\skywalking-master\oap-server\server-storage-plugin\storage-influxdb-plugin\src\main\java\org\apache\skywalking\oap\server\storage\plugin\influxdb\base\HistoryDeleteDAO.java,22,12,1,5,0,18
 skywalking-master\skywalking-master\oap-server\server-library\library-datacarrier-queue\src\main\java\org\apache\skywalking\oap\server\library\datacarrier\partition\ProducerThreadPartitioner.java,15,7,2,1,0,10
 skywalking-master\skywalking-master\oap-server\server-core\src\main\java\org\apache\skywalking\oap\server\core\analysis\SourceDispatcher.java,0,4,1,4,0,9
 skywalking-master\skywalking-master\oap-server\server-receiver-plugin\envoy-metrics-receiver-plugin\src\main\java\org\apache\skywalking\oap\server\receiver\envoy\als\k8s\KubernetesNodeRegistry.java,0,4,0,2,0,6
 skywalking-master\skywalking-master\oap-server\server-core\src\main\java\org\apache\skywalking\oap\server\core\RunningMode.java,32,5,2,1,0,8
 skywalking-master\skywalking-master\oap-server\server-receiver-plugin\skywalking-browser-receiver-plugin\src\main\java\org\apache\skywalking\oap\server\receiver\browser\provider\parser\performance\listener\SourceBuilder.java,0,32,0,9,0,41
 skywalking-master\skywalking-master\oap-server\server-library\library-util\src\main\java\org\apache\skywalking\oap\server\library\util\StringFormatGroup.java,63,18,0,2,0,20
 skywalking-master\skywalking-master\oap-server\server-core\src\main\java\org\apache\skywalking\oap\server\core\analysis\StreamProcessor.java,0,3,1,2,0,6
 skywalking-master\skywalking-master\oap-server\server-core\src\test\java\org\apache\skywalking\oap\server\core\remote\client\GRPCRemoteClientRealClient.java,68,23,3,4,0,30
 skywalking-master\skywalking-master\oap-server\server-library\library-elasticsearch-client\src\main\java\org\apache\skywalking\library\elasticsearch\requests\factory\v7\V7IndexFactory.java,0,15,0,8,0,23
 skywalking-master\skywalking-master\oap-server\server-cluster-plugin\cluster-consul-plugin\src\main\java\org\apache\skywalking\oap\server\cluster\plugin\consul\ConsulCoordinator.java,0,25,5,12,0,42
 skywalking-master\skywalking-master\oap-server\server-core\src\test\java\org\apache\skywalking\oap\server\core\storage\BlockingBatchQueueWithLinkedBlockingQueue.java,47,17,1,3,0,21
 skywalking-master\skywalking-master\oap-server\server-core\src\main\java\org\apache\skywalking\oap\server\core\cluster\OAPNodeChecker.java,42,19,2,11,0,32
 skywalking-master\skywalking-master\oap-server\server-storage-plugin\storage-jdbc-hikaricp-plugin\src\main\java\org\apache\skywalking\oap\server\storage\plugin\jdbc\mysql\MySQLLogQueryDAO.java,19,8,0,4,0,12
 skywalking-master\skywalking-master\oap-server\server-tools\profile-exporter\tool-profile-snapshot-bootstrap\src\test\java\org\apache\skywalking\oap\server\tool\profile\exporter\ProfileExportedAnalyze.java,117,25,3,15,0,43
 skywalking-master\skywalking-master\oap-server\server-configuration\configuration-api\src\test\java\org\apache\skywalking\oap\server\configuration\api\ConfigWatcherRegisterTest.java,176,43,6,23,7,79
 skywalking-master\skywalking-master\test\e2e-v2\java-test-service\e2e-service-provider\src\main\java\org\apache\skywalking\e2e\controller\UserController.java,36,16,4,5,0,25
 skywalking-master\skywalking-master\oap-server\server-core\src\main\java\org\apache\skywalking\oap\server\core\query\type\EBPFProfilingAnalyzation.java,5,4,0,1,0,5
 skywalking-master\skywalking-master\oap-server\server-library\library-elasticsearch-client\src\main\java\org\apache\skywalking\library\elasticsearch\requests\search\aggregation\BucketOrder.java,0,5,0,1,0,6
 skywalking-master\skywalking-master\oap-server\server-cluster-plugin\cluster-zookeeper-plugin\src\main\java\org\apache\skywalking\oap\server\cluster\plugin\zookeeper\ClusterModuleZookeeperProvider.java,106,26,6,15,0,47
 skywalking-master\skywalking-master\oap-server\server-alarm-plugin\src\test\java\org\apache\skywalking\oap\server\core\alarm\provider\NotifyHandlerTest.java,286,62,4,49,0,115
 skywalking-master\skywalking-master\oap-server\exporter\src\test\java\org\apache\skywalking\oap\server\exporter\provider\grpc\MockMetricExportServiceImpl.java,0,9,0,7,0,16
 skywalking-master\skywalking-master\oap-server\server-core\src\main\java\org\apache\skywalking\oap\server\core\storage\ComparableStorageData.java,0,0,0,1,0,1
 skywalking-master\skywalking-master\oap-server\server-core\src\main\java\org\apache\skywalking\oap\server\core\storage\profiling\trace\IProfileTaskLogQueryDAO.java,0,4,0,1,0,5
 skywalking-master\skywalking-master\oap-server\server-core\src\test\java\org\apache\skywalking\oap\server\core\remote\HTTPServerTest.java,85,26,1,9,0,36
 skywalking-master\skywalking-master\oap-server\server-core\src\main\java\org\apache\skywalking\oap\server\core\alarm\ServiceInstanceRelationMetaInAlarm.java,33,9,0,3,0,12
 skywalking-master\skywalking-master\oap-server\server-alarm-plugin\src\main\java\org\apache\skywalking\oap\server\core\alarm\provider\AlarmCore.java,57,26,3,12,0,41
 skywalking-master\skywalking-master\oap-server\server-core\src\main\java\org\apache\skywalking\oap\server\core\query\input\DashboardSetting.java,14,4,0,1,0,5
 skywalking-master\skywalking-master\oap-server\server-storage-plugin\storage-influxdb-plugin\src\main\java\org\apache\skywalking\oap\server\storage\plugin\influxdb\InfluxClient.java,0,70,6,27,0,103
 skywalking-master\skywalking-master\oap-server\server-library\library-server\src\main\java\org\apache\skywalking\oap\server\library\server\Server.java,0,3,0,1,0,4
 skywalking-master\skywalking-master\oap-server\oal-rt\src\main\java\org\apache\skywalking\oal\rt\parser\MetricsHolder.java,35,11,2,7,0,20
 skywalking-master\skywalking-master\oap-server\server-core\src\main\java\org\apache\skywalking\oap\server\core\profiling\ebpf\storage\EBPFProcessProfilingDataDispatcher.java,15,6,0,4,0,10
 skywalking-master\skywalking-master\oap-server\server-library\library-elasticsearch-client\src\main\java\org\apache\skywalking\library\elasticsearch\ElasticSearchVersion.java,0,21,2,11,0,34
 skywalking-master\skywalking-master\oap-server\server-core\src\main\java\org\apache\skywalking\oap\server\core\profiling\trace\analyze\ProfileStack.java,42,13,3,2,0,18
 skywalking-master\skywalking-master\oap-server\server-core\src\main\java\org\apache\skywalking\oap\server\core\query\sql\GroupBy.java,5,2,0,1,0,3
 skywalking-master\skywalking-master\oap-server\server-receiver-plugin\skywalking-sharing-server-plugin\src\main\java\org\apache\skywalking\oap\server\receiver\sharing\server\ReceiverHTTPHandlerRegister.java,11,3,0,1,0,4
 skywalking-master\skywalking-master\oap-server\server-core\src\main\java\org\apache\skywalking\oap\server\core\analysis\meter\function\avg\AvgHistogramFunction.java,168,46,2,19,0,67
 skywalking-master\skywalking-master\oap-server\server-core\src\main\java\org\apache\skywalking\oap\server\core\query\enumeration\Language.java,0,12,0,1,0,13
 skywalking-master\skywalking-master\oap-server\server-tools\profile-exporter\tool-profile-snapshot-bootstrap\src\main\java\org\apache\skywalking\oap\server\tool\profile\exporter\ProfileSnapshotExporterBootstrap.java,36,10,5,8,0,23
 skywalking-master\skywalking-master\oap-server\server-core\src\main\java\org\apache\skywalking\oap\server\core\analysis\manual\endpoint\EndpointTrafficDispatcher.java,12,1,0,2,0,3
 skywalking-master\skywalking-master\oap-server\server-storage-plugin\storage-influxdb-plugin\src\main\java\org\apache\skywalking\oap\server\storage\plugin\influxdb\InfluxStorageProvider.java,90,35,1,55,0,91
 skywalking-master\skywalking-master\oap-server\server-core\src\main\java\org\apache\skywalking\oap\server\core\analysis\worker\TopNStreamProcessor.java,57,31,0,16,0,47
 skywalking-master\skywalking-master\oap-server\server-core\src\test\java\org\apache\skywalking\oap\server\core\analysis\IDManagerTest.java,30,6,0,5,0,11
 skywalking-master\skywalking-master\oap-server\analyzer\meter-analyzer\src\test\java\org\apache\skywalking\oap\meter\analyzer\dsl\K8sTagTest.java,247,53,1,28,0,82
 skywalking-master\skywalking-master\oap-server\server-configuration\configuration-apollo\src\main\java\org\apache\skywalking\oap\server\configuration\apollo\ApolloConfigurationCenterSettings.java,11,9,0,1,0,10
 skywalking-master\skywalking-master\oap-server\server-core\src\main\java\org\apache\skywalking\oap\server\core\analysis\meter\ScopeType.java,0,7,0,1,0,8
 skywalking-master\skywalking-master\oap-server\server-query-plugin\query-graphql-plugin\src\main\java\org\apache\skywalking\oap\query\graphql\resolver\TraceQuery.java,48,15,0,7,0,22
 skywalking-master\skywalking-master\oap-server\analyzer\log-analyzer\src\main\java\org\apache\skywalking\oap\log\analyzer\dsl\spec\sink\SamplerSpec.java,55,13,4,7,0,24
 skywalking-master\skywalking-master\oap-server\server-tools\profile-exporter\tool-profile-snapshot-server-mock\src\main\java\org\apache\skywalking\oap\server\tool\profile\core\mock\MockGRPCHandlerRegister.java,14,4,3,1,0,8
 skywalking-master\skywalking-master\oap-server\analyzer\meter-analyzer\src\main\java\org\apache\skywalking\oap\meter\analyzer\dsl\Sample.java,23,17,0,3,0,20
 skywalking-master\skywalking-master\oap-server\server-library\library-client\src\main\java\org\apache\skywalking\oap\server\library\client\jdbc\hikaricp\JDBCHikariCPClient.java,0,38,4,9,11,62
 skywalking-master\skywalking-master\apm-webapp\src\test\java\org\apache\skywalking\oap\server\webapp\ApplicationContextTest.java,8,3,1,1,0,5
 skywalking-master\skywalking-master\oap-server\server-receiver-plugin\zipkin-receiver-plugin\src\main\java\org\apache\skywalking\oap\server\receiver\zipkin\ZipkinReceiverConfig.java,11,11,0,1,0,12
 skywalking-master\skywalking-master\oap-server\oal-rt\src\main\java\org\apache\skywalking\oal\rt\parser\SourceColumn.java,75,38,2,6,0,46
 skywalking-master\skywalking-master\oap-server\server-storage-plugin\storage-jdbc-hikaricp-plugin\src\main\java\org\apache\skywalking\oap\server\storage\plugin\jdbc\h2\dao\H2EventQueryDAO.java,166,36,6,27,0,69
 skywalking-master\skywalking-master\oap-server\server-library\library-elasticsearch-client\src\main\java\org\apache\skywalking\library\elasticsearch\requests\search\aggregation\SumAggregationBuilder.java,0,7,0,1,0,8
 skywalking-master\skywalking-master\oap-server\server-core\src\main\java\org\apache\skywalking\oap\server\core\config\group\EndpointGroupingRule.java,30,12,0,6,0,18
 skywalking-master\skywalking-master\oap-server\analyzer\meter-analyzer\src\test\java\org\apache\skywalking\oap\meter\analyzer\dsl\ArithmeticTest.java,452,166,1,67,0,234
 skywalking-master\skywalking-master\oap-server\server-library\library-elasticsearch-client\src\main\java\org\apache\skywalking\library\elasticsearch\requests\search\SearchBuilder.java,0,23,1,3,0,27
 skywalking-master\skywalking-master\oap-server\analyzer\log-analyzer\src\main\java\org\apache\skywalking\oap\log\analyzer\dsl\spec\parser\TextParserSpec.java,32,8,0,2,0,10
 skywalking-master\skywalking-master\oap-server\server-library\library-elasticsearch-client\src\main\java\org\apache\skywalking\library\elasticsearch\requests\search\RangeQuery.java,0,15,0,7,0,22
 skywalking-master\skywalking-master\oap-server\server-receiver-plugin\envoy-metrics-receiver-plugin\src\main\java\org\apache\skywalking\oap\server\receiver\envoy\EnvoyMetricReceiverProvider.java,72,19,1,12,0,32
 skywalking-master\skywalking-master\oap-server\analyzer\log-analyzer\src\main\java\org\apache\skywalking\oap\log\analyzer\provider\LogAnalyzerModuleConfig.java,36,11,0,3,0,14
 skywalking-master\skywalking-master\oap-server\server-core\src\main\java\org\apache\skywalking\oap\server\core\config\NamingControl.java,87,26,0,19,0,45
 skywalking-master\skywalking-master\oap-server\server-storage-plugin\storage-jdbc-hikaricp-plugin\src\main\java\org\apache\skywalking\oap\server\storage\plugin\jdbc\h2\H2StorageConfig.java,49,17,0,7,0,24
 skywalking-master\skywalking-master\oap-server\server-core\src\main\java\org\apache\skywalking\oap\server\core\query\type\HeatMap.java,132,31,0,8,0,39
 skywalking-master\skywalking-master\oap-server\server-health-checker\src\main\java\org\apache\skywalking\oap\server\health\checker\provider\HealthQueryService.java,12,4,0,1,0,5
 skywalking-master\skywalking-master\oap-server\server-core\src\test\java\org\apache\skywalking\oap\server\core\analysis\TimeBucketTest.java,47,13,2,2,0,17
 skywalking-master\skywalking-master\oap-server\server-configuration\configuration-k8s-configmap\src\main\java\org\apache\skywalking\oap\server\configuration\configmap\ConfigmapConfigurationSettings.java,15,3,0,1,0,4
 skywalking-master\skywalking-master\oap-server\server-core\src\main\java\org\apache\skywalking\oap\server\core\profiling\ebpf\storage\EBPFProfilingScheduleRecord.java,96,36,1,16,0,53
 skywalking-master\skywalking-master\oap-server\server-receiver-plugin\envoy-metrics-receiver-plugin\src\main\java\org\apache\skywalking\oap\server\receiver\envoy\als\AccessLogAnalyzer.java,0,12,2,6,0,20
 skywalking-master\skywalking-master\oap-server\server-storage-plugin\storage-elasticsearch-plugin\src\main\java\org\apache\skywalking\oap\server\storage\plugin\elasticsearch\query\MetricsQueryEsDAO.java,227,45,1,40,0,86
 skywalking-master\skywalking-master\oap-server\server-core\src\main\java\org\apache\skywalking\oap\server\core\browser\source\BrowserAppSingleVersionPerf.java,25,8,0,6,0,14
 skywalking-master\skywalking-master\oap-server\server-core\src\main\java\org\apache\skywalking\oap\server\core\logging\log4j\OapConfigurationFactory.java,27,4,0,4,0,8
 skywalking-master\skywalking-master\oap-server\server-alarm-plugin\src\test\java\org\apache\skywalking\oap\server\core\alarm\provider\RunningRuleTest.java,563,182,19,42,0,243
 skywalking-master\skywalking-master\oap-server\server-core\src\main\java\org\apache\skywalking\oap\server\core\query\ServiceInstanceTopologyBuilder.java,121,32,0,26,0,58
 skywalking-master\skywalking-master\oap-server\analyzer\log-analyzer\src\main\java\org\apache\skywalking\oap\log\analyzer\provider\log\listener\RecordAnalysisListener.java,104,24,2,12,0,38
 skywalking-master\skywalking-master\oap-server\server-core\src\main\java\org\apache\skywalking\oap\server\core\query\BrowserLogQueryService.java,34,9,0,7,0,16
 skywalking-master\skywalking-master\oap-server\server-core\src\main\java\org\apache\skywalking\oap\server\core\analysis\metrics\annotation\Arg.java,0,1,0,1,0,2
 skywalking-master\skywalking-master\oap-server\analyzer\meter-analyzer\src\main\java\org\apache\skywalking\oap\meter\analyzer\dsl\ExpressionParsingException.java,6,1,0,1,0,2
 skywalking-master\skywalking-master\oap-server\oal-rt\src\main\java\org\apache\skywalking\oal\rt\parser\PersistenceField.java,14,9,0,1,0,10
 skywalking-master\skywalking-master\oap-server\server-storage-plugin\storage-influxdb-plugin\src\main\java\org\apache\skywalking\oap\server\storage\plugin\influxdb\base\InfluxInsertRequest.java,0,26,0,8,0,34
 skywalking-master\skywalking-master\oap-server\server-library\library-util\src\main\java\org\apache\skywalking\oap\server\library\util\prometheus\parser\TextParser.java,97,14,2,5,1,22
 skywalking-master\skywalking-master\oap-server\server-core\src\main\java\org\apache\skywalking\oap\server\core\config\group\openapi\EndpointNameGroupingRule4OpenapiWatcher.java,33,14,0,8,0,22
 skywalking-master\skywalking-master\oap-server\server-storage-plugin\storage-influxdb-plugin\src\main\java\org\apache\skywalking\oap\server\storage\plugin\influxdb\InfluxTableInstaller.java,18,4,0,1,0,5
 skywalking-master\skywalking-master\oap-server\server-core\src\main\java\org\apache\skywalking\oap\server\core\profiling\trace\ProfileTaskMutationService.java,116,21,0,21,0,42
 skywalking-master\skywalking-master\apm-webapp\src\main\java\org\apache\skywalking\oap\server\webapp\ApplicationStartUp.java,6,4,1,1,0,6
 skywalking-master\skywalking-master\oap-server\server-core\src\main\java\org\apache\skywalking\oap\server\core\profiling\ebpf\storage\EBPFProcessProfilingScheduleDispatcher.java,13,6,0,6,0,12
 skywalking-master\skywalking-master\oap-server\server-core\src\main\java\org\apache\skywalking\oap\server\core\remote\selector\Selector.java,0,3,0,1,0,4
 skywalking-master\skywalking-master\oap-server\server-storage-plugin\storage-iotdb-plugin\src\main\java\org\apache\skywalking\oap\server\storage\plugin\iotdb\query\IoTDBMetricsQueryDAO.java,224,49,5,35,0,89
 skywalking-master\skywalking-master\oap-server\server-receiver-plugin\skywalking-trace-receiver-plugin\src\main\java\org\apache\skywalking\oap\server\receiver\trace\provider\handler\v8\grpc\TraceSegmentReportServiceHandlerCompat.java,0,6,0,6,0,12
 skywalking-master\skywalking-master\oap-server\server-core\src\main\java\org\apache\skywalking\oap\server\core\alarm\AlarmCallback.java,0,3,0,2,0,5
 skywalking-master\skywalking-master\oap-server\server-core\src\main\java\org\apache\skywalking\oap\server\core\storage\query\ITopologyQueryDAO.java,0,58,0,25,0,83
 skywalking-master\skywalking-master\oap-server\server-core\src\main\java\org\apache\skywalking\oap\server\core\query\type\EBPFProfilingSchedule.java,9,7,0,1,0,8
 skywalking-master\skywalking-master\oap-server\analyzer\agent-analyzer\src\main\java\org\apache\skywalking\oap\server\analyzer\provider\meter\config\MeterConfigs.java,38,9,1,3,0,13
 skywalking-master\skywalking-master\oap-server\server-library\library-module\src\test\java\org\apache\skywalking\oap\server\library\module\ApplicationConfigurationTest.java,20,7,0,6,0,13
 skywalking-master\skywalking-master\oap-server\server-core\src\main\java\org\apache\skywalking\oap\server\core\analysis\manual\log\LogRecord.java,34,8,0,4,0,12
 skywalking-master\skywalking-master\oap-server\server-starter\src\test\java\org\apache\skywalking\oap\server\starter\UITemplateCheckerTest.java,38,8,0,8,0,16
 skywalking-master\skywalking-master\oap-server\server-receiver-plugin\envoy-metrics-receiver-plugin\src\main\java\org\apache\skywalking\oap\server\receiver\envoy\als\k8s\ServiceNameFormatter.java,44,10,1,5,0,16
 skywalking-master\skywalking-master\oap-server\server-storage-plugin\storage-elasticsearch-plugin\src\test\java\org\apache\skywalking\oap\server\storage\plugin\elasticsearch\base\AnalyzerSettingTest.java,153,13,21,10,0,44
 skywalking-master\skywalking-master\oap-server\server-library\library-elasticsearch-client\src\main\java\org\apache\skywalking\library\elasticsearch\requests\factory\BulkFactory.java,0,3,0,2,0,5
 skywalking-master\skywalking-master\oap-server\analyzer\meter-analyzer\src\main\java\org\apache\skywalking\oap\meter\analyzer\dsl\tagOpt\Retag.java,0,3,1,2,0,6
 skywalking-master\skywalking-master\oap-server\oal-rt\src\main\java\org\apache\skywalking\oal\rt\util\TypeCastUtil.java,24,5,1,3,0,9
 skywalking-master\skywalking-master\oap-server\server-core\src\main\java\org\apache\skywalking\oap\server\core\profiling\ebpf\EBPFProfilingQueryService.java,117,38,0,27,0,65
 skywalking-master\skywalking-master\oap-server\server-library\library-module\src\main\java\org\apache\skywalking\oap\server\library\module\ProviderNotFoundException.java,10,4,0,1,0,5
 skywalking-master\skywalking-master\oap-server\server-core\src\main\java\org\apache\skywalking\oap\server\core\analysis\ConfigurationDictionary.java,0,0,0,1,0,1
 skywalking-master\skywalking-master\oap-server\oal-rt\src\main\java\org\apache\skywalking\oal\rt\parser\FilterMatchers.java,0,17,0,15,0,32
 skywalking-master\skywalking-master\oap-server\server-receiver-plugin\skywalking-zabbix-receiver-plugin\src\main\java\org\apache\skywalking\oap\server\receiver\zabbix\provider\protocol\ZabbixProtocolEncoder.java,29,16,0,7,0,23
 skywalking-master\skywalking-master\oap-server\server-receiver-plugin\skywalking-browser-receiver-plugin\src\main\java\org\apache\skywalking\oap\server\receiver\browser\provider\parser\errorlog\listener\MultiScopesErrorLogAnalysisListener.java,53,24,1,18,0,43
 skywalking-master\skywalking-master\oap-server\server-storage-plugin\storage-elasticsearch-plugin\src\main\java\org\apache\skywalking\oap\server\storage\plugin\elasticsearch\base\NoneStreamEsDAO.java,21,13,0,6,0,19
 skywalking-master\skywalking-master\oap-server\server-library\library-elasticsearch-client\src\main\java\org\apache\skywalking\library\elasticsearch\requests\search\BoolQuery.java,0,14,0,2,0,16
 skywalking-master\skywalking-master\oap-server\server-storage-plugin\storage-iotdb-plugin\src\main\java\org\apache\skywalking\oap\server\storage\plugin\iotdb\IoTDBTableMetaInfo.java,89,17,0,10,0,27
 skywalking-master\skywalking-master\oap-server\server-receiver-plugin\otel-receiver-plugin\src\main\java\org\apache\skywalking\oap\server\receiver\otel\OtelMetricReceiverConfig.java,39,9,2,3,0,14
 skywalking-master\skywalking-master\oap-server\server-core\src\test\java\org\apache\skywalking\oap\server\core\analysis\metrics\ApdexMetricsTest.java,110,44,2,1,0,47
 skywalking-master\skywalking-master\oap-server\server-query-plugin\query-graphql-plugin\src\main\java\org\apache\skywalking\oap\query\graphql\resolver\TopologyQuery.java,56,32,0,14,0,46
 skywalking-master\skywalking-master\oap-server\analyzer\log-analyzer\src\main\java\org\apache\skywalking\oap\log\analyzer\dsl\spec\sink\SinkSpec.java,37,8,0,1,0,9
 skywalking-master\skywalking-master\oap-server\server-core\src\main\java\org\apache\skywalking\oap\server\core\alarm\ServiceRelationMetaInAlarm.java,29,9,0,3,0,12
 skywalking-master\skywalking-master\oap-server\analyzer\log-analyzer\src\main\java\org\apache\skywalking\oap\log\analyzer\dsl\spec\AbstractSpec.java,22,11,0,2,0,13
 skywalking-master\skywalking-master\oap-server\server-telemetry\telemetry-api\src\main\java\org\apache\skywalking\oap\server\telemetry\TelemetryModule.java,16,5,0,1,0,6
 skywalking-master\skywalking-master\oap-server\server-telemetry\telemetry-prometheus\src\main\java\org\apache\skywalking\oap\server\telemetry\prometheus\PrometheusConfig.java,8,6,1,1,0,8
 skywalking-master\skywalking-master\oap-server\server-core\src\main\java\org\apache\skywalking\oap\server\core\browser\source\BrowserAppTrafficSource.java,14,8,2,2,0,12
 skywalking-master\skywalking-master\oap-server\server-core\src\test\java\org\apache\skywalking\oap\server\core\analysis\metrics\MaxLongMetricsTest.java,60,16,1,1,0,18
 skywalking-master\skywalking-master\oap-server\server-fetcher-plugin\prometheus-fetcher-plugin\src\main\java\org\apache\skywalking\oap\server\fetcher\prometheus\provider\PrometheusFetcherConfig.java,20,9,1,3,0,13
 skywalking-master\skywalking-master\oap-server\server-core\src\test\java\org\apache\skywalking\oap\server\core\analysis\manual\service\ServiceTrafficTest.java,24,6,0,4,0,10
 skywalking-master\skywalking-master\oap-server\server-cluster-plugin\cluster-zookeeper-plugin\src\main\java\org\apache\skywalking\oap\server\cluster\plugin\zookeeper\SWInstanceSerializer.java,16,9,0,5,0,14
 skywalking-master\skywalking-master\oap-server\server-telemetry\telemetry-prometheus\src\main\java\org\apache\skywalking\oap\server\telemetry\prometheus\PrometheusGaugeMetrics.java,0,20,0,5,0,25
 skywalking-master\skywalking-master\oap-server\server-receiver-plugin\skywalking-zabbix-receiver-plugin\src\main\java\org\apache\skywalking\oap\server\receiver\zabbix\provider\protocol\ZabbixProtocolHandler.java,48,15,0,10,0,25
 skywalking-master\skywalking-master\oap-server\server-core\src\main\java\org\apache\skywalking\oap\server\core\analysis\meter\function\avg\AvgFunction.java,0,45,0,18,0,63
 skywalking-master\skywalking-master\oap-server\server-receiver-plugin\zipkin-receiver-plugin\src\main\java\org\apache\skywalking\oap\server\receiver\zipkin\ZipkinReceiverModule.java,13,6,0,4,0,10
 skywalking-master\skywalking-master\oap-server\server-library\library-elasticsearch-client\src\main\java\org\apache\skywalking\library\elasticsearch\requests\search\BoolQueryBuilder.java,0,16,1,1,0,18
 skywalking-master\skywalking-master\oap-server\server-storage-plugin\storage-elasticsearch-plugin\src\main\java\org\apache\skywalking\oap\server\storage\plugin\elasticsearch\IndicesMetadataCache.java,21,10,3,1,0,14
 skywalking-master\skywalking-master\oap-server\server-cluster-plugin\cluster-kubernetes-plugin\src\main\java\org\apache\skywalking\oap\server\cluster\plugin\kubernetes\ClusterModuleKubernetesProvider.java,47,10,2,3,0,15
 skywalking-master\skywalking-master\oap-server\server-alarm-plugin\src\test\java\org\apache\skywalking\oap\server\core\alarm\provider\grpc\GRPChookCallbackTest.java,51,7,1,1,0,9
 skywalking-master\skywalking-master\oap-server\server-core\src\main\java\org\apache\skywalking\oap\server\core\query\TopNRecordsQueryService.java,23,11,0,5,0,16
 skywalking-master\skywalking-master\oap-server\server-query-plugin\query-graphql-plugin\src\main\java\org\apache\skywalking\oap\query\graphql\resolver\MetricsQuery.java,0,72,0,29,0,101
 skywalking-master\skywalking-master\oap-server\server-library\library-util\src\main\java\org\apache\skywalking\oap\server\library\util\MultipleFilesChangeMonitor.java,224,41,4,22,1,68
 skywalking-master\skywalking-master\oap-server\server-core\src\main\java\org\apache\skywalking\oap\server\core\analysis\manual\database\DatabaseStatementDispatcher.java,16,4,0,3,0,7
 skywalking-master\skywalking-master\oap-server\server-core\src\main\java\org\apache\skywalking\oap\server\core\browser\source\BrowserAppTraffic.java,12,4,0,5,0,9
 skywalking-master\skywalking-master\oap-server\analyzer\log-analyzer\src\main\java\org\apache\skywalking\oap\log\analyzer\provider\log\listener\LogFilterListener.java,44,10,0,5,0,15
 skywalking-master\skywalking-master\oap-server\server-core\src\main\java\org\apache\skywalking\oap\server\core\query\type\ProfileTaskCreationResult.java,9,4,0,2,0,6
 skywalking-master\skywalking-master\oap-server\server-receiver-plugin\zipkin-receiver-plugin\src\main\java\org\apache\skywalking\oap\server\receiver\zipkin\handler\SpanEncode.java,23,13,1,1,0,15
 skywalking-master\skywalking-master\oap-server\server-library\library-module\src\main\java\org\apache\skywalking\oap\server\library\module\ModuleServiceHolder.java,0,3,0,2,0,5
 skywalking-master\skywalking-master\oap-server\server-storage-plugin\storage-jdbc-hikaricp-plugin\src\main\java\org\apache\skywalking\oap\server\storage\plugin\jdbc\h2\dao\H2EBPFProfilingScheduleDAO.java,52,26,0,18,0,44
 skywalking-master\skywalking-master\oap-server\server-cluster-plugin\cluster-consul-plugin\src\main\java\org\apache\skywalking\oap\server\cluster\plugin\consul\ClusterModuleConsulConfig.java,0,6,0,1,0,7
 skywalking-master\skywalking-master\oap-server\server-configuration\configuration-apollo\src\test\java\org\apache\skywalking\oap\server\configuration\apollo\ApolloConfigurationTestModule.java,13,4,0,1,0,5
 skywalking-master\skywalking-master\oap-server\server-library\library-elasticsearch-client\src\main\java\org\apache\skywalking\library\elasticsearch\requests\search\Scroll.java,0,3,0,1,0,4
 skywalking-master\skywalking-master\oap-server\server-library\library-elasticsearch-client\src\main\java\org\apache\skywalking\library\elasticsearch\response\search\SearchHit.java,0,6,0,1,2,9
 skywalking-master\skywalking-master\oap-server\server-receiver-plugin\skywalking-zabbix-receiver-plugin\src\test\java\org\apache\skywalking\oap\server\receiver\zabbix\provider\protocol\ZabbixProtocolHandlerTest.java,55,15,0,10,0,25
 skywalking-master\skywalking-master\oap-server\exporter\src\test\java\org\apache\skywalking\oap\server\exporter\provider\grpc\MockDoubleValueMetrics.java,7,3,0,2,0,5
 skywalking-master\skywalking-master\oap-server\analyzer\log-analyzer\src\main\java\org\apache\skywalking\oap\log\analyzer\provider\log\listener\LogAnalysisListener.java,0,6,1,3,0,10
 skywalking-master\skywalking-master\oap-server\server-receiver-plugin\zipkin-receiver-plugin\src\main\java\org\apache\skywalking\oap\server\receiver\zipkin\ZipkinReceiverProvider.java,62,19,1,12,0,32
 skywalking-master\skywalking-master\oap-server\server-core\src\main\java\org\apache\skywalking\oap\server\core\config\group\StringFormatGroup.java,65,17,0,2,0,19
 skywalking-master\skywalking-master\oap-server\server-storage-plugin\storage-influxdb-plugin\src\main\java\org\apache\skywalking\oap\server\storage\plugin\influxdb\TableMetaInfo.java,78,30,2,23,0,55
 skywalking-master\skywalking-master\oap-server\analyzer\event-analyzer\src\main\java\org\apache\skywalking\oap\server\analyzer\event\EventAnalyzerServiceImpl.java,0,7,0,5,0,12
 skywalking-master\skywalking-master\oap-server\server-receiver-plugin\configuration-discovery-receiver-plugin\src\main\java\org\apache\skywalking\oap\server\recevier\configuration\discovery\ConfigurationDiscoveryModule.java,13,4,0,1,0,5
 skywalking-master\skywalking-master\oap-server\server-core\src\main\java\org\apache\skywalking\oap\server\core\source\ServiceInstance.java,71,25,2,7,0,34
 skywalking-master\skywalking-master\oap-server\server-core\src\main\java\org\apache\skywalking\oap\server\core\analysis\metrics\annotation\MetricsFunction.java,0,1,0,1,0,2
 skywalking-master\skywalking-master\oap-server\server-core\src\main\java\org\apache\skywalking\oap\server\core\analysis\worker\MetricsTransWorker.java,28,14,0,6,0,20
 skywalking-master\skywalking-master\oap-server\server-receiver-plugin\envoy-metrics-receiver-plugin\src\main\java\org\apache\skywalking\oap\server\receiver\envoy\als\k8s\K8sALSServiceMeshHTTPAnalysis.java,146,46,1,34,0,81
 skywalking-master\skywalking-master\oap-server\analyzer\log-analyzer\src\main\java\org\apache\skywalking\oap\log\analyzer\dsl\DSL.java,53,8,0,2,0,10
 skywalking-master\skywalking-master\oap-server\server-library\library-module\src\main\java\org\apache\skywalking\oap\server\library\module\ModuleProviderHolder.java,0,2,0,2,0,4
 skywalking-master\skywalking-master\oap-server\server-core\src\main\java\org\apache\skywalking\oap\server\core\query\type\ProfileTaskLogOperationType.java,0,14,0,3,0,17
 skywalking-master\skywalking-master\oap-server\server-library\library-elasticsearch-client\src\main\java\org\apache\skywalking\library\elasticsearch\requests\search\RangeQueryBuilder.java,0,24,0,2,0,26
 skywalking-master\skywalking-master\oap-server\server-storage-plugin\storage-elasticsearch-plugin\src\main\java\org\apache\skywalking\oap\server\storage\plugin\elasticsearch\query\BrowserLogQueryEsDAO.java,64,10,0,15,0,25
 skywalking-master\skywalking-master\oap-server\server-storage-plugin\storage-influxdb-plugin\src\main\java\org\apache\skywalking\oap\server\storage\plugin\influxdb\base\ManagementDAO.java,33,12,0,7,0,19
 skywalking-master\skywalking-master\oap-server\server-core\src\main\java\org\apache\skywalking\oap\server\core\analysis\worker\ManagementStreamProcessor.java,41,22,0,18,0,40
 skywalking-master\skywalking-master\oap-server\server-core\src\main\java\org\apache\skywalking\oap\server\core\query\type\TraceBrief.java,10,3,0,1,0,4
 skywalking-master\skywalking-master\oap-server\server-core\src\main\java\org\apache\skywalking\oap\server\core\analysis\manual\service\ServiceTrafficDispatcher.java,11,1,0,2,0,3
 skywalking-master\skywalking-master\oap-server\server-core\src\main\java\org\apache\skywalking\oap\server\core\UnexpectedException.java,10,5,0,1,0,6
 skywalking-master\skywalking-master\oap-server\server-library\library-elasticsearch-client\src\main\java\org\apache\skywalking\library\elasticsearch\requests\factory\common\CommonBulkFactory.java,0,3,0,2,0,5
 skywalking-master\skywalking-master\oap-server\server-cluster-plugin\cluster-nacos-plugin\src\main\java\org\apache\skywalking\oap\server\cluster\plugin\nacos\ClusterModuleNacosProvider.java,65,15,3,9,0,27
 skywalking-master\skywalking-master\oap-server\server-cluster-plugin\cluster-zookeeper-plugin\src\main\java\org\apache\skywalking\oap\server\cluster\plugin\zookeeper\ZookeeperCoordinator.java,0,36,5,23,0,64
 skywalking-master\skywalking-master\oap-server\server-library\library-module\src\test\java\org\apache\skywalking\oap\server\library\module\ModuleBBusiness2Impl.java,0,0,0,1,0,1
 skywalking-master\skywalking-master\oap-server\server-storage-plugin\storage-influxdb-plugin\src\main\java\org\apache\skywalking\oap\server\storage\plugin\influxdb\query\TraceQuery.java,172,54,1,23,0,78
 skywalking-master\skywalking-master\apm-protocol\apm-network\src\main\java\org\apache\skywalking\oap\server\network\trace\component\command\ConfigurationDiscoveryCommand.java,0,29,0,5,0,34
 skywalking-master\skywalking-master\oap-server\server-receiver-plugin\envoy-metrics-receiver-plugin\src\main\java\org\apache\skywalking\oap\server\receiver\envoy\TCPOALDefine.java,12,2,1,1,0,4
 skywalking-master\skywalking-master\oap-server\server-cluster-plugin\cluster-consul-plugin\src\test\java\org\apache\skywalking\oap\server\cluster\plugin\consul\ITClusterModuleConsulProviderFunctionalTest.java,234,65,9,28,0,102
 skywalking-master\skywalking-master\oap-server\server-receiver-plugin\skywalking-zabbix-receiver-plugin\src\main\java\org\apache\skywalking\oap\server\receiver\zabbix\provider\protocol\bean\ZabbixResponseJsonSerializer.java,19,7,0,3,0,10
 skywalking-master\skywalking-master\oap-server\exporter\src\test\java\org\apache\skywalking\oap\server\exporter\provider\grpc\MockIntValueMetrics.java,7,2,0,1,0,3
 skywalking-master\skywalking-master\oap-server\server-core\src\main\java\org\apache\skywalking\oap\server\core\analysis\metrics\annotation\ConstOne.java,0,0,0,1,0,1
 skywalking-master\skywalking-master\oap-server\server-core\src\main\java\org\apache\skywalking\oap\server\core\storage\IManagementDAO.java,0,2,0,1,0,3
 skywalking-master\skywalking-master\oap-server\server-core\src\main\java\org\apache\skywalking\oap\server\core\cluster\ClusterHealthStatus.java,11,7,0,2,0,9
 skywalking-master\skywalking-master\oap-server\server-core\src\main\java\org\apache\skywalking\oap\server\core\analysis\worker\ExportWorker.java,21,9,0,5,0,14
 skywalking-master\skywalking-master\oap-server\analyzer\agent-analyzer\src\main\java\org\apache\skywalking\oap\server\analyzer\provider\trace\parser\listener\CommonAnalysisListener.java,14,4,0,3,0,7
 skywalking-master\skywalking-master\oap-server\server-core\src\main\java\org\apache\skywalking\oap\server\core\query\ServiceTopologyBuilder.java,0,37,1,32,0,70
 skywalking-master\skywalking-master\oap-server\server-library\library-datacarrier-queue\src\main\java\org\apache\skywalking\oap\server\library\datacarrier\buffer\BufferStrategy.java,0,2,0,1,0,3
 skywalking-master\skywalking-master\oap-server\server-fetcher-plugin\kafka-fetcher-plugin\src\test\java\org\apache\skywalking\oap\server\analyzer\agent\kafka\provider\handler\AbstractKafkaHandlerTest.java,58,13,2,7,0,22
 skywalking-master\skywalking-master\oap-server\server-fetcher-plugin\kafka-fetcher-plugin\src\main\java\org\apache\skywalking\oap\server\analyzer\agent\kafka\provider\handler\TraceSegmentHandler.java,54,13,0,8,0,21
 skywalking-master\skywalking-master\oap-server\server-tools\profile-exporter\tool-profile-snapshot-server-mock\src\main\java\org\apache\skywalking\oap\server\tool\profile\core\mock\MockComponentLibraryCatalogService.java,22,11,0,3,0,14
 skywalking-master\skywalking-master\oap-server\analyzer\log-analyzer\src\main\java\org\apache\skywalking\oap\log\analyzer\module\LogAnalyzerModule.java,15,4,0,1,0,5
 skywalking-master\skywalking-master\oap-server\server-core\src\test\java\org\apache\skywalking\oap\server\core\analysis\metrics\expression\ContainMatchTest.java,11,5,0,3,0,8
 skywalking-master\skywalking-master\oap-server\server-core\src\main\java\org\apache\skywalking\oap\server\core\query\type\EndpointNode.java,12,5,0,1,0,6
 skywalking-master\skywalking-master\oap-server\server-core\src\main\java\org\apache\skywalking\oap\server\core\query\input\Entity.java,111,27,0,20,0,47
 skywalking-master\skywalking-master\oap-server\server-core\src\test\java\org\apache\skywalking\oap\server\core\CoreModuleTest.java,9,2,0,1,0,3
 skywalking-master\skywalking-master\oap-server\server-core\src\main\java\org\apache\skywalking\oap\server\core\profiling\ebpf\EBPFProfilingMutationService.java,136,39,2,29,0,70
 skywalking-master\skywalking-master\oap-server\server-core\src\main\java\org\apache\skywalking\oap\server\core\query\type\Pagination.java,6,3,0,1,0,4
 skywalking-master\skywalking-master\oap-server\server-core\src\main\java\org\apache\skywalking\oap\server\core\source\RequestType.java,0,6,0,1,0,7
 skywalking-master\skywalking-master\oap-server\server-library\library-elasticsearch-client\src\main\java\org\apache\skywalking\library\elasticsearch\bulk\BulkProcessorBuilder.java,0,15,0,2,0,17
 skywalking-master\skywalking-master\oap-server\server-storage-plugin\storage-elasticsearch-plugin\src\main\java\org\apache\skywalking\oap\server\storage\plugin\elasticsearch\query\ProfileTaskQueryEsDAO.java,96,31,0,24,0,55
 skywalking-master\skywalking-master\oap-server\server-alarm-plugin\src\test\java\org\apache\skywalking\oap\server\core\alarm\provider\feishu\FeishuHookCallbackTest.java,112,37,2,28,0,67
 skywalking-master\skywalking-master\oap-server\server-query-plugin\query-graphql-plugin\src\main\java\org\apache\skywalking\oap\query\graphql\resolver\UIConfigurationManagement.java,0,33,0,12,0,45
 skywalking-master\skywalking-master\oap-server\server-query-plugin\query-graphql-plugin\src\main\java\org\apache\skywalking\oap\query\graphql\resolver\AggregationQuery.java,89,27,0,14,0,41
 skywalking-master\skywalking-master\oap-server\server-receiver-plugin\skywalking-zabbix-receiver-plugin\src\main\java\org\apache\skywalking\oap\server\receiver\zabbix\provider\ZabbixMetrics.java,251,80,0,25,0,105
 skywalking-master\skywalking-master\oap-server\oal-rt\src\main\java\org\apache\skywalking\oal\rt\parser\DataColumn.java,19,13,0,1,0,14
 skywalking-master\skywalking-master\oap-server\analyzer\log-analyzer\src\main\java\org\apache\skywalking\oap\log\analyzer\dsl\spec\LALDelegatingScript.java,32,21,4,6,0,31
 skywalking-master\skywalking-master\oap-server\server-core\src\main\java\org\apache\skywalking\oap\server\core\query\type\Trace.java,8,2,0,1,0,3
 skywalking-master\skywalking-master\oap-server\server-alarm-plugin\src\main\java\org\apache\skywalking\oap\server\core\alarm\provider\slack\SlackSettings.java,8,2,0,1,0,3
 skywalking-master\skywalking-master\oap-server\server-core\src\main\java\org\apache\skywalking\oap\server\core\logging\log4j\OapConfiguration.java,7,2,0,1,0,3
 skywalking-master\skywalking-master\oap-server\analyzer\log-analyzer\src\main\java\org\apache\skywalking\oap\log\analyzer\provider\LALConfigs.java,35,6,1,6,0,13
 skywalking-master\skywalking-master\oap-server\server-core\src\main\java\org\apache\skywalking\oap\server\core\browser\source\BrowserErrorLog.java,34,10,0,2,0,12
 skywalking-master\skywalking-master\oap-server\server-configuration\configuration-api\src\main\java\org\apache\skywalking\oap\server\configuration\api\GroupConfigChangeWatcher.java,26,9,0,4,0,13
 skywalking-master\skywalking-master\oap-server\server-library\library-server\src\main\java\org\apache\skywalking\oap\server\library\server\ssl\PrivateKeyUtil.java,51,46,1,12,2,61
 skywalking-master\skywalking-master\oap-server\server-receiver-plugin\otel-receiver-plugin\src\main\java\org\apache\skywalking\oap\server\receiver\otel\OtelMetricReceiverModule.java,13,3,0,1,0,4
 skywalking-master\skywalking-master\oap-server\server-core\src\main\java\org\apache\skywalking\oap\server\core\source\ServiceRelation.java,86,29,1,9,0,39
 skywalking-master\skywalking-master\oap-server\server-library\library-util\src\main\java\org\apache\skywalking\oap\server\library\util\RunnableWithExceptionProtection.java,23,10,1,2,0,13
 skywalking-master\skywalking-master\oap-server\analyzer\agent-analyzer\src\main\java\org\apache\skywalking\oap\server\analyzer\provider\trace\TraceSamplingPolicyWatcher.java,142,59,6,34,0,99
 skywalking-master\skywalking-master\oap-server\server-core\src\main\java\org\apache\skywalking\oap\server\core\worker\IWorkerInstanceGetter.java,0,2,0,2,0,4
 skywalking-master\skywalking-master\oap-server\server-storage-plugin\storage-jdbc-hikaricp-plugin\src\main\java\org\apache\skywalking\oap\server\storage\plugin\jdbc\postgresql\dao\PostgreSQLAlarmQueryDAO.java,20,10,0,4,0,14
 skywalking-master\skywalking-master\oap-server\server-storage-plugin\storage-jdbc-hikaricp-plugin\src\main\java\org\apache\skywalking\oap\server\storage\plugin\jdbc\postgresql\dao\PostgreSQLBrowserLogQueryDAO.java,12,4,0,3,0,7
 skywalking-master\skywalking-master\oap-server\server-library\library-module\src\test\java\org\apache\skywalking\oap\server\library\module\ModuleABusiness2Impl.java,0,0,0,1,0,1
 skywalking-master\skywalking-master\oap-server\server-query-plugin\query-graphql-plugin\src\main\java\org\apache\skywalking\oap\query\graphql\resolver\ProfileQuery.java,40,24,0,10,0,34
 skywalking-master\skywalking-master\oap-server\server-core\src\main\java\org\apache\skywalking\oap\server\core\query\type\event\EventType.java,0,4,2,2,0,8
 skywalking-master\skywalking-master\oap-server\server-receiver-plugin\skywalking-log-recevier-plugin\src\main\java\org\apache\skywalking\oap\server\recevier\log\provider\LogModuleProvider.java,52,15,2,14,0,31
 skywalking-master\skywalking-master\oap-server\server-storage-plugin\storage-iotdb-plugin\src\main\java\org\apache\skywalking\oap\server\storage\plugin\iotdb\query\IoTDBTopNRecordsQueryDAO.java,79,17,0,12,0,29
