Class_Location,Class_Length,CheckStyle_Amount,PMD_Amount,SCAX_Amount,SpotBugs_Amount,Total_Amount
zookeeper-master\zookeeper-master\zookeeper-server\src\main\java\org\apache\zookeeper\cli\DelQuotaCommand.java,154,0,9,2,0,11
zookeeper-master\zookeeper-master\zookeeper-server\src\test\java\org\apache\zookeeper\common\BCFKSFileLoaderTest.java,161,0,0,19,0,19
zookeeper-master\zookeeper-master\zookeeper-server\src\main\java\org\apache\zookeeper\client\ZKClientConfig.java,115,0,0,23,0,23
zookeeper-master\zookeeper-master\zookeeper-server\src\main\java\org\apache\zookeeper\server\auth\SaslServerCallbackHandler.java,119,0,2,20,0,22
zookeeper-master\zookeeper-master\zookeeper-server\src\test\java\org\apache\zookeeper\test\AsyncOpsTest.java,234,0,22,2,0,24
zookeeper-master\zookeeper-master\zookeeper-contrib\zookeeper-contrib-zooinspector\src\main\java\org\apache\zookeeper\inspector\manager\ZooInspectorNodeTreeManager.java,20,0,2,1,0,3
zookeeper-master\zookeeper-master\zookeeper-server\src\test\java\org\apache\zookeeper\cli\CommandFactoryTest.java,13,0,0,1,0,1
zookeeper-master\zookeeper-master\zookeeper-contrib\zookeeper-contrib-zooinspector\src\main\java\org\apache\zookeeper\inspector\gui\Toolbar.java,66,0,1,4,0,5
zookeeper-master\zookeeper-master\zookeeper-server\src\test\java\org\apache\zookeeper\server\quorum\SessionUpgradeQuorumTest.java,0,0,26,30,0,56
zookeeper-master\zookeeper-master\zookeeper-server\src\test\java\org\apache\zookeeper\test\ObserverMasterTestBase.java,85,0,10,11,0,21
zookeeper-master\zookeeper-master\zookeeper-jute\src\main\java\org\apache\jute\compiler\CGenerator.java,0,0,6,26,0,32
zookeeper-master\zookeeper-master\zookeeper-server\src\test\java\org\apache\zookeeper\test\AuthFailX509AuthenticationProvider.java,23,0,0,5,0,5
zookeeper-master\zookeeper-master\zookeeper-it\target\generated-sources\annotations\org\apache\zookeeper\server\watch\generated\WatchBench_TriggerSparseWatchState_jmhType_B2.java,21,0,10,8,0,18
zookeeper-master\zookeeper-master\zookeeper-server\src\main\java\org\apache\zookeeper\server\auth\IPAuthenticationProvider.java,108,0,7,2,0,9
zookeeper-master\zookeeper-master\zookeeper-server\src\main\java\org\apache\zookeeper\server\admin\CommandBase.java,55,0,0,3,0,3
zookeeper-master\zookeeper-master\zookeeper-server\src\test\java\org\apache\zookeeper\server\CreateTTLTest.java,219,0,72,41,0,113
zookeeper-master\zookeeper-master\zookeeper-server\src\test\java\org\apache\zookeeper\server\quorum\auth\KerberosTestUtils.java,118,0,3,9,0,12
zookeeper-master\zookeeper-master\zookeeper-server\src\main\java\org\apache\zookeeper\Quotas.java,62,0,1,1,0,2
zookeeper-master\zookeeper-master\zookeeper-server\src\test\java\org\apache\zookeeper\server\quorum\FuzzySnapshotRelatedTest.java,495,0,20,36,0,56
zookeeper-master\zookeeper-master\zookeeper-server\src\test\java\org\apache\zookeeper\server\util\BitMapTest.java,51,0,4,1,0,5
zookeeper-master\zookeeper-master\zookeeper-server\src\main\java\org\apache\zookeeper\server\ZooKeeperServerMain.java,238,0,3,21,0,24
zookeeper-master\zookeeper-master\zookeeper-server\src\test\java\org\apache\zookeeper\common\SecretUtilsTest.java,40,0,3,7,0,10
zookeeper-master\zookeeper-master\zookeeper-server\src\test\java\org\apache\zookeeper\server\persistence\EmptySnapshotTest.java,46,0,2,8,0,10
zookeeper-master\zookeeper-master\zookeeper-server\src\main\java\org\apache\zookeeper\server\quorum\ObserverMaster.java,479,0,37,48,0,85
zookeeper-master\zookeeper-master\zookeeper-it\src\main\java\org\apache\zookeeper\test\system\SimpleSysTest.java,131,0,12,11,0,23
zookeeper-master\zookeeper-master\zookeeper-contrib\zookeeper-contrib-rest\src\main\java\org\apache\zookeeper\server\jersey\cfg\HostPortSet.java,29,0,0,1,0,1
zookeeper-master\zookeeper-master\zookeeper-contrib\zookeeper-contrib-zooinspector\src\main\java\org\apache\zookeeper\inspector\manager\ZooInspectorNodeManager.java,0,0,1,1,0,2
zookeeper-master\zookeeper-master\zookeeper-server\src\main\java\org\apache\zookeeper\metrics\Summary.java,0,0,0,3,0,3
zookeeper-master\zookeeper-master\zookeeper-contrib\zookeeper-contrib-rest\src\test\java\org\apache\zookeeper\server\jersey\DeleteTest.java,50,0,6,2,0,8
zookeeper-master\zookeeper-master\zookeeper-server\src\test\java\org\apache\zookeeper\server\util\RequestPathMetricsCollectorTest.java,412,0,28,97,0,125
zookeeper-master\zookeeper-master\zookeeper-server\src\test\java\org\apache\zookeeper\server\NettyServerCnxnTest.java,0,0,22,52,0,74
zookeeper-master\zookeeper-master\zookeeper-server\src\test\java\org\apache\zookeeper\test\SaslKerberosAuthOverSSLTest.java,196,0,2,32,0,34
zookeeper-master\zookeeper-master\zookeeper-server\src\test\java\org\apache\zookeeper\server\quorum\QuorumRequestPipelineTest.java,140,0,29,17,0,46
zookeeper-master\zookeeper-master\zookeeper-server\src\test\java\org\apache\zookeeper\server\X509AuthFailureTest.java,67,0,5,12,0,17
zookeeper-master\zookeeper-master\zookeeper-server\src\main\java\org\apache\zookeeper\server\quorum\UpgradeableSessionTracker.java,100,0,2,7,0,9
zookeeper-master\zookeeper-master\zookeeper-server\src\main\java\org\apache\zookeeper\server\util\SerializeUtils.java,135,0,36,7,0,43
zookeeper-master\zookeeper-master\zookeeper-server\src\main\java\org\apache\zookeeper\server\watch\WatcherCleaner.java,145,0,1,17,0,18
zookeeper-master\zookeeper-master\zookeeper-it\target\generated-sources\annotations\org\apache\zookeeper\server\watch\generated\WatchBench_jmhType_B1.java,0,0,19,18,0,37
zookeeper-master\zookeeper-master\zookeeper-server\src\test\java\org\apache\zookeeper\server\quorum\EagerACLFilterTest.java,237,0,26,47,0,73
zookeeper-master\zookeeper-master\zookeeper-server\src\test\java\org\apache\zookeeper\server\watch\WatcherCleanerTest.java,138,0,2,13,0,15
zookeeper-master\zookeeper-master\zookeeper-server\src\main\java\org\apache\zookeeper\server\ZooKeeperSaslServer.java,0,0,0,4,0,4
zookeeper-master\zookeeper-master\zookeeper-it\src\main\java\org\apache\zookeeper\test\system\BaseSysTest.java,241,0,10,13,0,23
zookeeper-master\zookeeper-master\zookeeper-server\src\main\java\org\apache\zookeeper\MultiOperationRecord.java,0,0,29,11,0,40
zookeeper-master\zookeeper-master\zookeeper-server\src\test\java\org\apache\zookeeper\server\ConnectionMetricsTest.java,193,0,3,13,0,16
zookeeper-master\zookeeper-master\zookeeper-server\src\test\java\org\apache\zookeeper\server\quorum\ZabUtils.java,125,0,20,15,0,35
zookeeper-master\zookeeper-master\zookeeper-server\src\test\java\org\apache\zookeeper\test\NioNettySuiteTest.java,4,0,0,2,0,2
zookeeper-master\zookeeper-master\zookeeper-contrib\zookeeper-contrib-rest\src\test\java\org\apache\zookeeper\server\jersey\GetTest.java,81,0,2,3,0,5
zookeeper-master\zookeeper-master\zookeeper-server\src\main\java\org\apache\zookeeper\ClientCnxnSocketNIO.java,379,0,19,18,0,37
zookeeper-master\zookeeper-master\zookeeper-contrib\zookeeper-contrib-rest\src\main\java\org\apache\zookeeper\server\jersey\resources\ZNodeResource.java,351,0,35,2,0,37
zookeeper-master\zookeeper-master\zookeeper-server\src\test\java\org\apache\zookeeper\audit\StandaloneServerAuditTest.java,0,0,3,5,0,8
zookeeper-master\zookeeper-master\zookeeper-server\src\main\java\org\apache\zookeeper\server\util\AdHash.java,54,0,1,1,0,2
zookeeper-master\zookeeper-master\zookeeper-server\src\main\java\org\apache\zookeeper\server\quorum\QuorumBean.java,0,0,0,1,0,1
zookeeper-master\zookeeper-master\zookeeper-server\src\test\java\org\apache\zookeeper\ClientCnxnSocketTest.java,63,0,0,5,0,5
zookeeper-master\zookeeper-master\zookeeper-server\src\test\java\org\apache\zookeeper\server\MockNIOServerCnxn.java,21,0,1,2,0,3
zookeeper-master\zookeeper-master\zookeeper-server\target\generated-sources\java\org\apache\zookeeper\version\VersionInfoMain.java,0,0,2,2,0,4
zookeeper-master\zookeeper-master\zookeeper-contrib\zookeeper-contrib-rest\src\main\java\org\apache\zookeeper\server\jersey\ZooKeeperService.java,203,0,2,5,0,7
zookeeper-master\zookeeper-master\zookeeper-server\src\test\java\org\apache\zookeeper\server\quorum\UnifiedServerSocketTest.java,0,0,23,70,0,93
zookeeper-master\zookeeper-master\zookeeper-server\src\test\java\org\apache\zookeeper\server\quorum\FLELostMessageTest.java,65,0,2,7,0,9
zookeeper-master\zookeeper-master\zookeeper-contrib\zookeeper-contrib-zooinspector\src\main\java\com\nitido\utils\toaster\Toaster.java,0,0,3,8,0,11
zookeeper-master\zookeeper-master\zookeeper-it\src\main\java\org\apache\zookeeper\test\system\SimpleClient.java,0,0,9,5,0,14
zookeeper-master\zookeeper-master\zookeeper-contrib\zookeeper-contrib-loggraph\src\main\java\org\apache\zookeeper\graph\filterops\GreaterThanOp.java,48,0,2,4,0,6
zookeeper-master\zookeeper-master\zookeeper-server\src\test\java\org\apache\zookeeper\EnforceAuthenticationTest.java,227,0,9,38,0,47
zookeeper-master\zookeeper-master\zookeeper-server\src\test\java\org\apache\zookeeper\server\PrepRequestProcessorMetricsTest.java,145,0,14,17,0,31
zookeeper-master\zookeeper-master\zookeeper-server\src\test\java\org\apache\zookeeper\test\FLEZeroWeightTest.java,0,0,15,13,0,28
zookeeper-master\zookeeper-master\zookeeper-contrib\zookeeper-contrib-rest\src\main\java\org\apache\zookeeper\server\jersey\cfg\Credentials.java,0,0,1,1,0,2
zookeeper-master\zookeeper-master\zookeeper-contrib\zookeeper-contrib-loggraph\src\main\java\org\apache\zookeeper\graph\servlets\FileLoader.java,0,0,2,2,0,4
zookeeper-master\zookeeper-master\zookeeper-server\src\main\java\org\apache\zookeeper\common\X509Util.java,0,0,7,96,0,103
zookeeper-master\zookeeper-master\zookeeper-server\src\test\java\org\apache\zookeeper\SaslAuthTest.java,212,0,25,22,0,47
zookeeper-master\zookeeper-master\zookeeper-server\src\main\java\org\apache\zookeeper\server\ConnectionBean.java,0,0,2,7,0,9
zookeeper-master\zookeeper-master\zookeeper-server\src\main\java\org\apache\zookeeper\server\command\NopCommand.java,16,0,0,3,0,3
zookeeper-master\zookeeper-master\zookeeper-server\src\test\java\org\apache\zookeeper\TestableZooKeeper.java,92,0,7,2,0,9
zookeeper-master\zookeeper-master\zookeeper-contrib\zookeeper-contrib-loggraph\src\main\java\org\apache\zookeeper\graph\FilterOp.java,54,0,19,1,0,20
zookeeper-master\zookeeper-master\zookeeper-server\src\test\java\org\apache\zookeeper\test\SaslAuthRequiredFailWrongSASLTest.java,37,0,2,5,0,7
zookeeper-master\zookeeper-master\zookeeper-server\src\test\java\org\apache\zookeeper\test\ServerCnxnTest.java,89,0,1,5,0,6
zookeeper-master\zookeeper-master\zookeeper-jute\src\main\java\org\apache\jute\InputArchive.java,0,0,0,1,0,1
zookeeper-master\zookeeper-master\zookeeper-server\src\main\java\org\apache\zookeeper\server\persistence\SnapStream.java,281,0,10,15,0,25
zookeeper-master\zookeeper-master\zookeeper-server\src\test\java\org\apache\zookeeper\test\UnsupportedAddWatcherTest.java,92,0,0,7,0,7
zookeeper-master\zookeeper-master\zookeeper-server\src\main\java\org\apache\zookeeper\common\ZKHostnameVerifier.java,0,0,15,38,0,53
zookeeper-master\zookeeper-master\zookeeper-server\src\main\java\org\apache\zookeeper\metrics\Gauge.java,0,0,0,3,0,3
zookeeper-master\zookeeper-master\zookeeper-server\src\main\java\org\apache\zookeeper\server\quorum\BufferStats.java,69,0,0,3,0,3
zookeeper-master\zookeeper-master\zookeeper-server\src\test\java\org\apache\zookeeper\server\quorum\QuorumBeanTest.java,51,0,0,8,0,8
zookeeper-master\zookeeper-master\zookeeper-server\src\main\java\org\apache\zookeeper\server\admin\AdminServer.java,0,0,0,1,0,1
zookeeper-master\zookeeper-master\zookeeper-server\src\main\java\org\apache\zookeeper\server\DataTree.java,1846,0,126,83,0,209
zookeeper-master\zookeeper-master\zookeeper-server\src\main\java\org\apache\zookeeper\server\quorum\ObserverZooKeeperServer.java,112,0,0,9,0,9
zookeeper-master\zookeeper-master\zookeeper-server\src\main\java\org\apache\zookeeper\server\quorum\LeaderMXBean.java,0,0,0,3,0,3
zookeeper-master\zookeeper-master\zookeeper-it\src\main\java\org\apache\zookeeper\test\system\DuplicateNameException.java,7,0,0,1,0,1
zookeeper-master\zookeeper-master\zookeeper-server\src\main\java\org\apache\zookeeper\server\RequestProcessor.java,0,0,1,1,0,2
zookeeper-master\zookeeper-master\zookeeper-contrib\zookeeper-contrib-zooinspector\src\main\java\org\apache\zookeeper\inspector\manager\NodesCache.java,66,0,5,12,0,17
zookeeper-master\zookeeper-master\zookeeper-server\src\main\java\org\apache\zookeeper\server\quorum\LearnerSender.java,57,0,13,4,0,17
zookeeper-master\zookeeper-master\zookeeper-server\src\test\java\org\apache\zookeeper\test\StatsTrackTest.java,112,0,0,2,0,2
zookeeper-master\zookeeper-master\zookeeper-server\src\test\java\org\apache\zookeeper\test\CreateTest.java,81,0,23,10,0,33
zookeeper-master\zookeeper-master\zookeeper-contrib\zookeeper-contrib-zooinspector\src\main\java\org\apache\zookeeper\inspector\gui\ZooInspectorAboutDialog.java,43,0,0,4,0,4
zookeeper-master\zookeeper-master\zookeeper-jute\src\test\java\org\apache\jute\TestReader.java,0,0,0,1,0,1
zookeeper-master\zookeeper-master\zookeeper-server\src\main\java\org\apache\zookeeper\server\quorum\LearnerHandlerMXBean.java,0,0,0,1,0,1
zookeeper-master\zookeeper-master\zookeeper-contrib\zookeeper-contrib-rest\src\main\java\org\apache\zookeeper\server\jersey\cfg\Endpoint.java,53,0,0,1,0,1
zookeeper-master\zookeeper-master\zookeeper-server\src\main\java\org\apache\zookeeper\cli\ListQuotaCommand.java,69,0,4,4,0,8
zookeeper-master\zookeeper-master\zookeeper-server\src\main\java\org\apache\zookeeper\server\metric\AvgMinMaxCounter.java,91,0,3,3,0,6
zookeeper-master\zookeeper-master\zookeeper-server\src\main\java\org\apache\zookeeper\server\watch\WatcherOrBitSet.java,39,0,0,1,0,1
zookeeper-master\zookeeper-master\zookeeper-server\src\main\java\org\apache\zookeeper\server\util\BitMap.java,110,0,0,2,0,2
zookeeper-master\zookeeper-master\zookeeper-server\src\test\java\org\apache\zookeeper\test\ClientBase.java,671,0,16,41,0,57
zookeeper-master\zookeeper-master\zookeeper-server\src\main\java\org\apache\zookeeper\common\NetUtils.java,62,0,1,7,0,8
zookeeper-master\zookeeper-master\zookeeper-server\src\test\java\org\apache\zookeeper\server\quorum\RemotePeerBeanTest.java,48,0,2,6,0,8
zookeeper-master\zookeeper-master\zookeeper-server\src\main\java\org\apache\zookeeper\Shell.java,421,0,13,16,0,29
zookeeper-master\zookeeper-master\zookeeper-server\src\main\java\org\apache\zookeeper\server\util\MessageTracker.java,129,0,3,15,0,18
zookeeper-master\zookeeper-master\zookeeper-server\src\test\java\org\apache\zookeeper\test\FLEPredicateTest.java,68,0,3,6,0,9
zookeeper-master\zookeeper-master\zookeeper-server\src\main\java\org\apache\zookeeper\ZKWatchManager.java,0,0,19,25,0,44
zookeeper-master\zookeeper-master\zookeeper-server\src\test\java\org\apache\zookeeper\server\PrepRequestProcessorTest.java,336,0,47,34,0,81
zookeeper-master\zookeeper-master\zookeeper-server\src\test\java\org\apache\zookeeper\server\util\SerializeUtilsTest.java,86,0,11,1,0,12
zookeeper-master\zookeeper-master\zookeeper-server\src\main\java\org\apache\zookeeper\server\EphemeralType.java,0,0,4,33,0,37
zookeeper-master\zookeeper-master\zookeeper-server\src\main\java\org\apache\zookeeper\audit\AuditLogger.java,0,0,1,1,0,2
zookeeper-master\zookeeper-master\zookeeper-server\src\test\java\org\apache\zookeeper\test\SaslAuthDesignatedServerTest.java,67,0,2,11,0,13
zookeeper-master\zookeeper-master\zookeeper-server\src\test\java\org\apache\zookeeper\server\quorum\auth\QuorumAuthTestBase.java,130,0,1,18,0,19
zookeeper-master\zookeeper-master\zookeeper-server\src\test\java\org\apache\zookeeper\server\quorum\QuorumServerConfigBuilder.java,0,0,2,10,0,12
zookeeper-master\zookeeper-master\zookeeper-server\src\main\java\org\apache\zookeeper\server\ZooKeeperServerMXBean.java,0,0,0,1,0,1
zookeeper-master\zookeeper-master\zookeeper-server\src\test\java\org\apache\zookeeper\server\CRCTest.java,123,0,8,8,0,16
zookeeper-master\zookeeper-master\zookeeper-it\target\generated-sources\annotations\org\apache\zookeeper\server\watch\generated\WatchBench_TriggerSparseWatchState_jmhType_B3.java,0,0,17,18,0,35
zookeeper-master\zookeeper-master\zookeeper-recipes\zookeeper-recipes-lock\src\main\java\org\apache\zookeeper\recipes\lock\ProtocolSupport.java,0,0,13,4,0,17
zookeeper-master\zookeeper-master\zookeeper-metrics-providers\zookeeper-prometheus-metrics\src\test\java\org\apache\zookeeper\metrics\prometheus\PrometheusMetricsProviderConfigTest.java,40,0,1,3,0,4
zookeeper-master\zookeeper-master\zookeeper-server\src\main\java\org\apache\zookeeper\server\controller\ControlCommand.java,99,0,1,8,0,9
zookeeper-master\zookeeper-master\zookeeper-server\src\test\java\org\apache\zookeeper\server\metric\AvgMinMaxCounterSetTest.java,62,0,0,21,0,21
zookeeper-master\zookeeper-master\zookeeper-server\src\main\java\org\apache\zookeeper\server\ServerCnxn.java,0,0,23,21,0,44
zookeeper-master\zookeeper-master\zookeeper-server\src\test\java\org\apache\zookeeper\server\ZooKeeperCriticalThreadMetricsTest.java,64,0,2,5,0,7
zookeeper-master\zookeeper-master\zookeeper-server\src\main\java\org\apache\zookeeper\server\util\AuthUtil.java,0,0,7,4,0,11
zookeeper-master\zookeeper-master\zookeeper-recipes\zookeeper-recipes-lock\src\main\java\org\apache\zookeeper\recipes\lock\LockListener.java,0,0,0,1,0,1
zookeeper-master\zookeeper-master\zookeeper-server\src\main\java\org\apache\zookeeper\server\ZKDatabase.java,689,0,36,33,0,69
zookeeper-master\zookeeper-master\zookeeper-server\src\test\java\org\apache\zookeeper\ZooKeeperTest.java,0,0,82,91,0,173
zookeeper-master\zookeeper-master\zookeeper-server\src\main\java\org\apache\zookeeper\cli\CliCommand.java,91,0,0,1,0,1
zookeeper-master\zookeeper-master\zookeeper-server\src\main\java\org\apache\zookeeper\server\quorum\QuorumZooKeeperServer.java,180,0,9,20,0,29
zookeeper-master\zookeeper-master\zookeeper-server\src\test\java\org\apache\zookeeper\server\quorum\LearnerHandlerTest.java,512,0,32,12,0,44
zookeeper-master\zookeeper-master\zookeeper-server\src\test\java\org\apache\zookeeper\test\NettyNettySuiteBase.java,28,0,0,4,0,4
zookeeper-master\zookeeper-master\zookeeper-server\src\main\java\org\apache\zookeeper\server\util\BitHashSet.java,123,0,0,1,0,1
zookeeper-master\zookeeper-master\zookeeper-server\src\test\java\org\apache\zookeeper\JaasConfiguration.java,0,0,2,6,0,8
zookeeper-master\zookeeper-master\zookeeper-server\src\main\java\org\apache\zookeeper\server\auth\SASLAuthenticationProvider.java,45,0,4,8,0,12
zookeeper-master\zookeeper-master\zookeeper-server\src\main\java\org\apache\zookeeper\server\watch\WatcherMode.java,0,0,1,1,0,2
zookeeper-master\zookeeper-master\zookeeper-server\src\main\java\org\apache\zookeeper\common\AtomicFileOutputStream.java,80,0,1,5,0,6
zookeeper-master\zookeeper-master\zookeeper-server\src\test\java\org\apache\zookeeper\test\QuorumUtil.java,299,0,10,27,0,37
zookeeper-master\zookeeper-master\zookeeper-it\target\generated-sources\annotations\org\apache\zookeeper\server\watch\generated\WatchBench_jmhType_B2.java,18,0,7,7,0,14
zookeeper-master\zookeeper-master\zookeeper-server\src\test\java\org\apache\zookeeper\test\LoadFromLogNoServerTest.java,130,0,42,19,0,61
zookeeper-master\zookeeper-master\zookeeper-server\src\test\java\org\apache\zookeeper\test\SessionTimeoutTest.java,100,0,13,15,0,28
zookeeper-master\zookeeper-master\zookeeper-contrib\zookeeper-contrib-zooinspector\src\main\java\org\apache\zookeeper\inspector\gui\nodeviewer\NodeViewerMetaData.java,158,0,5,6,0,11
zookeeper-master\zookeeper-master\zookeeper-server\src\main\java\org\apache\zookeeper\server\quorum\ReadOnlyZooKeeperServer.java,193,0,2,15,0,17
zookeeper-master\zookeeper-master\zookeeper-server\src\main\java\org\apache\zookeeper\server\util\ZxidUtils.java,17,0,1,1,0,2
zookeeper-master\zookeeper-master\zookeeper-server\src\test\java\org\apache\zookeeper\server\embedded\ZookeeperServerEmbeddedTest.java,69,0,0,9,0,9
zookeeper-master\zookeeper-master\zookeeper-server\src\test\java\org\apache\zookeeper\test\DuplicateLocalSessionUpgradeTest.java,73,0,9,5,0,14
zookeeper-master\zookeeper-master\zookeeper-server\src\main\java\org\apache\zookeeper\server\controller\ZooKeeperServerController.java,0,0,2,20,0,22
zookeeper-master\zookeeper-master\zookeeper-server\src\test\java\org\apache\zookeeper\MultiResponseTest.java,44,0,3,2,0,5
zookeeper-master\zookeeper-master\zookeeper-server\src\test\java\org\apache\zookeeper\server\ZxidRolloverTest.java,406,0,15,10,0,25
zookeeper-master\zookeeper-master\zookeeper-server\src\test\java\org\apache\zookeeper\test\LoadFromLogTest.java,251,0,30,31,0,61
zookeeper-master\zookeeper-master\zookeeper-server\src\main\java\org\apache\zookeeper\server\quorum\Observer.java,0,0,16,26,0,42
zookeeper-master\zookeeper-master\zookeeper-server\src\test\java\org\apache\zookeeper\server\quorum\ReconfigBackupTest.java,283,0,6,39,0,45
zookeeper-master\zookeeper-master\zookeeper-contrib\zookeeper-contrib-rest\src\test\java\org\apache\zookeeper\server\jersey\ExistsTest.java,40,0,0,2,0,2
zookeeper-master\zookeeper-master\zookeeper-server\src\main\java\org\apache\zookeeper\cli\DeleteCommand.java,68,0,1,2,0,3
zookeeper-master\zookeeper-master\zookeeper-contrib\zookeeper-contrib-loggraph\src\main\java\org\apache\zookeeper\graph\filterops\LessThanOp.java,47,0,2,3,0,5
zookeeper-master\zookeeper-master\zookeeper-server\src\main\java\org\apache\zookeeper\admin\ZooKeeperAdmin.java,289,0,24,16,0,40
zookeeper-master\zookeeper-master\zookeeper-server\src\test\java\org\apache\zookeeper\test\MultiAsyncTransactionTest.java,89,0,2,12,0,14
zookeeper-master\zookeeper-master\zookeeper-server\src\main\java\org\apache\zookeeper\server\ConnectionMXBean.java,0,0,0,1,0,1
zookeeper-master\zookeeper-master\zookeeper-server\src\main\java\org\apache\zookeeper\metrics\MetricsProvider.java,0,0,0,6,0,6
zookeeper-master\zookeeper-master\zookeeper-server\src\test\java\org\apache\zookeeper\ClientReconnectTest.java,51,0,2,2,0,4
zookeeper-master\zookeeper-master\zookeeper-server\src\main\java\org\apache\zookeeper\server\admin\Commands.java,796,0,3,76,0,79
zookeeper-master\zookeeper-master\zookeeper-server\src\main\java\org\apache\zookeeper\server\ServerCnxnFactory.java,293,0,2,46,0,48
zookeeper-master\zookeeper-master\zookeeper-server\src\test\java\org\apache\zookeeper\test\SaslAuthFailDesignatedClientTest.java,58,0,2,14,0,16
zookeeper-master\zookeeper-master\zookeeper-server\src\main\java\org\apache\zookeeper\jmx\ZKMBeanInfo.java,0,0,0,3,0,3
zookeeper-master\zookeeper-master\zookeeper-server\src\test\java\org\apache\zookeeper\server\quorum\CurrentEpochWriteFailureTest.java,84,0,2,16,0,18
zookeeper-master\zookeeper-master\zookeeper-server\src\test\java\org\apache\zookeeper\server\Emulate353TTLTest.java,76,0,12,11,0,23
zookeeper-master\zookeeper-master\zookeeper-server\src\test\java\org\apache\zookeeper\test\EnforceQuotaTest.java,57,0,5,7,0,12
zookeeper-master\zookeeper-master\zookeeper-server\src\test\java\org\apache\zookeeper\test\ThrottledOpObserverTest.java,43,0,0,2,0,2
zookeeper-master\zookeeper-master\zookeeper-server\src\main\java\org\apache\zookeeper\audit\AuditEvent.java,0,0,3,1,0,4
zookeeper-master\zookeeper-master\zookeeper-server\src\main\java\org\apache\zookeeper\server\quorum\FollowerMXBean.java,0,0,0,4,0,4
zookeeper-master\zookeeper-master\zookeeper-recipes\zookeeper-recipes-lock\src\main\java\org\apache\zookeeper\recipes\lock\WriteLock.java,0,0,9,15,0,24
zookeeper-master\zookeeper-master\zookeeper-server\src\main\java\org\apache\zookeeper\server\watch\PathParentIterator.java,80,0,4,3,0,7
zookeeper-master\zookeeper-master\zookeeper-server\src\main\java\org\apache\zookeeper\metrics\impl\NullMetricsProvider.java,125,0,13,4,0,17
zookeeper-master\zookeeper-master\zookeeper-server\src\main\java\org\apache\zookeeper\server\quorum\FastLeaderElection.java,1173,0,38,152,0,190
zookeeper-master\zookeeper-master\zookeeper-server\src\main\java\org\apache\zookeeper\server\quorum\Election.java,0,0,0,1,0,1
zookeeper-master\zookeeper-master\zookeeper-server\src\main\java\org\apache\zookeeper\jmx\ManagedUtil.java,86,0,2,15,0,17
zookeeper-master\zookeeper-master\zookeeper-contrib\zookeeper-contrib-rest\src\main\java\org\apache\zookeeper\server\jersey\jaxb\ZError.java,15,0,0,1,0,1
zookeeper-master\zookeeper-master\zookeeper-server\src\main\java\org\apache\zookeeper\server\util\VerifyingFileFactory.java,0,0,2,3,0,5
zookeeper-master\zookeeper-master\zookeeper-server\src\test\java\org\apache\zookeeper\server\persistence\FileTxnLogTest.java,216,0,37,27,0,64
zookeeper-master\zookeeper-master\zookeeper-server\src\main\java\org\apache\zookeeper\common\Time.java,33,0,1,3,0,4
zookeeper-master\zookeeper-master\zookeeper-server\src\test\java\org\apache\zookeeper\test\DisconnectableZooKeeper.java,32,0,1,4,0,5
zookeeper-master\zookeeper-master\zookeeper-server\src\test\java\org\apache\zookeeper\util\PemReaderTest.java,108,0,0,22,0,22
zookeeper-master\zookeeper-master\zookeeper-server\src\test\java\org\apache\zookeeper\server\metric\AvgMinMaxPercentileCounterTest.java,55,0,0,2,0,2
zookeeper-master\zookeeper-master\zookeeper-server\src\main\java\org\apache\zookeeper\server\quorum\ProposalRequestProcessor.java,79,0,1,8,0,9
zookeeper-master\zookeeper-master\zookeeper-contrib\zookeeper-contrib-zooinspector\src\main\java\org\apache\zookeeper\inspector\encryption\DataEncryptionManager.java,0,0,2,1,0,3
zookeeper-master\zookeeper-master\zookeeper-jute\src\main\java\org\apache\jute\compiler\JFloat.java,19,0,0,2,0,2
zookeeper-master\zookeeper-master\zookeeper-contrib\zookeeper-contrib-loggraph\src\main\java\org\apache\zookeeper\graph\RandomAccessFileReader.java,297,0,7,8,0,15
zookeeper-master\zookeeper-master\zookeeper-server\src\main\java\org\apache\zookeeper\server\quorum\auth\SaslQuorumServerCallbackHandler.java,108,0,3,11,0,14
zookeeper-master\zookeeper-master\zookeeper-server\src\test\java\org\apache\zookeeper\server\admin\JettyAdminServerTest.java,269,0,13,32,0,45
zookeeper-master\zookeeper-master\zookeeper-server\src\test\java\org\apache\zookeeper\test\ThrottledOpQuorumTest.java,71,0,0,5,0,5
zookeeper-master\zookeeper-master\zookeeper-contrib\zookeeper-contrib-loggraph\src\main\java\org\apache\zookeeper\graph\filterops\Arg.java,16,0,1,1,0,2
zookeeper-master\zookeeper-master\zookeeper-it\src\main\java\org\apache\zookeeper\test\system\InstanceContainer.java,0,0,15,16,0,31
zookeeper-master\zookeeper-master\zookeeper-server\src\main\java\org\apache\zookeeper\server\watch\WatchesSummary.java,75,0,0,1,0,1
zookeeper-master\zookeeper-master\zookeeper-server\src\test\java\org\apache\zookeeper\server\NodeHashMapImplTest.java,68,0,7,1,0,8
zookeeper-master\zookeeper-master\zookeeper-server\src\main\java\org\apache\zookeeper\common\JKSFileLoader.java,0,0,1,3,0,4
zookeeper-master\zookeeper-master\zookeeper-server\src\main\java\org\apache\zookeeper\server\command\CnxnStatResetCommand.java,18,0,0,1,0,1
zookeeper-master\zookeeper-master\zookeeper-server\src\main\java\org\apache\zookeeper\cli\SetQuotaCommand.java,306,0,28,22,0,50
zookeeper-master\zookeeper-master\zookeeper-server\src\main\java\org\apache\zookeeper\server\command\ConsCommand.java,21,0,0,1,0,1
zookeeper-master\zookeeper-master\zookeeper-server\src\main\java\org\apache\zookeeper\server\watch\IDeadWatcherListener.java,0,0,0,1,0,1
zookeeper-master\zookeeper-master\zookeeper-server\src\test\java\org\apache\zookeeper\common\ZKTrustManagerTest.java,190,0,4,39,0,43
zookeeper-master\zookeeper-master\zookeeper-contrib\zookeeper-contrib-rest\src\main\java\org\apache\zookeeper\server\jersey\resources\ZErrorWriter.java,24,0,0,1,0,1
zookeeper-master\zookeeper-master\zookeeper-server\src\main\java\org\apache\zookeeper\server\UnimplementedRequestProcessor.java,20,0,4,4,0,8
zookeeper-master\zookeeper-master\zookeeper-server\src\test\java\org\apache\zookeeper\test\ClientRetryTest.java,0,0,0,2,0,2
zookeeper-master\zookeeper-master\zookeeper-server\src\main\java\org\apache\zookeeper\server\quorum\SyncedLearnerTracker.java,69,0,4,7,0,11
zookeeper-master\zookeeper-master\zookeeper-server\src\test\java\org\apache\zookeeper\test\ObserverTest.java,44,0,3,5,0,8
zookeeper-master\zookeeper-master\zookeeper-server\src\test\java\org\apache\zookeeper\server\quorum\QuorumSSLTest.java,838,0,39,162,0,201
zookeeper-master\zookeeper-master\zookeeper-server\src\main\java\org\apache\zookeeper\server\metric\AvgMinMaxCounterSet.java,46,0,0,3,0,3
zookeeper-master\zookeeper-master\zookeeper-server\src\main\java\org\apache\zookeeper\server\quorum\LearnerSyncThrottler.java,89,0,2,9,0,11
zookeeper-master\zookeeper-master\zookeeper-server\src\test\java\org\apache\zookeeper\server\NIOServerCnxnFactoryTest.java,45,0,8,2,0,10
zookeeper-master\zookeeper-master\zookeeper-server\src\main\java\org\apache\zookeeper\common\X509Exception.java,56,0,1,1,0,2
zookeeper-master\zookeeper-master\zookeeper-server\src\main\java\org\apache\zookeeper\server\quorum\UnifiedServerSocket.java,736,0,2,134,0,136
zookeeper-master\zookeeper-master\zookeeper-recipes\zookeeper-recipes-lock\src\test\java\org\apache\zookeeper\recipes\lock\ZNodeNameTest.java,165,0,0,7,0,7
zookeeper-master\zookeeper-master\zookeeper-server\src\test\java\org\apache\zookeeper\server\quorum\EpochWriteFailureTest.java,119,0,4,18,0,22
zookeeper-master\zookeeper-master\zookeeper-it\target\generated-sources\annotations\org\apache\zookeeper\server\watch\generated\WatchBench_IterationState_jmhType_B3.java,0,0,17,18,0,35
zookeeper-master\zookeeper-master\zookeeper-server\src\main\java\org\apache\zookeeper\Op.java,536,0,40,30,0,70
zookeeper-master\zookeeper-master\zookeeper-server\src\test\java\org\apache\zookeeper\test\LeaderSessionTrackerTest.java,108,0,21,11,0,32
zookeeper-master\zookeeper-master\zookeeper-server\src\main\java\org\apache\zookeeper\server\watch\WatchesReport.java,56,0,0,1,0,1
zookeeper-master\zookeeper-master\zookeeper-server\src\test\java\org\apache\zookeeper\server\util\ConfigUtilsTest.java,94,0,9,4,0,13
zookeeper-master\zookeeper-master\zookeeper-server\src\test\java\org\apache\zookeeper\server\quorum\FLEMalformedNotificationMessageTest.java,212,0,2,36,0,38
zookeeper-master\zookeeper-master\zookeeper-server\src\test\java\org\apache\zookeeper\test\GetProposalFromTxnTest.java,89,0,12,6,0,18
zookeeper-master\zookeeper-master\zookeeper-server\src\main\java\org\apache\zookeeper\server\quorum\QuorumCnxManager.java,1393,0,45,137,0,182
zookeeper-master\zookeeper-master\zookeeper-server\src\main\java\org\apache\zookeeper\server\quorum\Follower.java,248,0,17,16,0,33
zookeeper-master\zookeeper-master\zookeeper-server\src\main\java\org\apache\zookeeper\server\quorum\ServerMXBean.java,0,0,0,1,0,1
zookeeper-master\zookeeper-master\zookeeper-contrib\zookeeper-contrib-loggraph\src\main\java\org\apache\zookeeper\graph\JsonGenerator.java,199,0,11,12,0,23
zookeeper-master\zookeeper-master\zookeeper-server\src\main\java\org\apache\zookeeper\server\embedded\ZooKeeperServerEmbedded.java,0,0,0,12,0,12
zookeeper-master\zookeeper-master\zookeeper-jute\src\test\java\org\apache\jute\TestCheckWriterReader.java,0,0,1,1,0,2
zookeeper-master\zookeeper-master\zookeeper-server\src\test\java\org\apache\zookeeper\test\NIOConnectionFactoryFdLeakTest.java,33,0,2,3,0,5
zookeeper-master\zookeeper-master\zookeeper-server\src\main\java\org\apache\zookeeper\common\IOUtils.java,91,0,4,3,0,7
zookeeper-master\zookeeper-master\zookeeper-server\src\main\java\org\apache\zookeeper\common\SecretUtils.java,0,0,1,6,0,7
zookeeper-master\zookeeper-master\zookeeper-server\src\test\java\org\apache\zookeeper\test\WatcherFuncTest.java,427,0,82,23,0,105
zookeeper-master\zookeeper-master\zookeeper-server\src\test\java\org\apache\zookeeper\test\FourLetterWordsTest.java,208,0,9,8,0,17
zookeeper-master\zookeeper-master\zookeeper-server\src\test\java\org\apache\zookeeper\test\NullDataTest.java,47,0,5,2,0,7
zookeeper-master\zookeeper-master\zookeeper-server\src\test\java\org\apache\zookeeper\server\MultiOpSessionUpgradeTest.java,91,0,20,23,0,43
zookeeper-master\zookeeper-master\zookeeper-server\src\main\java\org\apache\zookeeper\cli\AddAuthCommand.java,41,0,0,1,0,1
zookeeper-master\zookeeper-master\zookeeper-server\src\main\java\org\apache\zookeeper\server\command\StatResetCommand.java,22,0,1,2,0,3
zookeeper-master\zookeeper-master\zookeeper-server\src\test\java\org\apache\zookeeper\test\BufferSizeTest.java,103,0,7,13,0,20
zookeeper-master\zookeeper-master\zookeeper-jute\src\main\java\org\apache\jute\Utils.java,23,0,1,2,0,3
zookeeper-master\zookeeper-master\zookeeper-contrib\zookeeper-contrib-zooinspector\src\test\java\org\apache\zookeeper\inspector\LoggerTest.java,21,0,1,3,0,4
zookeeper-master\zookeeper-master\zookeeper-recipes\zookeeper-recipes-queue\src\test\java\org\apache\zookeeper\recipes\queue\DistributedQueueTest.java,0,0,12,5,0,17
zookeeper-master\zookeeper-master\zookeeper-server\src\main\java\org\apache\zookeeper\server\util\OSMXBean.java,134,0,7,11,0,18
zookeeper-master\zookeeper-master\zookeeper-server\src\test\java\org\apache\zookeeper\test\NioNettySuiteHammerTest.java,4,0,0,1,0,1
zookeeper-master\zookeeper-master\zookeeper-server\src\main\java\org\apache\zookeeper\server\quorum\flexible\QuorumOracleMaj.java,0,0,5,15,0,20
zookeeper-master\zookeeper-master\zookeeper-server\src\main\java\org\apache\zookeeper\WatchedEvent.java,50,0,4,5,0,9
zookeeper-master\zookeeper-master\zookeeper-server\src\test\java\org\apache\zookeeper\test\ResponseCacheTest.java,158,0,11,17,0,28
zookeeper-master\zookeeper-master\zookeeper-server\src\test\java\org\apache\zookeeper\server\watch\PathParentIteratorTest.java,62,0,0,3,0,3
zookeeper-master\zookeeper-master\zookeeper-server\src\test\java\org\apache\zookeeper\server\metric\SimpleCounterSetTest.java,36,0,0,3,0,3
zookeeper-master\zookeeper-master\zookeeper-contrib\zookeeper-contrib-loggraph\src\main\java\org\apache\zookeeper\graph\LogEntry.java,25,0,4,1,0,5
zookeeper-master\zookeeper-master\zookeeper-server\src\test\java\org\apache\zookeeper\server\embedded\ZookeeperServerClusterMutualAuthTest.java,105,0,1,16,0,17
zookeeper-master\zookeeper-master\zookeeper-server\src\main\java\org\apache\zookeeper\Transaction.java,39,0,2,3,0,5
zookeeper-master\zookeeper-master\zookeeper-server\src\test\java\org\apache\zookeeper\server\quorum\QuorumCnxManagerSocketConnectionTimeoutTest.java,77,0,0,16,0,16
zookeeper-master\zookeeper-master\zookeeper-server\src\main\java\org\apache\zookeeper\AsyncCallback.java,0,0,8,70,0,78
zookeeper-master\zookeeper-master\zookeeper-contrib\zookeeper-contrib-rest\src\main\java\org\apache\zookeeper\server\jersey\filters\HTTPBasicAuth.java,53,0,4,1,0,5
zookeeper-master\zookeeper-master\zookeeper-server\src\main\java\org\apache\zookeeper\server\quorum\flexible\QuorumVerifier.java,0,0,1,5,0,6
zookeeper-master\zookeeper-master\zookeeper-server\src\main\java\org\apache\zookeeper\server\quorum\LocalSessionTracker.java,24,0,0,2,0,2
zookeeper-master\zookeeper-master\zookeeper-server\src\main\java\org\apache\zookeeper\server\auth\ServerAuthenticationProvider.java,116,0,6,9,0,15
zookeeper-master\zookeeper-master\zookeeper-server\src\main\java\org\apache\zookeeper\audit\AuditConstants.java,0,0,0,2,0,2
zookeeper-master\zookeeper-master\zookeeper-server\src\test\java\org\apache\zookeeper\server\admin\CommandsTest.java,251,0,0,25,0,25
zookeeper-master\zookeeper-master\zookeeper-contrib\zookeeper-contrib-rest\src\main\java\org\apache\zookeeper\server\jersey\resources\RuntimeExceptionMapper.java,0,0,0,1,0,1
zookeeper-master\zookeeper-master\zookeeper-server\src\test\java\org\apache\zookeeper\server\quorum\QuorumPeerMainMultiAddressTest.java,297,0,10,69,0,79
zookeeper-master\zookeeper-master\zookeeper-jute\src\main\java\org\apache\jute\BinaryOutputArchive.java,123,0,6,1,0,7
zookeeper-master\zookeeper-master\zookeeper-server\src\main\java\org\apache\zookeeper\ServerAdminClient.java,249,0,20,6,0,26
zookeeper-master\zookeeper-master\zookeeper-server\src\test\java\org\apache\zookeeper\test\QuorumTest.java,358,0,27,33,0,60
zookeeper-master\zookeeper-master\zookeeper-server\src\test\java\org\apache\zookeeper\test\ReadOnlyModeTest.java,286,0,29,42,0,71
zookeeper-master\zookeeper-master\zookeeper-server\src\test\java\org\apache\zookeeper\server\DataTreeTest.java,0,0,90,70,0,160
zookeeper-master\zookeeper-master\zookeeper-server\src\test\java\org\apache\zookeeper\server\quorum\WatchLeakTest.java,274,0,24,17,0,41
zookeeper-master\zookeeper-master\zookeeper-server\src\test\java\org\apache\zookeeper\test\AuthTest.java,232,0,32,18,0,50
zookeeper-master\zookeeper-master\zookeeper-it\src\main\java\org\apache\zookeeper\test\system\NoAssignmentException.java,5,0,0,1,0,1
zookeeper-master\zookeeper-master\zookeeper-server\src\test\java\org\apache\zookeeper\common\ZKHostnameVerifierTest.java,130,0,4,7,0,11
zookeeper-master\zookeeper-master\zookeeper-server\src\test\java\org\apache\zookeeper\test\ClientTest.java,792,0,127,65,0,192
zookeeper-master\zookeeper-master\zookeeper-server\src\main\java\org\apache\zookeeper\server\quorum\Leader.java,1692,0,68,167,0,235
zookeeper-master\zookeeper-master\zookeeper-contrib\zookeeper-contrib-rest\src\main\java\org\apache\zookeeper\server\jersey\jaxb\ZChildren.java,47,0,1,1,0,2
zookeeper-master\zookeeper-master\zookeeper-server\src\test\java\org\apache\zookeeper\server\util\BitHashSetTest.java,77,0,4,5,0,9
zookeeper-master\zookeeper-master\zookeeper-server\src\main\java\org\apache\zookeeper\cli\AclParser.java,54,0,10,5,0,15
zookeeper-master\zookeeper-master\zookeeper-contrib\zookeeper-contrib-loggraph\src\main\java\org\apache\zookeeper\graph\LogIterator.java,0,0,1,2,0,3
zookeeper-master\zookeeper-master\zookeeper-server\src\main\java\org\apache\zookeeper\metrics\MetricsProviderLifeCycleException.java,21,0,1,1,0,2
zookeeper-master\zookeeper-master\zookeeper-contrib\zookeeper-contrib-loggraph\src\test\java\org\apache\zookeeper\graph\servlets\FileLoaderTest.java,90,0,4,8,0,12
zookeeper-master\zookeeper-master\zookeeper-server\src\main\java\org\apache\zookeeper\server\ExitCode.java,0,0,0,2,0,2
zookeeper-master\zookeeper-master\zookeeper-server\src\main\java\org\apache\zookeeper\server\ExpiryQueue.java,0,0,1,6,0,7
zookeeper-master\zookeeper-master\zookeeper-server\src\test\java\org\apache\zookeeper\audit\AuditLogPerfReading.java,0,0,0,1,0,1
zookeeper-master\zookeeper-master\zookeeper-server\src\test\java\org\apache\zookeeper\test\InvalidSnapshotTest.java,83,0,4,12,0,16
zookeeper-master\zookeeper-master\zookeeper-server\src\test\java\org\apache\zookeeper\test\WatchEventWhenAutoResetTest.java,0,0,14,12,0,26
zookeeper-master\zookeeper-master\zookeeper-server\src\main\java\org\apache\zookeeper\AddWatchMode.java,0,0,0,7,0,7
zookeeper-master\zookeeper-master\zookeeper-server\src\main\java\org\apache\zookeeper\server\controller\CommandListener.java,62,0,0,8,0,8
zookeeper-master\zookeeper-master\zookeeper-server\src\test\java\org\apache\zookeeper\test\AsyncOps.java,792,0,124,24,0,148
zookeeper-master\zookeeper-master\zookeeper-server\src\test\java\org\apache\zookeeper\server\controller\ZooKeeperServerControllerEndToEndTest.java,346,0,22,46,0,68
zookeeper-master\zookeeper-master\zookeeper-server\src\test\java\org\apache\zookeeper\server\quorum\DelayRequestProcessor.java,47,0,2,7,0,9
zookeeper-master\zookeeper-master\zookeeper-server\src\test\java\org\apache\zookeeper\test\SessionTest.java,348,0,38,28,0,66
zookeeper-master\zookeeper-master\zookeeper-server\src\main\java\org\apache\zookeeper\cli\CommandNotFoundException.java,8,0,1,1,0,2
zookeeper-master\zookeeper-master\zookeeper-jute\src\main\java\org\apache\jute\compiler\JCompType.java,53,0,0,6,0,6
zookeeper-master\zookeeper-master\zookeeper-server\src\test\java\org\apache\zookeeper\server\watch\WatchesReportTest.java,40,0,0,1,0,1
zookeeper-master\zookeeper-master\zookeeper-server\src\main\java\org\apache\zookeeper\server\auth\X509AuthenticationProvider.java,193,0,7,24,0,31
zookeeper-master\zookeeper-master\zookeeper-server\src\main\java\org\apache\zookeeper\Watcher.java,0,0,0,6,0,6
zookeeper-master\zookeeper-master\zookeeper-contrib\zookeeper-contrib-rest\src\test\java\org\apache\zookeeper\server\jersey\GetChildrenTest.java,0,0,1,4,0,5
zookeeper-master\zookeeper-master\zookeeper-it\target\generated-sources\annotations\org\apache\zookeeper\server\watch\generated\WatchBench_IterationState_jmhType_B2.java,21,0,10,8,0,18
zookeeper-master\zookeeper-master\zookeeper-server\src\main\java\org\apache\zookeeper\server\metric\SimpleCounter.java,32,0,0,1,0,1
zookeeper-master\zookeeper-master\zookeeper-server\src\test\java\org\apache\zookeeper\server\MockServerCnxn.java,94,0,13,2,0,15
zookeeper-master\zookeeper-master\zookeeper-server\src\main\java\org\apache\zookeeper\server\util\QuotaMetricsUtils.java,0,0,1,33,0,34
zookeeper-master\zookeeper-master\zookeeper-server\src\test\java\org\apache\zookeeper\server\quorum\EphemeralNodeDeletionTest.java,195,0,22,15,0,37
zookeeper-master\zookeeper-master\zookeeper-server\src\main\java\org\apache\zookeeper\server\RateLogger.java,65,0,0,1,0,1
zookeeper-master\zookeeper-master\zookeeper-server\src\main\java\org\apache\zookeeper\server\controller\ControllerService.java,134,0,4,16,0,20
zookeeper-master\zookeeper-master\zookeeper-server\src\test\java\org\apache\zookeeper\test\QuorumOracleMajTest.java,92,0,1,6,0,7
zookeeper-master\zookeeper-master\zookeeper-server\src\main\java\org\apache\zookeeper\server\controller\CommandClient.java,100,0,1,16,0,17
zookeeper-master\zookeeper-master\zookeeper-server\src\main\java\org\apache\zookeeper\server\quorum\ReadOnlyRequestProcessor.java,99,0,5,6,0,11
zookeeper-master\zookeeper-master\zookeeper-server\src\test\java\org\apache\zookeeper\test\ChrootAsyncTest.java,24,0,2,3,0,5
zookeeper-master\zookeeper-master\zookeeper-server\src\main\java\org\apache\zookeeper\server\DataNode.java,173,0,23,7,0,30
zookeeper-master\zookeeper-master\zookeeper-server\src\main\java\org\apache\zookeeper\metrics\GaugeSet.java,0,0,0,3,0,3
zookeeper-master\zookeeper-master\zookeeper-server\src\main\java\org\apache\zookeeper\server\command\WatchCommand.java,27,0,0,1,0,1
zookeeper-master\zookeeper-master\zookeeper-server\src\test\java\org\apache\zookeeper\server\quorum\CommitProcessorMetricsTest.java,467,0,5,45,0,50
zookeeper-master\zookeeper-master\zookeeper-server\src\main\java\org\apache\zookeeper\common\StringUtils.java,72,0,1,8,0,9
zookeeper-master\zookeeper-master\zookeeper-server\src\test\java\org\apache\zookeeper\server\persistence\FileTxnSnapLogMetricsTest.java,56,0,3,7,0,10
zookeeper-master\zookeeper-master\zookeeper-contrib\zookeeper-contrib-rest\src\main\java\org\apache\zookeeper\server\jersey\cfg\HostPort.java,32,0,0,1,0,1
zookeeper-master\zookeeper-master\zookeeper-server\src\test\java\org\apache\zookeeper\test\ObserverLETest.java,44,0,0,6,0,6
zookeeper-master\zookeeper-master\zookeeper-server\src\test\java\org\apache\zookeeper\test\TruncateTest.java,183,0,31,15,0,46
zookeeper-master\zookeeper-master\zookeeper-server\src\main\java\org\apache\zookeeper\server\quorum\AckRequestProcessor.java,0,0,1,3,0,4
zookeeper-master\zookeeper-master\zookeeper-contrib\zookeeper-contrib-loggraph\src\main\java\org\apache\zookeeper\graph\servlets\NumEvents.java,0,0,6,3,0,9
zookeeper-master\zookeeper-master\zookeeper-server\src\test\java\org\apache\zookeeper\server\quorum\QuorumPeerTestBase.java,526,0,17,51,0,68
zookeeper-master\zookeeper-master\zookeeper-server\src\main\java\org\apache\zookeeper\client\StaticHostProvider.java,0,0,7,46,0,53
zookeeper-master\zookeeper-master\zookeeper-server\src\test\java\org\apache\zookeeper\server\quorum\QuorumServerTest.java,122,0,2,18,0,20
zookeeper-master\zookeeper-master\zookeeper-contrib\zookeeper-contrib-loggraph\src\main\java\org\apache\zookeeper\graph\Log4JEntry.java,22,0,1,1,0,2
zookeeper-master\zookeeper-master\zookeeper-server\src\main\java\org\apache\zookeeper\server\watch\IWatchManager.java,0,0,0,4,0,4
zookeeper-master\zookeeper-master\zookeeper-contrib\zookeeper-contrib-zooinspector\src\main\java\org\apache\zookeeper\inspector\gui\nodeviewer\NodeViewerACL.java,146,0,2,3,0,5
zookeeper-master\zookeeper-master\zookeeper-server\src\test\java\org\apache\zookeeper\CustomHostProviderTest.java,58,0,8,3,0,11
zookeeper-master\zookeeper-master\zookeeper-server\src\test\java\org\apache\zookeeper\common\PKCS12FileLoaderTest.java,160,0,0,22,0,22
zookeeper-master\zookeeper-master\zookeeper-server\src\test\java\org\apache\zookeeper\common\ZKConfigTest.java,69,0,5,8,0,13
zookeeper-master\zookeeper-master\zookeeper-contrib\zookeeper-contrib-loggraph\src\main\java\org\apache\zookeeper\graph\servlets\Throughput.java,0,0,5,3,0,8
zookeeper-master\zookeeper-master\zookeeper-server\src\main\java\org\apache\zookeeper\server\admin\CommandResponse.java,89,0,0,1,0,1
zookeeper-master\zookeeper-master\zookeeper-server\src\test\java\org\apache\zookeeper\test\ChrootTest.java,103,0,17,7,0,24
zookeeper-master\zookeeper-master\zookeeper-server\src\test\java\org\apache\zookeeper\test\GetChildren2Test.java,100,0,14,7,0,21
zookeeper-master\zookeeper-master\zookeeper-server\src\test\java\org\apache\zookeeper\test\ClientPortBindTest.java,65,0,2,6,0,8
zookeeper-master\zookeeper-master\zookeeper-server\src\main\java\org\apache\zookeeper\server\metric\AvgMinMaxPercentileCounter.java,102,0,2,7,0,9
zookeeper-master\zookeeper-master\zookeeper-server\src\test\java\org\apache\zookeeper\server\persistence\SnapStreamTest.java,103,0,7,7,0,14
zookeeper-master\zookeeper-master\zookeeper-server\src\main\java\org\apache\zookeeper\server\TraceFormatter.java,58,0,3,2,0,5
zookeeper-master\zookeeper-master\zookeeper-server\src\test\java\org\apache\zookeeper\server\quorum\LearnerMetricsTest.java,99,0,1,19,0,20
zookeeper-master\zookeeper-master\zookeeper-server\src\main\java\org\apache\zookeeper\server\persistence\SnapShot.java,0,0,0,3,0,3
zookeeper-master\zookeeper-master\zookeeper-server\src\test\java\org\apache\zookeeper\test\WatchedEventTest.java,66,0,8,3,0,11
zookeeper-master\zookeeper-master\zookeeper-server\src\test\java\org\apache\zookeeper\server\quorum\CommitProcessorTest.java,442,0,21,41,0,62
zookeeper-master\zookeeper-master\zookeeper-it\src\main\java\org\apache\zookeeper\test\system\GenerateLoad.java,660,0,44,19,0,63
zookeeper-master\zookeeper-master\zookeeper-server\src\test\java\org\apache\zookeeper\server\embedded\ZookeeperServerSslEmbeddedTest.java,86,0,9,13,0,22
zookeeper-master\zookeeper-master\zookeeper-server\src\main\java\org\apache\zookeeper\common\FileKeyStoreLoaderBuilderProvider.java,27,0,1,3,0,4
zookeeper-master\zookeeper-master\zookeeper-server\src\test\java\org\apache\zookeeper\test\AtomicFileOutputStreamTest.java,166,0,11,8,0,19
zookeeper-master\zookeeper-master\zookeeper-jute\src\main\java\org\apache\jute\compiler\CppGenerator.java,0,0,6,26,0,32
zookeeper-master\zookeeper-master\zookeeper-contrib\zookeeper-contrib-loggraph\src\main\java\org\apache\zookeeper\graph\filterops\AndOp.java,11,0,0,1,0,1
zookeeper-master\zookeeper-master\zookeeper-server\src\main\java\org\apache\zookeeper\Testable.java,0,0,0,1,0,1
zookeeper-master\zookeeper-master\zookeeper-server\src\main\java\org\apache\zookeeper\server\ServerCnxnHelper.java,16,0,1,2,0,3
zookeeper-master\zookeeper-master\zookeeper-contrib\zookeeper-contrib-zooinspector\src\main\java\org\apache\zookeeper\inspector\encryption\BasicDataEncryptionManager.java,32,0,0,3,0,3
zookeeper-master\zookeeper-master\zookeeper-it\target\generated-sources\annotations\org\apache\zookeeper\server\watch\generated\WatchBench_jmhType_B3.java,0,0,17,17,0,34
zookeeper-master\zookeeper-master\zookeeper-server\src\main\java\org\apache\zookeeper\common\PEMFileLoader.java,0,0,1,5,0,6
zookeeper-master\zookeeper-master\zookeeper-contrib\zookeeper-contrib-rest\src\test\java\org\apache\zookeeper\JUnit4ZKTestRunner.java,85,0,6,6,0,12
zookeeper-master\zookeeper-master\zookeeper-server\src\test\java\org\apache\zookeeper\server\quorum\LeaderWithObserverTest.java,146,0,5,23,0,28
zookeeper-master\zookeeper-master\zookeeper-server\src\test\java\org\apache\zookeeper\test\SessionTrackerCheckTest.java,183,0,6,7,0,13
zookeeper-master\zookeeper-master\zookeeper-server\src\main\java\org\apache\zookeeper\server\ByteBufferOutputStream.java,26,0,0,2,0,2
zookeeper-master\zookeeper-master\zookeeper-contrib\zookeeper-contrib-zooinspector\src\main\java\org\apache\zookeeper\inspector\manager\Pair.java,0,0,7,1,0,8
zookeeper-master\zookeeper-master\zookeeper-server\src\test\java\org\apache\zookeeper\util\TestCircularBlockingQueue.java,51,0,1,2,0,3
zookeeper-master\zookeeper-master\zookeeper-server\src\main\java\org\apache\zookeeper\cli\SyncCommand.java,55,0,1,1,0,2
zookeeper-master\zookeeper-master\zookeeper-it\target\generated-sources\annotations\org\apache\zookeeper\server\watch\generated\WatchBench_AddSparseWatchState_jmhType_B1.java,0,0,19,18,0,37
zookeeper-master\zookeeper-master\zookeeper-server\src\test\java\org\apache\zookeeper\server\quorum\StatResetCommandTest.java,77,0,0,3,0,3
zookeeper-master\zookeeper-master\zookeeper-server\src\test\java\org\apache\zookeeper\test\ClientSkipACLTest.java,14,0,0,1,0,1
zookeeper-master\zookeeper-master\zookeeper-server\src\main\java\org\apache\zookeeper\server\PurgeTxnLog.java,193,0,1,28,0,29
zookeeper-master\zookeeper-master\zookeeper-server\src\test\java\org\apache\zookeeper\common\FileKeyStoreLoaderBuilderProviderTest.java,29,0,0,5,0,5
zookeeper-master\zookeeper-master\zookeeper-server\src\main\java\org\apache\zookeeper\server\quorum\QuorumPeer.java,0,0,55,196,0,251
zookeeper-master\zookeeper-master\zookeeper-contrib\zookeeper-contrib-zooinspector\src\main\java\org\apache\zookeeper\inspector\manager\NodeListener.java,0,0,1,1,0,2
zookeeper-master\zookeeper-master\zookeeper-server\src\main\java\org\apache\zookeeper\jmx\MBeanRegistry.java,184,0,8,10,0,18
zookeeper-master\zookeeper-master\zookeeper-server\src\main\java\org\apache\zookeeper\server\quorum\LocalPeerMXBean.java,0,0,0,1,0,1
zookeeper-master\zookeeper-master\zookeeper-server\src\main\java\org\apache\zookeeper\client\ConnectStringParser.java,0,0,2,2,0,4
zookeeper-master\zookeeper-master\zookeeper-server\src\test\java\org\apache\zookeeper\server\quorum\auth\QuorumKerberosAuthTest.java,120,0,4,16,0,20
zookeeper-master\zookeeper-master\zookeeper-server\src\test\java\org\apache\zookeeper\metrics\BaseTestMetricsProvider.java,117,0,5,11,0,16
zookeeper-master\zookeeper-master\zookeeper-server\src\main\java\org\apache\zookeeper\server\ReferenceCountedACLCache.java,213,0,40,6,0,46
zookeeper-master\zookeeper-master\zookeeper-server\src\test\java\org\apache\zookeeper\server\quorum\CnxManagerTest.java,622,0,44,50,0,94
zookeeper-master\zookeeper-master\zookeeper-contrib\zookeeper-contrib-zooinspector\src\main\java\org\apache\zookeeper\inspector\gui\ZooInspectorNodeViewersDialog.java,566,0,39,34,0,73
zookeeper-master\zookeeper-master\zookeeper-server\src\main\java\org\apache\zookeeper\ZooKeeper.java,2951,0,111,210,0,321
zookeeper-master\zookeeper-master\zookeeper-metrics-providers\zookeeper-prometheus-metrics\src\test\java\org\apache\zookeeper\metrics\prometheus\PrometheusMetricsProviderTest.java,619,0,30,41,0,71
zookeeper-master\zookeeper-master\zookeeper-server\src\main\java\org\apache\zookeeper\server\DataTreeBean.java,0,0,1,1,0,2
zookeeper-master\zookeeper-master\zookeeper-server\src\test\java\org\apache\zookeeper\server\quorum\ReconfigFailureCasesTest.java,201,0,12,22,0,34
zookeeper-master\zookeeper-master\zookeeper-server\src\main\java\org\apache\zookeeper\server\quorum\auth\NullQuorumAuthServer.java,9,0,0,1,0,1
zookeeper-master\zookeeper-master\zookeeper-jute\src\main\java\org\apache\jute\compiler\JVector.java,141,0,0,19,0,19
zookeeper-master\zookeeper-master\zookeeper-server\src\test\java\org\apache\zookeeper\PortAssignmentTest.java,33,0,0,7,0,7
zookeeper-master\zookeeper-master\zookeeper-server\src\test\java\org\apache\zookeeper\test\FLENewEpochTest.java,0,0,13,9,0,22
zookeeper-master\zookeeper-master\zookeeper-server\src\main\java\org\apache\zookeeper\server\quorum\QuorumPeerConfig.java,905,0,61,101,0,162
zookeeper-master\zookeeper-master\zookeeper-server\src\test\java\org\apache\zookeeper\server\ToStringTest.java,26,0,3,1,0,4
zookeeper-master\zookeeper-master\zookeeper-server\src\test\java\org\apache\zookeeper\test\QuorumRestartTest.java,104,0,3,18,0,21
zookeeper-master\zookeeper-master\zookeeper-contrib\zookeeper-contrib-rest\src\main\java\org\apache\zookeeper\server\jersey\jaxb\ZPath.java,37,0,0,1,0,1
zookeeper-master\zookeeper-master\zookeeper-server\src\main\java\org\apache\zookeeper\server\quorum\QuorumMXBean.java,0,0,0,5,0,5
zookeeper-master\zookeeper-master\zookeeper-server\src\main\java-filtered\org\apache\zookeeper\version\VersionInfoMain.java,0,0,2,2,0,4
zookeeper-master\zookeeper-master\zookeeper-server\src\test\java\org\apache\zookeeper\server\InvalidSnapCountTest.java,87,0,4,3,0,7
zookeeper-master\zookeeper-master\zookeeper-server\src\test\java\org\apache\zookeeper\server\watch\RecursiveWatchQtyTest.java,163,0,3,9,0,12
zookeeper-master\zookeeper-master\zookeeper-server\src\main\java\org\apache\zookeeper\server\quorum\flexible\QuorumHierarchical.java,326,0,16,10,0,26
zookeeper-master\zookeeper-master\zookeeper-server\src\main\java\org\apache\zookeeper\cli\CliParseException.java,12,0,1,1,0,2
zookeeper-master\zookeeper-master\zookeeper-server\src\test\java\org\apache\zookeeper\server\SessionTrackerTest.java,116,0,6,13,0,19
zookeeper-master\zookeeper-master\zookeeper-server\src\test\java\org\apache\zookeeper\server\admin\CommandResponseTest.java,34,0,0,1,0,1
zookeeper-master\zookeeper-master\zookeeper-server\src\test\java\org\apache\zookeeper\test\NonRecoverableErrorTest.java,135,0,10,15,0,25
zookeeper-master\zookeeper-master\zookeeper-server\src\main\java\org\apache\zookeeper\server\ClientCnxnLimitException.java,10,0,0,1,0,1
zookeeper-master\zookeeper-master\zookeeper-server\src\main\java\org\apache\zookeeper\server\quorum\ObserverMXBean.java,0,0,0,1,0,1
zookeeper-master\zookeeper-master\zookeeper-server\src\main\java\org\apache\zookeeper\WatchDeregistration.java,43,0,0,3,0,3
zookeeper-master\zookeeper-master\zookeeper-server\src\test\java\org\apache\zookeeper\test\QuorumBase.java,485,0,19,44,0,63
zookeeper-master\zookeeper-master\zookeeper-server\src\main\java\org\apache\zookeeper\ZooDefs.java,137,0,70,8,0,78
zookeeper-master\zookeeper-master\zookeeper-it\src\main\java\org\apache\zookeeper\test\system\QuorumPeerInstance.java,0,0,17,27,0,44
zookeeper-master\zookeeper-master\zookeeper-server\src\main\java\org\apache\zookeeper\Environment.java,73,0,2,5,0,7
zookeeper-master\zookeeper-master\zookeeper-server\src\main\java\org\apache\zookeeper\metrics\CounterSet.java,0,0,0,3,0,3
zookeeper-master\zookeeper-master\zookeeper-server\src\main\java\org\apache\zookeeper\server\persistence\TxnLogToolkit.java,385,0,37,32,0,69
zookeeper-master\zookeeper-master\zookeeper-server\src\test\java\org\apache\zookeeper\server\quorum\FLEOutOfElectionTest.java,88,0,1,29,0,30
zookeeper-master\zookeeper-master\zookeeper-server\src\test\java\org\apache\zookeeper\test\PersistentRecursiveWatcherTest.java,136,0,24,30,0,54
zookeeper-master\zookeeper-master\zookeeper-server\src\main\java\org\apache\zookeeper\ClientCnxnSocketNetty.java,483,0,15,31,0,46
zookeeper-master\zookeeper-master\zookeeper-server\src\main\java\org\apache\zookeeper\server\quorum\LeaderBean.java,83,0,0,1,0,1
zookeeper-master\zookeeper-master\zookeeper-server\src\main\java\org\apache\zookeeper\DigestWatcher.java,0,0,0,1,0,1
zookeeper-master\zookeeper-master\zookeeper-server\src\test\java\org\apache\zookeeper\test\FollowerResyncConcurrencyTest.java,639,0,42,88,0,130
zookeeper-master\zookeeper-master\zookeeper-server\src\main\java\org\apache\zookeeper\server\ServerStats.java,212,0,3,5,0,8
zookeeper-master\zookeeper-master\zookeeper-contrib\zookeeper-contrib-fatjar\src\main\java\org\apache\zookeeper\util\FatJarMain.java,88,0,4,4,0,8
zookeeper-master\zookeeper-master\zookeeper-server\src\test\java\org\apache\zookeeper\server\quorum\LearnerTest.java,309,0,19,26,0,45
zookeeper-master\zookeeper-master\zookeeper-jute\src\main\java\org\apache\jute\Index.java,0,0,0,1,0,1
zookeeper-master\zookeeper-master\zookeeper-server\src\main\java\org\apache\zookeeper\server\admin\CommandOutputter.java,0,0,0,1,0,1
zookeeper-master\zookeeper-master\zookeeper-server\src\main\java\org\apache\zookeeper\server\ZooKeeperServer.java,0,0,129,189,0,318
zookeeper-master\zookeeper-master\zookeeper-server\src\main\java\org\apache\zookeeper\common\PathUtils.java,0,0,5,8,0,13
zookeeper-master\zookeeper-master\zookeeper-server\src\main\java\org\apache\zookeeper\audit\Slf4jAuditLogger.java,13,0,2,2,0,4
zookeeper-master\zookeeper-master\zookeeper-server\src\main\java\org\apache\zookeeper\server\EphemeralTypeEmulate353.java,0,0,2,5,0,7
zookeeper-master\zookeeper-master\zookeeper-server\src\main\java\org\apache\zookeeper\server\ServerConfig.java,141,0,0,3,0,3
zookeeper-master\zookeeper-master\zookeeper-server\src\main\java\org\apache\zookeeper\server\quorum\CommitProcessor.java,570,0,9,80,0,89
zookeeper-master\zookeeper-master\zookeeper-contrib\zookeeper-contrib-loggraph\src\main\java\org\apache\zookeeper\graph\TxnLogSource.java,323,0,51,21,0,72
zookeeper-master\zookeeper-master\zookeeper-server\src\main\java\org\apache\zookeeper\server\command\SetTraceMaskCommand.java,15,0,0,2,0,2
zookeeper-master\zookeeper-master\zookeeper-server\src\test\java\org\apache\zookeeper\server\embedded\ZookeeperServerClusterTest.java,92,0,1,14,0,15
zookeeper-master\zookeeper-master\zookeeper-contrib\zookeeper-contrib-rest\src\main\java\org\apache\zookeeper\server\jersey\cfg\RestCfg.java,85,0,0,1,0,1
zookeeper-master\zookeeper-master\zookeeper-server\src\main\java\org\apache\zookeeper\server\quorum\ObserverRequestProcessor.java,132,0,6,9,0,15
zookeeper-master\zookeeper-master\zookeeper-contrib\zookeeper-contrib-loggraph\src\main\java\org\apache\zookeeper\graph\MergedLogSource.java,164,0,14,10,0,24
zookeeper-master\zookeeper-master\zookeeper-server\src\main\java\org\apache\zookeeper\OpResult.java,291,0,34,12,0,46
zookeeper-master\zookeeper-master\zookeeper-server\src\main\java\org\apache\zookeeper\server\quorum\LearnerMaster.java,223,0,3,19,0,22
zookeeper-master\zookeeper-master\zookeeper-jute\src\main\java\org\apache\jute\Record.java,0,0,0,1,0,1
zookeeper-master\zookeeper-master\zookeeper-server\src\main\java\org\apache\zookeeper\server\quorum\LearnerZooKeeperServer.java,142,0,1,9,0,10
zookeeper-master\zookeeper-master\zookeeper-server\src\main\java\org\apache\zookeeper\server\quorum\RemotePeerMXBean.java,0,0,0,1,0,1
zookeeper-master\zookeeper-master\zookeeper-recipes\zookeeper-recipes-lock\src\main\java\org\apache\zookeeper\recipes\lock\ZNodeName.java,0,0,0,6,0,6
zookeeper-master\zookeeper-master\zookeeper-server\src\main\java\org\apache\zookeeper\cli\LsCommand.java,103,0,5,4,0,9
zookeeper-master\zookeeper-master\zookeeper-contrib\zookeeper-contrib-rest\src\main\java\org\apache\zookeeper\server\jersey\resources\SessionsResource.java,87,0,4,1,0,5
zookeeper-master\zookeeper-master\zookeeper-server\src\main\java\org\apache\zookeeper\common\FileKeyStoreLoader.java,54,0,2,3,0,5
zookeeper-master\zookeeper-master\zookeeper-metrics-providers\zookeeper-prometheus-metrics\src\test\java\org\apache\zookeeper\metrics\prometheus\ExportJvmInfoTest.java,33,0,0,1,0,1
zookeeper-master\zookeeper-master\zookeeper-server\src\test\java\org\apache\zookeeper\server\TxnLogCountTest.java,40,0,8,3,0,11
zookeeper-master\zookeeper-master\zookeeper-jute\src\main\java\org\apache\jute\compiler\CSharpGenerator.java,30,0,2,1,0,3
zookeeper-master\zookeeper-master\zookeeper-server\src\test\java\org\apache\zookeeper\test\SaslAuthRequiredFailNoSASLTest.java,0,0,2,4,0,6
zookeeper-master\zookeeper-master\zookeeper-server\src\test\java\org\apache\zookeeper\test\QuorumQuotaTest.java,32,0,7,4,0,11
zookeeper-master\zookeeper-master\zookeeper-server\src\main\java\org\apache\zookeeper\ZooKeeperMain.java,388,0,15,26,0,41
zookeeper-master\zookeeper-master\zookeeper-server\src\main\java\org\apache\zookeeper\server\Request.java,455,0,34,9,0,43
zookeeper-master\zookeeper-master\zookeeper-server\src\main\java\org\apache\zookeeper\server\SessionTracker.java,0,0,0,3,0,3
zookeeper-master\zookeeper-master\zookeeper-server\src\test\java\org\apache\zookeeper\DummyWatcher.java,15,0,1,1,0,2
zookeeper-master\zookeeper-master\zookeeper-server\src\main\java\org\apache\zookeeper\server\controller\ControllerServerConfig.java,121,0,2,14,0,16
zookeeper-master\zookeeper-master\zookeeper-server\src\test\java\org\apache\zookeeper\server\quorum\UnifiedServerSocketModeDetectionTest.java,391,0,5,17,0,22
zookeeper-master\zookeeper-master\zookeeper-server\src\test\java\org\apache\zookeeper\test\SaslAuthDesignatedClientTest.java,126,0,18,19,0,37
zookeeper-master\zookeeper-master\zookeeper-contrib\zookeeper-contrib-rest\src\test\java\org\apache\zookeeper\server\jersey\RootTest.java,28,0,2,2,0,4
zookeeper-master\zookeeper-master\zookeeper-server\src\main\java\org\apache\zookeeper\server\command\TraceMaskCommand.java,14,0,0,1,0,1
zookeeper-master\zookeeper-master\zookeeper-server\src\test\java\org\apache\zookeeper\ClientCanonicalizeTest.java,61,0,4,18,0,22
zookeeper-master\zookeeper-master\zookeeper-server\src\main\java\org\apache\zookeeper\util\PemReader.java,0,0,4,28,0,32
zookeeper-master\zookeeper-master\zookeeper-server\src\test\java\org\apache\zookeeper\test\FLERestartTest.java,0,0,11,8,0,19
zookeeper-master\zookeeper-master\zookeeper-server\src\main\java\org\apache\zookeeper\server\ServerMetrics.java,0,0,1,113,0,114
zookeeper-master\zookeeper-master\zookeeper-recipes\zookeeper-recipes-lock\src\main\java\org\apache\zookeeper\recipes\lock\ZooKeeperOperation.java,0,0,0,3,0,3
zookeeper-master\zookeeper-master\zookeeper-server\src\main\java\org\apache\zookeeper\util\ServiceUtils.java,49,0,2,3,0,5
zookeeper-master\zookeeper-master\zookeeper-server\src\main\java\org\apache\zookeeper\server\util\KerberosUtil.java,8,0,1,1,0,2
zookeeper-master\zookeeper-master\zookeeper-server\src\test\java\org\apache\zookeeper\test\SessionUpgradeTest.java,169,0,19,20,0,39
zookeeper-master\zookeeper-master\zookeeper-server\src\test\java\org\apache\zookeeper\server\BlueThrottleTest.java,266,0,1,30,0,31
zookeeper-master\zookeeper-master\zookeeper-server\src\test\java\org\apache\zookeeper\server\quorum\ReconfigDuringLeaderSyncTest.java,240,0,8,21,0,29
zookeeper-master\zookeeper-master\zookeeper-server\src\test\java\org\apache\zookeeper\server\util\JvmPauseMonitorTest.java,50,0,3,3,0,6
zookeeper-master\zookeeper-master\zookeeper-jute\src\main\java\org\apache\jute\compiler\JDouble.java,19,0,0,2,0,2
zookeeper-master\zookeeper-master\zookeeper-server\src\main\java\org\apache\zookeeper\KeeperException.java,955,0,25,21,0,46
zookeeper-master\zookeeper-master\zookeeper-server\src\main\java\org\apache\zookeeper\server\command\AbstractFourLetterCommand.java,49,0,0,3,0,3
zookeeper-master\zookeeper-master\zookeeper-server\src\main\java\org\apache\zookeeper\server\quorum\auth\QuorumAuthServer.java,0,0,0,2,0,2
zookeeper-master\zookeeper-master\zookeeper-recipes\zookeeper-recipes-queue\src\main\java\org\apache\zookeeper\recipes\queue\DistributedQueue.java,265,0,23,17,0,40
zookeeper-master\zookeeper-master\zookeeper-server\src\test\java\org\apache\zookeeper\server\quorum\LearnerHandlerMetricsTest.java,82,0,7,11,0,18
zookeeper-master\zookeeper-master\zookeeper-it\src\main\java\org\apache\zookeeper\server\watch\WatchBench.java,0,0,9,3,0,12
zookeeper-master\zookeeper-master\zookeeper-server\src\test\java\org\apache\zookeeper\server\ServerIdTest.java,0,0,9,7,0,16
zookeeper-master\zookeeper-master\zookeeper-server\src\main\java\org\apache\zookeeper\server\quorum\QuorumPeerMain.java,195,0,2,29,0,31
zookeeper-master\zookeeper-master\zookeeper-server\src\test\java\org\apache\zookeeper\server\quorum\auth\QuorumDigestAuthTest.java,199,0,15,25,0,40
zookeeper-master\zookeeper-master\zookeeper-contrib\zookeeper-contrib-zooinspector\src\main\java\org\apache\zookeeper\retry\ZooKeeperRetry.java,254,0,29,3,0,32
zookeeper-master\zookeeper-master\zookeeper-contrib\zookeeper-contrib-zooinspector\src\main\java\org\apache\zookeeper\inspector\ZooInspector.java,38,0,1,1,0,2
zookeeper-master\zookeeper-master\zookeeper-server\src\main\java\org\apache\zookeeper\server\admin\JsonOutputter.java,38,0,2,3,0,5
zookeeper-master\zookeeper-master\zookeeper-server\src\main\java\org\apache\zookeeper\server\command\IsroCommand.java,19,0,0,1,0,1
zookeeper-master\zookeeper-master\zookeeper-server\src\test\java\org\apache\zookeeper\server\quorum\auth\QuorumAuthUpgradeTest.java,188,0,11,41,0,52
zookeeper-master\zookeeper-master\zookeeper-server\src\test\java\org\apache\zookeeper\server\ZooKeeperServerStartupTest.java,204,0,8,29,0,37
zookeeper-master\zookeeper-master\zookeeper-jute\src\main\java\org\apache\jute\compiler\JType.java,184,0,2,19,0,21
zookeeper-master\zookeeper-master\zookeeper-contrib\zookeeper-contrib-zooinspector\src\main\java\org\apache\zookeeper\inspector\logger\LoggerFactory.java,0,0,1,2,0,3
zookeeper-master\zookeeper-master\zookeeper-jute\src\main\java\org\apache\jute\compiler\JField.java,119,0,0,2,0,2
zookeeper-master\zookeeper-master\zookeeper-server\src\main\java\org\apache\zookeeper\cli\CloseCommand.java,24,0,0,1,0,1
zookeeper-master\zookeeper-master\zookeeper-jute\src\main\java\org\apache\jute\RecordReader.java,54,0,1,3,0,4
zookeeper-master\zookeeper-master\zookeeper-server\src\main\java\org\apache\zookeeper\server\ZooKeeperServerShutdownHandler.java,0,0,0,1,0,1
zookeeper-master\zookeeper-master\zookeeper-server\src\test\java\org\apache\zookeeper\server\ByteBufferInputStreamTest.java,128,0,10,4,0,14
zookeeper-master\zookeeper-master\zookeeper-server\src\main\java\org\apache\zookeeper\server\persistence\FilePadding.java,87,0,0,7,0,7
zookeeper-master\zookeeper-master\zookeeper-recipes\zookeeper-recipes-election\src\main\java\org\apache\zookeeper\recipes\leader\LeaderElectionSupport.java,384,0,14,31,0,45
zookeeper-master\zookeeper-master\zookeeper-server\src\test\java\org\apache\zookeeper\common\NetUtilsTest.java,98,0,12,14,0,26
zookeeper-master\zookeeper-master\zookeeper-server\src\main\java\org\apache\zookeeper\server\metric\Metric.java,14,0,4,1,0,5
zookeeper-master\zookeeper-master\zookeeper-recipes\zookeeper-recipes-election\src\main\java\org\apache\zookeeper\recipes\leader\LeaderElectionAware.java,0,0,0,4,0,4
zookeeper-master\zookeeper-master\zookeeper-server\src\test\java\org\apache\zookeeper\audit\Slf4JAuditLoggerTest.java,368,0,26,14,0,40
zookeeper-master\zookeeper-master\zookeeper-server\src\test\java\org\apache\zookeeper\server\ServerStatsTest.java,116,0,2,4,0,6
zookeeper-master\zookeeper-master\zookeeper-server\src\test\java\org\apache\zookeeper\server\controller\ControlCommandTest.java,63,0,7,5,0,12
zookeeper-master\zookeeper-master\zookeeper-server\src\test\java\org\apache\zookeeper\server\quorum\StandaloneDisabledTest.java,229,0,20,27,0,47
zookeeper-master\zookeeper-master\zookeeper-server\src\test\java\org\apache\zookeeper\server\quorum\FLETestUtils.java,57,0,2,4,0,6
zookeeper-master\zookeeper-master\zookeeper-contrib\zookeeper-contrib-loggraph\src\main\java\org\apache\zookeeper\graph\filterops\NotOp.java,9,0,0,1,0,1
zookeeper-master\zookeeper-master\zookeeper-server\src\test\java\org\apache\zookeeper\test\FourLetterWordsWhiteListTest.java,224,0,9,11,0,20
zookeeper-master\zookeeper-master\zookeeper-server\src\test\java\org\apache\zookeeper\test\SessionInvalidationTest.java,70,0,13,3,0,16
zookeeper-master\zookeeper-master\zookeeper-server\src\test\java\org\apache\zookeeper\server\CreateContainerTest.java,293,0,61,62,0,123
zookeeper-master\zookeeper-master\zookeeper-it\target\generated-sources\annotations\org\apache\zookeeper\server\watch\generated\WatchBench_IterationState_jmhType_B1.java,0,0,19,18,0,37
zookeeper-master\zookeeper-master\zookeeper-server\src\test\java\org\apache\zookeeper\test\FourLetterWordsQuorumTest.java,86,0,2,4,0,6
zookeeper-master\zookeeper-master\zookeeper-server\src\main\java\org\apache\zookeeper\common\KeyStoreLoader.java,0,0,0,1,0,1
zookeeper-master\zookeeper-master\zookeeper-server\src\main\java\org\apache\zookeeper\server\quorum\QuorumStats.java,53,0,3,2,0,5
zookeeper-master\zookeeper-master\zookeeper-server\src\main\java\org\apache\zookeeper\common\ClientX509Util.java,20,0,0,2,0,2
zookeeper-master\zookeeper-master\zookeeper-server\src\main\java\org\apache\zookeeper\server\quorum\LearnerHandlerBean.java,0,0,1,8,0,9
zookeeper-master\zookeeper-master\zookeeper-server\src\main\java\org\apache\zookeeper\server\BlueThrottle.java,295,0,5,32,0,37
zookeeper-master\zookeeper-master\zookeeper-contrib\zookeeper-contrib-loggraph\src\main\java\org\apache\zookeeper\graph\TransactionEntry.java,41,0,7,4,0,11
zookeeper-master\zookeeper-master\zookeeper-server\src\main\java\org\apache\zookeeper\common\ZKTrustManager.java,132,0,1,19,0,20
zookeeper-master\zookeeper-master\zookeeper-jute\src\main\java\org\apache\jute\compiler\JByte.java,14,0,0,2,0,2
zookeeper-master\zookeeper-master\zookeeper-contrib\zookeeper-contrib-zooinspector\src\main\java\org\apache\zookeeper\inspector\gui\ZooInspectorPanel.java,206,0,5,14,0,19
zookeeper-master\zookeeper-master\zookeeper-server\src\test\java\org\apache\zookeeper\server\FollowerRequestProcessorTest.java,54,0,9,15,0,24
zookeeper-master\zookeeper-master\zookeeper-jute\src\main\java\org\apache\jute\compiler\JRecord.java,739,0,35,102,0,137
zookeeper-master\zookeeper-master\zookeeper-it\target\generated-sources\annotations\org\apache\zookeeper\server\watch\generated\WatchBench_InvocationState_jmhType_B3.java,0,0,17,18,0,35
zookeeper-master\zookeeper-master\zookeeper-server\src\test\java\org\apache\zookeeper\common\X509TestContext.java,488,0,6,77,0,83
zookeeper-master\zookeeper-master\zookeeper-server\src\main\java\org\apache\zookeeper\ClientCnxn.java,1647,0,149,164,0,313
zookeeper-master\zookeeper-master\zookeeper-server\src\main\java\org\apache\zookeeper\cli\StatPrinter.java,24,0,2,2,0,4
zookeeper-master\zookeeper-master\zookeeper-server\src\main\java\org\apache\zookeeper\common\SSLContextAndOptions.java,169,0,6,27,0,33
zookeeper-master\zookeeper-master\zookeeper-server\src\main\java\org\apache\zookeeper\server\auth\ProviderRegistry.java,70,0,1,8,0,9
zookeeper-master\zookeeper-master\zookeeper-server\src\test\java\org\apache\zookeeper\test\ReconfigExceptionTest.java,185,0,27,22,0,49
zookeeper-master\zookeeper-master\zookeeper-server\src\test\java\org\apache\zookeeper\server\controller\ControllerTestBase.java,50,0,0,6,0,6
zookeeper-master\zookeeper-master\zookeeper-server\src\main\java\org\apache\zookeeper\cli\CliWrapperException.java,42,0,1,15,0,16
zookeeper-master\zookeeper-master\zookeeper-server\src\main\java\org\apache\zookeeper\server\metric\AvgMinMaxPercentileCounterSet.java,52,0,0,7,0,7
zookeeper-master\zookeeper-master\zookeeper-server\src\main\java\org\apache\zookeeper\cli\AddWatchCommand.java,55,0,2,4,0,6
zookeeper-master\zookeeper-master\zookeeper-server\src\test\java\org\apache\zookeeper\test\ObserverQuorumHammerTest.java,19,0,0,1,0,1
zookeeper-master\zookeeper-master\zookeeper-server\src\main\java\org\apache\zookeeper\cli\CliException.java,39,0,1,1,0,2
zookeeper-master\zookeeper-master\zookeeper-server\src\main\java\org\apache\zookeeper\cli\MalformedPathException.java,8,0,1,1,0,2
zookeeper-master\zookeeper-master\zookeeper-server\src\main\java\org\apache\zookeeper\server\quorum\PrependableSocket.java,39,0,1,6,0,7
zookeeper-master\zookeeper-master\zookeeper-server\src\main\java\org\apache\zookeeper\server\quorum\StateSummary.java,36,0,2,2,0,4
zookeeper-master\zookeeper-master\zookeeper-server\src\test\java\org\apache\zookeeper\test\KeeperStateTest.java,50,0,34,1,0,35
zookeeper-master\zookeeper-master\zookeeper-server\src\test\java\org\apache\zookeeper\server\util\MessageTrackerTest.java,103,0,3,6,0,9
zookeeper-master\zookeeper-master\zookeeper-contrib\zookeeper-contrib-loggraph\src\main\java\org\apache\zookeeper\graph\LogSkipList.java,64,0,4,7,0,11
zookeeper-master\zookeeper-master\zookeeper-server\src\main\java\org\apache\zookeeper\server\quorum\LeaderElectionMXBean.java,0,0,0,1,0,1
zookeeper-master\zookeeper-master\zookeeper-server\src\test\java\org\apache\zookeeper\client\ZKClientConfigTest.java,171,0,11,9,0,20
zookeeper-master\zookeeper-master\zookeeper-server\src\main\java\org\apache\zookeeper\server\controller\ControllableConnectionFactory.java,92,0,2,7,0,9
zookeeper-master\zookeeper-master\zookeeper-server\src\test\java\org\apache\zookeeper\server\quorum\LeaderMetricsTest.java,66,0,2,5,0,7
zookeeper-master\zookeeper-master\zookeeper-contrib\zookeeper-contrib-rest\src\main\java\org\apache\zookeeper\server\jersey\resources\KeeperExceptionMapper.java,53,0,1,1,0,2
zookeeper-master\zookeeper-master\zookeeper-server\src\main\java\org\apache\zookeeper\audit\ZKAuditProvider.java,108,0,4,12,0,16
zookeeper-master\zookeeper-master\zookeeper-server\src\main\java\org\apache\zookeeper\server\quorum\RemotePeerBean.java,0,0,0,3,0,3
zookeeper-master\zookeeper-master\zookeeper-contrib\zookeeper-contrib-rest\src\test\java\org\apache\zookeeper\server\jersey\SetTest.java,106,0,6,2,0,8
zookeeper-master\zookeeper-master\zookeeper-server\src\main\java\org\apache\zookeeper\cli\RemoveWatchesCommand.java,60,0,1,2,0,3
zookeeper-master\zookeeper-master\zookeeper-server\src\main\java\org\apache\zookeeper\common\ZKConfig.java,244,0,3,29,0,32
zookeeper-master\zookeeper-master\zookeeper-server\src\main\java\org\apache\zookeeper\server\Stats.java,0,0,0,1,0,1
zookeeper-master\zookeeper-master\zookeeper-server\src\test\java\org\apache\zookeeper\test\HierarchicalQuorumTest.java,264,0,20,26,0,46
zookeeper-master\zookeeper-master\zookeeper-server\src\test\java\org\apache\zookeeper\test\LocalSessionsOnlyTest.java,90,0,8,9,0,17
zookeeper-master\zookeeper-master\zookeeper-server\src\main\java\org\apache\zookeeper\SaslServerPrincipal.java,119,0,2,11,0,13
zookeeper-master\zookeeper-master\zookeeper-server\src\main\java\org\apache\zookeeper\server\util\JvmPauseMonitor.java,169,0,4,17,0,21
zookeeper-master\zookeeper-master\zookeeper-it\target\generated-sources\annotations\org\apache\zookeeper\server\watch\generated\WatchBench_TriggerSparseWatchState_jmhType.java,0,0,1,2,0,3
zookeeper-master\zookeeper-master\zookeeper-server\src\main\java\org\apache\zookeeper\common\NettyUtils.java,113,0,3,19,0,22
zookeeper-master\zookeeper-master\zookeeper-server\src\test\java\org\apache\zookeeper\server\quorum\LeaderBeanTest.java,162,0,6,10,0,16
zookeeper-master\zookeeper-master\zookeeper-server\src\main\java\org\apache\zookeeper\server\ZooTrace.java,64,0,5,5,0,10
zookeeper-master\zookeeper-master\zookeeper-contrib\zookeeper-contrib-loggraph\src\main\java\org\apache\zookeeper\graph\LogSource.java,0,0,9,3,0,12
zookeeper-master\zookeeper-master\zookeeper-metrics-providers\zookeeper-prometheus-metrics\src\main\java\org\apache\zookeeper\metrics\prometheus\PrometheusMetricsProvider.java,546,0,3,60,0,63
zookeeper-master\zookeeper-master\zookeeper-jute\src\main\java\org\apache\jute\compiler\JFile.java,58,0,3,2,0,5
zookeeper-master\zookeeper-master\zookeeper-server\src\test\java\org\apache\zookeeper\server\quorum\RaceConditionTest.java,206,0,6,32,0,38
zookeeper-master\zookeeper-master\zookeeper-server\src\test\java\org\apache\zookeeper\test\ACLRootTest.java,64,0,16,7,0,23
zookeeper-master\zookeeper-master\zookeeper-server\src\test\java\org\apache\zookeeper\test\OOMTest.java,99,0,6,18,0,24
zookeeper-master\zookeeper-master\zookeeper-server\src\main\java\org\apache\zookeeper\cli\SetAclCommand.java,70,0,6,3,0,9
zookeeper-master\zookeeper-master\zookeeper-server\src\test\java\org\apache\zookeeper\server\RequestThrottlerTest.java,306,0,6,31,0,37
zookeeper-master\zookeeper-master\zookeeper-server\src\test\java\org\apache\zookeeper\test\StaticHostProviderTest.java,0,0,37,134,0,171
zookeeper-master\zookeeper-master\zookeeper-contrib\zookeeper-contrib-loggraph\src\main\java\org\apache\zookeeper\graph\FilterParser.java,106,0,5,3,0,8
zookeeper-master\zookeeper-master\zookeeper-server\src\main\java\org\apache\zookeeper\server\watch\WatchManagerOptimized.java,0,0,0,16,0,16
zookeeper-master\zookeeper-master\zookeeper-contrib\zookeeper-contrib-zooinspector\src\main\java\org\apache\zookeeper\inspector\gui\ZooInspectorConnectionPropertiesDialog.java,271,0,6,10,0,16
zookeeper-master\zookeeper-master\zookeeper-server\src\test\java\org\apache\zookeeper\server\NettyServerCnxnFactoryTest.java,197,0,2,21,0,23
zookeeper-master\zookeeper-master\zookeeper-it\target\generated-sources\annotations\org\apache\zookeeper\server\watch\generated\WatchBench_AddSparseWatchState_jmhType_B2.java,21,0,10,8,0,18
zookeeper-master\zookeeper-master\zookeeper-server\src\main\java\org\apache\zookeeper\server\quorum\auth\SaslQuorumAuthLearner.java,165,0,16,31,0,47
zookeeper-master\zookeeper-master\zookeeper-server\src\test\java\org\apache\zookeeper\server\quorum\CommitProcessorConcurrencyTest.java,587,0,67,89,0,156
zookeeper-master\zookeeper-master\zookeeper-server\src\main\java\org\apache\zookeeper\server\auth\EnsembleAuthenticationProvider.java,92,0,0,7,0,7
zookeeper-master\zookeeper-master\zookeeper-server\src\main\java\org\apache\zookeeper\SaslClientCallbackHandler.java,74,0,0,16,0,16
zookeeper-master\zookeeper-master\zookeeper-server\src\test\java\org\apache\zookeeper\server\quorum\QuorumPeerConfigTest.java,177,0,2,16,0,18
zookeeper-master\zookeeper-master\zookeeper-server\src\test\java\org\apache\zookeeper\test\ChrootClientTest.java,30,0,2,3,0,5
zookeeper-master\zookeeper-master\zookeeper-server\src\test\java\org\apache\zookeeper\test\LoggerTestTool.java,58,0,3,4,0,7
zookeeper-master\zookeeper-master\zookeeper-contrib\zookeeper-contrib-loggraph\src\main\java\org\apache\zookeeper\graph\servlets\Fs.java,0,0,2,2,0,4
zookeeper-master\zookeeper-master\zookeeper-server\src\test\java\org\apache\zookeeper\test\ACLCountTest.java,69,0,22,9,0,31
zookeeper-master\zookeeper-master\zookeeper-server\src\main\java\org\apache\zookeeper\cli\VersionCommand.java,35,0,1,1,0,2
zookeeper-master\zookeeper-master\zookeeper-server\src\main\java\org\apache\zookeeper\server\persistence\Util.java,232,0,11,15,0,26
zookeeper-master\zookeeper-master\zookeeper-jute\src\main\java\org\apache\jute\compiler\JBoolean.java,30,0,0,4,0,4
zookeeper-master\zookeeper-master\zookeeper-it\target\generated-sources\annotations\org\apache\zookeeper\server\watch\generated\WatchBench_AddSparseWatchState_jmhType_B3.java,0,0,17,18,0,35
zookeeper-master\zookeeper-master\zookeeper-server\src\test\java\org\apache\zookeeper\test\SaslTestUtil.java,38,0,1,4,0,5
zookeeper-master\zookeeper-master\zookeeper-server\src\main\java\org\apache\zookeeper\server\ZooKeeperServerConf.java,179,0,0,3,0,3
zookeeper-master\zookeeper-master\zookeeper-server\src\main\java\org\apache\zookeeper\server\embedded\ExitHandler.java,0,0,0,1,0,1
zookeeper-master\zookeeper-master\zookeeper-server\src\main\java\org\apache\zookeeper\cli\GetConfigCommand.java,59,0,4,2,0,6
zookeeper-master\zookeeper-master\zookeeper-server\src\main\java\org\apache\zookeeper\server\SnapshotFormatter.java,191,0,11,25,0,36
zookeeper-master\zookeeper-master\zookeeper-it\target\generated-sources\annotations\org\apache\zookeeper\server\watch\generated\WatchBench_testTriggerConcentrateWatch_jmhTest.java,0,0,158,167,0,325
zookeeper-master\zookeeper-master\zookeeper-server\src\test\java\org\apache\zookeeper\common\PEMFileLoaderTest.java,143,0,0,19,0,19
zookeeper-master\zookeeper-master\zookeeper-server\src\test\java\org\apache\zookeeper\test\SaslSuperUserTest.java,122,0,20,19,0,39
zookeeper-master\zookeeper-master\zookeeper-server\src\test\java\org\apache\zookeeper\test\ZooKeeperQuotaTest.java,552,0,64,56,0,120
zookeeper-master\zookeeper-master\zookeeper-server\src\test\java\org\apache\zookeeper\server\quorum\DIFFSyncConsistencyTest.java,250,0,20,36,0,56
zookeeper-master\zookeeper-master\zookeeper-server\src\main\java\org\apache\zookeeper\server\command\EnvCommand.java,20,0,0,1,0,1
zookeeper-master\zookeeper-master\zookeeper-it\target\generated-sources\annotations\org\apache\zookeeper\server\watch\generated\WatchBench_testAddSparseWatch_jmhTest.java,0,0,160,169,0,329
zookeeper-master\zookeeper-master\zookeeper-server\src\test\java\org\apache\zookeeper\GetAllChildrenNumberTest.java,79,0,6,12,0,18
zookeeper-master\zookeeper-master\zookeeper-contrib\zookeeper-contrib-loggraph\src\test\java\org\apache\zookeeper\graph\servlets\FsTest.java,21,0,0,2,0,2
zookeeper-master\zookeeper-master\zookeeper-server\src\test\java\org\apache\zookeeper\server\quorum\auth\KerberosSecurityTestcase.java,74,0,0,2,0,2
zookeeper-master\zookeeper-master\zookeeper-server\src\main\java\org\apache\zookeeper\server\NodeHashMap.java,0,0,0,1,0,1
zookeeper-master\zookeeper-master\zookeeper-contrib\zookeeper-contrib-rest\src\main\java\org\apache\zookeeper\server\jersey\jaxb\ZChildrenJSON.java,45,0,1,1,0,2
zookeeper-master\zookeeper-master\zookeeper-server\src\main\java\org\apache\zookeeper\cli\DeleteAllCommand.java,59,0,2,3,0,5
zookeeper-master\zookeeper-master\zookeeper-server\src\main\java\org\apache\zookeeper\common\QuorumX509Util.java,14,0,0,1,0,1
zookeeper-master\zookeeper-master\zookeeper-server\src\main\java\org\apache\zookeeper\ZooKeeperTestable.java,0,0,0,3,0,3
zookeeper-master\zookeeper-master\zookeeper-server\src\test\java\org\apache\zookeeper\server\quorum\FLEBackwardElectionRoundTest.java,115,0,1,6,0,7
zookeeper-master\zookeeper-master\zookeeper-server\src\main\java\org\apache\zookeeper\server\quorum\MultipleAddresses.java,0,0,0,22,0,22
zookeeper-master\zookeeper-master\zookeeper-server\src\test\java\org\apache\zookeeper\audit\AuditEventTest.java,23,0,0,1,0,1
zookeeper-master\zookeeper-master\zookeeper-server\src\test\java\org\apache\zookeeper\common\TimeTest.java,59,0,2,6,0,8
zookeeper-master\zookeeper-master\zookeeper-server\src\main\java\org\apache\zookeeper\server\SnapshotComparer.java,412,0,5,61,0,66
zookeeper-master\zookeeper-master\zookeeper-server\src\main\java\org\apache\zookeeper\metrics\MetricsContext.java,0,0,0,2,0,2
zookeeper-master\zookeeper-master\zookeeper-server\src\test\java\org\apache\zookeeper\GetEphemeralsTest.java,170,0,7,29,0,36
zookeeper-master\zookeeper-master\zookeeper-server\src\test\java\org\apache\zookeeper\test\QuorumHammerTest.java,28,0,0,2,0,2
zookeeper-master\zookeeper-master\zookeeper-server\src\main\java\org\apache\zookeeper\server\quorum\LearnerSessionTracker.java,182,0,6,10,0,16
zookeeper-master\zookeeper-master\zookeeper-server\src\main\java\org\apache\zookeeper\server\auth\DigestAuthenticationProvider.java,145,0,7,13,0,20
zookeeper-master\zookeeper-master\zookeeper-server\src\test\java\org\apache\zookeeper\test\DigestAuthDisabledTest.java,50,0,1,3,0,4
zookeeper-master\zookeeper-master\zookeeper-server\src\test\java\org\apache\zookeeper\server\DatadirCleanupManagerTest.java,52,0,0,13,0,13
zookeeper-master\zookeeper-master\zookeeper-server\src\main\java\org\apache\zookeeper\server\ZooKeeperThread.java,26,0,0,3,0,3
zookeeper-master\zookeeper-master\zookeeper-server\src\main\java\org\apache\zookeeper\audit\AuditHelper.java,0,0,20,21,0,41
zookeeper-master\zookeeper-master\zookeeper-server\src\test\java\org\apache\zookeeper\server\ZooKeeperServerCreationTest.java,33,0,4,3,0,7
zookeeper-master\zookeeper-master\zookeeper-contrib\zookeeper-contrib-loggraph\src\main\java\org\apache\zookeeper\graph\servlets\StaticContent.java,24,0,5,4,0,9
zookeeper-master\zookeeper-master\zookeeper-server\src\test\java\org\apache\zookeeper\server\quorum\QuorumPeerTest.java,76,0,0,7,0,7
zookeeper-master\zookeeper-master\zookeeper-contrib\zookeeper-contrib-rest\src\test\java\org\apache\zookeeper\server\jersey\SessionTest.java,97,0,4,12,0,16
zookeeper-master\zookeeper-master\zookeeper-server\src\main\java\org\apache\zookeeper\server\util\CircularBuffer.java,75,0,0,3,0,3
zookeeper-master\zookeeper-master\zookeeper-server\src\test\java\org\apache\zookeeper\test\AuthSHA2Test.java,61,0,4,13,0,17
zookeeper-master\zookeeper-master\zookeeper-server\src\main\java\org\apache\zookeeper\server\quorum\LeaderElectionBean.java,0,0,0,1,0,1
zookeeper-master\zookeeper-master\zookeeper-contrib\zookeeper-contrib-loggraph\src\main\java\org\apache\zookeeper\graph\Log4JSource.java,350,0,35,23,0,58
zookeeper-master\zookeeper-master\zookeeper-server\src\test\java\org\apache\zookeeper\audit\ZKAuditLoggerPerformance.java,120,0,5,3,0,8
zookeeper-master\zookeeper-master\zookeeper-server\src\main\java\org\apache\zookeeper\server\quorum\LearnerSyncRequest.java,11,0,2,2,0,4
zookeeper-master\zookeeper-master\zookeeper-server\src\main\java\org\apache\zookeeper\client\FourLetterWordMain.java,114,0,4,11,0,15
zookeeper-master\zookeeper-master\zookeeper-server\src\main\java\org\apache\zookeeper\Version.java,0,0,6,8,0,14
zookeeper-master\zookeeper-master\zookeeper-server\src\test\java\org\apache\zookeeper\test\MultiOperationTest.java,910,0,126,160,0,286
zookeeper-master\zookeeper-master\zookeeper-server\src\main\java\org\apache\zookeeper\server\admin\UnifiedConnectionFactory.java,87,0,2,13,0,15
zookeeper-master\zookeeper-master\zookeeper-server\src\main\java\org\apache\zookeeper\server\metric\SimpleCounterSet.java,27,0,0,3,0,3
zookeeper-master\zookeeper-master\zookeeper-server\src\main\java\org\apache\zookeeper\server\quorum\LeaderZooKeeperServer.java,265,0,2,21,0,23
zookeeper-master\zookeeper-master\zookeeper-server\src\main\java\org\apache\zookeeper\server\quorum\LearnerHandler.java,1119,0,85,81,0,166
zookeeper-master\zookeeper-master\zookeeper-server\target\generated-sources\java\org\apache\zookeeper\version\Info.java,0,0,7,1,0,8
zookeeper-master\zookeeper-master\zookeeper-server\src\test\java\org\apache\zookeeper\server\util\QuotaMetricsUtilsTest.java,289,0,19,54,0,73
zookeeper-master\zookeeper-master\zookeeper-server\src\main\java\org\apache\zookeeper\Login.java,414,0,15,65,0,80
zookeeper-master\zookeeper-master\zookeeper-server\src\main\java\org\apache\zookeeper\server\command\StatCommand.java,42,0,1,3,0,4
zookeeper-master\zookeeper-master\zookeeper-it\src\main\java\org\apache\zookeeper\test\system\Instance.java,0,0,0,1,0,1
zookeeper-master\zookeeper-master\zookeeper-server\src\main\java\org\apache\zookeeper\server\ZooKeeperServerListenerImpl.java,0,0,0,2,0,2
zookeeper-master\zookeeper-master\zookeeper-server\src\test\java\org\apache\zookeeper\server\quorum\QuorumCanonicalizeTest.java,73,0,6,11,0,17
zookeeper-master\zookeeper-master\zookeeper-it\src\main\java\org\apache\zookeeper\test\system\NoAvailableContainers.java,9,0,0,1,0,1
zookeeper-master\zookeeper-master\zookeeper-server\src\main\java\org\apache\zookeeper\server\ContainerManager.java,166,0,11,19,0,30
zookeeper-master\zookeeper-master\zookeeper-server\src\test\java\org\apache\zookeeper\RemoveWatchesCmdTest.java,270,0,26,33,0,59
zookeeper-master\zookeeper-master\zookeeper-server\src\test\java\org\apache\zookeeper\test\PersistentWatcherTest.java,187,0,19,26,0,45
zookeeper-master\zookeeper-master\zookeeper-server\src\test\java\org\apache\zookeeper\test\SaslAuthMissingClientConfigTest.java,50,0,2,14,0,16
zookeeper-master\zookeeper-master\zookeeper-recipes\zookeeper-recipes-election\src\main\java\org\apache\zookeeper\recipes\leader\LeaderOffer.java,65,0,0,2,0,2
zookeeper-master\zookeeper-master\zookeeper-server\src\test\java\org\apache\zookeeper\RemoveWatchesTest.java,1037,0,86,124,0,210
zookeeper-master\zookeeper-master\zookeeper-server\src\main\java\org\apache\zookeeper\server\quorum\Vote.java,142,0,3,9,0,12
zookeeper-master\zookeeper-master\zookeeper-server\src\main\java\org\apache\zookeeper\server\admin\ReadAheadEndpoint.java,178,0,0,5,0,5
zookeeper-master\zookeeper-master\zookeeper-server\src\main\java\org\apache\zookeeper\server\util\RequestPathMetricsCollector.java,0,0,9,80,0,89
zookeeper-master\zookeeper-master\zookeeper-server\src\test\java\org\apache\zookeeper\server\quorum\ReconfigLegacyTest.java,266,0,5,23,0,28
zookeeper-master\zookeeper-master\zookeeper-contrib\zookeeper-contrib-rest\src\main\java\org\apache\zookeeper\server\jersey\jaxb\ZStat.java,80,0,0,1,0,1
zookeeper-master\zookeeper-master\zookeeper-contrib\zookeeper-contrib-zooinspector\src\main\java\org\apache\zookeeper\inspector\manager\ZooInspectorManagerImpl.java,735,0,29,21,0,50
zookeeper-master\zookeeper-master\zookeeper-server\src\test\java\org\apache\zookeeper\server\quorum\Zab1_0Test.java,1161,0,116,140,0,256
zookeeper-master\zookeeper-master\zookeeper-server\src\main\java\org\apache\zookeeper\server\persistence\FileSnap.java,235,0,8,14,0,22
zookeeper-master\zookeeper-master\zookeeper-server\src\main\java\org\apache\zookeeper\server\watch\WatcherModeManager.java,0,0,0,6,0,6
zookeeper-master\zookeeper-master\zookeeper-server\src\test\java\org\apache\zookeeper\test\ConnectStringParserTest.java,85,0,14,25,0,39
zookeeper-master\zookeeper-master\zookeeper-server\src\main\java\org\apache\zookeeper\ZookeeperBanner.java,21,0,1,6,0,7
zookeeper-master\zookeeper-master\zookeeper-server\src\test\java\org\apache\zookeeper\test\QuorumBaseOracle_2Nodes.java,318,0,16,23,0,39
zookeeper-master\zookeeper-master\zookeeper-contrib\zookeeper-contrib-zooinspector\src\main\java\org\apache\zookeeper\inspector\gui\ZooInspectorTreeView.java,585,0,10,81,0,91
zookeeper-master\zookeeper-master\zookeeper-server\src\test\java\org\apache\zookeeper\server\embedded\ZookeeperServeInfo.java,0,0,8,44,0,52
zookeeper-master\zookeeper-master\zookeeper-server\src\test\java\org\apache\zookeeper\test\NioNettySuiteBase.java,26,0,0,3,0,3
zookeeper-master\zookeeper-master\zookeeper-server\src\test\java\org\apache\zookeeper\server\watch\WatcherOrBitSetTest.java,34,0,0,1,0,1
zookeeper-master\zookeeper-master\zookeeper-server\src\main\java\org\apache\zookeeper\server\ZooKeeperCriticalThread.java,28,0,0,5,0,5
zookeeper-master\zookeeper-master\zookeeper-server\src\test\java\org\apache\zookeeper\server\MockSelectorThread.java,0,0,2,1,0,3
zookeeper-master\zookeeper-master\zookeeper-server\src\test\java\org\apache\zookeeper\test\AsyncHammerTest.java,0,0,11,7,0,18
zookeeper-master\zookeeper-master\zookeeper-server\src\test\java\org\apache\zookeeper\test\QuotasTest.java,27,0,0,5,0,5
zookeeper-master\zookeeper-master\zookeeper-server\src\main\java\org\apache\zookeeper\server\command\RuokCommand.java,13,0,0,1,0,1
zookeeper-master\zookeeper-master\zookeeper-server\src\main\java\org\apache\zookeeper\server\quorum\FollowerBean.java,70,0,0,2,0,2
zookeeper-master\zookeeper-master\zookeeper-server\src\test\java\org\apache\zookeeper\test\IntegrityCheck.java,0,0,10,8,0,18
zookeeper-master\zookeeper-master\zookeeper-server\src\test\java\org\apache\zookeeper\server\util\AdHashTest.java,74,0,0,5,0,5
zookeeper-master\zookeeper-master\zookeeper-contrib\zookeeper-contrib-zooinspector\src\main\java\org\apache\zookeeper\inspector\gui\nodeviewer\NodeViewerData.java,100,0,2,5,0,7
zookeeper-master\zookeeper-master\zookeeper-server\src\main\java\org\apache\zookeeper\server\DataTreeMXBean.java,0,0,0,1,0,1
zookeeper-master\zookeeper-master\zookeeper-server\src\main\java\org\apache\zookeeper\cli\GetCommand.java,73,0,4,3,0,7
zookeeper-master\zookeeper-master\zookeeper-server\src\main\java\org\apache\zookeeper\cli\WhoAmICommand.java,30,0,3,3,0,6
zookeeper-master\zookeeper-master\zookeeper-server\src\main\java\org\apache\zookeeper\server\AuthenticationHelper.java,108,0,9,16,0,25
zookeeper-master\zookeeper-master\zookeeper-server\src\main\java\org\apache\zookeeper\server\SyncRequestProcessor.java,231,0,7,18,0,25
zookeeper-master\zookeeper-master\zookeeper-server\src\main\java\org\apache\zookeeper\server\command\MonitorCommand.java,42,0,0,1,0,1
zookeeper-master\zookeeper-master\zookeeper-server\src\test\java\org\apache\zookeeper\server\quorum\MultipleAddressesTest.java,222,0,7,59,0,66
zookeeper-master\zookeeper-master\zookeeper-server\src\main\java\org\apache\zookeeper\server\watch\WatchManager.java,279,0,0,18,0,18
zookeeper-master\zookeeper-master\zookeeper-server\src\test\java\org\apache\zookeeper\ClientCnxnSocketFragilityTest.java,338,0,21,15,0,36
zookeeper-master\zookeeper-master\zookeeper-server\src\test\java\org\apache\zookeeper\server\EphemeralTypeTest.java,76,0,4,6,0,10
zookeeper-master\zookeeper-master\zookeeper-server\src\main\java\org\apache\zookeeper\server\quorum\FollowerRequestProcessor.java,143,0,6,14,0,20
zookeeper-master\zookeeper-master\zookeeper-jute\src\main\java\org\apache\jute\compiler\JLong.java,18,0,0,2,0,2
zookeeper-master\zookeeper-master\zookeeper-server\src\main\java\org\apache\zookeeper\server\auth\KerberosName.java,378,0,6,24,0,30
zookeeper-master\zookeeper-master\zookeeper-server\src\test\java\org\apache\zookeeper\server\quorum\LocalPeerBeanTest.java,72,0,0,1,0,1
zookeeper-master\zookeeper-master\zookeeper-it\target\generated-sources\annotations\org\apache\zookeeper\server\watch\generated\WatchBench_InvocationState_jmhType_B1.java,0,0,19,18,0,37
zookeeper-master\zookeeper-master\zookeeper-server\src\main\java\org\apache\zookeeper\server\quorum\auth\QuorumAuthLearner.java,0,0,0,1,0,1
zookeeper-master\zookeeper-master\zookeeper-server\src\test\java\org\apache\zookeeper\server\quorum\SyncRequestProcessorMetricTest.java,67,0,1,7,0,8
zookeeper-master\zookeeper-master\zookeeper-server\src\test\java\org\apache\zookeeper\common\BaseX509ParameterizedTestCase.java,0,0,1,11,0,12
zookeeper-master\zookeeper-master\zookeeper-server\src\test\java\org\apache\zookeeper\server\persistence\TxnLogToolkitTest.java,120,0,10,15,0,25
zookeeper-master\zookeeper-master\zookeeper-server\src\main\java\org\apache\zookeeper\server\PrepRequestProcessor.java,1063,0,119,153,0,272
zookeeper-master\zookeeper-master\zookeeper-server\src\test\java\org\apache\zookeeper\test\CreateModeTest.java,64,0,0,1,0,1
zookeeper-master\zookeeper-master\zookeeper-server\src\main\java\org\apache\zookeeper\server\persistence\SnapshotInfo.java,12,0,0,1,0,1
zookeeper-master\zookeeper-master\zookeeper-server\src\test\java\org\apache\zookeeper\server\InvalidSnapshotTest.java,46,0,4,5,0,9
zookeeper-master\zookeeper-master\zookeeper-server\src\test\java\org\apache\zookeeper\KerberosTicketRenewalTest.java,223,0,3,18,0,21
zookeeper-master\zookeeper-master\zookeeper-server\src\main\java\org\apache\zookeeper\common\PathTrie.java,0,0,0,4,0,4
zookeeper-master\zookeeper-master\zookeeper-contrib\zookeeper-contrib-rest\src\test\java\org\apache\zookeeper\server\jersey\Base.java,50,0,2,1,0,3
zookeeper-master\zookeeper-master\zookeeper-server\src\test\java\org\apache\zookeeper\server\controller\ControllerClientServerTest.java,83,0,0,22,0,22
zookeeper-master\zookeeper-master\zookeeper-server\src\test\java\org\apache\zookeeper\test\EnsembleAuthTest.java,94,0,1,7,0,8
zookeeper-master\zookeeper-master\zookeeper-it\target\generated-sources\annotations\org\apache\zookeeper\server\watch\generated\WatchBench_IterationState_jmhType.java,0,0,1,2,0,3
zookeeper-master\zookeeper-master\zookeeper-server\src\main\java\org\apache\zookeeper\CreateMode.java,0,0,0,3,0,3
zookeeper-master\zookeeper-master\zookeeper-server\src\test\java\org\apache\zookeeper\test\ClientHammerTest.java,208,0,13,14,0,27
zookeeper-master\zookeeper-master\zookeeper-server\src\test\java\org\apache\zookeeper\server\SerializationPerfTest.java,94,0,4,15,0,19
zookeeper-master\zookeeper-master\zookeeper-server\src\test\java\org\apache\zookeeper\server\quorum\auth\MiniKdcTest.java,74,0,3,12,0,15
zookeeper-master\zookeeper-master\zookeeper-server\src\main\java\org\apache\zookeeper\server\auth\AuthenticationProvider.java,0,0,1,2,0,3
zookeeper-master\zookeeper-master\zookeeper-server\src\test\java\org\apache\zookeeper\server\quorum\QuorumDigestTest.java,0,0,14,5,0,19
zookeeper-master\zookeeper-master\zookeeper-server\src\main\java\org\apache\zookeeper\server\NodeHashMapImpl.java,100,0,0,1,0,1
zookeeper-master\zookeeper-master\zookeeper-server\src\test\java\org\apache\zookeeper\server\ZooKeeperServerTest.java,152,0,4,10,0,14
zookeeper-master\zookeeper-master\zookeeper-server\src\main\java\org\apache\zookeeper\cli\GetEphemeralsCommand.java,46,0,1,1,0,2
zookeeper-master\zookeeper-master\zookeeper-server\src\test\java\org\apache\zookeeper\common\X509UtilTest.java,854,0,77,146,0,223
zookeeper-master\zookeeper-master\zookeeper-server\src\test\java\org\apache\zookeeper\test\QuorumMajorityTest.java,73,0,0,6,0,6
zookeeper-master\zookeeper-master\zookeeper-server\src\main\java\org\apache\zookeeper\ClientCnxnSocket.java,205,0,4,8,0,12
zookeeper-master\zookeeper-master\zookeeper-server\src\test\java\org\apache\zookeeper\common\CertificatesToPlayWith.java,507,0,0,30,0,30
zookeeper-master\zookeeper-master\zookeeper-server\src\test\java\org\apache\zookeeper\server\controller\ControllerConfigTest.java,118,0,17,10,0,27
zookeeper-master\zookeeper-master\zookeeper-contrib\zookeeper-contrib-zooinspector\src\main\java\org\apache\zookeeper\inspector\gui\nodeviewer\ZooInspectorNodeViewer.java,105,0,5,1,0,6
zookeeper-master\zookeeper-master\zookeeper-server\src\main\java\org\apache\zookeeper\server\FinalRequestProcessor.java,600,0,107,76,0,183
zookeeper-master\zookeeper-master\zookeeper-server\src\main\java\org\apache\zookeeper\server\NIOServerCnxnFactory.java,891,0,17,44,0,61
zookeeper-master\zookeeper-master\zookeeper-server\src\main\java\org\apache\zookeeper\server\quorum\LeaderSessionTracker.java,194,0,7,13,0,20
zookeeper-master\zookeeper-master\zookeeper-server\src\test\java\org\apache\zookeeper\test\NettyNettySuiteTest.java,4,0,0,2,0,2
zookeeper-master\zookeeper-master\zookeeper-server\src\test\java\org\apache\zookeeper\server\ZooKeeperThreadTest.java,62,0,2,3,0,5
zookeeper-master\zookeeper-master\zookeeper-server\src\main\java\org\apache\zookeeper\server\persistence\FileTxnSnapLog.java,621,0,28,42,0,70
zookeeper-master\zookeeper-master\zookeeper-server\src\main\java\org\apache\zookeeper\cli\StatCommand.java,69,0,4,4,0,8
zookeeper-master\zookeeper-master\zookeeper-server\src\main\java\org\apache\zookeeper\server\command\DigestCommand.java,20,0,0,3,0,3
zookeeper-master\zookeeper-master\zookeeper-server\src\test\java\org\apache\zookeeper\common\PathUtilsTest.java,143,0,20,1,0,21
zookeeper-master\zookeeper-master\zookeeper-jute\src\main\java\org\apache\jute\compiler\JMap.java,136,0,0,21,0,21
zookeeper-master\zookeeper-master\zookeeper-server\src\test\java\org\apache\zookeeper\server\util\CircularBufferTest.java,176,0,2,6,0,8
zookeeper-master\zookeeper-master\zookeeper-server\src\main\java\org\apache\zookeeper\server\auth\KeyAuthenticationProvider.java,78,0,8,6,0,14
zookeeper-master\zookeeper-master\zookeeper-server\src\main\java-filtered\org\apache\zookeeper\version\Info.java,0,0,0,2,0,2
zookeeper-master\zookeeper-master\zookeeper-server\src\test\java\org\apache\zookeeper\test\MaxCnxnsTest.java,107,0,5,10,0,15
zookeeper-master\zookeeper-master\zookeeper-server\src\test\java\org\apache\zookeeper\server\quorum\StatCommandTest.java,69,0,0,2,0,2
zookeeper-master\zookeeper-master\zookeeper-server\src\test\java\org\apache\zookeeper\test\TestByteBufAllocator.java,97,0,3,9,0,12
zookeeper-master\zookeeper-master\zookeeper-contrib\zookeeper-contrib-rest\src\main\java\org\apache\zookeeper\server\jersey\RestMain.java,113,0,2,4,0,6
zookeeper-master\zookeeper-master\zookeeper-server\src\main\java\org\apache\zookeeper\server\DigestCalculator.java,97,0,4,1,0,5
zookeeper-master\zookeeper-master\zookeeper-server\src\test\java\org\apache\zookeeper\test\TestByteBufAllocatorTestHelper.java,22,0,5,7,0,12
zookeeper-master\zookeeper-master\zookeeper-jute\src\test\java\org\apache\jute\TestWriter.java,0,0,0,1,0,1
zookeeper-master\zookeeper-master\zookeeper-server\src\main\java\org\apache\zookeeper\cli\GetAclCommand.java,54,0,7,1,0,8
zookeeper-master\zookeeper-master\zookeeper-server\src\test\java\org\apache\zookeeper\server\quorum\BufferStatsTest.java,37,0,0,1,0,1
zookeeper-master\zookeeper-master\zookeeper-contrib\zookeeper-contrib-zooinspector\src\main\java\org\apache\zookeeper\inspector\gui\nodeviewer\NodeSelectionListener.java,0,0,0,2,0,2
zookeeper-master\zookeeper-master\zookeeper-server\src\main\java\org\apache\zookeeper\server\WorkerService.java,197,0,4,12,0,16
zookeeper-master\zookeeper-master\zookeeper-contrib\zookeeper-contrib-rest\src\test\java\org\apache\zookeeper\server\jersey\CreateTest.java,116,0,4,3,0,7
zookeeper-master\zookeeper-master\zookeeper-server\src\test\java\org\apache\zookeeper\server\SnapshotDigestTest.java,166,0,8,16,0,24
zookeeper-master\zookeeper-master\zookeeper-server\src\main\java\org\apache\zookeeper\server\DumbWatcher.java,97,0,15,2,0,17
zookeeper-master\zookeeper-master\zookeeper-server\src\main\java\org\apache\zookeeper\StatsTrack.java,205,0,0,2,0,2
zookeeper-master\zookeeper-master\zookeeper-server\src\test\java\org\apache\zookeeper\test\OSMXBeanTest.java,43,0,2,3,0,5
zookeeper-master\zookeeper-master\zookeeper-server\src\main\java\org\apache\zookeeper\server\TxnLogProposalIterator.java,72,0,9,5,0,14
zookeeper-master\zookeeper-master\zookeeper-server\src\test\java\org\apache\zookeeper\common\JKSFileLoaderTest.java,124,0,0,29,0,29
zookeeper-master\zookeeper-master\zookeeper-server\src\main\java\org\apache\zookeeper\server\controller\ControllableConnection.java,40,0,7,8,0,15
zookeeper-master\zookeeper-master\zookeeper-server\src\test\java\org\apache\zookeeper\test\SaslDigestAuthOverSSLTest.java,110,0,2,17,0,19
zookeeper-master\zookeeper-master\zookeeper-server\src\test\java\org\apache\zookeeper\server\PurgeTxnTest.java,570,0,26,82,0,108
zookeeper-master\zookeeper-master\zookeeper-it\target\generated-sources\annotations\org\apache\zookeeper\server\watch\generated\WatchBench_jmhType.java,0,0,1,1,0,2
zookeeper-master\zookeeper-master\zookeeper-contrib\zookeeper-contrib-zooinspector\src\test\java\org\apache\zookeeper\inspector\manager\ZooInspectorManagerImplTest.java,81,0,6,8,0,14
zookeeper-master\zookeeper-master\zookeeper-server\src\main\java\org\apache\zookeeper\client\ZooKeeperSaslClient.java,420,0,31,63,0,94
zookeeper-master\zookeeper-master\zookeeper-contrib\zookeeper-contrib-zooinspector\src\main\java\org\apache\zookeeper\inspector\gui\IconResource.java,75,0,4,4,0,8
zookeeper-master\zookeeper-master\zookeeper-server\src\main\java\org\apache\zookeeper\client\HostProvider.java,0,0,0,6,0,6
zookeeper-master\zookeeper-master\zookeeper-server\src\main\java\org\apache\zookeeper\server\quorum\LocalPeerBean.java,107,0,0,4,0,4
zookeeper-master\zookeeper-master\zookeeper-server\src\main\java\org\apache\zookeeper\server\RequestThrottler.java,221,0,7,13,0,20
zookeeper-master\zookeeper-master\zookeeper-server\src\test\java\org\apache\zookeeper\server\util\PortForwarder.java,181,0,11,16,0,27
zookeeper-master\zookeeper-master\zookeeper-server\src\test\java\org\apache\zookeeper\MockPacket.java,0,0,6,2,0,8
zookeeper-master\zookeeper-master\zookeeper-server\src\main\java\org\apache\zookeeper\metrics\impl\DefaultMetricsProvider.java,188,0,2,22,0,24
zookeeper-master\zookeeper-master\zookeeper-contrib\zookeeper-contrib-zooinspector\src\main\java\org\apache\zookeeper\inspector\manager\ZooInspectorManager.java,106,0,11,2,0,13
zookeeper-master\zookeeper-master\zookeeper-server\src\main\java\org\apache\zookeeper\server\SessionTrackerImpl.java,316,0,6,17,0,23
zookeeper-master\zookeeper-master\zookeeper-server\src\test\java\org\apache\zookeeper\server\FinalRequestProcessorTest.java,174,0,77,37,0,114
zookeeper-master\zookeeper-master\zookeeper-server\src\test\java\org\apache\zookeeper\common\AtomicFileWritingIdiomTest.java,307,0,2,21,0,23
zookeeper-master\zookeeper-master\zookeeper-server\src\test\java\org\apache\zookeeper\server\ReferenceCountedACLCacheTest.java,252,0,75,17,0,92
zookeeper-master\zookeeper-master\zookeeper-server\src\test\java\org\apache\zookeeper\test\TestUtils.java,35,0,1,3,0,4
zookeeper-master\zookeeper-master\zookeeper-server\src\test\java\org\apache\zookeeper\server\quorum\auth\QuorumKerberosHostBasedAuthTest.java,188,0,7,35,0,42
zookeeper-master\zookeeper-master\zookeeper-server\src\main\java\org\apache\zookeeper\cli\ReconfigCommand.java,132,0,8,29,0,37
zookeeper-master\zookeeper-master\zookeeper-server\src\main\java\org\apache\zookeeper\server\quorum\auth\QuorumAuth.java,69,0,5,14,0,19
zookeeper-master\zookeeper-master\zookeeper-server\src\test\java\org\apache\zookeeper\server\quorum\ReconfigRollingRestartCompatibilityTest.java,0,0,6,72,0,78
zookeeper-master\zookeeper-master\zookeeper-server\src\test\java\org\apache\zookeeper\test\AsyncTest.java,0,0,9,5,0,14
zookeeper-master\zookeeper-master\zookeeper-contrib\zookeeper-contrib-loggraph\src\main\java\org\apache\zookeeper\graph\filterops\XorOp.java,18,0,1,1,0,2
zookeeper-master\zookeeper-master\zookeeper-contrib\zookeeper-contrib-loggraph\src\main\java\org\apache\zookeeper\graph\LogServer.java,0,0,15,1,0,16
zookeeper-master\zookeeper-master\zookeeper-jute\src\main\java\org\apache\jute\compiler\JString.java,26,0,0,2,0,2
zookeeper-master\zookeeper-master\zookeeper-server\src\main\java\org\apache\zookeeper\server\watch\WatchManagerFactory.java,23,0,1,6,0,7
zookeeper-master\zookeeper-master\zookeeper-server\src\test\java\org\apache\zookeeper\test\ObserverHierarchicalQuorumTest.java,20,0,0,1,0,1
zookeeper-master\zookeeper-master\zookeeper-contrib\zookeeper-contrib-rest\src\test\java\org\apache\zookeeper\server\jersey\WadlTest.java,13,0,0,1,0,1
zookeeper-master\zookeeper-master\zookeeper-server\src\test\java\org\apache\zookeeper\test\ObserverMasterTest.java,473,0,34,78,0,112
zookeeper-master\zookeeper-master\zookeeper-server\src\main\java\org\apache\zookeeper\server\ZooKeeperServerListener.java,0,0,0,1,0,1
zookeeper-master\zookeeper-master\zookeeper-server\src\test\java\org\apache\zookeeper\test\SSLAuthTest.java,84,0,2,17,0,19
zookeeper-master\zookeeper-master\zookeeper-server\src\main\java\org\apache\zookeeper\server\quorum\FollowerZooKeeperServer.java,137,0,8,19,0,27
zookeeper-master\zookeeper-master\zookeeper-contrib\zookeeper-contrib-zooinspector\src\main\java\org\apache\zookeeper\inspector\gui\NodeViewersChangeListener.java,0,0,1,1,0,2
zookeeper-master\zookeeper-master\zookeeper-server\src\test\java\org\apache\zookeeper\server\quorum\auth\MiniKdc.java,332,0,7,34,0,41
zookeeper-master\zookeeper-master\zookeeper-server\src\test\java\org\apache\zookeeper\test\StatTest.java,166,0,21,11,0,32
zookeeper-master\zookeeper-master\zookeeper-server\src\test\java\org\apache\zookeeper\metrics\MetricsUtils.java,34,0,1,1,0,2
zookeeper-master\zookeeper-master\zookeeper-server\src\main\java\org\apache\zookeeper\server\quorum\Learner.java,833,0,87,88,0,175
zookeeper-master\zookeeper-master\zookeeper-server\src\test\java\org\apache\zookeeper\ZKTestCase.java,76,0,2,6,0,8
zookeeper-master\zookeeper-master\zookeeper-server\src\test\java\org\apache\zookeeper\server\quorum\QuorumPeerMainTest.java,1737,0,124,262,0,386
zookeeper-master\zookeeper-master\zookeeper-server\src\main\java\org\apache\zookeeper\metrics\SummarySet.java,0,0,0,3,0,3
zookeeper-master\zookeeper-master\zookeeper-server\src\test\java\org\apache\zookeeper\test\ThrottledOpStandaloneTest.java,38,0,0,2,0,2
zookeeper-master\zookeeper-master\zookeeper-server\src\main\java\org\apache\zookeeper\server\quorum\ServerBean.java,0,0,0,1,0,1
zookeeper-master\zookeeper-master\zookeeper-server\src\main\java\org\apache\zookeeper\cli\MalformedCommandException.java,8,0,1,1,0,2
zookeeper-master\zookeeper-master\zookeeper-server\src\main\java\org\apache\zookeeper\server\util\ConfigUtils.java,97,0,2,11,0,13
zookeeper-master\zookeeper-master\zookeeper-server\src\test\java\org\apache\zookeeper\test\RepeatStartupTest.java,41,0,2,4,0,6
zookeeper-master\zookeeper-master\zookeeper-it\src\main\java\org\apache\zookeeper\BenchMain.java,6,0,9,1,0,10
zookeeper-master\zookeeper-master\zookeeper-server\src\test\java\org\apache\zookeeper\common\PathTrieTest.java,139,0,0,3,0,3
zookeeper-master\zookeeper-master\zookeeper-server\src\main\java\org\apache\zookeeper\util\CircularBlockingQueue.java,238,0,0,3,0,3
zookeeper-master\zookeeper-master\zookeeper-server\src\test\java\org\apache\zookeeper\ClientRequestTimeoutTest.java,141,0,7,10,0,17
zookeeper-master\zookeeper-master\zookeeper-server\src\test\java\org\apache\zookeeper\test\LogChopperTest.java,74,0,12,6,0,18
zookeeper-master\zookeeper-master\zookeeper-server\src\test\java\org\apache\zookeeper\server\ServerMetricsTest.java,82,0,0,2,0,2
zookeeper-master\zookeeper-master\zookeeper-contrib\zookeeper-contrib-loggraph\src\main\java\org\apache\zookeeper\graph\MeasureThroughput.java,77,0,16,5,0,21
zookeeper-master\zookeeper-master\zookeeper-server\src\test\java\org\apache\zookeeper\test\QuorumZxidSyncTest.java,127,0,7,9,0,16
zookeeper-master\zookeeper-master\zookeeper-jute\src\main\java\org\apache\jute\RecordWriter.java,53,0,2,4,0,6
zookeeper-master\zookeeper-master\zookeeper-server\src\main\java\org\apache\zookeeper\ZKUtil.java,256,0,7,19,0,26
zookeeper-master\zookeeper-master\zookeeper-server\src\test\java\org\apache\zookeeper\test\SyncCallTest.java,0,0,13,10,0,23
zookeeper-master\zookeeper-master\zookeeper-jute\src\main\java\org\apache\jute\compiler\JBuffer.java,87,0,0,10,0,10
zookeeper-master\zookeeper-master\zookeeper-server\src\main\java\org\apache\zookeeper\server\command\ConfCommand.java,17,0,0,1,0,1
zookeeper-master\zookeeper-master\zookeeper-it\target\generated-sources\annotations\org\apache\zookeeper\server\watch\generated\WatchBench_InvocationState_jmhType.java,0,0,1,2,0,3
zookeeper-master\zookeeper-master\zookeeper-server\src\main\java\org\apache\zookeeper\server\util\LogChopper.java,114,0,8,11,0,19
zookeeper-master\zookeeper-master\zookeeper-server\src\test\java\org\apache\zookeeper\common\KeyStoreFileTypeTest.java,83,0,0,22,0,22
zookeeper-master\zookeeper-master\zookeeper-server\src\test\java\org\apache\zookeeper\server\quorum\ReconfigRecoveryTest.java,518,0,25,52,0,77
zookeeper-master\zookeeper-master\zookeeper-server\src\main\java\org\apache\zookeeper\server\persistence\FileTxnLog.java,0,0,47,31,0,78
zookeeper-master\zookeeper-master\zookeeper-contrib\zookeeper-contrib-rest\src\main\java\org\apache\zookeeper\server\jersey\jaxb\ZSession.java,33,0,0,1,0,1
zookeeper-master\zookeeper-master\zookeeper-server\src\main\java\org\apache\zookeeper\cli\GetAllChildrenNumberCommand.java,45,0,1,1,0,2
zookeeper-master\zookeeper-master\zookeeper-server\src\test\java\org\apache\zookeeper\ServerConfigTest.java,70,0,0,4,0,4
zookeeper-master\zookeeper-master\zookeeper-server\src\test\java\org\apache\zookeeper\test\ACLTest.java,258,0,48,24,0,72
zookeeper-master\zookeeper-master\zookeeper-server\src\main\java\org\apache\zookeeper\server\quorum\flexible\QuorumMaj.java,129,0,4,4,0,8
zookeeper-master\zookeeper-master\zookeeper-server\src\test\java\org\apache\zookeeper\test\TestHammer.java,31,0,2,3,0,5
zookeeper-master\zookeeper-master\zookeeper-server\src\test\java\org\apache\zookeeper\common\FileChangeWatcherTest.java,226,0,12,20,0,32
zookeeper-master\zookeeper-master\zookeeper-server\src\main\java\org\apache\zookeeper\server\command\DirsCommand.java,18,0,0,1,0,1
zookeeper-master\zookeeper-master\zookeeper-server\src\main\java\org\apache\zookeeper\metrics\Counter.java,0,0,0,4,0,4
zookeeper-master\zookeeper-master\zookeeper-server\src\test\java\org\apache\zookeeper\test\NettyNettySuiteHammerTest.java,4,0,0,1,0,1
zookeeper-master\zookeeper-master\zookeeper-server\src\main\java\org\apache\zookeeper\cli\CreateCommand.java,105,0,9,7,0,16
zookeeper-master\zookeeper-master\zookeeper-server\src\test\java\org\apache\zookeeper\test\EventTypeTest.java,25,0,1,1,0,2
zookeeper-master\zookeeper-master\zookeeper-server\src\test\java\org\apache\zookeeper\test\QuorumUtilTest.java,59,0,0,4,0,4
zookeeper-master\zookeeper-master\zookeeper-server\src\main\java\org\apache\zookeeper\server\auth\WrappedAuthenticationProvider.java,0,0,2,6,0,8
zookeeper-master\zookeeper-master\zookeeper-it\src\main\java\org\apache\zookeeper\test\system\InstanceManager.java,0,0,20,24,0,44
zookeeper-master\zookeeper-master\zookeeper-contrib\zookeeper-contrib-loggraph\src\main\java\org\apache\zookeeper\graph\filterops\NumberArg.java,0,0,2,1,0,3
zookeeper-master\zookeeper-master\zookeeper-server\src\main\java\org\apache\zookeeper\server\quorum\auth\SaslQuorumAuthServer.java,132,0,13,17,0,30
zookeeper-master\zookeeper-master\zookeeper-server\src\main\java\org\apache\zookeeper\server\auth\DigestLoginModule.java,0,0,1,3,0,4
zookeeper-master\zookeeper-master\zookeeper-server\src\test\java\org\apache\zookeeper\test\WatcherTest.java,405,0,38,26,0,64
zookeeper-master\zookeeper-master\zookeeper-compatibility-tests\zookeeper-compatibility-tests-curator\src\test\java\org\apache\zookeeper\compatibility\TestApacheCuratorCompatibility.java,54,0,0,9,0,9
zookeeper-master\zookeeper-master\zookeeper-server\src\test\java\org\apache\zookeeper\test\DisconnectedWatcherTest.java,225,0,22,21,0,43
zookeeper-master\zookeeper-master\zookeeper-contrib\zookeeper-contrib-rest\src\test\java\org\apache\zookeeper\server\jersey\RestTestSuite.java,14,0,1,1,0,2
zookeeper-master\zookeeper-master\zookeeper-server\src\main\java\org\apache\zookeeper\server\quorum\SendAckRequestProcessor.java,0,0,4,8,0,12
zookeeper-master\zookeeper-master\zookeeper-contrib\zookeeper-contrib-loggraph\src\main\java\org\apache\zookeeper\graph\filterops\EqualsOp.java,22,0,1,1,0,2
zookeeper-master\zookeeper-master\zookeeper-recipes\zookeeper-recipes-election\src\test\java\org\apache\zookeeper\recipes\leader\LeaderElectionSupportTest.java,230,0,1,15,0,16
zookeeper-master\zookeeper-master\zookeeper-it\target\generated-sources\annotations\org\apache\zookeeper\server\watch\generated\WatchBench_TriggerSparseWatchState_jmhType_B1.java,0,0,19,18,0,37
zookeeper-master\zookeeper-master\zookeeper-server\src\test\java\org\apache\zookeeper\MultiOperationRecordTest.java,41,0,1,4,0,5
zookeeper-master\zookeeper-master\zookeeper-server\src\test\java\org\apache\zookeeper\server\ZooKeeperServerBeanTest.java,107,0,5,3,0,8
zookeeper-master\zookeeper-master\zookeeper-contrib\zookeeper-contrib-zooinspector\src\main\java\org\apache\zookeeper\inspector\manager\ZooInspectorReadOnlyManager.java,0,0,5,1,0,6
zookeeper-master\zookeeper-master\zookeeper-server\src\test\java\org\apache\zookeeper\test\ReconfigMisconfigTest.java,0,0,8,10,0,18
zookeeper-master\zookeeper-master\zookeeper-server\src\test\java\org\apache\zookeeper\test\SaslAuthRequiredTest.java,34,0,1,5,0,6
zookeeper-master\zookeeper-master\zookeeper-server\src\test\java\org\apache\zookeeper\test\RestoreCommittedLogTest.java,92,0,3,12,0,15
zookeeper-master\zookeeper-master\zookeeper-it\target\generated-sources\annotations\org\apache\zookeeper\server\watch\generated\WatchBench_testAddConcentrateWatch_jmhTest.java,0,0,105,90,0,195
zookeeper-master\zookeeper-master\zookeeper-server\src\test\java\org\apache\zookeeper\server\DataNodeTest.java,42,0,2,1,0,3
zookeeper-master\zookeeper-master\zookeeper-server\src\test\java\org\apache\zookeeper\server\util\VerifyingFileFactoryTest.java,40,0,0,5,0,5
zookeeper-master\zookeeper-master\zookeeper-server\src\test\java\org\apache\zookeeper\test\ReconfigTest.java,1217,0,38,112,0,150
zookeeper-master\zookeeper-master\zookeeper-contrib\zookeeper-contrib-loggraph\src\main\java\org\apache\zookeeper\graph\filterops\OrOp.java,11,0,0,1,0,1
zookeeper-master\zookeeper-master\zookeeper-server\src\main\java\org\apache\zookeeper\ClientWatchManager.java,0,0,0,2,0,2
zookeeper-master\zookeeper-master\zookeeper-server\src\test\java\org\apache\zookeeper\test\FLETest.java,459,0,33,28,0,61
zookeeper-master\zookeeper-master\zookeeper-jute\src\main\java\org\apache\jute\OutputArchive.java,0,0,2,1,0,3
zookeeper-master\zookeeper-master\zookeeper-server\src\main\java\org\apache\zookeeper\server\ByteBufferInputStream.java,56,0,0,2,0,2
zookeeper-master\zookeeper-master\zookeeper-server\src\main\java\org\apache\zookeeper\common\KeyStoreFileType.java,0,0,1,9,0,10
zookeeper-master\zookeeper-master\zookeeper-server\src\test\java\org\apache\zookeeper\test\ThrottledOpHelper.java,186,0,50,10,0,60
zookeeper-master\zookeeper-master\zookeeper-server\src\main\java\org\apache\zookeeper\server\admin\AdminServerFactory.java,38,0,6,6,0,12
zookeeper-master\zookeeper-master\zookeeper-jute\src\main\java\org\apache\jute\BinaryInputArchive.java,141,0,6,4,0,10
zookeeper-master\zookeeper-master\zookeeper-server\src\main\java\org\apache\zookeeper\common\PKCS12FileLoader.java,0,0,1,3,0,4
zookeeper-master\zookeeper-master\zookeeper-server\src\main\java\org\apache\zookeeper\server\admin\DummyAdminServer.java,16,0,3,1,0,4
zookeeper-master\zookeeper-master\zookeeper-server\src\test\java\org\apache\zookeeper\test\StandaloneTest.java,112,0,9,14,0,23
zookeeper-master\zookeeper-master\zookeeper-jute\src\main\java\org\apache\jute\compiler\JavaGenerator.java,0,0,3,1,0,4
zookeeper-master\zookeeper-master\zookeeper-server\src\main\java\org\apache\zookeeper\server\ZooKeeperServerBean.java,0,0,0,3,0,3
zookeeper-master\zookeeper-master\zookeeper-server\src\test\java\org\apache\zookeeper\test\ZkDatabaseCorruptionTest.java,157,0,7,8,0,15
zookeeper-master\zookeeper-master\zookeeper-jute\src\main\java\org\apache\jute\ToStringOutputArchive.java,0,0,3,2,0,5
zookeeper-master\zookeeper-master\zookeeper-server\src\main\java\org\apache\zookeeper\server\watch\WatchesPathReport.java,56,0,0,1,0,1
zookeeper-master\zookeeper-master\zookeeper-server\src\main\java\org\apache\zookeeper\cli\SetCommand.java,57,0,4,1,0,5
zookeeper-master\zookeeper-master\zookeeper-server\src\main\java\org\apache\zookeeper\server\DatadirCleanupManager.java,162,0,0,4,0,4
zookeeper-master\zookeeper-master\zookeeper-server\src\test\java\org\apache\zookeeper\PortAssignment.java,0,0,1,14,0,15
zookeeper-master\zookeeper-master\zookeeper-server\src\main\java\org\apache\zookeeper\server\ResponseCache.java,65,0,8,3,0,11
zookeeper-master\zookeeper-master\zookeeper-server\src\main\java\org\apache\zookeeper\server\quorum\SyncThrottleException.java,17,0,1,4,0,5
zookeeper-master\zookeeper-master\zookeeper-server\src\main\java\org\apache\zookeeper\server\TxnLogEntry.java,0,0,12,1,0,13
zookeeper-master\zookeeper-master\zookeeper-server\src\test\java\org\apache\zookeeper\test\RecoveryTest.java,143,0,12,21,0,33
zookeeper-master\zookeeper-master\zookeeper-server\src\test\java\org\apache\zookeeper\test\ClientSSLTest.java,171,0,5,38,0,43
zookeeper-master\zookeeper-master\zookeeper-server\src\test\java\org\apache\zookeeper\test\SaslClientTest.java,35,0,0,6,0,6
zookeeper-master\zookeeper-master\zookeeper-it\target\generated-sources\annotations\org\apache\zookeeper\server\watch\generated\WatchBench_InvocationState_jmhType_B2.java,21,0,10,8,0,18
zookeeper-master\zookeeper-master\zookeeper-server\src\test\java\org\apache\zookeeper\test\SledgeHammer.java,77,0,9,5,0,14
zookeeper-master\zookeeper-master\zookeeper-server\src\test\java\org\apache\zookeeper\server\ZooKeeperServerConfTest.java,36,0,0,8,0,8
zookeeper-master\zookeeper-master\zookeeper-server\src\main\java\org\apache\zookeeper\server\admin\JettyAdminServer.java,252,0,4,33,0,37
zookeeper-master\zookeeper-master\zookeeper-server\src\test\java\org\apache\zookeeper\server\persistence\FileTxnSnapLogTest.java,354,0,28,29,0,57
zookeeper-master\zookeeper-master\zookeeper-server\src\test\java\org\apache\zookeeper\test\X509AuthTest.java,237,0,19,17,0,36
zookeeper-master\zookeeper-master\zookeeper-server\src\test\java\org\apache\zookeeper\test\SaslAuthFailTest.java,66,0,2,7,0,9
zookeeper-master\zookeeper-master\zookeeper-jute\src\test\java\org\apache\jute\BinaryInputArchiveTest.java,162,0,1,4,0,5
zookeeper-master\zookeeper-master\zookeeper-server\src\main\java\org\apache\zookeeper\server\command\DumpCommand.java,25,0,0,2,0,2
zookeeper-master\zookeeper-master\zookeeper-server\src\main\java\org\apache\zookeeper\server\NIOServerCnxn.java,731,0,23,34,0,57
zookeeper-master\zookeeper-master\zookeeper-server\src\test\java\org\apache\zookeeper\server\quorum\ReadOnlyZooKeeperServerTest.java,32,0,0,7,0,7
zookeeper-master\zookeeper-master\zookeeper-server\src\test\java\org\apache\zookeeper\server\watch\WatchesSummaryTest.java,24,0,0,3,0,3
zookeeper-master\zookeeper-master\zookeeper-server\src\test\java\org\apache\zookeeper\common\X509TestHelpers.java,359,0,3,108,0,111
zookeeper-master\zookeeper-master\zookeeper-server\src\test\java\org\apache\zookeeper\test\JMXEnv.java,299,0,14,23,0,37
zookeeper-master\zookeeper-master\zookeeper-it\target\generated-sources\annotations\org\apache\zookeeper\server\watch\generated\WatchBench_AddSparseWatchState_jmhType.java,0,0,1,2,0,3
zookeeper-master\zookeeper-master\zookeeper-server\src\test\java\org\apache\zookeeper\server\NIOServerCnxnTest.java,50,0,4,13,0,17
zookeeper-master\zookeeper-master\zookeeper-server\src\main\java\org\apache\zookeeper\server\command\CommandExecutor.java,65,0,0,3,0,3
zookeeper-master\zookeeper-master\zookeeper-server\src\main\java\org\apache\zookeeper\server\quorum\auth\NullQuorumAuthLearner.java,9,0,1,1,0,2
zookeeper-master\zookeeper-master\zookeeper-contrib\zookeeper-contrib-loggraph\src\main\java\org\apache\zookeeper\graph\filterops\StringArg.java,0,0,2,1,0,3
zookeeper-master\zookeeper-master\zookeeper-server\src\test\java\org\apache\zookeeper\server\quorum\LearnerSyncThrottlerTest.java,130,0,4,11,0,15
zookeeper-master\zookeeper-master\zookeeper-contrib\zookeeper-contrib-loggraph\src\main\java\org\apache\zookeeper\graph\filterops\SymbolArg.java,7,0,2,1,0,3
zookeeper-master\zookeeper-master\zookeeper-server\src\main\java\org\apache\zookeeper\common\FileChangeWatcher.java,0,0,7,29,0,36
zookeeper-master\zookeeper-master\zookeeper-server\src\test\java\org\apache\zookeeper\server\ZooKeeperServerMaxCnxnsTest.java,142,0,3,19,0,22
zookeeper-master\zookeeper-master\zookeeper-contrib\zookeeper-contrib-zooinspector\src\main\java\org\apache\zookeeper\inspector\gui\ZooInspectorNodeViewersPanel.java,0,0,0,4,0,4
zookeeper-master\zookeeper-master\zookeeper-server\src\main\java\org\apache\zookeeper\server\embedded\ZooKeeperServerEmbeddedImpl.java,0,0,16,19,0,35
zookeeper-master\zookeeper-master\zookeeper-server\src\test\java\org\apache\zookeeper\server\DeserializationPerfTest.java,84,0,2,14,0,16
zookeeper-master\zookeeper-master\zookeeper-contrib\zookeeper-contrib-loggraph\src\main\java\org\apache\zookeeper\graph\servlets\JsonServlet.java,0,0,4,6,0,10
zookeeper-master\zookeeper-master\zookeeper-server\src\main\java\org\apache\zookeeper\server\quorum\ReadOnlyBean.java,12,0,0,1,0,1
zookeeper-master\zookeeper-master\zookeeper-server\src\test\java\org\apache\zookeeper\server\watch\WatchesPathReportTest.java,40,0,0,1,0,1
zookeeper-master\zookeeper-master\zookeeper-server\src\main\java\org\apache\zookeeper\server\persistence\TxnLog.java,0,0,7,2,0,9
zookeeper-master\zookeeper-master\zookeeper-server\src\test\java\org\apache\zookeeper\server\metric\AvgMinMaxPercentileCounterSetTest.java,77,0,0,37,0,37
zookeeper-master\zookeeper-master\zookeeper-it\target\generated-sources\annotations\org\apache\zookeeper\server\watch\generated\WatchBench_testTriggerSparseWatch_jmhTest.java,0,0,160,183,0,343
zookeeper-master\zookeeper-master\zookeeper-server\src\main\java\org\apache\zookeeper\server\command\FourLetterCommands.java,219,0,5,28,0,33
zookeeper-master\zookeeper-master\zookeeper-server\src\main\java\org\apache\zookeeper\common\BCFKSFileLoader.java,0,0,1,3,0,4
zookeeper-master\zookeeper-master\zookeeper-server\src\main\java\org\apache\zookeeper\common\StandardTypeFileKeyStoreLoader.java,45,0,0,7,0,7
zookeeper-master\zookeeper-master\zookeeper-server\src\main\java\org\apache\zookeeper\common\AtomicFileWritingIdiom.java,58,0,1,7,0,8
zookeeper-master\zookeeper-master\zookeeper-server\src\test\java\org\apache\zookeeper\server\TxnLogDigestTest.java,226,0,13,10,0,23
zookeeper-master\zookeeper-master\zookeeper-server\src\test\java\org\apache\zookeeper\server\watch\WatchManagerTest.java,427,0,7,20,0,27
zookeeper-master\zookeeper-master\zookeeper-server\src\main\java\org\apache\zookeeper\cli\CommandFactory.java,51,0,2,1,0,3
zookeeper-master\zookeeper-master\zookeeper-server\src\main\java\org\apache\zookeeper\server\ObserverBean.java,38,0,0,3,0,3
zookeeper-master\zookeeper-master\zookeeper-server\src\test\java\org\apache\zookeeper\server\ZooKeeperServerMainTest.java,617,0,60,85,0,145
zookeeper-master\zookeeper-master\zookeeper-server\src\main\java\org\apache\zookeeper\MultiResponse.java,0,0,37,16,0,53
zookeeper-master\zookeeper-master\zookeeper-server\src\test\java\org\apache\zookeeper\common\X509KeyType.java,0,0,0,2,0,2
zookeeper-master\zookeeper-master\zookeeper-server\src\main\java\org\apache\zookeeper\JLineZNodeCompleter.java,0,0,2,5,0,7
zookeeper-master\zookeeper-master\zookeeper-jute\src\main\java\org\apache\jute\compiler\JInt.java,14,0,0,2,0,2
zookeeper-master\zookeeper-master\zookeeper-server\src\main\java\org\apache\zookeeper\server\NettyServerCnxnFactory.java,767,0,19,122,0,141
zookeeper-master\zookeeper-master\zookeeper-contrib\zookeeper-contrib-loggraph\src\main\java\org\apache\zookeeper\graph\FilterException.java,4,0,1,1,0,2
zookeeper-master\zookeeper-master\zookeeper-server\src\test\java\org\apache\zookeeper\test\LocalSessionRequestTest.java,106,0,4,7,0,11
zookeeper-master\zookeeper-master\zookeeper-server\src\test\java\org\apache\zookeeper\server\quorum\CloseSessionTxnTest.java,68,0,2,3,0,5
zookeeper-master\zookeeper-master\zookeeper-server\src\test\java\org\apache\zookeeper\test\StringUtilTest.java,44,0,0,1,0,1
zookeeper-master\zookeeper-master\zookeeper-contrib\zookeeper-contrib-rest\src\main\java\org\apache\zookeeper\server\jersey\resources\JAXBContextResolver.java,0,0,5,1,0,6
zookeeper-master\zookeeper-master\zookeeper-server\src\main\java\org\apache\zookeeper\server\admin\Command.java,0,0,0,1,0,1
zookeeper-master\zookeeper-master\zookeeper-recipes\zookeeper-recipes-lock\src\test\java\org\apache\zookeeper\recipes\lock\WriteLockTest.java,126,0,3,8,0,11
zookeeper-master\zookeeper-master\zookeeper-server\src\main\java\org\apache\zookeeper\server\NettyServerCnxn.java,610,0,29,50,0,79
zookeeper-master\zookeeper-master\zookeeper-server\src\test\java\org\apache\zookeeper\test\AuthSHA3Test.java,61,0,4,13,0,17
zookeeper-master\zookeeper-master\zookeeper-server\src\test\java\org\apache\zookeeper\test\KeyAuthClientTest.java,101,0,19,4,0,23
zookeeper-master\zookeeper-master\zookeeper-contrib\zookeeper-contrib-loggraph\src\main\java\org\apache\zookeeper\graph\servlets\GraphData.java,0,0,1,3,0,4
zookeeper-master\zookeeper-master\zookeeper-server\src\test\java\org\apache\zookeeper\ZKUtilTest.java,88,0,7,10,0,17
zookeeper-master\zookeeper-master\zookeeper-server\src\main\java\org\apache\zookeeper\metrics\impl\MetricsProviderBootstrap.java,31,0,0,6,0,6
zookeeper-master\zookeeper-master\zookeeper-server\src\test\java\org\apache\zookeeper\test\EmptiedSnapshotRecoveryTest.java,153,0,7,23,0,30
zookeeper-master\zookeeper-master\zookeeper-contrib\zookeeper-contrib-loggraph\src\test\java\org\apache\zookeeper\graph\servlets\ThroughputTest.java,56,0,3,4,0,7
zookeeper-master\zookeeper-master\zookeeper-server\src\main\java\org\apache\zookeeper\util\SecurityUtils.java,0,0,11,40,0,51
zookeeper-master\zookeeper-master\zookeeper-server\src\test\java\org\apache\zookeeper\test\ZooKeeperTestClient.java,416,0,53,47,0,100
zookeeper-master\zookeeper-master\zookeeper-server\src\test\java\org\apache\zookeeper\server\util\AuthUtilTest.java,45,0,9,2,0,11
zookeeper-master\zookeeper-master\zookeeper-server\src\main\java\org\apache\zookeeper\server\quorum\LeaderRequestProcessor.java,51,0,4,4,0,8
